PokerStars Hand #222955213477:  Hold'em No Limit ($0.05/$0.10 USD) - 2021/01/23 9:30:27 ET
Table 'Bohlinia III' 6-max Seat #4 is the button
Seat 1: eungenio ($16.85 in chips) 
Seat 2: Richard12358 ($9.17 in chips) 
Seat 3: supernightman ($10 in chips) 
Seat 4: EES888 ($12.28 in chips) 
Seat 5: Kimi1892 ($10 in chips) 
Seat 6: saitam_06 ($10.45 in chips) 
Kimi1892: posts small blind $0.05
saitam_06: posts big blind $0.10
*** HOLE CARDS ***
eungenio: folds 
Richard12358: raises $0.20 to $0.30
supernightman: folds 
EES888: calls $0.30
Kimi1892: folds 
saitam_06: folds 
*** FLOP *** [6c 5c 6s]
Richard12358: checks 
EES888: checks 
*** TURN *** [6c 5c 6s] [3s]
Richard12358: checks 
EES888: checks 
*** RIVER *** [6c 5c 6s 3s] [9c]
Richard12358: checks 
EES888: checks 
*** SHOW DOWN ***
Richard12358: shows [Qh Ks] (a pair of Sixes)
EES888: mucks hand 
Richard12358 collected $0.72 from pot
*** SUMMARY ***
Total pot $0.75 | Rake $0.03 
Board [6c 5c 6s 3s 9c]
Seat 1: eungenio folded before Flop (didn't bet)
Seat 2: Richard12358 showed [Qh Ks] and won ($0.72) with a pair of Sixes
Seat 3: supernightman folded before Flop (didn't bet)
Seat 4: EES888 (button) mucked
Seat 5: Kimi1892 (small blind) folded before Flop
Seat 6: saitam_06 (big blind) folded before Flop



PokerStars Hand #222952557495:  Hold'em No Limit ($0.05/$0.10 USD) - 2021/01/23 7:50:12 ET
Table 'Bohlinia III' 6-max Seat #4 is the button
Seat 1: Nickh147 ($10 in chips) 
Seat 2: fred00205 ($8 in chips) 
Seat 3: Smertobro ($10.28 in chips) 
Seat 4: SERG244 ($10 in chips) 
Nickh147: posts small blind $0.05
fred00205: posts big blind $0.10
*** HOLE CARDS ***
Smertobro: folds 
SERG244: folds 
Nickh147: raises $0.11 to $0.21
fred00205: calls $0.11
*** FLOP *** [7d Js Qs]
Nickh147: checks 
fred00205: checks 
*** TURN *** [7d Js Qs] [Td]
Nickh147: bets $0.20
fred00205: calls $0.20
*** RIVER *** [7d Js Qs Td] [Qc]
Nickh147: checks 
fred00205: bets $0.30
Nickh147: folds 
Uncalled bet ($0.30) returned to fred00205
fred00205 collected $0.78 from pot
fred00205: doesn't show hand 
*** SUMMARY ***
Total pot $0.82 | Rake $0.04 
Board [7d Js Qs Td Qc]
Seat 1: Nickh147 (small blind) folded on the River
Seat 2: fred00205 (big blind) collected ($0.78)
Seat 3: Smertobro folded before Flop (didn't bet)
Seat 4: SERG244 (button) folded before Flop (didn't bet)



PokerStars Hand #222952578874:  Hold'em No Limit ($0.05/$0.10 USD) - 2021/01/23 7:51:07 ET
Table 'Bohlinia III' 6-max Seat #1 is the button
Seat 1: Nickh147 ($10 in chips) 
Seat 2: fred00205 ($8.37 in chips) 
Seat 3: Smertobro ($10.28 in chips) 
Seat 4: SERG244 ($10 in chips) 
fred00205: posts small blind $0.05
Smertobro: posts big blind $0.10
Hop top 77: sits out 
ivan2772ms: sits out 
*** HOLE CARDS ***
SERG244: folds 
Nickh147: raises $0.11 to $0.21
fred00205: calls $0.16
Smertobro: raises $0.84 to $1.05
Nickh147: folds 
fred00205: folds 
Uncalled bet ($0.84) returned to Smertobro
Smertobro collected $0.63 from pot
Smertobro: doesn't show hand 
*** SUMMARY ***
Total pot $0.63 | Rake $0 
Seat 1: Nickh147 (button) folded before Flop
Seat 2: fred00205 (small blind) folded before Flop
Seat 3: Smertobro (big blind) collected ($0.63)
Seat 4: SERG244 folded before Flop (didn't bet)



PokerStars Hand #222952590207:  Hold'em No Limit ($0.05/$0.10 USD) - 2021/01/23 7:51:37 ET
Table 'Bohlinia III' 6-max Seat #2 is the button
Seat 1: Nickh147 ($10 in chips) 
Seat 2: fred00205 ($8.16 in chips) 
Seat 3: Smertobro ($10.70 in chips) 
Seat 4: SERG244 ($10 in chips) 
Smertobro: posts small blind $0.05
SERG244: posts big blind $0.10
Hop top 77: sits out 
ivan2772ms: sits out 
*** HOLE CARDS ***
Nickh147: raises $0.11 to $0.21
fred00205: folds 
Smertobro: folds 
SERG244: calls $0.11
*** FLOP *** [9d 4c 7s]
SERG244: checks 
Nickh147: bets $0.20
SERG244: raises $0.40 to $0.60
Nickh147: folds 
Uncalled bet ($0.40) returned to SERG244
SERG244 collected $0.83 from pot
SERG244: doesn't show hand 
*** SUMMARY ***
Total pot $0.87 | Rake $0.04 
Board [9d 4c 7s]
Seat 1: Nickh147 folded on the Flop
Seat 2: fred00205 (button) folded before Flop (didn't bet)
Seat 3: Smertobro (small blind) folded before Flop
Seat 4: SERG244 (big blind) collected ($0.83)



PokerStars Hand #222952602374:  Hold'em No Limit ($0.05/$0.10 USD) - 2021/01/23 7:52:08 ET
Table 'Bohlinia III' 6-max Seat #3 is the button
Seat 1: Nickh147 ($10 in chips) 
Seat 2: fred00205 ($8.16 in chips) 
Seat 3: Smertobro ($10.65 in chips) 
Seat 4: SERG244 ($10.42 in chips) 
Seat 5: Hop top 77 ($10 in chips) 
SERG244: posts small blind $0.05
Hop top 77: posts big blind $0.10
ivan2772ms: sits out 
*** HOLE CARDS ***
Nickh147: folds 
fred00205: folds 
Smertobro: folds 
SERG244: folds 
Uncalled bet ($0.05) returned to Hop top 77
Hop top 77 collected $0.10 from pot
Hop top 77: doesn't show hand 
*** SUMMARY ***
Total pot $0.10 | Rake $0 
Seat 1: Nickh147 folded before Flop (didn't bet)
Seat 2: fred00205 folded before Flop (didn't bet)
Seat 3: Smertobro (button) folded before Flop (didn't bet)
Seat 4: SERG244 (small blind) folded before Flop
Seat 5: Hop top 77 (big blind) collected ($0.10)



PokerStars Hand #222952605752:  Hold'em No Limit ($0.05/$0.10 USD) - 2021/01/23 7:52:17 ET
Table 'Bohlinia III' 6-max Seat #4 is the button
Seat 1: Nickh147 ($10 in chips) 
Seat 2: fred00205 ($8.16 in chips) 
Seat 3: Smertobro ($10.65 in chips) 
Seat 4: SERG244 ($10.37 in chips) 
Seat 5: Hop top 77 ($10.05 in chips) 
Seat 6: ivan2772ms ($10 in chips) 
Hop top 77: posts small blind $0.05
ivan2772ms: posts big blind $0.10
*** HOLE CARDS ***
Nickh147: folds 
fred00205: folds 
Smertobro: folds 
SERG244: raises $0.16 to $0.26
Hop top 77: raises $0.84 to $1.10
ivan2772ms: folds 
SERG244: folds 
Uncalled bet ($0.84) returned to Hop top 77
Hop top 77 collected $0.62 from pot
Hop top 77: doesn't show hand 
*** SUMMARY ***
Total pot $0.62 | Rake $0 
Seat 1: Nickh147 folded before Flop (didn't bet)
Seat 2: fred00205 folded before Flop (didn't bet)
Seat 3: Smertobro folded before Flop (didn't bet)
Seat 4: SERG244 (button) folded before Flop
Seat 5: Hop top 77 (small blind) collected ($0.62)
Seat 6: ivan2772ms (big blind) folded before Flop



PokerStars Hand #222952613008:  Hold'em No Limit ($0.05/$0.10 USD) - 2021/01/23 7:52:36 ET
Table 'Bohlinia III' 6-max Seat #5 is the button
Seat 1: Nickh147 ($10 in chips) 
Seat 2: fred00205 ($8.16 in chips) 
Seat 3: Smertobro ($10.65 in chips) 
Seat 4: SERG244 ($10.11 in chips) 
Seat 5: Hop top 77 ($10.41 in chips) 
Seat 6: ivan2772ms ($9.90 in chips) 
ivan2772ms: posts small blind $0.05
Nickh147: posts big blind $0.10
*** HOLE CARDS ***
fred00205: folds 
Smertobro: folds 
SERG244: folds 
Hop top 77: folds 
ivan2772ms: folds 
Uncalled bet ($0.05) returned to Nickh147
Nickh147 collected $0.10 from pot
Nickh147: doesn't show hand 
*** SUMMARY ***
Total pot $0.10 | Rake $0 
Seat 1: Nickh147 (big blind) collected ($0.10)
Seat 2: fred00205 folded before Flop (didn't bet)
Seat 3: Smertobro folded before Flop (didn't bet)
Seat 4: SERG244 folded before Flop (didn't bet)
Seat 5: Hop top 77 (button) folded before Flop (didn't bet)
Seat 6: ivan2772ms (small blind) folded before Flop



PokerStars Hand #222952616569:  Hold'em No Limit ($0.05/$0.10 USD) - 2021/01/23 7:52:45 ET
Table 'Bohlinia III' 6-max Seat #6 is the button
Seat 1: Nickh147 ($10.05 in chips) 
Seat 2: fred00205 ($8.16 in chips) 
Seat 3: Smertobro ($10.65 in chips) 
Seat 4: SERG244 ($10.11 in chips) 
Seat 5: Hop top 77 ($10.41 in chips) 
Seat 6: ivan2772ms ($9.85 in chips) 
Nickh147: posts small blind $0.05
fred00205: posts big blind $0.10
*** HOLE CARDS ***
Smertobro: folds 
SERG244: folds 
Hop top 77: raises $0.20 to $0.30
ivan2772ms: folds 
Nickh147: folds 
fred00205: calls $0.20
*** FLOP *** [Ac Kc 6s]
fred00205: checks 
Hop top 77: bets $0.20
fred00205: calls $0.20
*** TURN *** [Ac Kc 6s] [Td]
fred00205: checks 
Hop top 77: bets $0.32
fred00205: calls $0.32
*** RIVER *** [Ac Kc 6s Td] [Ts]
fred00205: checks 
Hop top 77: checks 
*** SHOW DOWN ***
fred00205: shows [Ad 7s] (two pair, Aces and Tens)
Hop top 77: shows [Jc Ah] (two pair, Aces and Tens)
fred00205 collected $0.81 from pot
Hop top 77 collected $0.80 from pot
*** SUMMARY ***
Total pot $1.69 | Rake $0.08 
Board [Ac Kc 6s Td Ts]
Seat 1: Nickh147 (small blind) folded before Flop
Seat 2: fred00205 (big blind) showed [Ad 7s] and won ($0.81) with two pair, Aces and Tens
Seat 3: Smertobro folded before Flop (didn't bet)
Seat 4: SERG244 folded before Flop (didn't bet)
Seat 5: Hop top 77 showed [Jc Ah] and won ($0.80) with two pair, Aces and Tens
Seat 6: ivan2772ms (button) folded before Flop (didn't bet)



PokerStars Hand #222952641395:  Hold'em No Limit ($0.05/$0.10 USD) - 2021/01/23 7:53:49 ET
Table 'Bohlinia III' 6-max Seat #1 is the button
Seat 1: Nickh147 ($10 in chips) 
Seat 2: fred00205 ($8.15 in chips) 
Seat 3: Smertobro ($10.65 in chips) 
Seat 4: SERG244 ($10.11 in chips) 
Seat 5: Hop top 77 ($10.39 in chips) 
Seat 6: ivan2772ms ($9.85 in chips) 
fred00205: posts small blind $0.05
Smertobro: posts big blind $0.10
*** HOLE CARDS ***
SERG244: folds 
Hop top 77: folds 
ivan2772ms: raises $0.20 to $0.30
Nickh147: folds 
fred00205: folds 
Smertobro: calls $0.20
*** FLOP *** [3s Tc 4h]
Smertobro: checks 
ivan2772ms: bets $0.47
Smertobro: calls $0.47
*** TURN *** [3s Tc 4h] [As]
Smertobro: checks 
ivan2772ms: bets $1.14
Smertobro: folds 
Uncalled bet ($1.14) returned to ivan2772ms
ivan2772ms collected $1.52 from pot
ivan2772ms: doesn't show hand 
*** SUMMARY ***
Total pot $1.59 | Rake $0.07 
Board [3s Tc 4h As]
Seat 1: Nickh147 (button) folded before Flop (didn't bet)
Seat 2: fred00205 (small blind) folded before Flop
Seat 3: Smertobro (big blind) folded on the Turn
Seat 4: SERG244 folded before Flop (didn't bet)
Seat 5: Hop top 77 folded before Flop (didn't bet)
Seat 6: ivan2772ms collected ($1.52)



PokerStars Hand #222952661197:  Hold'em No Limit ($0.05/$0.10 USD) - 2021/01/23 7:54:40 ET
Table 'Bohlinia III' 6-max Seat #2 is the button
Seat 1: Nickh147 ($10 in chips) 
Seat 2: fred00205 ($8.10 in chips) 
Seat 3: Smertobro ($10 in chips) 
Seat 5: Hop top 77 ($10.39 in chips) 
Seat 6: ivan2772ms ($10.60 in chips) 
Smertobro: posts small blind $0.05
SERG244: is sitting out 
Hop top 77: posts big blind $0.10
*** HOLE CARDS ***
ivan2772ms: folds 
Nickh147: folds 
fred00205: folds 
Smertobro: raises $0.15 to $0.25
Hop top 77: folds 
Uncalled bet ($0.15) returned to Smertobro
Smertobro collected $0.20 from pot
Smertobro: doesn't show hand 
*** SUMMARY ***
Total pot $0.20 | Rake $0 
Seat 1: Nickh147 folded before Flop (didn't bet)
Seat 2: fred00205 (button) folded before Flop (didn't bet)
Seat 3: Smertobro (small blind) collected ($0.20)
Seat 5: Hop top 77 (big blind) folded before Flop
Seat 6: ivan2772ms folded before Flop (didn't bet)



PokerStars Hand #222952665877:  Hold'em No Limit ($0.05/$0.10 USD) - 2021/01/23 7:54:52 ET
Table 'Bohlinia III' 6-max Seat #3 is the button
Seat 1: Nickh147 ($10 in chips) 
Seat 2: fred00205 ($8.10 in chips) 
Seat 3: Smertobro ($10.10 in chips) 
Seat 5: Hop top 77 ($10.29 in chips) 
Seat 6: ivan2772ms ($10.60 in chips) 
Hop top 77: posts small blind $0.05
ivan2772ms: posts big blind $0.10
*** HOLE CARDS ***
Nickh147: raises $0.11 to $0.21
fred00205: calls $0.21
Smertobro: folds 
Hop top 77: folds 
ivan2772ms: folds 
*** FLOP *** [8d Qd 4h]
Nickh147: bets $0.23
SERG244 leaves the table
fred00205: folds 
Uncalled bet ($0.23) returned to Nickh147
Nickh147 collected $0.54 from pot
Nickh147: doesn't show hand 
*** SUMMARY ***
Total pot $0.57 | Rake $0.03 
Board [8d Qd 4h]
Seat 1: Nickh147 collected ($0.54)
Seat 2: fred00205 folded on the Flop
Seat 3: Smertobro (button) folded before Flop (didn't bet)
Seat 5: Hop top 77 (small blind) folded before Flop
Seat 6: ivan2772ms (big blind) folded before Flop



PokerStars Hand #222952674489:  Hold'em No Limit ($0.05/$0.10 USD) - 2021/01/23 7:55:16 ET
Table 'Bohlinia III' 6-max Seat #5 is the button
Seat 1: Nickh147 ($10.33 in chips) 
Seat 2: fred00205 ($7.89 in chips) 
Seat 3: Smertobro ($10.10 in chips) 
Seat 5: Hop top 77 ($10.24 in chips) 
Seat 6: ivan2772ms ($10.50 in chips) 
ivan2772ms: posts small blind $0.05
Nickh147: posts big blind $0.10
*** HOLE CARDS ***
fred00205: folds 
Smertobro: folds 
luchom87 joins the table at seat #4 
Hop top 77: raises $0.15 to $0.25
ivan2772ms: folds 
Nickh147: raises $0.44 to $0.69
Hop top 77: calls $0.44
*** FLOP *** [Qs Ts Jc]
Nickh147: bets $0.70
Hop top 77: calls $0.70
*** TURN *** [Qs Ts Jc] [9s]
Nickh147: bets $1.13
Hop top 77: folds 
Uncalled bet ($1.13) returned to Nickh147
Nickh147 collected $2.70 from pot
Nickh147: doesn't show hand 
*** SUMMARY ***
Total pot $2.83 | Rake $0.13 
Board [Qs Ts Jc 9s]
Seat 1: Nickh147 (big blind) collected ($2.70)
Seat 2: fred00205 folded before Flop (didn't bet)
Seat 3: Smertobro folded before Flop (didn't bet)
Seat 5: Hop top 77 (button) folded on the Turn
Seat 6: ivan2772ms (small blind) folded before Flop



PokerStars Hand #222952690477:  Hold'em No Limit ($0.05/$0.10 USD) - 2021/01/23 7:56:05 ET
Table 'Bohlinia III' 6-max Seat #6 is the button
Seat 1: Nickh147 ($11.64 in chips) 
Seat 2: fred00205 ($7.89 in chips) 
Seat 3: Smertobro ($10.10 in chips) 
Seat 5: Hop top 77 ($10 in chips) 
Seat 6: ivan2772ms ($10.45 in chips) 
Nickh147: posts small blind $0.05
fred00205: posts big blind $0.10
luchom87: sits out 
*** HOLE CARDS ***
Smertobro: raises $0.20 to $0.30
Hop top 77: folds 
ivan2772ms: folds 
Nickh147: folds 
fred00205: calls $0.20
*** FLOP *** [5d 2h Qd]
fred00205: checks 
Smertobro: bets $0.41
fred00205: folds 
Uncalled bet ($0.41) returned to Smertobro
Smertobro collected $0.62 from pot
Smertobro: doesn't show hand 
*** SUMMARY ***
Total pot $0.65 | Rake $0.03 
Board [5d 2h Qd]
Seat 1: Nickh147 (small blind) folded before Flop
Seat 2: fred00205 (big blind) folded on the Flop
Seat 3: Smertobro collected ($0.62)
Seat 5: Hop top 77 folded before Flop (didn't bet)
Seat 6: ivan2772ms (button) folded before Flop (didn't bet)



PokerStars Hand #222952698942:  Hold'em No Limit ($0.05/$0.10 USD) - 2021/01/23 7:56:31 ET
Table 'Bohlinia III' 6-max Seat #1 is the button
Seat 1: Nickh147 ($11.59 in chips) 
Seat 2: fred00205 ($7.59 in chips) 
Seat 4: luchom87 ($10 in chips) 
Seat 5: Hop top 77 ($10 in chips) 
Seat 6: ivan2772ms ($10.45 in chips) 
fred00205: posts small blind $0.05
Smertobro: is sitting out 
luchom87: posts big blind $0.10
*** HOLE CARDS ***
Smertobro leaves the table
Hop top 77: raises $0.20 to $0.30
ivan2772ms: folds 
Nickh147: folds 
fred00205: folds 
kilativ7 joins the table at seat #3 
luchom87: calls $0.20
*** FLOP *** [9h 8s Td]
luchom87: checks 
Hop top 77: bets $0.20
luchom87: calls $0.20
*** TURN *** [9h 8s Td] [9s]
luchom87: checks 
Hop top 77: bets $0.50
luchom87: calls $0.50
*** RIVER *** [9h 8s Td 9s] [7h]
luchom87: checks 
Hop top 77: bets $1.29
luchom87: raises $2.61 to $3.90
Hop top 77: folds 
Uncalled bet ($2.61) returned to luchom87
luchom87 collected $4.42 from pot
luchom87: doesn't show hand 
*** SUMMARY ***
Total pot $4.63 | Rake $0.21 
Board [9h 8s Td 9s 7h]
Seat 1: Nickh147 (button) folded before Flop (didn't bet)
Seat 2: fred00205 (small blind) folded before Flop
Seat 4: luchom87 (big blind) collected ($4.42)
Seat 5: Hop top 77 folded on the River
Seat 6: ivan2772ms folded before Flop (didn't bet)



PokerStars Hand #222952735294:  Hold'em No Limit ($0.05/$0.10 USD) - 2021/01/23 7:58:22 ET
Table 'Bohlinia III' 6-max Seat #2 is the button
Seat 1: Nickh147 ($11.59 in chips) 
Seat 2: fred00205 ($7.54 in chips) 
Seat 4: luchom87 ($12.13 in chips) 
Seat 5: Hop top 77 ($10 in chips) 
Seat 6: ivan2772ms ($10.45 in chips) 
luchom87: posts small blind $0.05
Hop top 77: posts big blind $0.10
*** HOLE CARDS ***
ivan2772ms: folds 
Nickh147: folds 
fred00205: calls $0.10
luchom87: calls $0.05
Hop top 77: checks 
*** FLOP *** [4h 2s 9s]
luchom87: checks 
Hop top 77: bets $0.19
fred00205: calls $0.19
luchom87: calls $0.19
*** TURN *** [4h 2s 9s] [9c]
luchom87: checks 
Hop top 77: checks 
fred00205: checks 
*** RIVER *** [4h 2s 9s 9c] [Kh]
luchom87: checks 
Hop top 77: bets $2.60
fred00205: calls $2.60
luchom87: folds 
*** SHOW DOWN ***
Hop top 77: shows [4c 9d] (a full house, Nines full of Fours)
fred00205: mucks hand 
Hop top 77 collected $5.80 from pot
*** SUMMARY ***
Total pot $6.07 | Rake $0.27 
Board [4h 2s 9s 9c Kh]
Seat 1: Nickh147 folded before Flop (didn't bet)
Seat 2: fred00205 (button) mucked
Seat 4: luchom87 (small blind) folded on the River
Seat 5: Hop top 77 (big blind) showed [4c 9d] and won ($5.80) with a full house, Nines full of Fours
Seat 6: ivan2772ms folded before Flop (didn't bet)



PokerStars Hand #222952762018:  Hold'em No Limit ($0.05/$0.10 USD) - 2021/01/23 7:59:44 ET
Table 'Bohlinia III' 6-max Seat #4 is the button
Seat 1: Nickh147 ($11.59 in chips) 
Seat 2: fred00205 ($4.65 in chips) 
Seat 4: luchom87 ($11.84 in chips) 
Seat 5: Hop top 77 ($12.91 in chips) 
Seat 6: ivan2772ms ($10.45 in chips) 
Hop top 77: posts small blind $0.05
ivan2772ms: posts big blind $0.10
kilativ7: sits out 
*** HOLE CARDS ***
Nickh147: raises $0.14 to $0.24
fred00205: folds 
luchom87: folds 
Hop top 77: folds 
ivan2772ms: calls $0.14
*** FLOP *** [2c 6c 7c]
ivan2772ms: checks 
Nickh147: bets $0.25
ivan2772ms: raises $0.50 to $0.75
Nickh147: folds 
Uncalled bet ($0.50) returned to ivan2772ms
ivan2772ms collected $0.98 from pot
ivan2772ms: doesn't show hand 
*** SUMMARY ***
Total pot $1.03 | Rake $0.05 
Board [2c 6c 7c]
Seat 1: Nickh147 folded on the Flop
Seat 2: fred00205 folded before Flop (didn't bet)
Seat 4: luchom87 (button) folded before Flop (didn't bet)
Seat 5: Hop top 77 (small blind) folded before Flop
Seat 6: ivan2772ms (big blind) collected ($0.98)



PokerStars Hand #222952780034:  Hold'em No Limit ($0.05/$0.10 USD) - 2021/01/23 8:00:37 ET
Table 'Bohlinia III' 6-max Seat #5 is the button
Seat 1: Nickh147 ($11.10 in chips) 
Seat 2: fred00205 ($4.65 in chips) 
Seat 4: luchom87 ($11.84 in chips) 
Seat 5: Hop top 77 ($12.86 in chips) 
Seat 6: ivan2772ms ($10.94 in chips) 
ivan2772ms: posts small blind $0.05
Nickh147: posts big blind $0.10
kilativ7: sits out 
*** HOLE CARDS ***
fred00205: folds 
luchom87: folds 
Hop top 77: raises $0.15 to $0.25
ivan2772ms: raises $0.65 to $0.90
Nickh147: calls $0.80
Hop top 77: calls $0.65
*** FLOP *** [Qc 5c 5h]
ivan2772ms: checks 
Nickh147: checks 
Hop top 77: checks 
*** TURN *** [Qc 5c 5h] [Ac]
ivan2772ms: checks 
Nickh147: checks 
Hop top 77: checks 
*** RIVER *** [Qc 5c 5h Ac] [5s]
ivan2772ms: checks 
Nickh147: bets $0.62
Hop top 77: folds 
ivan2772ms: calls $0.62
*** SHOW DOWN ***
Nickh147: shows [Tc Td] (a full house, Fives full of Tens)
ivan2772ms: shows [Kd Qs] (a full house, Fives full of Queens)
ivan2772ms collected $3.76 from pot
*** SUMMARY ***
Total pot $3.94 | Rake $0.18 
Board [Qc 5c 5h Ac 5s]
Seat 1: Nickh147 (big blind) showed [Tc Td] and lost with a full house, Fives full of Tens
Seat 2: fred00205 folded before Flop (didn't bet)
Seat 4: luchom87 folded before Flop (didn't bet)
Seat 5: Hop top 77 (button) folded on the River
Seat 6: ivan2772ms (small blind) showed [Kd Qs] and won ($3.76) with a full house, Fives full of Queens



PokerStars Hand #222952807757:  Hold'em No Limit ($0.05/$0.10 USD) - 2021/01/23 8:01:52 ET
Table 'Bohlinia III' 6-max Seat #6 is the button
Seat 1: Nickh147 ($10 in chips) 
Seat 2: fred00205 ($4.65 in chips) 
Seat 4: luchom87 ($11.84 in chips) 
Seat 5: Hop top 77 ($11.96 in chips) 
Seat 6: ivan2772ms ($13.18 in chips) 
Nickh147: posts small blind $0.05
fred00205: posts big blind $0.10
kilativ7: sits out 
*** HOLE CARDS ***
luchom87: folds 
Hop top 77: raises $0.20 to $0.30
ivan2772ms: folds 
Nickh147: folds 
fred00205: calls $0.20
*** FLOP *** [3s Td Ah]
fred00205: checks 
Hop top 77: checks 
*** TURN *** [3s Td Ah] [Qh]
fred00205: checks 
Hop top 77: bets $0.31
fred00205: folds 
Uncalled bet ($0.31) returned to Hop top 77
Hop top 77 collected $0.62 from pot
Hop top 77: doesn't show hand 
*** SUMMARY ***
Total pot $0.65 | Rake $0.03 
Board [3s Td Ah Qh]
Seat 1: Nickh147 (small blind) folded before Flop
Seat 2: fred00205 (big blind) folded on the Turn
Seat 4: luchom87 folded before Flop (didn't bet)
Seat 5: Hop top 77 collected ($0.62)
Seat 6: ivan2772ms (button) folded before Flop (didn't bet)



PokerStars Hand #222952826649:  Hold'em No Limit ($0.05/$0.10 USD) - 2021/01/23 8:02:28 ET
Table 'Bohlinia III' 6-max Seat #1 is the button
Seat 1: Nickh147 ($10 in chips) 
Seat 2: fred00205 ($4.35 in chips) 
Seat 3: kilativ7 ($10 in chips) 
Seat 4: luchom87 ($11.84 in chips) 
Seat 5: Hop top 77 ($12.28 in chips) 
Seat 6: ivan2772ms ($13.18 in chips) 
fred00205: posts small blind $0.05
kilativ7: posts big blind $0.10
*** HOLE CARDS ***
luchom87: folds 
Hop top 77: folds 
ivan2772ms: raises $0.20 to $0.30
Nickh147: folds 
fred00205: folds 
kilativ7: folds 
Uncalled bet ($0.20) returned to ivan2772ms
ivan2772ms collected $0.25 from pot
ivan2772ms: doesn't show hand 
*** SUMMARY ***
Total pot $0.25 | Rake $0 
Seat 1: Nickh147 (button) folded before Flop (didn't bet)
Seat 2: fred00205 (small blind) folded before Flop
Seat 3: kilativ7 (big blind) folded before Flop
Seat 4: luchom87 folded before Flop (didn't bet)
Seat 5: Hop top 77 folded before Flop (didn't bet)
Seat 6: ivan2772ms collected ($0.25)



PokerStars Hand #222952831543:  Hold'em No Limit ($0.05/$0.10 USD) - 2021/01/23 8:02:41 ET
Table 'Bohlinia III' 6-max Seat #2 is the button
Seat 1: Nickh147 ($10 in chips) 
Seat 2: fred00205 ($4.30 in chips) 
Seat 3: kilativ7 ($10 in chips) 
Seat 4: luchom87 ($11.84 in chips) 
Seat 5: Hop top 77 ($12.28 in chips) 
Seat 6: ivan2772ms ($13.33 in chips) 
kilativ7: posts small blind $0.05
luchom87: posts big blind $0.10
*** HOLE CARDS ***
Hop top 77: folds 
ivan2772ms: raises $0.20 to $0.30
Nickh147: raises $0.42 to $0.72
fred00205: folds 
kilativ7: folds 
luchom87: raises $1.98 to $2.70
ivan2772ms: folds 
Nickh147: folds 
Uncalled bet ($1.98) returned to luchom87
luchom87 collected $1.79 from pot
luchom87: doesn't show hand 
*** SUMMARY ***
Total pot $1.79 | Rake $0 
Seat 1: Nickh147 folded before Flop
Seat 2: fred00205 (button) folded before Flop (didn't bet)
Seat 3: kilativ7 (small blind) folded before Flop
Seat 4: luchom87 (big blind) collected ($1.79)
Seat 5: Hop top 77 folded before Flop (didn't bet)
Seat 6: ivan2772ms folded before Flop



PokerStars Hand #222952848878:  Hold'em No Limit ($0.05/$0.10 USD) - 2021/01/23 8:03:24 ET
Table 'Bohlinia III' 6-max Seat #3 is the button
Seat 1: Nickh147 ($10 in chips) 
Seat 2: fred00205 ($4.30 in chips) 
Seat 3: kilativ7 ($10 in chips) 
Seat 4: luchom87 ($12.91 in chips) 
Seat 5: Hop top 77 ($12.28 in chips) 
Seat 6: ivan2772ms ($13.03 in chips) 
luchom87: posts small blind $0.05
Hop top 77: posts big blind $0.10
*** HOLE CARDS ***
ivan2772ms: folds 
Nickh147: folds 
fred00205: calls $0.10
kilativ7: folds 
luchom87: folds 
Hop top 77: checks 
*** FLOP *** [9s 8d 4s]
Hop top 77: checks 
fred00205: checks 
*** TURN *** [9s 8d 4s] [9h]
Hop top 77: checks 
fred00205: checks 
*** RIVER *** [9s 8d 4s 9h] [9c]
Hop top 77: checks 
fred00205: checks 
*** SHOW DOWN ***
Hop top 77: shows [5d Ad] (three of a kind, Nines)
fred00205: mucks hand 
Hop top 77 collected $0.24 from pot
*** SUMMARY ***
Total pot $0.25 | Rake $0.01 
Board [9s 8d 4s 9h 9c]
Seat 1: Nickh147 folded before Flop (didn't bet)
Seat 2: fred00205 mucked
Seat 3: kilativ7 (button) folded before Flop (didn't bet)
Seat 4: luchom87 (small blind) folded before Flop
Seat 5: Hop top 77 (big blind) showed [5d Ad] and won ($0.24) with three of a kind, Nines
Seat 6: ivan2772ms folded before Flop (didn't bet)



PokerStars Hand #222952864255:  Hold'em No Limit ($0.05/$0.10 USD) - 2021/01/23 8:04:03 ET
Table 'Bohlinia III' 6-max Seat #4 is the button
Seat 1: Nickh147 ($10 in chips) 
Seat 2: fred00205 ($4.20 in chips) 
Seat 3: kilativ7 ($10 in chips) 
Seat 4: luchom87 ($12.86 in chips) 
Seat 5: Hop top 77 ($12.42 in chips) 
Seat 6: ivan2772ms ($13.03 in chips) 
Hop top 77: posts small blind $0.05
ivan2772ms: posts big blind $0.10
*** HOLE CARDS ***
Nickh147: folds 
fred00205: calls $0.10
kilativ7: folds 
luchom87: folds 
Hop top 77: folds 
ivan2772ms: checks 
*** FLOP *** [Qd 4h 8d]
ivan2772ms: checks 
fred00205: checks 
*** TURN *** [Qd 4h 8d] [2c]
ivan2772ms: bets $0.10
fred00205: calls $0.10
*** RIVER *** [Qd 4h 8d 2c] [9s]
ivan2772ms: bets $0.10
fred00205: calls $0.10
*** SHOW DOWN ***
ivan2772ms: shows [4s Ad] (a pair of Fours)
fred00205: shows [9d Jd] (a pair of Nines)
fred00205 collected $0.62 from pot
*** SUMMARY ***
Total pot $0.65 | Rake $0.03 
Board [Qd 4h 8d 2c 9s]
Seat 1: Nickh147 folded before Flop (didn't bet)
Seat 2: fred00205 showed [9d Jd] and won ($0.62) with a pair of Nines
Seat 3: kilativ7 folded before Flop (didn't bet)
Seat 4: luchom87 (button) folded before Flop (didn't bet)
Seat 5: Hop top 77 (small blind) folded before Flop
Seat 6: ivan2772ms (big blind) showed [4s Ad] and lost with a pair of Fours



PokerStars Hand #222952881816:  Hold'em No Limit ($0.05/$0.10 USD) - 2021/01/23 8:04:47 ET
Table 'Bohlinia III' 6-max Seat #5 is the button
Seat 1: Nickh147 ($10 in chips) 
Seat 2: fred00205 ($4.52 in chips) 
Seat 3: kilativ7 ($10 in chips) 
Seat 4: luchom87 ($12.86 in chips) 
Seat 5: Hop top 77 ($12.37 in chips) 
Seat 6: ivan2772ms ($12.73 in chips) 
ivan2772ms: posts small blind $0.05
Nickh147: posts big blind $0.10
*** HOLE CARDS ***
fred00205: folds 
kilativ7: folds 
luchom87: folds 
Hop top 77: folds 
ivan2772ms: folds 
Uncalled bet ($0.05) returned to Nickh147
Nickh147 collected $0.10 from pot
Nickh147: doesn't show hand 
*** SUMMARY ***
Total pot $0.10 | Rake $0 
Seat 1: Nickh147 (big blind) collected ($0.10)
Seat 2: fred00205 folded before Flop (didn't bet)
Seat 3: kilativ7 folded before Flop (didn't bet)
Seat 4: luchom87 folded before Flop (didn't bet)
Seat 5: Hop top 77 (button) folded before Flop (didn't bet)
Seat 6: ivan2772ms (small blind) folded before Flop



PokerStars Hand #222952886010:  Hold'em No Limit ($0.05/$0.10 USD) - 2021/01/23 8:04:57 ET
Table 'Bohlinia III' 6-max Seat #6 is the button
Seat 1: Nickh147 ($10.05 in chips) 
Seat 2: fred00205 ($4.52 in chips) 
Seat 3: kilativ7 ($10 in chips) 
Seat 4: luchom87 ($12.86 in chips) 
Seat 5: Hop top 77 ($12.37 in chips) 
Seat 6: ivan2772ms ($12.68 in chips) 
Nickh147: posts small blind $0.05
fred00205: posts big blind $0.10
*** HOLE CARDS ***
kilativ7: folds 
luchom87 has timed out
luchom87: folds 
Hop top 77: folds 
ivan2772ms: folds 
Nickh147: raises $0.11 to $0.21
fred00205: calls $0.11
*** FLOP *** [Js Ts 3s]
Nickh147: checks 
fred00205: checks 
*** TURN *** [Js Ts 3s] [Ks]
Nickh147: bets $0.10
fred00205: calls $0.10
*** RIVER *** [Js Ts 3s Ks] [Kh]
Nickh147: bets $0.25
fred00205: calls $0.25
*** SHOW DOWN ***
Nickh147: shows [9s Ad] (a flush, King high)
fred00205: mucks hand 
Nickh147 collected $1.07 from pot
*** SUMMARY ***
Total pot $1.12 | Rake $0.05 
Board [Js Ts 3s Ks Kh]
Seat 1: Nickh147 (small blind) showed [9s Ad] and won ($1.07) with a flush, King high
Seat 2: fred00205 (big blind) mucked
Seat 3: kilativ7 folded before Flop (didn't bet)
Seat 4: luchom87 folded before Flop (didn't bet)
Seat 5: Hop top 77 folded before Flop (didn't bet)
Seat 6: ivan2772ms (button) folded before Flop (didn't bet)



PokerStars Hand #222952909153:  Hold'em No Limit ($0.05/$0.10 USD) - 2021/01/23 8:05:54 ET
Table 'Bohlinia III' 6-max Seat #1 is the button
Seat 1: Nickh147 ($10.56 in chips) 
Seat 2: fred00205 ($3.96 in chips) 
Seat 3: kilativ7 ($10 in chips) 
Seat 4: luchom87 ($12.86 in chips) 
Seat 5: Hop top 77 ($12.37 in chips) 
Seat 6: ivan2772ms ($12.68 in chips) 
fred00205: posts small blind $0.05
kilativ7: posts big blind $0.10
*** HOLE CARDS ***
luchom87: raises $0.20 to $0.30
Hop top 77: raises $0.63 to $0.93
ivan2772ms: folds 
Nickh147: folds 
fred00205: folds 
kilativ7: folds 
luchom87: calls $0.63
*** FLOP *** [8h 2h Jh]
luchom87: checks 
Hop top 77: bets $0.96
luchom87: folds 
Uncalled bet ($0.96) returned to Hop top 77
Hop top 77 collected $1.92 from pot
Hop top 77: doesn't show hand 
*** SUMMARY ***
Total pot $2.01 | Rake $0.09 
Board [8h 2h Jh]
Seat 1: Nickh147 (button) folded before Flop (didn't bet)
Seat 2: fred00205 (small blind) folded before Flop
Seat 3: kilativ7 (big blind) folded before Flop
Seat 4: luchom87 folded on the Flop
Seat 5: Hop top 77 collected ($1.92)
Seat 6: ivan2772ms folded before Flop (didn't bet)



PokerStars Hand #222952929853:  Hold'em No Limit ($0.05/$0.10 USD) - 2021/01/23 8:06:46 ET
Table 'Bohlinia III' 6-max Seat #2 is the button
Seat 1: Nickh147 ($10.56 in chips) 
Seat 2: fred00205 ($3.91 in chips) 
Seat 3: kilativ7 ($10 in chips) 
Seat 4: luchom87 ($11.93 in chips) 
Seat 5: Hop top 77 ($13.36 in chips) 
Seat 6: ivan2772ms ($12.68 in chips) 
kilativ7: posts small blind $0.05
luchom87: posts big blind $0.10
*** HOLE CARDS ***
Hop top 77: folds 
ivan2772ms: folds 
Nickh147: folds 
fred00205: folds 
kilativ7: raises $0.15 to $0.25
luchom87: calls $0.15
*** FLOP *** [7c 5h Jd]
kilativ7: checks 
luchom87: checks 
*** TURN *** [7c 5h Jd] [Kd]
kilativ7: checks 
luchom87: checks 
*** RIVER *** [7c 5h Jd Kd] [Jh]
kilativ7: checks 
luchom87: checks 
*** SHOW DOWN ***
kilativ7: shows [Qh 7h] (two pair, Jacks and Sevens)
luchom87: mucks hand 
kilativ7 collected $0.48 from pot
*** SUMMARY ***
Total pot $0.50 | Rake $0.02 
Board [7c 5h Jd Kd Jh]
Seat 1: Nickh147 folded before Flop (didn't bet)
Seat 2: fred00205 (button) folded before Flop (didn't bet)
Seat 3: kilativ7 (small blind) showed [Qh 7h] and won ($0.48) with two pair, Jacks and Sevens
Seat 4: luchom87 (big blind) mucked
Seat 5: Hop top 77 folded before Flop (didn't bet)
Seat 6: ivan2772ms folded before Flop (didn't bet)



PokerStars Hand #222952948018:  Hold'em No Limit ($0.05/$0.10 USD) - 2021/01/23 8:07:31 ET
Table 'Bohlinia III' 6-max Seat #3 is the button
Seat 1: Nickh147 ($10.56 in chips) 
Seat 2: fred00205 ($3.91 in chips) 
Seat 3: kilativ7 ($10.23 in chips) 
Seat 4: luchom87 ($11.68 in chips) 
Seat 5: Hop top 77 ($13.36 in chips) 
Seat 6: ivan2772ms ($12.68 in chips) 
luchom87: posts small blind $0.05
Hop top 77: posts big blind $0.10
*** HOLE CARDS ***
ivan2772ms: folds 
Nickh147: folds 
fred00205: calls $0.10
kilativ7: calls $0.10
luchom87: folds 
Hop top 77: checks 
*** FLOP *** [Jc 8c Ah]
Hop top 77: checks 
fred00205: checks 
kilativ7: checks 
*** TURN *** [Jc 8c Ah] [Kh]
Hop top 77: checks 
fred00205: checks 
kilativ7: checks 
*** RIVER *** [Jc 8c Ah Kh] [5h]
Hop top 77: checks 
fred00205: checks 
kilativ7: checks 
*** SHOW DOWN ***
Hop top 77: shows [Qd 3c] (high card Ace)
fred00205: shows [5d 4d] (a pair of Fives)
kilativ7: shows [Qc Jh] (a pair of Jacks)
kilativ7 collected $0.33 from pot
*** SUMMARY ***
Total pot $0.35 | Rake $0.02 
Board [Jc 8c Ah Kh 5h]
Seat 1: Nickh147 folded before Flop (didn't bet)
Seat 2: fred00205 showed [5d 4d] and lost with a pair of Fives
Seat 3: kilativ7 (button) showed [Qc Jh] and won ($0.33) with a pair of Jacks
Seat 4: luchom87 (small blind) folded before Flop
Seat 5: Hop top 77 (big blind) showed [Qd 3c] and lost with high card Ace
Seat 6: ivan2772ms folded before Flop (didn't bet)



PokerStars Hand #222952966125:  Hold'em No Limit ($0.05/$0.10 USD) - 2021/01/23 8:08:15 ET
Table 'Bohlinia III' 6-max Seat #4 is the button
Seat 1: Nickh147 ($10.56 in chips) 
Seat 2: fred00205 ($3.81 in chips) 
Seat 3: kilativ7 ($10.46 in chips) 
Seat 4: luchom87 ($11.63 in chips) 
Seat 5: Hop top 77 ($13.26 in chips) 
Hop top 77: posts small blind $0.05
Nickh147: posts big blind $0.10
*** HOLE CARDS ***
fred00205: folds 
kilativ7: folds 
luchom87: folds 
Hop top 77: raises $0.20 to $0.30
Nickh147: folds 
Uncalled bet ($0.20) returned to Hop top 77
Hop top 77 collected $0.20 from pot
Hop top 77: doesn't show hand 
*** SUMMARY ***
Total pot $0.20 | Rake $0 
Seat 1: Nickh147 (big blind) folded before Flop
Seat 2: fred00205 folded before Flop (didn't bet)
Seat 3: kilativ7 folded before Flop (didn't bet)
Seat 4: luchom87 (button) folded before Flop (didn't bet)
Seat 5: Hop top 77 (small blind) collected ($0.20)



PokerStars Hand #222952974157:  Hold'em No Limit ($0.05/$0.10 USD) - 2021/01/23 8:08:35 ET
Table 'Bohlinia III' 6-max Seat #5 is the button
Seat 1: Nickh147 ($10.46 in chips) 
Seat 2: fred00205 ($3.81 in chips) 
Seat 3: kilativ7 ($10.46 in chips) 
Seat 4: luchom87 ($11.63 in chips) 
Seat 5: Hop top 77 ($13.36 in chips) 
Nickh147: posts small blind $0.05
fred00205: posts big blind $0.10
*** HOLE CARDS ***
kilativ7: folds 
luchom87: folds 
Hop top 77: raises $0.15 to $0.25
Nickh147: folds 
fred00205: calls $0.15
*** FLOP *** [8d 2h Td]
fred00205: checks 
Hop top 77: bets $0.35
fred00205: folds 
Uncalled bet ($0.35) returned to Hop top 77
Hop top 77 collected $0.53 from pot
Hop top 77: doesn't show hand 
*** SUMMARY ***
Total pot $0.55 | Rake $0.02 
Board [8d 2h Td]
Seat 1: Nickh147 (small blind) folded before Flop
Seat 2: fred00205 (big blind) folded on the Flop
Seat 3: kilativ7 folded before Flop (didn't bet)
Seat 4: luchom87 folded before Flop (didn't bet)
Seat 5: Hop top 77 (button) collected ($0.53)



PokerStars Hand #222952996676:  Hold'em No Limit ($0.05/$0.10 USD) - 2021/01/23 8:09:30 ET
Table 'Bohlinia III' 6-max Seat #1 is the button
Seat 1: Nickh147 ($10.41 in chips) 
Seat 2: fred00205 ($3.56 in chips) 
Seat 3: kilativ7 ($10.46 in chips) 
Seat 4: luchom87 ($11.63 in chips) 
Seat 5: Hop top 77 ($13.64 in chips) 
fred00205: posts small blind $0.05
kilativ7: posts big blind $0.10
*** HOLE CARDS ***
luchom87: folds 
Hop top 77: folds 
Nickh147: raises $0.11 to $0.21
fred00205: folds 
kilativ7: folds 
Uncalled bet ($0.11) returned to Nickh147
Nickh147 collected $0.25 from pot
Nickh147: doesn't show hand 
*** SUMMARY ***
Total pot $0.25 | Rake $0 
Seat 1: Nickh147 (button) collected ($0.25)
Seat 2: fred00205 (small blind) folded before Flop
Seat 3: kilativ7 (big blind) folded before Flop
Seat 4: luchom87 folded before Flop (didn't bet)
Seat 5: Hop top 77 folded before Flop (didn't bet)



PokerStars Hand #222953001623:  Hold'em No Limit ($0.05/$0.10 USD) - 2021/01/23 8:09:42 ET
Table 'Bohlinia III' 6-max Seat #2 is the button
Seat 1: Nickh147 ($10.56 in chips) 
Seat 2: fred00205 ($3.51 in chips) 
Seat 3: kilativ7 ($10.36 in chips) 
Seat 4: luchom87 ($11.63 in chips) 
Seat 5: Hop top 77 ($13.64 in chips) 
kilativ7: posts small blind $0.05
luchom87: posts big blind $0.10
*** HOLE CARDS ***
Hop top 77: folds 
Nickh147: folds 
fred00205: calls $0.10
kilativ7: folds 
luchom87: checks 
*** FLOP *** [4d 3d Jd]
luchom87: checks 
fred00205: bets $0.30
luchom87: folds 
Uncalled bet ($0.30) returned to fred00205
fred00205 collected $0.24 from pot
fred00205: doesn't show hand 
*** SUMMARY ***
Total pot $0.25 | Rake $0.01 
Board [4d 3d Jd]
Seat 1: Nickh147 folded before Flop (didn't bet)
Seat 2: fred00205 (button) collected ($0.24)
Seat 3: kilativ7 (small blind) folded before Flop
Seat 4: luchom87 (big blind) folded on the Flop
Seat 5: Hop top 77 folded before Flop (didn't bet)



PokerStars Hand #222953015509:  Hold'em No Limit ($0.05/$0.10 USD) - 2021/01/23 8:10:16 ET
Table 'Bohlinia III' 6-max Seat #3 is the button
Seat 1: Nickh147 ($10.56 in chips) 
Seat 2: fred00205 ($3.65 in chips) 
Seat 3: kilativ7 ($10.31 in chips) 
Seat 4: luchom87 ($11.53 in chips) 
Seat 5: Hop top 77 ($13.64 in chips) 
luchom87: posts small blind $0.05
Hop top 77: posts big blind $0.10
*** HOLE CARDS ***
Nickh147: folds 
fred00205: folds 
kilativ7: folds 
luchom87: folds 
Uncalled bet ($0.05) returned to Hop top 77
Hop top 77 collected $0.10 from pot
Hop top 77: doesn't show hand 
*** SUMMARY ***
Total pot $0.10 | Rake $0 
Seat 1: Nickh147 folded before Flop (didn't bet)
Seat 2: fred00205 folded before Flop (didn't bet)
Seat 3: kilativ7 (button) folded before Flop (didn't bet)
Seat 4: luchom87 (small blind) folded before Flop
Seat 5: Hop top 77 (big blind) collected ($0.10)



PokerStars Hand #222953019737:  Hold'em No Limit ($0.05/$0.10 USD) - 2021/01/23 8:10:26 ET
Table 'Bohlinia III' 6-max Seat #4 is the button
Seat 1: Nickh147 ($10.56 in chips) 
Seat 2: fred00205 ($3.65 in chips) 
Seat 3: kilativ7 ($10.31 in chips) 
Seat 4: luchom87 ($11.48 in chips) 
Seat 5: Hop top 77 ($13.69 in chips) 
Hop top 77: posts small blind $0.05
Nickh147: posts big blind $0.10
*** HOLE CARDS ***
fred00205: folds 
kilativ7: raises $0.15 to $0.25
luchom87: folds 
Hop top 77: calls $0.20
Nickh147: folds 
*** FLOP *** [6d 9s 8c]
Hop top 77: checks 
kilativ7: bets $0.31
Hop top 77: calls $0.31
*** TURN *** [6d 9s 8c] [Qd]
Hop top 77: checks 
kilativ7: checks 
*** RIVER *** [6d 9s 8c Qd] [2d]
Hop top 77: checks 
kilativ7: checks 
*** SHOW DOWN ***
Hop top 77: shows [Ah 7h] (high card Ace)
kilativ7: shows [As Tc] (high card Ace - Queen+Ten kicker)
kilativ7 collected $1.17 from pot
*** SUMMARY ***
Total pot $1.22 | Rake $0.05 
Board [6d 9s 8c Qd 2d]
Seat 1: Nickh147 (big blind) folded before Flop
Seat 2: fred00205 folded before Flop (didn't bet)
Seat 3: kilativ7 showed [As Tc] and won ($1.17) with high card Ace
Seat 4: luchom87 (button) folded before Flop (didn't bet)
Seat 5: Hop top 77 (small blind) showed [Ah 7h] and lost with high card Ace



PokerStars Hand #222953038486:  Hold'em No Limit ($0.05/$0.10 USD) - 2021/01/23 8:11:13 ET
Table 'Bohlinia III' 6-max Seat #5 is the button
Seat 1: Nickh147 ($10.46 in chips) 
Seat 2: fred00205 ($3.65 in chips) 
Seat 3: kilativ7 ($10.92 in chips) 
Seat 4: luchom87 ($11.48 in chips) 
Seat 5: Hop top 77 ($13.13 in chips) 
Nickh147: posts small blind $0.05
fred00205: posts big blind $0.10
*** HOLE CARDS ***
kilativ7: folds 
luchom87: folds 
Hop top 77: folds 
Nickh147: raises $0.11 to $0.21
fred00205: calls $0.11
*** FLOP *** [Ks As 5h]
Nickh147: bets $0.17
fred00205: folds 
Uncalled bet ($0.17) returned to Nickh147
Nickh147 collected $0.40 from pot
Nickh147: doesn't show hand 
*** SUMMARY ***
Total pot $0.42 | Rake $0.02 
Board [Ks As 5h]
Seat 1: Nickh147 (small blind) collected ($0.40)
Seat 2: fred00205 (big blind) folded on the Flop
Seat 3: kilativ7 folded before Flop (didn't bet)
Seat 4: luchom87 folded before Flop (didn't bet)
Seat 5: Hop top 77 (button) folded before Flop (didn't bet)



PokerStars Hand #222953048283:  Hold'em No Limit ($0.05/$0.10 USD) - 2021/01/23 8:11:37 ET
Table 'Bohlinia III' 6-max Seat #1 is the button
Seat 1: Nickh147 ($10.65 in chips) 
Seat 2: fred00205 ($3.44 in chips) 
Seat 3: kilativ7 ($10.92 in chips) 
Seat 4: luchom87 ($11.48 in chips) 
Seat 5: Hop top 77 ($13.13 in chips) 
fred00205: posts small blind $0.05
kilativ7: posts big blind $0.10
*** HOLE CARDS ***
luchom87: raises $0.20 to $0.30
Hop top 77: folds 
Nickh147: folds 
fred00205: folds 
kilativ7: folds 
Uncalled bet ($0.20) returned to luchom87
luchom87 collected $0.25 from pot
luchom87: doesn't show hand 
*** SUMMARY ***
Total pot $0.25 | Rake $0 
Seat 1: Nickh147 (button) folded before Flop (didn't bet)
Seat 2: fred00205 (small blind) folded before Flop
Seat 3: kilativ7 (big blind) folded before Flop
Seat 4: luchom87 collected ($0.25)
Seat 5: Hop top 77 folded before Flop (didn't bet)



PokerStars Hand #222953053166:  Hold'em No Limit ($0.05/$0.10 USD) - 2021/01/23 8:11:49 ET
Table 'Bohlinia III' 6-max Seat #2 is the button
Seat 1: Nickh147 ($10.65 in chips) 
Seat 2: fred00205 ($3.39 in chips) 
Seat 3: kilativ7 ($10.82 in chips) 
Seat 4: luchom87 ($11.63 in chips) 
Seat 5: Hop top 77 ($13.13 in chips) 
kilativ7: posts small blind $0.05
luchom87: posts big blind $0.10
*** HOLE CARDS ***
Hop top 77: raises $0.20 to $0.30
Nickh147: folds 
fred00205: folds 
kilativ7: folds 
luchom87: folds 
Uncalled bet ($0.20) returned to Hop top 77
Hop top 77 collected $0.25 from pot
Hop top 77: doesn't show hand 
*** SUMMARY ***
Total pot $0.25 | Rake $0 
Seat 1: Nickh147 folded before Flop (didn't bet)
Seat 2: fred00205 (button) folded before Flop (didn't bet)
Seat 3: kilativ7 (small blind) folded before Flop
Seat 4: luchom87 (big blind) folded before Flop
Seat 5: Hop top 77 collected ($0.25)



PokerStars Hand #222953059408:  Hold'em No Limit ($0.05/$0.10 USD) - 2021/01/23 8:12:04 ET
Table 'Bohlinia III' 6-max Seat #3 is the button
Seat 1: Nickh147 ($10.65 in chips) 
Seat 2: fred00205 ($3.39 in chips) 
Seat 3: kilativ7 ($10.77 in chips) 
Seat 4: luchom87 ($11.53 in chips) 
Seat 5: Hop top 77 ($13.28 in chips) 
luchom87: posts small blind $0.05
Hop top 77: posts big blind $0.10
*** HOLE CARDS ***
Nickh147: folds 
fred00205: folds 
kilativ7: raises $0.15 to $0.25
luchom87: folds 
Hop top 77: raises $0.85 to $1.10
kilativ7: folds 
Uncalled bet ($0.85) returned to Hop top 77
Hop top 77 collected $0.55 from pot
Hop top 77: doesn't show hand 
*** SUMMARY ***
Total pot $0.55 | Rake $0 
Seat 1: Nickh147 folded before Flop (didn't bet)
Seat 2: fred00205 folded before Flop (didn't bet)
Seat 3: kilativ7 (button) folded before Flop
Seat 4: luchom87 (small blind) folded before Flop
Seat 5: Hop top 77 (big blind) collected ($0.55)



PokerStars Hand #222953066021:  Hold'em No Limit ($0.05/$0.10 USD) - 2021/01/23 8:12:20 ET
Table 'Bohlinia III' 6-max Seat #4 is the button
Seat 1: Nickh147 ($10.65 in chips) 
Seat 2: fred00205 ($3.39 in chips) 
Seat 3: kilativ7 ($10.52 in chips) 
Seat 4: luchom87 ($11.48 in chips) 
Seat 5: Hop top 77 ($13.58 in chips) 
Hop top 77: posts small blind $0.05
Nickh147: posts big blind $0.10
*** HOLE CARDS ***
fred00205: folds 
kilativ7: folds 
luchom87: raises $0.15 to $0.25
Hop top 77: folds 
Nickh147: folds 
Uncalled bet ($0.15) returned to luchom87
luchom87 collected $0.25 from pot
luchom87: doesn't show hand 
*** SUMMARY ***
Total pot $0.25 | Rake $0 
Seat 1: Nickh147 (big blind) folded before Flop
Seat 2: fred00205 folded before Flop (didn't bet)
Seat 3: kilativ7 folded before Flop (didn't bet)
Seat 4: luchom87 (button) collected ($0.25)
Seat 5: Hop top 77 (small blind) folded before Flop



PokerStars Hand #222953114618:  Hold'em No Limit ($0.05/$0.10 USD) - 2021/01/23 8:14:18 ET
Table 'Bohlinia III' 6-max Seat #2 is the button
Seat 1: Nickh147 ($10.50 in chips) 
Seat 2: fred00205 ($3.93 in chips) 
Seat 3: kilativ7 ($10.22 in chips) 
Seat 4: luchom87 ($11.03 in chips) 
Seat 5: Hop top 77 ($13.85 in chips) 
kilativ7: posts small blind $0.05
luchom87: posts big blind $0.10
*** HOLE CARDS ***
Hop top 77: raises $0.20 to $0.30
Nickh147: folds 
fred00205: folds 
kilativ7: folds 
luchom87: folds 
Uncalled bet ($0.20) returned to Hop top 77
Hop top 77 collected $0.25 from pot
Hop top 77: doesn't show hand 
*** SUMMARY ***
Total pot $0.25 | Rake $0 
Seat 1: Nickh147 folded before Flop (didn't bet)
Seat 2: fred00205 (button) folded before Flop (didn't bet)
Seat 3: kilativ7 (small blind) folded before Flop
Seat 4: luchom87 (big blind) folded before Flop
Seat 5: Hop top 77 collected ($0.25)



PokerStars Hand #222953121892:  Hold'em No Limit ($0.05/$0.10 USD) - 2021/01/23 8:14:36 ET
Table 'Bohlinia III' 6-max Seat #3 is the button
Seat 1: Nickh147 ($10.50 in chips) 
Seat 2: fred00205 ($3.93 in chips) 
Seat 3: kilativ7 ($10.17 in chips) 
Seat 4: luchom87 ($10.93 in chips) 
Seat 5: Hop top 77 ($14 in chips) 
luchom87: posts small blind $0.05
Hop top 77: posts big blind $0.10
*** HOLE CARDS ***
Nickh147: folds 
fred00205: calls $0.10
kilativ7: folds 
luchom87: calls $0.05
Hop top 77: checks 
*** FLOP *** [5s Ks 7s]
luchom87: checks 
ivan2772ms leaves the table
Hop top 77: bets $0.15
fred00205: folds 
luchom87: folds 
Uncalled bet ($0.15) returned to Hop top 77
bigbadwooods joins the table at seat #6 
Hop top 77 collected $0.29 from pot
Hop top 77: doesn't show hand 
*** SUMMARY ***
Total pot $0.30 | Rake $0.01 
Board [5s Ks 7s]
Seat 1: Nickh147 folded before Flop (didn't bet)
Seat 2: fred00205 folded on the Flop
Seat 3: kilativ7 (button) folded before Flop (didn't bet)
Seat 4: luchom87 (small blind) folded on the Flop
Seat 5: Hop top 77 (big blind) collected ($0.29)



PokerStars Hand #222953137759:  Hold'em No Limit ($0.05/$0.10 USD) - 2021/01/23 8:15:14 ET
Table 'Bohlinia III' 6-max Seat #4 is the button
Seat 1: Nickh147 ($10.50 in chips) 
Seat 2: fred00205 ($3.83 in chips) 
Seat 3: kilativ7 ($10.17 in chips) 
Seat 4: luchom87 ($10.83 in chips) 
Seat 5: Hop top 77 ($14.19 in chips) 
Seat 6: bigbadwooods ($10 in chips) 
Hop top 77: posts small blind $0.05
bigbadwooods: posts big blind $0.10
*** HOLE CARDS ***
Nickh147: folds 
fred00205: calls $0.10
kilativ7: folds 
luchom87: folds 
Hop top 77: folds 
bigbadwooods: checks 
*** FLOP *** [4d 9d 6h]
bigbadwooods: checks 
fred00205: bets $0.30
bigbadwooods: folds 
Uncalled bet ($0.30) returned to fred00205
fred00205 collected $0.24 from pot
fred00205: doesn't show hand 
*** SUMMARY ***
Total pot $0.25 | Rake $0.01 
Board [4d 9d 6h]
Seat 1: Nickh147 folded before Flop (didn't bet)
Seat 2: fred00205 collected ($0.24)
Seat 3: kilativ7 folded before Flop (didn't bet)
Seat 4: luchom87 (button) folded before Flop (didn't bet)
Seat 5: Hop top 77 (small blind) folded before Flop
Seat 6: bigbadwooods (big blind) folded on the Flop



PokerStars Hand #222953147609:  Hold'em No Limit ($0.05/$0.10 USD) - 2021/01/23 8:15:38 ET
Table 'Bohlinia III' 6-max Seat #5 is the button
Seat 1: Nickh147 ($10.50 in chips) 
Seat 2: fred00205 ($3.97 in chips) 
Seat 3: kilativ7 ($10.17 in chips) 
Seat 4: luchom87 ($10.83 in chips) 
Seat 5: Hop top 77 ($14.14 in chips) 
Seat 6: bigbadwooods ($10 in chips) 
bigbadwooods: posts small blind $0.05
Nickh147: posts big blind $0.10
*** HOLE CARDS ***
fred00205: folds 
kilativ7: folds 
luchom87: folds 
Hop top 77: folds 
bigbadwooods: folds 
Uncalled bet ($0.05) returned to Nickh147
Nickh147 collected $0.10 from pot
Nickh147: doesn't show hand 
*** SUMMARY ***
Total pot $0.10 | Rake $0 
Seat 1: Nickh147 (big blind) collected ($0.10)
Seat 2: fred00205 folded before Flop (didn't bet)
Seat 3: kilativ7 folded before Flop (didn't bet)
Seat 4: luchom87 folded before Flop (didn't bet)
Seat 5: Hop top 77 (button) folded before Flop (didn't bet)
Seat 6: bigbadwooods (small blind) folded before Flop



PokerStars Hand #222953154024:  Hold'em No Limit ($0.05/$0.10 USD) - 2021/01/23 8:15:53 ET
Table 'Bohlinia III' 6-max Seat #6 is the button
Seat 1: Nickh147 ($10.55 in chips) 
Seat 2: fred00205 ($3.97 in chips) 
Seat 3: kilativ7 ($10.17 in chips) 
Seat 4: luchom87 ($10.83 in chips) 
Seat 5: Hop top 77 ($14.14 in chips) 
Seat 6: bigbadwooods ($10 in chips) 
Nickh147: posts small blind $0.05
fred00205: posts big blind $0.10
*** HOLE CARDS ***
kilativ7: raises $0.20 to $0.30
luchom87: folds 
Hop top 77: folds 
bigbadwooods: calls $0.30
Nickh147: folds 
fred00205: calls $0.20
*** FLOP *** [Ad 8h 6h]
fred00205: checks 
kilativ7: bets $0.50
bigbadwooods: folds 
fred00205: folds 
Uncalled bet ($0.50) returned to kilativ7
kilativ7 collected $0.91 from pot
kilativ7: doesn't show hand 
*** SUMMARY ***
Total pot $0.95 | Rake $0.04 
Board [Ad 8h 6h]
Seat 1: Nickh147 (small blind) folded before Flop
Seat 2: fred00205 (big blind) folded on the Flop
Seat 3: kilativ7 collected ($0.91)
Seat 4: luchom87 folded before Flop (didn't bet)
Seat 5: Hop top 77 folded before Flop (didn't bet)
Seat 6: bigbadwooods (button) folded on the Flop



PokerStars Hand #222953163598:  Hold'em No Limit ($0.05/$0.10 USD) - 2021/01/23 8:16:17 ET
Table 'Bohlinia III' 6-max Seat #1 is the button
Seat 1: Nickh147 ($10.50 in chips) 
Seat 2: fred00205 ($3.67 in chips) 
Seat 3: kilativ7 ($10.78 in chips) 
Seat 4: luchom87 ($10.83 in chips) 
Seat 5: Hop top 77 ($14.14 in chips) 
Seat 6: bigbadwooods ($10 in chips) 
fred00205: posts small blind $0.05
kilativ7: posts big blind $0.10
*** HOLE CARDS ***
luchom87: folds 
Hop top 77: folds 
bigbadwooods: folds 
Nickh147: raises $0.11 to $0.21
fred00205: folds 
kilativ7: raises $0.54 to $0.75
Nickh147: folds 
Uncalled bet ($0.54) returned to kilativ7
kilativ7 collected $0.47 from pot
kilativ7: doesn't show hand 
*** SUMMARY ***
Total pot $0.47 | Rake $0 
Seat 1: Nickh147 (button) folded before Flop
Seat 2: fred00205 (small blind) folded before Flop
Seat 3: kilativ7 (big blind) collected ($0.47)
Seat 4: luchom87 folded before Flop (didn't bet)
Seat 5: Hop top 77 folded before Flop (didn't bet)
Seat 6: bigbadwooods folded before Flop (didn't bet)



PokerStars Hand #222953175763:  Hold'em No Limit ($0.05/$0.10 USD) - 2021/01/23 8:16:46 ET
Table 'Bohlinia III' 6-max Seat #2 is the button
Seat 1: Nickh147 ($10.29 in chips) 
Seat 2: fred00205 ($3.62 in chips) 
Seat 3: kilativ7 ($11.04 in chips) 
Seat 4: luchom87 ($10.83 in chips) 
Seat 5: Hop top 77 ($14.14 in chips) 
Seat 6: bigbadwooods ($10 in chips) 
kilativ7: posts small blind $0.05
luchom87: posts big blind $0.10
*** HOLE CARDS ***
Hop top 77: folds 
bigbadwooods: folds 
Nickh147: raises $0.14 to $0.24
fred00205: calls $0.24
kilativ7: folds 
luchom87: folds 
*** FLOP *** [7h Jh 2h]
Nickh147: bets $0.25
fred00205: folds 
Uncalled bet ($0.25) returned to Nickh147
Nickh147 collected $0.60 from pot
Nickh147: doesn't show hand 
*** SUMMARY ***
Total pot $0.63 | Rake $0.03 
Board [7h Jh 2h]
Seat 1: Nickh147 collected ($0.60)
Seat 2: fred00205 (button) folded on the Flop
Seat 3: kilativ7 (small blind) folded before Flop
Seat 4: luchom87 (big blind) folded before Flop
Seat 5: Hop top 77 folded before Flop (didn't bet)
Seat 6: bigbadwooods folded before Flop (didn't bet)



PokerStars Hand #222953192875:  Hold'em No Limit ($0.05/$0.10 USD) - 2021/01/23 8:17:27 ET
Table 'Bohlinia III' 6-max Seat #3 is the button
Seat 1: Nickh147 ($10.65 in chips) 
Seat 2: fred00205 ($3.38 in chips) 
Seat 3: kilativ7 ($10.99 in chips) 
Seat 4: luchom87 ($10.73 in chips) 
Seat 5: Hop top 77 ($14.14 in chips) 
Seat 6: bigbadwooods ($10 in chips) 
luchom87: posts small blind $0.05
Hop top 77: posts big blind $0.10
*** HOLE CARDS ***
bigbadwooods has timed out
bigbadwooods: folds 
Nickh147: folds 
fred00205: folds 
kilativ7: folds 
luchom87: folds 
Uncalled bet ($0.05) returned to Hop top 77
Hop top 77 collected $0.10 from pot
Hop top 77: doesn't show hand 
*** SUMMARY ***
Total pot $0.10 | Rake $0 
Seat 1: Nickh147 folded before Flop (didn't bet)
Seat 2: fred00205 folded before Flop (didn't bet)
Seat 3: kilativ7 (button) folded before Flop (didn't bet)
Seat 4: luchom87 (small blind) folded before Flop
Seat 5: Hop top 77 (big blind) collected ($0.10)
Seat 6: bigbadwooods folded before Flop (didn't bet)



PokerStars Hand #222953205936:  Hold'em No Limit ($0.05/$0.10 USD) - 2021/01/23 8:17:58 ET
Table 'Bohlinia III' 6-max Seat #4 is the button
Seat 1: Nickh147 ($10.65 in chips) 
Seat 2: fred00205 ($3.38 in chips) 
Seat 3: kilativ7 ($10.99 in chips) 
Seat 4: luchom87 ($10.68 in chips) 
Seat 5: Hop top 77 ($14.19 in chips) 
Seat 6: bigbadwooods ($10 in chips) 
Hop top 77: posts small blind $0.05
bigbadwooods: posts big blind $0.10
*** HOLE CARDS ***
Nickh147: folds 
fred00205: folds 
kilativ7: folds 
luchom87: folds 
Hop top 77: folds 
Uncalled bet ($0.05) returned to bigbadwooods
bigbadwooods collected $0.10 from pot
bigbadwooods: doesn't show hand 
*** SUMMARY ***
Total pot $0.10 | Rake $0 
Seat 1: Nickh147 folded before Flop (didn't bet)
Seat 2: fred00205 folded before Flop (didn't bet)
Seat 3: kilativ7 folded before Flop (didn't bet)
Seat 4: luchom87 (button) folded before Flop (didn't bet)
Seat 5: Hop top 77 (small blind) folded before Flop
Seat 6: bigbadwooods (big blind) collected ($0.10)



PokerStars Hand #222953211960:  Hold'em No Limit ($0.05/$0.10 USD) - 2021/01/23 8:18:13 ET
Table 'Bohlinia III' 6-max Seat #5 is the button
Seat 1: Nickh147 ($10.65 in chips) 
Seat 2: fred00205 ($3.38 in chips) 
Seat 3: kilativ7 ($10.99 in chips) 
Seat 4: luchom87 ($10.68 in chips) 
Seat 5: Hop top 77 ($14.14 in chips) 
Seat 6: bigbadwooods ($10.05 in chips) 
bigbadwooods: posts small blind $0.05
Nickh147: posts big blind $0.10
*** HOLE CARDS ***
fred00205: calls $0.10
kilativ7: folds 
luchom87: folds 
Hop top 77: folds 
bigbadwooods: raises $0.20 to $0.30
Nickh147: calls $0.20
fred00205: calls $0.20
*** FLOP *** [7h Tc Ts]
bigbadwooods: checks 
Nickh147: checks 
fred00205: checks 
*** TURN *** [7h Tc Ts] [8h]
bigbadwooods: checks 
Nickh147: checks 
fred00205: checks 
*** RIVER *** [7h Tc Ts 8h] [Qc]
bigbadwooods: checks 
Nickh147: checks 
fred00205: checks 
*** SHOW DOWN ***
bigbadwooods: shows [Ac 5c] (a pair of Tens)
Nickh147: mucks hand 
fred00205: shows [Ah Kc] (a pair of Tens - Ace+King kicker)
fred00205 collected $0.86 from pot
*** SUMMARY ***
Total pot $0.90 | Rake $0.04 
Board [7h Tc Ts 8h Qc]
Seat 1: Nickh147 (big blind) mucked
Seat 2: fred00205 showed [Ah Kc] and won ($0.86) with a pair of Tens
Seat 3: kilativ7 folded before Flop (didn't bet)
Seat 4: luchom87 folded before Flop (didn't bet)
Seat 5: Hop top 77 (button) folded before Flop (didn't bet)
Seat 6: bigbadwooods (small blind) showed [Ac 5c] and lost with a pair of Tens



PokerStars Hand #222953227879:  Hold'em No Limit ($0.05/$0.10 USD) - 2021/01/23 8:18:50 ET
Table 'Bohlinia III' 6-max Seat #6 is the button
Seat 1: Nickh147 ($10.35 in chips) 
Seat 2: fred00205 ($3.94 in chips) 
Seat 3: kilativ7 ($10.99 in chips) 
Seat 4: luchom87 ($10.68 in chips) 
Seat 5: Hop top 77 ($14.14 in chips) 
Seat 6: bigbadwooods ($10 in chips) 
Nickh147: posts small blind $0.05
fred00205: posts big blind $0.10
*** HOLE CARDS ***
kilativ7: folds 
luchom87: folds 
Hop top 77: folds 
bigbadwooods: folds 
Nickh147: raises $0.11 to $0.21
fred00205: calls $0.11
*** FLOP *** [Jc Kh Ks]
Nickh147: checks 
fred00205: bets $0.40
Nickh147: calls $0.40
*** TURN *** [Jc Kh Ks] [7h]
Nickh147: checks 
fred00205: checks 
*** RIVER *** [Jc Kh Ks 7h] [9s]
Nickh147: bets $0.73
fred00205: calls $0.73
*** SHOW DOWN ***
Nickh147: shows [Kc 8d] (three of a kind, Kings)
fred00205: mucks hand 
Nickh147 collected $2.56 from pot
*** SUMMARY ***
Total pot $2.68 | Rake $0.12 
Board [Jc Kh Ks 7h 9s]
Seat 1: Nickh147 (small blind) showed [Kc 8d] and won ($2.56) with three of a kind, Kings
Seat 2: fred00205 (big blind) mucked
Seat 3: kilativ7 folded before Flop (didn't bet)
Seat 4: luchom87 folded before Flop (didn't bet)
Seat 5: Hop top 77 folded before Flop (didn't bet)
Seat 6: bigbadwooods (button) folded before Flop (didn't bet)



PokerStars Hand #222953249533:  Hold'em No Limit ($0.05/$0.10 USD) - 2021/01/23 8:19:42 ET
Table 'Bohlinia III' 6-max Seat #1 is the button
Seat 1: Nickh147 ($11.57 in chips) 
Seat 2: fred00205 ($2.60 in chips) 
Seat 3: kilativ7 ($10.99 in chips) 
Seat 4: luchom87 ($10.68 in chips) 
Seat 5: Hop top 77 ($14.14 in chips) 
Seat 6: bigbadwooods ($10 in chips) 
fred00205: posts small blind $0.05
kilativ7: posts big blind $0.10
*** HOLE CARDS ***
luchom87: folds 
Hop top 77: folds 
bigbadwooods: folds 
Nickh147: raises $0.11 to $0.21
fred00205: folds 
kilativ7: folds 
Uncalled bet ($0.11) returned to Nickh147
Nickh147 collected $0.25 from pot
Nickh147: doesn't show hand 
*** SUMMARY ***
Total pot $0.25 | Rake $0 
Seat 1: Nickh147 (button) collected ($0.25)
Seat 2: fred00205 (small blind) folded before Flop
Seat 3: kilativ7 (big blind) folded before Flop
Seat 4: luchom87 folded before Flop (didn't bet)
Seat 5: Hop top 77 folded before Flop (didn't bet)
Seat 6: bigbadwooods folded before Flop (didn't bet)



PokerStars Hand #222953255683:  Hold'em No Limit ($0.05/$0.10 USD) - 2021/01/23 8:19:56 ET
Table 'Bohlinia III' 6-max Seat #2 is the button
Seat 1: Nickh147 ($11.72 in chips) 
Seat 2: fred00205 ($2.55 in chips) 
Seat 3: kilativ7 ($10.89 in chips) 
Seat 4: luchom87 ($10.68 in chips) 
Seat 5: Hop top 77 ($14.14 in chips) 
Seat 6: bigbadwooods ($10 in chips) 
kilativ7: posts small blind $0.05
luchom87: posts big blind $0.10
*** HOLE CARDS ***
Hop top 77: folds 
bigbadwooods: folds 
Nickh147: folds 
fred00205: folds 
kilativ7: folds 
Uncalled bet ($0.05) returned to luchom87
luchom87 collected $0.10 from pot
luchom87: doesn't show hand 
*** SUMMARY ***
Total pot $0.10 | Rake $0 
Seat 1: Nickh147 folded before Flop (didn't bet)
Seat 2: fred00205 (button) folded before Flop (didn't bet)
Seat 3: kilativ7 (small blind) folded before Flop
Seat 4: luchom87 (big blind) collected ($0.10)
Seat 5: Hop top 77 folded before Flop (didn't bet)
Seat 6: bigbadwooods folded before Flop (didn't bet)



PokerStars Hand #222953264975:  Hold'em No Limit ($0.05/$0.10 USD) - 2021/01/23 8:20:18 ET
Table 'Bohlinia III' 6-max Seat #3 is the button
Seat 1: Nickh147 ($11.72 in chips) 
Seat 2: fred00205 ($2.55 in chips) 
Seat 3: kilativ7 ($10.84 in chips) 
Seat 4: luchom87 ($10.73 in chips) 
Seat 5: Hop top 77 ($14.14 in chips) 
Seat 6: bigbadwooods ($10 in chips) 
luchom87: posts small blind $0.05
Hop top 77: posts big blind $0.10
*** HOLE CARDS ***
bigbadwooods: folds 
Nickh147: folds 
fred00205: calls $0.10
kilativ7: folds 
luchom87: folds 
Hop top 77: checks 
*** FLOP *** [7c 9c Td]
Hop top 77: checks 
fred00205: bets $0.40
Hop top 77: folds 
Uncalled bet ($0.40) returned to fred00205
fred00205 collected $0.24 from pot
fred00205: doesn't show hand 
*** SUMMARY ***
Total pot $0.25 | Rake $0.01 
Board [7c 9c Td]
Seat 1: Nickh147 folded before Flop (didn't bet)
Seat 2: fred00205 collected ($0.24)
Seat 3: kilativ7 (button) folded before Flop (didn't bet)
Seat 4: luchom87 (small blind) folded before Flop
Seat 5: Hop top 77 (big blind) folded on the Flop
Seat 6: bigbadwooods folded before Flop (didn't bet)



PokerStars Hand #222953278937:  Hold'em No Limit ($0.05/$0.10 USD) - 2021/01/23 8:20:51 ET
Table 'Bohlinia III' 6-max Seat #4 is the button
Seat 1: Nickh147 ($11.72 in chips) 
Seat 2: fred00205 ($2.69 in chips) 
Seat 3: kilativ7 ($10.84 in chips) 
Seat 4: luchom87 ($10.68 in chips) 
Seat 5: Hop top 77 ($14.04 in chips) 
Seat 6: bigbadwooods ($10 in chips) 
Hop top 77: posts small blind $0.05
bigbadwooods: posts big blind $0.10
*** HOLE CARDS ***
Nickh147: raises $0.17 to $0.27
fred00205: folds 
kilativ7: folds 
luchom87: calls $0.27
Hop top 77: folds 
bigbadwooods: folds 
*** FLOP *** [3s 6h Th]
Nickh147: checks 
luchom87: bets $0.23
Nickh147: folds 
Uncalled bet ($0.23) returned to luchom87
luchom87 collected $0.66 from pot
luchom87: doesn't show hand 
*** SUMMARY ***
Total pot $0.69 | Rake $0.03 
Board [3s 6h Th]
Seat 1: Nickh147 folded on the Flop
Seat 2: fred00205 folded before Flop (didn't bet)
Seat 3: kilativ7 folded before Flop (didn't bet)
Seat 4: luchom87 (button) collected ($0.66)
Seat 5: Hop top 77 (small blind) folded before Flop
Seat 6: bigbadwooods (big blind) folded before Flop



PokerStars Hand #222953311377:  Hold'em No Limit ($0.05/$0.10 USD) - 2021/01/23 8:22:06 ET
Table 'Bohlinia III' 6-max Seat #5 is the button
Seat 1: Nickh147 ($11.45 in chips) 
Seat 2: fred00205 ($2.69 in chips) 
Seat 3: kilativ7 ($10.84 in chips) 
Seat 4: luchom87 ($11.07 in chips) 
Seat 5: Hop top 77 ($13.99 in chips) 
Seat 6: bigbadwooods ($10 in chips) 
bigbadwooods: posts small blind $0.05
Nickh147: posts big blind $0.10
*** HOLE CARDS ***
fred00205: calls $0.10
kilativ7: folds 
luchom87: folds 
Hop top 77: folds 
bigbadwooods: folds 
Nickh147: checks 
*** FLOP *** [Ts Td As]
Nickh147: checks 
fred00205: checks 
*** TURN *** [Ts Td As] [Kc]
Nickh147: bets $0.10
fred00205: calls $0.10
*** RIVER *** [Ts Td As Kc] [6c]
Nickh147: bets $0.30
fred00205: calls $0.30
*** SHOW DOWN ***
Nickh147: shows [Ah 9s] (two pair, Aces and Tens)
fred00205: mucks hand 
Nickh147 collected $1 from pot
*** SUMMARY ***
Total pot $1.05 | Rake $0.05 
Board [Ts Td As Kc 6c]
Seat 1: Nickh147 (big blind) showed [Ah 9s] and won ($1) with two pair, Aces and Tens
Seat 2: fred00205 mucked
Seat 3: kilativ7 folded before Flop (didn't bet)
Seat 4: luchom87 folded before Flop (didn't bet)
Seat 5: Hop top 77 (button) folded before Flop (didn't bet)
Seat 6: bigbadwooods (small blind) folded before Flop



PokerStars Hand #222953324903:  Hold'em No Limit ($0.05/$0.10 USD) - 2021/01/23 8:22:37 ET
Table 'Bohlinia III' 6-max Seat #6 is the button
Seat 1: Nickh147 ($11.95 in chips) 
Seat 2: fred00205 ($2.19 in chips) 
Seat 3: kilativ7 ($10.84 in chips) 
Seat 4: luchom87 ($11.07 in chips) 
Seat 5: Hop top 77 ($13.99 in chips) 
Seat 6: bigbadwooods ($10 in chips) 
Nickh147: posts small blind $0.05
fred00205: posts big blind $0.10
*** HOLE CARDS ***
kilativ7: folds 
luchom87: raises $0.20 to $0.30
Hop top 77: folds 
bigbadwooods: folds 
Nickh147: folds 
fred00205: calls $0.20
*** FLOP *** [5d Jc 3c]
fred00205: checks 
luchom87: bets $0.22
fred00205: calls $0.22
*** TURN *** [5d Jc 3c] [7d]
fred00205: checks 
luchom87: checks 
*** RIVER *** [5d Jc 3c 7d] [3h]
fred00205: checks 
luchom87: checks 
*** SHOW DOWN ***
fred00205: shows [Js Qd] (two pair, Jacks and Threes)
luchom87: mucks hand 
fred00205 collected $1.04 from pot
*** SUMMARY ***
Total pot $1.09 | Rake $0.05 
Board [5d Jc 3c 7d 3h]
Seat 1: Nickh147 (small blind) folded before Flop
Seat 2: fred00205 (big blind) showed [Js Qd] and won ($1.04) with two pair, Jacks and Threes
Seat 3: kilativ7 folded before Flop (didn't bet)
Seat 4: luchom87 mucked
Seat 5: Hop top 77 folded before Flop (didn't bet)
Seat 6: bigbadwooods (button) folded before Flop (didn't bet)



PokerStars Hand #222953345610:  Hold'em No Limit ($0.05/$0.10 USD) - 2021/01/23 8:23:25 ET
Table 'Bohlinia III' 6-max Seat #1 is the button
Seat 1: Nickh147 ($11.90 in chips) 
Seat 2: fred00205 ($2.71 in chips) 
Seat 4: luchom87 ($10.55 in chips) 
Seat 5: Hop top 77 ($13.99 in chips) 
Seat 6: bigbadwooods ($10 in chips) 
fred00205: posts small blind $0.05
kilativ7: is sitting out 
kilativ7 leaves the table
luchom87: posts big blind $0.10
*** HOLE CARDS ***
Hop top 77: raises $0.20 to $0.30
bigbadwooods: folds 
Nickh147: folds 
fred00205: folds 
Akaiso joins the table at seat #3 
luchom87: folds 
Uncalled bet ($0.20) returned to Hop top 77
Hop top 77 collected $0.25 from pot
Hop top 77: doesn't show hand 
*** SUMMARY ***
Total pot $0.25 | Rake $0 
Seat 1: Nickh147 (button) folded before Flop (didn't bet)
Seat 2: fred00205 (small blind) folded before Flop
Seat 4: luchom87 (big blind) folded before Flop
Seat 5: Hop top 77 collected ($0.25)
Seat 6: bigbadwooods folded before Flop (didn't bet)



PokerStars Hand #222953356428:  Hold'em No Limit ($0.05/$0.10 USD) - 2021/01/23 8:23:50 ET
Table 'Bohlinia III' 6-max Seat #2 is the button
Seat 1: Nickh147 ($11.90 in chips) 
Seat 2: fred00205 ($2.66 in chips) 
Seat 4: luchom87 ($10.45 in chips) 
Seat 5: Hop top 77 ($14.14 in chips) 
Seat 6: bigbadwooods ($10 in chips) 
luchom87: posts small blind $0.05
Hop top 77: posts big blind $0.10
*** HOLE CARDS ***
bigbadwooods: folds 
Nickh147: folds 
fred00205: folds 
luchom87: folds 
Uncalled bet ($0.05) returned to Hop top 77
Hop top 77 collected $0.10 from pot
Hop top 77: doesn't show hand 
*** SUMMARY ***
Total pot $0.10 | Rake $0 
Seat 1: Nickh147 folded before Flop (didn't bet)
Seat 2: fred00205 (button) folded before Flop (didn't bet)
Seat 4: luchom87 (small blind) folded before Flop
Seat 5: Hop top 77 (big blind) collected ($0.10)
Seat 6: bigbadwooods folded before Flop (didn't bet)



PokerStars Hand #222953362202:  Hold'em No Limit ($0.05/$0.10 USD) - 2021/01/23 8:24:03 ET
Table 'Bohlinia III' 6-max Seat #4 is the button
Seat 1: Nickh147 ($11.90 in chips) 
Seat 2: fred00205 ($2.66 in chips) 
Seat 3: Akaiso ($8.52 in chips) 
Seat 4: luchom87 ($10.40 in chips) 
Seat 5: Hop top 77 ($14.19 in chips) 
Seat 6: bigbadwooods ($10 in chips) 
Hop top 77: posts small blind $0.05
bigbadwooods: posts big blind $0.10
Akaiso: posts big blind $0.10
*** HOLE CARDS ***
Nickh147: folds 
fred00205: folds 
Akaiso: checks 
luchom87: raises $0.40 to $0.50
Hop top 77: folds 
bigbadwooods: folds 
Akaiso: folds 
Uncalled bet ($0.40) returned to luchom87
luchom87 collected $0.35 from pot
luchom87: doesn't show hand 
*** SUMMARY ***
Total pot $0.35 | Rake $0 
Seat 1: Nickh147 folded before Flop (didn't bet)
Seat 2: fred00205 folded before Flop (didn't bet)
Seat 3: Akaiso folded before Flop (didn't bet)
Seat 4: luchom87 (button) collected ($0.35)
Seat 5: Hop top 77 (small blind) folded before Flop
Seat 6: bigbadwooods (big blind) folded before Flop



PokerStars Hand #222953372828:  Hold'em No Limit ($0.05/$0.10 USD) - 2021/01/23 8:24:28 ET
Table 'Bohlinia III' 6-max Seat #5 is the button
Seat 1: Nickh147 ($11.90 in chips) 
Seat 2: fred00205 ($2.66 in chips) 
Seat 3: Akaiso ($8.42 in chips) 
Seat 4: luchom87 ($10.65 in chips) 
Seat 5: Hop top 77 ($14.14 in chips) 
Seat 6: bigbadwooods ($10 in chips) 
bigbadwooods: posts small blind $0.05
Nickh147: posts big blind $0.10
*** HOLE CARDS ***
fred00205: folds 
Akaiso: calls $0.10
luchom87: raises $0.40 to $0.50
Hop top 77: folds 
bigbadwooods: folds 
Nickh147: folds 
Akaiso: calls $0.40
*** FLOP *** [Kd 6d 5d]
Akaiso: bets $0.30
luchom87: folds 
Uncalled bet ($0.30) returned to Akaiso
Akaiso collected $1.10 from pot
Akaiso: doesn't show hand 
*** SUMMARY ***
Total pot $1.15 | Rake $0.05 
Board [Kd 6d 5d]
Seat 1: Nickh147 (big blind) folded before Flop
Seat 2: fred00205 folded before Flop (didn't bet)
Seat 3: Akaiso collected ($1.10)
Seat 4: luchom87 folded on the Flop
Seat 5: Hop top 77 (button) folded before Flop (didn't bet)
Seat 6: bigbadwooods (small blind) folded before Flop



PokerStars Hand #222953384657:  Hold'em No Limit ($0.05/$0.10 USD) - 2021/01/23 8:24:55 ET
Table 'Bohlinia III' 6-max Seat #6 is the button
Seat 1: Nickh147 ($11.80 in chips) 
Seat 2: fred00205 ($2.66 in chips) 
Seat 3: Akaiso ($9.02 in chips) 
Seat 4: luchom87 ($10.15 in chips) 
Seat 5: Hop top 77 ($14.14 in chips) 
Seat 6: bigbadwooods ($10 in chips) 
Nickh147: posts small blind $0.05
fred00205: posts big blind $0.10
*** HOLE CARDS ***
Akaiso: calls $0.10
luchom87: folds 
Hop top 77: folds 
bigbadwooods: folds 
Nickh147: calls $0.05
fred00205: checks 
*** FLOP *** [Qh 8h Jh]
Nickh147: checks 
fred00205: checks 
Akaiso: bets $0.40
Nickh147: folds 
fred00205: calls $0.40
*** TURN *** [Qh 8h Jh] [Th]
fred00205: checks 
Akaiso: bets $0.40
fred00205: raises $1.76 to $2.16 and is all-in
Akaiso: calls $1.76
*** RIVER *** [Qh 8h Jh Th] [6d]
*** SHOW DOWN ***
fred00205: shows [Kc 9d] (a straight, Nine to King)
Akaiso: shows [Ac Tc] (a pair of Tens)
fred00205 collected $5.18 from pot
*** SUMMARY ***
Total pot $5.42 | Rake $0.24 
Board [Qh 8h Jh Th 6d]
Seat 1: Nickh147 (small blind) folded on the Flop
Seat 2: fred00205 (big blind) showed [Kc 9d] and won ($5.18) with a straight, Nine to King
Seat 3: Akaiso showed [Ac Tc] and lost with a pair of Tens
Seat 4: luchom87 folded before Flop (didn't bet)
Seat 5: Hop top 77 folded before Flop (didn't bet)
Seat 6: bigbadwooods (button) folded before Flop (didn't bet)



PokerStars Hand #222953409863:  Hold'em No Limit ($0.05/$0.10 USD) - 2021/01/23 8:25:54 ET
Table 'Bohlinia III' 6-max Seat #1 is the button
Seat 1: Nickh147 ($11.70 in chips) 
Seat 2: fred00205 ($5.18 in chips) 
Seat 3: Akaiso ($6.36 in chips) 
Seat 4: luchom87 ($10.15 in chips) 
Seat 5: Hop top 77 ($14.14 in chips) 
Seat 6: bigbadwooods ($10 in chips) 
fred00205: posts small blind $0.05
Akaiso: posts big blind $0.10
*** HOLE CARDS ***
luchom87: folds 
Hop top 77: folds 
bigbadwooods: folds 
Nickh147: raises $0.11 to $0.21
fred00205: folds 
Akaiso: folds 
Uncalled bet ($0.11) returned to Nickh147
Nickh147 collected $0.25 from pot
Nickh147: doesn't show hand 
*** SUMMARY ***
Total pot $0.25 | Rake $0 
Seat 1: Nickh147 (button) collected ($0.25)
Seat 2: fred00205 (small blind) folded before Flop
Seat 3: Akaiso (big blind) folded before Flop
Seat 4: luchom87 folded before Flop (didn't bet)
Seat 5: Hop top 77 folded before Flop (didn't bet)
Seat 6: bigbadwooods folded before Flop (didn't bet)



PokerStars Hand #222953419080:  Hold'em No Limit ($0.05/$0.10 USD) - 2021/01/23 8:26:15 ET
Table 'Bohlinia III' 6-max Seat #2 is the button
Seat 1: Nickh147 ($11.85 in chips) 
Seat 2: fred00205 ($5.13 in chips) 
Seat 3: Akaiso ($6.26 in chips) 
Seat 4: luchom87 ($10.15 in chips) 
Seat 5: Hop top 77 ($14.14 in chips) 
Seat 6: bigbadwooods ($10 in chips) 
Akaiso: posts small blind $0.05
luchom87: posts big blind $0.10
*** HOLE CARDS ***
Hop top 77: folds 
bigbadwooods: folds 
Nickh147: raises $0.14 to $0.24
fred00205: folds 
Akaiso: calls $0.19
luchom87: folds 
*** FLOP *** [7s Ts Kd]
Akaiso: checks 
Nickh147: bets $0.30
Akaiso: folds 
Uncalled bet ($0.30) returned to Nickh147
Nickh147 collected $0.55 from pot
Nickh147: doesn't show hand 
*** SUMMARY ***
Total pot $0.58 | Rake $0.03 
Board [7s Ts Kd]
Seat 1: Nickh147 collected ($0.55)
Seat 2: fred00205 (button) folded before Flop (didn't bet)
Seat 3: Akaiso (small blind) folded on the Flop
Seat 4: luchom87 (big blind) folded before Flop
Seat 5: Hop top 77 folded before Flop (didn't bet)
Seat 6: bigbadwooods folded before Flop (didn't bet)



PokerStars Hand #222953434692:  Hold'em No Limit ($0.05/$0.10 USD) - 2021/01/23 8:26:52 ET
Table 'Bohlinia III' 6-max Seat #3 is the button
Seat 1: Nickh147 ($12.16 in chips) 
Seat 2: fred00205 ($5.13 in chips) 
Seat 3: Akaiso ($6.02 in chips) 
Seat 4: luchom87 ($10.05 in chips) 
Seat 5: Hop top 77 ($14.14 in chips) 
Seat 6: bigbadwooods ($10 in chips) 
luchom87: posts small blind $0.05
Hop top 77: posts big blind $0.10
*** HOLE CARDS ***
bigbadwooods: folds 
Nickh147: raises $0.17 to $0.27
fred00205: folds 
Akaiso: calls $0.27
luchom87: folds 
Hop top 77: calls $0.17
*** FLOP *** [7d 2s 7s]
Hop top 77: checks 
Nickh147: bets $0.40
Akaiso: calls $0.40
Hop top 77: folds 
*** TURN *** [7d 2s 7s] [9c]
Nickh147: bets $0.70
Akaiso: calls $0.70
*** RIVER *** [7d 2s 7s 9c] [4s]
Nickh147: bets $1.81
Akaiso: calls $1.81
*** SHOW DOWN ***
Nickh147: shows [As Ts] (a flush, Ace high)
Akaiso: mucks hand 
Nickh147 collected $6.38 from pot
*** SUMMARY ***
Total pot $6.68 | Rake $0.30 
Board [7d 2s 7s 9c 4s]
Seat 1: Nickh147 showed [As Ts] and won ($6.38) with a flush, Ace high
Seat 2: fred00205 folded before Flop (didn't bet)
Seat 3: Akaiso (button) mucked
Seat 4: luchom87 (small blind) folded before Flop
Seat 5: Hop top 77 (big blind) folded on the Flop
Seat 6: bigbadwooods folded before Flop (didn't bet)



PokerStars Hand #222953467620:  Hold'em No Limit ($0.05/$0.10 USD) - 2021/01/23 8:28:07 ET
Table 'Bohlinia III' 6-max Seat #4 is the button
Seat 1: Nickh147 ($15.36 in chips) 
Seat 2: fred00205 ($5.13 in chips) 
Seat 3: Akaiso ($2.84 in chips) 
Seat 4: luchom87 ($10 in chips) 
Seat 5: Hop top 77 ($13.87 in chips) 
Seat 6: bigbadwooods ($10 in chips) 
Hop top 77: posts small blind $0.05
bigbadwooods: posts big blind $0.10
*** HOLE CARDS ***
Nickh147: folds 
fred00205: calls $0.10
Akaiso: folds 
luchom87: raises $0.40 to $0.50
Hop top 77: folds 
bigbadwooods: raises $1 to $1.50
fred00205: folds 
luchom87: folds 
Uncalled bet ($1) returned to bigbadwooods
bigbadwooods collected $1.15 from pot
bigbadwooods: doesn't show hand 
*** SUMMARY ***
Total pot $1.15 | Rake $0 
Seat 1: Nickh147 folded before Flop (didn't bet)
Seat 2: fred00205 folded before Flop
Seat 3: Akaiso folded before Flop (didn't bet)
Seat 4: luchom87 (button) folded before Flop
Seat 5: Hop top 77 (small blind) folded before Flop
Seat 6: bigbadwooods (big blind) collected ($1.15)



PokerStars Hand #222953479281:  Hold'em No Limit ($0.05/$0.10 USD) - 2021/01/23 8:28:34 ET
Table 'Bohlinia III' 6-max Seat #5 is the button
Seat 2: fred00205 ($5.03 in chips) 
Seat 3: Akaiso ($2.84 in chips) 
Seat 4: luchom87 ($10 in chips) 
Seat 5: Hop top 77 ($13.82 in chips) 
Seat 6: bigbadwooods ($10.65 in chips) 
bigbadwooods: posts small blind $0.05
Nickh147: is sitting out 
fred00205: posts big blind $0.10
*** HOLE CARDS ***
Akaiso: calls $0.10
luchom87: folds 
Hop top 77: folds 
bigbadwooods: calls $0.05
fred00205: checks 
*** FLOP *** [Js Ts 5s]
bigbadwooods: checks 
fred00205: checks 
Akaiso: bets $0.40
bigbadwooods: folds 
fred00205: calls $0.40
*** TURN *** [Js Ts 5s] [Ac]
fred00205: checks 
Akaiso: bets $0.40
fred00205: calls $0.40
*** RIVER *** [Js Ts 5s Ac] [3c]
fred00205: checks 
Akaiso: bets $1.94 and is all-in
fred00205: folds 
Uncalled bet ($1.94) returned to Akaiso
Akaiso collected $1.81 from pot
Akaiso: doesn't show hand 
*** SUMMARY ***
Total pot $1.90 | Rake $0.09 
Board [Js Ts 5s Ac 3c]
Seat 2: fred00205 (big blind) folded on the River
Seat 3: Akaiso collected ($1.81)
Seat 4: luchom87 folded before Flop (didn't bet)
Seat 5: Hop top 77 (button) folded before Flop (didn't bet)
Seat 6: bigbadwooods (small blind) folded on the Flop



PokerStars Hand #222953509945:  Hold'em No Limit ($0.05/$0.10 USD) - 2021/01/23 8:29:44 ET
Table 'Bohlinia III' 6-max Seat #6 is the button
Seat 2: fred00205 ($4.13 in chips) 
Seat 3: Akaiso ($3.75 in chips) 
Seat 4: luchom87 ($10 in chips) 
Seat 5: Hop top 77 ($13.82 in chips) 
Seat 6: bigbadwooods ($10.55 in chips) 
fred00205: posts small blind $0.05
Akaiso: posts big blind $0.10
*** HOLE CARDS ***
luchom87: folds 
Hop top 77: raises $0.20 to $0.30
bigbadwooods: folds 
fred00205: folds 
Akaiso: calls $0.20
*** FLOP *** [Th 8h 6d]
Akaiso: checks 
Hop top 77: checks 
*** TURN *** [Th 8h 6d] [Ad]
Akaiso: bets $0.30
Hop top 77: folds 
Uncalled bet ($0.30) returned to Akaiso
Akaiso collected $0.62 from pot
Akaiso: doesn't show hand 
*** SUMMARY ***
Total pot $0.65 | Rake $0.03 
Board [Th 8h 6d Ad]
Seat 2: fred00205 (small blind) folded before Flop
Seat 3: Akaiso (big blind) collected ($0.62)
Seat 4: luchom87 folded before Flop (didn't bet)
Seat 5: Hop top 77 folded on the Turn
Seat 6: bigbadwooods (button) folded before Flop (didn't bet)



PokerStars Hand #222953528080:  Hold'em No Limit ($0.05/$0.10 USD) - 2021/01/23 8:30:25 ET
Table 'Bohlinia III' 6-max Seat #2 is the button
Seat 2: fred00205 ($4.08 in chips) 
Seat 3: Akaiso ($4.07 in chips) 
Seat 4: luchom87 ($10 in chips) 
Seat 5: Hop top 77 ($13.52 in chips) 
Seat 6: bigbadwooods ($10.55 in chips) 
Akaiso: posts small blind $0.05
luchom87: posts big blind $0.10
*** HOLE CARDS ***
Hop top 77: folds 
bigbadwooods: folds 
fred00205: calls $0.10
Akaiso: folds 
luchom87: checks 
*** FLOP *** [7s Kd Td]
luchom87: checks 
fred00205: checks 
*** TURN *** [7s Kd Td] [Jh]
luchom87: checks 
fred00205: checks 
*** RIVER *** [7s Kd Td Jh] [8s]
luchom87: bets $0.33
fred00205: folds 
Uncalled bet ($0.33) returned to luchom87
luchom87 collected $0.24 from pot
luchom87: doesn't show hand 
*** SUMMARY ***
Total pot $0.25 | Rake $0.01 
Board [7s Kd Td Jh 8s]
Seat 2: fred00205 (button) folded on the River
Seat 3: Akaiso (small blind) folded before Flop
Seat 4: luchom87 (big blind) collected ($0.24)
Seat 5: Hop top 77 folded before Flop (didn't bet)
Seat 6: bigbadwooods folded before Flop (didn't bet)



PokerStars Hand #222953547943:  Hold'em No Limit ($0.05/$0.10 USD) - 2021/01/23 8:31:10 ET
Table 'Bohlinia III' 6-max Seat #3 is the button
Seat 2: fred00205 ($3.98 in chips) 
Seat 3: Akaiso ($4.02 in chips) 
Seat 4: luchom87 ($10.14 in chips) 
Seat 5: Hop top 77 ($13.52 in chips) 
Seat 6: bigbadwooods ($10.55 in chips) 
luchom87: posts small blind $0.05
Hop top 77: posts big blind $0.10
*** HOLE CARDS ***
bigbadwooods: folds 
fred00205: calls $0.10
Akaiso: calls $0.10
Nickh147 leaves the table
luchom87: calls $0.05
Hop top 77: checks 
*** FLOP *** [8s 8h Ad]
luchom87: checks 
Hop top 77: checks 
fred00205: bets $0.20
Akaiso: folds 
luchom87: folds 
Hop top 77: folds 
Uncalled bet ($0.20) returned to fred00205
fred00205 collected $0.38 from pot
fred00205: doesn't show hand 
*** SUMMARY ***
Total pot $0.40 | Rake $0.02 
Board [8s 8h Ad]
Seat 2: fred00205 collected ($0.38)
Seat 3: Akaiso (button) folded on the Flop
Seat 4: luchom87 (small blind) folded on the Flop
Seat 5: Hop top 77 (big blind) folded on the Flop
Seat 6: bigbadwooods folded before Flop (didn't bet)



PokerStars Hand #222953567908:  Hold'em No Limit ($0.05/$0.10 USD) - 2021/01/23 8:31:55 ET
Table 'Bohlinia III' 6-max Seat #4 is the button
Seat 2: fred00205 ($4.26 in chips) 
Seat 3: Akaiso ($3.92 in chips) 
Seat 4: luchom87 ($10.04 in chips) 
Seat 5: Hop top 77 ($13.42 in chips) 
Seat 6: bigbadwooods ($10.55 in chips) 
Hop top 77: posts small blind $0.05
bigbadwooods: posts big blind $0.10
*** HOLE CARDS ***
fred00205: folds 
Akaiso: folds 
luchom87: raises $0.15 to $0.25
Hop top 77: folds 
bigbadwooods: folds 
Uncalled bet ($0.15) returned to luchom87
Strocub1 joins the table at seat #1 
luchom87 collected $0.25 from pot
luchom87: doesn't show hand 
*** SUMMARY ***
Total pot $0.25 | Rake $0 
Seat 2: fred00205 folded before Flop (didn't bet)
Seat 3: Akaiso folded before Flop (didn't bet)
Seat 4: luchom87 (button) collected ($0.25)
Seat 5: Hop top 77 (small blind) folded before Flop
Seat 6: bigbadwooods (big blind) folded before Flop



PokerStars Hand #222953573175:  Hold'em No Limit ($0.05/$0.10 USD) - 2021/01/23 8:32:07 ET
Table 'Bohlinia III' 6-max Seat #5 is the button
Seat 1: Strocub1 ($8 in chips) 
Seat 2: fred00205 ($4.26 in chips) 
Seat 3: Akaiso ($3.92 in chips) 
Seat 4: luchom87 ($10.19 in chips) 
Seat 5: Hop top 77 ($13.37 in chips) 
Seat 6: bigbadwooods ($10.45 in chips) 
bigbadwooods: posts small blind $0.05
Strocub1: posts big blind $0.10
*** HOLE CARDS ***
fred00205: folds 
Akaiso: folds 
luchom87: folds 
Hop top 77: folds 
bigbadwooods: folds 
Uncalled bet ($0.05) returned to Strocub1
Strocub1 collected $0.10 from pot
Strocub1: doesn't show hand 
*** SUMMARY ***
Total pot $0.10 | Rake $0 
Seat 1: Strocub1 (big blind) collected ($0.10)
Seat 2: fred00205 folded before Flop (didn't bet)
Seat 3: Akaiso folded before Flop (didn't bet)
Seat 4: luchom87 folded before Flop (didn't bet)
Seat 5: Hop top 77 (button) folded before Flop (didn't bet)
Seat 6: bigbadwooods (small blind) folded before Flop



PokerStars Hand #222953581481:  Hold'em No Limit ($0.05/$0.10 USD) - 2021/01/23 8:32:25 ET
Table 'Bohlinia III' 6-max Seat #6 is the button
Seat 1: Strocub1 ($8.05 in chips) 
Seat 2: fred00205 ($4.26 in chips) 
Seat 3: Akaiso ($3.92 in chips) 
Seat 4: luchom87 ($10.19 in chips) 
Seat 5: Hop top 77 ($13.37 in chips) 
Seat 6: bigbadwooods ($10.40 in chips) 
Strocub1: posts small blind $0.05
fred00205: posts big blind $0.10
*** HOLE CARDS ***
Akaiso: folds 
luchom87: folds 
Hop top 77: raises $0.20 to $0.30
bigbadwooods: folds 
Strocub1: folds 
fred00205: calls $0.20
*** FLOP *** [Jd 4s 3c]
fred00205: checks 
Hop top 77: bets $0.41
fred00205: folds 
Uncalled bet ($0.41) returned to Hop top 77
Hop top 77 collected $0.62 from pot
Hop top 77: doesn't show hand 
*** SUMMARY ***
Total pot $0.65 | Rake $0.03 
Board [Jd 4s 3c]
Seat 1: Strocub1 (small blind) folded before Flop
Seat 2: fred00205 (big blind) folded on the Flop
Seat 3: Akaiso folded before Flop (didn't bet)
Seat 4: luchom87 folded before Flop (didn't bet)
Seat 5: Hop top 77 collected ($0.62)
Seat 6: bigbadwooods (button) folded before Flop (didn't bet)



PokerStars Hand #222953597289:  Hold'em No Limit ($0.05/$0.10 USD) - 2021/01/23 8:33:01 ET
Table 'Bohlinia III' 6-max Seat #1 is the button
Seat 1: Strocub1 ($8 in chips) 
Seat 2: fred00205 ($3.96 in chips) 
Seat 3: Akaiso ($3.92 in chips) 
Seat 4: luchom87 ($10.19 in chips) 
Seat 5: Hop top 77 ($13.69 in chips) 
Seat 6: bigbadwooods ($10.40 in chips) 
fred00205: posts small blind $0.05
Akaiso: posts big blind $0.10
*** HOLE CARDS ***
luchom87: folds 
Hop top 77: folds 
bigbadwooods: raises $0.10 to $0.20
Strocub1: folds 
fred00205: folds 
Akaiso: calls $0.10
*** FLOP *** [4h 2d Th]
Akaiso: checks 
bigbadwooods: bets $0.20
Akaiso: calls $0.20
*** TURN *** [4h 2d Th] [6d]
Akaiso: bets $0.40
bigbadwooods: calls $0.40
*** RIVER *** [4h 2d Th 6d] [6h]
Akaiso: bets $1
bigbadwooods: calls $1
*** SHOW DOWN ***
Akaiso: shows [7s 2s] (two pair, Sixes and Deuces)
bigbadwooods: shows [5s 6s] (three of a kind, Sixes)
bigbadwooods collected $3.49 from pot
*** SUMMARY ***
Total pot $3.65 | Rake $0.16 
Board [4h 2d Th 6d 6h]
Seat 1: Strocub1 (button) folded before Flop (didn't bet)
Seat 2: fred00205 (small blind) folded before Flop
Seat 3: Akaiso (big blind) showed [7s 2s] and lost with two pair, Sixes and Deuces
Seat 4: luchom87 folded before Flop (didn't bet)
Seat 5: Hop top 77 folded before Flop (didn't bet)
Seat 6: bigbadwooods showed [5s 6s] and won ($3.49) with three of a kind, Sixes



PokerStars Hand #222953618301:  Hold'em No Limit ($0.05/$0.10 USD) - 2021/01/23 8:33:48 ET
Table 'Bohlinia III' 6-max Seat #2 is the button
Seat 1: Strocub1 ($8 in chips) 
Seat 2: fred00205 ($3.91 in chips) 
Seat 3: Akaiso ($2.12 in chips) 
Seat 4: luchom87 ($10.19 in chips) 
Seat 5: Hop top 77 ($13.69 in chips) 
Seat 6: bigbadwooods ($12.09 in chips) 
Akaiso: posts small blind $0.05
luchom87: posts big blind $0.10
*** HOLE CARDS ***
Hop top 77: folds 
bigbadwooods: raises $0.20 to $0.30
Strocub1: folds 
fred00205: folds 
Akaiso: folds 
luchom87: folds 
Uncalled bet ($0.20) returned to bigbadwooods
bigbadwooods collected $0.25 from pot
bigbadwooods: doesn't show hand 
*** SUMMARY ***
Total pot $0.25 | Rake $0 
Seat 1: Strocub1 folded before Flop (didn't bet)
Seat 2: fred00205 (button) folded before Flop (didn't bet)
Seat 3: Akaiso (small blind) folded before Flop
Seat 4: luchom87 (big blind) folded before Flop
Seat 5: Hop top 77 folded before Flop (didn't bet)
Seat 6: bigbadwooods collected ($0.25)



PokerStars Hand #222953627374:  Hold'em No Limit ($0.05/$0.10 USD) - 2021/01/23 8:34:08 ET
Table 'Bohlinia III' 6-max Seat #3 is the button
Seat 1: Strocub1 ($8 in chips) 
Seat 2: fred00205 ($3.91 in chips) 
Seat 3: Akaiso ($2.07 in chips) 
Seat 4: luchom87 ($10.09 in chips) 
Seat 5: Hop top 77 ($13.69 in chips) 
Seat 6: bigbadwooods ($12.24 in chips) 
luchom87: posts small blind $0.05
Hop top 77: posts big blind $0.10
*** HOLE CARDS ***
bigbadwooods: folds 
Strocub1: raises $0.10 to $0.20
fred00205: folds 
Akaiso: calls $0.20
luchom87: folds 
Hop top 77: folds 
*** FLOP *** [5h 3d 9d]
Strocub1: bets $0.27
Akaiso: raises $0.27 to $0.54
Strocub1: calls $0.27
*** TURN *** [5h 3d 9d] [Jh]
Strocub1: checks 
Akaiso: bets $1.33 and is all-in
Strocub1: calls $1.33
*** RIVER *** [5h 3d 9d Jh] [3s]
*** SHOW DOWN ***
Strocub1: shows [Kd Td] (a pair of Threes)
Akaiso: shows [4c 4h] (two pair, Fours and Threes)
Akaiso collected $4.10 from pot
*** SUMMARY ***
Total pot $4.29 | Rake $0.19 
Board [5h 3d 9d Jh 3s]
Seat 1: Strocub1 showed [Kd Td] and lost with a pair of Threes
Seat 2: fred00205 folded before Flop (didn't bet)
Seat 3: Akaiso (button) showed [4c 4h] and won ($4.10) with two pair, Fours and Threes
Seat 4: luchom87 (small blind) folded before Flop
Seat 5: Hop top 77 (big blind) folded before Flop
Seat 6: bigbadwooods folded before Flop (didn't bet)



PokerStars Hand #222953650125:  Hold'em No Limit ($0.05/$0.10 USD) - 2021/01/23 8:34:59 ET
Table 'Bohlinia III' 6-max Seat #4 is the button
Seat 1: Strocub1 ($5.93 in chips) 
Seat 2: fred00205 ($3.91 in chips) 
Seat 3: Akaiso ($4.10 in chips) 
Seat 4: luchom87 ($10.04 in chips) 
Seat 5: Hop top 77 ($13.59 in chips) 
Seat 6: bigbadwooods ($12.24 in chips) 
Hop top 77: posts small blind $0.05
bigbadwooods: posts big blind $0.10
*** HOLE CARDS ***
Strocub1: raises $0.10 to $0.20
fred00205: calls $0.20
Akaiso: folds 
luchom87: folds 
Hop top 77: calls $0.15
bigbadwooods: folds 
*** FLOP *** [Ks 5h 6h]
Hop top 77: checks 
Strocub1: bets $0.34
fred00205: folds 
Hop top 77: folds 
Uncalled bet ($0.34) returned to Strocub1
Strocub1 collected $0.67 from pot
Strocub1: doesn't show hand 
*** SUMMARY ***
Total pot $0.70 | Rake $0.03 
Board [Ks 5h 6h]
Seat 1: Strocub1 collected ($0.67)
Seat 2: fred00205 folded on the Flop
Seat 3: Akaiso folded before Flop (didn't bet)
Seat 4: luchom87 (button) folded before Flop (didn't bet)
Seat 5: Hop top 77 (small blind) folded on the Flop
Seat 6: bigbadwooods (big blind) folded before Flop



PokerStars Hand #222953667043:  Hold'em No Limit ($0.05/$0.10 USD) - 2021/01/23 8:35:37 ET
Table 'Bohlinia III' 6-max Seat #5 is the button
Seat 1: Strocub1 ($10 in chips) 
Seat 2: fred00205 ($3.71 in chips) 
Seat 3: Akaiso ($4.10 in chips) 
Seat 4: luchom87 ($10.04 in chips) 
Seat 5: Hop top 77 ($13.39 in chips) 
Seat 6: bigbadwooods ($12.14 in chips) 
bigbadwooods: posts small blind $0.05
Strocub1: posts big blind $0.10
*** HOLE CARDS ***
fred00205: folds 
Akaiso: folds 
luchom87: folds 
Hop top 77: folds 
bigbadwooods: raises $0.10 to $0.20
Strocub1: calls $0.10
*** FLOP *** [Js 2h 6d]
bigbadwooods: bets $0.20
Strocub1: folds 
Uncalled bet ($0.20) returned to bigbadwooods
bigbadwooods collected $0.38 from pot
bigbadwooods: doesn't show hand 
*** SUMMARY ***
Total pot $0.40 | Rake $0.02 
Board [Js 2h 6d]
Seat 1: Strocub1 (big blind) folded on the Flop
Seat 2: fred00205 folded before Flop (didn't bet)
Seat 3: Akaiso folded before Flop (didn't bet)
Seat 4: luchom87 folded before Flop (didn't bet)
Seat 5: Hop top 77 (button) folded before Flop (didn't bet)
Seat 6: bigbadwooods (small blind) collected ($0.38)



PokerStars Hand #222953678042:  Hold'em No Limit ($0.05/$0.10 USD) - 2021/01/23 8:36:02 ET
Table 'Bohlinia III' 6-max Seat #6 is the button
Seat 1: Strocub1 ($9.80 in chips) 
Seat 2: fred00205 ($3.71 in chips) 
Seat 3: Akaiso ($4.10 in chips) 
Seat 4: luchom87 ($10.04 in chips) 
Seat 5: Hop top 77 ($13.39 in chips) 
Seat 6: bigbadwooods ($12.32 in chips) 
Strocub1: posts small blind $0.05
fred00205: posts big blind $0.10
*** HOLE CARDS ***
Akaiso: calls $0.10
luchom87: folds 
Hop top 77: folds 
bigbadwooods: raises $0.30 to $0.40
Strocub1: folds 
fred00205: folds 
Akaiso: calls $0.30
*** FLOP *** [8d Ts Td]
Akaiso: checks 
bigbadwooods: bets $0.40
Akaiso: calls $0.40
*** TURN *** [8d Ts Td] [Ah]
Akaiso: checks 
bigbadwooods: bets $0.80
Akaiso: calls $0.80
*** RIVER *** [8d Ts Td Ah] [4h]
Akaiso: bets $2.50 and is all-in
bigbadwooods: calls $2.50
*** SHOW DOWN ***
Akaiso: shows [9d Jd] (a pair of Tens)
bigbadwooods: shows [Kh Ad] (two pair, Aces and Tens)
bigbadwooods collected $7.97 from pot
*** SUMMARY ***
Total pot $8.35 | Rake $0.38 
Board [8d Ts Td Ah 4h]
Seat 1: Strocub1 (small blind) folded before Flop
Seat 2: fred00205 (big blind) folded before Flop
Seat 3: Akaiso showed [9d Jd] and lost with a pair of Tens
Seat 4: luchom87 folded before Flop (didn't bet)
Seat 5: Hop top 77 folded before Flop (didn't bet)
Seat 6: bigbadwooods (button) showed [Kh Ad] and won ($7.97) with two pair, Aces and Tens



PokerStars Hand #222953702984:  Hold'em No Limit ($0.05/$0.10 USD) - 2021/01/23 8:36:58 ET
Table 'Bohlinia III' 6-max Seat #1 is the button
Seat 1: Strocub1 ($9.75 in chips) 
Seat 2: fred00205 ($3.61 in chips) 
Seat 4: luchom87 ($10.04 in chips) 
Seat 5: Hop top 77 ($13.39 in chips) 
Seat 6: bigbadwooods ($16.19 in chips) 
fred00205: posts small blind $0.05
luchom87: posts big blind $0.10
*** HOLE CARDS ***
Hop top 77: folds 
Akaiso leaves the table
bigbadwooods: raises $0.10 to $0.20
Strocub1: folds 
Strocub1 leaves the table
fred00205: calls $0.15
luchom87: folds 
*** FLOP *** [Th 6h 2d]
fred00205: checks 
bigbadwooods: bets $0.20
fred00205: folds 
Uncalled bet ($0.20) returned to bigbadwooods
bigbadwooods collected $0.48 from pot
bigbadwooods: doesn't show hand 
supernightman joins the table at seat #3 
*** SUMMARY ***
Total pot $0.50 | Rake $0.02 
Board [Th 6h 2d]
Seat 1: Strocub1 (button) folded before Flop (didn't bet)
Seat 2: fred00205 (small blind) folded on the Flop
Seat 4: luchom87 (big blind) folded before Flop
Seat 5: Hop top 77 folded before Flop (didn't bet)
Seat 6: bigbadwooods collected ($0.48)



PokerStars Hand #222953716937:  Hold'em No Limit ($0.05/$0.10 USD) - 2021/01/23 8:37:29 ET
Table 'Bohlinia III' 6-max Seat #2 is the button
Seat 2: fred00205 ($3.41 in chips) 
Seat 4: luchom87 ($10 in chips) 
Seat 5: Hop top 77 ($13.39 in chips) 
Seat 6: bigbadwooods ($16.47 in chips) 
luchom87: posts small blind $0.05
Hop top 77: posts big blind $0.10
*** HOLE CARDS ***
mikeyd1172 joins the table at seat #1 
bigbadwooods: folds 
fred00205: folds 
luchom87: folds 
Uncalled bet ($0.05) returned to Hop top 77
Hop top 77 collected $0.10 from pot
Hop top 77: doesn't show hand 
*** SUMMARY ***
Total pot $0.10 | Rake $0 
Seat 2: fred00205 (button) folded before Flop (didn't bet)
Seat 4: luchom87 (small blind) folded before Flop
Seat 5: Hop top 77 (big blind) collected ($0.10)
Seat 6: bigbadwooods folded before Flop (didn't bet)



PokerStars Hand #222953720074:  Hold'em No Limit ($0.05/$0.10 USD) - 2021/01/23 8:37:37 ET
Table 'Bohlinia III' 6-max Seat #4 is the button
Seat 2: fred00205 ($3.41 in chips) 
Seat 4: luchom87 ($10 in chips) 
Seat 5: Hop top 77 ($13.44 in chips) 
Seat 6: bigbadwooods ($16.47 in chips) 
Hop top 77: posts small blind $0.05
bigbadwooods: posts big blind $0.10
mikeyd1172: sits out 
supernightman: sits out 
*** HOLE CARDS ***
fred00205: folds 
luchom87: folds 
Hop top 77: raises $0.20 to $0.30
bigbadwooods: raises $0.60 to $0.90
Hop top 77: folds 
Uncalled bet ($0.60) returned to bigbadwooods
bigbadwooods collected $0.60 from pot
bigbadwooods: doesn't show hand 
*** SUMMARY ***
Total pot $0.60 | Rake $0 
Seat 2: fred00205 folded before Flop (didn't bet)
Seat 4: luchom87 (button) folded before Flop (didn't bet)
Seat 5: Hop top 77 (small blind) folded before Flop
Seat 6: bigbadwooods (big blind) collected ($0.60)



PokerStars Hand #222953730339:  Hold'em No Limit ($0.05/$0.10 USD) - 2021/01/23 8:38:00 ET
Table 'Bohlinia III' 6-max Seat #5 is the button
Seat 1: mikeyd1172 ($8 in chips) 
Seat 2: fred00205 ($3.41 in chips) 
Seat 4: luchom87 ($10 in chips) 
Seat 5: Hop top 77 ($13.14 in chips) 
Seat 6: bigbadwooods ($16.77 in chips) 
bigbadwooods: posts small blind $0.05
mikeyd1172: posts big blind $0.10
supernightman: sits out 
*** HOLE CARDS ***
fred00205: folds 
luchom87: folds 
Hop top 77: raises $0.15 to $0.25
bigbadwooods: folds 
mikeyd1172: folds 
Uncalled bet ($0.15) returned to Hop top 77
Hop top 77 collected $0.25 from pot
Hop top 77: doesn't show hand 
*** SUMMARY ***
Total pot $0.25 | Rake $0 
Seat 1: mikeyd1172 (big blind) folded before Flop
Seat 2: fred00205 folded before Flop (didn't bet)
Seat 4: luchom87 folded before Flop (didn't bet)
Seat 5: Hop top 77 (button) collected ($0.25)
Seat 6: bigbadwooods (small blind) folded before Flop



PokerStars Hand #222953740688:  Hold'em No Limit ($0.05/$0.10 USD) - 2021/01/23 8:38:23 ET
Table 'Bohlinia III' 6-max Seat #6 is the button
Seat 1: mikeyd1172 ($7.90 in chips) 
Seat 2: fred00205 ($3.41 in chips) 
Seat 4: luchom87 ($10 in chips) 
Seat 5: Hop top 77 ($13.29 in chips) 
Seat 6: bigbadwooods ($16.72 in chips) 
mikeyd1172: posts small blind $0.05
fred00205: posts big blind $0.10
supernightman: sits out 
*** HOLE CARDS ***
luchom87: folds 
Hop top 77: folds 
bigbadwooods: raises $0.10 to $0.20
mikeyd1172: calls $0.15
fred00205: calls $0.10
*** FLOP *** [5c 9h Kc]
mikeyd1172: checks 
fred00205: checks 
bigbadwooods: bets $0.30
mikeyd1172: calls $0.30
fred00205: calls $0.30
*** TURN *** [5c 9h Kc] [As]
mikeyd1172: checks 
fred00205: checks 
bigbadwooods: checks 
*** RIVER *** [5c 9h Kc As] [Ac]
mikeyd1172: checks 
fred00205: checks 
bigbadwooods: checks 
*** SHOW DOWN ***
mikeyd1172: shows [Td 2d] (a pair of Aces)
fred00205: mucks hand 
bigbadwooods: shows [Th Ks] (two pair, Aces and Kings)
bigbadwooods collected $1.43 from pot
*** SUMMARY ***
Total pot $1.50 | Rake $0.07 
Board [5c 9h Kc As Ac]
Seat 1: mikeyd1172 (small blind) showed [Td 2d] and lost with a pair of Aces
Seat 2: fred00205 (big blind) mucked
Seat 4: luchom87 folded before Flop (didn't bet)
Seat 5: Hop top 77 folded before Flop (didn't bet)
Seat 6: bigbadwooods (button) showed [Th Ks] and won ($1.43) with two pair, Aces and Kings



PokerStars Hand #222953761590:  Hold'em No Limit ($0.05/$0.10 USD) - 2021/01/23 8:39:10 ET
Table 'Bohlinia III' 6-max Seat #1 is the button
Seat 1: mikeyd1172 ($7.40 in chips) 
Seat 2: fred00205 ($2.91 in chips) 
Seat 3: supernightman ($10 in chips) 
Seat 4: luchom87 ($10 in chips) 
Seat 5: Hop top 77 ($13.29 in chips) 
Seat 6: bigbadwooods ($17.65 in chips) 
fred00205: posts small blind $0.05
supernightman: posts big blind $0.10
*** HOLE CARDS ***
luchom87: folds 
Hop top 77: folds 
bigbadwooods: folds 
mikeyd1172: folds 
fred00205: folds 
Uncalled bet ($0.05) returned to supernightman
supernightman collected $0.10 from pot
*** SUMMARY ***
Total pot $0.10 | Rake $0 
Seat 1: mikeyd1172 (button) folded before Flop (didn't bet)
Seat 2: fred00205 (small blind) folded before Flop
Seat 3: supernightman (big blind) collected ($0.10)
Seat 4: luchom87 folded before Flop (didn't bet)
Seat 5: Hop top 77 folded before Flop (didn't bet)
Seat 6: bigbadwooods folded before Flop (didn't bet)



PokerStars Hand #222953766769:  Hold'em No Limit ($0.05/$0.10 USD) - 2021/01/23 8:39:21 ET
Table 'Bohlinia III' 6-max Seat #2 is the button
Seat 1: mikeyd1172 ($7.40 in chips) 
Seat 2: fred00205 ($2.86 in chips) 
Seat 3: supernightman ($10.05 in chips) 
Seat 4: luchom87 ($10 in chips) 
Seat 5: Hop top 77 ($13.29 in chips) 
Seat 6: bigbadwooods ($17.65 in chips) 
supernightman: posts small blind $0.05
luchom87: posts big blind $0.10
*** HOLE CARDS ***
Hop top 77: folds 
bigbadwooods: folds 
mikeyd1172: folds 
fred00205: calls $0.10
supernightman: raises $0.30 to $0.40
luchom87: folds 
fred00205: calls $0.30
*** FLOP *** [3s 9h Th]
supernightman: bets $0.65
fred00205: folds 
Uncalled bet ($0.65) returned to supernightman
supernightman collected $0.86 from pot
*** SUMMARY ***
Total pot $0.90 | Rake $0.04 
Board [3s 9h Th]
Seat 1: mikeyd1172 folded before Flop (didn't bet)
Seat 2: fred00205 (button) folded on the Flop
Seat 3: supernightman (small blind) collected ($0.86)
Seat 4: luchom87 (big blind) folded before Flop
Seat 5: Hop top 77 folded before Flop (didn't bet)
Seat 6: bigbadwooods folded before Flop (didn't bet)



PokerStars Hand #222953783624:  Hold'em No Limit ($0.05/$0.10 USD) - 2021/01/23 8:39:59 ET
Table 'Bohlinia III' 6-max Seat #3 is the button
Seat 1: mikeyd1172 ($7.40 in chips) 
Seat 2: fred00205 ($2.46 in chips) 
Seat 3: supernightman ($10.51 in chips) 
Seat 4: luchom87 ($10 in chips) 
Seat 5: Hop top 77 ($13.29 in chips) 
Seat 6: bigbadwooods ($17.65 in chips) 
luchom87: posts small blind $0.05
Hop top 77: posts big blind $0.10
*** HOLE CARDS ***
bigbadwooods: raises $0.20 to $0.30
mikeyd1172: folds 
fred00205: calls $0.30
supernightman: folds 
luchom87: folds 
Hop top 77: folds 
*** FLOP *** [2h 5h 8h]
bigbadwooods: bets $0.30
fred00205: calls $0.30
*** TURN *** [2h 5h 8h] [Tc]
bigbadwooods: checks 
fred00205: bets $1.86 and is all-in
bigbadwooods: folds 
Uncalled bet ($1.86) returned to fred00205
fred00205 collected $1.29 from pot
fred00205: doesn't show hand 
*** SUMMARY ***
Total pot $1.35 | Rake $0.06 
Board [2h 5h 8h Tc]
Seat 1: mikeyd1172 folded before Flop (didn't bet)
Seat 2: fred00205 collected ($1.29)
Seat 3: supernightman (button) folded before Flop (didn't bet)
Seat 4: luchom87 (small blind) folded before Flop
Seat 5: Hop top 77 (big blind) folded before Flop
Seat 6: bigbadwooods folded on the Turn



PokerStars Hand #222953803032:  Hold'em No Limit ($0.05/$0.10 USD) - 2021/01/23 8:40:42 ET
Table 'Bohlinia III' 6-max Seat #4 is the button
Seat 1: mikeyd1172 ($7.40 in chips) 
Seat 2: fred00205 ($3.15 in chips) 
Seat 3: supernightman ($10.51 in chips) 
Seat 4: luchom87 ($10 in chips) 
Seat 5: Hop top 77 ($13.19 in chips) 
Seat 6: bigbadwooods ($17.05 in chips) 
Hop top 77: posts small blind $0.05
bigbadwooods: posts big blind $0.10
*** HOLE CARDS ***
mikeyd1172: calls $0.10
fred00205: folds 
supernightman: raises $0.20 to $0.30
luchom87: folds 
Hop top 77: folds 
bigbadwooods: calls $0.20
mikeyd1172: calls $0.20
*** FLOP *** [6c 9h 8s]
bigbadwooods: checks 
mikeyd1172: checks 
supernightman: checks 
*** TURN *** [6c 9h 8s] [Js]
bigbadwooods: checks 
mikeyd1172: checks 
supernightman: checks 
*** RIVER *** [6c 9h 8s Js] [Qc]
bigbadwooods: checks 
mikeyd1172: bets $0.50
supernightman: folds 
bigbadwooods: folds 
Uncalled bet ($0.50) returned to mikeyd1172
mikeyd1172 collected $0.91 from pot
mikeyd1172: doesn't show hand 
*** SUMMARY ***
Total pot $0.95 | Rake $0.04 
Board [6c 9h 8s Js Qc]
Seat 1: mikeyd1172 collected ($0.91)
Seat 2: fred00205 folded before Flop (didn't bet)
Seat 3: supernightman folded on the River
Seat 4: luchom87 (button) folded before Flop (didn't bet)
Seat 5: Hop top 77 (small blind) folded before Flop
Seat 6: bigbadwooods (big blind) folded on the River



PokerStars Hand #222953824409:  Hold'em No Limit ($0.05/$0.10 USD) - 2021/01/23 8:41:30 ET
Table 'Bohlinia III' 6-max Seat #5 is the button
Seat 1: mikeyd1172 ($8.01 in chips) 
Seat 2: fred00205 ($3.15 in chips) 
Seat 3: supernightman ($10.21 in chips) 
Seat 4: luchom87 ($10 in chips) 
Seat 5: Hop top 77 ($13.14 in chips) 
Seat 6: bigbadwooods ($16.75 in chips) 
bigbadwooods: posts small blind $0.05
mikeyd1172: posts big blind $0.10
*** HOLE CARDS ***
fred00205: folds 
supernightman: folds 
luchom87: raises $0.20 to $0.30
Hop top 77: folds 
bigbadwooods: folds 
mikeyd1172: calls $0.20
*** FLOP *** [3d Kh Jc]
mikeyd1172: checks 
luchom87: checks 
*** TURN *** [3d Kh Jc] [4h]
mikeyd1172: checks 
luchom87: bets $0.22
mikeyd1172: calls $0.22
*** RIVER *** [3d Kh Jc 4h] [7d]
mikeyd1172: bets $0.50
luchom87: folds 
Uncalled bet ($0.50) returned to mikeyd1172
mikeyd1172 collected $1.04 from pot
mikeyd1172: doesn't show hand 
*** SUMMARY ***
Total pot $1.09 | Rake $0.05 
Board [3d Kh Jc 4h 7d]
Seat 1: mikeyd1172 (big blind) collected ($1.04)
Seat 2: fred00205 folded before Flop (didn't bet)
Seat 3: supernightman folded before Flop (didn't bet)
Seat 4: luchom87 folded on the River
Seat 5: Hop top 77 (button) folded before Flop (didn't bet)
Seat 6: bigbadwooods (small blind) folded before Flop



PokerStars Hand #222953854354:  Hold'em No Limit ($0.05/$0.10 USD) - 2021/01/23 8:42:34 ET
Table 'Bohlinia III' 6-max Seat #6 is the button
Seat 1: mikeyd1172 ($8.53 in chips) 
Seat 2: fred00205 ($3.15 in chips) 
Seat 3: supernightman ($10.21 in chips) 
Seat 4: luchom87 ($10 in chips) 
Seat 5: Hop top 77 ($13.14 in chips) 
Seat 6: bigbadwooods ($16.70 in chips) 
mikeyd1172: posts small blind $0.05
fred00205: posts big blind $0.10
*** HOLE CARDS ***
supernightman: folds 
luchom87: folds 
Hop top 77: raises $0.20 to $0.30
bigbadwooods: folds 
mikeyd1172: folds 
fred00205: calls $0.20
*** FLOP *** [As 4h 3s]
fred00205: checks 
Hop top 77: bets $0.41
fred00205: folds 
Uncalled bet ($0.41) returned to Hop top 77
Hop top 77 collected $0.62 from pot
Hop top 77: doesn't show hand 
*** SUMMARY ***
Total pot $0.65 | Rake $0.03 
Board [As 4h 3s]
Seat 1: mikeyd1172 (small blind) folded before Flop
Seat 2: fred00205 (big blind) folded on the Flop
Seat 3: supernightman folded before Flop (didn't bet)
Seat 4: luchom87 folded before Flop (didn't bet)
Seat 5: Hop top 77 collected ($0.62)
Seat 6: bigbadwooods (button) folded before Flop (didn't bet)



PokerStars Hand #222954092967:  Hold'em No Limit ($0.05/$0.10 USD) - 2021/01/23 8:51:20 ET
Table 'Bohlinia III' 6-max Seat #3 is the button
Seat 1: mikeyd1172 ($8.42 in chips) 
Seat 2: fred00205 ($5.44 in chips) 
Seat 3: supernightman ($8.17 in chips) 
Seat 4: luchom87 ($15.22 in chips) 
Seat 5: Kimi1892 ($10.65 in chips) 
Seat 6: bigbadwooods ($18.27 in chips) 
luchom87: posts small blind $0.05
Kimi1892: posts big blind $0.10
*** HOLE CARDS ***
bigbadwooods: folds 
mikeyd1172: folds 
fred00205: folds 
supernightman: folds 
luchom87: folds 
Uncalled bet ($0.05) returned to Kimi1892
Kimi1892 collected $0.10 from pot
Kimi1892: doesn't show hand 
*** SUMMARY ***
Total pot $0.10 | Rake $0 
Seat 1: mikeyd1172 folded before Flop (didn't bet)
Seat 2: fred00205 folded before Flop (didn't bet)
Seat 3: supernightman (button) folded before Flop (didn't bet)
Seat 4: luchom87 (small blind) folded before Flop
Seat 5: Kimi1892 (big blind) collected ($0.10)
Seat 6: bigbadwooods folded before Flop (didn't bet)



PokerStars Hand #222954099545:  Hold'em No Limit ($0.05/$0.10 USD) - 2021/01/23 8:51:34 ET
Table 'Bohlinia III' 6-max Seat #4 is the button
Seat 1: mikeyd1172 ($8.42 in chips) 
Seat 2: fred00205 ($5.44 in chips) 
Seat 3: supernightman ($8.17 in chips) 
Seat 4: luchom87 ($15.17 in chips) 
Seat 5: Kimi1892 ($10.70 in chips) 
Seat 6: bigbadwooods ($18.27 in chips) 
Kimi1892: posts small blind $0.05
bigbadwooods: posts big blind $0.10
*** HOLE CARDS ***
mikeyd1172: calls $0.10
fred00205: folds 
supernightman: folds 
luchom87: folds 
Kimi1892: folds 
bigbadwooods: checks 
*** FLOP *** [As 2h Js]
bigbadwooods: checks 
mikeyd1172: checks 
*** TURN *** [As 2h Js] [4s]
bigbadwooods: checks 
mikeyd1172: checks 
*** RIVER *** [As 2h Js 4s] [7c]
bigbadwooods: checks 
mikeyd1172: checks 
*** SHOW DOWN ***
bigbadwooods: shows [9c 5c] (high card Ace)
mikeyd1172: shows [Kh 9s] (high card Ace - King kicker)
mikeyd1172 collected $0.24 from pot
*** SUMMARY ***
Total pot $0.25 | Rake $0.01 
Board [As 2h Js 4s 7c]
Seat 1: mikeyd1172 showed [Kh 9s] and won ($0.24) with high card Ace
Seat 2: fred00205 folded before Flop (didn't bet)
Seat 3: supernightman folded before Flop (didn't bet)
Seat 4: luchom87 (button) folded before Flop (didn't bet)
Seat 5: Kimi1892 (small blind) folded before Flop
Seat 6: bigbadwooods (big blind) showed [9c 5c] and lost with high card Ace



PokerStars Hand #222954112416:  Hold'em No Limit ($0.05/$0.10 USD) - 2021/01/23 8:52:03 ET
Table 'Bohlinia III' 6-max Seat #5 is the button
Seat 1: mikeyd1172 ($8.56 in chips) 
Seat 2: fred00205 ($5.44 in chips) 
Seat 3: supernightman ($8.17 in chips) 
Seat 4: luchom87 ($15.17 in chips) 
Seat 5: Kimi1892 ($10.65 in chips) 
Seat 6: bigbadwooods ($18.17 in chips) 
bigbadwooods: posts small blind $0.05
mikeyd1172: posts big blind $0.10
*** HOLE CARDS ***
fred00205: calls $0.10
supernightman has timed out
supernightman: folds 
luchom87: folds 
Kimi1892: folds 
bigbadwooods: raises $0.20 to $0.30
mikeyd1172: calls $0.20
fred00205: calls $0.20
*** FLOP *** [8d 9c Th]
bigbadwooods: checks 
mikeyd1172: checks 
fred00205: checks 
*** TURN *** [8d 9c Th] [6c]
bigbadwooods: checks 
mikeyd1172: checks 
fred00205: checks 
*** RIVER *** [8d 9c Th 6c] [5h]
bigbadwooods: checks 
mikeyd1172: checks 
fred00205: bets $0.30
bigbadwooods: raises $1.20 to $1.50
mikeyd1172: folds 
fred00205: calls $1.20
*** SHOW DOWN ***
bigbadwooods: shows [Jh Qc] (a straight, Eight to Queen)
fred00205: mucks hand 
bigbadwooods collected $3.72 from pot
*** SUMMARY ***
Total pot $3.90 | Rake $0.18 
Board [8d 9c Th 6c 5h]
Seat 1: mikeyd1172 (big blind) folded on the River
Seat 2: fred00205 mucked
Seat 3: supernightman folded before Flop (didn't bet)
Seat 4: luchom87 folded before Flop (didn't bet)
Seat 5: Kimi1892 (button) folded before Flop (didn't bet)
Seat 6: bigbadwooods (small blind) showed [Jh Qc] and won ($3.72) with a straight, Eight to Queen



PokerStars Hand #222954136430:  Hold'em No Limit ($0.05/$0.10 USD) - 2021/01/23 8:52:56 ET
Table 'Bohlinia III' 6-max Seat #6 is the button
Seat 1: mikeyd1172 ($8.26 in chips) 
Seat 2: fred00205 ($3.64 in chips) 
Seat 3: supernightman ($8.17 in chips) 
Seat 4: luchom87 ($15.17 in chips) 
Seat 5: Kimi1892 ($10.65 in chips) 
Seat 6: bigbadwooods ($20.09 in chips) 
mikeyd1172: posts small blind $0.05
fred00205: posts big blind $0.10
*** HOLE CARDS ***
supernightman: folds 
luchom87: folds 
Kimi1892: folds 
bigbadwooods: raises $0.10 to $0.20
mikeyd1172: folds 
fred00205: calls $0.10
*** FLOP *** [3c 4h 5h]
fred00205: checks 
bigbadwooods: bets $0.20
fred00205: folds 
Uncalled bet ($0.20) returned to bigbadwooods
bigbadwooods collected $0.43 from pot
bigbadwooods: doesn't show hand 
*** SUMMARY ***
Total pot $0.45 | Rake $0.02 
Board [3c 4h 5h]
Seat 1: mikeyd1172 (small blind) folded before Flop
Seat 2: fred00205 (big blind) folded on the Flop
Seat 3: supernightman folded before Flop (didn't bet)
Seat 4: luchom87 folded before Flop (didn't bet)
Seat 5: Kimi1892 folded before Flop (didn't bet)
Seat 6: bigbadwooods (button) collected ($0.43)



PokerStars Hand #222954148280:  Hold'em No Limit ($0.05/$0.10 USD) - 2021/01/23 8:53:22 ET
Table 'Bohlinia III' 6-max Seat #1 is the button
Seat 1: mikeyd1172 ($8.21 in chips) 
Seat 2: fred00205 ($3.44 in chips) 
Seat 3: supernightman ($8.17 in chips) 
Seat 4: luchom87 ($15.17 in chips) 
Seat 5: Kimi1892 ($10.65 in chips) 
Seat 6: bigbadwooods ($20.32 in chips) 
fred00205: posts small blind $0.05
supernightman: posts big blind $0.10
*** HOLE CARDS ***
luchom87: raises $0.20 to $0.30
Kimi1892: folds 
bigbadwooods: calls $0.30
mikeyd1172: calls $0.30
fred00205: calls $0.25
supernightman: folds 
*** FLOP *** [9s 5h Qc]
fred00205: checks 
luchom87: bets $0.95
bigbadwooods: folds 
mikeyd1172: folds 
fred00205: folds 
Uncalled bet ($0.95) returned to luchom87
luchom87 collected $1.24 from pot
luchom87: doesn't show hand 
*** SUMMARY ***
Total pot $1.30 | Rake $0.06 
Board [9s 5h Qc]
Seat 1: mikeyd1172 (button) folded on the Flop
Seat 2: fred00205 (small blind) folded on the Flop
Seat 3: supernightman (big blind) folded before Flop
Seat 4: luchom87 collected ($1.24)
Seat 5: Kimi1892 folded before Flop (didn't bet)
Seat 6: bigbadwooods folded on the Flop



PokerStars Hand #222954164764:  Hold'em No Limit ($0.05/$0.10 USD) - 2021/01/23 8:53:58 ET
Table 'Bohlinia III' 6-max Seat #2 is the button
Seat 1: mikeyd1172 ($7.91 in chips) 
Seat 2: fred00205 ($3.14 in chips) 
Seat 3: supernightman ($8.07 in chips) 
Seat 4: luchom87 ($16.11 in chips) 
Seat 5: Kimi1892 ($10.65 in chips) 
Seat 6: bigbadwooods ($20.02 in chips) 
supernightman: posts small blind $0.05
luchom87: posts big blind $0.10
*** HOLE CARDS ***
Kimi1892: raises $0.20 to $0.30
bigbadwooods: folds 
mikeyd1172: raises $0.20 to $0.50
fred00205: folds 
supernightman: raises $0.70 to $1.20
luchom87: folds 
Kimi1892: folds 
mikeyd1172: calls $0.70
*** FLOP *** [Ks Th Td]
supernightman: bets $1.34
mikeyd1172: calls $1.34
*** TURN *** [Ks Th Td] [3s]
supernightman: bets $2.62
mikeyd1172: calls $2.62
*** RIVER *** [Ks Th Td 3s] [5s]
supernightman: bets $2.91 and is all-in
mikeyd1172: calls $2.75 and is all-in
Uncalled bet ($0.16) returned to supernightman
*** SHOW DOWN ***
supernightman: shows [Ad Kd] (two pair, Kings and Tens)
mikeyd1172: shows [Qs Ts] (a flush, King high)
mikeyd1172 collected $15.49 from pot
*** SUMMARY ***
Total pot $16.22 | Rake $0.73 
Board [Ks Th Td 3s 5s]
Seat 1: mikeyd1172 showed [Qs Ts] and won ($15.49) with a flush, King high
Seat 2: fred00205 (button) folded before Flop (didn't bet)
Seat 3: supernightman (small blind) showed [Ad Kd] and lost with two pair, Kings and Tens
Seat 4: luchom87 (big blind) folded before Flop
Seat 5: Kimi1892 folded before Flop
Seat 6: bigbadwooods folded before Flop (didn't bet)



PokerStars Hand #222954198333:  Hold'em No Limit ($0.05/$0.10 USD) - 2021/01/23 8:55:02 ET
Table 'Bohlinia III' 6-max Seat #3 is the button
Seat 1: mikeyd1172 ($15.49 in chips) 
Seat 2: fred00205 ($3.14 in chips) 
Seat 3: supernightman ($0.16 in chips) 
Seat 4: luchom87 ($16.01 in chips) 
Seat 5: Kimi1892 ($10.35 in chips) 
Seat 6: bigbadwooods ($20.02 in chips) 
luchom87: posts small blind $0.05
Kimi1892: posts big blind $0.10
*** HOLE CARDS ***
bigbadwooods: folds 
mikeyd1172: folds 
fred00205: folds 
supernightman: folds 
luchom87: folds 
Uncalled bet ($0.05) returned to Kimi1892
Kimi1892 collected $0.10 from pot
Kimi1892: doesn't show hand 
*** SUMMARY ***
Total pot $0.10 | Rake $0 
Seat 1: mikeyd1172 folded before Flop (didn't bet)
Seat 2: fred00205 folded before Flop (didn't bet)
Seat 3: supernightman (button) folded before Flop (didn't bet)
Seat 4: luchom87 (small blind) folded before Flop
Seat 5: Kimi1892 (big blind) collected ($0.10)
Seat 6: bigbadwooods folded before Flop (didn't bet)



PokerStars Hand #222954206732:  Hold'em No Limit ($0.05/$0.10 USD) - 2021/01/23 8:55:24 ET
Table 'Bohlinia III' 6-max Seat #4 is the button
Seat 1: mikeyd1172 ($15.49 in chips) 
Seat 2: fred00205 ($3.14 in chips) 
Seat 3: supernightman ($10 in chips) 
Seat 4: luchom87 ($15.96 in chips) 
Seat 5: Kimi1892 ($10.40 in chips) 
Seat 6: bigbadwooods ($20.02 in chips) 
Kimi1892: posts small blind $0.05
bigbadwooods: posts big blind $0.10
*** HOLE CARDS ***
mikeyd1172: folds 
fred00205: folds 
supernightman: raises $0.20 to $0.30
luchom87: folds 
Kimi1892: raises $0.90 to $1.20
bigbadwooods: folds 
supernightman: calls $0.90
*** FLOP *** [2h 2c As]
Kimi1892: checks 
supernightman: checks 
*** TURN *** [2h 2c As] [9d]
Kimi1892: checks 
supernightman: checks 
*** RIVER *** [2h 2c As 9d] [Ah]
Kimi1892: checks 
supernightman: checks 
*** SHOW DOWN ***
Kimi1892: shows [8d 8h] (two pair, Aces and Eights)
supernightman: mucks hand 
Kimi1892 collected $2.39 from pot
*** SUMMARY ***
Total pot $2.50 | Rake $0.11 
Board [2h 2c As 9d Ah]
Seat 1: mikeyd1172 folded before Flop (didn't bet)
Seat 2: fred00205 folded before Flop (didn't bet)
Seat 3: supernightman mucked
Seat 4: luchom87 (button) folded before Flop (didn't bet)
Seat 5: Kimi1892 (small blind) showed [8d 8h] and won ($2.39) with two pair, Aces and Eights
Seat 6: bigbadwooods (big blind) folded before Flop



PokerStars Hand #222954220553:  Hold'em No Limit ($0.05/$0.10 USD) - 2021/01/23 8:56:02 ET
Table 'Bohlinia III' 6-max Seat #5 is the button
Seat 1: mikeyd1172 ($15.49 in chips) 
Seat 2: fred00205 ($3.14 in chips) 
Seat 3: supernightman ($8.80 in chips) 
Seat 5: Kimi1892 ($11.59 in chips) 
Seat 6: bigbadwooods ($19.92 in chips) 
bigbadwooods: posts small blind $0.05
mikeyd1172: posts big blind $0.10
*** HOLE CARDS ***
fred00205: folds 
supernightman: folds 
Kimi1892: folds 
bigbadwooods: folds 
Uncalled bet ($0.05) returned to mikeyd1172
mikeyd1172 collected $0.10 from pot
mikeyd1172: doesn't show hand 
*** SUMMARY ***
Total pot $0.10 | Rake $0 
Seat 1: mikeyd1172 (big blind) collected ($0.10)
Seat 2: fred00205 folded before Flop (didn't bet)
Seat 3: supernightman folded before Flop (didn't bet)
Seat 5: Kimi1892 (button) folded before Flop (didn't bet)
Seat 6: bigbadwooods (small blind) folded before Flop



PokerStars Hand #222954223097:  Hold'em No Limit ($0.05/$0.10 USD) - 2021/01/23 8:56:09 ET
Table 'Bohlinia III' 6-max Seat #6 is the button
Seat 1: mikeyd1172 ($15.54 in chips) 
Seat 2: fred00205 ($3.14 in chips) 
Seat 3: supernightman ($8.80 in chips) 
Seat 5: Kimi1892 ($11.59 in chips) 
Seat 6: bigbadwooods ($19.87 in chips) 
mikeyd1172: posts small blind $0.05
fred00205: posts big blind $0.10
*** HOLE CARDS ***
supernightman: folds 
Kimi1892: folds 
bigbadwooods: folds 
mikeyd1172: calls $0.05
fred00205: checks 
*** FLOP *** [8d 8c 4c]
mikeyd1172: checks 
fred00205: checks 
*** TURN *** [8d 8c 4c] [2h]
mikeyd1172: checks 
fred00205: checks 
*** RIVER *** [8d 8c 4c 2h] [8s]
mikeyd1172: checks 
fred00205: checks 
*** SHOW DOWN ***
mikeyd1172: shows [Kd 9h] (three of a kind, Eights)
fred00205: mucks hand 
mikeyd1172 collected $0.19 from pot
*** SUMMARY ***
Total pot $0.20 | Rake $0.01 
Board [8d 8c 4c 2h 8s]
Seat 1: mikeyd1172 (small blind) showed [Kd 9h] and won ($0.19) with three of a kind, Eights
Seat 2: fred00205 (big blind) mucked
Seat 3: supernightman folded before Flop (didn't bet)
Seat 5: Kimi1892 folded before Flop (didn't bet)
Seat 6: bigbadwooods (button) folded before Flop (didn't bet)



PokerStars Hand #222954237116:  Hold'em No Limit ($0.05/$0.10 USD) - 2021/01/23 8:56:48 ET
Table 'Bohlinia III' 6-max Seat #1 is the button
Seat 1: mikeyd1172 ($15.63 in chips) 
Seat 2: fred00205 ($3.04 in chips) 
Seat 3: supernightman ($10 in chips) 
Seat 5: Kimi1892 ($11.59 in chips) 
Seat 6: bigbadwooods ($19.87 in chips) 
fred00205: posts small blind $0.05
supernightman: posts big blind $0.10
*** HOLE CARDS ***
Kimi1892: folds 
bigbadwooods: folds 
mikeyd1172: raises $0.10 to $0.20
fred00205: calls $0.15
supernightman: folds 
*** FLOP *** [6h Ac Qs]
fred00205: checks 
mikeyd1172: bets $0.40
fred00205: folds 
Uncalled bet ($0.40) returned to mikeyd1172
mikeyd1172 collected $0.48 from pot
mikeyd1172: doesn't show hand 
*** SUMMARY ***
Total pot $0.50 | Rake $0.02 
Board [6h Ac Qs]
Seat 1: mikeyd1172 (button) collected ($0.48)
Seat 2: fred00205 (small blind) folded on the Flop
Seat 3: supernightman (big blind) folded before Flop
Seat 5: Kimi1892 folded before Flop (didn't bet)
Seat 6: bigbadwooods folded before Flop (didn't bet)



PokerStars Hand #222954248526:  Hold'em No Limit ($0.05/$0.10 USD) - 2021/01/23 8:57:19 ET
Table 'Bohlinia III' 6-max Seat #2 is the button
Seat 1: mikeyd1172 ($15.91 in chips) 
Seat 2: fred00205 ($2.84 in chips) 
Seat 3: supernightman ($9.90 in chips) 
Seat 5: Kimi1892 ($11.59 in chips) 
Seat 6: bigbadwooods ($19.87 in chips) 
supernightman: posts small blind $0.05
Kimi1892: posts big blind $0.10
*** HOLE CARDS ***
bigbadwooods has timed out
bigbadwooods: folds 
mikeyd1172: folds 
fred00205: folds 
supernightman: folds 
Uncalled bet ($0.05) returned to Kimi1892
Kimi1892 collected $0.10 from pot
Kimi1892: doesn't show hand 
*** SUMMARY ***
Total pot $0.10 | Rake $0 
Seat 1: mikeyd1172 folded before Flop (didn't bet)
Seat 2: fred00205 (button) folded before Flop (didn't bet)
Seat 3: supernightman (small blind) folded before Flop
Seat 5: Kimi1892 (big blind) collected ($0.10)
Seat 6: bigbadwooods folded before Flop (didn't bet)



PokerStars Hand #222954254890:  Hold'em No Limit ($0.05/$0.10 USD) - 2021/01/23 8:57:36 ET
Table 'Bohlinia III' 6-max Seat #3 is the button
Seat 1: mikeyd1172 ($15.91 in chips) 
Seat 2: fred00205 ($2.84 in chips) 
Seat 3: supernightman ($9.85 in chips) 
Seat 5: Kimi1892 ($11.64 in chips) 
Kimi1892: posts small blind $0.05
mikeyd1172: posts big blind $0.10
*** HOLE CARDS ***
fred00205: folds 
supernightman: folds 
Kimi1892: folds 
Uncalled bet ($0.05) returned to mikeyd1172
mikeyd1172 collected $0.10 from pot
mikeyd1172: doesn't show hand 
*** SUMMARY ***
Total pot $0.10 | Rake $0 
Seat 1: mikeyd1172 (big blind) collected ($0.10)
Seat 2: fred00205 folded before Flop (didn't bet)
Seat 3: supernightman (button) folded before Flop (didn't bet)
Seat 5: Kimi1892 (small blind) folded before Flop



PokerStars Hand #222954260097:  Hold'em No Limit ($0.05/$0.10 USD) - 2021/01/23 8:57:51 ET
Table 'Bohlinia III' 6-max Seat #5 is the button
Seat 1: mikeyd1172 ($15.96 in chips) 
Seat 2: fred00205 ($2.84 in chips) 
Seat 3: supernightman ($9.85 in chips) 
Seat 5: Kimi1892 ($11.59 in chips) 
mikeyd1172: posts small blind $0.05
fred00205: posts big blind $0.10
*** HOLE CARDS ***
supernightman: raises $0.20 to $0.30
Kimi1892: calls $0.30
mikeyd1172: calls $0.25
fred00205: calls $0.20
*** FLOP *** [Qd 7d 8d]
mikeyd1172: bets $0.10
fred00205: calls $0.10
supernightman: folds 
Kimi1892: calls $0.10
*** TURN *** [Qd 7d 8d] [9s]
mikeyd1172: checks 
fred00205: checks 
Kimi1892: checks 
*** RIVER *** [Qd 7d 8d 9s] [3h]
mikeyd1172: bets $0.30
fred00205: folds 
Kimi1892: folds 
Uncalled bet ($0.30) returned to mikeyd1172
mikeyd1172 collected $1.43 from pot
mikeyd1172: doesn't show hand 
*** SUMMARY ***
Total pot $1.50 | Rake $0.07 
Board [Qd 7d 8d 9s 3h]
Seat 1: mikeyd1172 (small blind) collected ($1.43)
Seat 2: fred00205 (big blind) folded on the River
Seat 3: supernightman folded on the Flop
Seat 5: Kimi1892 (button) folded on the River



PokerStars Hand #222954281645:  Hold'em No Limit ($0.05/$0.10 USD) - 2021/01/23 8:58:50 ET
Table 'Bohlinia III' 6-max Seat #1 is the button
Seat 1: mikeyd1172 ($16.99 in chips) 
Seat 2: fred00205 ($2.44 in chips) 
Seat 3: supernightman ($9.55 in chips) 
Seat 5: Kimi1892 ($11.19 in chips) 
Seat 6: bigbadwooods ($19.87 in chips) 
fred00205: posts small blind $0.05
supernightman: posts big blind $0.10
bigbadwooods: posts small & big blinds $0.15
*** HOLE CARDS ***
Kimi1892: folds 
bigbadwooods: raises $0.30 to $0.40
mikeyd1172: raises $0.30 to $0.70
fred00205: folds 
supernightman: folds 
bigbadwooods: calls $0.30
*** FLOP *** [3h 8h 4h]
bigbadwooods: checks 
mikeyd1172: checks 
*** TURN *** [3h 8h 4h] [Qd]
bigbadwooods: bets $0.60
mikeyd1172: calls $0.60
*** RIVER *** [3h 8h 4h Qd] [Kh]
bigbadwooods: checks 
mikeyd1172: checks 
*** SHOW DOWN ***
bigbadwooods: shows [Ah 8s] (a flush, Ace high)
mikeyd1172: mucks hand 
bigbadwooods collected $2.67 from pot
*** SUMMARY ***
Total pot $2.80 | Rake $0.13 
Board [3h 8h 4h Qd Kh]
Seat 1: mikeyd1172 (button) mucked
Seat 2: fred00205 (small blind) folded before Flop
Seat 3: supernightman (big blind) folded before Flop
Seat 5: Kimi1892 folded before Flop (didn't bet)
Seat 6: bigbadwooods showed [Ah 8s] and won ($2.67) with a flush, Ace high



PokerStars Hand #222954291214:  Hold'em No Limit ($0.05/$0.10 USD) - 2021/01/23 8:59:16 ET
Table 'Bohlinia III' 6-max Seat #2 is the button
Seat 1: mikeyd1172 ($15.69 in chips) 
Seat 2: fred00205 ($2.39 in chips) 
Seat 3: supernightman ($9.45 in chips) 
Seat 5: Kimi1892 ($11.19 in chips) 
Seat 6: bigbadwooods ($21.19 in chips) 
supernightman: posts small blind $0.05
Kimi1892: posts big blind $0.10
*** HOLE CARDS ***
bigbadwooods: folds 
mikeyd1172: folds 
fred00205: folds 
supernightman: folds 
Uncalled bet ($0.05) returned to Kimi1892
Kimi1892 collected $0.10 from pot
Kimi1892: doesn't show hand 
*** SUMMARY ***
Total pot $0.10 | Rake $0 
Seat 1: mikeyd1172 folded before Flop (didn't bet)
Seat 2: fred00205 (button) folded before Flop (didn't bet)
Seat 3: supernightman (small blind) folded before Flop
Seat 5: Kimi1892 (big blind) collected ($0.10)
Seat 6: bigbadwooods folded before Flop (didn't bet)



PokerStars Hand #222954294176:  Hold'em No Limit ($0.05/$0.10 USD) - 2021/01/23 8:59:24 ET
Table 'Bohlinia III' 6-max Seat #3 is the button
Seat 1: mikeyd1172 ($15.69 in chips) 
Seat 2: fred00205 ($2.39 in chips) 
Seat 3: supernightman ($9.40 in chips) 
Seat 5: Kimi1892 ($11.24 in chips) 
Seat 6: bigbadwooods ($21.19 in chips) 
Kimi1892: posts small blind $0.05
bigbadwooods: posts big blind $0.10
*** HOLE CARDS ***
mikeyd1172: folds 
fred00205: folds 
supernightman: raises $0.20 to $0.30
Kimi1892: folds 
bigbadwooods: raises $0.60 to $0.90
supernightman: calls $0.60
*** FLOP *** [8d Kd 5s]
bigbadwooods: bets $0.70
supernightman: calls $0.70
*** TURN *** [8d Kd 5s] [5d]
bigbadwooods: checks 
supernightman: checks 
*** RIVER *** [8d Kd 5s 5d] [Th]
bigbadwooods: bets $1.80
supernightman: folds 
Uncalled bet ($1.80) returned to bigbadwooods
bigbadwooods collected $3.10 from pot
bigbadwooods: doesn't show hand 
*** SUMMARY ***
Total pot $3.25 | Rake $0.15 
Board [8d Kd 5s 5d Th]
Seat 1: mikeyd1172 folded before Flop (didn't bet)
Seat 2: fred00205 folded before Flop (didn't bet)
Seat 3: supernightman (button) folded on the River
Seat 5: Kimi1892 (small blind) folded before Flop
Seat 6: bigbadwooods (big blind) collected ($3.10)



PokerStars Hand #222954306902:  Hold'em No Limit ($0.05/$0.10 USD) - 2021/01/23 8:59:59 ET
Table 'Bohlinia III' 6-max Seat #5 is the button
Seat 1: mikeyd1172 ($15.69 in chips) 
Seat 2: fred00205 ($2.39 in chips) 
Seat 3: supernightman ($7.80 in chips) 
Seat 5: Kimi1892 ($11.19 in chips) 
Seat 6: bigbadwooods ($22.69 in chips) 
bigbadwooods: posts small blind $0.05
mikeyd1172: posts big blind $0.10
*** HOLE CARDS ***
fred00205: calls $0.10
supernightman: folds 
Kimi1892 has timed out
Kimi1892: folds 
bigbadwooods: raises $0.20 to $0.30
mikeyd1172: folds 
fred00205: calls $0.20
*** FLOP *** [7c Ts Ks]
bigbadwooods: checks 
fred00205: checks 
*** TURN *** [7c Ts Ks] [Qh]
bigbadwooods: checks 
fred00205: checks 
*** RIVER *** [7c Ts Ks Qh] [Ah]
bigbadwooods: bets $0.67
fred00205: raises $1.42 to $2.09 and is all-in
bigbadwooods: calls $1.42
*** SHOW DOWN ***
fred00205: shows [Js Tc] (a straight, Ten to Ace)
bigbadwooods: shows [Jh As] (a straight, Ten to Ace)
bigbadwooods collected $2.33 from pot
fred00205 collected $2.33 from pot
*** SUMMARY ***
Total pot $4.88 | Rake $0.22 
Board [7c Ts Ks Qh Ah]
Seat 1: mikeyd1172 (big blind) folded before Flop
Seat 2: fred00205 showed [Js Tc] and won ($2.33) with a straight, Ten to Ace
Seat 3: supernightman folded before Flop (didn't bet)
Seat 5: Kimi1892 (button) folded before Flop (didn't bet)
Seat 6: bigbadwooods (small blind) showed [Jh As] and won ($2.33) with a straight, Ten to Ace



PokerStars Hand #222954334525:  Hold'em No Limit ($0.05/$0.10 USD) - 2021/01/23 9:01:08 ET
Table 'Bohlinia III' 6-max Seat #6 is the button
Seat 1: mikeyd1172 ($15.59 in chips) 
Seat 2: fred00205 ($2.33 in chips) 
Seat 3: supernightman ($7.80 in chips) 
Seat 6: bigbadwooods ($22.63 in chips) 
mikeyd1172: posts small blind $0.05
fred00205: posts big blind $0.10
*** HOLE CARDS ***
supernightman: folds 
bigbadwooods: folds 
mikeyd1172: raises $0.20 to $0.30
fred00205: calls $0.20
*** FLOP *** [6s 4c 4h]
mikeyd1172: bets $0.40
fred00205: folds 
Uncalled bet ($0.40) returned to mikeyd1172
mikeyd1172 collected $0.57 from pot
mikeyd1172: doesn't show hand 
*** SUMMARY ***
Total pot $0.60 | Rake $0.03 
Board [6s 4c 4h]
Seat 1: mikeyd1172 (small blind) collected ($0.57)
Seat 2: fred00205 (big blind) folded on the Flop
Seat 3: supernightman folded before Flop (didn't bet)
Seat 6: bigbadwooods (button) folded before Flop (didn't bet)



PokerStars Hand #222954348478:  Hold'em No Limit ($0.05/$0.10 USD) - 2021/01/23 9:01:33 ET
Table 'Bohlinia III' 6-max Seat #1 is the button
Seat 1: mikeyd1172 ($15.86 in chips) 
Seat 2: fred00205 ($2.03 in chips) 
Seat 3: supernightman ($7.80 in chips) 
Seat 6: bigbadwooods ($22.63 in chips) 
fred00205: posts small blind $0.05
supernightman: posts big blind $0.10
*** HOLE CARDS ***
bigbadwooods: folds 
mikeyd1172: raises $0.10 to $0.20
fred00205: calls $0.15
supernightman: calls $0.10
*** FLOP *** [3s 6d Ts]
fred00205: checks 
supernightman: checks 
mikeyd1172: checks 
*** TURN *** [3s 6d Ts] [Jh]
fred00205: checks 
supernightman: checks 
mikeyd1172: checks 
*** RIVER *** [3s 6d Ts Jh] [3c]
fred00205: bets $1.83 and is all-in
supernightman: calls $1.83
mikeyd1172: folds 
*** SHOW DOWN ***
fred00205: shows [2h 3h] (three of a kind, Threes)
supernightman: shows [Jc 2s] (two pair, Jacks and Threes)
fred00205 collected $4.07 from pot
*** SUMMARY ***
Total pot $4.26 | Rake $0.19 
Board [3s 6d Ts Jh 3c]
Seat 1: mikeyd1172 (button) folded on the River
Seat 2: fred00205 (small blind) showed [2h 3h] and won ($4.07) with three of a kind, Threes
Seat 3: supernightman (big blind) showed [Jc 2s] and lost with two pair, Jacks and Threes
Seat 6: bigbadwooods folded before Flop (didn't bet)



PokerStars Hand #222954373340:  Hold'em No Limit ($0.05/$0.10 USD) - 2021/01/23 9:02:26 ET
Table 'Bohlinia III' 6-max Seat #2 is the button
Seat 1: mikeyd1172 ($15.66 in chips) 
Seat 2: fred00205 ($4.07 in chips) 
Seat 3: supernightman ($5.77 in chips) 
Seat 6: bigbadwooods ($22.63 in chips) 
supernightman: posts small blind $0.05
bigbadwooods: posts big blind $0.10
*** HOLE CARDS ***
mikeyd1172: folds 
fred00205: calls $0.10
mikeyd1172 leaves the table
supernightman: calls $0.05
bigbadwooods: checks 
*** FLOP *** [Kd 2s 3h]
supernightman: checks 
bigbadwooods: checks 
fred00205: checks 
*** TURN *** [Kd 2s 3h] [6d]
supernightman: checks 
bigbadwooods: bets $0.29
fred00205: folds 
supernightman: folds 
Uncalled bet ($0.29) returned to bigbadwooods
bigbadwooods collected $0.29 from pot
bigbadwooods: doesn't show hand 
*** SUMMARY ***
Total pot $0.30 | Rake $0.01 
Board [Kd 2s 3h 6d]
Seat 1: mikeyd1172 folded before Flop (didn't bet)
Seat 2: fred00205 (button) folded on the Turn
Seat 3: supernightman (small blind) folded on the Turn
Seat 6: bigbadwooods (big blind) collected ($0.29)



PokerStars Hand #222954398576:  Hold'em No Limit ($0.05/$0.10 USD) - 2021/01/23 9:03:18 ET
Table 'Bohlinia III' 6-max Seat #3 is the button
Seat 2: fred00205 ($3.97 in chips) 
Seat 3: supernightman ($9.67 in chips) 
Seat 6: bigbadwooods ($22.82 in chips) 
bigbadwooods: posts small blind $0.05
fred00205: posts big blind $0.10
*** HOLE CARDS ***
supernightman: folds 
bigbadwooods: raises $0.10 to $0.20
fred00205: calls $0.10
*** FLOP *** [6s 7c 5d]
bigbadwooods: bets $0.10
fred00205: calls $0.10
*** TURN *** [6s 7c 5d] [9s]
bigbadwooods: bets $0.30
fred00205: calls $0.30
*** RIVER *** [6s 7c 5d 9s] [5c]
bigbadwooods: checks 
fred00205: checks 
*** SHOW DOWN ***
bigbadwooods: shows [Ts Td] (two pair, Tens and Fives)
fred00205: mucks hand 
bigbadwooods collected $1.15 from pot
*** SUMMARY ***
Total pot $1.20 | Rake $0.05 
Board [6s 7c 5d 9s 5c]
Seat 2: fred00205 (big blind) mucked
Seat 3: supernightman (button) folded before Flop (didn't bet)
Seat 6: bigbadwooods (small blind) showed [Ts Td] and won ($1.15) with two pair, Tens and Fives



PokerStars Hand #222954413222:  Hold'em No Limit ($0.05/$0.10 USD) - 2021/01/23 9:03:48 ET
Table 'Bohlinia III' 6-max Seat #6 is the button
Seat 2: fred00205 ($3.37 in chips) 
Seat 3: supernightman ($9.67 in chips) 
Seat 6: bigbadwooods ($23.37 in chips) 
fred00205: posts small blind $0.05
supernightman: posts big blind $0.10
luchom87: sits out 
Kimi1892: sits out 
*** HOLE CARDS ***
eungenio joins the table at seat #1 
bigbadwooods: raises $0.10 to $0.20
fred00205: folds 
supernightman: folds 
Uncalled bet ($0.10) returned to bigbadwooods
bigbadwooods collected $0.25 from pot
bigbadwooods: doesn't show hand 
*** SUMMARY ***
Total pot $0.25 | Rake $0 
Seat 2: fred00205 (small blind) folded before Flop
Seat 3: supernightman (big blind) folded before Flop
Seat 6: bigbadwooods (button) collected ($0.25)



PokerStars Hand #222954417482:  Hold'em No Limit ($0.05/$0.10 USD) - 2021/01/23 9:03:57 ET
Table 'Bohlinia III' 6-max Seat #2 is the button
Seat 2: fred00205 ($3.32 in chips) 
Seat 3: supernightman ($9.57 in chips) 
Seat 4: luchom87 ($15.96 in chips) 
Seat 6: bigbadwooods ($23.52 in chips) 
supernightman: posts small blind $0.05
luchom87: posts big blind $0.10
Kimi1892: sits out 
eungenio: sits out 
*** HOLE CARDS ***
bigbadwooods: folds 
fred00205: calls $0.10
supernightman: raises $0.20 to $0.30
luchom87: folds 
fred00205: calls $0.20
*** FLOP *** [Ts 2c Kc]
supernightman: checks 
fred00205: checks 
*** TURN *** [Ts 2c Kc] [5d]
supernightman: checks 
fred00205: checks 
*** RIVER *** [Ts 2c Kc 5d] [4c]
supernightman: checks 
fred00205: checks 
*** SHOW DOWN ***
supernightman: shows [Ac 9s] (high card Ace)
fred00205: shows [Kh 9d] (a pair of Kings)
fred00205 collected $0.67 from pot
*** SUMMARY ***
Total pot $0.70 | Rake $0.03 
Board [Ts 2c Kc 5d 4c]
Seat 2: fred00205 (button) showed [Kh 9d] and won ($0.67) with a pair of Kings
Seat 3: supernightman (small blind) showed [Ac 9s] and lost with high card Ace
Seat 4: luchom87 (big blind) folded before Flop
Seat 6: bigbadwooods folded before Flop (didn't bet)



PokerStars Hand #222954434536:  Hold'em No Limit ($0.05/$0.10 USD) - 2021/01/23 9:04:32 ET
Table 'Bohlinia III' 6-max Seat #3 is the button
Seat 2: fred00205 ($3.69 in chips) 
Seat 3: supernightman ($9.27 in chips) 
Seat 4: luchom87 ($15.86 in chips) 
Seat 5: Kimi1892 ($11.19 in chips) 
Seat 6: bigbadwooods ($23.52 in chips) 
luchom87: posts small blind $0.05
Kimi1892: posts big blind $0.10
eungenio: sits out 
*** HOLE CARDS ***
bigbadwooods: folds 
fred00205: calls $0.10
supernightman: raises $0.40 to $0.50
luchom87: folds 
Kimi1892: folds 
fred00205: calls $0.40
*** FLOP *** [Ad 7d 8c]
fred00205: checks 
supernightman: checks 
*** TURN *** [Ad 7d 8c] [As]
fred00205: checks 
supernightman: checks 
*** RIVER *** [Ad 7d 8c As] [3s]
fred00205: checks 
supernightman: bets $0.55
fred00205: folds 
Uncalled bet ($0.55) returned to supernightman
supernightman collected $1.10 from pot
*** SUMMARY ***
Total pot $1.15 | Rake $0.05 
Board [Ad 7d 8c As 3s]
Seat 2: fred00205 folded on the River
Seat 3: supernightman (button) collected ($1.10)
Seat 4: luchom87 (small blind) folded before Flop
Seat 5: Kimi1892 (big blind) folded before Flop
Seat 6: bigbadwooods folded before Flop (didn't bet)



PokerStars Hand #222954460745:  Hold'em No Limit ($0.05/$0.10 USD) - 2021/01/23 9:05:26 ET
Table 'Bohlinia III' 6-max Seat #4 is the button
Seat 2: fred00205 ($3.19 in chips) 
Seat 3: supernightman ($9.87 in chips) 
Seat 4: luchom87 ($15.81 in chips) 
Seat 5: Kimi1892 ($11.09 in chips) 
Seat 6: bigbadwooods ($23.52 in chips) 
Kimi1892: posts small blind $0.05
bigbadwooods: posts big blind $0.10
eungenio: sits out 
*** HOLE CARDS ***
fred00205: calls $0.10
supernightman: folds 
luchom87: folds 
Kimi1892: folds 
bigbadwooods: raises $0.20 to $0.30
fred00205: calls $0.20
*** FLOP *** [Ks 4c Th]
bigbadwooods: bets $0.30
fred00205: calls $0.30
*** TURN *** [Ks 4c Th] [5h]
bigbadwooods: checks 
fred00205: checks 
*** RIVER *** [Ks 4c Th 5h] [Kc]
bigbadwooods: checks 
fred00205: bets $2.59 and is all-in
bigbadwooods: folds 
Uncalled bet ($2.59) returned to fred00205
fred00205 collected $1.19 from pot
fred00205: doesn't show hand 
*** SUMMARY ***
Total pot $1.25 | Rake $0.06 
Board [Ks 4c Th 5h Kc]
Seat 2: fred00205 collected ($1.19)
Seat 3: supernightman folded before Flop (didn't bet)
Seat 4: luchom87 (button) folded before Flop (didn't bet)
Seat 5: Kimi1892 (small blind) folded before Flop
Seat 6: bigbadwooods (big blind) folded on the River



PokerStars Hand #222954483764:  Hold'em No Limit ($0.05/$0.10 USD) - 2021/01/23 9:06:13 ET
Table 'Bohlinia III' 6-max Seat #5 is the button
Seat 1: eungenio ($10 in chips) 
Seat 2: fred00205 ($3.78 in chips) 
Seat 3: supernightman ($9.87 in chips) 
Seat 4: luchom87 ($15.81 in chips) 
Seat 5: Kimi1892 ($11.04 in chips) 
Seat 6: bigbadwooods ($22.92 in chips) 
bigbadwooods: posts small blind $0.05
eungenio: posts big blind $0.10
*** HOLE CARDS ***
fred00205: folds 
supernightman: folds 
luchom87: folds 
Kimi1892: raises $0.15 to $0.25
bigbadwooods: folds 
eungenio: folds 
Uncalled bet ($0.15) returned to Kimi1892
Kimi1892 collected $0.25 from pot
Kimi1892: doesn't show hand 
*** SUMMARY ***
Total pot $0.25 | Rake $0 
Seat 1: eungenio (big blind) folded before Flop
Seat 2: fred00205 folded before Flop (didn't bet)
Seat 3: supernightman folded before Flop (didn't bet)
Seat 4: luchom87 folded before Flop (didn't bet)
Seat 5: Kimi1892 (button) collected ($0.25)
Seat 6: bigbadwooods (small blind) folded before Flop



PokerStars Hand #222954491470:  Hold'em No Limit ($0.05/$0.10 USD) - 2021/01/23 9:06:28 ET
Table 'Bohlinia III' 6-max Seat #6 is the button
Seat 1: eungenio ($10 in chips) 
Seat 2: fred00205 ($3.78 in chips) 
Seat 3: supernightman ($9.87 in chips) 
Seat 4: luchom87 ($15.81 in chips) 
Seat 5: Kimi1892 ($11.19 in chips) 
Seat 6: bigbadwooods ($22.87 in chips) 
eungenio: posts small blind $0.05
fred00205: posts big blind $0.10
*** HOLE CARDS ***
supernightman: folds 
luchom87: folds 
Kimi1892: folds 
bigbadwooods: folds 
eungenio: raises $0.20 to $0.30
fred00205: calls $0.20
*** FLOP *** [8h Th Qs]
eungenio: bets $0.19
fred00205: folds 
Uncalled bet ($0.19) returned to eungenio
eungenio collected $0.57 from pot
eungenio: doesn't show hand 
*** SUMMARY ***
Total pot $0.60 | Rake $0.03 
Board [8h Th Qs]
Seat 1: eungenio (small blind) collected ($0.57)
Seat 2: fred00205 (big blind) folded on the Flop
Seat 3: supernightman folded before Flop (didn't bet)
Seat 4: luchom87 folded before Flop (didn't bet)
Seat 5: Kimi1892 folded before Flop (didn't bet)
Seat 6: bigbadwooods (button) folded before Flop (didn't bet)



PokerStars Hand #222954508482:  Hold'em No Limit ($0.05/$0.10 USD) - 2021/01/23 9:07:03 ET
Table 'Bohlinia III' 6-max Seat #1 is the button
Seat 1: eungenio ($10.27 in chips) 
Seat 2: fred00205 ($3.48 in chips) 
Seat 3: supernightman ($9.87 in chips) 
Seat 4: luchom87 ($15.81 in chips) 
Seat 5: Kimi1892 ($11.19 in chips) 
fred00205: posts small blind $0.05
supernightman: posts big blind $0.10
*** HOLE CARDS ***
luchom87: folds 
Kimi1892: raises $0.20 to $0.30
eungenio: folds 
fred00205: folds 
supernightman: calls $0.20
*** FLOP *** [Kd Qd Kh]
supernightman: checks 
Kimi1892: checks 
*** TURN *** [Kd Qd Kh] [6c]
supernightman: bets $0.31
Kimi1892: calls $0.31
*** RIVER *** [Kd Qd Kh 6c] [8c]
supernightman: checks 
Kimi1892: bets $0.40
supernightman: folds 
Uncalled bet ($0.40) returned to Kimi1892
Kimi1892 collected $1.21 from pot
Kimi1892: doesn't show hand 
*** SUMMARY ***
Total pot $1.27 | Rake $0.06 
Board [Kd Qd Kh 6c 8c]
Seat 1: eungenio (button) folded before Flop (didn't bet)
Seat 2: fred00205 (small blind) folded before Flop
Seat 3: supernightman (big blind) folded on the River
Seat 4: luchom87 folded before Flop (didn't bet)
Seat 5: Kimi1892 collected ($1.21)



PokerStars Hand #222954531032:  Hold'em No Limit ($0.05/$0.10 USD) - 2021/01/23 9:07:49 ET
Table 'Bohlinia III' 6-max Seat #2 is the button
Seat 1: eungenio ($10.27 in chips) 
Seat 2: fred00205 ($3.43 in chips) 
Seat 3: supernightman ($9.26 in chips) 
Seat 4: luchom87 ($15.81 in chips) 
Seat 5: Kimi1892 ($11.79 in chips) 
supernightman: posts small blind $0.05
luchom87: posts big blind $0.10
*** HOLE CARDS ***
Kimi1892: folds 
eungenio: folds 
fred00205: folds 
supernightman: folds 
Uncalled bet ($0.05) returned to luchom87
luchom87 collected $0.10 from pot
luchom87: doesn't show hand 
*** SUMMARY ***
Total pot $0.10 | Rake $0 
Seat 1: eungenio folded before Flop (didn't bet)
Seat 2: fred00205 (button) folded before Flop (didn't bet)
Seat 3: supernightman (small blind) folded before Flop
Seat 4: luchom87 (big blind) collected ($0.10)
Seat 5: Kimi1892 folded before Flop (didn't bet)



PokerStars Hand #222954535060:  Hold'em No Limit ($0.05/$0.10 USD) - 2021/01/23 9:07:57 ET
Table 'Bohlinia III' 6-max Seat #3 is the button
Seat 1: eungenio ($10.27 in chips) 
Seat 2: fred00205 ($3.43 in chips) 
Seat 3: supernightman ($9.21 in chips) 
Seat 4: luchom87 ($15.86 in chips) 
Seat 5: Kimi1892 ($11.79 in chips) 
luchom87: posts small blind $0.05
Kimi1892: posts big blind $0.10
*** HOLE CARDS ***
eungenio: folds 
fred00205: calls $0.10
supernightman: folds 
luchom87: raises $0.40 to $0.50
Kimi1892: folds 
fred00205: raises $0.40 to $0.90
luchom87: raises $8.90 to $9.80
fred00205: calls $2.53 and is all-in
Uncalled bet ($6.37) returned to luchom87
*** FLOP *** [Ad Qd 2s]
*** TURN *** [Ad Qd 2s] [5c]
*** RIVER *** [Ad Qd 2s 5c] [8s]
*** SHOW DOWN ***
luchom87: shows [Kd Jd] (high card Ace)
fred00205: shows [Kh Ks] (a pair of Kings)
fred00205 collected $6.65 from pot
*** SUMMARY ***
Total pot $6.96 | Rake $0.31 
Board [Ad Qd 2s 5c 8s]
Seat 1: eungenio folded before Flop (didn't bet)
Seat 2: fred00205 showed [Kh Ks] and won ($6.65) with a pair of Kings
Seat 3: supernightman (button) folded before Flop (didn't bet)
Seat 4: luchom87 (small blind) showed [Kd Jd] and lost with high card Ace
Seat 5: Kimi1892 (big blind) folded before Flop



PokerStars Hand #222954551833:  Hold'em No Limit ($0.05/$0.10 USD) - 2021/01/23 9:08:31 ET
Table 'Bohlinia III' 6-max Seat #4 is the button
Seat 1: eungenio ($10.27 in chips) 
Seat 2: fred00205 ($6.65 in chips) 
Seat 3: supernightman ($9.21 in chips) 
Seat 4: luchom87 ($12.43 in chips) 
Seat 5: Kimi1892 ($11.69 in chips) 
Kimi1892: posts small blind $0.05
eungenio: posts big blind $0.10
*** HOLE CARDS ***
fred00205: folds 
supernightman: folds 
luchom87: raises $0.15 to $0.25
Kimi1892: folds 
eungenio: calls $0.15
*** FLOP *** [Kd 5c Qs]
eungenio: checks 
luchom87: bets $0.19
eungenio: raises $0.50 to $0.69
luchom87: folds 
Uncalled bet ($0.50) returned to eungenio
eungenio collected $0.89 from pot
eungenio: doesn't show hand 
*** SUMMARY ***
Total pot $0.93 | Rake $0.04 
Board [Kd 5c Qs]
Seat 1: eungenio (big blind) collected ($0.89)
Seat 2: fred00205 folded before Flop (didn't bet)
Seat 3: supernightman folded before Flop (didn't bet)
Seat 4: luchom87 (button) folded on the Flop
Seat 5: Kimi1892 (small blind) folded before Flop



PokerStars Hand #222954581796:  Hold'em No Limit ($0.05/$0.10 USD) - 2021/01/23 9:09:32 ET
Table 'Bohlinia III' 6-max Seat #5 is the button
Seat 1: eungenio ($10.72 in chips) 
Seat 2: fred00205 ($6.65 in chips) 
Seat 3: supernightman ($9.21 in chips) 
Seat 4: luchom87 ($11.99 in chips) 
Seat 5: Kimi1892 ($11.64 in chips) 
eungenio: posts small blind $0.05
fred00205: posts big blind $0.10
*** HOLE CARDS ***
supernightman: folds 
luchom87: raises $0.20 to $0.30
Kimi1892: folds 
eungenio: folds 
fred00205: calls $0.20
*** FLOP *** [5d 9s 8d]
fred00205: checks 
luchom87: bets $0.22
fred00205: folds 
Uncalled bet ($0.22) returned to luchom87
luchom87 collected $0.62 from pot
luchom87: doesn't show hand 
*** SUMMARY ***
Total pot $0.65 | Rake $0.03 
Board [5d 9s 8d]
Seat 1: eungenio (small blind) folded before Flop
Seat 2: fred00205 (big blind) folded on the Flop
Seat 3: supernightman folded before Flop (didn't bet)
Seat 4: luchom87 collected ($0.62)
Seat 5: Kimi1892 (button) folded before Flop (didn't bet)



PokerStars Hand #222954599428:  Hold'em No Limit ($0.05/$0.10 USD) - 2021/01/23 9:10:07 ET
Table 'Bohlinia III' 6-max Seat #1 is the button
Seat 1: eungenio ($10.67 in chips) 
Seat 2: fred00205 ($6.35 in chips) 
Seat 3: supernightman ($9.21 in chips) 
Seat 4: luchom87 ($12.31 in chips) 
Seat 5: Kimi1892 ($11.64 in chips) 
fred00205: posts small blind $0.05
supernightman: posts big blind $0.10
*** HOLE CARDS ***
luchom87: folds 
Kimi1892: folds 
eungenio: folds 
fred00205: calls $0.05
supernightman: checks 
*** FLOP *** [7s 3h 8s]
fred00205: checks 
supernightman: checks 
*** TURN *** [7s 3h 8s] [Ks]
fred00205: checks 
supernightman: checks 
*** RIVER *** [7s 3h 8s Ks] [3d]
fred00205: checks 
supernightman: checks 
*** SHOW DOWN ***
fred00205: shows [Qc Th] (a pair of Threes)
supernightman: shows [4c As] (a pair of Threes - Ace kicker)
supernightman collected $0.19 from pot
*** SUMMARY ***
Total pot $0.20 | Rake $0.01 
Board [7s 3h 8s Ks 3d]
Seat 1: eungenio (button) folded before Flop (didn't bet)
Seat 2: fred00205 (small blind) showed [Qc Th] and lost with a pair of Threes
Seat 3: supernightman (big blind) showed [4c As] and won ($0.19) with a pair of Threes
Seat 4: luchom87 folded before Flop (didn't bet)
Seat 5: Kimi1892 folded before Flop (didn't bet)



PokerStars Hand #222954617309:  Hold'em No Limit ($0.05/$0.10 USD) - 2021/01/23 9:10:43 ET
Table 'Bohlinia III' 6-max Seat #2 is the button
Seat 1: eungenio ($10.67 in chips) 
Seat 2: fred00205 ($6.25 in chips) 
Seat 3: supernightman ($9.30 in chips) 
Seat 4: luchom87 ($12.31 in chips) 
Seat 5: Kimi1892 ($11.64 in chips) 
supernightman: posts small blind $0.05
luchom87: posts big blind $0.10
*** HOLE CARDS ***
Kimi1892: raises $0.20 to $0.30
eungenio: folds 
fred00205: folds 
supernightman: folds 
luchom87: folds 
Uncalled bet ($0.20) returned to Kimi1892
Kimi1892 collected $0.25 from pot
Kimi1892: doesn't show hand 
*** SUMMARY ***
Total pot $0.25 | Rake $0 
Seat 1: eungenio folded before Flop (didn't bet)
Seat 2: fred00205 (button) folded before Flop (didn't bet)
Seat 3: supernightman (small blind) folded before Flop
Seat 4: luchom87 (big blind) folded before Flop
Seat 5: Kimi1892 collected ($0.25)



PokerStars Hand #222954624551:  Hold'em No Limit ($0.05/$0.10 USD) - 2021/01/23 9:10:58 ET
Table 'Bohlinia III' 6-max Seat #3 is the button
Seat 1: eungenio ($10.67 in chips) 
Seat 2: fred00205 ($6.25 in chips) 
Seat 3: supernightman ($9.25 in chips) 
Seat 4: luchom87 ($12.21 in chips) 
Seat 5: Kimi1892 ($11.79 in chips) 
luchom87: posts small blind $0.05
Kimi1892: posts big blind $0.10
*** HOLE CARDS ***
eungenio: raises $0.20 to $0.30
fred00205: folds 
supernightman: folds 
luchom87: folds 
Kimi1892: folds 
Uncalled bet ($0.20) returned to eungenio
eungenio collected $0.25 from pot
eungenio: doesn't show hand 
*** SUMMARY ***
Total pot $0.25 | Rake $0 
Seat 1: eungenio collected ($0.25)
Seat 2: fred00205 folded before Flop (didn't bet)
Seat 3: supernightman (button) folded before Flop (didn't bet)
Seat 4: luchom87 (small blind) folded before Flop
Seat 5: Kimi1892 (big blind) folded before Flop



PokerStars Hand #222954635137:  Hold'em No Limit ($0.05/$0.10 USD) - 2021/01/23 9:11:19 ET
Table 'Bohlinia III' 6-max Seat #4 is the button
Seat 1: eungenio ($10.82 in chips) 
Seat 2: fred00205 ($6.25 in chips) 
Seat 3: supernightman ($9.25 in chips) 
Seat 4: luchom87 ($12.16 in chips) 
Seat 5: Kimi1892 ($11.69 in chips) 
Kimi1892: posts small blind $0.05
eungenio: posts big blind $0.10
*** HOLE CARDS ***
fred00205: calls $0.10
supernightman: raises $0.40 to $0.50
luchom87: folds 
Kimi1892: folds 
eungenio: folds 
fred00205: folds 
Uncalled bet ($0.40) returned to supernightman
supernightman collected $0.35 from pot
*** SUMMARY ***
Total pot $0.35 | Rake $0 
Seat 1: eungenio (big blind) folded before Flop
Seat 2: fred00205 folded before Flop
Seat 3: supernightman collected ($0.35)
Seat 4: luchom87 (button) folded before Flop (didn't bet)
Seat 5: Kimi1892 (small blind) folded before Flop



PokerStars Hand #222954647806:  Hold'em No Limit ($0.05/$0.10 USD) - 2021/01/23 9:11:45 ET
Table 'Bohlinia III' 6-max Seat #5 is the button
Seat 1: eungenio ($10.72 in chips) 
Seat 2: fred00205 ($6.15 in chips) 
Seat 3: supernightman ($9.50 in chips) 
Seat 4: luchom87 ($12.16 in chips) 
Seat 5: Kimi1892 ($11.64 in chips) 
eungenio: posts small blind $0.05
fred00205: posts big blind $0.10
*** HOLE CARDS ***
supernightman: folds 
luchom87: folds 
Kimi1892: folds 
eungenio: folds 
Uncalled bet ($0.05) returned to fred00205
fred00205 collected $0.10 from pot
fred00205: doesn't show hand 
*** SUMMARY ***
Total pot $0.10 | Rake $0 
Seat 1: eungenio (small blind) folded before Flop
Seat 2: fred00205 (big blind) collected ($0.10)
Seat 3: supernightman folded before Flop (didn't bet)
Seat 4: luchom87 folded before Flop (didn't bet)
Seat 5: Kimi1892 (button) folded before Flop (didn't bet)



PokerStars Hand #222954653934:  Hold'em No Limit ($0.05/$0.10 USD) - 2021/01/23 9:11:57 ET
Table 'Bohlinia III' 6-max Seat #1 is the button
Seat 1: eungenio ($10.67 in chips) 
Seat 2: fred00205 ($6.20 in chips) 
Seat 3: supernightman ($9.50 in chips) 
Seat 4: luchom87 ($12.16 in chips) 
Seat 5: Kimi1892 ($11.64 in chips) 
Seat 6: bigbadwooods ($22.87 in chips) 
fred00205: posts small blind $0.05
supernightman: posts big blind $0.10
bigbadwooods: posts small & big blinds $0.15
*** HOLE CARDS ***
luchom87: raises $0.40 to $0.50
Kimi1892: folds 
bigbadwooods: folds 
eungenio: calls $0.50
fred00205: folds 
supernightman: folds 
*** FLOP *** [Kh 6d 2s]
fred00205 leaves the table
luchom87: checks 
Richard12358 joins the table at seat #2 
eungenio: checks 
*** TURN *** [Kh 6d 2s] [9c]
luchom87: checks 
eungenio: bets $0.41
luchom87: folds 
Uncalled bet ($0.41) returned to eungenio
eungenio collected $1.24 from pot
eungenio: doesn't show hand 
*** SUMMARY ***
Total pot $1.30 | Rake $0.06 
Board [Kh 6d 2s 9c]
Seat 1: eungenio (button) collected ($1.24)
Seat 2: fred00205 (small blind) folded before Flop
Seat 3: supernightman (big blind) folded before Flop
Seat 4: luchom87 folded on the Turn
Seat 5: Kimi1892 folded before Flop (didn't bet)
Seat 6: bigbadwooods folded before Flop (didn't bet)



PokerStars Hand #222954678203:  Hold'em No Limit ($0.05/$0.10 USD) - 2021/01/23 9:12:46 ET
Table 'Bohlinia III' 6-max Seat #3 is the button
Seat 1: eungenio ($11.41 in chips) 
Seat 2: Richard12358 ($8 in chips) 
Seat 3: supernightman ($9.40 in chips) 
Seat 4: luchom87 ($11.66 in chips) 
Seat 5: Kimi1892 ($11.64 in chips) 
Seat 6: bigbadwooods ($22.72 in chips) 
luchom87: posts small blind $0.05
Kimi1892: posts big blind $0.10
Richard12358: posts big blind $0.10
*** HOLE CARDS ***
bigbadwooods: folds 
eungenio: folds 
Richard12358: raises $0.20 to $0.30
supernightman: folds 
luchom87: folds 
Kimi1892: folds 
Uncalled bet ($0.20) returned to Richard12358
Richard12358 collected $0.25 from pot
Richard12358: doesn't show hand 
*** SUMMARY ***
Total pot $0.25 | Rake $0 
Seat 1: eungenio folded before Flop (didn't bet)
Seat 2: Richard12358 collected ($0.25)
Seat 3: supernightman (button) folded before Flop (didn't bet)
Seat 4: luchom87 (small blind) folded before Flop
Seat 5: Kimi1892 (big blind) folded before Flop
Seat 6: bigbadwooods folded before Flop (didn't bet)



PokerStars Hand #222954687108:  Hold'em No Limit ($0.05/$0.10 USD) - 2021/01/23 9:13:04 ET
Table 'Bohlinia III' 6-max Seat #4 is the button
Seat 1: eungenio ($11.41 in chips) 
Seat 2: Richard12358 ($8.15 in chips) 
Seat 3: supernightman ($9.40 in chips) 
Seat 4: luchom87 ($11.61 in chips) 
Seat 5: Kimi1892 ($11.54 in chips) 
Seat 6: bigbadwooods ($22.72 in chips) 
Kimi1892: posts small blind $0.05
bigbadwooods: posts big blind $0.10
*** HOLE CARDS ***
eungenio: raises $0.20 to $0.30
Richard12358: calls $0.30
supernightman: calls $0.30
luchom87: folds 
Kimi1892: folds 
bigbadwooods: calls $0.20
*** FLOP *** [9h Kh Qc]
bigbadwooods: checks 
eungenio: checks 
Richard12358: checks 
supernightman: checks 
*** TURN *** [9h Kh Qc] [3d]
bigbadwooods: checks 
eungenio: checks 
Richard12358: checks 
supernightman: checks 
*** RIVER *** [9h Kh Qc 3d] [8s]
bigbadwooods: checks 
eungenio: checks 
Richard12358: checks 
supernightman: checks 
*** SHOW DOWN ***
bigbadwooods: shows [Td 9s] (a pair of Nines)
eungenio: mucks hand 
Richard12358: mucks hand 
supernightman: shows [Tc 9c] (a pair of Nines)
bigbadwooods collected $0.60 from pot
supernightman collected $0.59 from pot
*** SUMMARY ***
Total pot $1.25 | Rake $0.06 
Board [9h Kh Qc 3d 8s]
Seat 1: eungenio mucked
Seat 2: Richard12358 mucked
Seat 3: supernightman showed [Tc 9c] and won ($0.59) with a pair of Nines
Seat 4: luchom87 (button) folded before Flop (didn't bet)
Seat 5: Kimi1892 (small blind) folded before Flop
Seat 6: bigbadwooods (big blind) showed [Td 9s] and won ($0.60) with a pair of Nines



PokerStars Hand #222954710113:  Hold'em No Limit ($0.05/$0.10 USD) - 2021/01/23 9:13:50 ET
Table 'Bohlinia III' 6-max Seat #5 is the button
Seat 1: eungenio ($11.11 in chips) 
Seat 2: Richard12358 ($7.85 in chips) 
Seat 3: supernightman ($9.69 in chips) 
Seat 4: luchom87 ($11.61 in chips) 
Seat 5: Kimi1892 ($11.49 in chips) 
Seat 6: bigbadwooods ($23.02 in chips) 
bigbadwooods: posts small blind $0.05
eungenio: posts big blind $0.10
*** HOLE CARDS ***
Richard12358: calls $0.10
supernightman: folds 
luchom87: folds 
Kimi1892: raises $0.30 to $0.40
bigbadwooods: folds 
eungenio: folds 
Richard12358: calls $0.30
*** FLOP *** [9c Jd 2c]
Richard12358: bets $0.60
Kimi1892: calls $0.60
*** TURN *** [9c Jd 2c] [6s]
Richard12358: checks 
Kimi1892: checks 
*** RIVER *** [9c Jd 2c 6s] [Jh]
Richard12358: checks 
Kimi1892: checks 
*** SHOW DOWN ***
Richard12358: shows [8d 4d] (a pair of Jacks)
Kimi1892: shows [Qd Kd] (a pair of Jacks - King kicker)
Kimi1892 collected $2.05 from pot
*** SUMMARY ***
Total pot $2.15 | Rake $0.10 
Board [9c Jd 2c 6s Jh]
Seat 1: eungenio (big blind) folded before Flop
Seat 2: Richard12358 showed [8d 4d] and lost with a pair of Jacks
Seat 3: supernightman folded before Flop (didn't bet)
Seat 4: luchom87 folded before Flop (didn't bet)
Seat 5: Kimi1892 (button) showed [Qd Kd] and won ($2.05) with a pair of Jacks
Seat 6: bigbadwooods (small blind) folded before Flop



PokerStars Hand #222954731312:  Hold'em No Limit ($0.05/$0.10 USD) - 2021/01/23 9:14:32 ET
Table 'Bohlinia III' 6-max Seat #6 is the button
Seat 1: eungenio ($11.01 in chips) 
Seat 2: Richard12358 ($6.85 in chips) 
Seat 3: supernightman ($9.69 in chips) 
Seat 4: luchom87 ($11.61 in chips) 
Seat 5: Kimi1892 ($12.54 in chips) 
Seat 6: bigbadwooods ($22.97 in chips) 
eungenio: posts small blind $0.05
Richard12358: posts big blind $0.10
*** HOLE CARDS ***
supernightman: raises $0.20 to $0.30
luchom87: folds 
Kimi1892: folds 
bigbadwooods: folds 
eungenio: folds 
Richard12358: folds 
Uncalled bet ($0.20) returned to supernightman
supernightman collected $0.25 from pot
*** SUMMARY ***
Total pot $0.25 | Rake $0 
Seat 1: eungenio (small blind) folded before Flop
Seat 2: Richard12358 (big blind) folded before Flop
Seat 3: supernightman collected ($0.25)
Seat 4: luchom87 folded before Flop (didn't bet)
Seat 5: Kimi1892 folded before Flop (didn't bet)
Seat 6: bigbadwooods (button) folded before Flop (didn't bet)



PokerStars Hand #222954738141:  Hold'em No Limit ($0.05/$0.10 USD) - 2021/01/23 9:14:46 ET
Table 'Bohlinia III' 6-max Seat #1 is the button
Seat 1: eungenio ($10.96 in chips) 
Seat 2: Richard12358 ($6.75 in chips) 
Seat 3: supernightman ($9.84 in chips) 
Seat 4: luchom87 ($11.61 in chips) 
Seat 5: Kimi1892 ($12.54 in chips) 
Seat 6: bigbadwooods ($22.97 in chips) 
Richard12358: posts small blind $0.05
supernightman: posts big blind $0.10
*** HOLE CARDS ***
luchom87: raises $0.20 to $0.30
Kimi1892: folds 
bigbadwooods: folds 
eungenio: folds 
Richard12358: folds 
supernightman: folds 
Uncalled bet ($0.20) returned to luchom87
luchom87 collected $0.25 from pot
luchom87: doesn't show hand 
*** SUMMARY ***
Total pot $0.25 | Rake $0 
Seat 1: eungenio (button) folded before Flop (didn't bet)
Seat 2: Richard12358 (small blind) folded before Flop
Seat 3: supernightman (big blind) folded before Flop
Seat 4: luchom87 collected ($0.25)
Seat 5: Kimi1892 folded before Flop (didn't bet)
Seat 6: bigbadwooods folded before Flop (didn't bet)



PokerStars Hand #222954746124:  Hold'em No Limit ($0.05/$0.10 USD) - 2021/01/23 9:15:02 ET
Table 'Bohlinia III' 6-max Seat #2 is the button
Seat 1: eungenio ($10.96 in chips) 
Seat 2: Richard12358 ($6.70 in chips) 
Seat 3: supernightman ($9.74 in chips) 
Seat 4: luchom87 ($11.76 in chips) 
Seat 5: Kimi1892 ($12.54 in chips) 
Seat 6: bigbadwooods ($22.97 in chips) 
supernightman: posts small blind $0.05
luchom87: posts big blind $0.10
*** HOLE CARDS ***
Kimi1892: folds 
bigbadwooods: folds 
eungenio: folds 
Richard12358: calls $0.10
supernightman: folds 
luchom87: checks 
*** FLOP *** [4d 3s Kh]
luchom87: checks 
Richard12358: checks 
*** TURN *** [4d 3s Kh] [Kc]
luchom87: checks 
Richard12358: bets $0.10
luchom87: folds 
Uncalled bet ($0.10) returned to Richard12358
Richard12358 collected $0.24 from pot
*** SUMMARY ***
Total pot $0.25 | Rake $0.01 
Board [4d 3s Kh Kc]
Seat 1: eungenio folded before Flop (didn't bet)
Seat 2: Richard12358 (button) collected ($0.24)
Seat 3: supernightman (small blind) folded before Flop
Seat 4: luchom87 (big blind) folded on the Turn
Seat 5: Kimi1892 folded before Flop (didn't bet)
Seat 6: bigbadwooods folded before Flop (didn't bet)



PokerStars Hand #222954761898:  Hold'em No Limit ($0.05/$0.10 USD) - 2021/01/23 9:15:33 ET
Table 'Bohlinia III' 6-max Seat #3 is the button
Seat 1: eungenio ($10.96 in chips) 
Seat 2: Richard12358 ($6.84 in chips) 
Seat 3: supernightman ($9.69 in chips) 
Seat 4: luchom87 ($11.66 in chips) 
Seat 5: Kimi1892 ($12.54 in chips) 
Seat 6: bigbadwooods ($22.97 in chips) 
luchom87: posts small blind $0.05
Kimi1892: posts big blind $0.10
*** HOLE CARDS ***
bigbadwooods: folds 
eungenio: folds 
Richard12358: folds 
supernightman: folds 
luchom87: folds 
Uncalled bet ($0.05) returned to Kimi1892
Kimi1892 collected $0.10 from pot
Kimi1892: doesn't show hand 
*** SUMMARY ***
Total pot $0.10 | Rake $0 
Seat 1: eungenio folded before Flop (didn't bet)
Seat 2: Richard12358 folded before Flop (didn't bet)
Seat 3: supernightman (button) folded before Flop (didn't bet)
Seat 4: luchom87 (small blind) folded before Flop
Seat 5: Kimi1892 (big blind) collected ($0.10)
Seat 6: bigbadwooods folded before Flop (didn't bet)



PokerStars Hand #222954773719:  Hold'em No Limit ($0.05/$0.10 USD) - 2021/01/23 9:15:57 ET
Table 'Bohlinia III' 6-max Seat #4 is the button
Seat 1: eungenio ($10.96 in chips) 
Seat 2: Richard12358 ($6.84 in chips) 
Seat 3: supernightman ($9.69 in chips) 
Seat 4: luchom87 ($11.61 in chips) 
Seat 5: Kimi1892 ($12.59 in chips) 
Seat 6: bigbadwooods ($22.97 in chips) 
Kimi1892: posts small blind $0.05
bigbadwooods: posts big blind $0.10
*** HOLE CARDS ***
eungenio: folds 
Richard12358: folds 
supernightman: folds 
luchom87: folds 
Kimi1892: raises $0.20 to $0.30
bigbadwooods: folds 
Uncalled bet ($0.20) returned to Kimi1892
Kimi1892 collected $0.20 from pot
Kimi1892: doesn't show hand 
*** SUMMARY ***
Total pot $0.20 | Rake $0 
Seat 1: eungenio folded before Flop (didn't bet)
Seat 2: Richard12358 folded before Flop (didn't bet)
Seat 3: supernightman folded before Flop (didn't bet)
Seat 4: luchom87 (button) folded before Flop (didn't bet)
Seat 5: Kimi1892 (small blind) collected ($0.20)
Seat 6: bigbadwooods (big blind) folded before Flop



PokerStars Hand #222954781139:  Hold'em No Limit ($0.05/$0.10 USD) - 2021/01/23 9:16:12 ET
Table 'Bohlinia III' 6-max Seat #5 is the button
Seat 1: eungenio ($10.96 in chips) 
Seat 2: Richard12358 ($6.84 in chips) 
Seat 3: supernightman ($9.69 in chips) 
Seat 4: luchom87 ($11.61 in chips) 
Seat 5: Kimi1892 ($12.69 in chips) 
Seat 6: bigbadwooods ($22.87 in chips) 
bigbadwooods: posts small blind $0.05
eungenio: posts big blind $0.10
*** HOLE CARDS ***
Richard12358: folds 
supernightman: folds 
luchom87: folds 
Kimi1892: folds 
bigbadwooods: folds 
Uncalled bet ($0.05) returned to eungenio
eungenio collected $0.10 from pot
eungenio: doesn't show hand 
*** SUMMARY ***
Total pot $0.10 | Rake $0 
Seat 1: eungenio (big blind) collected ($0.10)
Seat 2: Richard12358 folded before Flop (didn't bet)
Seat 3: supernightman folded before Flop (didn't bet)
Seat 4: luchom87 folded before Flop (didn't bet)
Seat 5: Kimi1892 (button) folded before Flop (didn't bet)
Seat 6: bigbadwooods (small blind) folded before Flop



PokerStars Hand #222954789581:  Hold'em No Limit ($0.05/$0.10 USD) - 2021/01/23 9:16:29 ET
Table 'Bohlinia III' 6-max Seat #6 is the button
Seat 1: eungenio ($11.01 in chips) 
Seat 2: Richard12358 ($6.84 in chips) 
Seat 3: supernightman ($9.69 in chips) 
Seat 4: luchom87 ($11.61 in chips) 
Seat 5: Kimi1892 ($12.69 in chips) 
Seat 6: bigbadwooods ($22.82 in chips) 
eungenio: posts small blind $0.05
Richard12358: posts big blind $0.10
*** HOLE CARDS ***
supernightman: folds 
luchom87: folds 
Kimi1892: folds 
bigbadwooods: raises $0.10 to $0.20
eungenio: folds 
Richard12358: calls $0.10
*** FLOP *** [8c 8h Ts]
Richard12358: checks 
bigbadwooods: bets $0.20
Richard12358: calls $0.20
*** TURN *** [8c 8h Ts] [9c]
Richard12358: bets $0.50
bigbadwooods: calls $0.50
*** RIVER *** [8c 8h Ts 9c] [6c]
Richard12358: checks 
bigbadwooods: checks 
*** SHOW DOWN ***
Richard12358: shows [Kh 4d] (a pair of Eights)
bigbadwooods: shows [Ks Td] (two pair, Tens and Eights)
bigbadwooods collected $1.77 from pot
*** SUMMARY ***
Total pot $1.85 | Rake $0.08 
Board [8c 8h Ts 9c 6c]
Seat 1: eungenio (small blind) folded before Flop
Seat 2: Richard12358 (big blind) showed [Kh 4d] and lost with a pair of Eights
Seat 3: supernightman folded before Flop (didn't bet)
Seat 4: luchom87 folded before Flop (didn't bet)
Seat 5: Kimi1892 folded before Flop (didn't bet)
Seat 6: bigbadwooods (button) showed [Ks Td] and won ($1.77) with two pair, Tens and Eights



PokerStars Hand #222954810430:  Hold'em No Limit ($0.05/$0.10 USD) - 2021/01/23 9:17:11 ET
Table 'Bohlinia III' 6-max Seat #1 is the button
Seat 1: eungenio ($10.96 in chips) 
Seat 2: Richard12358 ($5.94 in chips) 
Seat 3: supernightman ($9.69 in chips) 
Seat 4: luchom87 ($11.61 in chips) 
Seat 5: Kimi1892 ($12.69 in chips) 
Seat 6: bigbadwooods ($23.69 in chips) 
Richard12358: posts small blind $0.05
supernightman: posts big blind $0.10
*** HOLE CARDS ***
luchom87: folds 
Kimi1892: folds 
bigbadwooods: folds 
eungenio: raises $0.15 to $0.25
Richard12358: folds 
supernightman: folds 
Uncalled bet ($0.15) returned to eungenio
eungenio collected $0.25 from pot
eungenio: doesn't show hand 
*** SUMMARY ***
Total pot $0.25 | Rake $0 
Seat 1: eungenio (button) collected ($0.25)
Seat 2: Richard12358 (small blind) folded before Flop
Seat 3: supernightman (big blind) folded before Flop
Seat 4: luchom87 folded before Flop (didn't bet)
Seat 5: Kimi1892 folded before Flop (didn't bet)
Seat 6: bigbadwooods folded before Flop (didn't bet)



PokerStars Hand #222954821118:  Hold'em No Limit ($0.05/$0.10 USD) - 2021/01/23 9:17:33 ET
Table 'Bohlinia III' 6-max Seat #2 is the button
Seat 1: eungenio ($11.11 in chips) 
Seat 2: Richard12358 ($9.89 in chips) 
Seat 3: supernightman ($9.59 in chips) 
Seat 4: luchom87 ($11.61 in chips) 
Seat 5: Kimi1892 ($12.69 in chips) 
Seat 6: bigbadwooods ($23.69 in chips) 
supernightman: posts small blind $0.05
luchom87: posts big blind $0.10
*** HOLE CARDS ***
Kimi1892: folds 
bigbadwooods: folds 
eungenio: folds 
Richard12358: calls $0.10
supernightman: folds 
luchom87: checks 
*** FLOP *** [6h 4d 2c]
luchom87: checks 
Richard12358: checks 
*** TURN *** [6h 4d 2c] [Ad]
luchom87: checks 
Richard12358: bets $0.10
luchom87: calls $0.10
*** RIVER *** [6h 4d 2c Ad] [2s]
luchom87: checks 
Richard12358: checks 
*** SHOW DOWN ***
luchom87: shows [Th 6s] (two pair, Sixes and Deuces)
Richard12358: mucks hand 
luchom87 collected $0.43 from pot
*** SUMMARY ***
Total pot $0.45 | Rake $0.02 
Board [6h 4d 2c Ad 2s]
Seat 1: eungenio folded before Flop (didn't bet)
Seat 2: Richard12358 (button) mucked
Seat 3: supernightman (small blind) folded before Flop
Seat 4: luchom87 (big blind) showed [Th 6s] and won ($0.43) with two pair, Sixes and Deuces
Seat 5: Kimi1892 folded before Flop (didn't bet)
Seat 6: bigbadwooods folded before Flop (didn't bet)



PokerStars Hand #222954844123:  Hold'em No Limit ($0.05/$0.10 USD) - 2021/01/23 9:18:19 ET
Table 'Bohlinia III' 6-max Seat #3 is the button
Seat 1: eungenio ($11.11 in chips) 
Seat 2: Richard12358 ($9.69 in chips) 
Seat 3: supernightman ($9.54 in chips) 
Seat 4: luchom87 ($11.84 in chips) 
Seat 5: Kimi1892 ($12.69 in chips) 
Seat 6: bigbadwooods ($23.69 in chips) 
luchom87: posts small blind $0.05
Kimi1892: posts big blind $0.10
*** HOLE CARDS ***
bigbadwooods: folds 
eungenio: folds 
Richard12358: folds 
supernightman: folds 
luchom87: raises $0.20 to $0.30
Kimi1892: calls $0.20
*** FLOP *** [2h Kd Qh]
luchom87: checks 
Kimi1892: checks 
*** TURN *** [2h Kd Qh] [5s]
luchom87: bets $0.44
Kimi1892: folds 
Uncalled bet ($0.44) returned to luchom87
luchom87 collected $0.57 from pot
luchom87: doesn't show hand 
*** SUMMARY ***
Total pot $0.60 | Rake $0.03 
Board [2h Kd Qh 5s]
Seat 1: eungenio folded before Flop (didn't bet)
Seat 2: Richard12358 folded before Flop (didn't bet)
Seat 3: supernightman (button) folded before Flop (didn't bet)
Seat 4: luchom87 (small blind) collected ($0.57)
Seat 5: Kimi1892 (big blind) folded on the Turn
Seat 6: bigbadwooods folded before Flop (didn't bet)



PokerStars Hand #222954859472:  Hold'em No Limit ($0.05/$0.10 USD) - 2021/01/23 9:18:49 ET
Table 'Bohlinia III' 6-max Seat #4 is the button
Seat 1: eungenio ($11.11 in chips) 
Seat 2: Richard12358 ($9.69 in chips) 
Seat 3: supernightman ($9.54 in chips) 
Seat 4: luchom87 ($12.11 in chips) 
Seat 5: Kimi1892 ($12.39 in chips) 
Kimi1892: posts small blind $0.05
eungenio: posts big blind $0.10
*** HOLE CARDS ***
Richard12358: folds 
supernightman: folds 
luchom87: folds 
Kimi1892: raises $0.20 to $0.30
eungenio: folds 
Uncalled bet ($0.20) returned to Kimi1892
Kimi1892 collected $0.20 from pot
Kimi1892: doesn't show hand 
*** SUMMARY ***
Total pot $0.20 | Rake $0 
Seat 1: eungenio (big blind) folded before Flop
Seat 2: Richard12358 folded before Flop (didn't bet)
Seat 3: supernightman folded before Flop (didn't bet)
Seat 4: luchom87 (button) folded before Flop (didn't bet)
Seat 5: Kimi1892 (small blind) collected ($0.20)



PokerStars Hand #222954872788:  Hold'em No Limit ($0.05/$0.10 USD) - 2021/01/23 9:19:16 ET
Table 'Bohlinia III' 6-max Seat #5 is the button
Seat 1: eungenio ($11.01 in chips) 
Seat 2: Richard12358 ($9.69 in chips) 
Seat 3: supernightman ($9.54 in chips) 
Seat 4: luchom87 ($12.11 in chips) 
Seat 5: Kimi1892 ($12.49 in chips) 
eungenio: posts small blind $0.05
Richard12358: posts big blind $0.10
*** HOLE CARDS ***
supernightman: folds 
luchom87: raises $0.20 to $0.30
Kimi1892: folds 
eungenio: folds 
Richard12358: folds 
Uncalled bet ($0.20) returned to luchom87
luchom87 collected $0.25 from pot
luchom87: doesn't show hand 
*** SUMMARY ***
Total pot $0.25 | Rake $0 
Seat 1: eungenio (small blind) folded before Flop
Seat 2: Richard12358 (big blind) folded before Flop
Seat 3: supernightman folded before Flop (didn't bet)
Seat 4: luchom87 collected ($0.25)
Seat 5: Kimi1892 (button) folded before Flop (didn't bet)



PokerStars Hand #222954881548:  Hold'em No Limit ($0.05/$0.10 USD) - 2021/01/23 9:19:33 ET
Table 'Bohlinia III' 6-max Seat #1 is the button
Seat 1: eungenio ($10.96 in chips) 
Seat 2: Richard12358 ($9.59 in chips) 
Seat 3: supernightman ($9.54 in chips) 
Seat 4: luchom87 ($12.26 in chips) 
Seat 5: Kimi1892 ($12.49 in chips) 
Richard12358: posts small blind $0.05
supernightman: posts big blind $0.10
*** HOLE CARDS ***
luchom87: folds 
Kimi1892: raises $0.20 to $0.30
eungenio: folds 
Richard12358: folds 
supernightman: folds 
Uncalled bet ($0.20) returned to Kimi1892
Kimi1892 collected $0.25 from pot
Kimi1892: doesn't show hand 
*** SUMMARY ***
Total pot $0.25 | Rake $0 
Seat 1: eungenio (button) folded before Flop (didn't bet)
Seat 2: Richard12358 (small blind) folded before Flop
Seat 3: supernightman (big blind) folded before Flop
Seat 4: luchom87 folded before Flop (didn't bet)
Seat 5: Kimi1892 collected ($0.25)



PokerStars Hand #222954886760:  Hold'em No Limit ($0.05/$0.10 USD) - 2021/01/23 9:19:44 ET
Table 'Bohlinia III' 6-max Seat #2 is the button
Seat 1: eungenio ($10.96 in chips) 
Seat 2: Richard12358 ($9.54 in chips) 
Seat 3: supernightman ($9.44 in chips) 
Seat 4: luchom87 ($12.26 in chips) 
Seat 5: Kimi1892 ($12.64 in chips) 
supernightman: posts small blind $0.05
luchom87: posts big blind $0.10
*** HOLE CARDS ***
Kimi1892: folds 
eungenio: folds 
Richard12358: calls $0.10
supernightman: folds 
luchom87: checks 
*** FLOP *** [Ks 7c 6h]
luchom87: checks 
Richard12358: bets $0.10
luchom87: calls $0.10
*** TURN *** [Ks 7c 6h] [6d]
luchom87: checks 
Richard12358: bets $0.30
luchom87: calls $0.30
*** RIVER *** [Ks 7c 6h 6d] [5s]
luchom87: checks 
Richard12358: checks 
*** SHOW DOWN ***
luchom87: shows [8s 5c] (two pair, Sixes and Fives)
Richard12358: mucks hand 
luchom87 collected $1 from pot
*** SUMMARY ***
Total pot $1.05 | Rake $0.05 
Board [Ks 7c 6h 6d 5s]
Seat 1: eungenio folded before Flop (didn't bet)
Seat 2: Richard12358 (button) mucked
Seat 3: supernightman (small blind) folded before Flop
Seat 4: luchom87 (big blind) showed [8s 5c] and won ($1) with two pair, Sixes and Fives
Seat 5: Kimi1892 folded before Flop (didn't bet)



PokerStars Hand #222954911922:  Hold'em No Limit ($0.05/$0.10 USD) - 2021/01/23 9:20:34 ET
Table 'Bohlinia III' 6-max Seat #3 is the button
Seat 1: eungenio ($10.96 in chips) 
Seat 2: Richard12358 ($9.04 in chips) 
Seat 3: supernightman ($9.39 in chips) 
Seat 4: luchom87 ($12.76 in chips) 
Seat 5: Kimi1892 ($12.64 in chips) 
Seat 6: bigbadwooods ($23.69 in chips) 
luchom87: posts small blind $0.05
Kimi1892: posts big blind $0.10
bigbadwooods: posts small & big blinds $0.15
*** HOLE CARDS ***
bigbadwooods: raises $0.20 to $0.30
eungenio: folds 
Richard12358: folds 
supernightman: folds 
luchom87: folds 
Kimi1892: folds 
Uncalled bet ($0.20) returned to bigbadwooods
bigbadwooods collected $0.30 from pot
bigbadwooods: doesn't show hand 
*** SUMMARY ***
Total pot $0.30 | Rake $0 
Seat 1: eungenio folded before Flop (didn't bet)
Seat 2: Richard12358 folded before Flop (didn't bet)
Seat 3: supernightman (button) folded before Flop (didn't bet)
Seat 4: luchom87 (small blind) folded before Flop
Seat 5: Kimi1892 (big blind) folded before Flop
Seat 6: bigbadwooods collected ($0.30)



PokerStars Hand #222954919497:  Hold'em No Limit ($0.05/$0.10 USD) - 2021/01/23 9:20:49 ET
Table 'Bohlinia III' 6-max Seat #4 is the button
Seat 1: eungenio ($10.96 in chips) 
Seat 2: Richard12358 ($9.04 in chips) 
Seat 3: supernightman ($9.39 in chips) 
Seat 4: luchom87 ($12.71 in chips) 
Seat 5: Kimi1892 ($12.54 in chips) 
Seat 6: bigbadwooods ($23.84 in chips) 
Kimi1892: posts small blind $0.05
bigbadwooods: posts big blind $0.10
*** HOLE CARDS ***
eungenio: folds 
Richard12358: calls $0.10
supernightman: folds 
luchom87: raises $0.40 to $0.50
Kimi1892: folds 
bigbadwooods: folds 
Richard12358: raises $1.15 to $1.65
luchom87: folds 
Uncalled bet ($1.15) returned to Richard12358
Richard12358 collected $1.15 from pot
Richard12358: doesn't show hand 
*** SUMMARY ***
Total pot $1.15 | Rake $0 
Seat 1: eungenio folded before Flop (didn't bet)
Seat 2: Richard12358 collected ($1.15)
Seat 3: supernightman folded before Flop (didn't bet)
Seat 4: luchom87 (button) folded before Flop
Seat 5: Kimi1892 (small blind) folded before Flop
Seat 6: bigbadwooods (big blind) folded before Flop



PokerStars Hand #222954932571:  Hold'em No Limit ($0.05/$0.10 USD) - 2021/01/23 9:21:15 ET
Table 'Bohlinia III' 6-max Seat #5 is the button
Seat 1: eungenio ($10.96 in chips) 
Seat 2: Richard12358 ($9.69 in chips) 
Seat 3: supernightman ($9.39 in chips) 
Seat 4: luchom87 ($12.21 in chips) 
Seat 5: Kimi1892 ($12.49 in chips) 
Seat 6: bigbadwooods ($23.74 in chips) 
bigbadwooods: posts small blind $0.05
eungenio: posts big blind $0.10
*** HOLE CARDS ***
Richard12358: raises $0.20 to $0.30
supernightman: folds 
luchom87: folds 
Kimi1892: folds 
bigbadwooods: folds 
eungenio: folds 
Uncalled bet ($0.20) returned to Richard12358
Richard12358 collected $0.25 from pot
Richard12358: doesn't show hand 
*** SUMMARY ***
Total pot $0.25 | Rake $0 
Seat 1: eungenio (big blind) folded before Flop
Seat 2: Richard12358 collected ($0.25)
Seat 3: supernightman folded before Flop (didn't bet)
Seat 4: luchom87 folded before Flop (didn't bet)
Seat 5: Kimi1892 (button) folded before Flop (didn't bet)
Seat 6: bigbadwooods (small blind) folded before Flop



PokerStars Hand #222954946822:  Hold'em No Limit ($0.05/$0.10 USD) - 2021/01/23 9:21:44 ET
Table 'Bohlinia III' 6-max Seat #6 is the button
Seat 1: eungenio ($10.86 in chips) 
Seat 2: Richard12358 ($9.84 in chips) 
Seat 3: supernightman ($9.39 in chips) 
Seat 4: luchom87 ($12.21 in chips) 
Seat 5: Kimi1892 ($12.49 in chips) 
Seat 6: bigbadwooods ($23.69 in chips) 
eungenio: posts small blind $0.05
Richard12358: posts big blind $0.10
*** HOLE CARDS ***
supernightman: folds 
luchom87: raises $0.20 to $0.30
Kimi1892: folds 
bigbadwooods: folds 
eungenio: folds 
Richard12358: folds 
Uncalled bet ($0.20) returned to luchom87
luchom87 collected $0.25 from pot
luchom87: doesn't show hand 
*** SUMMARY ***
Total pot $0.25 | Rake $0 
Seat 1: eungenio (small blind) folded before Flop
Seat 2: Richard12358 (big blind) folded before Flop
Seat 3: supernightman folded before Flop (didn't bet)
Seat 4: luchom87 collected ($0.25)
Seat 5: Kimi1892 folded before Flop (didn't bet)
Seat 6: bigbadwooods (button) folded before Flop (didn't bet)



PokerStars Hand #222954955466:  Hold'em No Limit ($0.05/$0.10 USD) - 2021/01/23 9:22:01 ET
Table 'Bohlinia III' 6-max Seat #1 is the button
Seat 1: eungenio ($10.81 in chips) 
Seat 2: Richard12358 ($9.74 in chips) 
Seat 3: supernightman ($9.39 in chips) 
Seat 4: luchom87 ($12.36 in chips) 
Seat 5: Kimi1892 ($12.49 in chips) 
Seat 6: bigbadwooods ($23.69 in chips) 
Richard12358: posts small blind $0.05
supernightman: posts big blind $0.10
*** HOLE CARDS ***
luchom87: raises $0.20 to $0.30
Kimi1892: folds 
bigbadwooods: folds 
eungenio: folds 
Richard12358: folds 
supernightman: folds 
Uncalled bet ($0.20) returned to luchom87
luchom87 collected $0.25 from pot
luchom87: doesn't show hand 
*** SUMMARY ***
Total pot $0.25 | Rake $0 
Seat 1: eungenio (button) folded before Flop (didn't bet)
Seat 2: Richard12358 (small blind) folded before Flop
Seat 3: supernightman (big blind) folded before Flop
Seat 4: luchom87 collected ($0.25)
Seat 5: Kimi1892 folded before Flop (didn't bet)
Seat 6: bigbadwooods folded before Flop (didn't bet)



PokerStars Hand #222954962390:  Hold'em No Limit ($0.05/$0.10 USD) - 2021/01/23 9:22:15 ET
Table 'Bohlinia III' 6-max Seat #2 is the button
Seat 1: eungenio ($10.81 in chips) 
Seat 2: Richard12358 ($9.69 in chips) 
Seat 3: supernightman ($9.29 in chips) 
Seat 4: luchom87 ($12.51 in chips) 
Seat 5: Kimi1892 ($12.49 in chips) 
Seat 6: bigbadwooods ($23.69 in chips) 
supernightman: posts small blind $0.05
luchom87: posts big blind $0.10
*** HOLE CARDS ***
Kimi1892: folds 
bigbadwooods: raises $0.20 to $0.30
eungenio: folds 
Richard12358: calls $0.30
supernightman: raises $1.60 to $1.90
luchom87: folds 
bigbadwooods: folds 
Richard12358: folds 
Uncalled bet ($1.60) returned to supernightman
supernightman collected $1 from pot
*** SUMMARY ***
Total pot $1 | Rake $0 
Seat 1: eungenio folded before Flop (didn't bet)
Seat 2: Richard12358 (button) folded before Flop
Seat 3: supernightman (small blind) collected ($1)
Seat 4: luchom87 (big blind) folded before Flop
Seat 5: Kimi1892 folded before Flop (didn't bet)
Seat 6: bigbadwooods folded before Flop



PokerStars Hand #222954982455:  Hold'em No Limit ($0.05/$0.10 USD) - 2021/01/23 9:22:54 ET
Table 'Bohlinia III' 6-max Seat #3 is the button
Seat 1: eungenio ($10.81 in chips) 
Seat 2: Richard12358 ($9.39 in chips) 
Seat 3: supernightman ($9.99 in chips) 
Seat 4: luchom87 ($12.41 in chips) 
Seat 5: Kimi1892 ($12.49 in chips) 
Seat 6: bigbadwooods ($23.39 in chips) 
luchom87: posts small blind $0.05
Kimi1892: posts big blind $0.10
*** HOLE CARDS ***
bigbadwooods has timed out
bigbadwooods: folds 
eungenio: folds 
Richard12358: raises $0.29 to $0.39
supernightman: calls $0.39
luchom87: folds 
Kimi1892: calls $0.29
*** FLOP *** [7d 6c 9s]
Kimi1892: checks 
Richard12358: checks 
supernightman: checks 
*** TURN *** [7d 6c 9s] [8c]
Kimi1892: checks 
Richard12358: checks 
supernightman: checks 
*** RIVER *** [7d 6c 9s 8c] [4d]
Kimi1892: checks 
Richard12358: checks 
supernightman: checks 
*** SHOW DOWN ***
Kimi1892: shows [Ks Ad] (high card Ace)
Richard12358: shows [9h Th] (a straight, Six to Ten)
supernightman: mucks hand 
Richard12358 collected $1.17 from pot
*** SUMMARY ***
Total pot $1.22 | Rake $0.05 
Board [7d 6c 9s 8c 4d]
Seat 1: eungenio folded before Flop (didn't bet)
Seat 2: Richard12358 showed [9h Th] and won ($1.17) with a straight, Six to Ten
Seat 3: supernightman (button) mucked
Seat 4: luchom87 (small blind) folded before Flop
Seat 5: Kimi1892 (big blind) showed [Ks Ad] and lost with high card Ace
Seat 6: bigbadwooods folded before Flop (didn't bet)



PokerStars Hand #222955013906:  Hold'em No Limit ($0.05/$0.10 USD) - 2021/01/23 9:23:57 ET
Table 'Bohlinia III' 6-max Seat #4 is the button
Seat 1: eungenio ($10.81 in chips) 
Seat 2: Richard12358 ($10.17 in chips) 
Seat 3: supernightman ($9.60 in chips) 
Seat 4: luchom87 ($12.36 in chips) 
Seat 5: Kimi1892 ($12.10 in chips) 
Seat 6: bigbadwooods ($23.39 in chips) 
Kimi1892: posts small blind $0.05
bigbadwooods: posts big blind $0.10
*** HOLE CARDS ***
eungenio: folds 
Richard12358: folds 
supernightman: folds 
luchom87: folds 
Kimi1892: raises $0.20 to $0.30
bigbadwooods: folds 
Uncalled bet ($0.20) returned to Kimi1892
Kimi1892 collected $0.20 from pot
Kimi1892: doesn't show hand 
*** SUMMARY ***
Total pot $0.20 | Rake $0 
Seat 1: eungenio folded before Flop (didn't bet)
Seat 2: Richard12358 folded before Flop (didn't bet)
Seat 3: supernightman folded before Flop (didn't bet)
Seat 4: luchom87 (button) folded before Flop (didn't bet)
Seat 5: Kimi1892 (small blind) collected ($0.20)
Seat 6: bigbadwooods (big blind) folded before Flop



PokerStars Hand #222955019524:  Hold'em No Limit ($0.05/$0.10 USD) - 2021/01/23 9:24:09 ET
Table 'Bohlinia III' 6-max Seat #5 is the button
Seat 1: eungenio ($10.81 in chips) 
Seat 2: Richard12358 ($10.17 in chips) 
Seat 3: supernightman ($9.60 in chips) 
Seat 4: luchom87 ($12.36 in chips) 
Seat 5: Kimi1892 ($12.20 in chips) 
Seat 6: bigbadwooods ($23.29 in chips) 
bigbadwooods: posts small blind $0.05
eungenio: posts big blind $0.10
*** HOLE CARDS ***
Richard12358: raises $0.20 to $0.30
supernightman: folds 
luchom87: folds 
Kimi1892: folds 
bigbadwooods: raises $0.60 to $0.90
eungenio: folds 
Richard12358: folds 
Uncalled bet ($0.60) returned to bigbadwooods
bigbadwooods collected $0.70 from pot
bigbadwooods: doesn't show hand 
*** SUMMARY ***
Total pot $0.70 | Rake $0 
Seat 1: eungenio (big blind) folded before Flop
Seat 2: Richard12358 folded before Flop
Seat 3: supernightman folded before Flop (didn't bet)
Seat 4: luchom87 folded before Flop (didn't bet)
Seat 5: Kimi1892 (button) folded before Flop (didn't bet)
Seat 6: bigbadwooods (small blind) collected ($0.70)



PokerStars Hand #222955028126:  Hold'em No Limit ($0.05/$0.10 USD) - 2021/01/23 9:24:26 ET
Table 'Bohlinia III' 6-max Seat #6 is the button
Seat 1: eungenio ($10.71 in chips) 
Seat 2: Richard12358 ($9.87 in chips) 
Seat 3: supernightman ($9.60 in chips) 
Seat 4: luchom87 ($12.36 in chips) 
Seat 5: Kimi1892 ($12.20 in chips) 
Seat 6: bigbadwooods ($23.69 in chips) 
eungenio: posts small blind $0.05
Richard12358: posts big blind $0.10
*** HOLE CARDS ***
supernightman: folds 
luchom87: raises $0.20 to $0.30
Kimi1892: folds 
bigbadwooods: raises $0.60 to $0.90
eungenio: folds 
Richard12358: folds 
luchom87: calls $0.60
*** FLOP *** [Ts 6c 4c]
luchom87: checks 
bigbadwooods: checks 
*** TURN *** [Ts 6c 4c] [2s]
luchom87: bets $0.65
bigbadwooods: folds 
Uncalled bet ($0.65) returned to luchom87
luchom87 collected $1.86 from pot
luchom87: doesn't show hand 
*** SUMMARY ***
Total pot $1.95 | Rake $0.09 
Board [Ts 6c 4c 2s]
Seat 1: eungenio (small blind) folded before Flop
Seat 2: Richard12358 (big blind) folded before Flop
Seat 3: supernightman folded before Flop (didn't bet)
Seat 4: luchom87 collected ($1.86)
Seat 5: Kimi1892 folded before Flop (didn't bet)
Seat 6: bigbadwooods (button) folded on the Turn



PokerStars Hand #222955044710:  Hold'em No Limit ($0.05/$0.10 USD) - 2021/01/23 9:25:00 ET
Table 'Bohlinia III' 6-max Seat #1 is the button
Seat 1: eungenio ($10.66 in chips) 
Seat 2: Richard12358 ($9.77 in chips) 
Seat 3: supernightman ($9.60 in chips) 
Seat 4: luchom87 ($13.32 in chips) 
Seat 5: Kimi1892 ($12.20 in chips) 
Seat 6: bigbadwooods ($22.79 in chips) 
Richard12358: posts small blind $0.05
supernightman: posts big blind $0.10
*** HOLE CARDS ***
luchom87: folds 
Kimi1892: folds 
bigbadwooods: folds 
eungenio: raises $0.15 to $0.25
Richard12358: calls $0.20
supernightman: calls $0.15
*** FLOP *** [2s 7c Tc]
Richard12358: checks 
supernightman: checks 
eungenio: bets $0.55
Richard12358: raises $1.15 to $1.70
supernightman: folds 
eungenio: calls $1.15
*** TURN *** [2s 7c Tc] [Qc]
Richard12358: checks 
eungenio: checks 
*** RIVER *** [2s 7c Tc Qc] [8c]
Richard12358: bets $3.96
eungenio: calls $3.96
*** SHOW DOWN ***
Richard12358: shows [3d Jd] (high card Queen)
eungenio: shows [Kc Ks] (a flush, King high)
eungenio collected $11.53 from pot
*** SUMMARY ***
Total pot $12.07 | Rake $0.54 
Board [2s 7c Tc Qc 8c]
Seat 1: eungenio (button) showed [Kc Ks] and won ($11.53) with a flush, King high
Seat 2: Richard12358 (small blind) showed [3d Jd] and lost with high card Queen
Seat 3: supernightman (big blind) folded on the Flop
Seat 4: luchom87 folded before Flop (didn't bet)
Seat 5: Kimi1892 folded before Flop (didn't bet)
Seat 6: bigbadwooods folded before Flop (didn't bet)



PokerStars Hand #222955082201:  Hold'em No Limit ($0.05/$0.10 USD) - 2021/01/23 9:26:16 ET
Table 'Bohlinia III' 6-max Seat #2 is the button
Seat 1: eungenio ($16.28 in chips) 
Seat 2: Richard12358 ($3.86 in chips) 
Seat 3: supernightman ($9.35 in chips) 
Seat 4: luchom87 ($13.32 in chips) 
Seat 5: Kimi1892 ($12.20 in chips) 
Seat 6: bigbadwooods ($22.79 in chips) 
supernightman: posts small blind $0.05
luchom87: posts big blind $0.10
*** HOLE CARDS ***
Kimi1892: folds 
bigbadwooods: folds 
eungenio: folds 
Richard12358: folds 
supernightman: folds 
Uncalled bet ($0.05) returned to luchom87
luchom87 collected $0.10 from pot
luchom87: doesn't show hand 
bigbadwooods leaves the table
*** SUMMARY ***
Total pot $0.10 | Rake $0 
Seat 1: eungenio folded before Flop (didn't bet)
Seat 2: Richard12358 (button) folded before Flop (didn't bet)
Seat 3: supernightman (small blind) folded before Flop
Seat 4: luchom87 (big blind) collected ($0.10)
Seat 5: Kimi1892 folded before Flop (didn't bet)
Seat 6: bigbadwooods folded before Flop (didn't bet)



PokerStars Hand #222955096448:  Hold'em No Limit ($0.05/$0.10 USD) - 2021/01/23 9:26:45 ET
Table 'Bohlinia III' 6-max Seat #3 is the button
Seat 1: eungenio ($16.28 in chips) 
Seat 2: Richard12358 ($10 in chips) 
Seat 3: supernightman ($9.30 in chips) 
Seat 4: luchom87 ($13.37 in chips) 
Seat 5: Kimi1892 ($12.20 in chips) 
luchom87: posts small blind $0.05
Kimi1892: posts big blind $0.10
*** HOLE CARDS ***
eungenio: folds 
Richard12358: calls $0.10
saitam_06 joins the table at seat #6 
supernightman: folds 
luchom87: folds 
Kimi1892: checks 
*** FLOP *** [Qc 9s 7s]
Kimi1892: checks 
Richard12358: bets $0.10
Kimi1892: calls $0.10
*** TURN *** [Qc 9s 7s] [As]
Kimi1892: checks 
Richard12358: bets $0.36
Kimi1892: folds 
Uncalled bet ($0.36) returned to Richard12358
Richard12358 collected $0.43 from pot
Richard12358: doesn't show hand 
*** SUMMARY ***
Total pot $0.45 | Rake $0.02 
Board [Qc 9s 7s As]
Seat 1: eungenio folded before Flop (didn't bet)
Seat 2: Richard12358 collected ($0.43)
Seat 3: supernightman (button) folded before Flop (didn't bet)
Seat 4: luchom87 (small blind) folded before Flop
Seat 5: Kimi1892 (big blind) folded on the Turn



PokerStars Hand #222955114803:  Hold'em No Limit ($0.05/$0.10 USD) - 2021/01/23 9:27:22 ET
Table 'Bohlinia III' 6-max Seat #4 is the button
Seat 1: eungenio ($16.28 in chips) 
Seat 2: Richard12358 ($10.23 in chips) 
Seat 3: supernightman ($9.30 in chips) 
Seat 4: luchom87 ($13.32 in chips) 
Seat 5: Kimi1892 ($12 in chips) 
Seat 6: saitam_06 ($10 in chips) 
Kimi1892: posts small blind $0.05
saitam_06: posts big blind $0.10
*** HOLE CARDS ***
eungenio: folds 
Richard12358: raises $0.20 to $0.30
supernightman: folds 
luchom87: folds 
Kimi1892: folds 
saitam_06: folds 
Uncalled bet ($0.20) returned to Richard12358
Richard12358 collected $0.25 from pot
Richard12358: doesn't show hand 
*** SUMMARY ***
Total pot $0.25 | Rake $0 
Seat 1: eungenio folded before Flop (didn't bet)
Seat 2: Richard12358 collected ($0.25)
Seat 3: supernightman folded before Flop (didn't bet)
Seat 4: luchom87 (button) folded before Flop (didn't bet)
Seat 5: Kimi1892 (small blind) folded before Flop
Seat 6: saitam_06 (big blind) folded before Flop



PokerStars Hand #222955121754:  Hold'em No Limit ($0.05/$0.10 USD) - 2021/01/23 9:27:36 ET
Table 'Bohlinia III' 6-max Seat #5 is the button
Seat 1: eungenio ($16.28 in chips) 
Seat 2: Richard12358 ($10.38 in chips) 
Seat 3: supernightman ($9.30 in chips) 
Seat 4: luchom87 ($13.32 in chips) 
Seat 5: Kimi1892 ($11.95 in chips) 
Seat 6: saitam_06 ($10 in chips) 
saitam_06: posts small blind $0.05
eungenio: posts big blind $0.10
*** HOLE CARDS ***
Richard12358: folds 
supernightman: folds 
luchom87: folds 
Kimi1892: folds 
saitam_06: raises $0.15 to $0.25
eungenio: calls $0.15
*** FLOP *** [7d Kh 6s]
saitam_06: bets $0.24
eungenio: calls $0.24
*** TURN *** [7d Kh 6s] [3h]
saitam_06: checks 
eungenio: checks 
*** RIVER *** [7d Kh 6s 3h] [Jc]
saitam_06: bets $0.94
eungenio: folds 
Uncalled bet ($0.94) returned to saitam_06
saitam_06 collected $0.94 from pot
saitam_06: doesn't show hand 
*** SUMMARY ***
Total pot $0.98 | Rake $0.04 
Board [7d Kh 6s 3h Jc]
Seat 1: eungenio (big blind) folded on the River
Seat 2: Richard12358 folded before Flop (didn't bet)
Seat 3: supernightman folded before Flop (didn't bet)
Seat 4: luchom87 folded before Flop (didn't bet)
Seat 5: Kimi1892 (button) folded before Flop (didn't bet)
Seat 6: saitam_06 (small blind) collected ($0.94)



PokerStars Hand #222955146835:  Hold'em No Limit ($0.05/$0.10 USD) - 2021/01/23 9:28:13 ET
Table 'Bohlinia III' 6-max Seat #6 is the button
Seat 1: eungenio ($15.79 in chips) 
Seat 2: Richard12358 ($10.38 in chips) 
Seat 3: supernightman ($9.30 in chips) 
Seat 4: luchom87 ($13.32 in chips) 
Seat 5: Kimi1892 ($11.95 in chips) 
Seat 6: saitam_06 ($10.45 in chips) 
eungenio: posts small blind $0.05
Richard12358: posts big blind $0.10
*** HOLE CARDS ***
supernightman: folds 
luchom87: folds 
Kimi1892: raises $0.20 to $0.30
saitam_06: folds 
eungenio: folds 
Richard12358: folds 
Uncalled bet ($0.20) returned to Kimi1892
Kimi1892 collected $0.25 from pot
Kimi1892: doesn't show hand 
*** SUMMARY ***
Total pot $0.25 | Rake $0 
Seat 1: eungenio (small blind) folded before Flop
Seat 2: Richard12358 (big blind) folded before Flop
Seat 3: supernightman folded before Flop (didn't bet)
Seat 4: luchom87 folded before Flop (didn't bet)
Seat 5: Kimi1892 collected ($0.25)
Seat 6: saitam_06 (button) folded before Flop (didn't bet)



PokerStars Hand #222955157392:  Hold'em No Limit ($0.05/$0.10 USD) - 2021/01/23 9:28:34 ET
Table 'Bohlinia III' 6-max Seat #1 is the button
Seat 1: eungenio ($15.74 in chips) 
Seat 2: Richard12358 ($10.28 in chips) 
Seat 3: supernightman ($9.30 in chips) 
Seat 4: luchom87 ($13.32 in chips) 
Seat 5: Kimi1892 ($12.10 in chips) 
Seat 6: saitam_06 ($10.45 in chips) 
Richard12358: posts small blind $0.05
supernightman: posts big blind $0.10
*** HOLE CARDS ***
luchom87: folds 
luchom87 was removed from the table for failing to post
luchom87 leaves the table
Kimi1892: folds 
saitam_06: folds 
EES888 joins the table at seat #4 
eungenio: raises $0.15 to $0.25
Richard12358: calls $0.20
supernightman: folds 
*** FLOP *** [8d 5h Qh]
Richard12358: bets $0.29
eungenio: calls $0.29
*** TURN *** [8d 5h Qh] [Ah]
Richard12358: bets $0.57
eungenio: calls $0.57
*** RIVER *** [8d 5h Qh Ah] [5c]
Richard12358: checks 
eungenio: checks 
*** SHOW DOWN ***
Richard12358: shows [6c 4c] (a pair of Fives)
eungenio: shows [8s Ac] (two pair, Aces and Eights)
eungenio collected $2.22 from pot
*** SUMMARY ***
Total pot $2.32 | Rake $0.10 
Board [8d 5h Qh Ah 5c]
Seat 1: eungenio (button) showed [8s Ac] and won ($2.22) with two pair, Aces and Eights
Seat 2: Richard12358 (small blind) showed [6c 4c] and lost with a pair of Fives
Seat 3: supernightman (big blind) folded before Flop
Seat 4: luchom87 folded before Flop (didn't bet)
Seat 5: Kimi1892 folded before Flop (didn't bet)
Seat 6: saitam_06 folded before Flop (didn't bet)



PokerStars Hand #222955186713:  Hold'em No Limit ($0.05/$0.10 USD) - 2021/01/23 9:29:34 ET
Table 'Bohlinia III' 6-max Seat #2 is the button
Seat 1: eungenio ($16.85 in chips) 
Seat 2: Richard12358 ($9.17 in chips) 
Seat 3: supernightman ($9.20 in chips) 
Seat 4: EES888 ($10 in chips) 
Seat 5: Kimi1892 ($12.10 in chips) 
Seat 6: saitam_06 ($10.45 in chips) 
supernightman: posts small blind $0.05
EES888: posts big blind $0.10
*** HOLE CARDS ***
Kimi1892: folds 
saitam_06: folds 
eungenio: folds 
Richard12358: folds 
supernightman: folds 
Uncalled bet ($0.05) returned to EES888
EES888 collected $0.10 from pot
EES888: doesn't show hand 
*** SUMMARY ***
Total pot $0.10 | Rake $0 
Seat 1: eungenio folded before Flop (didn't bet)
Seat 2: Richard12358 (button) folded before Flop (didn't bet)
Seat 3: supernightman (small blind) folded before Flop
Seat 4: EES888 (big blind) collected ($0.10)
Seat 5: Kimi1892 folded before Flop (didn't bet)
Seat 6: saitam_06 folded before Flop (didn't bet)



PokerStars Hand #222955190533:  Hold'em No Limit ($0.05/$0.10 USD) - 2021/01/23 9:29:41 ET
Table 'Bohlinia III' 6-max Seat #3 is the button
Seat 1: eungenio ($16.85 in chips) 
Seat 2: Richard12358 ($9.17 in chips) 
Seat 3: supernightman ($9.15 in chips) 
Seat 4: EES888 ($10.05 in chips) 
Seat 5: Kimi1892 ($12.10 in chips) 
Seat 6: saitam_06 ($10.45 in chips) 
EES888: posts small blind $0.05
Kimi1892: posts big blind $0.10
*** HOLE CARDS ***
saitam_06: folds 
eungenio: folds 
Richard12358: folds 
supernightman: raises $0.20 to $0.30
EES888: calls $0.25
Kimi1892: calls $0.20
*** FLOP *** [6s 3d 2h]
EES888: checks 
Kimi1892: checks 
supernightman: checks 
*** TURN *** [6s 3d 2h] [3h]
EES888: checks 
Kimi1892: bets $0.44
supernightman: folds 
EES888: calls $0.44
*** RIVER *** [6s 3d 2h 3h] [7c]
EES888: checks 
Kimi1892: bets $1.40
EES888: calls $1.40
*** SHOW DOWN ***
Kimi1892: shows [Ks 9d] (a pair of Threes)
EES888: shows [6c Jd] (two pair, Sixes and Threes)
EES888 collected $4.37 from pot
*** SUMMARY ***
Total pot $4.58 | Rake $0.21 
Board [6s 3d 2h 3h 7c]
Seat 1: eungenio folded before Flop (didn't bet)
Seat 2: Richard12358 folded before Flop (didn't bet)
Seat 3: supernightman (button) folded on the Turn
Seat 4: EES888 (small blind) showed [6c Jd] and won ($4.37) with two pair, Sixes and Threes
Seat 5: Kimi1892 (big blind) showed [Ks 9d] and lost with a pair of Threes
Seat 6: saitam_06 folded before Flop (didn't bet)



PokerStars Hand #222955229008:  Hold'em No Limit ($0.05/$0.10 USD) - 2021/01/23 9:30:58 ET
Table 'Bohlinia III' 6-max Seat #5 is the button
Seat 1: eungenio ($16.85 in chips) 
Seat 2: Richard12358 ($9.59 in chips) 
Seat 3: supernightman ($10 in chips) 
Seat 4: EES888 ($11.98 in chips) 
Seat 5: Kimi1892 ($10 in chips) 
Seat 6: saitam_06 ($10.35 in chips) 
saitam_06: posts small blind $0.05
eungenio: posts big blind $0.10
*** HOLE CARDS ***
Richard12358: folds 
supernightman: folds 
EES888: calls $0.10
Kimi1892: folds 
saitam_06: raises $0.40 to $0.50
eungenio: calls $0.40
EES888: calls $0.40
*** FLOP *** [9c 7c 6d]
saitam_06: checks 
eungenio: checks 
EES888: checks 
*** TURN *** [9c 7c 6d] [Ah]
saitam_06: bets $0.80
eungenio: calls $0.80
EES888: folds 
*** RIVER *** [9c 7c 6d Ah] [Kc]
saitam_06: checks 
eungenio: bets $1.63
saitam_06: folds 
Uncalled bet ($1.63) returned to eungenio
eungenio collected $2.96 from pot
eungenio: doesn't show hand 
*** SUMMARY ***
Total pot $3.10 | Rake $0.14 
Board [9c 7c 6d Ah Kc]
Seat 1: eungenio (big blind) collected ($2.96)
Seat 2: Richard12358 folded before Flop (didn't bet)
Seat 3: supernightman folded before Flop (didn't bet)
Seat 4: EES888 folded on the Turn
Seat 5: Kimi1892 (button) folded before Flop (didn't bet)
Seat 6: saitam_06 (small blind) folded on the River



PokerStars Hand #222955261892:  Hold'em No Limit ($0.05/$0.10 USD) - 2021/01/23 9:32:03 ET
Table 'Bohlinia III' 6-max Seat #6 is the button
Seat 1: eungenio ($18.51 in chips) 
Seat 2: Richard12358 ($9.59 in chips) 
Seat 3: supernightman ($10 in chips) 
Seat 4: EES888 ($11.48 in chips) 
Seat 5: Kimi1892 ($10 in chips) 
Seat 6: saitam_06 ($10 in chips) 
eungenio: posts small blind $0.05
Richard12358: posts big blind $0.10
*** HOLE CARDS ***
supernightman: folds 
EES888: calls $0.10
Kimi1892: raises $0.40 to $0.50
saitam_06: folds 
eungenio: folds 
Richard12358: folds 
EES888: folds 
Uncalled bet ($0.40) returned to Kimi1892
Kimi1892 collected $0.35 from pot
Kimi1892: doesn't show hand 
*** SUMMARY ***
Total pot $0.35 | Rake $0 
Seat 1: eungenio (small blind) folded before Flop
Seat 2: Richard12358 (big blind) folded before Flop
Seat 3: supernightman folded before Flop (didn't bet)
Seat 4: EES888 folded before Flop
Seat 5: Kimi1892 collected ($0.35)
Seat 6: saitam_06 (button) folded before Flop (didn't bet)



PokerStars Hand #222955271739:  Hold'em No Limit ($0.05/$0.10 USD) - 2021/01/23 9:32:22 ET
Table 'Bohlinia III' 6-max Seat #1 is the button
Seat 1: eungenio ($18.46 in chips) 
Seat 2: Richard12358 ($9.49 in chips) 
Seat 3: supernightman ($10 in chips) 
Seat 4: EES888 ($11.38 in chips) 
Seat 5: Kimi1892 ($10.25 in chips) 
Seat 6: saitam_06 ($10 in chips) 
Richard12358: posts small blind $0.05
supernightman: posts big blind $0.10
*** HOLE CARDS ***
EES888: calls $0.10
Kimi1892: folds 
saitam_06: folds 
eungenio: folds 
Richard12358: calls $0.05
supernightman: raises $0.20 to $0.30
EES888: calls $0.20
Richard12358: calls $0.20
*** FLOP *** [Ah Th 9c]
Richard12358: checks 
supernightman: bets $0.43
EES888: calls $0.43
Richard12358: folds 
*** TURN *** [Ah Th 9c] [5c]
supernightman: checks 
EES888: checks 
*** RIVER *** [Ah Th 9c 5c] [Jc]
supernightman: bets $1.26
EES888: folds 
Uncalled bet ($1.26) returned to supernightman
supernightman collected $1.68 from pot
*** SUMMARY ***
Total pot $1.76 | Rake $0.08 
Board [Ah Th 9c 5c Jc]
Seat 1: eungenio (button) folded before Flop (didn't bet)
Seat 2: Richard12358 (small blind) folded on the Flop
Seat 3: supernightman (big blind) collected ($1.68)
Seat 4: EES888 folded on the River
Seat 5: Kimi1892 folded before Flop (didn't bet)
Seat 6: saitam_06 folded before Flop (didn't bet)



PokerStars Hand #222955298977:  Hold'em No Limit ($0.05/$0.10 USD) - 2021/01/23 9:33:16 ET
Table 'Bohlinia III' 6-max Seat #2 is the button
Seat 1: eungenio ($18.46 in chips) 
Seat 2: Richard12358 ($9.19 in chips) 
Seat 3: supernightman ($10.95 in chips) 
Seat 4: EES888 ($10.65 in chips) 
Seat 5: Kimi1892 ($10.25 in chips) 
Seat 6: saitam_06 ($10 in chips) 
supernightman: posts small blind $0.05
EES888: posts big blind $0.10
*** HOLE CARDS ***
Kimi1892 has timed out
Kimi1892: folds 
saitam_06: folds 
eungenio: raises $0.20 to $0.30
Richard12358: calls $0.30
supernightman: folds 
EES888: calls $0.20
*** FLOP *** [Jc Ad 8s]
EES888: checks 
eungenio: checks 
Richard12358: bets $0.46
EES888: calls $0.46
eungenio: folds 
*** TURN *** [Jc Ad 8s] [5c]
EES888: checks 
Richard12358: checks 
*** RIVER *** [Jc Ad 8s 5c] [6d]
EES888: checks 
Richard12358: checks 
*** SHOW DOWN ***
EES888: shows [Ah 3c] (a pair of Aces)
Richard12358: mucks hand 
EES888 collected $1.79 from pot
*** SUMMARY ***
Total pot $1.87 | Rake $0.08 
Board [Jc Ad 8s 5c 6d]
Seat 1: eungenio folded on the Flop
Seat 2: Richard12358 (button) mucked
Seat 3: supernightman (small blind) folded before Flop
Seat 4: EES888 (big blind) showed [Ah 3c] and won ($1.79) with a pair of Aces
Seat 5: Kimi1892 folded before Flop (didn't bet)
Seat 6: saitam_06 folded before Flop (didn't bet)



PokerStars Hand #222955324776:  Hold'em No Limit ($0.05/$0.10 USD) - 2021/01/23 9:34:08 ET
Table 'Bohlinia III' 6-max Seat #3 is the button
Seat 1: eungenio ($18.16 in chips) 
Seat 2: Richard12358 ($8.43 in chips) 
Seat 3: supernightman ($10.90 in chips) 
Seat 4: EES888 ($11.68 in chips) 
Seat 6: saitam_06 ($10 in chips) 
EES888: posts small blind $0.05
saitam_06: posts big blind $0.10
*** HOLE CARDS ***
eungenio: folds 
Richard12358: folds 
supernightman: folds 
EES888: calls $0.05
saitam_06: checks 
*** FLOP *** [2s Kc 8c]
EES888: checks 
saitam_06: checks 
*** TURN *** [2s Kc 8c] [2d]
EES888: checks 
saitam_06: checks 
*** RIVER *** [2s Kc 8c 2d] [5s]
EES888: checks 
saitam_06: checks 
*** SHOW DOWN ***
EES888: shows [3d As] (a pair of Deuces)
saitam_06: shows [4d Ad] (a pair of Deuces)
EES888 collected $0.10 from pot
saitam_06 collected $0.09 from pot
*** SUMMARY ***
Total pot $0.20 | Rake $0.01 
Board [2s Kc 8c 2d 5s]
Seat 1: eungenio folded before Flop (didn't bet)
Seat 2: Richard12358 folded before Flop (didn't bet)
Seat 3: supernightman (button) folded before Flop (didn't bet)
Seat 4: EES888 (small blind) showed [3d As] and won ($0.10) with a pair of Deuces
Seat 6: saitam_06 (big blind) showed [4d Ad] and won ($0.09) with a pair of Deuces



PokerStars Hand #222955347070:  Hold'em No Limit ($0.05/$0.10 USD) - 2021/01/23 9:34:52 ET
Table 'Bohlinia III' 6-max Seat #4 is the button
Seat 1: eungenio ($18.16 in chips) 
Seat 2: Richard12358 ($10 in chips) 
Seat 3: supernightman ($10.90 in chips) 
Seat 4: EES888 ($11.68 in chips) 
Seat 6: saitam_06 ($10 in chips) 
saitam_06: posts small blind $0.05
eungenio: posts big blind $0.10
*** HOLE CARDS ***
Richard12358: calls $0.10
supernightman: folds 
EES888: calls $0.10
saitam_06: folds 
eungenio: checks 
*** FLOP *** [Jh Jc Ah]
eungenio: checks 
Richard12358: checks 
EES888: checks 
*** TURN *** [Jh Jc Ah] [6s]
eungenio: checks 
Richard12358: checks 
EES888: bets $1.30
eungenio: folds 
Richard12358: folds 
Uncalled bet ($1.30) returned to EES888
EES888 collected $0.33 from pot
EES888: doesn't show hand 
*** SUMMARY ***
Total pot $0.35 | Rake $0.02 
Board [Jh Jc Ah 6s]
Seat 1: eungenio (big blind) folded on the Turn
Seat 2: Richard12358 folded on the Turn
Seat 3: supernightman folded before Flop (didn't bet)
Seat 4: EES888 (button) collected ($0.33)
Seat 6: saitam_06 (small blind) folded before Flop



PokerStars Hand #222955363716:  Hold'em No Limit ($0.05/$0.10 USD) - 2021/01/23 9:35:24 ET
Table 'Bohlinia III' 6-max Seat #6 is the button
Seat 1: eungenio ($18.06 in chips) 
Seat 2: Richard12358 ($9.90 in chips) 
Seat 3: supernightman ($10.90 in chips) 
Seat 4: EES888 ($11.91 in chips) 
Seat 6: saitam_06 ($10 in chips) 
eungenio: posts small blind $0.05
Richard12358: posts big blind $0.10
*** HOLE CARDS ***
supernightman: folds 
EES888: calls $0.10
saitam_06: folds 
eungenio: calls $0.05
Richard12358: checks 
*** FLOP *** [8h Jh Th]
eungenio: checks 
Richard12358: bets $0.15
EES888: calls $0.15
eungenio: folds 
*** TURN *** [8h Jh Th] [Kd]
Richard12358: bets $0.29
EES888: calls $0.29
*** RIVER *** [8h Jh Th Kd] [8c]
Richard12358: bets $0.41
EES888: calls $0.41
*** SHOW DOWN ***
Richard12358: shows [Tc 2s] (two pair, Tens and Eights)
EES888: shows [4d 8s] (three of a kind, Eights)
EES888 collected $1.91 from pot
*** SUMMARY ***
Total pot $2 | Rake $0.09 
Board [8h Jh Th Kd 8c]
Seat 1: eungenio (small blind) folded on the Flop
Seat 2: Richard12358 (big blind) showed [Tc 2s] and lost with two pair, Tens and Eights
Seat 3: supernightman folded before Flop (didn't bet)
Seat 4: EES888 showed [4d 8s] and won ($1.91) with three of a kind, Eights
Seat 6: saitam_06 (button) folded before Flop (didn't bet)



PokerStars Hand #222955390225:  Hold'em No Limit ($0.05/$0.10 USD) - 2021/01/23 9:36:18 ET
Table 'Bohlinia III' 6-max Seat #1 is the button
Seat 1: eungenio ($17.96 in chips) 
Seat 2: Richard12358 ($8.95 in chips) 
Seat 3: supernightman ($10.90 in chips) 
Seat 4: EES888 ($12.87 in chips) 
Seat 6: saitam_06 ($10 in chips) 
Richard12358: posts small blind $0.05
supernightman: posts big blind $0.10
*** HOLE CARDS ***
EES888: calls $0.10
saitam_06: folds 
eungenio: folds 
Richard12358: raises $0.20 to $0.30
supernightman: folds 
EES888: calls $0.20
*** FLOP *** [4c 9s 3d]
Richard12358: bets $0.29
EES888: calls $0.29
*** TURN *** [4c 9s 3d] [Qc]
Richard12358: bets $0.61
EES888: folds 
Uncalled bet ($0.61) returned to Richard12358
Richard12358 collected $1.22 from pot
Richard12358: doesn't show hand 
*** SUMMARY ***
Total pot $1.28 | Rake $0.06 
Board [4c 9s 3d Qc]
Seat 1: eungenio (button) folded before Flop (didn't bet)
Seat 2: Richard12358 (small blind) collected ($1.22)
Seat 3: supernightman (big blind) folded before Flop
Seat 4: EES888 folded on the Turn
Seat 6: saitam_06 folded before Flop (didn't bet)



PokerStars Hand #222955409322:  Hold'em No Limit ($0.05/$0.10 USD) - 2021/01/23 9:36:56 ET
Table 'Bohlinia III' 6-max Seat #2 is the button
Seat 1: eungenio ($17.96 in chips) 
Seat 2: Richard12358 ($9.58 in chips) 
Seat 3: supernightman ($10.80 in chips) 
Seat 4: EES888 ($12.28 in chips) 
Seat 6: saitam_06 ($10 in chips) 
supernightman: posts small blind $0.05
EES888: posts big blind $0.10
*** HOLE CARDS ***
saitam_06: folds 
eungenio: folds 
Richard12358: calls $0.10
supernightman: calls $0.05
EES888: checks 
*** FLOP *** [5s Js 9s]
supernightman: checks 
EES888: checks 
Richard12358: checks 
*** TURN *** [5s Js 9s] [4s]
supernightman: bets $0.15
EES888: folds 
Richard12358: folds 
Uncalled bet ($0.15) returned to supernightman
supernightman collected $0.29 from pot
*** SUMMARY ***
Total pot $0.30 | Rake $0.01 
Board [5s Js 9s 4s]
Seat 1: eungenio folded before Flop (didn't bet)
Seat 2: Richard12358 (button) folded on the Turn
Seat 3: supernightman (small blind) collected ($0.29)
Seat 4: EES888 (big blind) folded on the Turn
Seat 6: saitam_06 folded before Flop (didn't bet)



PokerStars Hand #222955432774:  Hold'em No Limit ($0.05/$0.10 USD) - 2021/01/23 9:37:43 ET
Table 'Bohlinia III' 6-max Seat #3 is the button
Seat 1: eungenio ($17.96 in chips) 
Seat 2: Richard12358 ($9.48 in chips) 
Seat 3: supernightman ($10.99 in chips) 
Seat 4: EES888 ($12.18 in chips) 
Seat 6: saitam_06 ($10 in chips) 
EES888: posts small blind $0.05
saitam_06: posts big blind $0.10
*** HOLE CARDS ***
eungenio: folds 
Richard12358: calls $0.10
supernightman: folds 
EES888: calls $0.05
saitam_06: checks 
*** FLOP *** [5d Qd 3h]
EES888: checks 
saitam_06: checks 
Richard12358: bets $0.15
EES888: calls $0.15
saitam_06: folds 
*** TURN *** [5d Qd 3h] [Ah]
EES888: checks 
Richard12358: bets $0.20
EES888: calls $0.20
*** RIVER *** [5d Qd 3h Ah] [9s]
EES888: checks 
Richard12358: bets $0.96
EES888: folds 
Uncalled bet ($0.96) returned to Richard12358
Richard12358 collected $0.96 from pot
Richard12358: doesn't show hand 
*** SUMMARY ***
Total pot $1 | Rake $0.04 
Board [5d Qd 3h Ah 9s]
Seat 1: eungenio folded before Flop (didn't bet)
Seat 2: Richard12358 collected ($0.96)
Seat 3: supernightman (button) folded before Flop (didn't bet)
Seat 4: EES888 (small blind) folded on the River
Seat 6: saitam_06 (big blind) folded on the Flop



PokerStars Hand #222955469887:  Hold'em No Limit ($0.05/$0.10 USD) - 2021/01/23 9:38:56 ET
Table 'Bohlinia III' 6-max Seat #4 is the button
Seat 1: eungenio ($17.96 in chips) 
Seat 2: Richard12358 ($9.99 in chips) 
Seat 3: supernightman ($10.99 in chips) 
Seat 4: EES888 ($11.73 in chips) 
Seat 6: saitam_06 ($10 in chips) 
saitam_06: posts small blind $0.05
eungenio: posts big blind $0.10
*** HOLE CARDS ***
Richard12358: folds 
supernightman: raises $0.20 to $0.30
EES888: calls $0.30
saitam_06: folds 
eungenio: folds 
*** FLOP *** [Tc Td 7c]
supernightman: checks 
EES888: checks 
*** TURN *** [Tc Td 7c] [5c]
supernightman: bets $0.36
EES888: calls $0.36
*** RIVER *** [Tc Td 7c 5c] [Ac]
supernightman: checks 
EES888: checks 
*** SHOW DOWN ***
supernightman: shows [6d 7d] (two pair, Tens and Sevens)
EES888: mucks hand 
supernightman collected $1.40 from pot
*** SUMMARY ***
Total pot $1.47 | Rake $0.07 
Board [Tc Td 7c 5c Ac]
Seat 1: eungenio (big blind) folded before Flop
Seat 2: Richard12358 folded before Flop (didn't bet)
Seat 3: supernightman showed [6d 7d] and won ($1.40) with two pair, Tens and Sevens
Seat 4: EES888 (button) mucked
Seat 6: saitam_06 (small blind) folded before Flop



PokerStars Hand #222955488710:  Hold'em No Limit ($0.05/$0.10 USD) - 2021/01/23 9:39:34 ET
Table 'Bohlinia III' 6-max Seat #6 is the button
Seat 1: eungenio ($17.86 in chips) 
Seat 2: Richard12358 ($9.99 in chips) 
Seat 3: supernightman ($11.73 in chips) 
Seat 4: EES888 ($11.07 in chips) 
Seat 6: saitam_06 ($10 in chips) 
eungenio: posts small blind $0.05
Richard12358: posts big blind $0.10
Kimi1892: sits out 
*** HOLE CARDS ***
supernightman: raises $0.20 to $0.30
EES888: calls $0.30
saitam_06: folds 
eungenio: folds 
Richard12358: calls $0.20
*** FLOP *** [5d Kc 6s]
Richard12358: checks 
supernightman: checks 
EES888: checks 
*** TURN *** [5d Kc 6s] [3h]
Richard12358: checks 
supernightman: checks 
EES888: checks 
*** RIVER *** [5d Kc 6s 3h] [3c]
Richard12358: checks 
supernightman: bets $0.46
EES888: folds 
Richard12358: folds 
Uncalled bet ($0.46) returned to supernightman
supernightman collected $0.91 from pot
*** SUMMARY ***
Total pot $0.95 | Rake $0.04 
Board [5d Kc 6s 3h 3c]
Seat 1: eungenio (small blind) folded before Flop
Seat 2: Richard12358 (big blind) folded on the River
Seat 3: supernightman collected ($0.91)
Seat 4: EES888 folded on the River
Seat 6: saitam_06 (button) folded before Flop (didn't bet)



PokerStars Hand #222955506555:  Hold'em No Limit ($0.05/$0.10 USD) - 2021/01/23 9:40:09 ET
Table 'Bohlinia III' 6-max Seat #1 is the button
Seat 1: eungenio ($17.81 in chips) 
Seat 2: Richard12358 ($9.69 in chips) 
Seat 3: supernightman ($12.34 in chips) 
Seat 4: EES888 ($10.77 in chips) 
Seat 6: saitam_06 ($10 in chips) 
Richard12358: posts small blind $0.05
supernightman: posts big blind $0.10
Kimi1892: sits out 
*** HOLE CARDS ***
EES888: calls $0.10
saitam_06: raises $0.40 to $0.50
eungenio: folds 
Richard12358: calls $0.45
supernightman: folds 
EES888: calls $0.40
*** FLOP *** [3s Qd 8h]
Richard12358: checks 
EES888: checks 
saitam_06: bets $0.90
Richard12358: folds 
EES888: folds 
Uncalled bet ($0.90) returned to saitam_06
saitam_06 collected $1.53 from pot
saitam_06: doesn't show hand 
*** SUMMARY ***
Total pot $1.60 | Rake $0.07 
Board [3s Qd 8h]
Seat 1: eungenio (button) folded before Flop (didn't bet)
Seat 2: Richard12358 (small blind) folded on the Flop
Seat 3: supernightman (big blind) folded before Flop
Seat 4: EES888 folded on the Flop
Seat 6: saitam_06 collected ($1.53)



PokerStars Hand #222955533237:  Hold'em No Limit ($0.05/$0.10 USD) - 2021/01/23 9:41:02 ET
Table 'Bohlinia III' 6-max Seat #2 is the button
Seat 1: eungenio ($17.81 in chips) 
Seat 2: Richard12358 ($9.19 in chips) 
Seat 3: supernightman ($12.24 in chips) 
Seat 4: EES888 ($10.27 in chips) 
Seat 6: saitam_06 ($11.03 in chips) 
supernightman: posts small blind $0.05
EES888: posts big blind $0.10
Kimi1892: sits out 
*** HOLE CARDS ***
saitam_06: folds 
eungenio: raises $0.20 to $0.30
Richard12358: folds 
supernightman: folds 
EES888: calls $0.20
*** FLOP *** [Qd 2s 6h]
EES888: checks 
eungenio: bets $0.20
EES888: folds 
Uncalled bet ($0.20) returned to eungenio
eungenio collected $0.62 from pot
eungenio: doesn't show hand 
*** SUMMARY ***
Total pot $0.65 | Rake $0.03 
Board [Qd 2s 6h]
Seat 1: eungenio collected ($0.62)
Seat 2: Richard12358 (button) folded before Flop (didn't bet)
Seat 3: supernightman (small blind) folded before Flop
Seat 4: EES888 (big blind) folded on the Flop
Seat 6: saitam_06 folded before Flop (didn't bet)



PokerStars Hand #222955544902:  Hold'em No Limit ($0.05/$0.10 USD) - 2021/01/23 9:41:25 ET
Table 'Bohlinia III' 6-max Seat #3 is the button
Seat 1: eungenio ($18.13 in chips) 
Seat 2: Richard12358 ($9.19 in chips) 
Seat 3: supernightman ($12.19 in chips) 
Seat 4: EES888 ($9.97 in chips) 
Seat 5: Kimi1892 ($10.25 in chips) 
Seat 6: saitam_06 ($11.03 in chips) 
EES888: posts small blind $0.05
Kimi1892: posts big blind $0.10
*** HOLE CARDS ***
saitam_06: folds 
eungenio: raises $0.20 to $0.30
Richard12358: calls $0.30
supernightman: folds 
EES888: calls $0.25
Kimi1892: folds 
*** FLOP *** [9d 7h Qd]
EES888: checks 
eungenio: bets $0.74
Richard12358: folds 
EES888: calls $0.74
*** TURN *** [9d 7h Qd] [6d]
EES888: checks 
eungenio: bets $1.82
EES888: calls $1.82
*** RIVER *** [9d 7h Qd 6d] [3s]
EES888: checks 
eungenio: checks 
*** SHOW DOWN ***
EES888: shows [2d 8d] (a flush, Queen high)
eungenio: mucks hand 
EES888 collected $5.84 from pot
*** SUMMARY ***
Total pot $6.12 | Rake $0.28 
Board [9d 7h Qd 6d 3s]
Seat 1: eungenio mucked
Seat 2: Richard12358 folded on the Flop
Seat 3: supernightman (button) folded before Flop (didn't bet)
Seat 4: EES888 (small blind) showed [2d 8d] and won ($5.84) with a flush, Queen high
Seat 5: Kimi1892 (big blind) folded before Flop
Seat 6: saitam_06 folded before Flop (didn't bet)



PokerStars Hand #222955563243:  Hold'em No Limit ($0.05/$0.10 USD) - 2021/01/23 9:42:01 ET
Table 'Bohlinia III' 6-max Seat #4 is the button
Seat 1: eungenio ($15.27 in chips) 
Seat 2: Richard12358 ($8.89 in chips) 
Seat 3: supernightman ($12.19 in chips) 
Seat 4: EES888 ($12.95 in chips) 
Seat 5: Kimi1892 ($10.15 in chips) 
Seat 6: saitam_06 ($11.03 in chips) 
Kimi1892: posts small blind $0.05
saitam_06: posts big blind $0.10
*** HOLE CARDS ***
eungenio: raises $0.20 to $0.30
Richard12358: calls $0.30
supernightman: folds 
EES888: calls $0.30
Kimi1892: folds 
saitam_06: raises $1.25 to $1.55
eungenio: folds 
Richard12358: folds 
EES888: calls $1.25
*** FLOP *** [4c 9s Tc]
saitam_06: checks 
EES888: checks 
*** TURN *** [4c 9s Tc] [3c]
saitam_06: bets $1.79
EES888: folds 
Uncalled bet ($1.79) returned to saitam_06
saitam_06 collected $3.58 from pot
saitam_06: doesn't show hand 
*** SUMMARY ***
Total pot $3.75 | Rake $0.17 
Board [4c 9s Tc 3c]
Seat 1: eungenio folded before Flop
Seat 2: Richard12358 folded before Flop
Seat 3: supernightman folded before Flop (didn't bet)
Seat 4: EES888 (button) folded on the Turn
Seat 5: Kimi1892 (small blind) folded before Flop
Seat 6: saitam_06 (big blind) collected ($3.58)



PokerStars Hand #222956916324:  Hold'em No Limit ($0.05/$0.10 USD) - 2021/01/23 10:26:09 ET
Table 'Bohlinia III' 6-max Seat #2 is the button
Seat 1: dante192 ($12.18 in chips) 
Seat 2: Richard12358 ($25.33 in chips) 
Seat 3: supernightman ($13.18 in chips) 
Seat 4: Mo3rupro ($11.10 in chips) 
Seat 5: selko1 ($10.20 in chips) 
supernightman: posts small blind $0.05
Mo3rupro: posts big blind $0.10
*** HOLE CARDS ***
whell11 leaves the table
selko1: folds 
dante192: raises $0.15 to $0.25
Richard12358: calls $0.25
supernightman: folds 
Mo3rupro: folds 
*** FLOP *** [Ah Jc 4c]
dante192: bets $0.31
Richard12358: calls $0.31
*** TURN *** [Ah Jc 4c] [Ac]
greenthum33 joins the table at seat #6 
dante192: checks 
Richard12358: bets $0.61
dante192: raises $11.01 to $11.62 and is all-in
greenthum33 leaves the table
Richard12358: folds [Qc]
Uncalled bet ($11.01) returned to dante192
dante192 collected $2.38 from pot
dante192: doesn't show hand 
*** SUMMARY ***
Total pot $2.49 | Rake $0.11 
Board [Ah Jc 4c Ac]
Seat 1: dante192 collected ($2.38)
Seat 2: Richard12358 (button) folded on the Turn
Seat 3: supernightman (small blind) folded before Flop
Seat 4: Mo3rupro (big blind) folded before Flop
Seat 5: selko1 folded before Flop (didn't bet)



PokerStars Hand #222956944642:  Hold'em No Limit ($0.05/$0.10 USD) - 2021/01/23 10:27:02 ET
Table 'Bohlinia III' 6-max Seat #3 is the button
Seat 1: dante192 ($13.39 in chips) 
Seat 2: Richard12358 ($24.16 in chips) 
Seat 3: supernightman ($13.13 in chips) 
Seat 4: Mo3rupro ($11 in chips) 
Seat 5: selko1 ($10.20 in chips) 
Mo3rupro: posts small blind $0.05
selko1: posts big blind $0.10
*** HOLE CARDS ***
dante192: folds 
Richard12358: calls $0.10
supernightman: raises $0.40 to $0.50
Mo3rupro: folds 
selko1: folds 
alex7512007 joins the table at seat #6 
Richard12358: calls $0.40
*** FLOP *** [Js 4h 8s]
Richard12358: checks 
supernightman: bets $0.55
Richard12358: raises $1.35 to $1.90
supernightman: calls $1.35
*** TURN *** [Js 4h 8s] [Kd]
Richard12358: checks 
supernightman: bets $3.55
Richard12358: folds 
Uncalled bet ($3.55) returned to supernightman
supernightman collected $4.73 from pot
*** SUMMARY ***
Total pot $4.95 | Rake $0.22 
Board [Js 4h 8s Kd]
Seat 1: dante192 folded before Flop (didn't bet)
Seat 2: Richard12358 folded on the Turn
Seat 3: supernightman (button) collected ($4.73)
Seat 4: Mo3rupro (small blind) folded before Flop
Seat 5: selko1 (big blind) folded before Flop



PokerStars Hand #222956968685:  Hold'em No Limit ($0.05/$0.10 USD) - 2021/01/23 10:27:46 ET
Table 'Bohlinia III' 6-max Seat #4 is the button
Seat 1: dante192 ($13.39 in chips) 
Seat 2: Richard12358 ($21.76 in chips) 
Seat 3: supernightman ($15.46 in chips) 
Seat 4: Mo3rupro ($10.95 in chips) 
Seat 5: selko1 ($10.10 in chips) 
Seat 6: alex7512007 ($4 in chips) 
selko1: posts small blind $0.05
alex7512007: posts big blind $0.10
*** HOLE CARDS ***
dante192: folds 
Richard12358: folds 
supernightman: folds 
Mo3rupro: folds 
selko1: folds 
Uncalled bet ($0.05) returned to alex7512007
alex7512007 collected $0.10 from pot
*** SUMMARY ***
Total pot $0.10 | Rake $0 
Seat 1: dante192 folded before Flop (didn't bet)
Seat 2: Richard12358 folded before Flop (didn't bet)
Seat 3: supernightman folded before Flop (didn't bet)
Seat 4: Mo3rupro (button) folded before Flop (didn't bet)
Seat 5: selko1 (small blind) folded before Flop
Seat 6: alex7512007 (big blind) collected ($0.10)



PokerStars Hand #222956974779:  Hold'em No Limit ($0.05/$0.10 USD) - 2021/01/23 10:27:57 ET
Table 'Bohlinia III' 6-max Seat #5 is the button
Seat 1: dante192 ($13.39 in chips) 
Seat 2: Richard12358 ($21.76 in chips) 
Seat 3: supernightman ($15.46 in chips) 
Seat 4: Mo3rupro ($10.95 in chips) 
Seat 5: selko1 ($10.05 in chips) 
Seat 6: alex7512007 ($4.05 in chips) 
alex7512007: posts small blind $0.05
dante192: posts big blind $0.10
*** HOLE CARDS ***
Richard12358: folds 
supernightman: folds 
Mo3rupro: folds 
selko1: folds 
alex7512007: folds 
Uncalled bet ($0.05) returned to dante192
dante192 collected $0.10 from pot
dante192: doesn't show hand 
*** SUMMARY ***
Total pot $0.10 | Rake $0 
Seat 1: dante192 (big blind) collected ($0.10)
Seat 2: Richard12358 folded before Flop (didn't bet)
Seat 3: supernightman folded before Flop (didn't bet)
Seat 4: Mo3rupro folded before Flop (didn't bet)
Seat 5: selko1 (button) folded before Flop (didn't bet)
Seat 6: alex7512007 (small blind) folded before Flop



PokerStars Hand #222956983105:  Hold'em No Limit ($0.05/$0.10 USD) - 2021/01/23 10:28:12 ET
Table 'Bohlinia III' 6-max Seat #6 is the button
Seat 1: dante192 ($13.44 in chips) 
Seat 2: Richard12358 ($21.76 in chips) 
Seat 3: supernightman ($15.46 in chips) 
Seat 4: Mo3rupro ($10.95 in chips) 
Seat 5: selko1 ($10.05 in chips) 
Seat 6: alex7512007 ($4 in chips) 
dante192: posts small blind $0.05
Richard12358: posts big blind $0.10
*** HOLE CARDS ***
supernightman: raises $0.20 to $0.30
Mo3rupro: folds 
selko1: folds 
alex7512007: calls $0.30
dante192: folds 
Richard12358: calls $0.20
*** FLOP *** [3c Tc 2s]
Richard12358: checks 
supernightman: bets $0.46
alex7512007: folds 
Richard12358: folds 
Uncalled bet ($0.46) returned to supernightman
supernightman collected $0.91 from pot
*** SUMMARY ***
Total pot $0.95 | Rake $0.04 
Board [3c Tc 2s]
Seat 1: dante192 (small blind) folded before Flop
Seat 2: Richard12358 (big blind) folded on the Flop
Seat 3: supernightman collected ($0.91)
Seat 4: Mo3rupro folded before Flop (didn't bet)
Seat 5: selko1 folded before Flop (didn't bet)
Seat 6: alex7512007 (button) folded on the Flop



PokerStars Hand #222957004978:  Hold'em No Limit ($0.05/$0.10 USD) - 2021/01/23 10:28:52 ET
Table 'Bohlinia III' 6-max Seat #1 is the button
Seat 1: dante192 ($13.39 in chips) 
Seat 2: Richard12358 ($21.46 in chips) 
Seat 3: supernightman ($16.07 in chips) 
Seat 4: Mo3rupro ($10.95 in chips) 
Seat 5: selko1 ($10.05 in chips) 
Seat 6: alex7512007 ($3.70 in chips) 
Richard12358: posts small blind $0.05
supernightman: posts big blind $0.10
*** HOLE CARDS ***
Mo3rupro: folds 
selko1: folds 
alex7512007: folds 
dante192: folds 
Richard12358: calls $0.05
supernightman: checks 
*** FLOP *** [Kc 9c 2d]
Richard12358: checks 
supernightman: checks 
*** TURN *** [Kc 9c 2d] [Qc]
Richard12358: checks 
supernightman: checks 
*** RIVER *** [Kc 9c 2d Qc] [7d]
Richard12358: checks 
supernightman: bets $0.14
Richard12358: folds 
Uncalled bet ($0.14) returned to supernightman
supernightman collected $0.19 from pot
*** SUMMARY ***
Total pot $0.20 | Rake $0.01 
Board [Kc 9c 2d Qc 7d]
Seat 1: dante192 (button) folded before Flop (didn't bet)
Seat 2: Richard12358 (small blind) folded on the River
Seat 3: supernightman (big blind) collected ($0.19)
Seat 4: Mo3rupro folded before Flop (didn't bet)
Seat 5: selko1 folded before Flop (didn't bet)
Seat 6: alex7512007 folded before Flop (didn't bet)



PokerStars Hand #222957029294:  Hold'em No Limit ($0.05/$0.10 USD) - 2021/01/23 10:29:37 ET
Table 'Bohlinia III' 6-max Seat #2 is the button
Seat 1: dante192 ($13.39 in chips) 
Seat 2: Richard12358 ($21.36 in chips) 
Seat 3: supernightman ($16.16 in chips) 
Seat 4: Mo3rupro ($10.95 in chips) 
Seat 5: selko1 ($10.05 in chips) 
Seat 6: alex7512007 ($3.70 in chips) 
supernightman: posts small blind $0.05
Mo3rupro: posts big blind $0.10
*** HOLE CARDS ***
selko1: folds 
alex7512007: folds 
dante192: folds 
Richard12358: folds 
supernightman: folds 
Uncalled bet ($0.05) returned to Mo3rupro
Mo3rupro collected $0.10 from pot
*** SUMMARY ***
Total pot $0.10 | Rake $0 
Seat 1: dante192 folded before Flop (didn't bet)
Seat 2: Richard12358 (button) folded before Flop (didn't bet)
Seat 3: supernightman (small blind) folded before Flop
Seat 4: Mo3rupro (big blind) collected ($0.10)
Seat 5: selko1 folded before Flop (didn't bet)
Seat 6: alex7512007 folded before Flop (didn't bet)



PokerStars Hand #222957035046:  Hold'em No Limit ($0.05/$0.10 USD) - 2021/01/23 10:29:48 ET
Table 'Bohlinia III' 6-max Seat #3 is the button
Seat 1: dante192 ($13.39 in chips) 
Seat 2: Richard12358 ($21.36 in chips) 
Seat 3: supernightman ($16.11 in chips) 
Seat 4: Mo3rupro ($11 in chips) 
Seat 5: selko1 ($10.05 in chips) 
Seat 6: alex7512007 ($3.70 in chips) 
Mo3rupro: posts small blind $0.05
selko1: posts big blind $0.10
*** HOLE CARDS ***
alex7512007: folds 
dante192: folds 
Richard12358: folds 
supernightman: folds 
Mo3rupro: folds 
Uncalled bet ($0.05) returned to selko1
selko1 collected $0.10 from pot
selko1: doesn't show hand 
*** SUMMARY ***
Total pot $0.10 | Rake $0 
Seat 1: dante192 folded before Flop (didn't bet)
Seat 2: Richard12358 folded before Flop (didn't bet)
Seat 3: supernightman (button) folded before Flop (didn't bet)
Seat 4: Mo3rupro (small blind) folded before Flop
Seat 5: selko1 (big blind) collected ($0.10)
Seat 6: alex7512007 folded before Flop (didn't bet)



PokerStars Hand #222957040786:  Hold'em No Limit ($0.05/$0.10 USD) - 2021/01/23 10:29:58 ET
Table 'Bohlinia III' 6-max Seat #4 is the button
Seat 1: dante192 ($13.39 in chips) 
Seat 2: Richard12358 ($21.36 in chips) 
Seat 3: supernightman ($16.11 in chips) 
Seat 4: Mo3rupro ($10.95 in chips) 
Seat 5: selko1 ($10.10 in chips) 
Seat 6: alex7512007 ($3.70 in chips) 
selko1: posts small blind $0.05
alex7512007: posts big blind $0.10
*** HOLE CARDS ***
dante192: folds 
Richard12358: raises $0.20 to $0.30
supernightman: folds 
Mo3rupro: folds 
selko1: folds 
alex7512007: calls $0.20
*** FLOP *** [Tc Qc Ah]
alex7512007: checks 
Richard12358: bets $0.31
alex7512007: folds 
Uncalled bet ($0.31) returned to Richard12358
Richard12358 collected $0.62 from pot
Richard12358: doesn't show hand 
*** SUMMARY ***
Total pot $0.65 | Rake $0.03 
Board [Tc Qc Ah]
Seat 1: dante192 folded before Flop (didn't bet)
Seat 2: Richard12358 collected ($0.62)
Seat 3: supernightman folded before Flop (didn't bet)
Seat 4: Mo3rupro (button) folded before Flop (didn't bet)
Seat 5: selko1 (small blind) folded before Flop
Seat 6: alex7512007 (big blind) folded on the Flop



PokerStars Hand #222957062307:  Hold'em No Limit ($0.05/$0.10 USD) - 2021/01/23 10:30:37 ET
Table 'Bohlinia III' 6-max Seat #5 is the button
Seat 1: dante192 ($13.39 in chips) 
Seat 2: Richard12358 ($21.68 in chips) 
Seat 3: supernightman ($16.11 in chips) 
Seat 4: Mo3rupro ($10.95 in chips) 
Seat 5: selko1 ($10.05 in chips) 
Seat 6: alex7512007 ($3.40 in chips) 
alex7512007: posts small blind $0.05
dante192: posts big blind $0.10
*** HOLE CARDS ***
Richard12358: calls $0.10
supernightman: folds 
Mo3rupro: folds 
selko1: folds 
alex7512007: raises $0.25 to $0.35
dante192: folds 
Richard12358: calls $0.25
*** FLOP *** [6h 8d 5s]
alex7512007: bets $0.40
Richard12358: raises $0.78 to $1.18
alex7512007: calls $0.78
*** TURN *** [6h 8d 5s] [6d]
alex7512007: checks 
Richard12358: checks 
*** RIVER *** [6h 8d 5s 6d] [9d]
alex7512007: bets $1.87 and is all-in
Richard12358: calls $1.87
*** SHOW DOWN ***
alex7512007: shows [Kd Ac] (a pair of Sixes)
Richard12358: shows [As 8s] (two pair, Eights and Sixes)
Richard12358 collected $6.59 from pot
*** SUMMARY ***
Total pot $6.90 | Rake $0.31 
Board [6h 8d 5s 6d 9d]
Seat 1: dante192 (big blind) folded before Flop
Seat 2: Richard12358 showed [As 8s] and won ($6.59) with two pair, Eights and Sixes
Seat 3: supernightman folded before Flop (didn't bet)
Seat 4: Mo3rupro folded before Flop (didn't bet)
Seat 5: selko1 (button) folded before Flop (didn't bet)
Seat 6: alex7512007 (small blind) showed [Kd Ac] and lost with a pair of Sixes



PokerStars Hand #222957097617:  Hold'em No Limit ($0.05/$0.10 USD) - 2021/01/23 10:31:30 ET
Table 'Bohlinia III' 6-max Seat #1 is the button
Seat 1: dante192 ($13.29 in chips) 
Seat 2: Richard12358 ($24.87 in chips) 
Seat 3: supernightman ($16.11 in chips) 
Seat 5: selko1 ($10.05 in chips) 
Richard12358: posts small blind $0.05
supernightman: posts big blind $0.10
*** HOLE CARDS ***
selko1: folds 
dante192: folds 
Richard12358: calls $0.05
supernightman: checks 
*** FLOP *** [6c 7h 8c]
Richard12358: bets $0.10
supernightman: calls $0.10
*** TURN *** [6c 7h 8c] [3c]
Richard12358: checks 
supernightman: bets $0.29
Richard12358: folds 
Uncalled bet ($0.29) returned to supernightman
supernightman collected $0.38 from pot
*** SUMMARY ***
Total pot $0.40 | Rake $0.02 
Board [6c 7h 8c 3c]
Seat 1: dante192 (button) folded before Flop (didn't bet)
Seat 2: Richard12358 (small blind) folded on the Turn
Seat 3: supernightman (big blind) collected ($0.38)
Seat 5: selko1 folded before Flop (didn't bet)



PokerStars Hand #222957111158:  Hold'em No Limit ($0.05/$0.10 USD) - 2021/01/23 10:31:55 ET
Table 'Bohlinia III' 6-max Seat #2 is the button
Seat 1: dante192 ($13.29 in chips) 
Seat 2: Richard12358 ($24.67 in chips) 
Seat 3: supernightman ($16.29 in chips) 
Seat 5: selko1 ($10.05 in chips) 
Seat 6: alex7512007 ($4 in chips) 
supernightman: posts small blind $0.05
selko1: posts big blind $0.10
*** HOLE CARDS ***
alex7512007: folds 
dante192: raises $0.15 to $0.25
Richard12358: folds 
supernightman: folds 
selko1: folds 
Uncalled bet ($0.15) returned to dante192
dante192 collected $0.25 from pot
dante192: doesn't show hand 
*** SUMMARY ***
Total pot $0.25 | Rake $0 
Seat 1: dante192 collected ($0.25)
Seat 2: Richard12358 (button) folded before Flop (didn't bet)
Seat 3: supernightman (small blind) folded before Flop
Seat 5: selko1 (big blind) folded before Flop
Seat 6: alex7512007 folded before Flop (didn't bet)



PokerStars Hand #222957124550:  Hold'em No Limit ($0.05/$0.10 USD) - 2021/01/23 10:32:19 ET
Table 'Bohlinia III' 6-max Seat #3 is the button
Seat 1: dante192 ($13.44 in chips) 
Seat 2: Richard12358 ($24.67 in chips) 
Seat 3: supernightman ($16.24 in chips) 
Seat 5: selko1 ($10 in chips) 
Seat 6: alex7512007 ($4 in chips) 
selko1: posts small blind $0.05
alex7512007: posts big blind $0.10
*** HOLE CARDS ***
dante192: folds 
Richard12358: calls $0.10
supernightman: folds 
selko1: folds 
alex7512007: checks 
*** FLOP *** [5s 4c 9s]
alex7512007: checks 
Richard12358: bets $0.10
alex7512007: calls $0.10
*** TURN *** [5s 4c 9s] [7c]
alex7512007: checks 
Richard12358: checks 
*** RIVER *** [5s 4c 9s 7c] [9d]
alex7512007: checks 
Richard12358: bets $24.47 and is all-in
alex7512007: folds 
Uncalled bet ($24.47) returned to Richard12358
Richard12358 collected $0.43 from pot
Richard12358: doesn't show hand 
*** SUMMARY ***
Total pot $0.45 | Rake $0.02 
Board [5s 4c 9s 7c 9d]
Seat 1: dante192 folded before Flop (didn't bet)
Seat 2: Richard12358 collected ($0.43)
Seat 3: supernightman (button) folded before Flop (didn't bet)
Seat 5: selko1 (small blind) folded before Flop
Seat 6: alex7512007 (big blind) folded on the River



PokerStars Hand #222957149443:  Hold'em No Limit ($0.05/$0.10 USD) - 2021/01/23 10:33:04 ET
Table 'Bohlinia III' 6-max Seat #5 is the button
Seat 1: dante192 ($13.44 in chips) 
Seat 2: Richard12358 ($24.90 in chips) 
Seat 3: supernightman ($16.24 in chips) 
Seat 5: selko1 ($10 in chips) 
Seat 6: alex7512007 ($3.80 in chips) 
alex7512007: posts small blind $0.05
dante192: posts big blind $0.10
*** HOLE CARDS ***
Richard12358: calls $0.10
supernightman: folds 
selko1: folds 
alex7512007: folds 
dante192: checks 
*** FLOP *** [3c Jd Tc]
dante192: checks 
Richard12358: checks 
*** TURN *** [3c Jd Tc] [4d]
dante192: checks 
Richard12358: bets $0.24
dante192: folds 
Uncalled bet ($0.24) returned to Richard12358
Richard12358 collected $0.24 from pot
Richard12358: doesn't show hand 
*** SUMMARY ***
Total pot $0.25 | Rake $0.01 
Board [3c Jd Tc 4d]
Seat 1: dante192 (big blind) folded on the Turn
Seat 2: Richard12358 collected ($0.24)
Seat 3: supernightman folded before Flop (didn't bet)
Seat 5: selko1 (button) folded before Flop (didn't bet)
Seat 6: alex7512007 (small blind) folded before Flop



PokerStars Hand #222957166187:  Hold'em No Limit ($0.05/$0.10 USD) - 2021/01/23 10:33:35 ET
Table 'Bohlinia III' 6-max Seat #6 is the button
Seat 1: dante192 ($13.34 in chips) 
Seat 2: Richard12358 ($25.04 in chips) 
Seat 3: supernightman ($16.24 in chips) 
Seat 5: selko1 ($10 in chips) 
Seat 6: alex7512007 ($3.75 in chips) 
dante192: posts small blind $0.05
Richard12358: posts big blind $0.10
*** HOLE CARDS ***
supernightman: raises $0.20 to $0.30
selko1: folds 
alex7512007: calls $0.30
dante192: folds 
Richard12358: folds 
*** FLOP *** [Jh 6d 3s]
supernightman: checks 
alex7512007: bets $0.30
supernightman: calls $0.30
*** TURN *** [Jh 6d 3s] [Qd]
supernightman: checks 
alex7512007: checks 
*** RIVER *** [Jh 6d 3s Qd] [Jc]
supernightman: bets $0.65
alex7512007: calls $0.65
*** SHOW DOWN ***
supernightman: shows [Ts Js] (three of a kind, Jacks)
alex7512007: mucks hand 
supernightman collected $2.53 from pot
*** SUMMARY ***
Total pot $2.65 | Rake $0.12 
Board [Jh 6d 3s Qd Jc]
Seat 1: dante192 (small blind) folded before Flop
Seat 2: Richard12358 (big blind) folded before Flop
Seat 3: supernightman showed [Ts Js] and won ($2.53) with three of a kind, Jacks
Seat 5: selko1 folded before Flop (didn't bet)
Seat 6: alex7512007 (button) mucked



PokerStars Hand #222957196237:  Hold'em No Limit ($0.05/$0.10 USD) - 2021/01/23 10:34:29 ET
Table 'Bohlinia III' 6-max Seat #1 is the button
Seat 1: dante192 ($13.29 in chips) 
Seat 2: Richard12358 ($24.94 in chips) 
Seat 3: supernightman ($17.52 in chips) 
Seat 5: selko1 ($10 in chips) 
Seat 6: alex7512007 ($2.50 in chips) 
Richard12358: posts small blind $0.05
supernightman: posts big blind $0.10
Mo3rupro: sits out 
*** HOLE CARDS ***
selko1: folds 
alex7512007: folds 
dante192: raises $0.15 to $0.25
Richard12358: calls $0.20
supernightman: folds 
*** FLOP *** [8d Kd 8s]
Richard12358: bets $0.40
dante192: folds 
Uncalled bet ($0.40) returned to Richard12358
Richard12358 collected $0.57 from pot
Richard12358: doesn't show hand 
*** SUMMARY ***
Total pot $0.60 | Rake $0.03 
Board [8d Kd 8s]
Seat 1: dante192 (button) folded on the Flop
Seat 2: Richard12358 (small blind) collected ($0.57)
Seat 3: supernightman (big blind) folded before Flop
Seat 5: selko1 folded before Flop (didn't bet)
Seat 6: alex7512007 folded before Flop (didn't bet)



PokerStars Hand #222957207426:  Hold'em No Limit ($0.05/$0.10 USD) - 2021/01/23 10:34:50 ET
Table 'Bohlinia III' 6-max Seat #2 is the button
Seat 1: dante192 ($13.04 in chips) 
Seat 2: Richard12358 ($25.26 in chips) 
Seat 3: supernightman ($17.42 in chips) 
Seat 4: Mo3rupro ($10.95 in chips) 
Seat 5: selko1 ($10 in chips) 
Seat 6: alex7512007 ($2.50 in chips) 
supernightman: posts small blind $0.05
Mo3rupro: posts big blind $0.10
*** HOLE CARDS ***
selko1: folds 
alex7512007: folds 
dante192: folds 
Richard12358: folds 
supernightman: raises $0.20 to $0.30
Mo3rupro: folds 
Uncalled bet ($0.20) returned to supernightman
supernightman collected $0.20 from pot
*** SUMMARY ***
Total pot $0.20 | Rake $0 
Seat 1: dante192 folded before Flop (didn't bet)
Seat 2: Richard12358 (button) folded before Flop (didn't bet)
Seat 3: supernightman (small blind) collected ($0.20)
Seat 4: Mo3rupro (big blind) folded before Flop
Seat 5: selko1 folded before Flop (didn't bet)
Seat 6: alex7512007 folded before Flop (didn't bet)



PokerStars Hand #222957214948:  Hold'em No Limit ($0.05/$0.10 USD) - 2021/01/23 10:35:03 ET
Table 'Bohlinia III' 6-max Seat #3 is the button
Seat 1: dante192 ($13.04 in chips) 
Seat 2: Richard12358 ($25.26 in chips) 
Seat 3: supernightman ($17.52 in chips) 
Seat 4: Mo3rupro ($10.85 in chips) 
Seat 5: selko1 ($10 in chips) 
Seat 6: alex7512007 ($2.50 in chips) 
Mo3rupro: posts small blind $0.05
selko1: posts big blind $0.10
*** HOLE CARDS ***
alex7512007: raises $0.20 to $0.30
dante192: folds 
Richard12358: raises $0.75 to $1.05
supernightman: calls $1.05
Mo3rupro: folds 
selko1: folds 
alex7512007: raises $1.45 to $2.50 and is all-in
Richard12358: calls $1.45
supernightman: raises $2.50 to $5
Richard12358: calls $2.50
*** FLOP *** [Jc 5s Kc]
Richard12358: bets $20.26 and is all-in
supernightman: calls $12.52 and is all-in
Uncalled bet ($7.74) returned to Richard12358
alex7512007 has timed out
*** TURN *** [Jc 5s Kc] [As]
*** RIVER *** [Jc 5s Kc As] [Td]
*** SHOW DOWN ***
Richard12358: shows [Ah Qc] (a straight, Ten to Ace)
supernightman: shows [Ad Ks] (two pair, Aces and Kings)
Richard12358 collected $28.88 from side pot
alex7512007: shows [9h 9s] (a pair of Nines)
Richard12358 collected $7.31 from main pot
*** SUMMARY ***
Total pot $37.69 Main pot $7.31. Side pot $28.88. | Rake $1.50 
Board [Jc 5s Kc As Td]
Seat 1: dante192 folded before Flop (didn't bet)
Seat 2: Richard12358 showed [Ah Qc] and won ($36.19) with a straight, Ten to Ace
Seat 3: supernightman (button) showed [Ad Ks] and lost with two pair, Aces and Kings
Seat 4: Mo3rupro (small blind) folded before Flop
Seat 5: selko1 (big blind) folded before Flop
Seat 6: alex7512007 showed [9h 9s] and lost with a pair of Nines



PokerStars Hand #222957268980:  Hold'em No Limit ($0.05/$0.10 USD) - 2021/01/23 10:36:42 ET
Table 'Bohlinia III' 6-max Seat #4 is the button
Seat 1: dante192 ($13.04 in chips) 
Seat 2: Richard12358 ($43.93 in chips) 
Seat 4: Mo3rupro ($10.80 in chips) 
Seat 5: selko1 ($10 in chips) 
selko1: posts small blind $0.05
dante192: posts big blind $0.10
*** HOLE CARDS ***
Richard12358: calls $0.10
Mo3rupro: folds 
selko1: folds 
dante192: raises $0.30 to $0.40
Richard12358: calls $0.30
*** FLOP *** [Ks As 9h]
dante192: bets $0.61
Richard12358: calls $0.61
*** TURN *** [Ks As 9h] [9c]
dante192: bets $1.50
Richard12358: folds [Ac]
Uncalled bet ($1.50) returned to dante192
dante192 collected $1.98 from pot
dante192: doesn't show hand 
*** SUMMARY ***
Total pot $2.07 | Rake $0.09 
Board [Ks As 9h 9c]
Seat 1: dante192 (big blind) collected ($1.98)
Seat 2: Richard12358 folded on the Turn
Seat 4: Mo3rupro (button) folded before Flop (didn't bet)
Seat 5: selko1 (small blind) folded before Flop



PokerStars Hand #222957289693:  Hold'em No Limit ($0.05/$0.10 USD) - 2021/01/23 10:37:19 ET
Table 'Bohlinia III' 6-max Seat #5 is the button
Seat 1: dante192 ($14.01 in chips) 
Seat 2: Richard12358 ($42.92 in chips) 
Seat 3: supernightman ($10 in chips) 
Seat 4: Mo3rupro ($10.80 in chips) 
Seat 5: selko1 ($10 in chips) 
dante192: posts small blind $0.05
Richard12358: posts big blind $0.10
*** HOLE CARDS ***
supernightman: folds 
alex7512007 leaves the table
Mo3rupro: folds 
selko1: folds 
xScarface joins the table at seat #6 
dante192: raises $0.15 to $0.25
Richard12358: folds 
Uncalled bet ($0.15) returned to dante192
dante192 collected $0.20 from pot
dante192: doesn't show hand 
*** SUMMARY ***
Total pot $0.20 | Rake $0 
Seat 1: dante192 (small blind) collected ($0.20)
Seat 2: Richard12358 (big blind) folded before Flop
Seat 3: supernightman folded before Flop (didn't bet)
Seat 4: Mo3rupro folded before Flop (didn't bet)
Seat 5: selko1 (button) folded before Flop (didn't bet)



PokerStars Hand #222957298281:  Hold'em No Limit ($0.05/$0.10 USD) - 2021/01/23 10:37:34 ET
Table 'Bohlinia III' 6-max Seat #1 is the button
Seat 1: dante192 ($14.11 in chips) 
Seat 2: Richard12358 ($42.82 in chips) 
Seat 3: supernightman ($10 in chips) 
Seat 4: Mo3rupro ($10.80 in chips) 
Seat 5: selko1 ($10 in chips) 
Richard12358: posts small blind $0.05
supernightman: posts big blind $0.10
xScarface: sits out 
*** HOLE CARDS ***
Mo3rupro: folds 
selko1: raises $0.20 to $0.30
dante192: folds 
Richard12358: folds 
supernightman: calls $0.20
*** FLOP *** [Kh 8s 5d]
supernightman: checks 
selko1: bets $0.31
supernightman: folds 
Uncalled bet ($0.31) returned to selko1
selko1 collected $0.62 from pot
*** SUMMARY ***
Total pot $0.65 | Rake $0.03 
Board [Kh 8s 5d]
Seat 1: dante192 (button) folded before Flop (didn't bet)
Seat 2: Richard12358 (small blind) folded before Flop
Seat 3: supernightman (big blind) folded on the Flop
Seat 4: Mo3rupro folded before Flop (didn't bet)
Seat 5: selko1 collected ($0.62)



PokerStars Hand #222957311424:  Hold'em No Limit ($0.05/$0.10 USD) - 2021/01/23 10:37:58 ET
Table 'Bohlinia III' 6-max Seat #2 is the button
Seat 1: dante192 ($14.11 in chips) 
Seat 2: Richard12358 ($42.77 in chips) 
Seat 3: supernightman ($9.70 in chips) 
Seat 6: xScarface ($10 in chips) 
supernightman: posts small blind $0.05
Mo3rupro: is sitting out 
selko1: is sitting out 
xScarface: posts big blind $0.10
*** HOLE CARDS ***
dante192: folds 
Richard12358: calls $0.10
supernightman: raises $0.50 to $0.60
xScarface: folds 
Richard12358: calls $0.50
*** FLOP *** [Ah 7h Js]
supernightman: bets $0.93
Richard12358: calls $0.93
*** TURN *** [Ah 7h Js] [Ac]
supernightman: bets $2.27
Richard12358: folds [Kh Qc]
Uncalled bet ($2.27) returned to supernightman
supernightman collected $3.02 from pot
*** SUMMARY ***
Total pot $3.16 | Rake $0.14 
Board [Ah 7h Js Ac]
Seat 1: dante192 folded before Flop (didn't bet)
Seat 2: Richard12358 (button) folded on the Turn
Seat 3: supernightman (small blind) collected ($3.02)
Seat 6: xScarface (big blind) folded before Flop



PokerStars Hand #222957329924:  Hold'em No Limit ($0.05/$0.10 USD) - 2021/01/23 10:38:32 ET
Table 'Bohlinia III' 6-max Seat #3 is the button
Seat 1: dante192 ($14.11 in chips) 
Seat 2: Richard12358 ($41.24 in chips) 
Seat 3: supernightman ($11.19 in chips) 
Seat 6: xScarface ($9.90 in chips) 
xScarface: posts small blind $0.05
dante192: posts big blind $0.10
*** HOLE CARDS ***
Richard12358: folds 
supernightman: raises $0.20 to $0.30
Richard12358 leaves the table
xScarface: raises $0.20 to $0.50
Mo3rupro leaves the table
ojeriza joins the table at seat #2 
dante192: folds 
supernightman: calls $0.20
*** FLOP *** [6h 8h 2s]
attila436 joins the table at seat #4 
xScarface: bets $0.53
supernightman: calls $0.53
*** TURN *** [6h 8h 2s] [3c]
xScarface: checks 
supernightman: checks 
*** RIVER *** [6h 8h 2s 3c] [2d]
xScarface: checks 
supernightman: bets $1.03
xScarface: folds 
Uncalled bet ($1.03) returned to supernightman
supernightman collected $2.06 from pot
*** SUMMARY ***
Total pot $2.16 | Rake $0.10 
Board [6h 8h 2s 3c 2d]
Seat 1: dante192 (big blind) folded before Flop
Seat 2: Richard12358 folded before Flop (didn't bet)
Seat 3: supernightman (button) collected ($2.06)
Seat 6: xScarface (small blind) folded on the River



PokerStars Hand #222955584662:  Hold'em No Limit ($0.05/$0.10 USD) - 2021/01/23 9:42:44 ET
Table 'Bohlinia III' 6-max Seat #5 is the button
Seat 1: eungenio ($14.97 in chips) 
Seat 2: Richard12358 ($8.59 in chips) 
Seat 3: supernightman ($12.19 in chips) 
Seat 4: EES888 ($11.40 in chips) 
Seat 5: Kimi1892 ($10.10 in chips) 
Seat 6: saitam_06 ($13.06 in chips) 
saitam_06: posts small blind $0.05
eungenio: posts big blind $0.10
*** HOLE CARDS ***
Richard12358: folds 
supernightman: raises $0.30 to $0.40
EES888: calls $0.40
Kimi1892: folds 
saitam_06: folds 
eungenio: raises $1.20 to $1.60
supernightman: calls $1.20
EES888: calls $1.20
*** FLOP *** [8s 3s Jd]
eungenio: checks 
supernightman: checks 
EES888: checks 
*** TURN *** [8s 3s Jd] [6d]
eungenio: checks 
supernightman: checks 
EES888: checks 
*** RIVER *** [8s 3s Jd 6d] [Jc]
eungenio: checks 
supernightman: checks 
EES888: checks 
*** SHOW DOWN ***
eungenio: shows [Kh Ac] (a pair of Jacks)
supernightman: shows [Kc Ad] (a pair of Jacks)
EES888: mucks hand 
eungenio collected $2.32 from pot
supernightman collected $2.31 from pot
*** SUMMARY ***
Total pot $4.85 | Rake $0.22 
Board [8s 3s Jd 6d Jc]
Seat 1: eungenio (big blind) showed [Kh Ac] and won ($2.32) with a pair of Jacks
Seat 2: Richard12358 folded before Flop (didn't bet)
Seat 3: supernightman showed [Kc Ad] and won ($2.31) with a pair of Jacks
Seat 4: EES888 mucked
Seat 5: Kimi1892 (button) folded before Flop (didn't bet)
Seat 6: saitam_06 (small blind) folded before Flop



PokerStars Hand #222955617005:  Hold'em No Limit ($0.05/$0.10 USD) - 2021/01/23 9:43:49 ET
Table 'Bohlinia III' 6-max Seat #6 is the button
Seat 1: eungenio ($15.69 in chips) 
Seat 2: Richard12358 ($8.59 in chips) 
Seat 3: supernightman ($12.90 in chips) 
Seat 4: EES888 ($9.80 in chips) 
Seat 5: Kimi1892 ($10.10 in chips) 
Seat 6: saitam_06 ($13.01 in chips) 
eungenio: posts small blind $0.05
Richard12358: posts big blind $0.10
*** HOLE CARDS ***
supernightman: folds 
EES888: calls $0.10
Kimi1892: folds 
saitam_06: folds 
eungenio: calls $0.05
Richard12358: checks 
*** FLOP *** [2d 7c 6c]
eungenio: checks 
Richard12358: checks 
EES888: checks 
*** TURN *** [2d 7c 6c] [8s]
eungenio: checks 
Richard12358: checks 
EES888: checks 
*** RIVER *** [2d 7c 6c 8s] [2c]
eungenio: checks 
Richard12358: bets $1
EES888: folds 
eungenio: folds 
Uncalled bet ($1) returned to Richard12358
Richard12358 collected $0.29 from pot
Richard12358: doesn't show hand 
*** SUMMARY ***
Total pot $0.30 | Rake $0.01 
Board [2d 7c 6c 8s 2c]
Seat 1: eungenio (small blind) folded on the River
Seat 2: Richard12358 (big blind) collected ($0.29)
Seat 3: supernightman folded before Flop (didn't bet)
Seat 4: EES888 folded on the River
Seat 5: Kimi1892 folded before Flop (didn't bet)
Seat 6: saitam_06 (button) folded before Flop (didn't bet)



PokerStars Hand #222955639148:  Hold'em No Limit ($0.05/$0.10 USD) - 2021/01/23 9:44:33 ET
Table 'Bohlinia III' 6-max Seat #1 is the button
Seat 1: eungenio ($15.59 in chips) 
Seat 2: Richard12358 ($8.78 in chips) 
Seat 3: supernightman ($12.90 in chips) 
Seat 4: EES888 ($9.70 in chips) 
Seat 5: Kimi1892 ($10.10 in chips) 
Seat 6: saitam_06 ($13.01 in chips) 
Richard12358: posts small blind $0.05
supernightman: posts big blind $0.10
*** HOLE CARDS ***
EES888: calls $0.10
Kimi1892: folds 
saitam_06: raises $0.40 to $0.50
eungenio: folds 
Richard12358: calls $0.45
supernightman: folds 
EES888: calls $0.40
*** FLOP *** [4s Qs 2c]
Richard12358: checks 
EES888: checks 
saitam_06: bets $0.77
Richard12358: raises $2.03 to $2.80
EES888: folds 
saitam_06: calls $2.03
*** TURN *** [4s Qs 2c] [5d]
Richard12358: bets $5.48 and is all-in
saitam_06: folds 
Uncalled bet ($5.48) returned to Richard12358
Richard12358 collected $6.88 from pot
Richard12358: doesn't show hand 
*** SUMMARY ***
Total pot $7.20 | Rake $0.32 
Board [4s Qs 2c 5d]
Seat 1: eungenio (button) folded before Flop (didn't bet)
Seat 2: Richard12358 (small blind) collected ($6.88)
Seat 3: supernightman (big blind) folded before Flop
Seat 4: EES888 folded on the Flop
Seat 5: Kimi1892 folded before Flop (didn't bet)
Seat 6: saitam_06 folded on the Turn



PokerStars Hand #222955667424:  Hold'em No Limit ($0.05/$0.10 USD) - 2021/01/23 9:45:29 ET
Table 'Bohlinia III' 6-max Seat #2 is the button
Seat 1: eungenio ($15.59 in chips) 
Seat 2: Richard12358 ($12.36 in chips) 
Seat 3: supernightman ($12.80 in chips) 
Seat 4: EES888 ($9.20 in chips) 
Seat 5: Kimi1892 ($10.10 in chips) 
Seat 6: saitam_06 ($10 in chips) 
supernightman: posts small blind $0.05
EES888: posts big blind $0.10
*** HOLE CARDS ***
Kimi1892: folds 
saitam_06: raises $0.15 to $0.25
eungenio: folds 
Richard12358: calls $0.25
supernightman: folds 
EES888: calls $0.15
*** FLOP *** [Tc Ad 5c]
EES888: checks 
saitam_06: bets $0.38
Richard12358: calls $0.38
EES888: folds 
*** TURN *** [Tc Ad 5c] [Jh]
saitam_06: bets $1.12
Richard12358: calls $1.12
*** RIVER *** [Tc Ad 5c Jh] [4h]
saitam_06: checks 
Richard12358: bets $3.63
saitam_06: folds 
Uncalled bet ($3.63) returned to Richard12358
Richard12358 collected $3.63 from pot
Richard12358: doesn't show hand 
*** SUMMARY ***
Total pot $3.80 | Rake $0.17 
Board [Tc Ad 5c Jh 4h]
Seat 1: eungenio folded before Flop (didn't bet)
Seat 2: Richard12358 (button) collected ($3.63)
Seat 3: supernightman (small blind) folded before Flop
Seat 4: EES888 (big blind) folded on the Flop
Seat 5: Kimi1892 folded before Flop (didn't bet)
Seat 6: saitam_06 folded on the River



PokerStars Hand #222955695650:  Hold'em No Limit ($0.05/$0.10 USD) - 2021/01/23 9:46:25 ET
Table 'Bohlinia III' 6-max Seat #3 is the button
Seat 1: eungenio ($15.59 in chips) 
Seat 2: Richard12358 ($14.24 in chips) 
Seat 3: supernightman ($12.75 in chips) 
Seat 4: EES888 ($8.95 in chips) 
Seat 5: Kimi1892 ($10.10 in chips) 
Seat 6: saitam_06 ($10 in chips) 
EES888: posts small blind $0.05
Kimi1892: posts big blind $0.10
*** HOLE CARDS ***
saitam_06: folds 
eungenio: folds 
Richard12358: calls $0.10
supernightman: calls $0.10
EES888: calls $0.05
Kimi1892: checks 
*** FLOP *** [4h 3s 6c]
EES888: checks 
Kimi1892: bets $0.19
Richard12358: calls $0.19
supernightman: raises $0.71 to $0.90
EES888: calls $0.90
Kimi1892: folds 
Richard12358: folds 
*** TURN *** [4h 3s 6c] [4c]
EES888: checks 
supernightman: bets $1.85
EES888: calls $1.85
*** RIVER *** [4h 3s 6c 4c] [Kd]
EES888: checks 
supernightman: bets $4.50
EES888: folds 
Uncalled bet ($4.50) returned to supernightman
supernightman collected $6 from pot
*** SUMMARY ***
Total pot $6.28 | Rake $0.28 
Board [4h 3s 6c 4c Kd]
Seat 1: eungenio folded before Flop (didn't bet)
Seat 2: Richard12358 folded on the Flop
Seat 3: supernightman (button) collected ($6)
Seat 4: EES888 (small blind) folded on the River
Seat 5: Kimi1892 (big blind) folded on the Flop
Seat 6: saitam_06 folded before Flop (didn't bet)



PokerStars Hand #222955724085:  Hold'em No Limit ($0.05/$0.10 USD) - 2021/01/23 9:47:21 ET
Table 'Bohlinia III' 6-max Seat #4 is the button
Seat 1: eungenio ($15.59 in chips) 
Seat 2: Richard12358 ($13.95 in chips) 
Seat 3: supernightman ($15.90 in chips) 
Seat 4: EES888 ($6.10 in chips) 
Seat 5: Kimi1892 ($10 in chips) 
Seat 6: saitam_06 ($10 in chips) 
Kimi1892: posts small blind $0.05
saitam_06: posts big blind $0.10
*** HOLE CARDS ***
eungenio: raises $0.20 to $0.30
Richard12358: folds 
supernightman: raises $0.60 to $0.90
EES888: calls $0.90
Kimi1892: folds 
saitam_06: raises $9.10 to $10 and is all-in
eungenio: folds 
supernightman: folds 
EES888: calls $5.20 and is all-in
Uncalled bet ($3.90) returned to saitam_06
*** FLOP *** [8s Ah Ts]
*** TURN *** [8s Ah Ts] [5h]
*** RIVER *** [8s Ah Ts 5h] [4d]
*** SHOW DOWN ***
saitam_06: shows [Kd Kc] (a pair of Kings)
EES888: shows [2s 4c] (a pair of Fours)
saitam_06 collected $12.84 from pot
*** SUMMARY ***
Total pot $13.45 | Rake $0.61 
Board [8s Ah Ts 5h 4d]
Seat 1: eungenio folded before Flop
Seat 2: Richard12358 folded before Flop (didn't bet)
Seat 3: supernightman folded before Flop
Seat 4: EES888 (button) showed [2s 4c] and lost with a pair of Fours
Seat 5: Kimi1892 (small blind) folded before Flop
Seat 6: saitam_06 (big blind) showed [Kd Kc] and won ($12.84) with a pair of Kings



PokerStars Hand #222955751046:  Hold'em No Limit ($0.05/$0.10 USD) - 2021/01/23 9:48:13 ET
Table 'Bohlinia III' 6-max Seat #5 is the button
Seat 1: eungenio ($15.29 in chips) 
Seat 2: Richard12358 ($13.95 in chips) 
Seat 3: supernightman ($15 in chips) 
Seat 5: Kimi1892 ($10 in chips) 
Seat 6: saitam_06 ($16.74 in chips) 
saitam_06: posts small blind $0.05
eungenio: posts big blind $0.10
*** HOLE CARDS ***
Richard12358: folds 
supernightman: folds 
Kimi1892: raises $0.15 to $0.25
saitam_06: folds 
EES888 leaves the table
eungenio: folds 
Uncalled bet ($0.15) returned to Kimi1892
Kimi1892 collected $0.25 from pot
Kimi1892: doesn't show hand 
*** SUMMARY ***
Total pot $0.25 | Rake $0 
Seat 1: eungenio (big blind) folded before Flop
Seat 2: Richard12358 folded before Flop (didn't bet)
Seat 3: supernightman folded before Flop (didn't bet)
Seat 5: Kimi1892 (button) collected ($0.25)
Seat 6: saitam_06 (small blind) folded before Flop



PokerStars Hand #222955977299:  Hold'em No Limit ($0.05/$0.10 USD) - 2021/01/23 9:55:27 ET
Table 'Bohlinia III' 6-max Seat #1 is the button
Seat 1: eungenio ($11.73 in chips) 
Seat 2: Richard12358 ($15.52 in chips) 
Seat 3: supernightman ($13.77 in chips) 
Seat 4: romanromanro ($10.84 in chips) 
Seat 5: Kimi1892 ($11.93 in chips) 
Seat 6: whell11 ($10 in chips) 
Richard12358: posts small blind $0.05
supernightman: posts big blind $0.10
*** HOLE CARDS ***
romanromanro: folds 
Kimi1892: folds 
whell11: folds 
eungenio: folds 
Richard12358: raises $0.10 to $0.20
supernightman: calls $0.10
*** FLOP *** [Ad 5s Ac]
Richard12358: bets $0.19
supernightman: calls $0.19
*** TURN *** [Ad 5s Ac] [8c]
Richard12358: checks 
supernightman: bets $0.37
Richard12358: folds 
Uncalled bet ($0.37) returned to supernightman
supernightman collected $0.74 from pot
*** SUMMARY ***
Total pot $0.78 | Rake $0.04 
Board [Ad 5s Ac 8c]
Seat 1: eungenio (button) folded before Flop (didn't bet)
Seat 2: Richard12358 (small blind) folded on the Turn
Seat 3: supernightman (big blind) collected ($0.74)
Seat 4: romanromanro folded before Flop (didn't bet)
Seat 5: Kimi1892 folded before Flop (didn't bet)
Seat 6: whell11 folded before Flop (didn't bet)



PokerStars Hand #222955996178:  Hold'em No Limit ($0.05/$0.10 USD) - 2021/01/23 9:56:14 ET
Table 'Bohlinia III' 6-max Seat #2 is the button
Seat 1: eungenio ($11.73 in chips) 
Seat 2: Richard12358 ($15.13 in chips) 
Seat 3: supernightman ($14.12 in chips) 
Seat 4: romanromanro ($10.84 in chips) 
Seat 5: Kimi1892 ($11.93 in chips) 
Seat 6: whell11 ($10 in chips) 
supernightman: posts small blind $0.05
romanromanro: posts big blind $0.10
*** HOLE CARDS ***
Kimi1892: folds 
whell11: raises $0.20 to $0.30
eungenio: folds 
Richard12358: calls $0.30
supernightman: folds 
romanromanro: folds 
*** FLOP *** [4c Js 5s]
whell11: checks 
Richard12358: bets $0.72
whell11: folds 
Uncalled bet ($0.72) returned to Richard12358
Richard12358 collected $0.72 from pot
Richard12358: doesn't show hand 
*** SUMMARY ***
Total pot $0.75 | Rake $0.03 
Board [4c Js 5s]
Seat 1: eungenio folded before Flop (didn't bet)
Seat 2: Richard12358 (button) collected ($0.72)
Seat 3: supernightman (small blind) folded before Flop
Seat 4: romanromanro (big blind) folded before Flop
Seat 5: Kimi1892 folded before Flop (didn't bet)
Seat 6: whell11 folded on the Flop



PokerStars Hand #222956007542:  Hold'em No Limit ($0.05/$0.10 USD) - 2021/01/23 9:56:42 ET
Table 'Bohlinia III' 6-max Seat #3 is the button
Seat 1: eungenio ($11.73 in chips) 
Seat 2: Richard12358 ($15.55 in chips) 
Seat 3: supernightman ($14.07 in chips) 
Seat 4: romanromanro ($10.74 in chips) 
Seat 5: Kimi1892 ($11.93 in chips) 
Seat 6: whell11 ($10 in chips) 
romanromanro: posts small blind $0.05
Kimi1892: posts big blind $0.10
*** HOLE CARDS ***
whell11: folds 
eungenio: raises $0.20 to $0.30
Richard12358: folds 
supernightman: folds 
romanromanro: folds 
Kimi1892: folds 
Uncalled bet ($0.20) returned to eungenio
eungenio collected $0.25 from pot
eungenio: doesn't show hand 
*** SUMMARY ***
Total pot $0.25 | Rake $0 
Seat 1: eungenio collected ($0.25)
Seat 2: Richard12358 folded before Flop (didn't bet)
Seat 3: supernightman (button) folded before Flop (didn't bet)
Seat 4: romanromanro (small blind) folded before Flop
Seat 5: Kimi1892 (big blind) folded before Flop
Seat 6: whell11 folded before Flop (didn't bet)



PokerStars Hand #222956016644:  Hold'em No Limit ($0.05/$0.10 USD) - 2021/01/23 9:57:05 ET
Table 'Bohlinia III' 6-max Seat #4 is the button
Seat 1: eungenio ($11.88 in chips) 
Seat 3: supernightman ($14.07 in chips) 
Seat 4: romanromanro ($10.69 in chips) 
Seat 5: Kimi1892 ($11.83 in chips) 
Seat 6: whell11 ($10 in chips) 
Kimi1892: posts small blind $0.05
whell11: posts big blind $0.10
*** HOLE CARDS ***
eungenio: folds 
supernightman: folds 
romanromanro: raises $0.15 to $0.25
Kimi1892: raises $0.65 to $0.90
whell11: folds 
romanromanro: calls $0.65
*** FLOP *** [9h 7c 4h]
Kimi1892: bets $0.60
romanromanro: calls $0.60
*** TURN *** [9h 7c 4h] [7s]
Kimi1892: bets $1.51
romanromanro: raises $1.51 to $3.02
Kimi1892: calls $1.51
*** RIVER *** [9h 7c 4h 7s] [2d]
Kimi1892: checks 
romanromanro: checks 
*** SHOW DOWN ***
Kimi1892: shows [Ac Jh] (a pair of Sevens)
romanromanro: mucks hand 
Kimi1892 collected $8.73 from pot
*** SUMMARY ***
Total pot $9.14 | Rake $0.41 
Board [9h 7c 4h 7s 2d]
Seat 1: eungenio folded before Flop (didn't bet)
Seat 3: supernightman folded before Flop (didn't bet)
Seat 4: romanromanro (button) mucked
Seat 5: Kimi1892 (small blind) showed [Ac Jh] and won ($8.73) with a pair of Sevens
Seat 6: whell11 (big blind) folded before Flop



PokerStars Hand #222956040662:  Hold'em No Limit ($0.05/$0.10 USD) - 2021/01/23 9:58:04 ET
Table 'Bohlinia III' 6-max Seat #5 is the button
Seat 1: eungenio ($11.88 in chips) 
Seat 3: supernightman ($14.07 in chips) 
Seat 4: romanromanro ($10 in chips) 
Seat 5: Kimi1892 ($16.04 in chips) 
Seat 6: whell11 ($10 in chips) 
whell11: posts small blind $0.05
eungenio: posts big blind $0.10
*** HOLE CARDS ***
supernightman: raises $0.20 to $0.30
romanromanro: folds 
Kimi1892: raises $0.70 to $1
whell11: folds 
eungenio: folds 
supernightman: folds 
Uncalled bet ($0.70) returned to Kimi1892
Kimi1892 collected $0.75 from pot
Kimi1892: doesn't show hand 
*** SUMMARY ***
Total pot $0.75 | Rake $0 
Seat 1: eungenio (big blind) folded before Flop
Seat 3: supernightman folded before Flop
Seat 4: romanromanro folded before Flop (didn't bet)
Seat 5: Kimi1892 (button) collected ($0.75)
Seat 6: whell11 (small blind) folded before Flop



PokerStars Hand #222956047913:  Hold'em No Limit ($0.05/$0.10 USD) - 2021/01/23 9:58:27 ET
Table 'Bohlinia III' 6-max Seat #6 is the button
Seat 1: eungenio ($11.78 in chips) 
Seat 3: supernightman ($13.77 in chips) 
Seat 4: romanromanro ($10 in chips) 
Seat 5: Kimi1892 ($16.49 in chips) 
Seat 6: whell11 ($10 in chips) 
eungenio: posts small blind $0.05
supernightman: posts big blind $0.10
*** HOLE CARDS ***
romanromanro: folds 
Kimi1892: folds 
whell11: folds 
eungenio: raises $0.20 to $0.30
supernightman: folds 
Uncalled bet ($0.20) returned to eungenio
eungenio collected $0.20 from pot
eungenio: doesn't show hand 
*** SUMMARY ***
Total pot $0.20 | Rake $0 
Seat 1: eungenio (small blind) collected ($0.20)
Seat 3: supernightman (big blind) folded before Flop
Seat 4: romanromanro folded before Flop (didn't bet)
Seat 5: Kimi1892 folded before Flop (didn't bet)
Seat 6: whell11 (button) folded before Flop (didn't bet)



PokerStars Hand #222956054575:  Hold'em No Limit ($0.05/$0.10 USD) - 2021/01/23 9:58:40 ET
Table 'Bohlinia III' 6-max Seat #1 is the button
Seat 1: eungenio ($11.88 in chips) 
Seat 3: supernightman ($13.67 in chips) 
Seat 4: romanromanro ($10 in chips) 
Seat 5: Kimi1892 ($16.49 in chips) 
Seat 6: whell11 ($10 in chips) 
supernightman: posts small blind $0.05
romanromanro: posts big blind $0.10
*** HOLE CARDS ***
Kimi1892: folds 
whell11: folds 
eungenio: folds 
supernightman: folds 
Uncalled bet ($0.05) returned to romanromanro
romanromanro collected $0.10 from pot
romanromanro: doesn't show hand 
*** SUMMARY ***
Total pot $0.10 | Rake $0 
Seat 1: eungenio (button) folded before Flop (didn't bet)
Seat 3: supernightman (small blind) folded before Flop
Seat 4: romanromanro (big blind) collected ($0.10)
Seat 5: Kimi1892 folded before Flop (didn't bet)
Seat 6: whell11 folded before Flop (didn't bet)



PokerStars Hand #222956057801:  Hold'em No Limit ($0.05/$0.10 USD) - 2021/01/23 9:58:48 ET
Table 'Bohlinia III' 6-max Seat #3 is the button
Seat 1: eungenio ($11.88 in chips) 
Seat 3: supernightman ($13.62 in chips) 
Seat 4: romanromanro ($10.05 in chips) 
Seat 5: Kimi1892 ($16.49 in chips) 
Seat 6: whell11 ($10 in chips) 
romanromanro: posts small blind $0.05
Kimi1892: posts big blind $0.10
*** HOLE CARDS ***
whell11: folds 
eungenio: folds 
supernightman: folds 
romanromanro: folds 
Uncalled bet ($0.05) returned to Kimi1892
Kimi1892 collected $0.10 from pot
Kimi1892: doesn't show hand 
*** SUMMARY ***
Total pot $0.10 | Rake $0 
Seat 1: eungenio folded before Flop (didn't bet)
Seat 3: supernightman (button) folded before Flop (didn't bet)
Seat 4: romanromanro (small blind) folded before Flop
Seat 5: Kimi1892 (big blind) collected ($0.10)
Seat 6: whell11 folded before Flop (didn't bet)



PokerStars Hand #222956063759:  Hold'em No Limit ($0.05/$0.10 USD) - 2021/01/23 9:59:02 ET
Table 'Bohlinia III' 6-max Seat #4 is the button
Seat 1: eungenio ($11.88 in chips) 
Seat 2: Richard12358 ($15.55 in chips) 
Seat 3: supernightman ($13.62 in chips) 
Seat 4: romanromanro ($10 in chips) 
Seat 5: Kimi1892 ($16.54 in chips) 
Seat 6: whell11 ($10 in chips) 
Kimi1892: posts small blind $0.05
whell11: posts big blind $0.10
Richard12358: posts small & big blinds $0.15
*** HOLE CARDS ***
eungenio: folds 
Richard12358: checks 
supernightman: folds 
romanromanro: raises $0.40 to $0.50
Kimi1892: folds 
whell11: calls $0.40
Richard12358: calls $0.40
*** FLOP *** [9d Jc 9s]
whell11: checks 
Richard12358: checks 
romanromanro: bets $0.55
whell11: folds 
Richard12358: calls $0.55
*** TURN *** [9d Jc 9s] [5d]
Richard12358: checks 
romanromanro: bets $1.94
Richard12358: calls $1.94
*** RIVER *** [9d Jc 9s 5d] [5h]
Richard12358: checks 
romanromanro: bets $3.14
Richard12358: calls $3.14
*** SHOW DOWN ***
romanromanro: shows [Ah Jd] (two pair, Jacks and Nines)
Richard12358: shows [Qh 9h] (a full house, Nines full of Fives)
Richard12358 collected $12.28 from pot
*** SUMMARY ***
Total pot $12.86 | Rake $0.58 
Board [9d Jc 9s 5d 5h]
Seat 1: eungenio folded before Flop (didn't bet)
Seat 2: Richard12358 showed [Qh 9h] and won ($12.28) with a full house, Nines full of Fives
Seat 3: supernightman folded before Flop (didn't bet)
Seat 4: romanromanro (button) showed [Ah Jd] and lost with two pair, Jacks and Nines
Seat 5: Kimi1892 (small blind) folded before Flop
Seat 6: whell11 (big blind) folded on the Flop



PokerStars Hand #222956113297:  Hold'em No Limit ($0.05/$0.10 USD) - 2021/01/23 10:01:01 ET
Table 'Bohlinia III' 6-max Seat #5 is the button
Seat 1: eungenio ($11.88 in chips) 
Seat 2: Richard12358 ($21.65 in chips) 
Seat 3: supernightman ($13.62 in chips) 
Seat 4: romanromanro ($10 in chips) 
Seat 5: Kimi1892 ($16.49 in chips) 
Seat 6: whell11 ($10 in chips) 
whell11: posts small blind $0.05
eungenio: posts big blind $0.10
*** HOLE CARDS ***
Richard12358: folds 
supernightman: raises $0.20 to $0.30
romanromanro: folds 
Kimi1892: folds 
whell11: folds 
eungenio: folds 
Uncalled bet ($0.20) returned to supernightman
supernightman collected $0.25 from pot
*** SUMMARY ***
Total pot $0.25 | Rake $0 
Seat 1: eungenio (big blind) folded before Flop
Seat 2: Richard12358 folded before Flop (didn't bet)
Seat 3: supernightman collected ($0.25)
Seat 4: romanromanro folded before Flop (didn't bet)
Seat 5: Kimi1892 (button) folded before Flop (didn't bet)
Seat 6: whell11 (small blind) folded before Flop



PokerStars Hand #222956120617:  Hold'em No Limit ($0.05/$0.10 USD) - 2021/01/23 10:01:17 ET
Table 'Bohlinia III' 6-max Seat #6 is the button
Seat 1: eungenio ($11.78 in chips) 
Seat 2: Richard12358 ($21.65 in chips) 
Seat 3: supernightman ($13.77 in chips) 
Seat 4: romanromanro ($10 in chips) 
Seat 5: Kimi1892 ($16.49 in chips) 
Seat 6: whell11 ($10 in chips) 
eungenio: posts small blind $0.05
Richard12358: posts big blind $0.10
*** HOLE CARDS ***
supernightman: raises $0.20 to $0.30
romanromanro: calls $0.30
Kimi1892: folds 
whell11: folds 
eungenio: folds 
Richard12358: calls $0.20
*** FLOP *** [Ah Kc As]
Richard12358: checks 
supernightman: checks 
romanromanro: checks 
*** TURN *** [Ah Kc As] [7s]
Richard12358: bets $0.32
supernightman: calls $0.32
romanromanro: folds 
*** RIVER *** [Ah Kc As 7s] [2s]
Richard12358: checks 
supernightman: checks 
*** SHOW DOWN ***
Richard12358: shows [9s Qs] (a flush, Ace high)
supernightman: mucks hand 
Richard12358 collected $1.52 from pot
*** SUMMARY ***
Total pot $1.59 | Rake $0.07 
Board [Ah Kc As 7s 2s]
Seat 1: eungenio (small blind) folded before Flop
Seat 2: Richard12358 (big blind) showed [9s Qs] and won ($1.52) with a flush, Ace high
Seat 3: supernightman mucked
Seat 4: romanromanro folded on the Turn
Seat 5: Kimi1892 folded before Flop (didn't bet)
Seat 6: whell11 (button) folded before Flop (didn't bet)



PokerStars Hand #222956146348:  Hold'em No Limit ($0.05/$0.10 USD) - 2021/01/23 10:02:09 ET
Table 'Bohlinia III' 6-max Seat #1 is the button
Seat 1: eungenio ($11.73 in chips) 
Seat 2: Richard12358 ($22.55 in chips) 
Seat 3: supernightman ($13.15 in chips) 
Seat 4: romanromanro ($10 in chips) 
Seat 5: Kimi1892 ($16.49 in chips) 
Seat 6: whell11 ($10 in chips) 
Richard12358: posts small blind $0.05
supernightman: posts big blind $0.10
*** HOLE CARDS ***
romanromanro: folds 
Kimi1892 has timed out
Kimi1892: folds 
whell11: folds 
eungenio: raises $0.15 to $0.25
Richard12358: folds 
supernightman: folds 
Uncalled bet ($0.15) returned to eungenio
eungenio collected $0.25 from pot
eungenio: doesn't show hand 
*** SUMMARY ***
Total pot $0.25 | Rake $0 
Seat 1: eungenio (button) collected ($0.25)
Seat 2: Richard12358 (small blind) folded before Flop
Seat 3: supernightman (big blind) folded before Flop
Seat 4: romanromanro folded before Flop (didn't bet)
Seat 5: Kimi1892 folded before Flop (didn't bet)
Seat 6: whell11 folded before Flop (didn't bet)



PokerStars Hand #222956160868:  Hold'em No Limit ($0.05/$0.10 USD) - 2021/01/23 10:02:38 ET
Table 'Bohlinia III' 6-max Seat #2 is the button
Seat 1: eungenio ($11.88 in chips) 
Seat 2: Richard12358 ($22.50 in chips) 
Seat 3: supernightman ($13.05 in chips) 
Seat 4: romanromanro ($10 in chips) 
Seat 6: whell11 ($10 in chips) 
supernightman: posts small blind $0.05
romanromanro: posts big blind $0.10
*** HOLE CARDS ***
whell11: folds 
eungenio: raises $0.20 to $0.30
Richard12358: folds 
supernightman: folds 
romanromanro: raises $0.80 to $1.10
eungenio: folds 
Uncalled bet ($0.80) returned to romanromanro
romanromanro collected $0.65 from pot
romanromanro: doesn't show hand 
*** SUMMARY ***
Total pot $0.65 | Rake $0 
Seat 1: eungenio folded before Flop
Seat 2: Richard12358 (button) folded before Flop (didn't bet)
Seat 3: supernightman (small blind) folded before Flop
Seat 4: romanromanro (big blind) collected ($0.65)
Seat 6: whell11 folded before Flop (didn't bet)



PokerStars Hand #222956171089:  Hold'em No Limit ($0.05/$0.10 USD) - 2021/01/23 10:02:58 ET
Table 'Bohlinia III' 6-max Seat #3 is the button
Seat 1: eungenio ($11.58 in chips) 
Seat 2: Richard12358 ($22.50 in chips) 
Seat 3: supernightman ($13 in chips) 
Seat 4: romanromanro ($10.35 in chips) 
Seat 6: whell11 ($10 in chips) 
romanromanro: posts small blind $0.05
whell11: posts big blind $0.10
*** HOLE CARDS ***
eungenio: folds 
Richard12358: folds 
supernightman: raises $0.20 to $0.30
romanromanro: folds 
whell11: folds 
Uncalled bet ($0.20) returned to supernightman
supernightman collected $0.25 from pot
*** SUMMARY ***
Total pot $0.25 | Rake $0 
Seat 1: eungenio folded before Flop (didn't bet)
Seat 2: Richard12358 folded before Flop (didn't bet)
Seat 3: supernightman (button) collected ($0.25)
Seat 4: romanromanro (small blind) folded before Flop
Seat 6: whell11 (big blind) folded before Flop



PokerStars Hand #222956177541:  Hold'em No Limit ($0.05/$0.10 USD) - 2021/01/23 10:03:11 ET
Table 'Bohlinia III' 6-max Seat #4 is the button
Seat 1: eungenio ($11.58 in chips) 
Seat 2: Richard12358 ($22.50 in chips) 
Seat 3: supernightman ($13.15 in chips) 
Seat 4: romanromanro ($10.30 in chips) 
Seat 6: whell11 ($10 in chips) 
whell11: posts small blind $0.05
eungenio: posts big blind $0.10
*** HOLE CARDS ***
Richard12358: folds 
supernightman: folds 
romanromanro: folds 
whell11: raises $0.20 to $0.30
eungenio: folds 
Uncalled bet ($0.20) returned to whell11
whell11 collected $0.20 from pot
whell11: doesn't show hand 
*** SUMMARY ***
Total pot $0.20 | Rake $0 
Seat 1: eungenio (big blind) folded before Flop
Seat 2: Richard12358 folded before Flop (didn't bet)
Seat 3: supernightman folded before Flop (didn't bet)
Seat 4: romanromanro (button) folded before Flop (didn't bet)
Seat 6: whell11 (small blind) collected ($0.20)



PokerStars Hand #222956183743:  Hold'em No Limit ($0.05/$0.10 USD) - 2021/01/23 10:03:23 ET
Table 'Bohlinia III' 6-max Seat #6 is the button
Seat 1: eungenio ($11.48 in chips) 
Seat 2: Richard12358 ($22.50 in chips) 
Seat 3: supernightman ($13.15 in chips) 
Seat 4: romanromanro ($10.30 in chips) 
Seat 6: whell11 ($10.10 in chips) 
eungenio: posts small blind $0.05
Richard12358: posts big blind $0.10
*** HOLE CARDS ***
supernightman: raises $0.20 to $0.30
romanromanro: folds 
whell11: folds 
eungenio: folds 
Richard12358: folds 
Uncalled bet ($0.20) returned to supernightman
supernightman collected $0.25 from pot
*** SUMMARY ***
Total pot $0.25 | Rake $0 
Seat 1: eungenio (small blind) folded before Flop
Seat 2: Richard12358 (big blind) folded before Flop
Seat 3: supernightman collected ($0.25)
Seat 4: romanromanro folded before Flop (didn't bet)
Seat 6: whell11 (button) folded before Flop (didn't bet)



PokerStars Hand #222956191731:  Hold'em No Limit ($0.05/$0.10 USD) - 2021/01/23 10:03:38 ET
Table 'Bohlinia III' 6-max Seat #1 is the button
Seat 1: eungenio ($11.43 in chips) 
Seat 2: Richard12358 ($22.40 in chips) 
Seat 3: supernightman ($13.30 in chips) 
Seat 4: romanromanro ($10.30 in chips) 
Seat 6: whell11 ($10.10 in chips) 
Richard12358: posts small blind $0.05
supernightman: posts big blind $0.10
*** HOLE CARDS ***
romanromanro: folds 
whell11: folds 
eungenio: raises $0.15 to $0.25
Richard12358: calls $0.20
supernightman: folds 
*** FLOP *** [Qh 8c 7d]
Richard12358: bets $0.30
eungenio: calls $0.30
*** TURN *** [Qh 8c 7d] [As]
Richard12358: checks 
eungenio: checks 
*** RIVER *** [Qh 8c 7d As] [3s]
Richard12358: checks 
eungenio: checks 
*** SHOW DOWN ***
Richard12358: shows [Kh Tc] (high card Ace)
eungenio: shows [9d 8h] (a pair of Eights)
eungenio collected $1.15 from pot
*** SUMMARY ***
Total pot $1.20 | Rake $0.05 
Board [Qh 8c 7d As 3s]
Seat 1: eungenio (button) showed [9d 8h] and won ($1.15) with a pair of Eights
Seat 2: Richard12358 (small blind) showed [Kh Tc] and lost with high card Ace
Seat 3: supernightman (big blind) folded before Flop
Seat 4: romanromanro folded before Flop (didn't bet)
Seat 6: whell11 folded before Flop (didn't bet)



PokerStars Hand #222956214461:  Hold'em No Limit ($0.05/$0.10 USD) - 2021/01/23 10:04:09 ET
Table 'Bohlinia III' 6-max Seat #2 is the button
Seat 1: eungenio ($12.03 in chips) 
Seat 2: Richard12358 ($21.85 in chips) 
Seat 3: supernightman ($13.20 in chips) 
Seat 4: romanromanro ($10.30 in chips) 
Seat 6: whell11 ($10.10 in chips) 
supernightman: posts small blind $0.05
romanromanro: posts big blind $0.10
*** HOLE CARDS ***
whell11: folds 
eungenio: folds 
Richard12358: calls $0.10
supernightman: calls $0.05
romanromanro: checks 
*** FLOP *** [3h 2s 8h]
supernightman: checks 
romanromanro: checks 
Richard12358: bets $0.29
supernightman: raises $1.01 to $1.30
romanromanro: folds 
Richard12358: folds 
Uncalled bet ($1.01) returned to supernightman
supernightman collected $0.84 from pot
*** SUMMARY ***
Total pot $0.88 | Rake $0.04 
Board [3h 2s 8h]
Seat 1: eungenio folded before Flop (didn't bet)
Seat 2: Richard12358 (button) folded on the Flop
Seat 3: supernightman (small blind) collected ($0.84)
Seat 4: romanromanro (big blind) folded on the Flop
Seat 6: whell11 folded before Flop (didn't bet)



PokerStars Hand #222956228844:  Hold'em No Limit ($0.05/$0.10 USD) - 2021/01/23 10:04:38 ET
Table 'Bohlinia III' 6-max Seat #3 is the button
Seat 1: eungenio ($12.03 in chips) 
Seat 2: Richard12358 ($21.46 in chips) 
Seat 3: supernightman ($13.65 in chips) 
Seat 4: romanromanro ($10.20 in chips) 
Seat 6: whell11 ($10.10 in chips) 
romanromanro: posts small blind $0.05
whell11: posts big blind $0.10
*** HOLE CARDS ***
eungenio: folds 
Richard12358: folds 
supernightman: raises $0.20 to $0.30
romanromanro: folds 
whell11: folds 
Uncalled bet ($0.20) returned to supernightman
supernightman collected $0.25 from pot
*** SUMMARY ***
Total pot $0.25 | Rake $0 
Seat 1: eungenio folded before Flop (didn't bet)
Seat 2: Richard12358 folded before Flop (didn't bet)
Seat 3: supernightman (button) collected ($0.25)
Seat 4: romanromanro (small blind) folded before Flop
Seat 6: whell11 (big blind) folded before Flop



PokerStars Hand #222956233698:  Hold'em No Limit ($0.05/$0.10 USD) - 2021/01/23 10:04:47 ET
Table 'Bohlinia III' 6-max Seat #4 is the button
Seat 1: eungenio ($12.03 in chips) 
Seat 2: Richard12358 ($21.46 in chips) 
Seat 3: supernightman ($13.80 in chips) 
Seat 4: romanromanro ($10.15 in chips) 
Seat 6: whell11 ($10 in chips) 
whell11: posts small blind $0.05
eungenio: posts big blind $0.10
*** HOLE CARDS ***
Richard12358: calls $0.10
supernightman: folds 
romanromanro: folds 
whell11: folds 
eungenio: checks 
*** FLOP *** [3s Ah Jc]
eungenio: checks 
Richard12358: bets $0.10
eungenio: folds 
Uncalled bet ($0.10) returned to Richard12358
Richard12358 collected $0.24 from pot
Richard12358: doesn't show hand 
*** SUMMARY ***
Total pot $0.25 | Rake $0.01 
Board [3s Ah Jc]
Seat 1: eungenio (big blind) folded on the Flop
Seat 2: Richard12358 collected ($0.24)
Seat 3: supernightman folded before Flop (didn't bet)
Seat 4: romanromanro (button) folded before Flop (didn't bet)
Seat 6: whell11 (small blind) folded before Flop



PokerStars Hand #222956245572:  Hold'em No Limit ($0.05/$0.10 USD) - 2021/01/23 10:05:09 ET
Table 'Bohlinia III' 6-max Seat #6 is the button
Seat 1: eungenio ($11.93 in chips) 
Seat 2: Richard12358 ($21.60 in chips) 
Seat 3: supernightman ($13.80 in chips) 
Seat 4: romanromanro ($10.15 in chips) 
Seat 6: whell11 ($10 in chips) 
eungenio: posts small blind $0.05
Richard12358: posts big blind $0.10
*** HOLE CARDS ***
supernightman: folds 
romanromanro: raises $0.15 to $0.25
whell11: folds 
eungenio: folds 
Richard12358: folds 
Uncalled bet ($0.15) returned to romanromanro
romanromanro collected $0.25 from pot
romanromanro: doesn't show hand 
*** SUMMARY ***
Total pot $0.25 | Rake $0 
Seat 1: eungenio (small blind) folded before Flop
Seat 2: Richard12358 (big blind) folded before Flop
Seat 3: supernightman folded before Flop (didn't bet)
Seat 4: romanromanro collected ($0.25)
Seat 6: whell11 (button) folded before Flop (didn't bet)



PokerStars Hand #222956251511:  Hold'em No Limit ($0.05/$0.10 USD) - 2021/01/23 10:05:21 ET
Table 'Bohlinia III' 6-max Seat #1 is the button
Seat 1: eungenio ($11.88 in chips) 
Seat 2: Richard12358 ($21.50 in chips) 
Seat 3: supernightman ($13.80 in chips) 
Seat 4: romanromanro ($10.30 in chips) 
Seat 6: whell11 ($10 in chips) 
Richard12358: posts small blind $0.05
supernightman: posts big blind $0.10
*** HOLE CARDS ***
romanromanro: folds 
whell11: folds 
eungenio: raises $0.15 to $0.25
Richard12358: folds 
supernightman: calls $0.15
*** FLOP *** [3d 2d 6d]
supernightman: checks 
eungenio: checks 
*** TURN *** [3d 2d 6d] [Ac]
supernightman: bets $0.40
eungenio: calls $0.40
*** RIVER *** [3d 2d 6d Ac] [7h]
supernightman: bets $1.29
eungenio: calls $1.29
*** SHOW DOWN ***
supernightman: shows [8c Kd] (high card Ace)
eungenio: shows [Ad Js] (a pair of Aces)
eungenio collected $3.75 from pot
*** SUMMARY ***
Total pot $3.93 | Rake $0.18 
Board [3d 2d 6d Ac 7h]
Seat 1: eungenio (button) showed [Ad Js] and won ($3.75) with a pair of Aces
Seat 2: Richard12358 (small blind) folded before Flop
Seat 3: supernightman (big blind) showed [8c Kd] and lost with high card Ace
Seat 4: romanromanro folded before Flop (didn't bet)
Seat 6: whell11 folded before Flop (didn't bet)



PokerStars Hand #222956269850:  Hold'em No Limit ($0.05/$0.10 USD) - 2021/01/23 10:05:56 ET
Table 'Bohlinia III' 6-max Seat #2 is the button
Seat 1: eungenio ($13.69 in chips) 
Seat 2: Richard12358 ($21.45 in chips) 
Seat 3: supernightman ($11.86 in chips) 
Seat 4: romanromanro ($10.30 in chips) 
Seat 6: whell11 ($10 in chips) 
supernightman: posts small blind $0.05
romanromanro: posts big blind $0.10
*** HOLE CARDS ***
whell11: folds 
eungenio: folds 
Richard12358: calls $0.10
supernightman: folds 
romanromanro: checks 
*** FLOP *** [Ks Qs 3d]
romanromanro: checks 
Richard12358: bets $0.10
romanromanro: folds 
Uncalled bet ($0.10) returned to Richard12358
Richard12358 collected $0.24 from pot
Richard12358: doesn't show hand 
*** SUMMARY ***
Total pot $0.25 | Rake $0.01 
Board [Ks Qs 3d]
Seat 1: eungenio folded before Flop (didn't bet)
Seat 2: Richard12358 (button) collected ($0.24)
Seat 3: supernightman (small blind) folded before Flop
Seat 4: romanromanro (big blind) folded on the Flop
Seat 6: whell11 folded before Flop (didn't bet)



PokerStars Hand #222956281244:  Hold'em No Limit ($0.05/$0.10 USD) - 2021/01/23 10:06:17 ET
Table 'Bohlinia III' 6-max Seat #3 is the button
Seat 1: eungenio ($13.69 in chips) 
Seat 2: Richard12358 ($21.59 in chips) 
Seat 3: supernightman ($11.81 in chips) 
Seat 4: romanromanro ($10.20 in chips) 
Seat 6: whell11 ($10 in chips) 
romanromanro: posts small blind $0.05
whell11: posts big blind $0.10
*** HOLE CARDS ***
eungenio: folds 
Richard12358: folds 
supernightman: folds 
romanromanro: folds 
Uncalled bet ($0.05) returned to whell11
whell11 collected $0.10 from pot
whell11: doesn't show hand 
*** SUMMARY ***
Total pot $0.10 | Rake $0 
Seat 1: eungenio folded before Flop (didn't bet)
Seat 2: Richard12358 folded before Flop (didn't bet)
Seat 3: supernightman (button) folded before Flop (didn't bet)
Seat 4: romanromanro (small blind) folded before Flop
Seat 6: whell11 (big blind) collected ($0.10)



PokerStars Hand #222956283748:  Hold'em No Limit ($0.05/$0.10 USD) - 2021/01/23 10:06:22 ET
Table 'Bohlinia III' 6-max Seat #4 is the button
Seat 1: eungenio ($13.69 in chips) 
Seat 2: Richard12358 ($21.59 in chips) 
Seat 3: supernightman ($11.81 in chips) 
Seat 4: romanromanro ($10.15 in chips) 
Seat 6: whell11 ($10.05 in chips) 
whell11: posts small blind $0.05
eungenio: posts big blind $0.10
*** HOLE CARDS ***
Richard12358: raises $0.20 to $0.30
supernightman: calls $0.30
romanromanro: folds 
whell11: folds 
eungenio: calls $0.20
*** FLOP *** [7c 4s 3h]
eungenio: checks 
Richard12358: bets $1
supernightman: calls $1
eungenio: folds 
*** TURN *** [7c 4s 3h] [Ac]
Richard12358: bets $1.41
supernightman: folds 
Uncalled bet ($1.41) returned to Richard12358
Richard12358 collected $2.82 from pot
Richard12358: doesn't show hand 
*** SUMMARY ***
Total pot $2.95 | Rake $0.13 
Board [7c 4s 3h Ac]
Seat 1: eungenio (big blind) folded on the Flop
Seat 2: Richard12358 collected ($2.82)
Seat 3: supernightman folded on the Turn
Seat 4: romanromanro (button) folded before Flop (didn't bet)
Seat 6: whell11 (small blind) folded before Flop



PokerStars Hand #222956304563:  Hold'em No Limit ($0.05/$0.10 USD) - 2021/01/23 10:07:02 ET
Table 'Bohlinia III' 6-max Seat #6 is the button
Seat 1: eungenio ($13.39 in chips) 
Seat 2: Richard12358 ($23.11 in chips) 
Seat 3: supernightman ($10.51 in chips) 
Seat 4: romanromanro ($10.15 in chips) 
Seat 6: whell11 ($10 in chips) 
eungenio: posts small blind $0.05
Richard12358: posts big blind $0.10
Kimi1892: sits out 
*** HOLE CARDS ***
supernightman: folds 
romanromanro: folds 
whell11: folds 
eungenio: folds 
Uncalled bet ($0.05) returned to Richard12358
Richard12358 collected $0.10 from pot
*** SUMMARY ***
Total pot $0.10 | Rake $0 
Seat 1: eungenio (small blind) folded before Flop
Seat 2: Richard12358 (big blind) collected ($0.10)
Seat 3: supernightman folded before Flop (didn't bet)
Seat 4: romanromanro folded before Flop (didn't bet)
Seat 6: whell11 (button) folded before Flop (didn't bet)



PokerStars Hand #222956313171:  Hold'em No Limit ($0.05/$0.10 USD) - 2021/01/23 10:07:18 ET
Table 'Bohlinia III' 6-max Seat #1 is the button
Seat 1: eungenio ($13.34 in chips) 
Seat 2: Richard12358 ($23.16 in chips) 
Seat 3: supernightman ($10.51 in chips) 
Seat 4: romanromanro ($10.15 in chips) 
Seat 6: whell11 ($10 in chips) 
Richard12358: posts small blind $0.05
supernightman: posts big blind $0.10
Kimi1892: sits out 
*** HOLE CARDS ***
romanromanro: folds 
whell11: raises $0.20 to $0.30
eungenio: folds 
Richard12358: folds 
supernightman: folds 
Uncalled bet ($0.20) returned to whell11
whell11 collected $0.25 from pot
whell11: doesn't show hand 
*** SUMMARY ***
Total pot $0.25 | Rake $0 
Seat 1: eungenio (button) folded before Flop (didn't bet)
Seat 2: Richard12358 (small blind) folded before Flop
Seat 3: supernightman (big blind) folded before Flop
Seat 4: romanromanro folded before Flop (didn't bet)
Seat 6: whell11 collected ($0.25)



PokerStars Hand #222956318729:  Hold'em No Limit ($0.05/$0.10 USD) - 2021/01/23 10:07:29 ET
Table 'Bohlinia III' 6-max Seat #2 is the button
Seat 1: eungenio ($13.34 in chips) 
Seat 2: Richard12358 ($23.11 in chips) 
Seat 3: supernightman ($10.41 in chips) 
Seat 4: romanromanro ($10.15 in chips) 
Seat 6: whell11 ($10.15 in chips) 
supernightman: posts small blind $0.05
romanromanro: posts big blind $0.10
Kimi1892: sits out 
*** HOLE CARDS ***
whell11: folds 
eungenio: raises $0.20 to $0.30
Richard12358: folds 
supernightman: folds 
romanromanro: calls $0.20
*** FLOP *** [Ah Qd Jc]
romanromanro: checks 
eungenio: checks 
*** TURN *** [Ah Qd Jc] [6h]
romanromanro: checks 
eungenio: bets $0.20
romanromanro: folds 
Uncalled bet ($0.20) returned to eungenio
eungenio collected $0.62 from pot
eungenio: doesn't show hand 
*** SUMMARY ***
Total pot $0.65 | Rake $0.03 
Board [Ah Qd Jc 6h]
Seat 1: eungenio collected ($0.62)
Seat 2: Richard12358 (button) folded before Flop (didn't bet)
Seat 3: supernightman (small blind) folded before Flop
Seat 4: romanromanro (big blind) folded on the Turn
Seat 6: whell11 folded before Flop (didn't bet)



PokerStars Hand #222956333998:  Hold'em No Limit ($0.05/$0.10 USD) - 2021/01/23 10:07:59 ET
Table 'Bohlinia III' 6-max Seat #3 is the button
Seat 1: eungenio ($13.66 in chips) 
Seat 2: Richard12358 ($23.11 in chips) 
Seat 3: supernightman ($10.36 in chips) 
Seat 4: romanromanro ($10 in chips) 
Seat 5: Kimi1892 ($16.49 in chips) 
Seat 6: whell11 ($10.15 in chips) 
romanromanro: posts small blind $0.05
Kimi1892: posts big blind $0.10
*** HOLE CARDS ***
whell11: folds 
eungenio: folds 
Richard12358: raises $0.20 to $0.30
supernightman: calls $0.30
romanromanro: folds 
Kimi1892: folds 
*** FLOP *** [Kd 8h Ks]
Richard12358: checks 
supernightman: checks 
*** TURN *** [Kd 8h Ks] [Th]
Richard12358: bets $0.36
supernightman: calls $0.36
*** RIVER *** [Kd 8h Ks Th] [4c]
Richard12358: checks 
supernightman: checks 
*** SHOW DOWN ***
Richard12358: shows [5h 6h] (a pair of Kings)
supernightman: shows [Qd 8d] (two pair, Kings and Eights)
supernightman collected $1.40 from pot
*** SUMMARY ***
Total pot $1.47 | Rake $0.07 
Board [Kd 8h Ks Th 4c]
Seat 1: eungenio folded before Flop (didn't bet)
Seat 2: Richard12358 showed [5h 6h] and lost with a pair of Kings
Seat 3: supernightman (button) showed [Qd 8d] and won ($1.40) with two pair, Kings and Eights
Seat 4: romanromanro (small blind) folded before Flop
Seat 5: Kimi1892 (big blind) folded before Flop
Seat 6: whell11 folded before Flop (didn't bet)



PokerStars Hand #222956361649:  Hold'em No Limit ($0.05/$0.10 USD) - 2021/01/23 10:08:52 ET
Table 'Bohlinia III' 6-max Seat #4 is the button
Seat 1: eungenio ($13.66 in chips) 
Seat 2: Richard12358 ($22.45 in chips) 
Seat 3: supernightman ($11.10 in chips) 
Seat 4: romanromanro ($10 in chips) 
Seat 5: Kimi1892 ($16.39 in chips) 
Seat 6: whell11 ($10.15 in chips) 
Kimi1892: posts small blind $0.05
whell11: posts big blind $0.10
*** HOLE CARDS ***
eungenio: folds 
Richard12358: folds 
supernightman: folds 
romanromanro: folds 
Kimi1892: folds 
Uncalled bet ($0.05) returned to whell11
whell11 collected $0.10 from pot
whell11: doesn't show hand 
*** SUMMARY ***
Total pot $0.10 | Rake $0 
Seat 1: eungenio folded before Flop (didn't bet)
Seat 2: Richard12358 folded before Flop (didn't bet)
Seat 3: supernightman folded before Flop (didn't bet)
Seat 4: romanromanro (button) folded before Flop (didn't bet)
Seat 5: Kimi1892 (small blind) folded before Flop
Seat 6: whell11 (big blind) collected ($0.10)



PokerStars Hand #222956367156:  Hold'em No Limit ($0.05/$0.10 USD) - 2021/01/23 10:09:02 ET
Table 'Bohlinia III' 6-max Seat #5 is the button
Seat 2: Richard12358 ($22.45 in chips) 
Seat 3: supernightman ($11.10 in chips) 
Seat 4: romanromanro ($10 in chips) 
Seat 5: Kimi1892 ($16.34 in chips) 
Seat 6: whell11 ($10.20 in chips) 
whell11: posts small blind $0.05
eungenio: is sitting out 
Richard12358: posts big blind $0.10
*** HOLE CARDS ***
eungenio leaves the table
supernightman: folds 
romanromanro: folds 
dante192 joins the table at seat #1 
Kimi1892: raises $0.20 to $0.30
whell11: folds 
Richard12358: calls $0.20
*** FLOP *** [2s As 6d]
Richard12358: checks 
Kimi1892: bets $0.41
Richard12358: folds 
Uncalled bet ($0.41) returned to Kimi1892
Kimi1892 collected $0.62 from pot
Kimi1892: doesn't show hand 
*** SUMMARY ***
Total pot $0.65 | Rake $0.03 
Board [2s As 6d]
Seat 2: Richard12358 (big blind) folded on the Flop
Seat 3: supernightman folded before Flop (didn't bet)
Seat 4: romanromanro folded before Flop (didn't bet)
Seat 5: Kimi1892 (button) collected ($0.62)
Seat 6: whell11 (small blind) folded before Flop



PokerStars Hand #222956379668:  Hold'em No Limit ($0.05/$0.10 USD) - 2021/01/23 10:09:26 ET
Table 'Bohlinia III' 6-max Seat #6 is the button
Seat 2: Richard12358 ($22.15 in chips) 
Seat 3: supernightman ($11.10 in chips) 
Seat 4: romanromanro ($10 in chips) 
Seat 5: Kimi1892 ($16.66 in chips) 
Seat 6: whell11 ($10.15 in chips) 
Richard12358: posts small blind $0.05
supernightman: posts big blind $0.10
*** HOLE CARDS ***
romanromanro: raises $0.15 to $0.25
Kimi1892: folds 
whell11: folds 
Richard12358: folds 
supernightman: calls $0.15
*** FLOP *** [5d As Qd]
supernightman: bets $0.27
romanromanro: calls $0.27
*** TURN *** [5d As Qd] [6h]
supernightman: bets $0.78
romanromanro: folds 
Uncalled bet ($0.78) returned to supernightman
supernightman collected $1.04 from pot
*** SUMMARY ***
Total pot $1.09 | Rake $0.05 
Board [5d As Qd 6h]
Seat 2: Richard12358 (small blind) folded before Flop
Seat 3: supernightman (big blind) collected ($1.04)
Seat 4: romanromanro folded on the Turn
Seat 5: Kimi1892 folded before Flop (didn't bet)
Seat 6: whell11 (button) folded before Flop (didn't bet)



PokerStars Hand #222956399259:  Hold'em No Limit ($0.05/$0.10 USD) - 2021/01/23 10:10:04 ET
Table 'Bohlinia III' 6-max Seat #2 is the button
Seat 2: Richard12358 ($22.10 in chips) 
Seat 3: supernightman ($11.62 in chips) 
Seat 4: romanromanro ($10 in chips) 
Seat 5: Kimi1892 ($16.66 in chips) 
Seat 6: whell11 ($10.15 in chips) 
supernightman: posts small blind $0.05
romanromanro: posts big blind $0.10
dante192: sits out 
*** HOLE CARDS ***
Kimi1892: raises $0.15 to $0.25
whell11: folds 
Richard12358: folds 
supernightman: folds 
romanromanro: folds 
Uncalled bet ($0.15) returned to Kimi1892
Kimi1892 collected $0.25 from pot
Kimi1892: doesn't show hand 
*** SUMMARY ***
Total pot $0.25 | Rake $0 
Seat 2: Richard12358 (button) folded before Flop (didn't bet)
Seat 3: supernightman (small blind) folded before Flop
Seat 4: romanromanro (big blind) folded before Flop
Seat 5: Kimi1892 collected ($0.25)
Seat 6: whell11 folded before Flop (didn't bet)



PokerStars Hand #222956404069:  Hold'em No Limit ($0.05/$0.10 USD) - 2021/01/23 10:10:13 ET
Table 'Bohlinia III' 6-max Seat #3 is the button
Seat 2: Richard12358 ($22.10 in chips) 
Seat 3: supernightman ($11.57 in chips) 
Seat 4: romanromanro ($10 in chips) 
Seat 5: Kimi1892 ($16.81 in chips) 
Seat 6: whell11 ($10.15 in chips) 
romanromanro: posts small blind $0.05
Kimi1892: posts big blind $0.10
dante192: sits out 
*** HOLE CARDS ***
whell11: folds 
Richard12358: folds 
supernightman: raises $0.20 to $0.30
romanromanro: folds 
Kimi1892: calls $0.20
*** FLOP *** [5s 5c 7c]
Kimi1892: checks 
supernightman: checks 
*** TURN *** [5s 5c 7c] [Qc]
Kimi1892: bets $0.41
supernightman: calls $0.41
*** RIVER *** [5s 5c 7c Qc] [Qh]
Kimi1892: bets $0.90
supernightman: raises $2.40 to $3.30
Kimi1892: folds 
Uncalled bet ($2.40) returned to supernightman
supernightman collected $3.12 from pot
*** SUMMARY ***
Total pot $3.27 | Rake $0.15 
Board [5s 5c 7c Qc Qh]
Seat 2: Richard12358 folded before Flop (didn't bet)
Seat 3: supernightman (button) collected ($3.12)
Seat 4: romanromanro (small blind) folded before Flop
Seat 5: Kimi1892 (big blind) folded on the River
Seat 6: whell11 folded before Flop (didn't bet)



PokerStars Hand #222956421758:  Hold'em No Limit ($0.05/$0.10 USD) - 2021/01/23 10:10:46 ET
Table 'Bohlinia III' 6-max Seat #4 is the button
Seat 2: Richard12358 ($22.10 in chips) 
Seat 3: supernightman ($13.08 in chips) 
Seat 4: romanromanro ($10 in chips) 
Seat 5: Kimi1892 ($15.20 in chips) 
Seat 6: whell11 ($10.15 in chips) 
Kimi1892: posts small blind $0.05
whell11: posts big blind $0.10
dante192: sits out 
*** HOLE CARDS ***
Richard12358: folds 
supernightman: folds 
romanromanro: folds 
Kimi1892: raises $0.20 to $0.30
whell11: folds 
Uncalled bet ($0.20) returned to Kimi1892
Kimi1892 collected $0.20 from pot
Kimi1892: doesn't show hand 
*** SUMMARY ***
Total pot $0.20 | Rake $0 
Seat 2: Richard12358 folded before Flop (didn't bet)
Seat 3: supernightman folded before Flop (didn't bet)
Seat 4: romanromanro (button) folded before Flop (didn't bet)
Seat 5: Kimi1892 (small blind) collected ($0.20)
Seat 6: whell11 (big blind) folded before Flop



PokerStars Hand #222956429266:  Hold'em No Limit ($0.05/$0.10 USD) - 2021/01/23 10:11:01 ET
Table 'Bohlinia III' 6-max Seat #5 is the button
Seat 1: dante192 ($10 in chips) 
Seat 2: Richard12358 ($22.10 in chips) 
Seat 3: supernightman ($13.08 in chips) 
Seat 4: romanromanro ($10 in chips) 
Seat 5: Kimi1892 ($15.30 in chips) 
Seat 6: whell11 ($10.05 in chips) 
whell11: posts small blind $0.05
dante192: posts big blind $0.10
*** HOLE CARDS ***
Richard12358 has timed out
Richard12358: folds 
supernightman: raises $0.20 to $0.30
romanromanro: folds 
Kimi1892: folds 
whell11: folds 
dante192: folds 
Uncalled bet ($0.20) returned to supernightman
supernightman collected $0.25 from pot
*** SUMMARY ***
Total pot $0.25 | Rake $0 
Seat 1: dante192 (big blind) folded before Flop
Seat 2: Richard12358 folded before Flop (didn't bet)
Seat 3: supernightman collected ($0.25)
Seat 4: romanromanro folded before Flop (didn't bet)
Seat 5: Kimi1892 (button) folded before Flop (didn't bet)
Seat 6: whell11 (small blind) folded before Flop



PokerStars Hand #222956440704:  Hold'em No Limit ($0.05/$0.10 USD) - 2021/01/23 10:11:22 ET
Table 'Bohlinia III' 6-max Seat #6 is the button
Seat 1: dante192 ($10 in chips) 
Seat 2: Richard12358 ($22.10 in chips) 
Seat 3: supernightman ($13.23 in chips) 
Seat 4: romanromanro ($10 in chips) 
Seat 5: Kimi1892 ($15.30 in chips) 
Seat 6: whell11 ($10 in chips) 
dante192: posts small blind $0.05
Richard12358: posts big blind $0.10
*** HOLE CARDS ***
supernightman: folds 
romanromanro: folds 
Kimi1892: raises $0.20 to $0.30
whell11: folds 
dante192: folds 
Richard12358: calls $0.20
*** FLOP *** [7s Qh Ah]
Richard12358: bets $0.31
Kimi1892: calls $0.31
*** TURN *** [7s Qh Ah] [Ad]
Richard12358: bets $0.61
Kimi1892: calls $0.61
*** RIVER *** [7s Qh Ah Ad] [8s]
Richard12358: bets $1
Kimi1892: folds 
Uncalled bet ($1) returned to Richard12358
Richard12358 collected $2.38 from pot
Richard12358: doesn't show hand 
*** SUMMARY ***
Total pot $2.49 | Rake $0.11 
Board [7s Qh Ah Ad 8s]
Seat 1: dante192 (small blind) folded before Flop
Seat 2: Richard12358 (big blind) collected ($2.38)
Seat 3: supernightman folded before Flop (didn't bet)
Seat 4: romanromanro folded before Flop (didn't bet)
Seat 5: Kimi1892 folded on the River
Seat 6: whell11 (button) folded before Flop (didn't bet)



PokerStars Hand #222956467215:  Hold'em No Limit ($0.05/$0.10 USD) - 2021/01/23 10:12:12 ET
Table 'Bohlinia III' 6-max Seat #1 is the button
Seat 1: dante192 ($10 in chips) 
Seat 2: Richard12358 ($23.26 in chips) 
Seat 3: supernightman ($13.23 in chips) 
Seat 4: romanromanro ($10 in chips) 
Seat 5: Kimi1892 ($14.08 in chips) 
Seat 6: whell11 ($10 in chips) 
Richard12358: posts small blind $0.05
supernightman: posts big blind $0.10
*** HOLE CARDS ***
romanromanro: folds 
Kimi1892: raises $0.20 to $0.30
whell11: folds 
dante192: folds 
Richard12358: folds 
supernightman: folds 
Uncalled bet ($0.20) returned to Kimi1892
Kimi1892 collected $0.25 from pot
Kimi1892: doesn't show hand 
*** SUMMARY ***
Total pot $0.25 | Rake $0 
Seat 1: dante192 (button) folded before Flop (didn't bet)
Seat 2: Richard12358 (small blind) folded before Flop
Seat 3: supernightman (big blind) folded before Flop
Seat 4: romanromanro folded before Flop (didn't bet)
Seat 5: Kimi1892 collected ($0.25)
Seat 6: whell11 folded before Flop (didn't bet)



PokerStars Hand #222956473265:  Hold'em No Limit ($0.05/$0.10 USD) - 2021/01/23 10:12:24 ET
Table 'Bohlinia III' 6-max Seat #2 is the button
Seat 1: dante192 ($10 in chips) 
Seat 2: Richard12358 ($23.21 in chips) 
Seat 3: supernightman ($13.13 in chips) 
Seat 4: romanromanro ($10 in chips) 
Seat 5: Kimi1892 ($14.23 in chips) 
Seat 6: whell11 ($10 in chips) 
supernightman: posts small blind $0.05
romanromanro: posts big blind $0.10
*** HOLE CARDS ***
Kimi1892: folds 
whell11: folds 
dante192: raises $0.15 to $0.25
Richard12358: calls $0.25
supernightman: folds 
romanromanro: folds 
*** FLOP *** [3c Qh Jd]
dante192: bets $0.31
Richard12358: calls $0.31
*** TURN *** [3c Qh Jd] [4c]
dante192: checks 
Richard12358: bets $0.35
dante192: calls $0.35
*** RIVER *** [3c Qh Jd 4c] [Ks]
dante192: checks 
Richard12358: bets $0.94
dante192: folds 
Uncalled bet ($0.94) returned to Richard12358
Richard12358 collected $1.88 from pot
Richard12358: doesn't show hand 
*** SUMMARY ***
Total pot $1.97 | Rake $0.09 
Board [3c Qh Jd 4c Ks]
Seat 1: dante192 folded on the River
Seat 2: Richard12358 (button) collected ($1.88)
Seat 3: supernightman (small blind) folded before Flop
Seat 4: romanromanro (big blind) folded before Flop
Seat 5: Kimi1892 folded before Flop (didn't bet)
Seat 6: whell11 folded before Flop (didn't bet)



PokerStars Hand #222956512502:  Hold'em No Limit ($0.05/$0.10 USD) - 2021/01/23 10:13:38 ET
Table 'Bohlinia III' 6-max Seat #3 is the button
Seat 1: dante192 ($10 in chips) 
Seat 2: Richard12358 ($24.18 in chips) 
Seat 3: supernightman ($13.08 in chips) 
Seat 4: romanromanro ($10 in chips) 
Seat 5: Kimi1892 ($14.23 in chips) 
Seat 6: whell11 ($10 in chips) 
romanromanro: posts small blind $0.05
Kimi1892: posts big blind $0.10
*** HOLE CARDS ***
whell11: folds 
dante192: folds 
Richard12358: folds 
supernightman: folds 
romanromanro: raises $0.20 to $0.30
Kimi1892: folds 
Uncalled bet ($0.20) returned to romanromanro
romanromanro collected $0.20 from pot
romanromanro: doesn't show hand 
*** SUMMARY ***
Total pot $0.20 | Rake $0 
Seat 1: dante192 folded before Flop (didn't bet)
Seat 2: Richard12358 folded before Flop (didn't bet)
Seat 3: supernightman (button) folded before Flop (didn't bet)
Seat 4: romanromanro (small blind) collected ($0.20)
Seat 5: Kimi1892 (big blind) folded before Flop
Seat 6: whell11 folded before Flop (didn't bet)



PokerStars Hand #222956519250:  Hold'em No Limit ($0.05/$0.10 USD) - 2021/01/23 10:13:50 ET
Table 'Bohlinia III' 6-max Seat #4 is the button
Seat 1: dante192 ($10 in chips) 
Seat 2: Richard12358 ($24.18 in chips) 
Seat 3: supernightman ($13.08 in chips) 
Seat 4: romanromanro ($10.10 in chips) 
Seat 5: Kimi1892 ($14.13 in chips) 
Seat 6: whell11 ($10 in chips) 
Kimi1892: posts small blind $0.05
whell11: posts big blind $0.10
*** HOLE CARDS ***
dante192: folds 
Richard12358: folds 
supernightman: raises $0.20 to $0.30
romanromanro: calls $0.30
Kimi1892: folds 
whell11: folds 
*** FLOP *** [Js 8s 6h]
supernightman: checks 
romanromanro: checks 
*** TURN *** [Js 8s 6h] [5s]
supernightman: checks 
romanromanro: checks 
*** RIVER *** [Js 8s 6h 5s] [2d]
supernightman: bets $0.36
romanromanro: calls $0.36
*** SHOW DOWN ***
supernightman: shows [Qd Jc] (a pair of Jacks)
romanromanro: mucks hand 
supernightman collected $1.40 from pot
*** SUMMARY ***
Total pot $1.47 | Rake $0.07 
Board [Js 8s 6h 5s 2d]
Seat 1: dante192 folded before Flop (didn't bet)
Seat 2: Richard12358 folded before Flop (didn't bet)
Seat 3: supernightman showed [Qd Jc] and won ($1.40) with a pair of Jacks
Seat 4: romanromanro (button) mucked
Seat 5: Kimi1892 (small blind) folded before Flop
Seat 6: whell11 (big blind) folded before Flop



PokerStars Hand #222956538977:  Hold'em No Limit ($0.05/$0.10 USD) - 2021/01/23 10:14:28 ET
Table 'Bohlinia III' 6-max Seat #5 is the button
Seat 1: dante192 ($10 in chips) 
Seat 2: Richard12358 ($24.18 in chips) 
Seat 3: supernightman ($13.82 in chips) 
Seat 4: romanromanro ($10 in chips) 
Seat 5: Kimi1892 ($14.08 in chips) 
Seat 6: whell11 ($10 in chips) 
whell11: posts small blind $0.05
dante192: posts big blind $0.10
*** HOLE CARDS ***
Richard12358: folds 
supernightman: folds 
romanromanro: raises $0.20 to $0.30
Kimi1892: folds 
whell11: folds 
dante192: folds 
Uncalled bet ($0.20) returned to romanromanro
romanromanro collected $0.25 from pot
romanromanro: doesn't show hand 
*** SUMMARY ***
Total pot $0.25 | Rake $0 
Seat 1: dante192 (big blind) folded before Flop
Seat 2: Richard12358 folded before Flop (didn't bet)
Seat 3: supernightman folded before Flop (didn't bet)
Seat 4: romanromanro collected ($0.25)
Seat 5: Kimi1892 (button) folded before Flop (didn't bet)
Seat 6: whell11 (small blind) folded before Flop



PokerStars Hand #222956546825:  Hold'em No Limit ($0.05/$0.10 USD) - 2021/01/23 10:14:43 ET
Table 'Bohlinia III' 6-max Seat #6 is the button
Seat 1: dante192 ($10 in chips) 
Seat 2: Richard12358 ($24.18 in chips) 
Seat 3: supernightman ($13.82 in chips) 
Seat 4: romanromanro ($10.15 in chips) 
Seat 5: Kimi1892 ($14.08 in chips) 
Seat 6: whell11 ($10 in chips) 
dante192: posts small blind $0.05
Richard12358: posts big blind $0.10
*** HOLE CARDS ***
supernightman: folds 
romanromanro: folds 
Kimi1892: raises $0.20 to $0.30
whell11: folds 
dante192: folds 
Richard12358: folds 
Uncalled bet ($0.20) returned to Kimi1892
Kimi1892 collected $0.25 from pot
Kimi1892: doesn't show hand 
*** SUMMARY ***
Total pot $0.25 | Rake $0 
Seat 1: dante192 (small blind) folded before Flop
Seat 2: Richard12358 (big blind) folded before Flop
Seat 3: supernightman folded before Flop (didn't bet)
Seat 4: romanromanro folded before Flop (didn't bet)
Seat 5: Kimi1892 collected ($0.25)
Seat 6: whell11 (button) folded before Flop (didn't bet)



PokerStars Hand #222956557509:  Hold'em No Limit ($0.05/$0.10 USD) - 2021/01/23 10:15:03 ET
Table 'Bohlinia III' 6-max Seat #1 is the button
Seat 1: dante192 ($10 in chips) 
Seat 2: Richard12358 ($24.08 in chips) 
Seat 3: supernightman ($13.82 in chips) 
Seat 4: romanromanro ($10.15 in chips) 
Seat 5: Kimi1892 ($14.23 in chips) 
Seat 6: whell11 ($10 in chips) 
Richard12358: posts small blind $0.05
supernightman: posts big blind $0.10
*** HOLE CARDS ***
romanromanro: folds 
Kimi1892: raises $0.20 to $0.30
whell11: folds 
romanromanro leaves the table
dante192: folds 
Richard12358: calls $0.25
abnormal01 joins the table at seat #4 
supernightman: folds 
*** FLOP *** [5s 7c Kh]
Richard12358: checks 
Kimi1892: bets $0.34
Richard12358: calls $0.34
*** TURN *** [5s 7c Kh] [Td]
Richard12358: checks 
Kimi1892: bets $1
Richard12358: folds 
Uncalled bet ($1) returned to Kimi1892
Kimi1892 collected $1.32 from pot
Kimi1892: doesn't show hand 
*** SUMMARY ***
Total pot $1.38 | Rake $0.06 
Board [5s 7c Kh Td]
Seat 1: dante192 (button) folded before Flop (didn't bet)
Seat 2: Richard12358 (small blind) folded on the Turn
Seat 3: supernightman (big blind) folded before Flop
Seat 4: romanromanro folded before Flop (didn't bet)
Seat 5: Kimi1892 collected ($1.32)
Seat 6: whell11 folded before Flop (didn't bet)



PokerStars Hand #222956578726:  Hold'em No Limit ($0.05/$0.10 USD) - 2021/01/23 10:15:42 ET
Table 'Bohlinia III' 6-max Seat #2 is the button
Seat 1: dante192 ($10 in chips) 
Seat 2: Richard12358 ($23.44 in chips) 
Seat 3: supernightman ($13.72 in chips) 
Seat 6: whell11 ($10 in chips) 
supernightman: posts small blind $0.05
Kimi1892: is sitting out 
whell11: posts big blind $0.10
*** HOLE CARDS ***
dante192: folds 
Kimi1892 leaves the table
Richard12358: folds 
supernightman: folds 
Uncalled bet ($0.05) returned to whell11
whell11 collected $0.10 from pot
whell11: doesn't show hand 
*** SUMMARY ***
Total pot $0.10 | Rake $0 
Seat 1: dante192 folded before Flop (didn't bet)
Seat 2: Richard12358 (button) folded before Flop (didn't bet)
Seat 3: supernightman (small blind) folded before Flop
Seat 6: whell11 (big blind) collected ($0.10)



PokerStars Hand #222956581733:  Hold'em No Limit ($0.05/$0.10 USD) - 2021/01/23 10:15:48 ET
Table 'Bohlinia III' 6-max Seat #3 is the button
Seat 1: dante192 ($10 in chips) 
Seat 2: Richard12358 ($23.44 in chips) 
Seat 3: supernightman ($13.67 in chips) 
Seat 6: whell11 ($10.05 in chips) 
whell11: posts small blind $0.05
dante192: posts big blind $0.10
*** HOLE CARDS ***
Richard12358: calls $0.10
supernightman: folds 
whell11: folds 
dante192: checks 
*** FLOP *** [4h Qh Kc]
selko1 joins the table at seat #5 
dante192: checks 
Richard12358: checks 
*** TURN *** [4h Qh Kc] [Td]
dante192: checks 
Richard12358: bets $0.10
dante192: folds 
Uncalled bet ($0.10) returned to Richard12358
Richard12358 collected $0.24 from pot
Richard12358: doesn't show hand 
*** SUMMARY ***
Total pot $0.25 | Rake $0.01 
Board [4h Qh Kc Td]
Seat 1: dante192 (big blind) folded on the Turn
Seat 2: Richard12358 collected ($0.24)
Seat 3: supernightman (button) folded before Flop (didn't bet)
Seat 6: whell11 (small blind) folded before Flop



PokerStars Hand #222956595268:  Hold'em No Limit ($0.05/$0.10 USD) - 2021/01/23 10:16:13 ET
Table 'Bohlinia III' 6-max Seat #6 is the button
Seat 1: dante192 ($10 in chips) 
Seat 2: Richard12358 ($23.58 in chips) 
Seat 3: supernightman ($13.67 in chips) 
Seat 6: whell11 ($10 in chips) 
dante192: posts small blind $0.05
Richard12358: posts big blind $0.10
selko1: sits out 
*** HOLE CARDS ***
supernightman: folds 
whell11: folds 
abnormal01 leaves the table
dante192: folds 
Uncalled bet ($0.05) returned to Richard12358
Richard12358 collected $0.10 from pot
*** SUMMARY ***
Total pot $0.10 | Rake $0 
Seat 1: dante192 (small blind) folded before Flop
Seat 2: Richard12358 (big blind) collected ($0.10)
Seat 3: supernightman folded before Flop (didn't bet)
Seat 6: whell11 (button) folded before Flop (didn't bet)



PokerStars Hand #222956602943:  Hold'em No Limit ($0.05/$0.10 USD) - 2021/01/23 10:16:27 ET
Table 'Bohlinia III' 6-max Seat #1 is the button
Seat 1: dante192 ($10 in chips) 
Seat 2: Richard12358 ($23.63 in chips) 
Seat 3: supernightman ($13.67 in chips) 
Seat 6: whell11 ($10 in chips) 
Richard12358: posts small blind $0.05
supernightman: posts big blind $0.10
selko1: sits out 
*** HOLE CARDS ***
whell11: folds 
dante192: folds 
Richard12358: calls $0.05
supernightman: checks 
*** FLOP *** [As Td 8s]
Mo3rupro joins the table at seat #4 
Richard12358: checks 
supernightman: checks 
*** TURN *** [As Td 8s] [9d]
Richard12358: bets $0.10
supernightman: calls $0.10
*** RIVER *** [As Td 8s 9d] [9h]
Richard12358: bets $0.38
supernightman: folds 
Uncalled bet ($0.38) returned to Richard12358
Richard12358 collected $0.38 from pot
Richard12358: doesn't show hand 
*** SUMMARY ***
Total pot $0.40 | Rake $0.02 
Board [As Td 8s 9d 9h]
Seat 1: dante192 (button) folded before Flop (didn't bet)
Seat 2: Richard12358 (small blind) collected ($0.38)
Seat 3: supernightman (big blind) folded on the River
Seat 6: whell11 folded before Flop (didn't bet)



PokerStars Hand #222956618798:  Hold'em No Limit ($0.05/$0.10 USD) - 2021/01/23 10:16:57 ET
Table 'Bohlinia III' 6-max Seat #2 is the button
Seat 1: dante192 ($10 in chips) 
Seat 2: Richard12358 ($23.81 in chips) 
Seat 3: supernightman ($13.47 in chips) 
Seat 4: Mo3rupro ($10 in chips) 
Seat 6: whell11 ($10 in chips) 
supernightman: posts small blind $0.05
Mo3rupro: posts big blind $0.10
selko1: sits out 
*** HOLE CARDS ***
whell11: folds 
dante192: folds 
Richard12358: calls $0.10
supernightman: raises $0.40 to $0.50
Mo3rupro: folds 
Richard12358: folds 
Uncalled bet ($0.40) returned to supernightman
supernightman collected $0.30 from pot
*** SUMMARY ***
Total pot $0.30 | Rake $0 
Seat 1: dante192 folded before Flop (didn't bet)
Seat 2: Richard12358 (button) folded before Flop
Seat 3: supernightman (small blind) collected ($0.30)
Seat 4: Mo3rupro (big blind) folded before Flop
Seat 6: whell11 folded before Flop (didn't bet)



PokerStars Hand #222956627302:  Hold'em No Limit ($0.05/$0.10 USD) - 2021/01/23 10:17:13 ET
Table 'Bohlinia III' 6-max Seat #3 is the button
Seat 1: dante192 ($10 in chips) 
Seat 2: Richard12358 ($23.71 in chips) 
Seat 3: supernightman ($13.67 in chips) 
Seat 4: Mo3rupro ($10 in chips) 
Seat 5: selko1 ($10 in chips) 
Seat 6: whell11 ($10 in chips) 
Mo3rupro: posts small blind $0.05
selko1: posts big blind $0.10
*** HOLE CARDS ***
whell11: raises $0.20 to $0.30
dante192: raises $0.60 to $0.90
Richard12358: folds 
supernightman: folds 
Mo3rupro: folds 
selko1: folds 
whell11: calls $0.60
*** FLOP *** [4d 7h Jc]
whell11: checks 
dante192: bets $0.70
whell11: calls $0.70
*** TURN *** [4d 7h Jc] [Qh]
whell11: checks 
dante192: checks 
*** RIVER *** [4d 7h Jc Qh] [Ad]
whell11: checks 
dante192: bets $2
whell11: folds 
Uncalled bet ($2) returned to dante192
dante192 collected $3.20 from pot
dante192: doesn't show hand 
*** SUMMARY ***
Total pot $3.35 | Rake $0.15 
Board [4d 7h Jc Qh Ad]
Seat 1: dante192 collected ($3.20)
Seat 2: Richard12358 folded before Flop (didn't bet)
Seat 3: supernightman (button) folded before Flop (didn't bet)
Seat 4: Mo3rupro (small blind) folded before Flop
Seat 5: selko1 (big blind) folded before Flop
Seat 6: whell11 folded on the River



PokerStars Hand #222956668905:  Hold'em No Limit ($0.05/$0.10 USD) - 2021/01/23 10:18:31 ET
Table 'Bohlinia III' 6-max Seat #4 is the button
Seat 1: dante192 ($11.60 in chips) 
Seat 2: Richard12358 ($23.71 in chips) 
Seat 3: supernightman ($13.67 in chips) 
Seat 4: Mo3rupro ($10 in chips) 
Seat 5: selko1 ($10 in chips) 
Seat 6: whell11 ($10 in chips) 
selko1: posts small blind $0.05
whell11: posts big blind $0.10
*** HOLE CARDS ***
dante192: raises $0.20 to $0.30
Richard12358: folds 
supernightman: folds 
Mo3rupro: folds 
selko1: folds 
whell11: folds 
Uncalled bet ($0.20) returned to dante192
dante192 collected $0.25 from pot
dante192: doesn't show hand 
*** SUMMARY ***
Total pot $0.25 | Rake $0 
Seat 1: dante192 collected ($0.25)
Seat 2: Richard12358 folded before Flop (didn't bet)
Seat 3: supernightman folded before Flop (didn't bet)
Seat 4: Mo3rupro (button) folded before Flop (didn't bet)
Seat 5: selko1 (small blind) folded before Flop
Seat 6: whell11 (big blind) folded before Flop



PokerStars Hand #222956680991:  Hold'em No Limit ($0.05/$0.10 USD) - 2021/01/23 10:18:53 ET
Table 'Bohlinia III' 6-max Seat #5 is the button
Seat 1: dante192 ($11.75 in chips) 
Seat 2: Richard12358 ($23.71 in chips) 
Seat 3: supernightman ($13.67 in chips) 
Seat 4: Mo3rupro ($10 in chips) 
Seat 5: selko1 ($10 in chips) 
Seat 6: whell11 ($10 in chips) 
whell11: posts small blind $0.05
dante192: posts big blind $0.10
*** HOLE CARDS ***
Richard12358: calls $0.10
supernightman: calls $0.10
Mo3rupro: folds 
selko1: folds 
whell11: folds 
dante192: checks 
*** FLOP *** [6d Jc Th]
dante192: checks 
Richard12358: checks 
supernightman: checks 
*** TURN *** [6d Jc Th] [As]
dante192: checks 
Richard12358: bets $0.33
supernightman: folds 
dante192: folds 
Uncalled bet ($0.33) returned to Richard12358
Richard12358 collected $0.33 from pot
Richard12358: doesn't show hand 
*** SUMMARY ***
Total pot $0.35 | Rake $0.02 
Board [6d Jc Th As]
Seat 1: dante192 (big blind) folded on the Turn
Seat 2: Richard12358 collected ($0.33)
Seat 3: supernightman folded on the Turn
Seat 4: Mo3rupro folded before Flop (didn't bet)
Seat 5: selko1 (button) folded before Flop (didn't bet)
Seat 6: whell11 (small blind) folded before Flop



PokerStars Hand #222956703880:  Hold'em No Limit ($0.05/$0.10 USD) - 2021/01/23 10:19:36 ET
Table 'Bohlinia III' 6-max Seat #6 is the button
Seat 1: dante192 ($11.65 in chips) 
Seat 2: Richard12358 ($23.94 in chips) 
Seat 3: supernightman ($13.57 in chips) 
Seat 4: Mo3rupro ($10 in chips) 
Seat 5: selko1 ($10 in chips) 
Seat 6: whell11 ($10 in chips) 
dante192: posts small blind $0.05
Richard12358: posts big blind $0.10
*** HOLE CARDS ***
supernightman: folds 
Mo3rupro: folds 
selko1: folds 
whell11: folds 
dante192: folds 
Uncalled bet ($0.05) returned to Richard12358
Richard12358 collected $0.10 from pot
*** SUMMARY ***
Total pot $0.10 | Rake $0 
Seat 1: dante192 (small blind) folded before Flop
Seat 2: Richard12358 (big blind) collected ($0.10)
Seat 3: supernightman folded before Flop (didn't bet)
Seat 4: Mo3rupro folded before Flop (didn't bet)
Seat 5: selko1 folded before Flop (didn't bet)
Seat 6: whell11 (button) folded before Flop (didn't bet)



PokerStars Hand #222956709658:  Hold'em No Limit ($0.05/$0.10 USD) - 2021/01/23 10:19:47 ET
Table 'Bohlinia III' 6-max Seat #1 is the button
Seat 1: dante192 ($11.60 in chips) 
Seat 2: Richard12358 ($23.99 in chips) 
Seat 3: supernightman ($13.57 in chips) 
Seat 4: Mo3rupro ($10 in chips) 
Seat 5: selko1 ($10 in chips) 
Seat 6: whell11 ($10 in chips) 
Richard12358: posts small blind $0.05
supernightman: posts big blind $0.10
*** HOLE CARDS ***
Mo3rupro: folds 
selko1: folds 
whell11: raises $0.20 to $0.30
dante192: folds 
Richard12358: calls $0.25
supernightman: folds 
*** FLOP *** [Ts 9s 2d]
Richard12358: checks 
whell11: bets $0.50
Richard12358: folds 
Uncalled bet ($0.50) returned to whell11
whell11 collected $0.67 from pot
whell11: doesn't show hand 
*** SUMMARY ***
Total pot $0.70 | Rake $0.03 
Board [Ts 9s 2d]
Seat 1: dante192 (button) folded before Flop (didn't bet)
Seat 2: Richard12358 (small blind) folded on the Flop
Seat 3: supernightman (big blind) folded before Flop
Seat 4: Mo3rupro folded before Flop (didn't bet)
Seat 5: selko1 folded before Flop (didn't bet)
Seat 6: whell11 collected ($0.67)



PokerStars Hand #222956721069:  Hold'em No Limit ($0.05/$0.10 USD) - 2021/01/23 10:20:08 ET
Table 'Bohlinia III' 6-max Seat #2 is the button
Seat 1: dante192 ($11.60 in chips) 
Seat 2: Richard12358 ($23.69 in chips) 
Seat 3: supernightman ($13.47 in chips) 
Seat 4: Mo3rupro ($10 in chips) 
Seat 5: selko1 ($10 in chips) 
Seat 6: whell11 ($10.37 in chips) 
supernightman: posts small blind $0.05
Mo3rupro: posts big blind $0.10
*** HOLE CARDS ***
selko1: folds 
whell11: folds 
dante192: raises $0.15 to $0.25
Richard12358: folds 
supernightman: folds 
Mo3rupro: calls $0.15
*** FLOP *** [Jd 2h Kc]
Mo3rupro: checks 
dante192: bets $0.19
Mo3rupro: folds 
Uncalled bet ($0.19) returned to dante192
dante192 collected $0.53 from pot
dante192: doesn't show hand 
*** SUMMARY ***
Total pot $0.55 | Rake $0.02 
Board [Jd 2h Kc]
Seat 1: dante192 collected ($0.53)
Seat 2: Richard12358 (button) folded before Flop (didn't bet)
Seat 3: supernightman (small blind) folded before Flop
Seat 4: Mo3rupro (big blind) folded on the Flop
Seat 5: selko1 folded before Flop (didn't bet)
Seat 6: whell11 folded before Flop (didn't bet)



PokerStars Hand #222956733874:  Hold'em No Limit ($0.05/$0.10 USD) - 2021/01/23 10:20:32 ET
Table 'Bohlinia III' 6-max Seat #3 is the button
Seat 1: dante192 ($11.88 in chips) 
Seat 2: Richard12358 ($23.69 in chips) 
Seat 3: supernightman ($13.42 in chips) 
Seat 4: Mo3rupro ($10 in chips) 
Seat 5: selko1 ($10 in chips) 
Seat 6: whell11 ($10.37 in chips) 
Mo3rupro: posts small blind $0.05
selko1: posts big blind $0.10
*** HOLE CARDS ***
whell11: folds 
dante192: folds 
Richard12358: calls $0.10
supernightman: folds 
Mo3rupro: folds 
selko1: raises $0.30 to $0.40
Richard12358: calls $0.30
*** FLOP *** [7d Qc 9c]
selko1: bets $0.50
Richard12358: calls $0.50
*** TURN *** [7d Qc 9c] [9s]
selko1: bets $1.10
Richard12358: calls $1.10
*** RIVER *** [7d Qc 9c 9s] [7c]
selko1: checks 
Richard12358: bets $3.87
selko1: folds 
Uncalled bet ($3.87) returned to Richard12358
Richard12358 collected $3.87 from pot
Richard12358: doesn't show hand 
*** SUMMARY ***
Total pot $4.05 | Rake $0.18 
Board [7d Qc 9c 9s 7c]
Seat 1: dante192 folded before Flop (didn't bet)
Seat 2: Richard12358 collected ($3.87)
Seat 3: supernightman (button) folded before Flop (didn't bet)
Seat 4: Mo3rupro (small blind) folded before Flop
Seat 5: selko1 (big blind) folded on the River
Seat 6: whell11 folded before Flop (didn't bet)



PokerStars Hand #222956783359:  Hold'em No Limit ($0.05/$0.10 USD) - 2021/01/23 10:22:04 ET
Table 'Bohlinia III' 6-max Seat #4 is the button
Seat 1: dante192 ($11.88 in chips) 
Seat 2: Richard12358 ($25.56 in chips) 
Seat 3: supernightman ($13.42 in chips) 
Seat 4: Mo3rupro ($10 in chips) 
Seat 5: selko1 ($10 in chips) 
Seat 6: whell11 ($10.37 in chips) 
selko1: posts small blind $0.05
whell11: posts big blind $0.10
*** HOLE CARDS ***
dante192: folds 
Richard12358: folds 
supernightman: raises $0.20 to $0.30
Mo3rupro: folds 
selko1: folds 
whell11: folds 
Uncalled bet ($0.20) returned to supernightman
supernightman collected $0.25 from pot
*** SUMMARY ***
Total pot $0.25 | Rake $0 
Seat 1: dante192 folded before Flop (didn't bet)
Seat 2: Richard12358 folded before Flop (didn't bet)
Seat 3: supernightman collected ($0.25)
Seat 4: Mo3rupro (button) folded before Flop (didn't bet)
Seat 5: selko1 (small blind) folded before Flop
Seat 6: whell11 (big blind) folded before Flop



PokerStars Hand #222956793174:  Hold'em No Limit ($0.05/$0.10 USD) - 2021/01/23 10:22:22 ET
Table 'Bohlinia III' 6-max Seat #5 is the button
Seat 1: dante192 ($11.88 in chips) 
Seat 2: Richard12358 ($25.56 in chips) 
Seat 3: supernightman ($13.57 in chips) 
Seat 4: Mo3rupro ($10 in chips) 
Seat 5: selko1 ($10 in chips) 
Seat 6: whell11 ($10.27 in chips) 
whell11: posts small blind $0.05
dante192: posts big blind $0.10
*** HOLE CARDS ***
Richard12358: folds 
supernightman: raises $0.20 to $0.30
Mo3rupro: folds 
selko1: folds 
whell11: folds 
dante192: folds 
Uncalled bet ($0.20) returned to supernightman
supernightman collected $0.25 from pot
*** SUMMARY ***
Total pot $0.25 | Rake $0 
Seat 1: dante192 (big blind) folded before Flop
Seat 2: Richard12358 folded before Flop (didn't bet)
Seat 3: supernightman collected ($0.25)
Seat 4: Mo3rupro folded before Flop (didn't bet)
Seat 5: selko1 (button) folded before Flop (didn't bet)
Seat 6: whell11 (small blind) folded before Flop



PokerStars Hand #222956803672:  Hold'em No Limit ($0.05/$0.10 USD) - 2021/01/23 10:22:42 ET
Table 'Bohlinia III' 6-max Seat #6 is the button
Seat 1: dante192 ($11.78 in chips) 
Seat 2: Richard12358 ($25.56 in chips) 
Seat 3: supernightman ($13.72 in chips) 
Seat 4: Mo3rupro ($10 in chips) 
Seat 5: selko1 ($10 in chips) 
Seat 6: whell11 ($10.22 in chips) 
dante192: posts small blind $0.05
Richard12358: posts big blind $0.10
*** HOLE CARDS ***
supernightman: folds 
Mo3rupro: raises $0.15 to $0.25
selko1: folds 
whell11: raises $0.65 to $0.90
dante192: folds 
Richard12358: folds 
Mo3rupro: folds 
Uncalled bet ($0.65) returned to whell11
whell11 collected $0.65 from pot
whell11: doesn't show hand 
*** SUMMARY ***
Total pot $0.65 | Rake $0 
Seat 1: dante192 (small blind) folded before Flop
Seat 2: Richard12358 (big blind) folded before Flop
Seat 3: supernightman folded before Flop (didn't bet)
Seat 4: Mo3rupro folded before Flop
Seat 5: selko1 folded before Flop (didn't bet)
Seat 6: whell11 (button) collected ($0.65)



PokerStars Hand #222957355212:  Hold'em No Limit ($0.05/$0.10 USD) - 2021/01/23 10:39:18 ET
Table 'Bohlinia III' 6-max Seat #6 is the button
Seat 1: dante192 ($14.01 in chips) 
Seat 2: ojeriza ($10 in chips) 
Seat 3: supernightman ($12.22 in chips) 
Seat 4: attila436 ($4 in chips) 
Seat 6: xScarface ($8.87 in chips) 
dante192: posts small blind $0.05
ojeriza: posts big blind $0.10
attila436: posts big blind $0.10
*** HOLE CARDS ***
supernightman: folds 
attila436 has timed out
attila436: checks 
xScarface: folds 
dante192: folds 
ojeriza: checks 
*** FLOP *** [Qh Js Qs]
ojeriza: checks 
attila436: checks 
*** TURN *** [Qh Js Qs] [9c]
ojeriza: bets $0.18
attila436 has timed out
attila436: folds 
Uncalled bet ($0.18) returned to ojeriza
ojeriza collected $0.24 from pot
ojeriza: doesn't show hand 
*** SUMMARY ***
Total pot $0.25 | Rake $0.01 
Board [Qh Js Qs 9c]
Seat 1: dante192 (small blind) folded before Flop
Seat 2: ojeriza (big blind) collected ($0.24)
Seat 3: supernightman folded before Flop (didn't bet)
Seat 4: attila436 folded on the Turn (didn't bet)
Seat 6: xScarface (button) folded before Flop (didn't bet)



PokerStars Hand #222957406573:  Hold'em No Limit ($0.05/$0.10 USD) - 2021/01/23 10:40:51 ET
Table 'Bohlinia III' 6-max Seat #1 is the button
Seat 1: dante192 ($13.96 in chips) 
Seat 2: ojeriza ($10.14 in chips) 
Seat 3: supernightman ($12.22 in chips) 
Seat 6: xScarface ($8.87 in chips) 
ojeriza: posts small blind $0.05
supernightman: posts big blind $0.10
*** HOLE CARDS ***
xScarface has timed out
xScarface: folds 
dante192: raises $0.15 to $0.25
ojeriza: folds 
supernightman: folds 
Uncalled bet ($0.15) returned to dante192
dante192 collected $0.25 from pot
dante192: doesn't show hand 
*** SUMMARY ***
Total pot $0.25 | Rake $0 
Seat 1: dante192 (button) collected ($0.25)
Seat 2: ojeriza (small blind) folded before Flop
Seat 3: supernightman (big blind) folded before Flop
Seat 6: xScarface folded before Flop (didn't bet)



PokerStars Hand #222957420922:  Hold'em No Limit ($0.05/$0.10 USD) - 2021/01/23 10:41:17 ET
Table 'Bohlinia III' 6-max Seat #2 is the button
Seat 1: dante192 ($14.11 in chips) 
Seat 2: ojeriza ($10.09 in chips) 
Seat 3: supernightman ($12.12 in chips) 
supernightman: posts small blind $0.05
dante192: posts big blind $0.10
*** HOLE CARDS ***
selko1 leaves the table
ojeriza: folds 
supernightman: folds 
Uncalled bet ($0.05) returned to dante192
19ElGringo91 joins the table at seat #5 
dante192 collected $0.10 from pot
dante192: doesn't show hand 
*** SUMMARY ***
Total pot $0.10 | Rake $0 
Seat 1: dante192 (big blind) collected ($0.10)
Seat 2: ojeriza (button) folded before Flop (didn't bet)
Seat 3: supernightman (small blind) folded before Flop



PokerStars Hand #222957424025:  Hold'em No Limit ($0.05/$0.10 USD) - 2021/01/23 10:41:23 ET
Table 'Bohlinia III' 6-max Seat #3 is the button
Seat 1: dante192 ($14.16 in chips) 
Seat 2: ojeriza ($10.09 in chips) 
Seat 3: supernightman ($12.07 in chips) 
dante192: posts small blind $0.05
ojeriza: posts big blind $0.10
*** HOLE CARDS ***
supernightman: raises $0.20 to $0.30
dante192: folds 
ojeriza: folds 
Uncalled bet ($0.20) returned to supernightman
supernightman collected $0.25 from pot
*** SUMMARY ***
Total pot $0.25 | Rake $0 
Seat 1: dante192 (small blind) folded before Flop
Seat 2: ojeriza (big blind) folded before Flop
Seat 3: supernightman (button) collected ($0.25)



PokerStars Hand #222957437420:  Hold'em No Limit ($0.05/$0.10 USD) - 2021/01/23 10:41:47 ET
Table 'Bohlinia III' 6-max Seat #1 is the button
Seat 1: dante192 ($14.11 in chips) 
Seat 2: ojeriza ($10 in chips) 
Seat 3: supernightman ($12.22 in chips) 
ojeriza: posts small blind $0.05
supernightman: posts big blind $0.10
attila436: sits out 
19ElGringo91: sits out 
*** HOLE CARDS ***
dante192: raises $0.15 to $0.25
ojeriza: folds 
supernightman: calls $0.15
*** FLOP *** [8s Qd Ad]
supernightman: checks 
dante192: bets $0.27
supernightman: calls $0.27
*** TURN *** [8s Qd Ad] [6h]
supernightman: checks 
dante192: checks 
*** RIVER *** [8s Qd Ad 6h] [8h]
supernightman: checks 
dante192: bets $0.80
supernightman: folds 
Uncalled bet ($0.80) returned to dante192
dante192 collected $1.04 from pot
dante192: doesn't show hand 
*** SUMMARY ***
Total pot $1.09 | Rake $0.05 
Board [8s Qd Ad 6h 8h]
Seat 1: dante192 (button) collected ($1.04)
Seat 2: ojeriza (small blind) folded before Flop
Seat 3: supernightman (big blind) folded on the River



PokerStars Hand #222957469127:  Hold'em No Limit ($0.05/$0.10 USD) - 2021/01/23 10:42:45 ET
Table 'Bohlinia III' 6-max Seat #2 is the button
Seat 1: dante192 ($14.63 in chips) 
Seat 2: ojeriza ($10 in chips) 
Seat 3: supernightman ($11.70 in chips) 
Seat 4: attila436 ($3.90 in chips) 
supernightman: posts small blind $0.05
attila436: posts big blind $0.10
19ElGringo91: sits out 
*** HOLE CARDS ***
dante192: folds 
ojeriza: folds 
supernightman: folds 
Uncalled bet ($0.05) returned to attila436
attila436 collected $0.10 from pot
attila436: doesn't show hand 
*** SUMMARY ***
Total pot $0.10 | Rake $0 
Seat 1: dante192 folded before Flop (didn't bet)
Seat 2: ojeriza (button) folded before Flop (didn't bet)
Seat 3: supernightman (small blind) folded before Flop
Seat 4: attila436 (big blind) collected ($0.10)



PokerStars Hand #222957489142:  Hold'em No Limit ($0.05/$0.10 USD) - 2021/01/23 10:43:21 ET
Table 'Bohlinia III' 6-max Seat #3 is the button
Seat 1: dante192 ($14.63 in chips) 
Seat 2: ojeriza ($10 in chips) 
Seat 3: supernightman ($11.65 in chips) 
Seat 4: attila436 ($3.95 in chips) 
Seat 5: 19ElGringo91 ($10 in chips) 
attila436: posts small blind $0.05
19ElGringo91: posts big blind $0.10
*** HOLE CARDS ***
dante192: folds 
ojeriza: folds 
supernightman: raises $0.20 to $0.30
attila436 has timed out
attila436: folds 
19ElGringo91: calls $0.20
*** FLOP *** [Tc 4c 7h]
19ElGringo91: checks 
supernightman: bets $0.47
19ElGringo91: folds 
Uncalled bet ($0.47) returned to supernightman
supernightman collected $0.62 from pot
*** SUMMARY ***
Total pot $0.65 | Rake $0.03 
Board [Tc 4c 7h]
Seat 1: dante192 folded before Flop (didn't bet)
Seat 2: ojeriza folded before Flop (didn't bet)
Seat 3: supernightman (button) collected ($0.62)
Seat 4: attila436 (small blind) folded before Flop
Seat 5: 19ElGringo91 (big blind) folded on the Flop



PokerStars Hand #222957508717:  Hold'em No Limit ($0.05/$0.10 USD) - 2021/01/23 10:43:56 ET
Table 'Bohlinia III' 6-max Seat #4 is the button
Seat 1: dante192 ($14.63 in chips) 
Seat 2: ojeriza ($10 in chips) 
Seat 3: supernightman ($11.97 in chips) 
Seat 4: attila436 ($3.90 in chips) 
Seat 5: 19ElGringo91 ($10 in chips) 
Seat 6: xScarface ($8.87 in chips) 
19ElGringo91: posts small blind $0.05
xScarface: posts big blind $0.10
*** HOLE CARDS ***
dante192: folds 
ojeriza: folds 
supernightman: raises $0.20 to $0.30
attila436: calls $0.30
19ElGringo91: folds 
xScarface: folds 
*** FLOP *** [6c Js 6h]
supernightman: bets $0.36
attila436: calls $0.36
*** TURN *** [6c Js 6h] [Td]
supernightman: bets $1.05
attila436: folds 
Uncalled bet ($1.05) returned to supernightman
supernightman collected $1.40 from pot
*** SUMMARY ***
Total pot $1.47 | Rake $0.07 
Board [6c Js 6h Td]
Seat 1: dante192 folded before Flop (didn't bet)
Seat 2: ojeriza folded before Flop (didn't bet)
Seat 3: supernightman collected ($1.40)
Seat 4: attila436 (button) folded on the Turn
Seat 5: 19ElGringo91 (small blind) folded before Flop
Seat 6: xScarface (big blind) folded before Flop



PokerStars Hand #222957532779:  Hold'em No Limit ($0.05/$0.10 USD) - 2021/01/23 10:44:40 ET
Table 'Bohlinia III' 6-max Seat #5 is the button
Seat 1: dante192 ($14.63 in chips) 
Seat 2: ojeriza ($10 in chips) 
Seat 3: supernightman ($12.71 in chips) 
Seat 4: attila436 ($3.24 in chips) 
Seat 5: 19ElGringo91 ($10 in chips) 
Seat 6: xScarface ($8.77 in chips) 
xScarface: posts small blind $0.05
dante192: posts big blind $0.10
*** HOLE CARDS ***
ojeriza: folds 
supernightman: raises $0.20 to $0.30
attila436: calls $0.30
19ElGringo91: folds 
xScarface: folds 
dante192: calls $0.20
*** FLOP *** [3c 5d 2h]
dante192: checks 
supernightman: checks 
attila436: checks 
*** TURN *** [3c 5d 2h] [4d]
dante192: checks 
supernightman: bets $0.46
attila436: raises $0.46 to $0.92
dante192: folds 
supernightman: calls $0.46
*** RIVER *** [3c 5d 2h 4d] [3s]
supernightman: checks 
attila436: bets $1.33
supernightman: calls $1.33
*** SHOW DOWN ***
attila436: shows [9d 6d] (a straight, Deuce to Six)
supernightman: mucks hand 
attila436 collected $5.20 from pot
*** SUMMARY ***
Total pot $5.45 | Rake $0.25 
Board [3c 5d 2h 4d 3s]
Seat 1: dante192 (big blind) folded on the Turn
Seat 2: ojeriza folded before Flop (didn't bet)
Seat 3: supernightman mucked
Seat 4: attila436 showed [9d 6d] and won ($5.20) with a straight, Deuce to Six
Seat 5: 19ElGringo91 (button) folded before Flop (didn't bet)
Seat 6: xScarface (small blind) folded before Flop



PokerStars Hand #222957562416:  Hold'em No Limit ($0.05/$0.10 USD) - 2021/01/23 10:45:33 ET
Table 'Bohlinia III' 6-max Seat #6 is the button
Seat 1: dante192 ($14.33 in chips) 
Seat 2: ojeriza ($10 in chips) 
Seat 3: supernightman ($10.16 in chips) 
Seat 4: attila436 ($5.89 in chips) 
Seat 5: 19ElGringo91 ($10 in chips) 
Seat 6: xScarface ($8.72 in chips) 
dante192: posts small blind $0.05
ojeriza: posts big blind $0.10
*** HOLE CARDS ***
supernightman: folds 
supernightman leaves the table
attila436: calls $0.10
19ElGringo91: folds 
robotov joins the table at seat #3 
xScarface: calls $0.10
dante192: raises $0.40 to $0.50
ojeriza: folds 
attila436: calls $0.40
xScarface: folds 
*** FLOP *** [9c Ah 3c]
dante192: bets $0.58
attila436: folds 
Uncalled bet ($0.58) returned to dante192
dante192 collected $1.15 from pot
dante192: doesn't show hand 
*** SUMMARY ***
Total pot $1.20 | Rake $0.05 
Board [9c Ah 3c]
Seat 1: dante192 (small blind) collected ($1.15)
Seat 2: ojeriza (big blind) folded before Flop
Seat 3: supernightman folded before Flop (didn't bet)
Seat 4: attila436 folded on the Flop
Seat 5: 19ElGringo91 folded before Flop (didn't bet)
Seat 6: xScarface (button) folded before Flop



PokerStars Hand #222957581074:  Hold'em No Limit ($0.05/$0.10 USD) - 2021/01/23 10:46:06 ET
Table 'Bohlinia III' 6-max Seat #1 is the button
Seat 1: dante192 ($14.98 in chips) 
Seat 2: ojeriza ($10 in chips) 
Seat 3: robotov ($10 in chips) 
Seat 4: attila436 ($5.39 in chips) 
Seat 5: 19ElGringo91 ($10 in chips) 
Seat 6: xScarface ($8.62 in chips) 
ojeriza: posts small blind $0.05
robotov: posts big blind $0.10
*** HOLE CARDS ***
attila436: folds 
19ElGringo91: folds 
xScarface: calls $0.10
dante192: folds 
ojeriza: folds 
robotov: checks 
*** FLOP *** [7h 7c 3c]
robotov: checks 
xScarface: checks 
*** TURN *** [7h 7c 3c] [Ad]
robotov: bets $0.30
xScarface: folds 
Uncalled bet ($0.30) returned to robotov
robotov collected $0.24 from pot
robotov: doesn't show hand 
*** SUMMARY ***
Total pot $0.25 | Rake $0.01 
Board [7h 7c 3c Ad]
Seat 1: dante192 (button) folded before Flop (didn't bet)
Seat 2: ojeriza (small blind) folded before Flop
Seat 3: robotov (big blind) collected ($0.24)
Seat 4: attila436 folded before Flop (didn't bet)
Seat 5: 19ElGringo91 folded before Flop (didn't bet)
Seat 6: xScarface folded on the Turn



PokerStars Hand #222957612204:  Hold'em No Limit ($0.05/$0.10 USD) - 2021/01/23 10:47:02 ET
Table 'Bohlinia III' 6-max Seat #2 is the button
Seat 1: dante192 ($14.98 in chips) 
Seat 2: ojeriza ($10 in chips) 
Seat 3: robotov ($10.14 in chips) 
Seat 4: attila436 ($5.39 in chips) 
Seat 5: 19ElGringo91 ($10 in chips) 
Seat 6: xScarface ($8.52 in chips) 
robotov: posts small blind $0.05
attila436: posts big blind $0.10
*** HOLE CARDS ***
19ElGringo91: folds 
xScarface: raises $0.10 to $0.20
dante192: folds 
ojeriza: folds 
robotov: folds 
attila436: calls $0.10
*** FLOP *** [Qd Qs 4d]
attila436: checks 
xScarface: checks 
*** TURN *** [Qd Qs 4d] [7s]
attila436: checks 
xScarface: checks 
*** RIVER *** [Qd Qs 4d 7s] [7d]
attila436: checks 
xScarface: bets $0.43
attila436: folds 
Uncalled bet ($0.43) returned to xScarface
xScarface collected $0.43 from pot
xScarface: doesn't show hand 
*** SUMMARY ***
Total pot $0.45 | Rake $0.02 
Board [Qd Qs 4d 7s 7d]
Seat 1: dante192 folded before Flop (didn't bet)
Seat 2: ojeriza (button) folded before Flop (didn't bet)
Seat 3: robotov (small blind) folded before Flop
Seat 4: attila436 (big blind) folded on the River
Seat 5: 19ElGringo91 folded before Flop (didn't bet)
Seat 6: xScarface collected ($0.43)



PokerStars Hand #222957637306:  Hold'em No Limit ($0.05/$0.10 USD) - 2021/01/23 10:47:47 ET
Table 'Bohlinia III' 6-max Seat #3 is the button
Seat 1: dante192 ($14.98 in chips) 
Seat 2: ojeriza ($10 in chips) 
Seat 3: robotov ($10.09 in chips) 
Seat 4: attila436 ($5.19 in chips) 
Seat 5: 19ElGringo91 ($10 in chips) 
Seat 6: xScarface ($8.75 in chips) 
attila436: posts small blind $0.05
19ElGringo91: posts big blind $0.10
*** HOLE CARDS ***
xScarface: folds 
dante192: raises $0.20 to $0.30
ojeriza: folds 
robotov: folds 
attila436: folds 
19ElGringo91: folds 
Uncalled bet ($0.20) returned to dante192
dante192 collected $0.25 from pot
dante192: doesn't show hand 
*** SUMMARY ***
Total pot $0.25 | Rake $0 
Seat 1: dante192 collected ($0.25)
Seat 2: ojeriza folded before Flop (didn't bet)
Seat 3: robotov (button) folded before Flop (didn't bet)
Seat 4: attila436 (small blind) folded before Flop
Seat 5: 19ElGringo91 (big blind) folded before Flop
Seat 6: xScarface folded before Flop (didn't bet)



PokerStars Hand #222957646565:  Hold'em No Limit ($0.05/$0.10 USD) - 2021/01/23 10:48:04 ET
Table 'Bohlinia III' 6-max Seat #4 is the button
Seat 1: dante192 ($15.13 in chips) 
Seat 2: ojeriza ($10 in chips) 
Seat 3: robotov ($10.09 in chips) 
Seat 4: attila436 ($5.14 in chips) 
Seat 5: 19ElGringo91 ($10 in chips) 
Seat 6: xScarface ($8.75 in chips) 
19ElGringo91: posts small blind $0.05
xScarface: posts big blind $0.10
*** HOLE CARDS ***
dante192: raises $0.20 to $0.30
ojeriza: folds 
robotov: folds 
attila436: calls $0.30
19ElGringo91: folds 
xScarface: folds 
*** FLOP *** [Qs 5d Jd]
dante192: bets $0.54
attila436: folds 
Uncalled bet ($0.54) returned to dante192
dante192 collected $0.72 from pot
dante192: doesn't show hand 
*** SUMMARY ***
Total pot $0.75 | Rake $0.03 
Board [Qs 5d Jd]
Seat 1: dante192 collected ($0.72)
Seat 2: ojeriza folded before Flop (didn't bet)
Seat 3: robotov folded before Flop (didn't bet)
Seat 4: attila436 (button) folded on the Flop
Seat 5: 19ElGringo91 (small blind) folded before Flop
Seat 6: xScarface (big blind) folded before Flop



PokerStars Hand #222957669837:  Hold'em No Limit ($0.05/$0.10 USD) - 2021/01/23 10:48:46 ET
Table 'Bohlinia III' 6-max Seat #5 is the button
Seat 1: dante192 ($15.55 in chips) 
Seat 2: ojeriza ($10 in chips) 
Seat 3: robotov ($10.09 in chips) 
Seat 4: attila436 ($4.84 in chips) 
Seat 5: 19ElGringo91 ($10 in chips) 
Seat 6: xScarface ($8.65 in chips) 
xScarface: posts small blind $0.05
dante192: posts big blind $0.10
*** HOLE CARDS ***
ojeriza: folds 
robotov: folds 
attila436: calls $0.10
19ElGringo91: folds 
xScarface: folds 
dante192: checks 
*** FLOP *** [Td 4c 6h]
dante192: checks 
attila436: checks 
*** TURN *** [Td 4c 6h] [Ad]
dante192: checks 
attila436: checks 
*** RIVER *** [Td 4c 6h Ad] [Qs]
dante192: checks 
attila436: checks 
*** SHOW DOWN ***
dante192: shows [3d 2h] (high card Ace)
attila436: shows [Jh 9s] (high card Ace - Queen+Jack kicker)
attila436 collected $0.24 from pot
*** SUMMARY ***
Total pot $0.25 | Rake $0.01 
Board [Td 4c 6h Ad Qs]
Seat 1: dante192 (big blind) showed [3d 2h] and lost with high card Ace
Seat 2: ojeriza folded before Flop (didn't bet)
Seat 3: robotov folded before Flop (didn't bet)
Seat 4: attila436 showed [Jh 9s] and won ($0.24) with high card Ace
Seat 5: 19ElGringo91 (button) folded before Flop (didn't bet)
Seat 6: xScarface (small blind) folded before Flop



PokerStars Hand #222957688648:  Hold'em No Limit ($0.05/$0.10 USD) - 2021/01/23 10:49:20 ET
Table 'Bohlinia III' 6-max Seat #6 is the button
Seat 1: dante192 ($15.45 in chips) 
Seat 2: ojeriza ($10 in chips) 
Seat 3: robotov ($10.09 in chips) 
Seat 4: attila436 ($4.98 in chips) 
Seat 5: 19ElGringo91 ($10 in chips) 
Seat 6: xScarface ($8.60 in chips) 
dante192: posts small blind $0.05
ojeriza: posts big blind $0.10
*** HOLE CARDS ***
robotov: raises $0.20 to $0.30
attila436: calls $0.30
19ElGringo91: folds 
xScarface: folds 
dante192: folds 
ojeriza: calls $0.20
*** FLOP *** [Th Ad 2c]
ojeriza: checks 
robotov: bets $0.60
attila436: calls $0.60
ojeriza: folds 
*** TURN *** [Th Ad 2c] [4d]
robotov: bets $1.35
attila436: folds 
Uncalled bet ($1.35) returned to robotov
robotov collected $2.05 from pot
robotov: doesn't show hand 
*** SUMMARY ***
Total pot $2.15 | Rake $0.10 
Board [Th Ad 2c 4d]
Seat 1: dante192 (small blind) folded before Flop
Seat 2: ojeriza (big blind) folded on the Flop
Seat 3: robotov collected ($2.05)
Seat 4: attila436 folded on the Turn
Seat 5: 19ElGringo91 folded before Flop (didn't bet)
Seat 6: xScarface (button) folded before Flop (didn't bet)



PokerStars Hand #222957724260:  Hold'em No Limit ($0.05/$0.10 USD) - 2021/01/23 10:50:23 ET
Table 'Bohlinia III' 6-max Seat #1 is the button
Seat 1: dante192 ($15.40 in chips) 
Seat 2: ojeriza ($10 in chips) 
Seat 3: robotov ($11.24 in chips) 
Seat 4: attila436 ($4.08 in chips) 
Seat 5: 19ElGringo91 ($10 in chips) 
Seat 6: xScarface ($8.60 in chips) 
ojeriza: posts small blind $0.05
robotov: posts big blind $0.10
*** HOLE CARDS ***
attila436: raises $0.10 to $0.20
19ElGringo91: folds 
xScarface: folds 
dante192: folds 
ojeriza: raises $0.60 to $0.80
robotov: folds 
attila436: calls $0.60
*** FLOP *** [Qh 4s Tc]
ojeriza: bets $0.87
attila436: folds 
Uncalled bet ($0.87) returned to ojeriza
ojeriza collected $1.62 from pot
ojeriza: doesn't show hand 
*** SUMMARY ***
Total pot $1.70 | Rake $0.08 
Board [Qh 4s Tc]
Seat 1: dante192 (button) folded before Flop (didn't bet)
Seat 2: ojeriza (small blind) collected ($1.62)
Seat 3: robotov (big blind) folded before Flop
Seat 4: attila436 folded on the Flop
Seat 5: 19ElGringo91 folded before Flop (didn't bet)
Seat 6: xScarface folded before Flop (didn't bet)



PokerStars Hand #222957742764:  Hold'em No Limit ($0.05/$0.10 USD) - 2021/01/23 10:50:57 ET
Table 'Bohlinia III' 6-max Seat #2 is the button
Seat 1: dante192 ($15.40 in chips) 
Seat 2: ojeriza ($10.82 in chips) 
Seat 3: robotov ($11.14 in chips) 
Seat 4: attila436 ($3.28 in chips) 
Seat 5: 19ElGringo91 ($10 in chips) 
Seat 6: xScarface ($8.60 in chips) 
robotov: posts small blind $0.05
attila436: posts big blind $0.10
*** HOLE CARDS ***
19ElGringo91: folds 
xScarface: folds 
dante192: raises $0.15 to $0.25
ojeriza: folds 
robotov: folds 
attila436: calls $0.15
*** FLOP *** [4s 9s Qd]
attila436: checks 
dante192: checks 
*** TURN *** [4s 9s Qd] [Js]
attila436: bets $0.53
dante192: folds 
Uncalled bet ($0.53) returned to attila436
attila436 collected $0.53 from pot
attila436: doesn't show hand 
*** SUMMARY ***
Total pot $0.55 | Rake $0.02 
Board [4s 9s Qd Js]
Seat 1: dante192 folded on the Turn
Seat 2: ojeriza (button) folded before Flop (didn't bet)
Seat 3: robotov (small blind) folded before Flop
Seat 4: attila436 (big blind) collected ($0.53)
Seat 5: 19ElGringo91 folded before Flop (didn't bet)
Seat 6: xScarface folded before Flop (didn't bet)



PokerStars Hand #222957766715:  Hold'em No Limit ($0.05/$0.10 USD) - 2021/01/23 10:51:40 ET
Table 'Bohlinia III' 6-max Seat #3 is the button
Seat 1: dante192 ($15.15 in chips) 
Seat 2: ojeriza ($10.82 in chips) 
Seat 3: robotov ($11.09 in chips) 
Seat 4: attila436 ($3.56 in chips) 
Seat 5: 19ElGringo91 ($10 in chips) 
Seat 6: xScarface ($8.60 in chips) 
attila436: posts small blind $0.05
19ElGringo91: posts big blind $0.10
*** HOLE CARDS ***
xScarface: folds 
dante192: folds 
ojeriza: raises $0.18 to $0.28
robotov: raises $0.67 to $0.95
attila436: raises $0.67 to $1.62
19ElGringo91: folds 
ojeriza: folds 
robotov: calls $0.67
*** FLOP *** [6d 8d Jc]
attila436: checks 
robotov: bets $2.70
attila436: calls $1.94 and is all-in
Uncalled bet ($0.76) returned to robotov
*** TURN *** [6d 8d Jc] [Kh]
*** RIVER *** [6d 8d Jc Kh] [Ad]
*** SHOW DOWN ***
attila436: shows [Ah Qc] (a pair of Aces)
robotov: shows [5c 6c] (a pair of Sixes)
attila436 cashed out the hand for $1.79 | Cash Out Fee $0.02
*** SUMMARY ***
Total pot $7.50 | Rake $0.34 
Board [6d 8d Jc Kh Ad]
Seat 1: dante192 folded before Flop (didn't bet)
Seat 2: ojeriza folded before Flop
Seat 3: robotov (button) showed [5c 6c] and lost with a pair of Sixes
Seat 4: attila436 (small blind) showed [Ah Qc] and won ($7.16) with a pair of Aces (pot not awarded as player cashed out)
Seat 5: 19ElGringo91 (big blind) folded before Flop
Seat 6: xScarface folded before Flop (didn't bet)



PokerStars Hand #222957800280:  Hold'em No Limit ($0.05/$0.10 USD) - 2021/01/23 10:52:41 ET
Table 'Bohlinia III' 6-max Seat #4 is the button
Seat 1: dante192 ($15.15 in chips) 
Seat 2: ojeriza ($10.54 in chips) 
Seat 3: robotov ($10 in chips) 
Seat 4: attila436 ($1.79 in chips) 
Seat 5: 19ElGringo91 ($10 in chips) 
Seat 6: xScarface ($8.60 in chips) 
19ElGringo91: posts small blind $0.05
xScarface: posts big blind $0.10
*** HOLE CARDS ***
dante192: folds 
ojeriza: folds 
robotov: folds 
attila436: calls $0.10
19ElGringo91: folds 
xScarface: checks 
*** FLOP *** [Tc 9s 9c]
xScarface: checks 
attila436: checks 
*** TURN *** [Tc 9s 9c] [Ac]
xScarface: checks 
attila436: checks 
*** RIVER *** [Tc 9s 9c Ac] [2h]
xScarface: checks 
attila436: checks 
*** SHOW DOWN ***
xScarface: shows [5d 6s] (a pair of Nines)
attila436: shows [Qc 8d] (a pair of Nines - Ace+Queen kicker)
attila436 collected $0.24 from pot
*** SUMMARY ***
Total pot $0.25 | Rake $0.01 
Board [Tc 9s 9c Ac 2h]
Seat 1: dante192 folded before Flop (didn't bet)
Seat 2: ojeriza folded before Flop (didn't bet)
Seat 3: robotov folded before Flop (didn't bet)
Seat 4: attila436 (button) showed [Qc 8d] and won ($0.24) with a pair of Nines
Seat 5: 19ElGringo91 (small blind) folded before Flop
Seat 6: xScarface (big blind) showed [5d 6s] and lost with a pair of Nines



PokerStars Hand #222957820068:  Hold'em No Limit ($0.05/$0.10 USD) - 2021/01/23 10:53:17 ET
Table 'Bohlinia III' 6-max Seat #5 is the button
Seat 1: dante192 ($15.15 in chips) 
Seat 2: ojeriza ($10.54 in chips) 
Seat 3: robotov ($10 in chips) 
Seat 4: attila436 ($1.93 in chips) 
Seat 5: 19ElGringo91 ($10 in chips) 
Seat 6: xScarface ($8.50 in chips) 
xScarface: posts small blind $0.05
dante192: posts big blind $0.10
*** HOLE CARDS ***
ojeriza: folds 
robotov: folds 
attila436: calls $0.10
19ElGringo91: raises $0.40 to $0.50
xScarface: folds 
dante192: calls $0.40
attila436: calls $0.40
*** FLOP *** [Kh Ts 7c]
dante192: checks 
attila436: checks 
19ElGringo91: bets $0.77
dante192: calls $0.77
attila436: folds 
*** TURN *** [Kh Ts 7c] [5h]
dante192: checks 
19ElGringo91: checks 
*** RIVER *** [Kh Ts 7c 5h] [5s]
dante192: bets $1.80
19ElGringo91: folds 
Uncalled bet ($1.80) returned to dante192
dante192 collected $2.95 from pot
dante192: doesn't show hand 
*** SUMMARY ***
Total pot $3.09 | Rake $0.14 
Board [Kh Ts 7c 5h 5s]
Seat 1: dante192 (big blind) collected ($2.95)
Seat 2: ojeriza folded before Flop (didn't bet)
Seat 3: robotov folded before Flop (didn't bet)
Seat 4: attila436 folded on the Flop
Seat 5: 19ElGringo91 (button) folded on the River
Seat 6: xScarface (small blind) folded before Flop



PokerStars Hand #222957864655:  Hold'em No Limit ($0.05/$0.10 USD) - 2021/01/23 10:54:39 ET
Table 'Bohlinia III' 6-max Seat #6 is the button
Seat 1: dante192 ($16.83 in chips) 
Seat 2: ojeriza ($10.54 in chips) 
Seat 3: robotov ($10 in chips) 
Seat 4: attila436 ($5.68 in chips) 
Seat 5: 19ElGringo91 ($10 in chips) 
Seat 6: xScarface ($8.45 in chips) 
dante192: posts small blind $0.05
ojeriza: posts big blind $0.10
*** HOLE CARDS ***
robotov: folds 
attila436: calls $0.10
19ElGringo91: folds 
xScarface: raises $0.10 to $0.20
dante192: folds 
ojeriza: calls $0.10
attila436: calls $0.10
*** FLOP *** [7c 8s 9d]
ojeriza: checks 
attila436: checks 
xScarface: checks 
*** TURN *** [7c 8s 9d] [7h]
ojeriza: bets $0.46
attila436: calls $0.46
xScarface: calls $0.46
*** RIVER *** [7c 8s 9d 7h] [5d]
ojeriza: checks 
attila436: checks 
xScarface: checks 
*** SHOW DOWN ***
ojeriza: shows [9c Kc] (two pair, Nines and Sevens)
attila436: mucks hand 
xScarface: mucks hand 
ojeriza collected $1.94 from pot
*** SUMMARY ***
Total pot $2.03 | Rake $0.09 
Board [7c 8s 9d 7h 5d]
Seat 1: dante192 (small blind) folded before Flop
Seat 2: ojeriza (big blind) showed [9c Kc] and won ($1.94) with two pair, Nines and Sevens
Seat 3: robotov folded before Flop (didn't bet)
Seat 4: attila436 mucked
Seat 5: 19ElGringo91 folded before Flop (didn't bet)
Seat 6: xScarface (button) mucked



PokerStars Hand #222957887967:  Hold'em No Limit ($0.05/$0.10 USD) - 2021/01/23 10:55:25 ET
Table 'Bohlinia III' 6-max Seat #1 is the button
Seat 1: dante192 ($16.78 in chips) 
Seat 2: ojeriza ($11.82 in chips) 
Seat 3: robotov ($10 in chips) 
Seat 4: attila436 ($5.02 in chips) 
Seat 5: 19ElGringo91 ($10 in chips) 
Seat 6: xScarface ($7.79 in chips) 
ojeriza: posts small blind $0.05
robotov: posts big blind $0.10
*** HOLE CARDS ***
attila436: calls $0.10
19ElGringo91: folds 
xScarface: folds 
dante192: folds 
ojeriza: folds 
robotov: checks 
*** FLOP *** [6d Ad 5h]
robotov: checks 
attila436: bets $0.10
robotov: folds 
Uncalled bet ($0.10) returned to attila436
attila436 collected $0.24 from pot
attila436: doesn't show hand 
*** SUMMARY ***
Total pot $0.25 | Rake $0.01 
Board [6d Ad 5h]
Seat 1: dante192 (button) folded before Flop (didn't bet)
Seat 2: ojeriza (small blind) folded before Flop
Seat 3: robotov (big blind) folded on the Flop
Seat 4: attila436 collected ($0.24)
Seat 5: 19ElGringo91 folded before Flop (didn't bet)
Seat 6: xScarface folded before Flop (didn't bet)



PokerStars Hand #222957896422:  Hold'em No Limit ($0.05/$0.10 USD) - 2021/01/23 10:55:44 ET
Table 'Bohlinia III' 6-max Seat #2 is the button
Seat 1: dante192 ($16.78 in chips) 
Seat 2: ojeriza ($11.77 in chips) 
Seat 3: robotov ($10 in chips) 
Seat 4: attila436 ($5.16 in chips) 
Seat 5: 19ElGringo91 ($10 in chips) 
Seat 6: xScarface ($7.79 in chips) 
robotov: posts small blind $0.05
attila436: posts big blind $0.10
*** HOLE CARDS ***
19ElGringo91: folds 
xScarface: raises $0.10 to $0.20
dante192: folds 
ojeriza: folds 
robotov: folds 
attila436: calls $0.10
*** FLOP *** [2h 2c 8c]
attila436: checks 
xScarface: bets $0.22
attila436: folds 
Uncalled bet ($0.22) returned to xScarface
xScarface collected $0.43 from pot
xScarface: doesn't show hand 
*** SUMMARY ***
Total pot $0.45 | Rake $0.02 
Board [2h 2c 8c]
Seat 1: dante192 folded before Flop (didn't bet)
Seat 2: ojeriza (button) folded before Flop (didn't bet)
Seat 3: robotov (small blind) folded before Flop
Seat 4: attila436 (big blind) folded on the Flop
Seat 5: 19ElGringo91 folded before Flop (didn't bet)
Seat 6: xScarface collected ($0.43)



PokerStars Hand #222957916424:  Hold'em No Limit ($0.05/$0.10 USD) - 2021/01/23 10:56:30 ET
Table 'Bohlinia III' 6-max Seat #3 is the button
Seat 1: dante192 ($16.78 in chips) 
Seat 2: ojeriza ($11.77 in chips) 
Seat 3: robotov ($10 in chips) 
Seat 4: attila436 ($4.96 in chips) 
Seat 5: 19ElGringo91 ($10 in chips) 
Seat 6: xScarface ($8.02 in chips) 
attila436: posts small blind $0.05
19ElGringo91: posts big blind $0.10
*** HOLE CARDS ***
xScarface: folds 
dante192: folds 
ojeriza: folds 
robotov: folds 
attila436: calls $0.05
19ElGringo91: checks 
*** FLOP *** [9h 3h Kh]
attila436: checks 
19ElGringo91: checks 
*** TURN *** [9h 3h Kh] [7c]
attila436: checks 
19ElGringo91: checks 
*** RIVER *** [9h 3h Kh 7c] [Jc]
attila436: checks 
19ElGringo91: checks 
*** SHOW DOWN ***
attila436: shows [4d 6d] (high card King)
19ElGringo91: shows [3s Ad] (a pair of Threes)
19ElGringo91 collected $0.19 from pot
*** SUMMARY ***
Total pot $0.20 | Rake $0.01 
Board [9h 3h Kh 7c Jc]
Seat 1: dante192 folded before Flop (didn't bet)
Seat 2: ojeriza folded before Flop (didn't bet)
Seat 3: robotov (button) folded before Flop (didn't bet)
Seat 4: attila436 (small blind) showed [4d 6d] and lost with high card King
Seat 5: 19ElGringo91 (big blind) showed [3s Ad] and won ($0.19) with a pair of Threes
Seat 6: xScarface folded before Flop (didn't bet)



PokerStars Hand #222957932140:  Hold'em No Limit ($0.05/$0.10 USD) - 2021/01/23 10:57:06 ET
Table 'Bohlinia III' 6-max Seat #4 is the button
Seat 1: dante192 ($16.78 in chips) 
Seat 2: ojeriza ($11.77 in chips) 
Seat 3: robotov ($10 in chips) 
Seat 4: attila436 ($4.86 in chips) 
Seat 5: 19ElGringo91 ($10.09 in chips) 
Seat 6: xScarface ($8.02 in chips) 
19ElGringo91: posts small blind $0.05
xScarface: posts big blind $0.10
*** HOLE CARDS ***
dante192: folds 
ojeriza: raises $0.20 to $0.30
robotov: folds 
attila436: calls $0.30
19ElGringo91: folds 
xScarface: calls $0.20
*** FLOP *** [Qs 6c 7c]
xScarface: checks 
ojeriza: checks 
attila436: bets $0.46
xScarface: calls $0.46
ojeriza: folds 
*** TURN *** [Qs 6c 7c] [5s]
xScarface: checks 
attila436: checks 
*** RIVER *** [Qs 6c 7c 5s] [Th]
xScarface: bets $1.79
attila436: calls $1.79
*** SHOW DOWN ***
xScarface: shows [6d 6h] (three of a kind, Sixes)
attila436: mucks hand 
xScarface collected $5.20 from pot
*** SUMMARY ***
Total pot $5.45 | Rake $0.25 
Board [Qs 6c 7c 5s Th]
Seat 1: dante192 folded before Flop (didn't bet)
Seat 2: ojeriza folded on the Flop
Seat 3: robotov folded before Flop (didn't bet)
Seat 4: attila436 (button) mucked
Seat 5: 19ElGringo91 (small blind) folded before Flop
Seat 6: xScarface (big blind) showed [6d 6h] and won ($5.20) with three of a kind, Sixes



PokerStars Hand #222957962730:  Hold'em No Limit ($0.05/$0.10 USD) - 2021/01/23 10:58:15 ET
Table 'Bohlinia III' 6-max Seat #5 is the button
Seat 1: dante192 ($16.78 in chips) 
Seat 2: ojeriza ($11.47 in chips) 
Seat 3: robotov ($10 in chips) 
Seat 4: attila436 ($2.31 in chips) 
Seat 5: 19ElGringo91 ($10.04 in chips) 
Seat 6: xScarface ($10.67 in chips) 
xScarface: posts small blind $0.05
dante192: posts big blind $0.10
*** HOLE CARDS ***
ojeriza: folds 
robotov: folds 
attila436: folds 
19ElGringo91: folds 
xScarface: raises $0.20 to $0.30
dante192: folds 
Uncalled bet ($0.20) returned to xScarface
xScarface collected $0.20 from pot
xScarface: doesn't show hand 
*** SUMMARY ***
Total pot $0.20 | Rake $0 
Seat 1: dante192 (big blind) folded before Flop
Seat 2: ojeriza folded before Flop (didn't bet)
Seat 3: robotov folded before Flop (didn't bet)
Seat 4: attila436 folded before Flop (didn't bet)
Seat 5: 19ElGringo91 (button) folded before Flop (didn't bet)
Seat 6: xScarface (small blind) collected ($0.20)



PokerStars Hand #222957972076:  Hold'em No Limit ($0.05/$0.10 USD) - 2021/01/23 10:58:37 ET
Table 'Bohlinia III' 6-max Seat #6 is the button
Seat 1: dante192 ($16.68 in chips) 
Seat 2: ojeriza ($11.47 in chips) 
Seat 3: robotov ($10 in chips) 
Seat 4: attila436 ($2.31 in chips) 
Seat 5: 19ElGringo91 ($10.04 in chips) 
Seat 6: xScarface ($10.77 in chips) 
dante192: posts small blind $0.05
ojeriza: posts big blind $0.10
*** HOLE CARDS ***
robotov: folds 
attila436: raises $2.21 to $2.31 and is all-in
19ElGringo91: folds 
xScarface has timed out
xScarface: folds 
dante192: folds 
ojeriza: folds 
Uncalled bet ($2.21) returned to attila436
attila436 collected $0.25 from pot
attila436: doesn't show hand 
*** SUMMARY ***
Total pot $0.25 | Rake $0 
Seat 1: dante192 (small blind) folded before Flop
Seat 2: ojeriza (big blind) folded before Flop
Seat 3: robotov folded before Flop (didn't bet)
Seat 4: attila436 collected ($0.25)
Seat 5: 19ElGringo91 folded before Flop (didn't bet)
Seat 6: xScarface (button) folded before Flop (didn't bet)



PokerStars Hand #222957989290:  Hold'em No Limit ($0.05/$0.10 USD) - 2021/01/23 10:59:14 ET
Table 'Bohlinia III' 6-max Seat #1 is the button
Seat 1: dante192 ($16.63 in chips) 
Seat 2: ojeriza ($11.37 in chips) 
Seat 3: robotov ($10 in chips) 
Seat 4: attila436 ($2.46 in chips) 
Seat 5: 19ElGringo91 ($10.04 in chips) 
Seat 6: xScarface ($10.77 in chips) 
ojeriza: posts small blind $0.05
robotov: posts big blind $0.10
*** HOLE CARDS ***
attila436: calls $0.10
19ElGringo91: folds 
xScarface: folds 
dante192: raises $0.30 to $0.40
ojeriza: folds 
robotov: folds 
attila436: calls $0.30
*** FLOP *** [6c Qh 2c]
attila436: checks 
dante192: bets $0.46
attila436: folds 
Uncalled bet ($0.46) returned to dante192
dante192 collected $0.91 from pot
dante192: doesn't show hand 
*** SUMMARY ***
Total pot $0.95 | Rake $0.04 
Board [6c Qh 2c]
Seat 1: dante192 (button) collected ($0.91)
Seat 2: ojeriza (small blind) folded before Flop
Seat 3: robotov (big blind) folded before Flop
Seat 4: attila436 folded on the Flop
Seat 5: 19ElGringo91 folded before Flop (didn't bet)
Seat 6: xScarface folded before Flop (didn't bet)



PokerStars Hand #222958004617:  Hold'em No Limit ($0.05/$0.10 USD) - 2021/01/23 10:59:48 ET
Table 'Bohlinia III' 6-max Seat #2 is the button
Seat 1: dante192 ($17.14 in chips) 
Seat 2: ojeriza ($11.32 in chips) 
Seat 3: robotov ($10 in chips) 
Seat 4: attila436 ($2.06 in chips) 
Seat 5: 19ElGringo91 ($10.04 in chips) 
Seat 6: xScarface ($10.77 in chips) 
robotov: posts small blind $0.05
attila436: posts big blind $0.10
*** HOLE CARDS ***
19ElGringo91: folds 
xScarface: calls $0.10
dante192: folds 
ojeriza: folds 
robotov: folds 
attila436: checks 
*** FLOP *** [2c Th 8h]
attila436: checks 
xScarface: checks 
*** TURN *** [2c Th 8h] [7d]
attila436: checks 
xScarface: checks 
*** RIVER *** [2c Th 8h 7d] [9c]
attila436: bets $0.24
xScarface: folds 
Uncalled bet ($0.24) returned to attila436
attila436 collected $0.24 from pot
attila436: doesn't show hand 
*** SUMMARY ***
Total pot $0.25 | Rake $0.01 
Board [2c Th 8h 7d 9c]
Seat 1: dante192 folded before Flop (didn't bet)
Seat 2: ojeriza (button) folded before Flop (didn't bet)
Seat 3: robotov (small blind) folded before Flop
Seat 4: attila436 (big blind) collected ($0.24)
Seat 5: 19ElGringo91 folded before Flop (didn't bet)
Seat 6: xScarface folded on the River



PokerStars Hand #222958027925:  Hold'em No Limit ($0.05/$0.10 USD) - 2021/01/23 11:00:39 ET
Table 'Bohlinia III' 6-max Seat #3 is the button
Seat 1: dante192 ($17.14 in chips) 
Seat 2: ojeriza ($11.32 in chips) 
Seat 3: robotov ($10 in chips) 
Seat 4: attila436 ($2.20 in chips) 
Seat 5: 19ElGringo91 ($10.04 in chips) 
Seat 6: xScarface ($10.67 in chips) 
attila436: posts small blind $0.05
19ElGringo91: posts big blind $0.10
*** HOLE CARDS ***
xScarface: raises $0.25 to $0.35
dante192 has timed out
dante192: folds 
ojeriza: folds 
robotov: folds 
attila436: folds 
19ElGringo91: folds 
Uncalled bet ($0.25) returned to xScarface
xScarface collected $0.25 from pot
xScarface: doesn't show hand 
*** SUMMARY ***
Total pot $0.25 | Rake $0 
Seat 1: dante192 folded before Flop (didn't bet)
Seat 2: ojeriza folded before Flop (didn't bet)
Seat 3: robotov (button) folded before Flop (didn't bet)
Seat 4: attila436 (small blind) folded before Flop
Seat 5: 19ElGringo91 (big blind) folded before Flop
Seat 6: xScarface collected ($0.25)



PokerStars Hand #222958042971:  Hold'em No Limit ($0.05/$0.10 USD) - 2021/01/23 11:01:10 ET
Table 'Bohlinia III' 6-max Seat #4 is the button
Seat 2: ojeriza ($11.32 in chips) 
Seat 3: robotov ($10 in chips) 
Seat 4: attila436 ($2.15 in chips) 
Seat 5: 19ElGringo91 ($10 in chips) 
Seat 6: xScarface ($10.82 in chips) 
19ElGringo91: posts small blind $0.05
xScarface: posts big blind $0.10
*** HOLE CARDS ***
ojeriza: folds 
robotov: folds 
attila436: calls $0.10
19ElGringo91: folds 
xScarface: checks 
*** FLOP *** [Td Ks 9h]
xScarface: checks 
attila436: checks 
*** TURN *** [Td Ks 9h] [Qc]
xScarface: checks 
attila436: checks 
*** RIVER *** [Td Ks 9h Qc] [6c]
xScarface: checks 
attila436: bets $0.24
xScarface: folds 
Uncalled bet ($0.24) returned to attila436
attila436 collected $0.24 from pot
attila436: doesn't show hand 
*** SUMMARY ***
Total pot $0.25 | Rake $0.01 
Board [Td Ks 9h Qc 6c]
Seat 2: ojeriza folded before Flop (didn't bet)
Seat 3: robotov folded before Flop (didn't bet)
Seat 4: attila436 (button) collected ($0.24)
Seat 5: 19ElGringo91 (small blind) folded before Flop
Seat 6: xScarface (big blind) folded on the River



PokerStars Hand #222958061073:  Hold'em No Limit ($0.05/$0.10 USD) - 2021/01/23 11:01:44 ET
Table 'Bohlinia III' 6-max Seat #5 is the button
Seat 1: dante192 ($17.14 in chips) 
Seat 2: ojeriza ($11.32 in chips) 
Seat 3: robotov ($10 in chips) 
Seat 4: attila436 ($2.29 in chips) 
Seat 5: 19ElGringo91 ($10 in chips) 
Seat 6: xScarface ($10.72 in chips) 
xScarface: posts small blind $0.05
dante192: posts big blind $0.10
*** HOLE CARDS ***
ojeriza: folds 
robotov: folds 
attila436: folds 
19ElGringo91: folds 
xScarface: calls $0.05
dante192: raises $0.30 to $0.40
xScarface: folds 
Uncalled bet ($0.30) returned to dante192
dante192 collected $0.20 from pot
dante192: doesn't show hand 
*** SUMMARY ***
Total pot $0.20 | Rake $0 
Seat 1: dante192 (big blind) collected ($0.20)
Seat 2: ojeriza folded before Flop (didn't bet)
Seat 3: robotov folded before Flop (didn't bet)
Seat 4: attila436 folded before Flop (didn't bet)
Seat 5: 19ElGringo91 (button) folded before Flop (didn't bet)
Seat 6: xScarface (small blind) folded before Flop



PokerStars Hand #222958075296:  Hold'em No Limit ($0.05/$0.10 USD) - 2021/01/23 11:02:11 ET
Table 'Bohlinia III' 6-max Seat #6 is the button
Seat 1: dante192 ($17.24 in chips) 
Seat 2: ojeriza ($11.32 in chips) 
Seat 3: robotov ($10 in chips) 
Seat 4: attila436 ($2.29 in chips) 
Seat 5: 19ElGringo91 ($10 in chips) 
Seat 6: xScarface ($10.62 in chips) 
dante192: posts small blind $0.05
ojeriza: posts big blind $0.10
*** HOLE CARDS ***
robotov: folds 
attila436 has timed out
attila436: folds 
19ElGringo91: raises $0.20 to $0.30
xScarface: folds 
dante192: folds 
ojeriza: folds 
Uncalled bet ($0.20) returned to 19ElGringo91
19ElGringo91 collected $0.25 from pot
19ElGringo91: doesn't show hand 
*** SUMMARY ***
Total pot $0.25 | Rake $0 
Seat 1: dante192 (small blind) folded before Flop
Seat 2: ojeriza (big blind) folded before Flop
Seat 3: robotov folded before Flop (didn't bet)
Seat 4: attila436 folded before Flop (didn't bet)
Seat 5: 19ElGringo91 collected ($0.25)
Seat 6: xScarface (button) folded before Flop (didn't bet)



PokerStars Hand #222958090943:  Hold'em No Limit ($0.05/$0.10 USD) - 2021/01/23 11:02:40 ET
Table 'Bohlinia III' 6-max Seat #1 is the button
Seat 1: dante192 ($17.19 in chips) 
Seat 2: ojeriza ($11.22 in chips) 
Seat 3: robotov ($10 in chips) 
Seat 4: attila436 ($2.29 in chips) 
Seat 5: 19ElGringo91 ($10.15 in chips) 
Seat 6: xScarface ($10.62 in chips) 
ojeriza: posts small blind $0.05
robotov: posts big blind $0.10
*** HOLE CARDS ***
attila436: raises $2.19 to $2.29 and is all-in
19ElGringo91: folds 
xScarface: folds 
dante192: folds 
ojeriza: folds 
robotov: folds 
Uncalled bet ($2.19) returned to attila436
attila436 collected $0.25 from pot
attila436: doesn't show hand 
*** SUMMARY ***
Total pot $0.25 | Rake $0 
Seat 1: dante192 (button) folded before Flop (didn't bet)
Seat 2: ojeriza (small blind) folded before Flop
Seat 3: robotov (big blind) folded before Flop
Seat 4: attila436 collected ($0.25)
Seat 5: 19ElGringo91 folded before Flop (didn't bet)
Seat 6: xScarface folded before Flop (didn't bet)



PokerStars Hand #222958102407:  Hold'em No Limit ($0.05/$0.10 USD) - 2021/01/23 11:03:02 ET
Table 'Bohlinia III' 6-max Seat #2 is the button
Seat 1: dante192 ($17.19 in chips) 
Seat 2: ojeriza ($11.17 in chips) 
Seat 3: robotov ($10 in chips) 
Seat 4: attila436 ($2.44 in chips) 
Seat 5: 19ElGringo91 ($10.15 in chips) 
Seat 6: xScarface ($10.62 in chips) 
robotov: posts small blind $0.05
attila436: posts big blind $0.10
*** HOLE CARDS ***
19ElGringo91: raises $0.20 to $0.30
xScarface: folds 
dante192: folds 
ojeriza: folds 
robotov: folds 
attila436: calls $0.20
*** FLOP *** [7s 4s 2c]
attila436: checks 
19ElGringo91: checks 
*** TURN *** [7s 4s 2c] [5h]
attila436: checks 
19ElGringo91: checks 
*** RIVER *** [7s 4s 2c 5h] [Kh]
attila436: bets $0.10
19ElGringo91: raises $0.50 to $0.60
attila436: folds 
Uncalled bet ($0.50) returned to 19ElGringo91
19ElGringo91 collected $0.81 from pot
19ElGringo91: doesn't show hand 
*** SUMMARY ***
Total pot $0.85 | Rake $0.04 
Board [7s 4s 2c 5h Kh]
Seat 1: dante192 folded before Flop (didn't bet)
Seat 2: ojeriza (button) folded before Flop (didn't bet)
Seat 3: robotov (small blind) folded before Flop
Seat 4: attila436 (big blind) folded on the River
Seat 5: 19ElGringo91 collected ($0.81)
Seat 6: xScarface folded before Flop (didn't bet)



PokerStars Hand #222958129922:  Hold'em No Limit ($0.05/$0.10 USD) - 2021/01/23 11:03:47 ET
Table 'Bohlinia III' 6-max Seat #3 is the button
Seat 1: dante192 ($17.19 in chips) 
Seat 2: ojeriza ($11.17 in chips) 
Seat 3: robotov ($10 in chips) 
Seat 4: attila436 ($2.04 in chips) 
Seat 5: 19ElGringo91 ($10.56 in chips) 
Seat 6: xScarface ($10.62 in chips) 
attila436: posts small blind $0.05
19ElGringo91: posts big blind $0.10
*** HOLE CARDS ***
xScarface has timed out
xScarface: folds 
dante192: folds 
ojeriza: folds 
robotov: folds 
attila436: raises $1.94 to $2.04 and is all-in
19ElGringo91: folds 
Uncalled bet ($1.94) returned to attila436
attila436 collected $0.20 from pot
attila436: doesn't show hand 
*** SUMMARY ***
Total pot $0.20 | Rake $0 
Seat 1: dante192 folded before Flop (didn't bet)
Seat 2: ojeriza folded before Flop (didn't bet)
Seat 3: robotov (button) folded before Flop (didn't bet)
Seat 4: attila436 (small blind) collected ($0.20)
Seat 5: 19ElGringo91 (big blind) folded before Flop
Seat 6: xScarface folded before Flop (didn't bet)



PokerStars Hand #222958141702:  Hold'em No Limit ($0.05/$0.10 USD) - 2021/01/23 11:04:08 ET
Table 'Bohlinia III' 6-max Seat #4 is the button
Seat 1: dante192 ($17.19 in chips) 
Seat 2: ojeriza ($11.17 in chips) 
Seat 3: robotov ($10 in chips) 
Seat 4: attila436 ($2.14 in chips) 
Seat 5: 19ElGringo91 ($10.46 in chips) 
Seat 6: xScarface ($10.62 in chips) 
19ElGringo91: posts small blind $0.05
xScarface: posts big blind $0.10
*** HOLE CARDS ***
dante192: folds 
ojeriza: folds 
robotov: raises $0.20 to $0.30
attila436: raises $1.84 to $2.14 and is all-in
19ElGringo91: folds 
xScarface: folds 
robotov: calls $1.84
*** FLOP *** [3s 8c Qd]
*** TURN *** [3s 8c Qd] [6d]
*** RIVER *** [3s 8c Qd 6d] [5c]
*** SHOW DOWN ***
robotov: shows [Jh Qh] (a pair of Queens)
attila436: shows [Qc 9s] (a pair of Queens - lower kicker)
robotov collected $4.23 from pot
*** SUMMARY ***
Total pot $4.43 | Rake $0.20 
Board [3s 8c Qd 6d 5c]
Seat 1: dante192 folded before Flop (didn't bet)
Seat 2: ojeriza folded before Flop (didn't bet)
Seat 3: robotov showed [Jh Qh] and won ($4.23) with a pair of Queens
Seat 4: attila436 (button) showed [Qc 9s] and lost with a pair of Queens
Seat 5: 19ElGringo91 (small blind) folded before Flop
Seat 6: xScarface (big blind) folded before Flop



PokerStars Hand #222958162821:  Hold'em No Limit ($0.05/$0.10 USD) - 2021/01/23 11:04:45 ET
Table 'Bohlinia III' 6-max Seat #5 is the button
Seat 1: dante192 ($17.19 in chips) 
Seat 2: ojeriza ($11.17 in chips) 
Seat 3: robotov ($12.09 in chips) 
Seat 5: 19ElGringo91 ($10.41 in chips) 
Seat 6: xScarface ($10.52 in chips) 
xScarface: posts small blind $0.05
dante192: posts big blind $0.10
*** HOLE CARDS ***
ojeriza: folds 
robotov: folds 
attila436 leaves the table
19ElGringo91: raises $0.20 to $0.30
xScarface: calls $0.25
dante192: folds 
*** FLOP *** [4c Tc 9d]
xScarface: checks 
19ElGringo91: checks 
*** TURN *** [4c Tc 9d] [Td]
BBCatBBQ joins the table at seat #4 
xScarface: checks 
19ElGringo91: bets $0.22
BBCatBBQ leaves the table
xScarface: calls $0.22
*** RIVER *** [4c Tc 9d Td] [Jd]
MtlPlumber joins the table at seat #4 
xScarface: bets $1.09
19ElGringo91: folds 
Uncalled bet ($1.09) returned to xScarface
xScarface collected $1.09 from pot
xScarface: doesn't show hand 
*** SUMMARY ***
Total pot $1.14 | Rake $0.05 
Board [4c Tc 9d Td Jd]
Seat 1: dante192 (big blind) folded before Flop
Seat 2: ojeriza folded before Flop (didn't bet)
Seat 3: robotov folded before Flop (didn't bet)
Seat 5: 19ElGringo91 (button) folded on the River
Seat 6: xScarface (small blind) collected ($1.09)



PokerStars Hand #222958225292:  Hold'em No Limit ($0.05/$0.10 USD) - 2021/01/23 11:06:31 ET
Table 'Bohlinia III' 6-max Seat #6 is the button
Seat 1: dante192 ($17.09 in chips) 
Seat 2: ojeriza ($11.17 in chips) 
Seat 3: robotov ($12.09 in chips) 
Seat 5: 19ElGringo91 ($10 in chips) 
Seat 6: xScarface ($11.09 in chips) 
dante192: posts small blind $0.05
ojeriza: posts big blind $0.10
MtlPlumber: sits out 
*** HOLE CARDS ***
robotov: folds 
19ElGringo91: folds 
xScarface: raises $0.10 to $0.20
dante192: folds 
ojeriza: folds 
Uncalled bet ($0.10) returned to xScarface
xScarface collected $0.25 from pot
xScarface: doesn't show hand 
*** SUMMARY ***
Total pot $0.25 | Rake $0 
Seat 1: dante192 (small blind) folded before Flop
Seat 2: ojeriza (big blind) folded before Flop
Seat 3: robotov folded before Flop (didn't bet)
Seat 5: 19ElGringo91 folded before Flop (didn't bet)
Seat 6: xScarface (button) collected ($0.25)



PokerStars Hand #222958238100:  Hold'em No Limit ($0.05/$0.10 USD) - 2021/01/23 11:06:53 ET
Table 'Bohlinia III' 6-max Seat #1 is the button
Seat 1: dante192 ($17.04 in chips) 
Seat 2: ojeriza ($11.07 in chips) 
Seat 3: robotov ($12.09 in chips) 
Seat 5: 19ElGringo91 ($10 in chips) 
Seat 6: xScarface ($11.24 in chips) 
ojeriza: posts small blind $0.05
robotov: posts big blind $0.10
MtlPlumber: sits out 
*** HOLE CARDS ***
19ElGringo91: folds 
xScarface: folds 
dante192: raises $0.15 to $0.25
ojeriza: folds 
robotov: folds 
Uncalled bet ($0.15) returned to dante192
dante192 collected $0.25 from pot
dante192: doesn't show hand 
*** SUMMARY ***
Total pot $0.25 | Rake $0 
Seat 1: dante192 (button) collected ($0.25)
Seat 2: ojeriza (small blind) folded before Flop
Seat 3: robotov (big blind) folded before Flop
Seat 5: 19ElGringo91 folded before Flop (didn't bet)
Seat 6: xScarface folded before Flop (didn't bet)



PokerStars Hand #222958250719:  Hold'em No Limit ($0.05/$0.10 USD) - 2021/01/23 11:07:14 ET
Table 'Bohlinia III' 6-max Seat #2 is the button
Seat 1: dante192 ($17.19 in chips) 
Seat 2: ojeriza ($11.02 in chips) 
Seat 3: robotov ($11.99 in chips) 
Seat 4: MtlPlumber ($5 in chips) 
Seat 5: 19ElGringo91 ($10 in chips) 
Seat 6: xScarface ($11.24 in chips) 
robotov: posts small blind $0.05
MtlPlumber: posts big blind $0.10
*** HOLE CARDS ***
19ElGringo91: raises $0.20 to $0.30
xScarface has timed out
xScarface: folds 
dante192: folds 
ojeriza: folds 
robotov: folds 
MtlPlumber: calls $0.20
*** FLOP *** [Qd 3c 4s]
MtlPlumber: checks 
19ElGringo91: bets $0.32
MtlPlumber: calls $0.32
*** TURN *** [Qd 3c 4s] [6s]
MtlPlumber: checks 
19ElGringo91: checks 
*** RIVER *** [Qd 3c 4s 6s] [6c]
MtlPlumber: checks 
19ElGringo91: checks 
*** SHOW DOWN ***
MtlPlumber: shows [4d 4h] (a full house, Fours full of Sixes)
19ElGringo91: mucks hand 
MtlPlumber collected $1.23 from pot
*** SUMMARY ***
Total pot $1.29 | Rake $0.06 
Board [Qd 3c 4s 6s 6c]
Seat 1: dante192 folded before Flop (didn't bet)
Seat 2: ojeriza (button) folded before Flop (didn't bet)
Seat 3: robotov (small blind) folded before Flop
Seat 4: MtlPlumber (big blind) showed [4d 4h] and won ($1.23) with a full house, Fours full of Sixes
Seat 5: 19ElGringo91 mucked
Seat 6: xScarface folded before Flop (didn't bet)



PokerStars Hand #222958289046:  Hold'em No Limit ($0.05/$0.10 USD) - 2021/01/23 11:08:18 ET
Table 'Bohlinia III' 6-max Seat #3 is the button
Seat 1: dante192 ($17.19 in chips) 
Seat 2: ojeriza ($11.02 in chips) 
Seat 3: robotov ($11.94 in chips) 
Seat 4: MtlPlumber ($5.61 in chips) 
Seat 5: 19ElGringo91 ($10 in chips) 
Seat 6: xScarface ($11.24 in chips) 
MtlPlumber: posts small blind $0.05
19ElGringo91: posts big blind $0.10
*** HOLE CARDS ***
xScarface: folds 
dante192: folds 
ojeriza: folds 
robotov: raises $0.15 to $0.25
MtlPlumber: raises $0.25 to $0.50
19ElGringo91: folds 
robotov: calls $0.25
*** FLOP *** [Th 6c 3s]
MtlPlumber: bets $0.55
robotov: raises $0.90 to $1.45
MtlPlumber: calls $0.90
*** TURN *** [Th 6c 3s] [Js]
MtlPlumber: checks 
robotov: checks 
*** RIVER *** [Th 6c 3s Js] [7c]
MtlPlumber: bets $3.66 and is all-in
robotov: calls $3.66
*** SHOW DOWN ***
MtlPlumber: shows [4d Ac] (high card Ace)
robotov: shows [Jc Ts] (two pair, Jacks and Tens)
robotov collected $10.81 from pot
*** SUMMARY ***
Total pot $11.32 | Rake $0.51 
Board [Th 6c 3s Js 7c]
Seat 1: dante192 folded before Flop (didn't bet)
Seat 2: ojeriza folded before Flop (didn't bet)
Seat 3: robotov (button) showed [Jc Ts] and won ($10.81) with two pair, Jacks and Tens
Seat 4: MtlPlumber (small blind) showed [4d Ac] and lost with high card Ace
Seat 5: 19ElGringo91 (big blind) folded before Flop
Seat 6: xScarface folded before Flop (didn't bet)



PokerStars Hand #222958320549:  Hold'em No Limit ($0.05/$0.10 USD) - 2021/01/23 11:09:11 ET
Table 'Bohlinia III' 6-max Seat #5 is the button
Seat 1: dante192 ($17.19 in chips) 
Seat 2: ojeriza ($11.02 in chips) 
Seat 3: robotov ($17.14 in chips) 
Seat 5: 19ElGringo91 ($10 in chips) 
Seat 6: xScarface ($11.24 in chips) 
xScarface: posts small blind $0.05
dante192: posts big blind $0.10
*** HOLE CARDS ***
MtlPlumber leaves the table
ojeriza: folds 
robotov: folds 
19ElGringo91: folds 
xScarface: folds 
Uncalled bet ($0.05) returned to dante192
dante192 collected $0.10 from pot
dante192: doesn't show hand 
*** SUMMARY ***
Total pot $0.10 | Rake $0 
Seat 1: dante192 (big blind) collected ($0.10)
Seat 2: ojeriza folded before Flop (didn't bet)
Seat 3: robotov folded before Flop (didn't bet)
Seat 5: 19ElGringo91 (button) folded before Flop (didn't bet)
Seat 6: xScarface (small blind) folded before Flop



PokerStars Hand #222958331702:  Hold'em No Limit ($0.05/$0.10 USD) - 2021/01/23 11:09:30 ET
Table 'Bohlinia III' 6-max Seat #6 is the button
Seat 1: dante192 ($17.24 in chips) 
Seat 2: ojeriza ($11.02 in chips) 
Seat 3: robotov ($17.14 in chips) 
Seat 5: 19ElGringo91 ($10 in chips) 
Seat 6: xScarface ($11.19 in chips) 
dante192: posts small blind $0.05
ojeriza: posts big blind $0.10
*** HOLE CARDS ***
robotov: folds 
19ElGringo91: folds 
xScarface: folds 
dante192: folds 
Uncalled bet ($0.05) returned to ojeriza
ojeriza collected $0.10 from pot
ojeriza: doesn't show hand 
*** SUMMARY ***
Total pot $0.10 | Rake $0 
Seat 1: dante192 (small blind) folded before Flop
Seat 2: ojeriza (big blind) collected ($0.10)
Seat 3: robotov folded before Flop (didn't bet)
Seat 5: 19ElGringo91 folded before Flop (didn't bet)
Seat 6: xScarface (button) folded before Flop (didn't bet)



PokerStars Hand #222958336558:  Hold'em No Limit ($0.05/$0.10 USD) - 2021/01/23 11:09:38 ET
Table 'Bohlinia III' 6-max Seat #1 is the button
Seat 1: dante192 ($17.19 in chips) 
Seat 2: ojeriza ($11.07 in chips) 
Seat 3: robotov ($17.14 in chips) 
Seat 5: 19ElGringo91 ($10 in chips) 
Seat 6: xScarface ($11.19 in chips) 
ojeriza: posts small blind $0.05
robotov: posts big blind $0.10
*** HOLE CARDS ***
19ElGringo91: folds 
xScarface: raises $0.10 to $0.20
dante192: folds 
ojeriza: folds 
robotov: folds 
Uncalled bet ($0.10) returned to xScarface
xScarface collected $0.25 from pot
xScarface: doesn't show hand 
*** SUMMARY ***
Total pot $0.25 | Rake $0 
Seat 1: dante192 (button) folded before Flop (didn't bet)
Seat 2: ojeriza (small blind) folded before Flop
Seat 3: robotov (big blind) folded before Flop
Seat 5: 19ElGringo91 folded before Flop (didn't bet)
Seat 6: xScarface collected ($0.25)



PokerStars Hand #222958344386:  Hold'em No Limit ($0.05/$0.10 USD) - 2021/01/23 11:09:51 ET
Table 'Bohlinia III' 6-max Seat #2 is the button
Seat 1: dante192 ($17.19 in chips) 
Seat 2: ojeriza ($11.02 in chips) 
Seat 3: robotov ($17.04 in chips) 
Seat 5: 19ElGringo91 ($10 in chips) 
Seat 6: xScarface ($11.34 in chips) 
robotov: posts small blind $0.05
19ElGringo91: posts big blind $0.10
*** HOLE CARDS ***
xScarface: folds 
dante192: raises $0.15 to $0.25
ojeriza: folds 
robotov: folds 
HeyLo joins the table at seat #4 
19ElGringo91: folds 
Uncalled bet ($0.15) returned to dante192
dante192 collected $0.25 from pot
dante192: doesn't show hand 
*** SUMMARY ***
Total pot $0.25 | Rake $0 
Seat 1: dante192 collected ($0.25)
Seat 2: ojeriza (button) folded before Flop (didn't bet)
Seat 3: robotov (small blind) folded before Flop
Seat 5: 19ElGringo91 (big blind) folded before Flop
Seat 6: xScarface folded before Flop (didn't bet)



PokerStars Hand #222958351148:  Hold'em No Limit ($0.05/$0.10 USD) - 2021/01/23 11:10:02 ET
Table 'Bohlinia III' 6-max Seat #3 is the button
Seat 1: dante192 ($17.34 in chips) 
Seat 2: ojeriza ($11.02 in chips) 
Seat 3: robotov ($16.99 in chips) 
Seat 5: 19ElGringo91 ($10 in chips) 
Seat 6: xScarface ($11.34 in chips) 
19ElGringo91: posts small blind $0.05
xScarface: posts big blind $0.10
*** HOLE CARDS ***
dante192: folds 
ojeriza: folds 
robotov: folds 
19ElGringo91: folds 
Uncalled bet ($0.05) returned to xScarface
dante192 leaves the table
xScarface collected $0.10 from pot
xScarface: doesn't show hand 
*** SUMMARY ***
Total pot $0.10 | Rake $0 
Seat 1: dante192 folded before Flop (didn't bet)
Seat 2: ojeriza folded before Flop (didn't bet)
Seat 3: robotov (button) folded before Flop (didn't bet)
Seat 5: 19ElGringo91 (small blind) folded before Flop
Seat 6: xScarface (big blind) collected ($0.10)



PokerStars Hand #222958357119:  Hold'em No Limit ($0.05/$0.10 USD) - 2021/01/23 11:10:12 ET
Table 'Bohlinia III' 6-max Seat #5 is the button
Seat 2: ojeriza ($11.02 in chips) 
Seat 3: robotov ($16.99 in chips) 
Seat 5: 19ElGringo91 ($10 in chips) 
Seat 6: xScarface ($11.39 in chips) 
xScarface: posts small blind $0.05
ojeriza: posts big blind $0.10
HeyLo: sits out 
*** HOLE CARDS ***
robotov: folds 
hempju1ce joins the table at seat #1 
19ElGringo91: raises $0.20 to $0.30
xScarface: folds 
ojeriza: folds 
Uncalled bet ($0.20) returned to 19ElGringo91
19ElGringo91 collected $0.25 from pot
19ElGringo91: doesn't show hand 
*** SUMMARY ***
Total pot $0.25 | Rake $0 
Seat 2: ojeriza (big blind) folded before Flop
Seat 3: robotov folded before Flop (didn't bet)
Seat 5: 19ElGringo91 (button) collected ($0.25)
Seat 6: xScarface (small blind) folded before Flop



PokerStars Hand #222958361928:  Hold'em No Limit ($0.05/$0.10 USD) - 2021/01/23 11:10:20 ET
Table 'Bohlinia III' 6-max Seat #6 is the button
Seat 2: ojeriza ($10.92 in chips) 
Seat 3: robotov ($16.99 in chips) 
Seat 5: 19ElGringo91 ($10.15 in chips) 
Seat 6: xScarface ($11.34 in chips) 
ojeriza: posts small blind $0.05
robotov: posts big blind $0.10
HeyLo: sits out 
*** HOLE CARDS ***
19ElGringo91: raises $0.20 to $0.30
xScarface has timed out
xScarface: folds 
ojeriza: folds 
robotov: calls $0.20
*** FLOP *** [Qs Ks Ah]
robotov: checks 
19ElGringo91: bets $0.32
robotov: calls $0.32
*** TURN *** [Qs Ks Ah] [2s]
robotov: checks 
19ElGringo91: checks 
*** RIVER *** [Qs Ks Ah 2s] [7h]
robotov: checks 
19ElGringo91: checks 
*** SHOW DOWN ***
robotov: shows [Kh Js] (a pair of Kings)
19ElGringo91: mucks hand 
robotov collected $1.23 from pot
*** SUMMARY ***
Total pot $1.29 | Rake $0.06 
Board [Qs Ks Ah 2s 7h]
Seat 2: ojeriza (small blind) folded before Flop
Seat 3: robotov (big blind) showed [Kh Js] and won ($1.23) with a pair of Kings
Seat 5: 19ElGringo91 mucked
Seat 6: xScarface (button) folded before Flop (didn't bet)



PokerStars Hand #222958387302:  Hold'em No Limit ($0.05/$0.10 USD) - 2021/01/23 11:11:02 ET
Table 'Bohlinia III' 6-max Seat #2 is the button
Seat 2: ojeriza ($10.87 in chips) 
Seat 3: robotov ($17.60 in chips) 
Seat 4: HeyLo ($10 in chips) 
Seat 5: 19ElGringo91 ($10 in chips) 
Seat 6: xScarface ($11.34 in chips) 
robotov: posts small blind $0.05
HeyLo: posts big blind $0.10
hempju1ce: sits out 
*** HOLE CARDS ***
19ElGringo91: folds 
xScarface: raises $0.25 to $0.35
ojeriza: folds 
robotov: folds 
HeyLo: folds 
Uncalled bet ($0.25) returned to xScarface
xScarface collected $0.25 from pot
xScarface: doesn't show hand 
*** SUMMARY ***
Total pot $0.25 | Rake $0 
Seat 2: ojeriza (button) folded before Flop (didn't bet)
Seat 3: robotov (small blind) folded before Flop
Seat 4: HeyLo (big blind) folded before Flop
Seat 5: 19ElGringo91 folded before Flop (didn't bet)
Seat 6: xScarface collected ($0.25)



PokerStars Hand #222958400704:  Hold'em No Limit ($0.05/$0.10 USD) - 2021/01/23 11:11:24 ET
Table 'Bohlinia III' 6-max Seat #3 is the button
Seat 2: ojeriza ($10.87 in chips) 
Seat 3: robotov ($17.55 in chips) 
Seat 4: HeyLo ($10 in chips) 
Seat 5: 19ElGringo91 ($10 in chips) 
Seat 6: xScarface ($11.49 in chips) 
HeyLo: posts small blind $0.05
19ElGringo91: posts big blind $0.10
hempju1ce: sits out 
*** HOLE CARDS ***
xScarface: folds 
ojeriza: raises $0.18 to $0.28
robotov: folds 
HeyLo: folds 
19ElGringo91: calls $0.18
*** FLOP *** [Ad 2h 8s]
19ElGringo91: checks 
ojeriza: checks 
*** TURN *** [Ad 2h 8s] [2c]
19ElGringo91: checks 
ojeriza: bets $0.43
19ElGringo91: calls $0.43
*** RIVER *** [Ad 2h 8s 2c] [6s]
19ElGringo91: checks 
ojeriza: checks 
*** SHOW DOWN ***
19ElGringo91: shows [Qd As] (two pair, Aces and Deuces)
ojeriza: mucks hand 
19ElGringo91 collected $1.40 from pot
*** SUMMARY ***
Total pot $1.47 | Rake $0.07 
Board [Ad 2h 8s 2c 6s]
Seat 2: ojeriza mucked
Seat 3: robotov (button) folded before Flop (didn't bet)
Seat 4: HeyLo (small blind) folded before Flop
Seat 5: 19ElGringo91 (big blind) showed [Qd As] and won ($1.40) with two pair, Aces and Deuces
Seat 6: xScarface folded before Flop (didn't bet)



PokerStars Hand #222958421948:  Hold'em No Limit ($0.05/$0.10 USD) - 2021/01/23 11:12:00 ET
Table 'Bohlinia III' 6-max Seat #4 is the button
Seat 2: ojeriza ($10.16 in chips) 
Seat 3: robotov ($17.55 in chips) 
Seat 4: HeyLo ($10 in chips) 
Seat 5: 19ElGringo91 ($10.69 in chips) 
Seat 6: xScarface ($11.49 in chips) 
19ElGringo91: posts small blind $0.05
xScarface: posts big blind $0.10
hempju1ce: sits out 
*** HOLE CARDS ***
ojeriza: folds 
robotov: raises $0.20 to $0.30
HeyLo: calls $0.30
19ElGringo91: raises $1.15 to $1.45
xScarface: folds 
robotov: calls $1.15
HeyLo: folds 
*** FLOP *** [2h Jh 9s]
19ElGringo91: bets $2.36
robotov: calls $2.36
*** TURN *** [2h Jh 9s] [7d]
19ElGringo91: bets $6.88 and is all-in
robotov: calls $6.88
*** RIVER *** [2h Jh 9s 7d] [Jd]
*** SHOW DOWN ***
19ElGringo91: shows [Ac Jc] (three of a kind, Jacks)
robotov: shows [9c 9h] (a full house, Nines full of Jacks)
robotov collected $20.80 from pot
*** SUMMARY ***
Total pot $21.78 | Rake $0.98 
Board [2h Jh 9s 7d Jd]
Seat 2: ojeriza folded before Flop (didn't bet)
Seat 3: robotov showed [9c 9h] and won ($20.80) with a full house, Nines full of Jacks
Seat 4: HeyLo (button) folded before Flop
Seat 5: 19ElGringo91 (small blind) showed [Ac Jc] and lost with three of a kind, Jacks
Seat 6: xScarface (big blind) folded before Flop



PokerStars Hand #222958475557:  Hold'em No Limit ($0.05/$0.10 USD) - 2021/01/23 11:13:21 ET
Table 'Bohlinia III' 6-max Seat #5 is the button
Seat 1: hempju1ce ($10 in chips) 
Seat 2: ojeriza ($10.16 in chips) 
Seat 3: robotov ($27.66 in chips) 
Seat 4: HeyLo ($10 in chips) 
Seat 5: 19ElGringo91 ($10 in chips) 
Seat 6: xScarface ($11.39 in chips) 
xScarface: posts small blind $0.05
hempju1ce: posts big blind $0.10
*** HOLE CARDS ***
ojeriza: folds 
robotov: folds 
HeyLo: folds 
19ElGringo91: raises $0.20 to $0.30
xScarface: folds 
hempju1ce: folds 
Uncalled bet ($0.20) returned to 19ElGringo91
19ElGringo91 collected $0.25 from pot
19ElGringo91: doesn't show hand 
*** SUMMARY ***
Total pot $0.25 | Rake $0 
Seat 1: hempju1ce (big blind) folded before Flop
Seat 2: ojeriza folded before Flop (didn't bet)
Seat 3: robotov folded before Flop (didn't bet)
Seat 4: HeyLo folded before Flop (didn't bet)
Seat 5: 19ElGringo91 (button) collected ($0.25)
Seat 6: xScarface (small blind) folded before Flop



PokerStars Hand #222958488330:  Hold'em No Limit ($0.05/$0.10 USD) - 2021/01/23 11:13:43 ET
Table 'Bohlinia III' 6-max Seat #6 is the button
Seat 1: hempju1ce ($9.90 in chips) 
Seat 2: ojeriza ($10.16 in chips) 
Seat 3: robotov ($27.66 in chips) 
Seat 4: HeyLo ($10 in chips) 
Seat 5: 19ElGringo91 ($10.15 in chips) 
Seat 6: xScarface ($11.34 in chips) 
hempju1ce: posts small blind $0.05
ojeriza: posts big blind $0.10
*** HOLE CARDS ***
robotov: folds 
HeyLo: folds 
19ElGringo91: folds 
xScarface: folds 
hempju1ce: calls $0.05
ojeriza: raises $0.36 to $0.46
hempju1ce: calls $0.36
*** FLOP *** [5d Qs 7d]
hempju1ce: bets $0.44
ojeriza: folds 
Uncalled bet ($0.44) returned to hempju1ce
hempju1ce collected $0.88 from pot
hempju1ce: doesn't show hand 
*** SUMMARY ***
Total pot $0.92 | Rake $0.04 
Board [5d Qs 7d]
Seat 1: hempju1ce (small blind) collected ($0.88)
Seat 2: ojeriza (big blind) folded on the Flop
Seat 3: robotov folded before Flop (didn't bet)
Seat 4: HeyLo folded before Flop (didn't bet)
Seat 5: 19ElGringo91 folded before Flop (didn't bet)
Seat 6: xScarface (button) folded before Flop (didn't bet)



PokerStars Hand #222958507976:  Hold'em No Limit ($0.05/$0.10 USD) - 2021/01/23 11:14:15 ET
Table 'Bohlinia III' 6-max Seat #1 is the button
Seat 1: hempju1ce ($10.32 in chips) 
Seat 2: ojeriza ($10 in chips) 
Seat 3: robotov ($27.66 in chips) 
Seat 4: HeyLo ($10 in chips) 
Seat 5: 19ElGringo91 ($10.15 in chips) 
Seat 6: xScarface ($11.34 in chips) 
ojeriza: posts small blind $0.05
robotov: posts big blind $0.10
*** HOLE CARDS ***
HeyLo: folds 
19ElGringo91: folds 
xScarface: folds 
hempju1ce: folds 
ojeriza: folds 
Uncalled bet ($0.05) returned to robotov
robotov collected $0.10 from pot
robotov: doesn't show hand 
*** SUMMARY ***
Total pot $0.10 | Rake $0 
Seat 1: hempju1ce (button) folded before Flop (didn't bet)
Seat 2: ojeriza (small blind) folded before Flop
Seat 3: robotov (big blind) collected ($0.10)
Seat 4: HeyLo folded before Flop (didn't bet)
Seat 5: 19ElGringo91 folded before Flop (didn't bet)
Seat 6: xScarface folded before Flop (didn't bet)



PokerStars Hand #222958514962:  Hold'em No Limit ($0.05/$0.10 USD) - 2021/01/23 11:14:27 ET
Table 'Bohlinia III' 6-max Seat #2 is the button
Seat 1: hempju1ce ($10.32 in chips) 
Seat 2: ojeriza ($10 in chips) 
Seat 3: robotov ($27.71 in chips) 
Seat 4: HeyLo ($10 in chips) 
Seat 5: 19ElGringo91 ($10.15 in chips) 
Seat 6: xScarface ($11.34 in chips) 
robotov: posts small blind $0.05
HeyLo: posts big blind $0.10
*** HOLE CARDS ***
19ElGringo91: raises $0.20 to $0.30
xScarface: calls $0.30
hempju1ce: folds 
ojeriza: folds 
robotov: folds 
HeyLo: folds 
*** FLOP *** [9d Qs 8c]
19ElGringo91: bets $0.24
xScarface: folds 
Uncalled bet ($0.24) returned to 19ElGringo91
19ElGringo91 collected $0.72 from pot
19ElGringo91: doesn't show hand 
*** SUMMARY ***
Total pot $0.75 | Rake $0.03 
Board [9d Qs 8c]
Seat 1: hempju1ce folded before Flop (didn't bet)
Seat 2: ojeriza (button) folded before Flop (didn't bet)
Seat 3: robotov (small blind) folded before Flop
Seat 4: HeyLo (big blind) folded before Flop
Seat 5: 19ElGringo91 collected ($0.72)
Seat 6: xScarface folded on the Flop



PokerStars Hand #222958529204:  Hold'em No Limit ($0.05/$0.10 USD) - 2021/01/23 11:14:51 ET
Table 'Bohlinia III' 6-max Seat #3 is the button
Seat 1: hempju1ce ($10.32 in chips) 
Seat 2: ojeriza ($10 in chips) 
Seat 3: robotov ($27.66 in chips) 
Seat 4: HeyLo ($10 in chips) 
Seat 5: 19ElGringo91 ($10.57 in chips) 
Seat 6: xScarface ($11.04 in chips) 
HeyLo: posts small blind $0.05
19ElGringo91: posts big blind $0.10
*** HOLE CARDS ***
xScarface: calls $0.10
hempju1ce: folds 
ojeriza: raises $0.36 to $0.46
robotov: folds 
HeyLo: folds 
19ElGringo91: folds 
xScarface: calls $0.36
*** FLOP *** [8s 9c 3s]
xScarface: checks 
ojeriza: checks 
*** TURN *** [8s 9c 3s] [Ah]
xScarface: checks 
ojeriza: checks 
*** RIVER *** [8s 9c 3s Ah] [6h]
xScarface: checks 
ojeriza: bets $0.77
xScarface: folds 
Uncalled bet ($0.77) returned to ojeriza
ojeriza collected $1.02 from pot
ojeriza: doesn't show hand 
*** SUMMARY ***
Total pot $1.07 | Rake $0.05 
Board [8s 9c 3s Ah 6h]
Seat 1: hempju1ce folded before Flop (didn't bet)
Seat 2: ojeriza collected ($1.02)
Seat 3: robotov (button) folded before Flop (didn't bet)
Seat 4: HeyLo (small blind) folded before Flop
Seat 5: 19ElGringo91 (big blind) folded before Flop
Seat 6: xScarface folded on the River



PokerStars Hand #222958565674:  Hold'em No Limit ($0.05/$0.10 USD) - 2021/01/23 11:15:51 ET
Table 'Bohlinia III' 6-max Seat #4 is the button
Seat 1: hempju1ce ($10.32 in chips) 
Seat 2: ojeriza ($10.56 in chips) 
Seat 3: robotov ($27.66 in chips) 
Seat 4: HeyLo ($10 in chips) 
Seat 5: 19ElGringo91 ($10.47 in chips) 
Seat 6: xScarface ($10.58 in chips) 
19ElGringo91: posts small blind $0.05
xScarface: posts big blind $0.10
*** HOLE CARDS ***
hempju1ce: folds 
ojeriza: folds 
robotov: folds 
HeyLo: raises $0.20 to $0.30
19ElGringo91: folds 
xScarface: folds 
Uncalled bet ($0.20) returned to HeyLo
HeyLo collected $0.25 from pot
HeyLo: doesn't show hand 
*** SUMMARY ***
Total pot $0.25 | Rake $0 
Seat 1: hempju1ce folded before Flop (didn't bet)
Seat 2: ojeriza folded before Flop (didn't bet)
Seat 3: robotov folded before Flop (didn't bet)
Seat 4: HeyLo (button) collected ($0.25)
Seat 5: 19ElGringo91 (small blind) folded before Flop
Seat 6: xScarface (big blind) folded before Flop



PokerStars Hand #222958577574:  Hold'em No Limit ($0.05/$0.10 USD) - 2021/01/23 11:16:11 ET
Table 'Bohlinia III' 6-max Seat #5 is the button
Seat 1: hempju1ce ($10.32 in chips) 
Seat 2: ojeriza ($10.56 in chips) 
Seat 3: robotov ($27.66 in chips) 
Seat 4: HeyLo ($10.15 in chips) 
Seat 5: 19ElGringo91 ($10.42 in chips) 
Seat 6: xScarface ($10.48 in chips) 
xScarface: posts small blind $0.05
hempju1ce: posts big blind $0.10
*** HOLE CARDS ***
ojeriza: folds 
robotov: raises $0.20 to $0.30
HeyLo: folds 
19ElGringo91: folds 
xScarface: folds 
hempju1ce: folds 
Uncalled bet ($0.20) returned to robotov
robotov collected $0.25 from pot
robotov: doesn't show hand 
*** SUMMARY ***
Total pot $0.25 | Rake $0 
Seat 1: hempju1ce (big blind) folded before Flop
Seat 2: ojeriza folded before Flop (didn't bet)
Seat 3: robotov collected ($0.25)
Seat 4: HeyLo folded before Flop (didn't bet)
Seat 5: 19ElGringo91 (button) folded before Flop (didn't bet)
Seat 6: xScarface (small blind) folded before Flop



PokerStars Hand #222958588373:  Hold'em No Limit ($0.05/$0.10 USD) - 2021/01/23 11:16:29 ET
Table 'Bohlinia III' 6-max Seat #6 is the button
Seat 1: hempju1ce ($10.22 in chips) 
Seat 2: ojeriza ($10.56 in chips) 
Seat 3: robotov ($27.81 in chips) 
Seat 4: HeyLo ($10.15 in chips) 
Seat 5: 19ElGringo91 ($10.42 in chips) 
Seat 6: xScarface ($10.43 in chips) 
hempju1ce: posts small blind $0.05
ojeriza: posts big blind $0.10
*** HOLE CARDS ***
robotov: raises $0.20 to $0.30
HeyLo: folds 
19ElGringo91: folds 
xScarface: raises $0.20 to $0.50
hempju1ce: calls $0.45
ojeriza: folds 
robotov: raises $1.65 to $2.15
xScarface: calls $1.65
hempju1ce: folds 
*** FLOP *** [9c 4h Jc]
robotov: bets $1.54
xScarface: folds 
Uncalled bet ($1.54) returned to robotov
robotov collected $4.68 from pot
robotov: doesn't show hand 
*** SUMMARY ***
Total pot $4.90 | Rake $0.22 
Board [9c 4h Jc]
Seat 1: hempju1ce (small blind) folded before Flop
Seat 2: ojeriza (big blind) folded before Flop
Seat 3: robotov collected ($4.68)
Seat 4: HeyLo folded before Flop (didn't bet)
Seat 5: 19ElGringo91 folded before Flop (didn't bet)
Seat 6: xScarface (button) folded on the Flop



PokerStars Hand #222958623187:  Hold'em No Limit ($0.05/$0.10 USD) - 2021/01/23 11:17:27 ET
Table 'Bohlinia III' 6-max Seat #1 is the button
Seat 1: hempju1ce ($9.72 in chips) 
Seat 2: ojeriza ($10.46 in chips) 
Seat 3: robotov ($30.34 in chips) 
Seat 4: HeyLo ($10.15 in chips) 
Seat 5: 19ElGringo91 ($10.42 in chips) 
Seat 6: xScarface ($8.28 in chips) 
ojeriza: posts small blind $0.05
robotov: posts big blind $0.10
*** HOLE CARDS ***
HeyLo: folds 
19ElGringo91: folds 
xScarface: folds 
hempju1ce: folds 
ojeriza: folds 
Uncalled bet ($0.05) returned to robotov
robotov collected $0.10 from pot
robotov: doesn't show hand 
*** SUMMARY ***
Total pot $0.10 | Rake $0 
Seat 1: hempju1ce (button) folded before Flop (didn't bet)
Seat 2: ojeriza (small blind) folded before Flop
Seat 3: robotov (big blind) collected ($0.10)
Seat 4: HeyLo folded before Flop (didn't bet)
Seat 5: 19ElGringo91 folded before Flop (didn't bet)
Seat 6: xScarface folded before Flop (didn't bet)



PokerStars Hand #222958632624:  Hold'em No Limit ($0.05/$0.10 USD) - 2021/01/23 11:17:42 ET
Table 'Bohlinia III' 6-max Seat #2 is the button
Seat 1: hempju1ce ($9.72 in chips) 
Seat 2: ojeriza ($10.41 in chips) 
Seat 3: robotov ($30.39 in chips) 
Seat 4: HeyLo ($10.15 in chips) 
Seat 5: 19ElGringo91 ($10.42 in chips) 
Seat 6: xScarface ($8.28 in chips) 
robotov: posts small blind $0.05
HeyLo: posts big blind $0.10
*** HOLE CARDS ***
19ElGringo91: folds 
xScarface: folds 
hempju1ce: folds 
ojeriza: raises $0.16 to $0.26
robotov: folds 
HeyLo: calls $0.16
*** FLOP *** [8d Ah Qd]
HeyLo: checks 
ojeriza: checks 
*** TURN *** [8d Ah Qd] [9h]
HeyLo: bets $0.36
ojeriza: calls $0.36
*** RIVER *** [8d Ah Qd 9h] [9d]
HeyLo: bets $0.82
ojeriza: calls $0.82
*** SHOW DOWN ***
HeyLo: shows [Jh Tc] (a straight, Eight to Queen)
ojeriza: mucks hand 
HeyLo collected $2.80 from pot
*** SUMMARY ***
Total pot $2.93 | Rake $0.13 
Board [8d Ah Qd 9h 9d]
Seat 1: hempju1ce folded before Flop (didn't bet)
Seat 2: ojeriza (button) mucked
Seat 3: robotov (small blind) folded before Flop
Seat 4: HeyLo (big blind) showed [Jh Tc] and won ($2.80) with a straight, Eight to Queen
Seat 5: 19ElGringo91 folded before Flop (didn't bet)
Seat 6: xScarface folded before Flop (didn't bet)



PokerStars Hand #222958660263:  Hold'em No Limit ($0.05/$0.10 USD) - 2021/01/23 11:18:28 ET
Table 'Bohlinia III' 6-max Seat #3 is the button
Seat 1: hempju1ce ($10 in chips) 
Seat 2: ojeriza ($10 in chips) 
Seat 3: robotov ($30.34 in chips) 
Seat 4: HeyLo ($11.51 in chips) 
Seat 5: 19ElGringo91 ($10.42 in chips) 
Seat 6: xScarface ($8.28 in chips) 
HeyLo: posts small blind $0.05
19ElGringo91: posts big blind $0.10
*** HOLE CARDS ***
xScarface: folds 
hempju1ce: folds 
ojeriza: folds 
robotov: folds 
HeyLo: folds 
Uncalled bet ($0.05) returned to 19ElGringo91
19ElGringo91 collected $0.10 from pot
19ElGringo91: doesn't show hand 
*** SUMMARY ***
Total pot $0.10 | Rake $0 
Seat 1: hempju1ce folded before Flop (didn't bet)
Seat 2: ojeriza folded before Flop (didn't bet)
Seat 3: robotov (button) folded before Flop (didn't bet)
Seat 4: HeyLo (small blind) folded before Flop
Seat 5: 19ElGringo91 (big blind) collected ($0.10)
Seat 6: xScarface folded before Flop (didn't bet)



PokerStars Hand #222958666451:  Hold'em No Limit ($0.05/$0.10 USD) - 2021/01/23 11:18:38 ET
Table 'Bohlinia III' 6-max Seat #4 is the button
Seat 1: hempju1ce ($10 in chips) 
Seat 2: ojeriza ($10 in chips) 
Seat 3: robotov ($30.34 in chips) 
Seat 4: HeyLo ($11.46 in chips) 
Seat 5: 19ElGringo91 ($10.47 in chips) 
Seat 6: xScarface ($8.28 in chips) 
19ElGringo91: posts small blind $0.05
xScarface: posts big blind $0.10
*** HOLE CARDS ***
hempju1ce: folds 
ojeriza: raises $0.20 to $0.30
robotov: folds 
HeyLo: folds 
19ElGringo91: folds 
xScarface: folds 
Uncalled bet ($0.20) returned to ojeriza
ojeriza collected $0.25 from pot
ojeriza: doesn't show hand 
*** SUMMARY ***
Total pot $0.25 | Rake $0 
Seat 1: hempju1ce folded before Flop (didn't bet)
Seat 2: ojeriza collected ($0.25)
Seat 3: robotov folded before Flop (didn't bet)
Seat 4: HeyLo (button) folded before Flop (didn't bet)
Seat 5: 19ElGringo91 (small blind) folded before Flop
Seat 6: xScarface (big blind) folded before Flop



PokerStars Hand #222958673598:  Hold'em No Limit ($0.05/$0.10 USD) - 2021/01/23 11:18:50 ET
Table 'Bohlinia III' 6-max Seat #5 is the button
Seat 1: hempju1ce ($10 in chips) 
Seat 2: ojeriza ($10.15 in chips) 
Seat 3: robotov ($30.34 in chips) 
Seat 4: HeyLo ($11.46 in chips) 
Seat 5: 19ElGringo91 ($10.42 in chips) 
Seat 6: xScarface ($8.18 in chips) 
xScarface: posts small blind $0.05
hempju1ce: posts big blind $0.10
*** HOLE CARDS ***
ojeriza: folds 
robotov: folds 
HeyLo: raises $0.20 to $0.30
19ElGringo91: folds 
xScarface: folds 
hempju1ce: folds 
Uncalled bet ($0.20) returned to HeyLo
HeyLo collected $0.25 from pot
HeyLo: doesn't show hand 
*** SUMMARY ***
Total pot $0.25 | Rake $0 
Seat 1: hempju1ce (big blind) folded before Flop
Seat 2: ojeriza folded before Flop (didn't bet)
Seat 3: robotov folded before Flop (didn't bet)
Seat 4: HeyLo collected ($0.25)
Seat 5: 19ElGringo91 (button) folded before Flop (didn't bet)
Seat 6: xScarface (small blind) folded before Flop



PokerStars Hand #222958685084:  Hold'em No Limit ($0.05/$0.10 USD) - 2021/01/23 11:19:09 ET
Table 'Bohlinia III' 6-max Seat #6 is the button
Seat 1: hempju1ce ($9.90 in chips) 
Seat 2: ojeriza ($10.15 in chips) 
Seat 3: robotov ($30.34 in chips) 
Seat 4: HeyLo ($11.61 in chips) 
Seat 5: 19ElGringo91 ($10.42 in chips) 
Seat 6: xScarface ($8.13 in chips) 
hempju1ce: posts small blind $0.05
ojeriza: posts big blind $0.10
*** HOLE CARDS ***
robotov: folds 
HeyLo: folds 
19ElGringo91: folds 
xScarface: folds 
hempju1ce: folds 
Uncalled bet ($0.05) returned to ojeriza
ojeriza collected $0.10 from pot
ojeriza: doesn't show hand 
*** SUMMARY ***
Total pot $0.10 | Rake $0 
Seat 1: hempju1ce (small blind) folded before Flop
Seat 2: ojeriza (big blind) collected ($0.10)
Seat 3: robotov folded before Flop (didn't bet)
Seat 4: HeyLo folded before Flop (didn't bet)
Seat 5: 19ElGringo91 folded before Flop (didn't bet)
Seat 6: xScarface (button) folded before Flop (didn't bet)



PokerStars Hand #222958691065:  Hold'em No Limit ($0.05/$0.10 USD) - 2021/01/23 11:19:19 ET
Table 'Bohlinia III' 6-max Seat #1 is the button
Seat 1: hempju1ce ($9.85 in chips) 
Seat 2: ojeriza ($10.20 in chips) 
Seat 3: robotov ($30.34 in chips) 
Seat 4: HeyLo ($11.61 in chips) 
Seat 5: 19ElGringo91 ($10.42 in chips) 
Seat 6: xScarface ($8.13 in chips) 
ojeriza: posts small blind $0.05
robotov: posts big blind $0.10
*** HOLE CARDS ***
HeyLo: folds 
19ElGringo91: folds 
xScarface: calls $0.10
hempju1ce: folds 
ojeriza: folds 
robotov: checks 
*** FLOP *** [9s 4d Ks]
robotov: checks 
xScarface: checks 
*** TURN *** [9s 4d Ks] [Kh]
robotov: checks 
xScarface: checks 
*** RIVER *** [9s 4d Ks Kh] [6s]
robotov: checks 
xScarface: checks 
*** SHOW DOWN ***
robotov: shows [4c Ad] (two pair, Kings and Fours)
xScarface: shows [Td 9d] (two pair, Kings and Nines)
xScarface collected $0.24 from pot
*** SUMMARY ***
Total pot $0.25 | Rake $0.01 
Board [9s 4d Ks Kh 6s]
Seat 1: hempju1ce (button) folded before Flop (didn't bet)
Seat 2: ojeriza (small blind) folded before Flop
Seat 3: robotov (big blind) showed [4c Ad] and lost with two pair, Kings and Fours
Seat 4: HeyLo folded before Flop (didn't bet)
Seat 5: 19ElGringo91 folded before Flop (didn't bet)
Seat 6: xScarface showed [Td 9d] and won ($0.24) with two pair, Kings and Nines



PokerStars Hand #222958733867:  Hold'em No Limit ($0.05/$0.10 USD) - 2021/01/23 11:20:30 ET
Table 'Bohlinia III' 6-max Seat #2 is the button
Seat 1: hempju1ce ($10 in chips) 
Seat 2: ojeriza ($10.15 in chips) 
Seat 3: robotov ($30.24 in chips) 
Seat 4: HeyLo ($11.61 in chips) 
Seat 5: 19ElGringo91 ($10.42 in chips) 
Seat 6: xScarface ($8.27 in chips) 
robotov: posts small blind $0.05
HeyLo: posts big blind $0.10
*** HOLE CARDS ***
19ElGringo91: folds 
xScarface: folds 
hempju1ce: folds 
xScarface leaves the table
ojeriza: raises $0.16 to $0.26
nathands93 joins the table at seat #6 
robotov: raises $0.62 to $0.88
HeyLo: folds 
ojeriza: folds 
Uncalled bet ($0.62) returned to robotov
robotov collected $0.62 from pot
robotov: doesn't show hand 
*** SUMMARY ***
Total pot $0.62 | Rake $0 
Seat 1: hempju1ce folded before Flop (didn't bet)
Seat 2: ojeriza (button) folded before Flop
Seat 3: robotov (small blind) collected ($0.62)
Seat 4: HeyLo (big blind) folded before Flop
Seat 5: 19ElGringo91 folded before Flop (didn't bet)
Seat 6: xScarface folded before Flop (didn't bet)



PokerStars Hand #222958756909:  Hold'em No Limit ($0.05/$0.10 USD) - 2021/01/23 11:21:08 ET
Table 'Bohlinia III' 6-max Seat #3 is the button
Seat 1: hempju1ce ($10 in chips) 
Seat 2: ojeriza ($10 in chips) 
Seat 3: robotov ($30.60 in chips) 
Seat 4: HeyLo ($11.51 in chips) 
Seat 5: 19ElGringo91 ($10.42 in chips) 
Seat 6: nathands93 ($6.01 in chips) 
HeyLo: posts small blind $0.05
19ElGringo91: posts big blind $0.10
nathands93: posts big blind $0.10
*** HOLE CARDS ***
nathands93: raises $0.10 to $0.20
hempju1ce: calls $0.20
ojeriza: folds 
robotov: folds 
HeyLo: folds 
19ElGringo91: folds 
*** FLOP *** [4d 2h 6d]
nathands93: bets $0.53
hempju1ce: folds 
Uncalled bet ($0.53) returned to nathands93
nathands93 collected $0.53 from pot
nathands93: doesn't show hand 
*** SUMMARY ***
Total pot $0.55 | Rake $0.02 
Board [4d 2h 6d]
Seat 1: hempju1ce folded on the Flop
Seat 2: ojeriza folded before Flop (didn't bet)
Seat 3: robotov (button) folded before Flop (didn't bet)
Seat 4: HeyLo (small blind) folded before Flop
Seat 5: 19ElGringo91 (big blind) folded before Flop
Seat 6: nathands93 collected ($0.53)



PokerStars Hand #222958783534:  Hold'em No Limit ($0.05/$0.10 USD) - 2021/01/23 11:21:52 ET
Table 'Bohlinia III' 6-max Seat #4 is the button
Seat 1: hempju1ce ($9.80 in chips) 
Seat 2: ojeriza ($10 in chips) 
Seat 3: robotov ($30.60 in chips) 
Seat 4: HeyLo ($11.46 in chips) 
Seat 5: 19ElGringo91 ($10.32 in chips) 
Seat 6: nathands93 ($6.34 in chips) 
19ElGringo91: posts small blind $0.05
nathands93: posts big blind $0.10
*** HOLE CARDS ***
hempju1ce: folds 
ojeriza: raises $0.20 to $0.30
robotov: raises $0.60 to $0.90
HeyLo: folds 
19ElGringo91: folds 
nathands93: folds 
ojeriza: calls $0.60
*** FLOP *** [Qd 2h 6d]
nathands93 leaves the table
ojeriza: checks 
robotov: bets $0.80
ojeriza: folds 
Uncalled bet ($0.80) returned to robotov
robotov collected $1.86 from pot
robotov: doesn't show hand 
volshebniknl joins the table at seat #6 
*** SUMMARY ***
Total pot $1.95 | Rake $0.09 
Board [Qd 2h 6d]
Seat 1: hempju1ce folded before Flop (didn't bet)
Seat 2: ojeriza folded on the Flop
Seat 3: robotov collected ($1.86)
Seat 4: HeyLo (button) folded before Flop (didn't bet)
Seat 5: 19ElGringo91 (small blind) folded before Flop
Seat 6: nathands93 (big blind) folded before Flop



PokerStars Hand #222958813086:  Hold'em No Limit ($0.05/$0.10 USD) - 2021/01/23 11:22:40 ET
Table 'Bohlinia III' 6-max Seat #5 is the button
Seat 1: hempju1ce ($9.80 in chips) 
Seat 3: robotov ($31.56 in chips) 
Seat 4: HeyLo ($11.46 in chips) 
Seat 5: 19ElGringo91 ($10.27 in chips) 
hempju1ce: posts small blind $0.05
ojeriza: is sitting out 
robotov: posts big blind $0.10
*** HOLE CARDS ***
HeyLo: folds 
19ElGringo91: folds 
hempju1ce: calls $0.05
robotov: raises $0.20 to $0.30
hempju1ce: calls $0.20
*** FLOP *** [8c 8h 5d]
hempju1ce: checks 
robotov: checks 
*** TURN *** [8c 8h 5d] [Th]
hempju1ce: bets $0.20
robotov: folds 
Uncalled bet ($0.20) returned to hempju1ce
hempju1ce collected $0.57 from pot
hempju1ce: doesn't show hand 
*** SUMMARY ***
Total pot $0.60 | Rake $0.03 
Board [8c 8h 5d Th]
Seat 1: hempju1ce (small blind) collected ($0.57)
Seat 3: robotov (big blind) folded on the Turn
Seat 4: HeyLo folded before Flop (didn't bet)
Seat 5: 19ElGringo91 (button) folded before Flop (didn't bet)



PokerStars Hand #222958826382:  Hold'em No Limit ($0.05/$0.10 USD) - 2021/01/23 11:23:02 ET
Table 'Bohlinia III' 6-max Seat #1 is the button
Seat 1: hempju1ce ($10.07 in chips) 
Seat 3: robotov ($31.26 in chips) 
Seat 4: HeyLo ($11.46 in chips) 
Seat 5: 19ElGringo91 ($10.27 in chips) 
robotov: posts small blind $0.05
HeyLo: posts big blind $0.10
volshebniknl: sits out 
*** HOLE CARDS ***
19ElGringo91: raises $0.20 to $0.30
hempju1ce: folds 
robotov: folds 
HeyLo: folds 
Uncalled bet ($0.20) returned to 19ElGringo91
19ElGringo91 collected $0.25 from pot
19ElGringo91: doesn't show hand 
*** SUMMARY ***
Total pot $0.25 | Rake $0 
Seat 1: hempju1ce (button) folded before Flop (didn't bet)
Seat 3: robotov (small blind) folded before Flop
Seat 4: HeyLo (big blind) folded before Flop
Seat 5: 19ElGringo91 collected ($0.25)



PokerStars Hand #222958833935:  Hold'em No Limit ($0.05/$0.10 USD) - 2021/01/23 11:23:15 ET
Table 'Bohlinia III' 6-max Seat #3 is the button
Seat 1: hempju1ce ($10.07 in chips) 
Seat 3: robotov ($31.21 in chips) 
Seat 4: HeyLo ($11.36 in chips) 
Seat 5: 19ElGringo91 ($10.42 in chips) 
HeyLo: posts small blind $0.05
19ElGringo91: posts big blind $0.10
volshebniknl: sits out 
*** HOLE CARDS ***
hempju1ce: raises $0.20 to $0.30
robotov: folds 
HeyLo: folds 
19ElGringo91: folds 
Uncalled bet ($0.20) returned to hempju1ce
hempju1ce collected $0.25 from pot
hempju1ce: doesn't show hand 
*** SUMMARY ***
Total pot $0.25 | Rake $0 
Seat 1: hempju1ce collected ($0.25)
Seat 3: robotov (button) folded before Flop (didn't bet)
Seat 4: HeyLo (small blind) folded before Flop
Seat 5: 19ElGringo91 (big blind) folded before Flop



PokerStars Hand #222958839985:  Hold'em No Limit ($0.05/$0.10 USD) - 2021/01/23 11:23:25 ET
Table 'Bohlinia III' 6-max Seat #4 is the button
Seat 1: hempju1ce ($10.22 in chips) 
Seat 3: robotov ($31.21 in chips) 
Seat 4: HeyLo ($11.31 in chips) 
Seat 5: 19ElGringo91 ($10.32 in chips) 
Seat 6: volshebniknl ($10 in chips) 
19ElGringo91: posts small blind $0.05
volshebniknl: posts big blind $0.10
*** HOLE CARDS ***
hempju1ce: folds 
robotov: folds 
ojeriza leaves the table
HeyLo: raises $0.20 to $0.30
19ElGringo91: raises $0.70 to $1
volshebniknl: folds 
HeyLo: calls $0.70
*** FLOP *** [3c 8c 7c]
19ElGringo91: checks 
HeyLo: checks 
*** TURN *** [3c 8c 7c] [Jc]
19ElGringo91: checks 
HeyLo: checks 
*** RIVER *** [3c 8c 7c Jc] [Ks]
19ElGringo91: checks 
HeyLo: checks 
*** SHOW DOWN ***
19ElGringo91: shows [9s 9d] (a pair of Nines)
HeyLo: mucks hand 
19ElGringo91 collected $2.01 from pot
*** SUMMARY ***
Total pot $2.10 | Rake $0.09 
Board [3c 8c 7c Jc Ks]
Seat 1: hempju1ce folded before Flop (didn't bet)
Seat 3: robotov folded before Flop (didn't bet)
Seat 4: HeyLo (button) mucked
Seat 5: 19ElGringo91 (small blind) showed [9s 9d] and won ($2.01) with a pair of Nines
Seat 6: volshebniknl (big blind) folded before Flop



PokerStars Hand #222958861521:  Hold'em No Limit ($0.05/$0.10 USD) - 2021/01/23 11:24:00 ET
Table 'Bohlinia III' 6-max Seat #5 is the button
Seat 1: hempju1ce ($10.22 in chips) 
Seat 3: robotov ($31.21 in chips) 
Seat 4: HeyLo ($10.31 in chips) 
Seat 5: 19ElGringo91 ($11.33 in chips) 
Seat 6: volshebniknl ($10 in chips) 
volshebniknl: posts small blind $0.05
hempju1ce: posts big blind $0.10
*** HOLE CARDS ***
robotov: folds 
HeyLo: raises $0.20 to $0.30
19ElGringo91: folds 
volshebniknl: folds 
hempju1ce: folds 
Uncalled bet ($0.20) returned to HeyLo
HeyLo collected $0.25 from pot
HeyLo: doesn't show hand 
*** SUMMARY ***
Total pot $0.25 | Rake $0 
Seat 1: hempju1ce (big blind) folded before Flop
Seat 3: robotov folded before Flop (didn't bet)
Seat 4: HeyLo collected ($0.25)
Seat 5: 19ElGringo91 (button) folded before Flop (didn't bet)
Seat 6: volshebniknl (small blind) folded before Flop



PokerStars Hand #222958874983:  Hold'em No Limit ($0.05/$0.10 USD) - 2021/01/23 11:24:22 ET
Table 'Bohlinia III' 6-max Seat #6 is the button
Seat 1: hempju1ce ($10.12 in chips) 
Seat 4: HeyLo ($10.46 in chips) 
Seat 5: 19ElGringo91 ($11.33 in chips) 
Seat 6: volshebniknl ($10 in chips) 
hempju1ce: posts small blind $0.05
robotov: is sitting out 
HeyLo: posts big blind $0.10
*** HOLE CARDS ***
19ElGringo91: folds 
robotov leaves the table
volshebniknl: folds 
hempju1ce: folds 
Uncalled bet ($0.05) returned to HeyLo
HeyLo collected $0.10 from pot
HeyLo: doesn't show hand 
*** SUMMARY ***
Total pot $0.10 | Rake $0 
Seat 1: hempju1ce (small blind) folded before Flop
Seat 4: HeyLo (big blind) collected ($0.10)
Seat 5: 19ElGringo91 folded before Flop (didn't bet)
Seat 6: volshebniknl (button) folded before Flop (didn't bet)



PokerStars Hand #222958883189:  Hold'em No Limit ($0.05/$0.10 USD) - 2021/01/23 11:24:36 ET
Table 'Bohlinia III' 6-max Seat #1 is the button
Seat 1: hempju1ce ($10.07 in chips) 
Seat 4: HeyLo ($10.51 in chips) 
Seat 5: 19ElGringo91 ($11.33 in chips) 
Seat 6: volshebniknl ($10 in chips) 
HeyLo: posts small blind $0.05
19ElGringo91: posts big blind $0.10
*** HOLE CARDS ***
volshebniknl: folds 
hempju1ce: calls $0.10
HeyLo: folds 
19ElGringo91: checks 
*** FLOP *** [5h 2d Qs]
19ElGringo91: checks 
hempju1ce: checks 
*** TURN *** [5h 2d Qs] [6d]
19ElGringo91: checks 
hempju1ce: checks 
*** RIVER *** [5h 2d Qs 6d] [5d]
19ElGringo91: checks 
hempju1ce: checks 
*** SHOW DOWN ***
19ElGringo91: shows [Jd 9s] (a pair of Fives)
hempju1ce: shows [Kc 3c] (a pair of Fives - King kicker)
hempju1ce collected $0.24 from pot
*** SUMMARY ***
Total pot $0.25 | Rake $0.01 
Board [5h 2d Qs 6d 5d]
Seat 1: hempju1ce (button) showed [Kc 3c] and won ($0.24) with a pair of Fives
Seat 4: HeyLo (small blind) folded before Flop
Seat 5: 19ElGringo91 (big blind) showed [Jd 9s] and lost with a pair of Fives
Seat 6: volshebniknl folded before Flop (didn't bet)



PokerStars Hand #222958903788:  Hold'em No Limit ($0.05/$0.10 USD) - 2021/01/23 11:25:10 ET
Table 'Bohlinia III' 6-max Seat #4 is the button
Seat 1: hempju1ce ($10.21 in chips) 
Seat 4: HeyLo ($10.46 in chips) 
Seat 5: 19ElGringo91 ($11.23 in chips) 
Seat 6: volshebniknl ($10 in chips) 
19ElGringo91: posts small blind $0.05
volshebniknl: posts big blind $0.10
*** HOLE CARDS ***
hempju1ce has timed out
hempju1ce: folds 
HeyLo: raises $0.20 to $0.30
vilemo20 joins the table at seat #2 
19ElGringo91: raises $0.70 to $1
volshebniknl: folds 
HeyLo: calls $0.70
*** FLOP *** [6h Ad 6s]
19ElGringo91: bets $0.50
HeyLo: raises $2.01 to $2.51
19ElGringo91: calls $2.01
*** TURN *** [6h Ad 6s] [5h]
19ElGringo91: checks 
HeyLo: checks 
*** RIVER *** [6h Ad 6s 5h] [Ks]
19ElGringo91: checks 
HeyLo: bets $6.80
19ElGringo91: calls $6.80
*** SHOW DOWN ***
HeyLo: shows [Kh As] (two pair, Aces and Kings)
19ElGringo91: mucks hand 
HeyLo collected $19.79 from pot
*** SUMMARY ***
Total pot $20.72 | Rake $0.93 
Board [6h Ad 6s 5h Ks]
Seat 1: hempju1ce folded before Flop (didn't bet)
Seat 4: HeyLo (button) showed [Kh As] and won ($19.79) with two pair, Aces and Kings
Seat 5: 19ElGringo91 (small blind) mucked
Seat 6: volshebniknl (big blind) folded before Flop



PokerStars Hand #222958940751:  Hold'em No Limit ($0.05/$0.10 USD) - 2021/01/23 11:26:11 ET
Table 'Bohlinia III' 6-max Seat #5 is the button
Seat 2: vilemo20 ($10 in chips) 
Seat 4: HeyLo ($19.94 in chips) 
Seat 5: 19ElGringo91 ($10 in chips) 
Seat 6: volshebniknl ($10 in chips) 
volshebniknl: posts small blind $0.05
hempju1ce: is sitting out 
vilemo20: posts big blind $0.10
*** HOLE CARDS ***
HeyLo: folds 
19ElGringo91: folds 
volshebniknl: folds 
Uncalled bet ($0.05) returned to vilemo20
vilemo20 collected $0.10 from pot
vilemo20: doesn't show hand 
*** SUMMARY ***
Total pot $0.10 | Rake $0 
Seat 2: vilemo20 (big blind) collected ($0.10)
Seat 4: HeyLo folded before Flop (didn't bet)
Seat 5: 19ElGringo91 (button) folded before Flop (didn't bet)
Seat 6: volshebniknl (small blind) folded before Flop



PokerStars Hand #222958944807:  Hold'em No Limit ($0.05/$0.10 USD) - 2021/01/23 11:26:17 ET
Table 'Bohlinia III' 6-max Seat #6 is the button
Seat 2: vilemo20 ($10.05 in chips) 
Seat 4: HeyLo ($19.94 in chips) 
Seat 5: 19ElGringo91 ($10 in chips) 
Seat 6: volshebniknl ($10 in chips) 
vilemo20: posts small blind $0.05
HeyLo: posts big blind $0.10
*** HOLE CARDS ***
19ElGringo91: folds 
volshebniknl: raises $0.20 to $0.30
vilemo20: folds 
HeyLo: folds 
Uncalled bet ($0.20) returned to volshebniknl
volshebniknl collected $0.25 from pot
volshebniknl: doesn't show hand 
*** SUMMARY ***
Total pot $0.25 | Rake $0 
Seat 2: vilemo20 (small blind) folded before Flop
Seat 4: HeyLo (big blind) folded before Flop
Seat 5: 19ElGringo91 folded before Flop (didn't bet)
Seat 6: volshebniknl (button) collected ($0.25)



PokerStars Hand #222958960645:  Hold'em No Limit ($0.05/$0.10 USD) - 2021/01/23 11:26:38 ET
Table 'Bohlinia III' 6-max Seat #2 is the button
Seat 2: vilemo20 ($10 in chips) 
Seat 4: HeyLo ($19.84 in chips) 
Seat 5: 19ElGringo91 ($10 in chips) 
Seat 6: volshebniknl ($10.15 in chips) 
HeyLo: posts small blind $0.05
19ElGringo91: posts big blind $0.10
hempju1ce: sits out 
*** HOLE CARDS ***
volshebniknl: raises $0.20 to $0.30
vilemo20: folds 
HeyLo: folds 
19ElGringo91: folds 
Uncalled bet ($0.20) returned to volshebniknl
volshebniknl collected $0.25 from pot
volshebniknl: doesn't show hand 
*** SUMMARY ***
Total pot $0.25 | Rake $0 
Seat 2: vilemo20 (button) folded before Flop (didn't bet)
Seat 4: HeyLo (small blind) folded before Flop
Seat 5: 19ElGringo91 (big blind) folded before Flop
Seat 6: volshebniknl collected ($0.25)



PokerStars Hand #222958968452:  Hold'em No Limit ($0.05/$0.10 USD) - 2021/01/23 11:26:51 ET
Table 'Bohlinia III' 6-max Seat #4 is the button
Seat 2: vilemo20 ($10 in chips) 
Seat 4: HeyLo ($19.79 in chips) 
Seat 5: 19ElGringo91 ($10 in chips) 
Seat 6: volshebniknl ($10.30 in chips) 
19ElGringo91: posts small blind $0.05
volshebniknl: posts big blind $0.10
hempju1ce: sits out 
*** HOLE CARDS ***
vilemo20: folds 
HeyLo: folds 
19ElGringo91: folds 
Uncalled bet ($0.05) returned to volshebniknl
volshebniknl collected $0.10 from pot
volshebniknl: doesn't show hand 
*** SUMMARY ***
Total pot $0.10 | Rake $0 
Seat 2: vilemo20 folded before Flop (didn't bet)
Seat 4: HeyLo (button) folded before Flop (didn't bet)
Seat 5: 19ElGringo91 (small blind) folded before Flop
Seat 6: volshebniknl (big blind) collected ($0.10)



PokerStars Hand #222958973685:  Hold'em No Limit ($0.05/$0.10 USD) - 2021/01/23 11:27:00 ET
Table 'Bohlinia III' 6-max Seat #5 is the button
Seat 1: hempju1ce ($10.21 in chips) 
Seat 2: vilemo20 ($10 in chips) 
Seat 4: HeyLo ($19.79 in chips) 
Seat 5: 19ElGringo91 ($10 in chips) 
Seat 6: volshebniknl ($10.35 in chips) 
volshebniknl: posts small blind $0.05
hempju1ce: posts big blind $0.10
*** HOLE CARDS ***
vilemo20: folds 
HeyLo: folds 
19ElGringo91: folds 
volshebniknl: folds 
Uncalled bet ($0.05) returned to hempju1ce
hempju1ce collected $0.10 from pot
hempju1ce: doesn't show hand 
*** SUMMARY ***
Total pot $0.10 | Rake $0 
Seat 1: hempju1ce (big blind) collected ($0.10)
Seat 2: vilemo20 folded before Flop (didn't bet)
Seat 4: HeyLo folded before Flop (didn't bet)
Seat 5: 19ElGringo91 (button) folded before Flop (didn't bet)
Seat 6: volshebniknl (small blind) folded before Flop



PokerStars Hand #222958979289:  Hold'em No Limit ($0.05/$0.10 USD) - 2021/01/23 11:27:09 ET
Table 'Bohlinia III' 6-max Seat #6 is the button
Seat 1: hempju1ce ($10.26 in chips) 
Seat 2: vilemo20 ($10 in chips) 
Seat 4: HeyLo ($19.79 in chips) 
Seat 5: 19ElGringo91 ($10 in chips) 
Seat 6: volshebniknl ($10.30 in chips) 
hempju1ce: posts small blind $0.05
vilemo20: posts big blind $0.10
*** HOLE CARDS ***
HeyLo: folds 
19ElGringo91: folds 
yYanniky joins the table at seat #3 
volshebniknl: raises $0.20 to $0.30
hempju1ce: folds 
vilemo20: folds 
Uncalled bet ($0.20) returned to volshebniknl
volshebniknl collected $0.25 from pot
volshebniknl: doesn't show hand 
*** SUMMARY ***
Total pot $0.25 | Rake $0 
Seat 1: hempju1ce (small blind) folded before Flop
Seat 2: vilemo20 (big blind) folded before Flop
Seat 4: HeyLo folded before Flop (didn't bet)
Seat 5: 19ElGringo91 folded before Flop (didn't bet)
Seat 6: volshebniknl (button) collected ($0.25)



PokerStars Hand #222958987348:  Hold'em No Limit ($0.05/$0.10 USD) - 2021/01/23 11:27:22 ET
Table 'Bohlinia III' 6-max Seat #1 is the button
Seat 1: hempju1ce ($10.21 in chips) 
Seat 2: vilemo20 ($10 in chips) 
Seat 3: yYanniky ($10 in chips) 
Seat 4: HeyLo ($19.79 in chips) 
Seat 5: 19ElGringo91 ($10 in chips) 
Seat 6: volshebniknl ($10.45 in chips) 
vilemo20: posts small blind $0.05
yYanniky: posts big blind $0.10
*** HOLE CARDS ***
HeyLo: raises $0.20 to $0.30
19ElGringo91: folds 
volshebniknl: folds 
hempju1ce: folds 
vilemo20: folds 
yYanniky: folds 
Uncalled bet ($0.20) returned to HeyLo
HeyLo collected $0.25 from pot
HeyLo: doesn't show hand 
*** SUMMARY ***
Total pot $0.25 | Rake $0 
Seat 1: hempju1ce (button) folded before Flop (didn't bet)
Seat 2: vilemo20 (small blind) folded before Flop
Seat 3: yYanniky (big blind) folded before Flop
Seat 4: HeyLo collected ($0.25)
Seat 5: 19ElGringo91 folded before Flop (didn't bet)
Seat 6: volshebniknl folded before Flop (didn't bet)



PokerStars Hand #222958999185:  Hold'em No Limit ($0.05/$0.10 USD) - 2021/01/23 11:27:41 ET
Table 'Bohlinia III' 6-max Seat #2 is the button
Seat 1: hempju1ce ($10.21 in chips) 
Seat 2: vilemo20 ($10 in chips) 
Seat 3: yYanniky ($10 in chips) 
Seat 4: HeyLo ($19.94 in chips) 
Seat 5: 19ElGringo91 ($10 in chips) 
Seat 6: volshebniknl ($10.45 in chips) 
yYanniky: posts small blind $0.05
HeyLo: posts big blind $0.10
*** HOLE CARDS ***
19ElGringo91: raises $0.20 to $0.30
volshebniknl: folds 
hempju1ce: folds 
vilemo20: folds 
yYanniky: folds 
HeyLo: folds 
Uncalled bet ($0.20) returned to 19ElGringo91
19ElGringo91 collected $0.25 from pot
19ElGringo91: doesn't show hand 
*** SUMMARY ***
Total pot $0.25 | Rake $0 
Seat 1: hempju1ce folded before Flop (didn't bet)
Seat 2: vilemo20 (button) folded before Flop (didn't bet)
Seat 3: yYanniky (small blind) folded before Flop
Seat 4: HeyLo (big blind) folded before Flop
Seat 5: 19ElGringo91 collected ($0.25)
Seat 6: volshebniknl folded before Flop (didn't bet)



PokerStars Hand #222959007770:  Hold'em No Limit ($0.05/$0.10 USD) - 2021/01/23 11:27:56 ET
Table 'Bohlinia III' 6-max Seat #3 is the button
Seat 1: hempju1ce ($10.21 in chips) 
Seat 2: vilemo20 ($10 in chips) 
Seat 3: yYanniky ($10 in chips) 
Seat 4: HeyLo ($19.84 in chips) 
Seat 5: 19ElGringo91 ($10.15 in chips) 
Seat 6: volshebniknl ($10.45 in chips) 
HeyLo: posts small blind $0.05
19ElGringo91: posts big blind $0.10
*** HOLE CARDS ***
volshebniknl: folds 
hempju1ce: folds 
vilemo20: folds 
yYanniky: folds 
HeyLo: folds 
Uncalled bet ($0.05) returned to 19ElGringo91
19ElGringo91 collected $0.10 from pot
19ElGringo91: doesn't show hand 
*** SUMMARY ***
Total pot $0.10 | Rake $0 
Seat 1: hempju1ce folded before Flop (didn't bet)
Seat 2: vilemo20 folded before Flop (didn't bet)
Seat 3: yYanniky (button) folded before Flop (didn't bet)
Seat 4: HeyLo (small blind) folded before Flop
Seat 5: 19ElGringo91 (big blind) collected ($0.10)
Seat 6: volshebniknl folded before Flop (didn't bet)



PokerStars Hand #222959014697:  Hold'em No Limit ($0.05/$0.10 USD) - 2021/01/23 11:28:07 ET
Table 'Bohlinia III' 6-max Seat #4 is the button
Seat 1: hempju1ce ($10.21 in chips) 
Seat 2: vilemo20 ($10 in chips) 
Seat 3: yYanniky ($10 in chips) 
Seat 4: HeyLo ($19.79 in chips) 
Seat 5: 19ElGringo91 ($10.20 in chips) 
Seat 6: volshebniknl ($10.45 in chips) 
19ElGringo91: posts small blind $0.05
volshebniknl: posts big blind $0.10
*** HOLE CARDS ***
hempju1ce: folds 
vilemo20: folds 
yYanniky: raises $0.15 to $0.25
HeyLo: folds 
19ElGringo91: folds 
volshebniknl: folds 
Uncalled bet ($0.15) returned to yYanniky
yYanniky collected $0.25 from pot
yYanniky: doesn't show hand 
*** SUMMARY ***
Total pot $0.25 | Rake $0 
Seat 1: hempju1ce folded before Flop (didn't bet)
Seat 2: vilemo20 folded before Flop (didn't bet)
Seat 3: yYanniky collected ($0.25)
Seat 4: HeyLo (button) folded before Flop (didn't bet)
Seat 5: 19ElGringo91 (small blind) folded before Flop
Seat 6: volshebniknl (big blind) folded before Flop



PokerStars Hand #222959025546:  Hold'em No Limit ($0.05/$0.10 USD) - 2021/01/23 11:28:25 ET
Table 'Bohlinia III' 6-max Seat #5 is the button
Seat 1: hempju1ce ($10.21 in chips) 
Seat 2: vilemo20 ($10 in chips) 
Seat 3: yYanniky ($10.15 in chips) 
Seat 4: HeyLo ($19.79 in chips) 
Seat 5: 19ElGringo91 ($10.15 in chips) 
Seat 6: volshebniknl ($10.35 in chips) 
volshebniknl: posts small blind $0.05
hempju1ce: posts big blind $0.10
*** HOLE CARDS ***
vilemo20: folds 
yYanniky: folds 
HeyLo: raises $0.20 to $0.30
19ElGringo91: raises $0.60 to $0.90
volshebniknl: folds 
hempju1ce: folds 
HeyLo: calls $0.60
*** FLOP *** [4h Ks 2c]
HeyLo: checks 
19ElGringo91: bets $0.61
HeyLo: calls $0.61
*** TURN *** [4h Ks 2c] [5s]
HeyLo: checks 
19ElGringo91: bets $2.27
HeyLo: folds 
Uncalled bet ($2.27) returned to 19ElGringo91
19ElGringo91 collected $3.03 from pot
19ElGringo91: doesn't show hand 
*** SUMMARY ***
Total pot $3.17 | Rake $0.14 
Board [4h Ks 2c 5s]
Seat 1: hempju1ce (big blind) folded before Flop
Seat 2: vilemo20 folded before Flop (didn't bet)
Seat 3: yYanniky folded before Flop (didn't bet)
Seat 4: HeyLo folded on the Turn
Seat 5: 19ElGringo91 (button) collected ($3.03)
Seat 6: volshebniknl (small blind) folded before Flop



PokerStars Hand #222959056607:  Hold'em No Limit ($0.05/$0.10 USD) - 2021/01/23 11:29:16 ET
Table 'Bohlinia III' 6-max Seat #6 is the button
Seat 1: hempju1ce ($10.11 in chips) 
Seat 2: vilemo20 ($10 in chips) 
Seat 3: yYanniky ($10.15 in chips) 
Seat 4: HeyLo ($18.28 in chips) 
Seat 5: 19ElGringo91 ($11.67 in chips) 
Seat 6: volshebniknl ($10.30 in chips) 
hempju1ce: posts small blind $0.05
vilemo20: posts big blind $0.10
*** HOLE CARDS ***
yYanniky: folds 
HeyLo: folds 
19ElGringo91: raises $0.20 to $0.30
volshebniknl: folds 
hempju1ce: folds 
vilemo20: folds 
Uncalled bet ($0.20) returned to 19ElGringo91
19ElGringo91 collected $0.25 from pot
19ElGringo91: doesn't show hand 
*** SUMMARY ***
Total pot $0.25 | Rake $0 
Seat 1: hempju1ce (small blind) folded before Flop
Seat 2: vilemo20 (big blind) folded before Flop
Seat 3: yYanniky folded before Flop (didn't bet)
Seat 4: HeyLo folded before Flop (didn't bet)
Seat 5: 19ElGringo91 collected ($0.25)
Seat 6: volshebniknl (button) folded before Flop (didn't bet)



PokerStars Hand #222959076753:  Hold'em No Limit ($0.05/$0.10 USD) - 2021/01/23 11:29:47 ET
Table 'Bohlinia III' 6-max Seat #1 is the button
Seat 1: hempju1ce ($10.06 in chips) 
Seat 2: vilemo20 ($10 in chips) 
Seat 3: yYanniky ($10.15 in chips) 
Seat 4: HeyLo ($18.28 in chips) 
Seat 5: 19ElGringo91 ($11.82 in chips) 
Seat 6: volshebniknl ($10.30 in chips) 
vilemo20: posts small blind $0.05
yYanniky: posts big blind $0.10
*** HOLE CARDS ***
HeyLo: raises $0.20 to $0.30
19ElGringo91: folds 
volshebniknl: folds 
hempju1ce: calls $0.30
vilemo20: folds 
yYanniky: folds 
*** FLOP *** [4c Js Jh]
HeyLo: checks 
hempju1ce: checks 
*** TURN *** [4c Js Jh] [Td]
HeyLo: checks 
hempju1ce: checks 
*** RIVER *** [4c Js Jh Td] [8c]
HeyLo: checks 
hempju1ce: checks 
*** SHOW DOWN ***
HeyLo: shows [7c 6c] (a pair of Jacks)
hempju1ce: shows [9h 9d] (two pair, Jacks and Nines)
hempju1ce collected $0.72 from pot
*** SUMMARY ***
Total pot $0.75 | Rake $0.03 
Board [4c Js Jh Td 8c]
Seat 1: hempju1ce (button) showed [9h 9d] and won ($0.72) with two pair, Jacks and Nines
Seat 2: vilemo20 (small blind) folded before Flop
Seat 3: yYanniky (big blind) folded before Flop
Seat 4: HeyLo showed [7c 6c] and lost with a pair of Jacks
Seat 5: 19ElGringo91 folded before Flop (didn't bet)
Seat 6: volshebniknl folded before Flop (didn't bet)



PokerStars Hand #222959108127:  Hold'em No Limit ($0.05/$0.10 USD) - 2021/01/23 11:30:37 ET
Table 'Bohlinia III' 6-max Seat #2 is the button
Seat 1: hempju1ce ($10.48 in chips) 
Seat 2: vilemo20 ($10 in chips) 
Seat 3: yYanniky ($10.05 in chips) 
Seat 4: HeyLo ($17.98 in chips) 
Seat 5: 19ElGringo91 ($11.82 in chips) 
Seat 6: volshebniknl ($10.30 in chips) 
yYanniky: posts small blind $0.05
HeyLo: posts big blind $0.10
*** HOLE CARDS ***
19ElGringo91: folds 
volshebniknl: folds 
hempju1ce: calls $0.10
vilemo20: raises $0.30 to $0.40
yYanniky: folds 
HeyLo: folds 
hempju1ce: folds 
Uncalled bet ($0.30) returned to vilemo20
vilemo20 collected $0.35 from pot
vilemo20: doesn't show hand 
*** SUMMARY ***
Total pot $0.35 | Rake $0 
Seat 1: hempju1ce folded before Flop
Seat 2: vilemo20 (button) collected ($0.35)
Seat 3: yYanniky (small blind) folded before Flop
Seat 4: HeyLo (big blind) folded before Flop
Seat 5: 19ElGringo91 folded before Flop (didn't bet)
Seat 6: volshebniknl folded before Flop (didn't bet)



PokerStars Hand #222959122333:  Hold'em No Limit ($0.05/$0.10 USD) - 2021/01/23 11:31:01 ET
Table 'Bohlinia III' 6-max Seat #3 is the button
Seat 1: hempju1ce ($10.38 in chips) 
Seat 2: vilemo20 ($10.25 in chips) 
Seat 3: yYanniky ($10 in chips) 
Seat 4: HeyLo ($17.88 in chips) 
Seat 5: 19ElGringo91 ($11.82 in chips) 
Seat 6: volshebniknl ($10.30 in chips) 
HeyLo: posts small blind $0.05
19ElGringo91: posts big blind $0.10
*** HOLE CARDS ***
volshebniknl: raises $0.20 to $0.30
hempju1ce: calls $0.30
vilemo20: calls $0.30
yYanniky: folds 
HeyLo: folds 
19ElGringo91: folds 
*** FLOP *** [3c 6s 2c]
volshebniknl: bets $0.77
hempju1ce: folds 
vilemo20: raises $1.54 to $2.31
volshebniknl: folds 
Uncalled bet ($1.54) returned to vilemo20
vilemo20 collected $2.47 from pot
vilemo20: doesn't show hand 
*** SUMMARY ***
Total pot $2.59 | Rake $0.12 
Board [3c 6s 2c]
Seat 1: hempju1ce folded on the Flop
Seat 2: vilemo20 collected ($2.47)
Seat 3: yYanniky (button) folded before Flop (didn't bet)
Seat 4: HeyLo (small blind) folded before Flop
Seat 5: 19ElGringo91 (big blind) folded before Flop
Seat 6: volshebniknl folded on the Flop



PokerStars Hand #222959159183:  Hold'em No Limit ($0.05/$0.10 USD) - 2021/01/23 11:32:01 ET
Table 'Bohlinia III' 6-max Seat #4 is the button
Seat 1: hempju1ce ($10.08 in chips) 
Seat 2: vilemo20 ($11.65 in chips) 
Seat 3: yYanniky ($10 in chips) 
Seat 4: HeyLo ($17.83 in chips) 
Seat 5: 19ElGringo91 ($11.72 in chips) 
Seat 6: volshebniknl ($10 in chips) 
19ElGringo91: posts small blind $0.05
volshebniknl: posts big blind $0.10
*** HOLE CARDS ***
hempju1ce: folds 
vilemo20: folds 
yYanniky: raises $0.15 to $0.25
HeyLo: folds 
19ElGringo91: folds 
volshebniknl: folds 
Uncalled bet ($0.15) returned to yYanniky
yYanniky collected $0.25 from pot
yYanniky: doesn't show hand 
*** SUMMARY ***
Total pot $0.25 | Rake $0 
Seat 1: hempju1ce folded before Flop (didn't bet)
Seat 2: vilemo20 folded before Flop (didn't bet)
Seat 3: yYanniky collected ($0.25)
Seat 4: HeyLo (button) folded before Flop (didn't bet)
Seat 5: 19ElGringo91 (small blind) folded before Flop
Seat 6: volshebniknl (big blind) folded before Flop



PokerStars Hand #222959171123:  Hold'em No Limit ($0.05/$0.10 USD) - 2021/01/23 11:32:20 ET
Table 'Bohlinia III' 6-max Seat #5 is the button
Seat 1: hempju1ce ($10.08 in chips) 
Seat 2: vilemo20 ($11.65 in chips) 
Seat 3: yYanniky ($10.15 in chips) 
Seat 4: HeyLo ($17.83 in chips) 
Seat 5: 19ElGringo91 ($11.67 in chips) 
Seat 6: volshebniknl ($10 in chips) 
volshebniknl: posts small blind $0.05
hempju1ce: posts big blind $0.10
*** HOLE CARDS ***
vilemo20: folds 
yYanniky: folds 
HeyLo: raises $0.20 to $0.30
19ElGringo91: folds 
volshebniknl: folds 
hempju1ce: calls $0.20
*** FLOP *** [6h Tc 8h]
hempju1ce: checks 
HeyLo: bets $0.40
hempju1ce: calls $0.40
*** TURN *** [6h Tc 8h] [Js]
hempju1ce: checks 
HeyLo: checks 
*** RIVER *** [6h Tc 8h Js] [Ah]
hempju1ce: bets $1.38
HeyLo: calls $1.38
*** SHOW DOWN ***
hempju1ce: shows [6s 6c] (three of a kind, Sixes)
HeyLo: mucks hand 
hempju1ce collected $4.02 from pot
*** SUMMARY ***
Total pot $4.21 | Rake $0.19 
Board [6h Tc 8h Js Ah]
Seat 1: hempju1ce (big blind) showed [6s 6c] and won ($4.02) with three of a kind, Sixes
Seat 2: vilemo20 folded before Flop (didn't bet)
Seat 3: yYanniky folded before Flop (didn't bet)
Seat 4: HeyLo mucked
Seat 5: 19ElGringo91 (button) folded before Flop (didn't bet)
Seat 6: volshebniknl (small blind) folded before Flop



PokerStars Hand #222959198132:  Hold'em No Limit ($0.05/$0.10 USD) - 2021/01/23 11:33:04 ET
Table 'Bohlinia III' 6-max Seat #6 is the button
Seat 1: hempju1ce ($12.02 in chips) 
Seat 2: vilemo20 ($11.65 in chips) 
Seat 3: yYanniky ($10.15 in chips) 
Seat 4: HeyLo ($15.75 in chips) 
Seat 5: 19ElGringo91 ($11.67 in chips) 
Seat 6: volshebniknl ($10 in chips) 
hempju1ce: posts small blind $0.05
vilemo20: posts big blind $0.10
*** HOLE CARDS ***
yYanniky: folds 
HeyLo: folds 
19ElGringo91: folds 
volshebniknl: folds 
hempju1ce: folds 
Uncalled bet ($0.05) returned to vilemo20
vilemo20 collected $0.10 from pot
vilemo20: doesn't show hand 
*** SUMMARY ***
Total pot $0.10 | Rake $0 
Seat 1: hempju1ce (small blind) folded before Flop
Seat 2: vilemo20 (big blind) collected ($0.10)
Seat 3: yYanniky folded before Flop (didn't bet)
Seat 4: HeyLo folded before Flop (didn't bet)
Seat 5: 19ElGringo91 folded before Flop (didn't bet)
Seat 6: volshebniknl (button) folded before Flop (didn't bet)



PokerStars Hand #222959206652:  Hold'em No Limit ($0.05/$0.10 USD) - 2021/01/23 11:33:17 ET
Table 'Bohlinia III' 6-max Seat #1 is the button
Seat 1: hempju1ce ($11.97 in chips) 
Seat 2: vilemo20 ($11.70 in chips) 
Seat 3: yYanniky ($10.15 in chips) 
Seat 4: HeyLo ($15.75 in chips) 
Seat 5: 19ElGringo91 ($11.67 in chips) 
Seat 6: volshebniknl ($10 in chips) 
vilemo20: posts small blind $0.05
yYanniky: posts big blind $0.10
*** HOLE CARDS ***
HeyLo: folds 
19ElGringo91: folds 
volshebniknl: folds 
hempju1ce: folds 
vilemo20: folds 
Uncalled bet ($0.05) returned to yYanniky
yYanniky collected $0.10 from pot
yYanniky: doesn't show hand 
*** SUMMARY ***
Total pot $0.10 | Rake $0 
Seat 1: hempju1ce (button) folded before Flop (didn't bet)
Seat 2: vilemo20 (small blind) folded before Flop
Seat 3: yYanniky (big blind) collected ($0.10)
Seat 4: HeyLo folded before Flop (didn't bet)
Seat 5: 19ElGringo91 folded before Flop (didn't bet)
Seat 6: volshebniknl folded before Flop (didn't bet)



PokerStars Hand #222959215724:  Hold'em No Limit ($0.05/$0.10 USD) - 2021/01/23 11:33:32 ET
Table 'Bohlinia III' 6-max Seat #2 is the button
Seat 1: hempju1ce ($11.97 in chips) 
Seat 2: vilemo20 ($11.65 in chips) 
Seat 3: yYanniky ($10.20 in chips) 
Seat 4: HeyLo ($15.75 in chips) 
Seat 5: 19ElGringo91 ($11.67 in chips) 
Seat 6: volshebniknl ($10 in chips) 
yYanniky: posts small blind $0.05
HeyLo: posts big blind $0.10
*** HOLE CARDS ***
19ElGringo91: raises $0.20 to $0.30
volshebniknl: folds 
hempju1ce: folds 
vilemo20: folds 
yYanniky: folds 
HeyLo: folds 
Uncalled bet ($0.20) returned to 19ElGringo91
19ElGringo91 collected $0.25 from pot
19ElGringo91: doesn't show hand 
*** SUMMARY ***
Total pot $0.25 | Rake $0 
Seat 1: hempju1ce folded before Flop (didn't bet)
Seat 2: vilemo20 (button) folded before Flop (didn't bet)
Seat 3: yYanniky (small blind) folded before Flop
Seat 4: HeyLo (big blind) folded before Flop
Seat 5: 19ElGringo91 collected ($0.25)
Seat 6: volshebniknl folded before Flop (didn't bet)



PokerStars Hand #222959224527:  Hold'em No Limit ($0.05/$0.10 USD) - 2021/01/23 11:33:46 ET
Table 'Bohlinia III' 6-max Seat #3 is the button
Seat 1: hempju1ce ($11.97 in chips) 
Seat 2: vilemo20 ($11.65 in chips) 
Seat 3: yYanniky ($10.15 in chips) 
Seat 4: HeyLo ($15.65 in chips) 
Seat 5: 19ElGringo91 ($11.82 in chips) 
Seat 6: volshebniknl ($10 in chips) 
HeyLo: posts small blind $0.05
19ElGringo91: posts big blind $0.10
*** HOLE CARDS ***
volshebniknl: folds 
hempju1ce: folds 
vilemo20: raises $0.20 to $0.30
yYanniky: folds 
HeyLo: calls $0.25
19ElGringo91: folds 
*** FLOP *** [5h 4c 2s]
HeyLo: checks 
vilemo20: checks 
*** TURN *** [5h 4c 2s] [5s]
HeyLo: bets $0.45
vilemo20: folds 
Uncalled bet ($0.45) returned to HeyLo
HeyLo collected $0.67 from pot
HeyLo: doesn't show hand 
*** SUMMARY ***
Total pot $0.70 | Rake $0.03 
Board [5h 4c 2s 5s]
Seat 1: hempju1ce folded before Flop (didn't bet)
Seat 2: vilemo20 folded on the Turn
Seat 3: yYanniky (button) folded before Flop (didn't bet)
Seat 4: HeyLo (small blind) collected ($0.67)
Seat 5: 19ElGringo91 (big blind) folded before Flop
Seat 6: volshebniknl folded before Flop (didn't bet)



PokerStars Hand #222959259323:  Hold'em No Limit ($0.05/$0.10 USD) - 2021/01/23 11:34:43 ET
Table 'Bohlinia III' 6-max Seat #4 is the button
Seat 1: hempju1ce ($11.97 in chips) 
Seat 2: vilemo20 ($11.35 in chips) 
Seat 3: yYanniky ($10.15 in chips) 
Seat 4: HeyLo ($16.02 in chips) 
Seat 5: 19ElGringo91 ($11.72 in chips) 
Seat 6: volshebniknl ($10 in chips) 
19ElGringo91: posts small blind $0.05
volshebniknl: posts big blind $0.10
*** HOLE CARDS ***
hempju1ce: calls $0.10
vilemo20: folds 
yYanniky: folds 
HeyLo: folds 
19ElGringo91: raises $0.40 to $0.50
volshebniknl: folds 
hempju1ce: folds 
Uncalled bet ($0.40) returned to 19ElGringo91
19ElGringo91 collected $0.30 from pot
19ElGringo91: doesn't show hand 
*** SUMMARY ***
Total pot $0.30 | Rake $0 
Seat 1: hempju1ce folded before Flop
Seat 2: vilemo20 folded before Flop (didn't bet)
Seat 3: yYanniky folded before Flop (didn't bet)
Seat 4: HeyLo (button) folded before Flop (didn't bet)
Seat 5: 19ElGringo91 (small blind) collected ($0.30)
Seat 6: volshebniknl (big blind) folded before Flop



PokerStars Hand #222959284912:  Hold'em No Limit ($0.05/$0.10 USD) - 2021/01/23 11:35:16 ET
Table 'Bohlinia III' 6-max Seat #5 is the button
Seat 1: hempju1ce ($11.87 in chips) 
Seat 2: vilemo20 ($11.35 in chips) 
Seat 3: yYanniky ($10.15 in chips) 
Seat 4: HeyLo ($16.02 in chips) 
Seat 5: 19ElGringo91 ($11.92 in chips) 
Seat 6: volshebniknl ($10 in chips) 
volshebniknl: posts small blind $0.05
hempju1ce: posts big blind $0.10
*** HOLE CARDS ***
vilemo20: folds 
yYanniky: folds 
HeyLo: folds 
19ElGringo91: folds 
volshebniknl: folds 
Uncalled bet ($0.05) returned to hempju1ce
hempju1ce collected $0.10 from pot
hempju1ce: doesn't show hand 
*** SUMMARY ***
Total pot $0.10 | Rake $0 
Seat 1: hempju1ce (big blind) collected ($0.10)
Seat 2: vilemo20 folded before Flop (didn't bet)
Seat 3: yYanniky folded before Flop (didn't bet)
Seat 4: HeyLo folded before Flop (didn't bet)
Seat 5: 19ElGringo91 (button) folded before Flop (didn't bet)
Seat 6: volshebniknl (small blind) folded before Flop



PokerStars Hand #222959293982:  Hold'em No Limit ($0.05/$0.10 USD) - 2021/01/23 11:35:31 ET
Table 'Bohlinia III' 6-max Seat #6 is the button
Seat 1: hempju1ce ($11.92 in chips) 
Seat 2: vilemo20 ($11.35 in chips) 
Seat 3: yYanniky ($10.15 in chips) 
Seat 4: HeyLo ($16.02 in chips) 
Seat 5: 19ElGringo91 ($11.92 in chips) 
Seat 6: volshebniknl ($10 in chips) 
hempju1ce: posts small blind $0.05
vilemo20: posts big blind $0.10
*** HOLE CARDS ***
yYanniky: folds 
HeyLo: folds 
19ElGringo91: folds 
volshebniknl: raises $0.12 to $0.22
hempju1ce: calls $0.17
vilemo20: calls $0.12
*** FLOP *** [Th 7h 3h]
hempju1ce: checks 
vilemo20: checks 
volshebniknl: bets $0.30
hempju1ce: folds 
vilemo20: folds 
Uncalled bet ($0.30) returned to volshebniknl
volshebniknl collected $0.63 from pot
volshebniknl: doesn't show hand 
*** SUMMARY ***
Total pot $0.66 | Rake $0.03 
Board [Th 7h 3h]
Seat 1: hempju1ce (small blind) folded on the Flop
Seat 2: vilemo20 (big blind) folded on the Flop
Seat 3: yYanniky folded before Flop (didn't bet)
Seat 4: HeyLo folded before Flop (didn't bet)
Seat 5: 19ElGringo91 folded before Flop (didn't bet)
Seat 6: volshebniknl (button) collected ($0.63)



PokerStars Hand #222959317398:  Hold'em No Limit ($0.05/$0.10 USD) - 2021/01/23 11:36:09 ET
Table 'Bohlinia III' 6-max Seat #1 is the button
Seat 1: hempju1ce ($11.70 in chips) 
Seat 2: vilemo20 ($11.13 in chips) 
Seat 3: yYanniky ($10.15 in chips) 
Seat 4: HeyLo ($16.02 in chips) 
Seat 5: 19ElGringo91 ($11.92 in chips) 
Seat 6: volshebniknl ($10.41 in chips) 
vilemo20: posts small blind $0.05
yYanniky: posts big blind $0.10
*** HOLE CARDS ***
HeyLo: folds 
19ElGringo91: folds 
volshebniknl: folds 
hempju1ce: folds 
vilemo20: raises $0.20 to $0.30
yYanniky: calls $0.20
*** FLOP *** [3d Qd 6c]
vilemo20: checks 
yYanniky: bets $0.21
vilemo20: calls $0.21
*** TURN *** [3d Qd 6c] [9c]
vilemo20: checks 
yYanniky: checks 
*** RIVER *** [3d Qd 6c 9c] [Td]
vilemo20: bets $0.66
yYanniky: folds 
Uncalled bet ($0.66) returned to vilemo20
vilemo20 collected $0.97 from pot
vilemo20: doesn't show hand 
*** SUMMARY ***
Total pot $1.02 | Rake $0.05 
Board [3d Qd 6c 9c Td]
Seat 1: hempju1ce (button) folded before Flop (didn't bet)
Seat 2: vilemo20 (small blind) collected ($0.97)
Seat 3: yYanniky (big blind) folded on the River
Seat 4: HeyLo folded before Flop (didn't bet)
Seat 5: 19ElGringo91 folded before Flop (didn't bet)
Seat 6: volshebniknl folded before Flop (didn't bet)



PokerStars Hand #222959351394:  Hold'em No Limit ($0.05/$0.10 USD) - 2021/01/23 11:37:04 ET
Table 'Bohlinia III' 6-max Seat #2 is the button
Seat 1: hempju1ce ($11.70 in chips) 
Seat 2: vilemo20 ($11.59 in chips) 
Seat 3: yYanniky ($10 in chips) 
Seat 4: HeyLo ($16.02 in chips) 
Seat 5: 19ElGringo91 ($11.92 in chips) 
Seat 6: volshebniknl ($10.41 in chips) 
yYanniky: posts small blind $0.05
HeyLo: posts big blind $0.10
*** HOLE CARDS ***
19ElGringo91: folds 
volshebniknl: folds 
hempju1ce: folds 
vilemo20: folds 
yYanniky: folds 
Uncalled bet ($0.05) returned to HeyLo
HeyLo collected $0.10 from pot
HeyLo: doesn't show hand 
*** SUMMARY ***
Total pot $0.10 | Rake $0 
Seat 1: hempju1ce folded before Flop (didn't bet)
Seat 2: vilemo20 (button) folded before Flop (didn't bet)
Seat 3: yYanniky (small blind) folded before Flop
Seat 4: HeyLo (big blind) collected ($0.10)
Seat 5: 19ElGringo91 folded before Flop (didn't bet)
Seat 6: volshebniknl folded before Flop (didn't bet)



PokerStars Hand #222959361211:  Hold'em No Limit ($0.05/$0.10 USD) - 2021/01/23 11:37:20 ET
Table 'Bohlinia III' 6-max Seat #3 is the button
Seat 1: hempju1ce ($11.70 in chips) 
Seat 2: vilemo20 ($11.59 in chips) 
Seat 3: yYanniky ($10 in chips) 
Seat 4: HeyLo ($16.07 in chips) 
Seat 5: 19ElGringo91 ($11.92 in chips) 
Seat 6: volshebniknl ($10.41 in chips) 
HeyLo: posts small blind $0.05
19ElGringo91: posts big blind $0.10
*** HOLE CARDS ***
volshebniknl: folds 
hempju1ce: calls $0.10
vilemo20: folds 
yYanniky: folds 
HeyLo: folds 
19ElGringo91: checks 
*** FLOP *** [9h 6c 2h]
19ElGringo91: checks 
hempju1ce: checks 
*** TURN *** [9h 6c 2h] [3h]
19ElGringo91: checks 
hempju1ce: checks 
*** RIVER *** [9h 6c 2h 3h] [Ah]
19ElGringo91: checks 
hempju1ce: checks 
*** SHOW DOWN ***
19ElGringo91: shows [5s Ts] (high card Ace)
hempju1ce: shows [Jc 8c] (high card Ace - Jack kicker)
hempju1ce collected $0.24 from pot
*** SUMMARY ***
Total pot $0.25 | Rake $0.01 
Board [9h 6c 2h 3h Ah]
Seat 1: hempju1ce showed [Jc 8c] and won ($0.24) with high card Ace
Seat 2: vilemo20 folded before Flop (didn't bet)
Seat 3: yYanniky (button) folded before Flop (didn't bet)
Seat 4: HeyLo (small blind) folded before Flop
Seat 5: 19ElGringo91 (big blind) showed [5s Ts] and lost with high card Ace
Seat 6: volshebniknl folded before Flop (didn't bet)



PokerStars Hand #222959380396:  Hold'em No Limit ($0.05/$0.10 USD) - 2021/01/23 11:37:52 ET
Table 'Bohlinia III' 6-max Seat #4 is the button
Seat 1: hempju1ce ($11.84 in chips) 
Seat 2: vilemo20 ($11.59 in chips) 
Seat 3: yYanniky ($10 in chips) 
Seat 4: HeyLo ($16.02 in chips) 
Seat 5: 19ElGringo91 ($11.82 in chips) 
Seat 6: volshebniknl ($10.41 in chips) 
19ElGringo91: posts small blind $0.05
volshebniknl: posts big blind $0.10
*** HOLE CARDS ***
hempju1ce: folds 
vilemo20: folds 
yYanniky: folds 
HeyLo: folds 
19ElGringo91: folds 
Uncalled bet ($0.05) returned to volshebniknl
volshebniknl collected $0.10 from pot
volshebniknl: doesn't show hand 
*** SUMMARY ***
Total pot $0.10 | Rake $0 
Seat 1: hempju1ce folded before Flop (didn't bet)
Seat 2: vilemo20 folded before Flop (didn't bet)
Seat 3: yYanniky folded before Flop (didn't bet)
Seat 4: HeyLo (button) folded before Flop (didn't bet)
Seat 5: 19ElGringo91 (small blind) folded before Flop
Seat 6: volshebniknl (big blind) collected ($0.10)



PokerStars Hand #222959395099:  Hold'em No Limit ($0.05/$0.10 USD) - 2021/01/23 11:38:16 ET
Table 'Bohlinia III' 6-max Seat #5 is the button
Seat 1: hempju1ce ($11.84 in chips) 
Seat 2: vilemo20 ($11.59 in chips) 
Seat 3: yYanniky ($10 in chips) 
Seat 4: HeyLo ($16.02 in chips) 
Seat 5: 19ElGringo91 ($11.77 in chips) 
Seat 6: volshebniknl ($10.46 in chips) 
volshebniknl: posts small blind $0.05
hempju1ce: posts big blind $0.10
*** HOLE CARDS ***
vilemo20: raises $0.20 to $0.30
yYanniky: folds 
HeyLo: folds 
19ElGringo91: raises $0.60 to $0.90
volshebniknl: folds 
hempju1ce: folds 
vilemo20: folds 
Uncalled bet ($0.60) returned to 19ElGringo91
19ElGringo91 collected $0.75 from pot
19ElGringo91: doesn't show hand 
*** SUMMARY ***
Total pot $0.75 | Rake $0 
Seat 1: hempju1ce (big blind) folded before Flop
Seat 2: vilemo20 folded before Flop
Seat 3: yYanniky folded before Flop (didn't bet)
Seat 4: HeyLo folded before Flop (didn't bet)
Seat 5: 19ElGringo91 (button) collected ($0.75)
Seat 6: volshebniknl (small blind) folded before Flop



PokerStars Hand #222959405852:  Hold'em No Limit ($0.05/$0.10 USD) - 2021/01/23 11:38:33 ET
Table 'Bohlinia III' 6-max Seat #6 is the button
Seat 1: hempju1ce ($11.74 in chips) 
Seat 2: vilemo20 ($11.29 in chips) 
Seat 3: yYanniky ($10 in chips) 
Seat 4: HeyLo ($16.02 in chips) 
Seat 5: 19ElGringo91 ($12.22 in chips) 
Seat 6: volshebniknl ($10.41 in chips) 
hempju1ce: posts small blind $0.05
vilemo20: posts big blind $0.10
*** HOLE CARDS ***
yYanniky: folds 
HeyLo: folds 
19ElGringo91: folds 
volshebniknl: raises $0.12 to $0.22
hempju1ce: folds 
vilemo20: calls $0.12
*** FLOP *** [Ks 2c 3h]
vilemo20: checks 
volshebniknl: bets $0.16
vilemo20: folds 
Uncalled bet ($0.16) returned to volshebniknl
volshebniknl collected $0.47 from pot
volshebniknl: doesn't show hand 
*** SUMMARY ***
Total pot $0.49 | Rake $0.02 
Board [Ks 2c 3h]
Seat 1: hempju1ce (small blind) folded before Flop
Seat 2: vilemo20 (big blind) folded on the Flop
Seat 3: yYanniky folded before Flop (didn't bet)
Seat 4: HeyLo folded before Flop (didn't bet)
Seat 5: 19ElGringo91 folded before Flop (didn't bet)
Seat 6: volshebniknl (button) collected ($0.47)



PokerStars Hand #222959426651:  Hold'em No Limit ($0.05/$0.10 USD) - 2021/01/23 11:39:07 ET
Table 'Bohlinia III' 6-max Seat #1 is the button
Seat 1: hempju1ce ($11.69 in chips) 
Seat 2: vilemo20 ($11.07 in chips) 
Seat 3: yYanniky ($10 in chips) 
Seat 4: HeyLo ($16.02 in chips) 
Seat 5: 19ElGringo91 ($12.22 in chips) 
Seat 6: volshebniknl ($10.66 in chips) 
vilemo20: posts small blind $0.05
yYanniky: posts big blind $0.10
*** HOLE CARDS ***
HeyLo: folds 
19ElGringo91: folds 
volshebniknl: folds 
hempju1ce: folds 
vilemo20: raises $0.20 to $0.30
yYanniky: folds 
Uncalled bet ($0.20) returned to vilemo20
vilemo20 collected $0.20 from pot
vilemo20: doesn't show hand 
*** SUMMARY ***
Total pot $0.20 | Rake $0 
Seat 1: hempju1ce (button) folded before Flop (didn't bet)
Seat 2: vilemo20 (small blind) collected ($0.20)
Seat 3: yYanniky (big blind) folded before Flop
Seat 4: HeyLo folded before Flop (didn't bet)
Seat 5: 19ElGringo91 folded before Flop (didn't bet)
Seat 6: volshebniknl folded before Flop (didn't bet)



PokerStars Hand #222959434346:  Hold'em No Limit ($0.05/$0.10 USD) - 2021/01/23 11:39:20 ET
Table 'Bohlinia III' 6-max Seat #2 is the button
Seat 1: hempju1ce ($11.69 in chips) 
Seat 2: vilemo20 ($11.17 in chips) 
Seat 3: yYanniky ($10 in chips) 
Seat 4: HeyLo ($16.02 in chips) 
Seat 5: 19ElGringo91 ($12.22 in chips) 
Seat 6: volshebniknl ($10.66 in chips) 
yYanniky: posts small blind $0.05
HeyLo: posts big blind $0.10
*** HOLE CARDS ***
19ElGringo91: folds 
volshebniknl: raises $0.20 to $0.30
hempju1ce: folds 
vilemo20: folds 
yYanniky: folds 
HeyLo: folds 
Uncalled bet ($0.20) returned to volshebniknl
volshebniknl collected $0.25 from pot
volshebniknl: doesn't show hand 
*** SUMMARY ***
Total pot $0.25 | Rake $0 
Seat 1: hempju1ce folded before Flop (didn't bet)
Seat 2: vilemo20 (button) folded before Flop (didn't bet)
Seat 3: yYanniky (small blind) folded before Flop
Seat 4: HeyLo (big blind) folded before Flop
Seat 5: 19ElGringo91 folded before Flop (didn't bet)
Seat 6: volshebniknl collected ($0.25)



PokerStars Hand #222959444062:  Hold'em No Limit ($0.05/$0.10 USD) - 2021/01/23 11:39:36 ET
Table 'Bohlinia III' 6-max Seat #3 is the button
Seat 1: hempju1ce ($11.69 in chips) 
Seat 2: vilemo20 ($11.17 in chips) 
Seat 3: yYanniky ($10 in chips) 
Seat 4: HeyLo ($15.92 in chips) 
Seat 5: 19ElGringo91 ($12.22 in chips) 
Seat 6: volshebniknl ($10.81 in chips) 
HeyLo: posts small blind $0.05
19ElGringo91: posts big blind $0.10
*** HOLE CARDS ***
volshebniknl: folds 
hempju1ce: folds 
vilemo20: folds 
yYanniky: raises $0.15 to $0.25
HeyLo: calls $0.20
19ElGringo91: folds 
*** FLOP *** [Tc 2c Jd]
HeyLo: checks 
yYanniky: checks 
*** TURN *** [Tc 2c Jd] [2h]
HeyLo: bets $0.30
yYanniky: raises $0.30 to $0.60
HeyLo: calls $0.30
*** RIVER *** [Tc 2c Jd 2h] [3c]
HeyLo: checks 
yYanniky: bets $1.72
HeyLo: folds 
Uncalled bet ($1.72) returned to yYanniky
yYanniky collected $1.72 from pot
yYanniky: doesn't show hand 
*** SUMMARY ***
Total pot $1.80 | Rake $0.08 
Board [Tc 2c Jd 2h 3c]
Seat 1: hempju1ce folded before Flop (didn't bet)
Seat 2: vilemo20 folded before Flop (didn't bet)
Seat 3: yYanniky (button) collected ($1.72)
Seat 4: HeyLo (small blind) folded on the River
Seat 5: 19ElGringo91 (big blind) folded before Flop
Seat 6: volshebniknl folded before Flop (didn't bet)



PokerStars Hand #222959481815:  Hold'em No Limit ($0.05/$0.10 USD) - 2021/01/23 11:40:37 ET
Table 'Bohlinia III' 6-max Seat #4 is the button
Seat 1: hempju1ce ($11.69 in chips) 
Seat 2: vilemo20 ($11.17 in chips) 
Seat 3: yYanniky ($10.87 in chips) 
Seat 4: HeyLo ($15.07 in chips) 
Seat 5: 19ElGringo91 ($12.12 in chips) 
Seat 6: volshebniknl ($10.81 in chips) 
19ElGringo91: posts small blind $0.05
volshebniknl: posts big blind $0.10
*** HOLE CARDS ***
hempju1ce: folds 
vilemo20: folds 
yYanniky: folds 
HeyLo: raises $0.20 to $0.30
19ElGringo91: folds 
volshebniknl: folds 
Uncalled bet ($0.20) returned to HeyLo
HeyLo collected $0.25 from pot
HeyLo: doesn't show hand 
*** SUMMARY ***
Total pot $0.25 | Rake $0 
Seat 1: hempju1ce folded before Flop (didn't bet)
Seat 2: vilemo20 folded before Flop (didn't bet)
Seat 3: yYanniky folded before Flop (didn't bet)
Seat 4: HeyLo (button) collected ($0.25)
Seat 5: 19ElGringo91 (small blind) folded before Flop
Seat 6: volshebniknl (big blind) folded before Flop



PokerStars Hand #222959488115:  Hold'em No Limit ($0.05/$0.10 USD) - 2021/01/23 11:40:47 ET
Table 'Bohlinia III' 6-max Seat #5 is the button
Seat 1: hempju1ce ($11.69 in chips) 
Seat 2: vilemo20 ($11.17 in chips) 
Seat 3: yYanniky ($10.87 in chips) 
Seat 4: HeyLo ($15.22 in chips) 
Seat 5: 19ElGringo91 ($12.07 in chips) 
Seat 6: volshebniknl ($10.71 in chips) 
volshebniknl: posts small blind $0.05
hempju1ce: posts big blind $0.10
*** HOLE CARDS ***
vilemo20: folds 
yYanniky: raises $0.15 to $0.25
HeyLo: folds 
19ElGringo91: raises $0.60 to $0.85
volshebniknl: folds 
hempju1ce: folds 
yYanniky: folds 
Uncalled bet ($0.60) returned to 19ElGringo91
19ElGringo91 collected $0.65 from pot
19ElGringo91: doesn't show hand 
*** SUMMARY ***
Total pot $0.65 | Rake $0 
Seat 1: hempju1ce (big blind) folded before Flop
Seat 2: vilemo20 folded before Flop (didn't bet)
Seat 3: yYanniky folded before Flop
Seat 4: HeyLo folded before Flop (didn't bet)
Seat 5: 19ElGringo91 (button) collected ($0.65)
Seat 6: volshebniknl (small blind) folded before Flop



PokerStars Hand #222959502060:  Hold'em No Limit ($0.05/$0.10 USD) - 2021/01/23 11:41:10 ET
Table 'Bohlinia III' 6-max Seat #6 is the button
Seat 1: hempju1ce ($11.59 in chips) 
Seat 2: vilemo20 ($11.17 in chips) 
Seat 3: yYanniky ($10.62 in chips) 
Seat 4: HeyLo ($15.22 in chips) 
Seat 5: 19ElGringo91 ($12.47 in chips) 
Seat 6: volshebniknl ($10.66 in chips) 
hempju1ce: posts small blind $0.05
vilemo20: posts big blind $0.10
*** HOLE CARDS ***
yYanniky: folds 
HeyLo: folds 
19ElGringo91: folds 
volshebniknl: raises $0.12 to $0.22
hempju1ce: folds 
vilemo20: folds 
Uncalled bet ($0.12) returned to volshebniknl
volshebniknl collected $0.25 from pot
volshebniknl: doesn't show hand 
*** SUMMARY ***
Total pot $0.25 | Rake $0 
Seat 1: hempju1ce (small blind) folded before Flop
Seat 2: vilemo20 (big blind) folded before Flop
Seat 3: yYanniky folded before Flop (didn't bet)
Seat 4: HeyLo folded before Flop (didn't bet)
Seat 5: 19ElGringo91 folded before Flop (didn't bet)
Seat 6: volshebniknl (button) collected ($0.25)



PokerStars Hand #222959510257:  Hold'em No Limit ($0.05/$0.10 USD) - 2021/01/23 11:41:23 ET
Table 'Bohlinia III' 6-max Seat #1 is the button
Seat 1: hempju1ce ($11.54 in chips) 
Seat 2: vilemo20 ($11.07 in chips) 
Seat 3: yYanniky ($10.62 in chips) 
Seat 4: HeyLo ($15.22 in chips) 
Seat 5: 19ElGringo91 ($12.47 in chips) 
Seat 6: volshebniknl ($10.81 in chips) 
vilemo20: posts small blind $0.05
yYanniky: posts big blind $0.10
*** HOLE CARDS ***
HeyLo: folds 
19ElGringo91: folds 
volshebniknl: folds 
hempju1ce: folds 
vilemo20: folds 
Uncalled bet ($0.05) returned to yYanniky
yYanniky collected $0.10 from pot
yYanniky: doesn't show hand 
*** SUMMARY ***
Total pot $0.10 | Rake $0 
Seat 1: hempju1ce (button) folded before Flop (didn't bet)
Seat 2: vilemo20 (small blind) folded before Flop
Seat 3: yYanniky (big blind) collected ($0.10)
Seat 4: HeyLo folded before Flop (didn't bet)
Seat 5: 19ElGringo91 folded before Flop (didn't bet)
Seat 6: volshebniknl folded before Flop (didn't bet)



PokerStars Hand #222959518792:  Hold'em No Limit ($0.05/$0.10 USD) - 2021/01/23 11:41:37 ET
Table 'Bohlinia III' 6-max Seat #2 is the button
Seat 1: hempju1ce ($11.54 in chips) 
Seat 2: vilemo20 ($11.02 in chips) 
Seat 3: yYanniky ($10.67 in chips) 
Seat 4: HeyLo ($15.22 in chips) 
Seat 5: 19ElGringo91 ($12.47 in chips) 
Seat 6: volshebniknl ($10.81 in chips) 
yYanniky: posts small blind $0.05
HeyLo: posts big blind $0.10
*** HOLE CARDS ***
19ElGringo91: folds 
volshebniknl: folds 
hempju1ce: folds 
vilemo20: folds 
yYanniky: folds 
Uncalled bet ($0.05) returned to HeyLo
HeyLo collected $0.10 from pot
HeyLo: doesn't show hand 
*** SUMMARY ***
Total pot $0.10 | Rake $0 
Seat 1: hempju1ce folded before Flop (didn't bet)
Seat 2: vilemo20 (button) folded before Flop (didn't bet)
Seat 3: yYanniky (small blind) folded before Flop
Seat 4: HeyLo (big blind) collected ($0.10)
Seat 5: 19ElGringo91 folded before Flop (didn't bet)
Seat 6: volshebniknl folded before Flop (didn't bet)



PokerStars Hand #222959527506:  Hold'em No Limit ($0.05/$0.10 USD) - 2021/01/23 11:41:51 ET
Table 'Bohlinia III' 6-max Seat #3 is the button
Seat 1: hempju1ce ($11.54 in chips) 
Seat 2: vilemo20 ($11.02 in chips) 
Seat 3: yYanniky ($10.62 in chips) 
Seat 4: HeyLo ($15.27 in chips) 
Seat 5: 19ElGringo91 ($12.47 in chips) 
Seat 6: volshebniknl ($10.81 in chips) 
HeyLo: posts small blind $0.05
19ElGringo91: posts big blind $0.10
*** HOLE CARDS ***
volshebniknl: folds 
hempju1ce: folds 
vilemo20: raises $0.20 to $0.30
yYanniky: folds 
HeyLo: folds 
19ElGringo91: calls $0.20
*** FLOP *** [Tc 2s Ah]
19ElGringo91: checks 
vilemo20: bets $0.40
19ElGringo91: calls $0.40
*** TURN *** [Tc 2s Ah] [Jh]
19ElGringo91: checks 
vilemo20: bets $0.90
19ElGringo91: calls $0.90
*** RIVER *** [Tc 2s Ah Jh] [5c]
19ElGringo91: checks 
vilemo20: bets $2.11
19ElGringo91: calls $2.11
*** SHOW DOWN ***
vilemo20: shows [Qs Kc] (a straight, Ten to Ace)
19ElGringo91: mucks hand 
vilemo20 collected $7.13 from pot
*** SUMMARY ***
Total pot $7.47 | Rake $0.34 
Board [Tc 2s Ah Jh 5c]
Seat 1: hempju1ce folded before Flop (didn't bet)
Seat 2: vilemo20 showed [Qs Kc] and won ($7.13) with a straight, Ten to Ace
Seat 3: yYanniky (button) folded before Flop (didn't bet)
Seat 4: HeyLo (small blind) folded before Flop
Seat 5: 19ElGringo91 (big blind) mucked
Seat 6: volshebniknl folded before Flop (didn't bet)



PokerStars Hand #222959562000:  Hold'em No Limit ($0.05/$0.10 USD) - 2021/01/23 11:42:48 ET
Table 'Bohlinia III' 6-max Seat #4 is the button
Seat 1: hempju1ce ($11.54 in chips) 
Seat 2: vilemo20 ($14.44 in chips) 
Seat 3: yYanniky ($10.62 in chips) 
Seat 4: HeyLo ($15.22 in chips) 
Seat 5: 19ElGringo91 ($10 in chips) 
Seat 6: volshebniknl ($10.81 in chips) 
19ElGringo91: posts small blind $0.05
volshebniknl: posts big blind $0.10
*** HOLE CARDS ***
hempju1ce: folds 
vilemo20: folds 
yYanniky: raises $0.15 to $0.25
HeyLo: folds 
19ElGringo91: folds 
volshebniknl: folds 
Uncalled bet ($0.15) returned to yYanniky
yYanniky collected $0.25 from pot
yYanniky: doesn't show hand 
*** SUMMARY ***
Total pot $0.25 | Rake $0 
Seat 1: hempju1ce folded before Flop (didn't bet)
Seat 2: vilemo20 folded before Flop (didn't bet)
Seat 3: yYanniky collected ($0.25)
Seat 4: HeyLo (button) folded before Flop (didn't bet)
Seat 5: 19ElGringo91 (small blind) folded before Flop
Seat 6: volshebniknl (big blind) folded before Flop



PokerStars Hand #222959575939:  Hold'em No Limit ($0.05/$0.10 USD) - 2021/01/23 11:43:10 ET
Table 'Bohlinia III' 6-max Seat #5 is the button
Seat 1: hempju1ce ($11.54 in chips) 
Seat 2: vilemo20 ($14.44 in chips) 
Seat 3: yYanniky ($10.77 in chips) 
Seat 4: HeyLo ($15.22 in chips) 
Seat 5: 19ElGringo91 ($10 in chips) 
Seat 6: volshebniknl ($10.71 in chips) 
volshebniknl: posts small blind $0.05
hempju1ce: posts big blind $0.10
*** HOLE CARDS ***
vilemo20: folds 
yYanniky: raises $0.17 to $0.27
HeyLo: folds 
19ElGringo91: raises $0.58 to $0.85
volshebniknl: folds 
hempju1ce: folds 
yYanniky: calls $0.58
*** FLOP *** [6h 3c Qd]
yYanniky: checks 
19ElGringo91: bets $0.92
yYanniky: calls $0.92
*** TURN *** [6h 3c Qd] [Kh]
yYanniky: checks 
19ElGringo91: bets $2.64
yYanniky: folds 
Uncalled bet ($2.64) returned to 19ElGringo91
19ElGringo91 collected $3.52 from pot
19ElGringo91: doesn't show hand 
*** SUMMARY ***
Total pot $3.69 | Rake $0.17 
Board [6h 3c Qd Kh]
Seat 1: hempju1ce (big blind) folded before Flop
Seat 2: vilemo20 folded before Flop (didn't bet)
Seat 3: yYanniky folded on the Turn
Seat 4: HeyLo folded before Flop (didn't bet)
Seat 5: 19ElGringo91 (button) collected ($3.52)
Seat 6: volshebniknl (small blind) folded before Flop



PokerStars Hand #222959615793:  Hold'em No Limit ($0.05/$0.10 USD) - 2021/01/23 11:44:15 ET
Table 'Bohlinia III' 6-max Seat #6 is the button
Seat 1: hempju1ce ($11.44 in chips) 
Seat 2: vilemo20 ($14.44 in chips) 
Seat 3: yYanniky ($10 in chips) 
Seat 4: HeyLo ($15.22 in chips) 
Seat 5: 19ElGringo91 ($11.75 in chips) 
Seat 6: volshebniknl ($10.66 in chips) 
hempju1ce: posts small blind $0.05
vilemo20: posts big blind $0.10
*** HOLE CARDS ***
yYanniky: folds 
HeyLo: folds 
19ElGringo91: folds 
volshebniknl: raises $0.12 to $0.22
hempju1ce: folds 
vilemo20: calls $0.12
*** FLOP *** [9d Kd 2c]
vilemo20: checks 
volshebniknl: bets $0.16
vilemo20: calls $0.16
*** TURN *** [9d Kd 2c] [Jc]
vilemo20: checks 
volshebniknl: checks 
*** RIVER *** [9d Kd 2c Jc] [3s]
vilemo20: bets $0.52
volshebniknl: folds 
Uncalled bet ($0.52) returned to vilemo20
vilemo20 collected $0.77 from pot
vilemo20: doesn't show hand 
*** SUMMARY ***
Total pot $0.81 | Rake $0.04 
Board [9d Kd 2c Jc 3s]
Seat 1: hempju1ce (small blind) folded before Flop
Seat 2: vilemo20 (big blind) collected ($0.77)
Seat 3: yYanniky folded before Flop (didn't bet)
Seat 4: HeyLo folded before Flop (didn't bet)
Seat 5: 19ElGringo91 folded before Flop (didn't bet)
Seat 6: volshebniknl (button) folded on the River



PokerStars Hand #222959648841:  Hold'em No Limit ($0.05/$0.10 USD) - 2021/01/23 11:45:08 ET
Table 'Bohlinia III' 6-max Seat #1 is the button
Seat 1: hempju1ce ($11.39 in chips) 
Seat 2: vilemo20 ($14.83 in chips) 
Seat 3: yYanniky ($10 in chips) 
Seat 4: HeyLo ($15.22 in chips) 
Seat 5: 19ElGringo91 ($11.75 in chips) 
Seat 6: volshebniknl ($10.28 in chips) 
vilemo20: posts small blind $0.05
yYanniky: posts big blind $0.10
*** HOLE CARDS ***
HeyLo: folds 
19ElGringo91: folds 
volshebniknl: folds 
hempju1ce: folds 
vilemo20: folds 
Uncalled bet ($0.05) returned to yYanniky
yYanniky collected $0.10 from pot
yYanniky: doesn't show hand 
*** SUMMARY ***
Total pot $0.10 | Rake $0 
Seat 1: hempju1ce (button) folded before Flop (didn't bet)
Seat 2: vilemo20 (small blind) folded before Flop
Seat 3: yYanniky (big blind) collected ($0.10)
Seat 4: HeyLo folded before Flop (didn't bet)
Seat 5: 19ElGringo91 folded before Flop (didn't bet)
Seat 6: volshebniknl folded before Flop (didn't bet)



PokerStars Hand #222959655412:  Hold'em No Limit ($0.05/$0.10 USD) - 2021/01/23 11:45:19 ET
Table 'Bohlinia III' 6-max Seat #2 is the button
Seat 1: hempju1ce ($11.39 in chips) 
Seat 2: vilemo20 ($14.78 in chips) 
Seat 3: yYanniky ($10.05 in chips) 
Seat 4: HeyLo ($15.22 in chips) 
Seat 5: 19ElGringo91 ($11.75 in chips) 
Seat 6: volshebniknl ($10.28 in chips) 
yYanniky: posts small blind $0.05
HeyLo: posts big blind $0.10
*** HOLE CARDS ***
19ElGringo91: folds 
volshebniknl: raises $0.20 to $0.30
hempju1ce: folds 
vilemo20 has timed out
vilemo20: folds 
yYanniky: folds 
HeyLo: folds 
Uncalled bet ($0.20) returned to volshebniknl
volshebniknl collected $0.25 from pot
volshebniknl: doesn't show hand 
*** SUMMARY ***
Total pot $0.25 | Rake $0 
Seat 1: hempju1ce folded before Flop (didn't bet)
Seat 2: vilemo20 (button) folded before Flop (didn't bet)
Seat 3: yYanniky (small blind) folded before Flop
Seat 4: HeyLo (big blind) folded before Flop
Seat 5: 19ElGringo91 folded before Flop (didn't bet)
Seat 6: volshebniknl collected ($0.25)



PokerStars Hand #222959672222:  Hold'em No Limit ($0.05/$0.10 USD) - 2021/01/23 11:45:46 ET
Table 'Bohlinia III' 6-max Seat #3 is the button
Seat 1: hempju1ce ($11.39 in chips) 
Seat 3: yYanniky ($10 in chips) 
Seat 4: HeyLo ($15.12 in chips) 
Seat 5: 19ElGringo91 ($11.75 in chips) 
Seat 6: volshebniknl ($10.43 in chips) 
HeyLo: posts small blind $0.05
19ElGringo91: posts big blind $0.10
*** HOLE CARDS ***
volshebniknl: folds 
hempju1ce: calls $0.10
vilemo20 is disconnected 
yYanniky: raises $0.20 to $0.30
HeyLo: folds 
19ElGringo91: folds 
hempju1ce: folds 
Uncalled bet ($0.20) returned to yYanniky
yYanniky collected $0.35 from pot
yYanniky: doesn't show hand 
*** SUMMARY ***
Total pot $0.35 | Rake $0 
Seat 1: hempju1ce folded before Flop
Seat 3: yYanniky (button) collected ($0.35)
Seat 4: HeyLo (small blind) folded before Flop
Seat 5: 19ElGringo91 (big blind) folded before Flop
Seat 6: volshebniknl folded before Flop (didn't bet)



PokerStars Hand #222959691863:  Hold'em No Limit ($0.05/$0.10 USD) - 2021/01/23 11:46:18 ET
Table 'Bohlinia III' 6-max Seat #4 is the button
Seat 1: hempju1ce ($11.29 in chips) 
Seat 3: yYanniky ($10.25 in chips) 
Seat 4: HeyLo ($15.07 in chips) 
Seat 5: 19ElGringo91 ($11.65 in chips) 
19ElGringo91: posts small blind $0.05
volshebniknl: is sitting out 
hempju1ce: posts big blind $0.10
*** HOLE CARDS ***
yYanniky: raises $0.15 to $0.25
HeyLo: folds 
19ElGringo91: folds 
volshebniknl leaves the table
hempju1ce: calls $0.15
*** FLOP *** [7c 6d 8d]
GrinZwe91! joins the table at seat #6 
hempju1ce: bets $0.10
yYanniky: calls $0.10
*** TURN *** [7c 6d 8d] [Jh]
hempju1ce: bets $0.36
yYanniky: calls $0.36
*** RIVER *** [7c 6d 8d Jh] [9s]
hempju1ce: bets $0.70
yYanniky: folds 
Uncalled bet ($0.70) returned to hempju1ce
hempju1ce collected $1.40 from pot
hempju1ce: doesn't show hand 
*** SUMMARY ***
Total pot $1.47 | Rake $0.07 
Board [7c 6d 8d Jh 9s]
Seat 1: hempju1ce (big blind) collected ($1.40)
Seat 3: yYanniky folded on the River
Seat 4: HeyLo (button) folded before Flop (didn't bet)
Seat 5: 19ElGringo91 (small blind) folded before Flop



PokerStars Hand #222959721268:  Hold'em No Limit ($0.05/$0.10 USD) - 2021/01/23 11:47:05 ET
Table 'Bohlinia III' 6-max Seat #5 is the button
Seat 1: hempju1ce ($11.98 in chips) 
Seat 2: vilemo20 ($14.78 in chips) 
Seat 3: yYanniky ($10 in chips) 
Seat 4: HeyLo ($15.07 in chips) 
Seat 5: 19ElGringo91 ($11.60 in chips) 
hempju1ce: posts small blind $0.05
vilemo20: posts big blind $0.10
*** HOLE CARDS ***
yYanniky: folds 
HeyLo: folds 
19ElGringo91: raises $0.20 to $0.30
hempju1ce: folds 
vilemo20: folds 
Uncalled bet ($0.20) returned to 19ElGringo91
19ElGringo91 collected $0.25 from pot
19ElGringo91: doesn't show hand 
*** SUMMARY ***
Total pot $0.25 | Rake $0 
Seat 1: hempju1ce (small blind) folded before Flop
Seat 2: vilemo20 (big blind) folded before Flop
Seat 3: yYanniky folded before Flop (didn't bet)
Seat 4: HeyLo folded before Flop (didn't bet)
Seat 5: 19ElGringo91 (button) collected ($0.25)



PokerStars Hand #222959732702:  Hold'em No Limit ($0.05/$0.10 USD) - 2021/01/23 11:47:24 ET
Table 'Bohlinia III' 6-max Seat #1 is the button
Seat 1: hempju1ce ($11.93 in chips) 
Seat 2: vilemo20 ($14.68 in chips) 
Seat 3: yYanniky ($10 in chips) 
Seat 4: HeyLo ($15.07 in chips) 
Seat 5: 19ElGringo91 ($11.75 in chips) 
vilemo20: posts small blind $0.05
yYanniky: posts big blind $0.10
GrinZwe91!: sits out 
*** HOLE CARDS ***
HeyLo: folds 
19ElGringo91: raises $0.20 to $0.30
hempju1ce: folds 
vilemo20: folds 
yYanniky: folds 
Uncalled bet ($0.20) returned to 19ElGringo91
19ElGringo91 collected $0.25 from pot
19ElGringo91: doesn't show hand 
*** SUMMARY ***
Total pot $0.25 | Rake $0 
Seat 1: hempju1ce (button) folded before Flop (didn't bet)
Seat 2: vilemo20 (small blind) folded before Flop
Seat 3: yYanniky (big blind) folded before Flop
Seat 4: HeyLo folded before Flop (didn't bet)
Seat 5: 19ElGringo91 collected ($0.25)



PokerStars Hand #222959744777:  Hold'em No Limit ($0.05/$0.10 USD) - 2021/01/23 11:47:43 ET
Table 'Bohlinia III' 6-max Seat #2 is the button
Seat 1: hempju1ce ($11.93 in chips) 
Seat 2: vilemo20 ($14.63 in chips) 
Seat 3: yYanniky ($10 in chips) 
Seat 4: HeyLo ($15.07 in chips) 
Seat 5: 19ElGringo91 ($11.90 in chips) 
yYanniky: posts small blind $0.05
HeyLo: posts big blind $0.10
GrinZwe91!: sits out 
*** HOLE CARDS ***
19ElGringo91: folds 
hempju1ce: folds 
vilemo20: folds 
yYanniky: folds 
Uncalled bet ($0.05) returned to HeyLo
HeyLo collected $0.10 from pot
HeyLo: doesn't show hand 
*** SUMMARY ***
Total pot $0.10 | Rake $0 
Seat 1: hempju1ce folded before Flop (didn't bet)
Seat 2: vilemo20 (button) folded before Flop (didn't bet)
Seat 3: yYanniky (small blind) folded before Flop
Seat 4: HeyLo (big blind) collected ($0.10)
Seat 5: 19ElGringo91 folded before Flop (didn't bet)



PokerStars Hand #222959751293:  Hold'em No Limit ($0.05/$0.10 USD) - 2021/01/23 11:47:54 ET
Table 'Bohlinia III' 6-max Seat #3 is the button
Seat 1: hempju1ce ($11.93 in chips) 
Seat 2: vilemo20 ($14.63 in chips) 
Seat 3: yYanniky ($10 in chips) 
Seat 4: HeyLo ($15.12 in chips) 
Seat 5: 19ElGringo91 ($11.90 in chips) 
HeyLo: posts small blind $0.05
19ElGringo91: posts big blind $0.10
GrinZwe91!: sits out 
*** HOLE CARDS ***
hempju1ce: raises $0.20 to $0.30
vilemo20: folds 
yYanniky: folds 
HeyLo: calls $0.25
19ElGringo91: folds 
*** FLOP *** [4c 7h 6s]
HeyLo: checks 
hempju1ce: checks 
*** TURN *** [4c 7h 6s] [8h]
HeyLo: checks 
hempju1ce: checks 
*** RIVER *** [4c 7h 6s 8h] [5c]
HeyLo: checks 
hempju1ce: checks 
*** SHOW DOWN ***
HeyLo: shows [Jc Qd] (a straight, Four to Eight)
hempju1ce: shows [Ac Qs] (a straight, Four to Eight)
HeyLo collected $0.34 from pot
hempju1ce collected $0.33 from pot
*** SUMMARY ***
Total pot $0.70 | Rake $0.03 
Board [4c 7h 6s 8h 5c]
Seat 1: hempju1ce showed [Ac Qs] and won ($0.33) with a straight, Four to Eight
Seat 2: vilemo20 folded before Flop (didn't bet)
Seat 3: yYanniky (button) folded before Flop (didn't bet)
Seat 4: HeyLo (small blind) showed [Jc Qd] and won ($0.34) with a straight, Four to Eight
Seat 5: 19ElGringo91 (big blind) folded before Flop



PokerStars Hand #222959776273:  Hold'em No Limit ($0.05/$0.10 USD) - 2021/01/23 11:48:34 ET
Table 'Bohlinia III' 6-max Seat #4 is the button
Seat 1: hempju1ce ($11.96 in chips) 
Seat 2: vilemo20 ($14.63 in chips) 
Seat 3: yYanniky ($10 in chips) 
Seat 4: HeyLo ($15.16 in chips) 
Seat 5: 19ElGringo91 ($11.80 in chips) 
Seat 6: GrinZwe91! ($10 in chips) 
19ElGringo91: posts small blind $0.05
GrinZwe91!: posts big blind $0.10
*** HOLE CARDS ***
hempju1ce: folds 
vilemo20: folds 
yYanniky: folds 
HeyLo: folds 
19ElGringo91: raises $0.20 to $0.30
GrinZwe91!: raises $0.60 to $0.90
19ElGringo91: calls $0.60
*** FLOP *** [Qd As Kd]
19ElGringo91: checks 
GrinZwe91!: bets $1
19ElGringo91: calls $1
*** TURN *** [Qd As Kd] [Jc]
19ElGringo91: checks 
GrinZwe91!: checks 
*** RIVER *** [Qd As Kd Jc] [Ac]
19ElGringo91: checks 
GrinZwe91!: bets $1.30
19ElGringo91: folds 
Uncalled bet ($1.30) returned to GrinZwe91!
GrinZwe91! collected $3.63 from pot
GrinZwe91!: doesn't show hand 
*** SUMMARY ***
Total pot $3.80 | Rake $0.17 
Board [Qd As Kd Jc Ac]
Seat 1: hempju1ce folded before Flop (didn't bet)
Seat 2: vilemo20 folded before Flop (didn't bet)
Seat 3: yYanniky folded before Flop (didn't bet)
Seat 4: HeyLo (button) folded before Flop (didn't bet)
Seat 5: 19ElGringo91 (small blind) folded on the River
Seat 6: GrinZwe91! (big blind) collected ($3.63)



PokerStars Hand #222959808617:  Hold'em No Limit ($0.05/$0.10 USD) - 2021/01/23 11:49:26 ET
Table 'Bohlinia III' 6-max Seat #5 is the button
Seat 1: hempju1ce ($11.96 in chips) 
Seat 2: vilemo20 ($14.63 in chips) 
Seat 3: yYanniky ($10 in chips) 
Seat 4: HeyLo ($15.16 in chips) 
Seat 5: 19ElGringo91 ($10 in chips) 
Seat 6: GrinZwe91! ($11.73 in chips) 
GrinZwe91!: posts small blind $0.05
hempju1ce: posts big blind $0.10
*** HOLE CARDS ***
vilemo20: folds 
yYanniky: folds 
HeyLo: folds 
19ElGringo91: folds 
GrinZwe91!: raises $0.20 to $0.30
hempju1ce: calls $0.20
*** FLOP *** [Qs Ad 9c]
GrinZwe91!: checks 
hempju1ce: checks 
*** TURN *** [Qs Ad 9c] [5c]
GrinZwe91!: checks 
hempju1ce: checks 
*** RIVER *** [Qs Ad 9c 5c] [8h]
GrinZwe91!: bets $0.30
hempju1ce: raises $0.30 to $0.60
GrinZwe91!: calls $0.30
*** SHOW DOWN ***
hempju1ce: shows [8c 9d] (two pair, Nines and Eights)
GrinZwe91!: mucks hand 
hempju1ce collected $1.72 from pot
*** SUMMARY ***
Total pot $1.80 | Rake $0.08 
Board [Qs Ad 9c 5c 8h]
Seat 1: hempju1ce (big blind) showed [8c 9d] and won ($1.72) with two pair, Nines and Eights
Seat 2: vilemo20 folded before Flop (didn't bet)
Seat 3: yYanniky folded before Flop (didn't bet)
Seat 4: HeyLo folded before Flop (didn't bet)
Seat 5: 19ElGringo91 (button) folded before Flop (didn't bet)
Seat 6: GrinZwe91! (small blind) mucked



PokerStars Hand #222959829643:  Hold'em No Limit ($0.05/$0.10 USD) - 2021/01/23 11:50:00 ET
Table 'Bohlinia III' 6-max Seat #6 is the button
Seat 1: hempju1ce ($12.78 in chips) 
Seat 2: vilemo20 ($14.63 in chips) 
Seat 3: yYanniky ($10 in chips) 
Seat 4: HeyLo ($15.16 in chips) 
Seat 5: 19ElGringo91 ($10 in chips) 
Seat 6: GrinZwe91! ($10.83 in chips) 
hempju1ce: posts small blind $0.05
vilemo20: posts big blind $0.10
*** HOLE CARDS ***
yYanniky: raises $0.17 to $0.27
HeyLo: folds 
19ElGringo91: folds 
GrinZwe91!: calls $0.27
hempju1ce: folds 
vilemo20: folds 
*** FLOP *** [5c 5h Td]
yYanniky: bets $0.24
GrinZwe91!: folds 
Uncalled bet ($0.24) returned to yYanniky
yYanniky collected $0.66 from pot
yYanniky: doesn't show hand 
*** SUMMARY ***
Total pot $0.69 | Rake $0.03 
Board [5c 5h Td]
Seat 1: hempju1ce (small blind) folded before Flop
Seat 2: vilemo20 (big blind) folded before Flop
Seat 3: yYanniky collected ($0.66)
Seat 4: HeyLo folded before Flop (didn't bet)
Seat 5: 19ElGringo91 folded before Flop (didn't bet)
Seat 6: GrinZwe91! (button) folded on the Flop



PokerStars Hand #222959845002:  Hold'em No Limit ($0.05/$0.10 USD) - 2021/01/23 11:50:25 ET
Table 'Bohlinia III' 6-max Seat #1 is the button
Seat 1: hempju1ce ($12.73 in chips) 
Seat 2: vilemo20 ($14.53 in chips) 
Seat 3: yYanniky ($10.39 in chips) 
Seat 4: HeyLo ($15.16 in chips) 
Seat 5: 19ElGringo91 ($10 in chips) 
Seat 6: GrinZwe91! ($10.56 in chips) 
vilemo20: posts small blind $0.05
yYanniky: posts big blind $0.10
*** HOLE CARDS ***
HeyLo: folds 
19ElGringo91: folds 
GrinZwe91!: folds 
hempju1ce: folds 
vilemo20: folds 
Uncalled bet ($0.05) returned to yYanniky
yYanniky collected $0.10 from pot
yYanniky: doesn't show hand 
*** SUMMARY ***
Total pot $0.10 | Rake $0 
Seat 1: hempju1ce (button) folded before Flop (didn't bet)
Seat 2: vilemo20 (small blind) folded before Flop
Seat 3: yYanniky (big blind) collected ($0.10)
Seat 4: HeyLo folded before Flop (didn't bet)
Seat 5: 19ElGringo91 folded before Flop (didn't bet)
Seat 6: GrinZwe91! folded before Flop (didn't bet)



PokerStars Hand #222959853916:  Hold'em No Limit ($0.05/$0.10 USD) - 2021/01/23 11:50:40 ET
Table 'Bohlinia III' 6-max Seat #2 is the button
Seat 1: hempju1ce ($12.73 in chips) 
Seat 2: vilemo20 ($14.48 in chips) 
Seat 3: yYanniky ($10.44 in chips) 
Seat 4: HeyLo ($15.16 in chips) 
Seat 5: 19ElGringo91 ($10 in chips) 
Seat 6: GrinZwe91! ($10.56 in chips) 
yYanniky: posts small blind $0.05
HeyLo: posts big blind $0.10
*** HOLE CARDS ***
19ElGringo91: folds 
GrinZwe91!: folds 
hempju1ce: folds 
vilemo20: folds 
yYanniky: folds 
Uncalled bet ($0.05) returned to HeyLo
HeyLo collected $0.10 from pot
HeyLo: doesn't show hand 
*** SUMMARY ***
Total pot $0.10 | Rake $0 
Seat 1: hempju1ce folded before Flop (didn't bet)
Seat 2: vilemo20 (button) folded before Flop (didn't bet)
Seat 3: yYanniky (small blind) folded before Flop
Seat 4: HeyLo (big blind) collected ($0.10)
Seat 5: 19ElGringo91 folded before Flop (didn't bet)
Seat 6: GrinZwe91! folded before Flop (didn't bet)



PokerStars Hand #222959862975:  Hold'em No Limit ($0.05/$0.10 USD) - 2021/01/23 11:50:54 ET
Table 'Bohlinia III' 6-max Seat #3 is the button
Seat 1: hempju1ce ($12.73 in chips) 
Seat 2: vilemo20 ($14.48 in chips) 
Seat 3: yYanniky ($10.39 in chips) 
Seat 4: HeyLo ($15.21 in chips) 
Seat 5: 19ElGringo91 ($10 in chips) 
Seat 6: GrinZwe91! ($10.56 in chips) 
HeyLo: posts small blind $0.05
19ElGringo91: posts big blind $0.10
*** HOLE CARDS ***
GrinZwe91!: folds 
hempju1ce: folds 
vilemo20: folds 
yYanniky: folds 
HeyLo: raises $0.20 to $0.30
19ElGringo91: folds 
Uncalled bet ($0.20) returned to HeyLo
HeyLo collected $0.20 from pot
HeyLo: doesn't show hand 
*** SUMMARY ***
Total pot $0.20 | Rake $0 
Seat 1: hempju1ce folded before Flop (didn't bet)
Seat 2: vilemo20 folded before Flop (didn't bet)
Seat 3: yYanniky (button) folded before Flop (didn't bet)
Seat 4: HeyLo (small blind) collected ($0.20)
Seat 5: 19ElGringo91 (big blind) folded before Flop
Seat 6: GrinZwe91! folded before Flop (didn't bet)



PokerStars Hand #222959873449:  Hold'em No Limit ($0.05/$0.10 USD) - 2021/01/23 11:51:11 ET
Table 'Bohlinia III' 6-max Seat #4 is the button
Seat 1: hempju1ce ($12.73 in chips) 
Seat 2: vilemo20 ($14.48 in chips) 
Seat 3: yYanniky ($10.39 in chips) 
Seat 4: HeyLo ($15.31 in chips) 
Seat 5: 19ElGringo91 ($10 in chips) 
Seat 6: GrinZwe91! ($10.56 in chips) 
19ElGringo91: posts small blind $0.05
GrinZwe91!: posts big blind $0.10
*** HOLE CARDS ***
hempju1ce: folds 
vilemo20: raises $0.20 to $0.30
yYanniky: folds 
HeyLo: calls $0.30
19ElGringo91: folds 
GrinZwe91!: folds 
*** FLOP *** [Td 8h 7d]
vilemo20: checks 
HeyLo: bets $0.48
vilemo20: folds 
Uncalled bet ($0.48) returned to HeyLo
HeyLo collected $0.72 from pot
HeyLo: doesn't show hand 
*** SUMMARY ***
Total pot $0.75 | Rake $0.03 
Board [Td 8h 7d]
Seat 1: hempju1ce folded before Flop (didn't bet)
Seat 2: vilemo20 folded on the Flop
Seat 3: yYanniky folded before Flop (didn't bet)
Seat 4: HeyLo (button) collected ($0.72)
Seat 5: 19ElGringo91 (small blind) folded before Flop
Seat 6: GrinZwe91! (big blind) folded before Flop



PokerStars Hand #222959898123:  Hold'em No Limit ($0.05/$0.10 USD) - 2021/01/23 11:51:41 ET
Table 'Bohlinia III' 6-max Seat #5 is the button
Seat 1: hempju1ce ($12.73 in chips) 
Seat 2: vilemo20 ($14.18 in chips) 
Seat 3: yYanniky ($10.39 in chips) 
Seat 4: HeyLo ($15.73 in chips) 
Seat 5: 19ElGringo91 ($10 in chips) 
Seat 6: GrinZwe91! ($10.46 in chips) 
GrinZwe91!: posts small blind $0.05
hempju1ce: posts big blind $0.10
*** HOLE CARDS ***
vilemo20: folds 
yYanniky: folds 
HeyLo: raises $0.20 to $0.30
19ElGringo91: folds 
GrinZwe91!: folds 
hempju1ce: calls $0.20
*** FLOP *** [Qh Ac Jd]
hempju1ce: checks 
HeyLo: bets $0.41
hempju1ce: calls $0.41
*** TURN *** [Qh Ac Jd] [2h]
hempju1ce: checks 
HeyLo: checks 
*** RIVER *** [Qh Ac Jd 2h] [8d]
hempju1ce: bets $0.70
HeyLo: folds 
Uncalled bet ($0.70) returned to hempju1ce
hempju1ce collected $1.40 from pot
hempju1ce: doesn't show hand 
*** SUMMARY ***
Total pot $1.47 | Rake $0.07 
Board [Qh Ac Jd 2h 8d]
Seat 1: hempju1ce (big blind) collected ($1.40)
Seat 2: vilemo20 folded before Flop (didn't bet)
Seat 3: yYanniky folded before Flop (didn't bet)
Seat 4: HeyLo folded on the River
Seat 5: 19ElGringo91 (button) folded before Flop (didn't bet)
Seat 6: GrinZwe91! (small blind) folded before Flop



PokerStars Hand #222959921394:  Hold'em No Limit ($0.05/$0.10 USD) - 2021/01/23 11:52:19 ET
Table 'Bohlinia III' 6-max Seat #6 is the button
Seat 1: hempju1ce ($13.42 in chips) 
Seat 2: vilemo20 ($14.18 in chips) 
Seat 3: yYanniky ($10.39 in chips) 
Seat 4: HeyLo ($15.02 in chips) 
Seat 5: 19ElGringo91 ($10 in chips) 
Seat 6: GrinZwe91! ($10.41 in chips) 
hempju1ce: posts small blind $0.05
vilemo20: posts big blind $0.10
*** HOLE CARDS ***
yYanniky: folds 
HeyLo: raises $0.20 to $0.30
19ElGringo91: folds 
GrinZwe91!: folds 
hempju1ce: folds 
vilemo20: folds 
Uncalled bet ($0.20) returned to HeyLo
HeyLo collected $0.25 from pot
HeyLo: doesn't show hand 
*** SUMMARY ***
Total pot $0.25 | Rake $0 
Seat 1: hempju1ce (small blind) folded before Flop
Seat 2: vilemo20 (big blind) folded before Flop
Seat 3: yYanniky folded before Flop (didn't bet)
Seat 4: HeyLo collected ($0.25)
Seat 5: 19ElGringo91 folded before Flop (didn't bet)
Seat 6: GrinZwe91! (button) folded before Flop (didn't bet)



PokerStars Hand #222959930992:  Hold'em No Limit ($0.05/$0.10 USD) - 2021/01/23 11:52:34 ET
Table 'Bohlinia III' 6-max Seat #1 is the button
Seat 1: hempju1ce ($13.37 in chips) 
Seat 2: vilemo20 ($14.08 in chips) 
Seat 3: yYanniky ($10.39 in chips) 
Seat 4: HeyLo ($15.17 in chips) 
Seat 5: 19ElGringo91 ($10 in chips) 
Seat 6: GrinZwe91! ($10.41 in chips) 
vilemo20: posts small blind $0.05
yYanniky: posts big blind $0.10
*** HOLE CARDS ***
HeyLo: folds 
19ElGringo91: folds 
GrinZwe91!: folds 
hempju1ce: folds 
vilemo20: raises $0.20 to $0.30
yYanniky: calls $0.20
*** FLOP *** [Js 2c 8h]
vilemo20: checks 
yYanniky: bets $0.21
vilemo20: folds 
Uncalled bet ($0.21) returned to yYanniky
yYanniky collected $0.57 from pot
yYanniky: doesn't show hand 
*** SUMMARY ***
Total pot $0.60 | Rake $0.03 
Board [Js 2c 8h]
Seat 1: hempju1ce (button) folded before Flop (didn't bet)
Seat 2: vilemo20 (small blind) folded on the Flop
Seat 3: yYanniky (big blind) collected ($0.57)
Seat 4: HeyLo folded before Flop (didn't bet)
Seat 5: 19ElGringo91 folded before Flop (didn't bet)
Seat 6: GrinZwe91! folded before Flop (didn't bet)



PokerStars Hand #222959952071:  Hold'em No Limit ($0.05/$0.10 USD) - 2021/01/23 11:53:08 ET
Table 'Bohlinia III' 6-max Seat #2 is the button
Seat 1: hempju1ce ($13.37 in chips) 
Seat 2: vilemo20 ($13.78 in chips) 
Seat 3: yYanniky ($10.66 in chips) 
Seat 4: HeyLo ($15.17 in chips) 
Seat 5: 19ElGringo91 ($10 in chips) 
Seat 6: GrinZwe91! ($10.41 in chips) 
yYanniky: posts small blind $0.05
HeyLo: posts big blind $0.10
*** HOLE CARDS ***
19ElGringo91: folds 
GrinZwe91!: raises $0.20 to $0.30
hempju1ce: folds 
vilemo20: folds 
yYanniky: folds 
HeyLo: folds 
Uncalled bet ($0.20) returned to GrinZwe91!
GrinZwe91! collected $0.25 from pot
GrinZwe91!: doesn't show hand 
*** SUMMARY ***
Total pot $0.25 | Rake $0 
Seat 1: hempju1ce folded before Flop (didn't bet)
Seat 2: vilemo20 (button) folded before Flop (didn't bet)
Seat 3: yYanniky (small blind) folded before Flop
Seat 4: HeyLo (big blind) folded before Flop
Seat 5: 19ElGringo91 folded before Flop (didn't bet)
Seat 6: GrinZwe91! collected ($0.25)



PokerStars Hand #222959962298:  Hold'em No Limit ($0.05/$0.10 USD) - 2021/01/23 11:53:25 ET
Table 'Bohlinia III' 6-max Seat #3 is the button
Seat 1: hempju1ce ($13.37 in chips) 
Seat 2: vilemo20 ($13.78 in chips) 
Seat 3: yYanniky ($10.61 in chips) 
Seat 4: HeyLo ($15.07 in chips) 
Seat 5: 19ElGringo91 ($10 in chips) 
Seat 6: GrinZwe91! ($10.56 in chips) 
HeyLo: posts small blind $0.05
19ElGringo91: posts big blind $0.10
*** HOLE CARDS ***
GrinZwe91!: folds 
hempju1ce: raises $0.20 to $0.30
vilemo20: folds 
yYanniky: folds 
HeyLo: folds 
19ElGringo91: folds 
Uncalled bet ($0.20) returned to hempju1ce
hempju1ce collected $0.25 from pot
hempju1ce: doesn't show hand 
*** SUMMARY ***
Total pot $0.25 | Rake $0 
Seat 1: hempju1ce collected ($0.25)
Seat 2: vilemo20 folded before Flop (didn't bet)
Seat 3: yYanniky (button) folded before Flop (didn't bet)
Seat 4: HeyLo (small blind) folded before Flop
Seat 5: 19ElGringo91 (big blind) folded before Flop
Seat 6: GrinZwe91! folded before Flop (didn't bet)



PokerStars Hand #222959969953:  Hold'em No Limit ($0.05/$0.10 USD) - 2021/01/23 11:53:38 ET
Table 'Bohlinia III' 6-max Seat #4 is the button
Seat 1: hempju1ce ($13.52 in chips) 
Seat 2: vilemo20 ($13.78 in chips) 
Seat 3: yYanniky ($10.61 in chips) 
Seat 4: HeyLo ($15.02 in chips) 
Seat 5: 19ElGringo91 ($10 in chips) 
Seat 6: GrinZwe91! ($10.56 in chips) 
19ElGringo91: posts small blind $0.05
GrinZwe91!: posts big blind $0.10
*** HOLE CARDS ***
hempju1ce: folds 
vilemo20: folds 
yYanniky: raises $0.15 to $0.25
HeyLo: folds 
19ElGringo91: raises $0.75 to $1
GrinZwe91!: folds 
yYanniky: folds 
Uncalled bet ($0.75) returned to 19ElGringo91
19ElGringo91 collected $0.60 from pot
19ElGringo91: doesn't show hand 
*** SUMMARY ***
Total pot $0.60 | Rake $0 
Seat 1: hempju1ce folded before Flop (didn't bet)
Seat 2: vilemo20 folded before Flop (didn't bet)
Seat 3: yYanniky folded before Flop
Seat 4: HeyLo (button) folded before Flop (didn't bet)
Seat 5: 19ElGringo91 (small blind) collected ($0.60)
Seat 6: GrinZwe91! (big blind) folded before Flop



PokerStars Hand #222959987749:  Hold'em No Limit ($0.05/$0.10 USD) - 2021/01/23 11:54:07 ET
Table 'Bohlinia III' 6-max Seat #5 is the button
Seat 1: hempju1ce ($13.52 in chips) 
Seat 2: vilemo20 ($13.78 in chips) 
Seat 3: yYanniky ($10.36 in chips) 
Seat 4: HeyLo ($15.02 in chips) 
Seat 5: 19ElGringo91 ($10.35 in chips) 
Seat 6: GrinZwe91! ($10.46 in chips) 
GrinZwe91!: posts small blind $0.05
hempju1ce: posts big blind $0.10
*** HOLE CARDS ***
vilemo20: folds 
yYanniky: folds 
HeyLo: folds 
19ElGringo91: folds 
GrinZwe91!: raises $0.20 to $0.30
hempju1ce: folds 
Uncalled bet ($0.20) returned to GrinZwe91!
GrinZwe91! collected $0.20 from pot
GrinZwe91!: doesn't show hand 
*** SUMMARY ***
Total pot $0.20 | Rake $0 
Seat 1: hempju1ce (big blind) folded before Flop
Seat 2: vilemo20 folded before Flop (didn't bet)
Seat 3: yYanniky folded before Flop (didn't bet)
Seat 4: HeyLo folded before Flop (didn't bet)
Seat 5: 19ElGringo91 (button) folded before Flop (didn't bet)
Seat 6: GrinZwe91! (small blind) collected ($0.20)



PokerStars Hand #222960000905:  Hold'em No Limit ($0.05/$0.10 USD) - 2021/01/23 11:54:28 ET
Table 'Bohlinia III' 6-max Seat #6 is the button
Seat 1: hempju1ce ($13.42 in chips) 
Seat 2: vilemo20 ($13.78 in chips) 
Seat 3: yYanniky ($10.36 in chips) 
Seat 4: HeyLo ($15.02 in chips) 
Seat 5: 19ElGringo91 ($10.35 in chips) 
Seat 6: GrinZwe91! ($10.56 in chips) 
hempju1ce: posts small blind $0.05
vilemo20: posts big blind $0.10
*** HOLE CARDS ***
yYanniky: folds 
HeyLo: folds 
19ElGringo91: folds 
GrinZwe91!: folds 
hempju1ce: folds 
Uncalled bet ($0.05) returned to vilemo20
vilemo20 collected $0.10 from pot
vilemo20: doesn't show hand 
*** SUMMARY ***
Total pot $0.10 | Rake $0 
Seat 1: hempju1ce (small blind) folded before Flop
Seat 2: vilemo20 (big blind) collected ($0.10)
Seat 3: yYanniky folded before Flop (didn't bet)
Seat 4: HeyLo folded before Flop (didn't bet)
Seat 5: 19ElGringo91 folded before Flop (didn't bet)
Seat 6: GrinZwe91! (button) folded before Flop (didn't bet)



PokerStars Hand #222960009936:  Hold'em No Limit ($0.05/$0.10 USD) - 2021/01/23 11:54:42 ET
Table 'Bohlinia III' 6-max Seat #1 is the button
Seat 1: hempju1ce ($13.37 in chips) 
Seat 2: vilemo20 ($13.83 in chips) 
Seat 3: yYanniky ($10.36 in chips) 
Seat 4: HeyLo ($15.02 in chips) 
Seat 5: 19ElGringo91 ($10.35 in chips) 
Seat 6: GrinZwe91! ($10.56 in chips) 
vilemo20: posts small blind $0.05
yYanniky: posts big blind $0.10
*** HOLE CARDS ***
HeyLo: folds 
19ElGringo91: folds 
GrinZwe91!: folds 
hempju1ce: calls $0.10
vilemo20: folds 
yYanniky: checks 
*** FLOP *** [Kd As 7h]
yYanniky: checks 
hempju1ce: checks 
*** TURN *** [Kd As 7h] [Tc]
yYanniky: bets $0.12
hempju1ce: folds 
Uncalled bet ($0.12) returned to yYanniky
yYanniky collected $0.24 from pot
yYanniky: doesn't show hand 
*** SUMMARY ***
Total pot $0.25 | Rake $0.01 
Board [Kd As 7h Tc]
Seat 1: hempju1ce (button) folded on the Turn
Seat 2: vilemo20 (small blind) folded before Flop
Seat 3: yYanniky (big blind) collected ($0.24)
Seat 4: HeyLo folded before Flop (didn't bet)
Seat 5: 19ElGringo91 folded before Flop (didn't bet)
Seat 6: GrinZwe91! folded before Flop (didn't bet)



PokerStars Hand #222960029531:  Hold'em No Limit ($0.05/$0.10 USD) - 2021/01/23 11:55:16 ET
Table 'Bohlinia III' 6-max Seat #2 is the button
Seat 1: hempju1ce ($13.27 in chips) 
Seat 2: vilemo20 ($13.78 in chips) 
Seat 3: yYanniky ($10.50 in chips) 
Seat 4: HeyLo ($15.02 in chips) 
Seat 5: 19ElGringo91 ($10.35 in chips) 
Seat 6: GrinZwe91! ($10.56 in chips) 
yYanniky: posts small blind $0.05
HeyLo: posts big blind $0.10
*** HOLE CARDS ***
19ElGringo91: folds 
GrinZwe91!: folds 
hempju1ce: folds 
vilemo20: raises $0.15 to $0.25
yYanniky: folds 
HeyLo: folds 
Uncalled bet ($0.15) returned to vilemo20
vilemo20 collected $0.25 from pot
vilemo20: doesn't show hand 
*** SUMMARY ***
Total pot $0.25 | Rake $0 
Seat 1: hempju1ce folded before Flop (didn't bet)
Seat 2: vilemo20 (button) collected ($0.25)
Seat 3: yYanniky (small blind) folded before Flop
Seat 4: HeyLo (big blind) folded before Flop
Seat 5: 19ElGringo91 folded before Flop (didn't bet)
Seat 6: GrinZwe91! folded before Flop (didn't bet)



PokerStars Hand #222960035475:  Hold'em No Limit ($0.05/$0.10 USD) - 2021/01/23 11:55:29 ET
Table 'Bohlinia III' 6-max Seat #3 is the button
Seat 1: hempju1ce ($13.27 in chips) 
Seat 2: vilemo20 ($13.93 in chips) 
Seat 3: yYanniky ($10.45 in chips) 
Seat 4: HeyLo ($14.92 in chips) 
Seat 5: 19ElGringo91 ($10.35 in chips) 
Seat 6: GrinZwe91! ($10.56 in chips) 
HeyLo: posts small blind $0.05
19ElGringo91: posts big blind $0.10
*** HOLE CARDS ***
GrinZwe91!: folds 
hempju1ce: folds 
vilemo20: folds 
yYanniky: raises $0.15 to $0.25
HeyLo: folds 
19ElGringo91: folds 
Uncalled bet ($0.15) returned to yYanniky
yYanniky collected $0.25 from pot
yYanniky: doesn't show hand 
*** SUMMARY ***
Total pot $0.25 | Rake $0 
Seat 1: hempju1ce folded before Flop (didn't bet)
Seat 2: vilemo20 folded before Flop (didn't bet)
Seat 3: yYanniky (button) collected ($0.25)
Seat 4: HeyLo (small blind) folded before Flop
Seat 5: 19ElGringo91 (big blind) folded before Flop
Seat 6: GrinZwe91! folded before Flop (didn't bet)



PokerStars Hand #222960042157:  Hold'em No Limit ($0.05/$0.10 USD) - 2021/01/23 11:55:44 ET
Table 'Bohlinia III' 6-max Seat #4 is the button
Seat 1: hempju1ce ($13.27 in chips) 
Seat 2: vilemo20 ($13.93 in chips) 
Seat 3: yYanniky ($10.60 in chips) 
Seat 4: HeyLo ($14.87 in chips) 
Seat 5: 19ElGringo91 ($10.25 in chips) 
Seat 6: GrinZwe91! ($10.56 in chips) 
19ElGringo91: posts small blind $0.05
GrinZwe91!: posts big blind $0.10
*** HOLE CARDS ***
hempju1ce: folds 
vilemo20: raises $0.20 to $0.30
yYanniky: folds 
HeyLo: raises $0.70 to $1
19ElGringo91: folds 
GrinZwe91!: folds 
vilemo20: calls $0.70
*** FLOP *** [Th 3h As]
vilemo20: checks 
HeyLo: bets $1.37
vilemo20: calls $1.37
*** TURN *** [Th 3h As] [7s]
vilemo20: checks 
HeyLo: bets $4.67
vilemo20: folds 
Uncalled bet ($4.67) returned to HeyLo
HeyLo collected $4.67 from pot
HeyLo: doesn't show hand 
*** SUMMARY ***
Total pot $4.89 | Rake $0.22 
Board [Th 3h As 7s]
Seat 1: hempju1ce folded before Flop (didn't bet)
Seat 2: vilemo20 folded on the Turn
Seat 3: yYanniky folded before Flop (didn't bet)
Seat 4: HeyLo (button) collected ($4.67)
Seat 5: 19ElGringo91 (small blind) folded before Flop
Seat 6: GrinZwe91! (big blind) folded before Flop



PokerStars Hand #222960073847:  Hold'em No Limit ($0.05/$0.10 USD) - 2021/01/23 11:56:52 ET
Table 'Bohlinia III' 6-max Seat #5 is the button
Seat 1: hempju1ce ($13.27 in chips) 
Seat 2: vilemo20 ($11.56 in chips) 
Seat 3: yYanniky ($10.60 in chips) 
Seat 4: HeyLo ($17.17 in chips) 
Seat 5: 19ElGringo91 ($10.20 in chips) 
Seat 6: GrinZwe91! ($10.46 in chips) 
GrinZwe91!: posts small blind $0.05
hempju1ce: posts big blind $0.10
*** HOLE CARDS ***
vilemo20: folds 
yYanniky: folds 
HeyLo: folds 
19ElGringo91: raises $0.20 to $0.30
GrinZwe91!: folds 
hempju1ce: calls $0.20
*** FLOP *** [8c 5d 7d]
hempju1ce: checks 
19ElGringo91: checks 
*** TURN *** [8c 5d 7d] [5c]
hempju1ce: checks 
19ElGringo91: bets $0.47
hempju1ce: folds 
Uncalled bet ($0.47) returned to 19ElGringo91
19ElGringo91 collected $0.62 from pot
19ElGringo91: doesn't show hand 
*** SUMMARY ***
Total pot $0.65 | Rake $0.03 
Board [8c 5d 7d 5c]
Seat 1: hempju1ce (big blind) folded on the Turn
Seat 2: vilemo20 folded before Flop (didn't bet)
Seat 3: yYanniky folded before Flop (didn't bet)
Seat 4: HeyLo folded before Flop (didn't bet)
Seat 5: 19ElGringo91 (button) collected ($0.62)
Seat 6: GrinZwe91! (small blind) folded before Flop



PokerStars Hand #222960094669:  Hold'em No Limit ($0.05/$0.10 USD) - 2021/01/23 11:57:36 ET
Table 'Bohlinia III' 6-max Seat #6 is the button
Seat 1: hempju1ce ($12.97 in chips) 
Seat 2: vilemo20 ($11.56 in chips) 
Seat 3: yYanniky ($10.60 in chips) 
Seat 4: HeyLo ($17.17 in chips) 
Seat 5: 19ElGringo91 ($10.52 in chips) 
Seat 6: GrinZwe91! ($10.41 in chips) 
hempju1ce: posts small blind $0.05
vilemo20: posts big blind $0.10
*** HOLE CARDS ***
yYanniky: folds 
HeyLo: folds 
19ElGringo91: raises $0.20 to $0.30
GrinZwe91!: folds 
hempju1ce: folds 
vilemo20: folds 
Uncalled bet ($0.20) returned to 19ElGringo91
19ElGringo91 collected $0.25 from pot
19ElGringo91: doesn't show hand 
*** SUMMARY ***
Total pot $0.25 | Rake $0 
Seat 1: hempju1ce (small blind) folded before Flop
Seat 2: vilemo20 (big blind) folded before Flop
Seat 3: yYanniky folded before Flop (didn't bet)
Seat 4: HeyLo folded before Flop (didn't bet)
Seat 5: 19ElGringo91 collected ($0.25)
Seat 6: GrinZwe91! (button) folded before Flop (didn't bet)



PokerStars Hand #222960107037:  Hold'em No Limit ($0.05/$0.10 USD) - 2021/01/23 11:58:02 ET
Table 'Bohlinia III' 6-max Seat #1 is the button
Seat 1: hempju1ce ($12.92 in chips) 
Seat 2: vilemo20 ($11.46 in chips) 
Seat 3: yYanniky ($10.60 in chips) 
Seat 4: HeyLo ($17.17 in chips) 
Seat 5: 19ElGringo91 ($10.67 in chips) 
Seat 6: GrinZwe91! ($10.41 in chips) 
vilemo20: posts small blind $0.05
yYanniky: posts big blind $0.10
*** HOLE CARDS ***
HeyLo: folds 
19ElGringo91: folds 
GrinZwe91!: raises $0.20 to $0.30
hempju1ce: folds 
vilemo20: folds 
yYanniky: folds 
Uncalled bet ($0.20) returned to GrinZwe91!
GrinZwe91! collected $0.25 from pot
GrinZwe91!: doesn't show hand 
*** SUMMARY ***
Total pot $0.25 | Rake $0 
Seat 1: hempju1ce (button) folded before Flop (didn't bet)
Seat 2: vilemo20 (small blind) folded before Flop
Seat 3: yYanniky (big blind) folded before Flop
Seat 4: HeyLo folded before Flop (didn't bet)
Seat 5: 19ElGringo91 folded before Flop (didn't bet)
Seat 6: GrinZwe91! collected ($0.25)



PokerStars Hand #222960113084:  Hold'em No Limit ($0.05/$0.10 USD) - 2021/01/23 11:58:15 ET
Table 'Bohlinia III' 6-max Seat #2 is the button
Seat 1: hempju1ce ($12.92 in chips) 
Seat 2: vilemo20 ($11.41 in chips) 
Seat 3: yYanniky ($10.50 in chips) 
Seat 4: HeyLo ($17.17 in chips) 
Seat 5: 19ElGringo91 ($10.67 in chips) 
Seat 6: GrinZwe91! ($10.56 in chips) 
yYanniky: posts small blind $0.05
HeyLo: posts big blind $0.10
*** HOLE CARDS ***
19ElGringo91: folds 
GrinZwe91!: folds 
hempju1ce: calls $0.10
vilemo20: calls $0.10
yYanniky: calls $0.05
HeyLo: checks 
*** FLOP *** [6h Jd 4d]
yYanniky: checks 
HeyLo: bets $0.25
hempju1ce: folds 
vilemo20: folds 
yYanniky: folds 
Uncalled bet ($0.25) returned to HeyLo
HeyLo collected $0.38 from pot
HeyLo: doesn't show hand 
*** SUMMARY ***
Total pot $0.40 | Rake $0.02 
Board [6h Jd 4d]
Seat 1: hempju1ce folded on the Flop
Seat 2: vilemo20 (button) folded on the Flop
Seat 3: yYanniky (small blind) folded on the Flop
Seat 4: HeyLo (big blind) collected ($0.38)
Seat 5: 19ElGringo91 folded before Flop (didn't bet)
Seat 6: GrinZwe91! folded before Flop (didn't bet)



PokerStars Hand #222960132893:  Hold'em No Limit ($0.05/$0.10 USD) - 2021/01/23 11:58:57 ET
Table 'Bohlinia III' 6-max Seat #3 is the button
Seat 1: hempju1ce ($12.82 in chips) 
Seat 2: vilemo20 ($11.31 in chips) 
Seat 3: yYanniky ($10.40 in chips) 
Seat 4: HeyLo ($17.45 in chips) 
Seat 5: 19ElGringo91 ($10.67 in chips) 
Seat 6: GrinZwe91! ($10.56 in chips) 
HeyLo: posts small blind $0.05
19ElGringo91: posts big blind $0.10
*** HOLE CARDS ***
GrinZwe91!: folds 
hempju1ce: folds 
vilemo20: folds 
yYanniky: folds 
HeyLo: raises $0.10 to $0.20
19ElGringo91: calls $0.10
*** FLOP *** [4d 4s Ts]
HeyLo: checks 
19ElGringo91: checks 
*** TURN *** [4d 4s Ts] [3h]
HeyLo: bets $0.20
19ElGringo91: folds 
Uncalled bet ($0.20) returned to HeyLo
HeyLo collected $0.38 from pot
HeyLo: doesn't show hand 
*** SUMMARY ***
Total pot $0.40 | Rake $0.02 
Board [4d 4s Ts 3h]
Seat 1: hempju1ce folded before Flop (didn't bet)
Seat 2: vilemo20 folded before Flop (didn't bet)
Seat 3: yYanniky (button) folded before Flop (didn't bet)
Seat 4: HeyLo (small blind) collected ($0.38)
Seat 5: 19ElGringo91 (big blind) folded on the Turn
Seat 6: GrinZwe91! folded before Flop (didn't bet)



PokerStars Hand #222960148186:  Hold'em No Limit ($0.05/$0.10 USD) - 2021/01/23 11:59:29 ET
Table 'Bohlinia III' 6-max Seat #4 is the button
Seat 1: hempju1ce ($12.82 in chips) 
Seat 2: vilemo20 ($11.31 in chips) 
Seat 3: yYanniky ($10.40 in chips) 
Seat 4: HeyLo ($17.63 in chips) 
Seat 5: 19ElGringo91 ($10.47 in chips) 
Seat 6: GrinZwe91! ($10.56 in chips) 
19ElGringo91: posts small blind $0.05
GrinZwe91!: posts big blind $0.10
*** HOLE CARDS ***
hempju1ce: raises $0.10 to $0.20
vilemo20: folds 
yYanniky: folds 
HeyLo: folds 
19ElGringo91: raises $0.80 to $1
GrinZwe91!: folds 
hempju1ce: calls $0.80
*** FLOP *** [5d Td Kd]
19ElGringo91: checks 
hempju1ce: checks 
*** TURN *** [5d Td Kd] [6s]
19ElGringo91: bets $1.51
hempju1ce: folds 
Uncalled bet ($1.51) returned to 19ElGringo91
19ElGringo91 collected $2.01 from pot
19ElGringo91: doesn't show hand 
*** SUMMARY ***
Total pot $2.10 | Rake $0.09 
Board [5d Td Kd 6s]
Seat 1: hempju1ce folded on the Turn
Seat 2: vilemo20 folded before Flop (didn't bet)
Seat 3: yYanniky folded before Flop (didn't bet)
Seat 4: HeyLo (button) folded before Flop (didn't bet)
Seat 5: 19ElGringo91 (small blind) collected ($2.01)
Seat 6: GrinZwe91! (big blind) folded before Flop



PokerStars Hand #222960172479:  Hold'em No Limit ($0.05/$0.10 USD) - 2021/01/23 12:00:19 ET
Table 'Bohlinia III' 6-max Seat #5 is the button
Seat 1: hempju1ce ($11.82 in chips) 
Seat 2: vilemo20 ($11.31 in chips) 
Seat 3: yYanniky ($10.40 in chips) 
Seat 4: HeyLo ($17.63 in chips) 
Seat 5: 19ElGringo91 ($11.48 in chips) 
Seat 6: GrinZwe91! ($10.46 in chips) 
GrinZwe91!: posts small blind $0.05
hempju1ce: posts big blind $0.10
*** HOLE CARDS ***
vilemo20: folds 
yYanniky: folds 
HeyLo: folds 
19ElGringo91: raises $0.20 to $0.30
GrinZwe91!: folds 
hempju1ce: calls $0.20
*** FLOP *** [Qh 2c 3c]
hempju1ce: checks 
19ElGringo91: checks 
*** TURN *** [Qh 2c 3c] [Qc]
hempju1ce: checks 
19ElGringo91: bets $0.20
hempju1ce: calls $0.20
*** RIVER *** [Qh 2c 3c Qc] [Ks]
hempju1ce: checks 
19ElGringo91: checks 
*** SHOW DOWN ***
hempju1ce: shows [Kc Th] (two pair, Kings and Queens)
19ElGringo91: mucks hand 
hempju1ce collected $1 from pot
*** SUMMARY ***
Total pot $1.05 | Rake $0.05 
Board [Qh 2c 3c Qc Ks]
Seat 1: hempju1ce (big blind) showed [Kc Th] and won ($1) with two pair, Kings and Queens
Seat 2: vilemo20 folded before Flop (didn't bet)
Seat 3: yYanniky folded before Flop (didn't bet)
Seat 4: HeyLo folded before Flop (didn't bet)
Seat 5: 19ElGringo91 (button) mucked
Seat 6: GrinZwe91! (small blind) folded before Flop



PokerStars Hand #222960200419:  Hold'em No Limit ($0.05/$0.10 USD) - 2021/01/23 12:00:58 ET
Table 'Bohlinia III' 6-max Seat #6 is the button
Seat 1: hempju1ce ($12.32 in chips) 
Seat 2: vilemo20 ($11.31 in chips) 
Seat 3: yYanniky ($10.40 in chips) 
Seat 4: HeyLo ($17.63 in chips) 
Seat 5: 19ElGringo91 ($10.98 in chips) 
Seat 6: GrinZwe91! ($10.41 in chips) 
hempju1ce: posts small blind $0.05
vilemo20: posts big blind $0.10
*** HOLE CARDS ***
yYanniky: folds 
HeyLo: folds 
19ElGringo91: folds 
GrinZwe91!: folds 
hempju1ce: calls $0.05
vilemo20: checks 
*** FLOP *** [3h Ad 5d]
hempju1ce: checks 
vilemo20: bets $0.20
hempju1ce: folds 
Uncalled bet ($0.20) returned to vilemo20
vilemo20 collected $0.19 from pot
vilemo20: doesn't show hand 
*** SUMMARY ***
Total pot $0.20 | Rake $0.01 
Board [3h Ad 5d]
Seat 1: hempju1ce (small blind) folded on the Flop
Seat 2: vilemo20 (big blind) collected ($0.19)
Seat 3: yYanniky folded before Flop (didn't bet)
Seat 4: HeyLo folded before Flop (didn't bet)
Seat 5: 19ElGringo91 folded before Flop (didn't bet)
Seat 6: GrinZwe91! (button) folded before Flop (didn't bet)



PokerStars Hand #222960215786:  Hold'em No Limit ($0.05/$0.10 USD) - 2021/01/23 12:01:25 ET
Table 'Bohlinia III' 6-max Seat #1 is the button
Seat 1: hempju1ce ($12.22 in chips) 
Seat 2: vilemo20 ($11.40 in chips) 
Seat 3: yYanniky ($10.40 in chips) 
Seat 4: HeyLo ($17.63 in chips) 
Seat 5: 19ElGringo91 ($10.98 in chips) 
Seat 6: GrinZwe91! ($10.41 in chips) 
vilemo20: posts small blind $0.05
yYanniky: posts big blind $0.10
*** HOLE CARDS ***
HeyLo: raises $0.20 to $0.30
19ElGringo91: folds 
GrinZwe91!: folds 
hempju1ce: folds 
vilemo20: folds 
yYanniky: folds 
Uncalled bet ($0.20) returned to HeyLo
HeyLo collected $0.25 from pot
HeyLo: doesn't show hand 
*** SUMMARY ***
Total pot $0.25 | Rake $0 
Seat 1: hempju1ce (button) folded before Flop (didn't bet)
Seat 2: vilemo20 (small blind) folded before Flop
Seat 3: yYanniky (big blind) folded before Flop
Seat 4: HeyLo collected ($0.25)
Seat 5: 19ElGringo91 folded before Flop (didn't bet)
Seat 6: GrinZwe91! folded before Flop (didn't bet)



PokerStars Hand #222960225115:  Hold'em No Limit ($0.05/$0.10 USD) - 2021/01/23 12:01:41 ET
Table 'Bohlinia III' 6-max Seat #2 is the button
Seat 1: hempju1ce ($12.22 in chips) 
Seat 2: vilemo20 ($11.35 in chips) 
Seat 3: yYanniky ($10.30 in chips) 
Seat 4: HeyLo ($17.78 in chips) 
Seat 5: 19ElGringo91 ($10.98 in chips) 
Seat 6: GrinZwe91! ($10.41 in chips) 
yYanniky: posts small blind $0.05
HeyLo: posts big blind $0.10
*** HOLE CARDS ***
19ElGringo91: folds 
GrinZwe91!: folds 
hempju1ce: folds 
vilemo20: raises $0.15 to $0.25
yYanniky: folds 
HeyLo: folds 
Uncalled bet ($0.15) returned to vilemo20
vilemo20 collected $0.25 from pot
vilemo20: doesn't show hand 
*** SUMMARY ***
Total pot $0.25 | Rake $0 
Seat 1: hempju1ce folded before Flop (didn't bet)
Seat 2: vilemo20 (button) collected ($0.25)
Seat 3: yYanniky (small blind) folded before Flop
Seat 4: HeyLo (big blind) folded before Flop
Seat 5: 19ElGringo91 folded before Flop (didn't bet)
Seat 6: GrinZwe91! folded before Flop (didn't bet)



PokerStars Hand #222960232955:  Hold'em No Limit ($0.05/$0.10 USD) - 2021/01/23 12:01:54 ET
Table 'Bohlinia III' 6-max Seat #3 is the button
Seat 1: hempju1ce ($12.22 in chips) 
Seat 2: vilemo20 ($11.50 in chips) 
Seat 3: yYanniky ($10.25 in chips) 
Seat 4: HeyLo ($17.68 in chips) 
Seat 5: 19ElGringo91 ($10.98 in chips) 
Seat 6: GrinZwe91! ($10.41 in chips) 
HeyLo: posts small blind $0.05
19ElGringo91: posts big blind $0.10
*** HOLE CARDS ***
GrinZwe91!: folds 
hempju1ce: folds 
vilemo20: folds 
yYanniky: folds 
HeyLo: raises $0.20 to $0.30
19ElGringo91: folds 
Uncalled bet ($0.20) returned to HeyLo
HeyLo collected $0.20 from pot
HeyLo: doesn't show hand 
*** SUMMARY ***
Total pot $0.20 | Rake $0 
Seat 1: hempju1ce folded before Flop (didn't bet)
Seat 2: vilemo20 folded before Flop (didn't bet)
Seat 3: yYanniky (button) folded before Flop (didn't bet)
Seat 4: HeyLo (small blind) collected ($0.20)
Seat 5: 19ElGringo91 (big blind) folded before Flop
Seat 6: GrinZwe91! folded before Flop (didn't bet)



PokerStars Hand #222960244609:  Hold'em No Limit ($0.05/$0.10 USD) - 2021/01/23 12:02:13 ET
Table 'Bohlinia III' 6-max Seat #4 is the button
Seat 1: hempju1ce ($12.22 in chips) 
Seat 2: vilemo20 ($11.50 in chips) 
Seat 3: yYanniky ($10.25 in chips) 
Seat 4: HeyLo ($17.78 in chips) 
Seat 5: 19ElGringo91 ($10.88 in chips) 
Seat 6: GrinZwe91! ($10.41 in chips) 
19ElGringo91: posts small blind $0.05
GrinZwe91!: posts big blind $0.10
*** HOLE CARDS ***
hempju1ce: folds 
vilemo20: folds 
yYanniky: raises $0.15 to $0.25
HeyLo: raises $0.65 to $0.90
19ElGringo91: folds 
GrinZwe91!: folds 
yYanniky: folds 
Uncalled bet ($0.65) returned to HeyLo
HeyLo collected $0.65 from pot
HeyLo: doesn't show hand 
*** SUMMARY ***
Total pot $0.65 | Rake $0 
Seat 1: hempju1ce folded before Flop (didn't bet)
Seat 2: vilemo20 folded before Flop (didn't bet)
Seat 3: yYanniky folded before Flop
Seat 4: HeyLo (button) collected ($0.65)
Seat 5: 19ElGringo91 (small blind) folded before Flop
Seat 6: GrinZwe91! (big blind) folded before Flop



PokerStars Hand #222960255831:  Hold'em No Limit ($0.05/$0.10 USD) - 2021/01/23 12:02:31 ET
Table 'Bohlinia III' 6-max Seat #5 is the button
Seat 1: hempju1ce ($12.22 in chips) 
Seat 2: vilemo20 ($11.50 in chips) 
Seat 3: yYanniky ($10 in chips) 
Seat 4: HeyLo ($18.18 in chips) 
Seat 5: 19ElGringo91 ($10.83 in chips) 
Seat 6: GrinZwe91! ($10.31 in chips) 
GrinZwe91!: posts small blind $0.05
hempju1ce: posts big blind $0.10
*** HOLE CARDS ***
vilemo20: raises $0.20 to $0.30
yYanniky: folds 
HeyLo: folds 
19ElGringo91: folds 
GrinZwe91!: folds 
hempju1ce: folds 
Uncalled bet ($0.20) returned to vilemo20
vilemo20 collected $0.25 from pot
vilemo20: doesn't show hand 
*** SUMMARY ***
Total pot $0.25 | Rake $0 
Seat 1: hempju1ce (big blind) folded before Flop
Seat 2: vilemo20 collected ($0.25)
Seat 3: yYanniky folded before Flop (didn't bet)
Seat 4: HeyLo folded before Flop (didn't bet)
Seat 5: 19ElGringo91 (button) folded before Flop (didn't bet)
Seat 6: GrinZwe91! (small blind) folded before Flop



PokerStars Hand #222960266127:  Hold'em No Limit ($0.05/$0.10 USD) - 2021/01/23 12:02:48 ET
Table 'Bohlinia III' 6-max Seat #6 is the button
Seat 1: hempju1ce ($12.12 in chips) 
Seat 2: vilemo20 ($11.65 in chips) 
Seat 3: yYanniky ($10 in chips) 
Seat 4: HeyLo ($18.18 in chips) 
Seat 5: 19ElGringo91 ($10.83 in chips) 
Seat 6: GrinZwe91! ($10.26 in chips) 
hempju1ce: posts small blind $0.05
vilemo20: posts big blind $0.10
*** HOLE CARDS ***
yYanniky: folds 
HeyLo: folds 
19ElGringo91: raises $0.20 to $0.30
GrinZwe91!: folds 
hempju1ce: calls $0.25
vilemo20: folds 
*** FLOP *** [6h 2h Th]
hempju1ce: checks 
19ElGringo91: checks 
*** TURN *** [6h 2h Th] [9d]
hempju1ce: checks 
19ElGringo91: checks 
*** RIVER *** [6h 2h Th 9d] [Jc]
hempju1ce: checks 
19ElGringo91: checks 
*** SHOW DOWN ***
hempju1ce: shows [Ad 7d] (high card Ace)
19ElGringo91: shows [5c 5d] (a pair of Fives)
19ElGringo91 collected $0.67 from pot
*** SUMMARY ***
Total pot $0.70 | Rake $0.03 
Board [6h 2h Th 9d Jc]
Seat 1: hempju1ce (small blind) showed [Ad 7d] and lost with high card Ace
Seat 2: vilemo20 (big blind) folded before Flop
Seat 3: yYanniky folded before Flop (didn't bet)
Seat 4: HeyLo folded before Flop (didn't bet)
Seat 5: 19ElGringo91 showed [5c 5d] and won ($0.67) with a pair of Fives
Seat 6: GrinZwe91! (button) folded before Flop (didn't bet)



PokerStars Hand #222960287912:  Hold'em No Limit ($0.05/$0.10 USD) - 2021/01/23 12:03:22 ET
Table 'Bohlinia III' 6-max Seat #1 is the button
Seat 1: hempju1ce ($11.82 in chips) 
Seat 2: vilemo20 ($11.55 in chips) 
Seat 3: yYanniky ($10 in chips) 
Seat 4: HeyLo ($18.18 in chips) 
Seat 5: 19ElGringo91 ($11.20 in chips) 
Seat 6: GrinZwe91! ($10.26 in chips) 
vilemo20: posts small blind $0.05
yYanniky: posts big blind $0.10
*** HOLE CARDS ***
HeyLo: folds 
19ElGringo91: folds 
GrinZwe91!: raises $0.20 to $0.30
hempju1ce: folds 
vilemo20: folds 
yYanniky: folds 
Uncalled bet ($0.20) returned to GrinZwe91!
GrinZwe91! collected $0.25 from pot
GrinZwe91!: doesn't show hand 
*** SUMMARY ***
Total pot $0.25 | Rake $0 
Seat 1: hempju1ce (button) folded before Flop (didn't bet)
Seat 2: vilemo20 (small blind) folded before Flop
Seat 3: yYanniky (big blind) folded before Flop
Seat 4: HeyLo folded before Flop (didn't bet)
Seat 5: 19ElGringo91 folded before Flop (didn't bet)
Seat 6: GrinZwe91! collected ($0.25)



PokerStars Hand #222960297897:  Hold'em No Limit ($0.05/$0.10 USD) - 2021/01/23 12:03:39 ET
Table 'Bohlinia III' 6-max Seat #2 is the button
Seat 1: hempju1ce ($11.82 in chips) 
Seat 2: vilemo20 ($11.50 in chips) 
Seat 3: yYanniky ($10 in chips) 
Seat 4: HeyLo ($18.18 in chips) 
Seat 5: 19ElGringo91 ($11.20 in chips) 
Seat 6: GrinZwe91! ($10.41 in chips) 
yYanniky: posts small blind $0.05
HeyLo: posts big blind $0.10
*** HOLE CARDS ***
19ElGringo91: raises $0.20 to $0.30
GrinZwe91!: folds 
hempju1ce: folds 
vilemo20: folds 
yYanniky: folds 
HeyLo: calls $0.20
*** FLOP *** [5d 3c 9h]
HeyLo: checks 
19ElGringo91: bets $0.32
HeyLo: folds 
Uncalled bet ($0.32) returned to 19ElGringo91
19ElGringo91 collected $0.62 from pot
19ElGringo91: doesn't show hand 
*** SUMMARY ***
Total pot $0.65 | Rake $0.03 
Board [5d 3c 9h]
Seat 1: hempju1ce folded before Flop (didn't bet)
Seat 2: vilemo20 (button) folded before Flop (didn't bet)
Seat 3: yYanniky (small blind) folded before Flop
Seat 4: HeyLo (big blind) folded on the Flop
Seat 5: 19ElGringo91 collected ($0.62)
Seat 6: GrinZwe91! folded before Flop (didn't bet)



PokerStars Hand #222960315947:  Hold'em No Limit ($0.05/$0.10 USD) - 2021/01/23 12:04:07 ET
Table 'Bohlinia III' 6-max Seat #3 is the button
Seat 1: hempju1ce ($11.82 in chips) 
Seat 2: vilemo20 ($11.50 in chips) 
Seat 3: yYanniky ($10 in chips) 
Seat 4: HeyLo ($17.88 in chips) 
Seat 5: 19ElGringo91 ($11.52 in chips) 
Seat 6: GrinZwe91! ($10.41 in chips) 
HeyLo: posts small blind $0.05
19ElGringo91: posts big blind $0.10
*** HOLE CARDS ***
GrinZwe91!: raises $0.20 to $0.30
hempju1ce: folds 
vilemo20: folds 
yYanniky: calls $0.30
HeyLo: folds 
19ElGringo91: folds 
*** FLOP *** [Qh Th 6c]
GrinZwe91!: checks 
yYanniky: checks 
*** TURN *** [Qh Th 6c] [5h]
GrinZwe91!: checks 
yYanniky: bets $0.27
GrinZwe91!: calls $0.27
*** RIVER *** [Qh Th 6c 5h] [2d]
GrinZwe91!: checks 
yYanniky: checks 
*** SHOW DOWN ***
GrinZwe91!: shows [Td Ad] (a pair of Tens)
yYanniky: mucks hand 
GrinZwe91! collected $1.23 from pot
*** SUMMARY ***
Total pot $1.29 | Rake $0.06 
Board [Qh Th 6c 5h 2d]
Seat 1: hempju1ce folded before Flop (didn't bet)
Seat 2: vilemo20 folded before Flop (didn't bet)
Seat 3: yYanniky (button) mucked
Seat 4: HeyLo (small blind) folded before Flop
Seat 5: 19ElGringo91 (big blind) folded before Flop
Seat 6: GrinZwe91! showed [Td Ad] and won ($1.23) with a pair of Tens



PokerStars Hand #222960344921:  Hold'em No Limit ($0.05/$0.10 USD) - 2021/01/23 12:04:53 ET
Table 'Bohlinia III' 6-max Seat #4 is the button
Seat 1: hempju1ce ($11.82 in chips) 
Seat 2: vilemo20 ($11.50 in chips) 
Seat 3: yYanniky ($10 in chips) 
Seat 4: HeyLo ($17.83 in chips) 
Seat 5: 19ElGringo91 ($11.42 in chips) 
Seat 6: GrinZwe91! ($11.07 in chips) 
19ElGringo91: posts small blind $0.05
GrinZwe91!: posts big blind $0.10
*** HOLE CARDS ***
hempju1ce has timed out
hempju1ce: folds 
vilemo20: folds 
yYanniky: folds 
HeyLo: folds 
19ElGringo91: folds 
Uncalled bet ($0.05) returned to GrinZwe91!
GrinZwe91! collected $0.10 from pot
GrinZwe91!: doesn't show hand 
*** SUMMARY ***
Total pot $0.10 | Rake $0 
Seat 1: hempju1ce folded before Flop (didn't bet)
Seat 2: vilemo20 folded before Flop (didn't bet)
Seat 3: yYanniky folded before Flop (didn't bet)
Seat 4: HeyLo (button) folded before Flop (didn't bet)
Seat 5: 19ElGringo91 (small blind) folded before Flop
Seat 6: GrinZwe91! (big blind) collected ($0.10)



PokerStars Hand #222960357064:  Hold'em No Limit ($0.05/$0.10 USD) - 2021/01/23 12:05:12 ET
Table 'Bohlinia III' 6-max Seat #5 is the button
Seat 2: vilemo20 ($11.50 in chips) 
Seat 3: yYanniky ($10 in chips) 
Seat 4: HeyLo ($17.83 in chips) 
Seat 5: 19ElGringo91 ($11.37 in chips) 
Seat 6: GrinZwe91! ($11.12 in chips) 
GrinZwe91!: posts small blind $0.05
vilemo20: posts big blind $0.10
*** HOLE CARDS ***
yYanniky: raises $0.17 to $0.27
HeyLo: folds 
19ElGringo91: folds 
HeyLo leaves the table
GrinZwe91!: folds 
vilemo20: calls $0.17
*** FLOP *** [6d 9h 6s]
vilemo20: checks 
JohnSF7 joins the table at seat #4 
yYanniky: bets $0.37
vilemo20: folds 
Uncalled bet ($0.37) returned to yYanniky
yYanniky collected $0.56 from pot
yYanniky: doesn't show hand 
*** SUMMARY ***
Total pot $0.59 | Rake $0.03 
Board [6d 9h 6s]
Seat 2: vilemo20 (big blind) folded on the Flop
Seat 3: yYanniky collected ($0.56)
Seat 4: HeyLo folded before Flop (didn't bet)
Seat 5: 19ElGringo91 (button) folded before Flop (didn't bet)
Seat 6: GrinZwe91! (small blind) folded before Flop



PokerStars Hand #222960378470:  Hold'em No Limit ($0.05/$0.10 USD) - 2021/01/23 12:05:46 ET
Table 'Bohlinia III' 6-max Seat #6 is the button
Seat 2: vilemo20 ($11.23 in chips) 
Seat 3: yYanniky ($10.29 in chips) 
Seat 5: 19ElGringo91 ($11.37 in chips) 
Seat 6: GrinZwe91! ($11.07 in chips) 
vilemo20: posts small blind $0.05
yYanniky: posts big blind $0.10
JohnSF7: sits out 
*** HOLE CARDS ***
19ElGringo91: folds 
GrinZwe91!: raises $0.20 to $0.30
vilemo20: folds 
yYanniky: folds 
Uncalled bet ($0.20) returned to GrinZwe91!
GrinZwe91! collected $0.25 from pot
GrinZwe91!: doesn't show hand 
*** SUMMARY ***
Total pot $0.25 | Rake $0 
Seat 2: vilemo20 (small blind) folded before Flop
Seat 3: yYanniky (big blind) folded before Flop
Seat 5: 19ElGringo91 folded before Flop (didn't bet)
Seat 6: GrinZwe91! (button) collected ($0.25)



PokerStars Hand #222960384936:  Hold'em No Limit ($0.05/$0.10 USD) - 2021/01/23 12:05:57 ET
Table 'Bohlinia III' 6-max Seat #2 is the button
Seat 2: vilemo20 ($11.18 in chips) 
Seat 3: yYanniky ($10.19 in chips) 
Seat 4: JohnSF7 ($10 in chips) 
Seat 5: 19ElGringo91 ($11.37 in chips) 
Seat 6: GrinZwe91! ($11.22 in chips) 
yYanniky: posts small blind $0.05
JohnSF7: posts big blind $0.10
hempju1ce: sits out 
*** HOLE CARDS ***
19ElGringo91: folds 
GrinZwe91!: folds 
vilemo20: folds 
yYanniky: raises $0.20 to $0.30
JohnSF7: folds 
Uncalled bet ($0.20) returned to yYanniky
yYanniky collected $0.20 from pot
yYanniky: doesn't show hand 
*** SUMMARY ***
Total pot $0.20 | Rake $0 
Seat 2: vilemo20 (button) folded before Flop (didn't bet)
Seat 3: yYanniky (small blind) collected ($0.20)
Seat 4: JohnSF7 (big blind) folded before Flop
Seat 5: 19ElGringo91 folded before Flop (didn't bet)
Seat 6: GrinZwe91! folded before Flop (didn't bet)



PokerStars Hand #222960391898:  Hold'em No Limit ($0.05/$0.10 USD) - 2021/01/23 12:06:08 ET
Table 'Bohlinia III' 6-max Seat #3 is the button
Seat 2: vilemo20 ($11.18 in chips) 
Seat 3: yYanniky ($10.29 in chips) 
Seat 4: JohnSF7 ($10 in chips) 
Seat 5: 19ElGringo91 ($11.37 in chips) 
Seat 6: GrinZwe91! ($11.22 in chips) 
JohnSF7: posts small blind $0.05
19ElGringo91: posts big blind $0.10
hempju1ce: sits out 
*** HOLE CARDS ***
GrinZwe91!: folds 
vilemo20: folds 
yYanniky: folds 
JohnSF7: raises $0.20 to $0.30
19ElGringo91: folds 
Uncalled bet ($0.20) returned to JohnSF7
JohnSF7 collected $0.20 from pot
JohnSF7: doesn't show hand 
*** SUMMARY ***
Total pot $0.20 | Rake $0 
Seat 2: vilemo20 folded before Flop (didn't bet)
Seat 3: yYanniky (button) folded before Flop (didn't bet)
Seat 4: JohnSF7 (small blind) collected ($0.20)
Seat 5: 19ElGringo91 (big blind) folded before Flop
Seat 6: GrinZwe91! folded before Flop (didn't bet)



PokerStars Hand #222960411308:  Hold'em No Limit ($0.05/$0.10 USD) - 2021/01/23 12:06:39 ET
Table 'Bohlinia III' 6-max Seat #4 is the button
Seat 2: vilemo20 ($11.18 in chips) 
Seat 3: yYanniky ($10.29 in chips) 
Seat 4: JohnSF7 ($10.10 in chips) 
Seat 5: 19ElGringo91 ($11.27 in chips) 
Seat 6: GrinZwe91! ($11.22 in chips) 
19ElGringo91: posts small blind $0.05
GrinZwe91!: posts big blind $0.10
hempju1ce: sits out 
*** HOLE CARDS ***
vilemo20: folds 
yYanniky: folds 
JohnSF7: raises $0.15 to $0.25
19ElGringo91: folds 
GrinZwe91!: folds 
Uncalled bet ($0.15) returned to JohnSF7
JohnSF7 collected $0.25 from pot
JohnSF7: doesn't show hand 
*** SUMMARY ***
Total pot $0.25 | Rake $0 
Seat 2: vilemo20 folded before Flop (didn't bet)
Seat 3: yYanniky folded before Flop (didn't bet)
Seat 4: JohnSF7 (button) collected ($0.25)
Seat 5: 19ElGringo91 (small blind) folded before Flop
Seat 6: GrinZwe91! (big blind) folded before Flop



PokerStars Hand #222960422586:  Hold'em No Limit ($0.05/$0.10 USD) - 2021/01/23 12:06:56 ET
Table 'Bohlinia III' 6-max Seat #5 is the button
Seat 1: hempju1ce ($11.82 in chips) 
Seat 2: vilemo20 ($11.18 in chips) 
Seat 3: yYanniky ($10.29 in chips) 
Seat 4: JohnSF7 ($10.25 in chips) 
Seat 5: 19ElGringo91 ($11.22 in chips) 
Seat 6: GrinZwe91! ($11.12 in chips) 
GrinZwe91!: posts small blind $0.05
hempju1ce: posts big blind $0.10
*** HOLE CARDS ***
vilemo20: folds 
yYanniky: folds 
JohnSF7: raises $0.15 to $0.25
19ElGringo91: folds 
GrinZwe91!: folds 
hempju1ce: folds 
Uncalled bet ($0.15) returned to JohnSF7
JohnSF7 collected $0.25 from pot
JohnSF7: doesn't show hand 
*** SUMMARY ***
Total pot $0.25 | Rake $0 
Seat 1: hempju1ce (big blind) folded before Flop
Seat 2: vilemo20 folded before Flop (didn't bet)
Seat 3: yYanniky folded before Flop (didn't bet)
Seat 4: JohnSF7 collected ($0.25)
Seat 5: 19ElGringo91 (button) folded before Flop (didn't bet)
Seat 6: GrinZwe91! (small blind) folded before Flop



PokerStars Hand #222960438607:  Hold'em No Limit ($0.05/$0.10 USD) - 2021/01/23 12:07:22 ET
Table 'Bohlinia III' 6-max Seat #6 is the button
Seat 1: hempju1ce ($11.72 in chips) 
Seat 3: yYanniky ($10.29 in chips) 
Seat 4: JohnSF7 ($10.40 in chips) 
Seat 5: 19ElGringo91 ($11.22 in chips) 
Seat 6: GrinZwe91! ($11.07 in chips) 
hempju1ce: posts small blind $0.05
vilemo20: is sitting out 
yYanniky: posts big blind $0.10
*** HOLE CARDS ***
JohnSF7: folds 
19ElGringo91: folds 
GrinZwe91!: folds 
hempju1ce: calls $0.05
yYanniky: checks 
*** FLOP *** [Ac Th 7c]
hempju1ce: checks 
yYanniky: checks 
*** TURN *** [Ac Th 7c] [2s]
hempju1ce: checks 
yYanniky: checks 
*** RIVER *** [Ac Th 7c 2s] [4d]
hempju1ce: checks 
yYanniky: checks 
*** SHOW DOWN ***
hempju1ce: shows [Jd 7d] (a pair of Sevens)
yYanniky: mucks hand 
hempju1ce collected $0.19 from pot
*** SUMMARY ***
Total pot $0.20 | Rake $0.01 
Board [Ac Th 7c 2s 4d]
Seat 1: hempju1ce (small blind) showed [Jd 7d] and won ($0.19) with a pair of Sevens
Seat 3: yYanniky (big blind) mucked
Seat 4: JohnSF7 folded before Flop (didn't bet)
Seat 5: 19ElGringo91 folded before Flop (didn't bet)
Seat 6: GrinZwe91! (button) folded before Flop (didn't bet)



PokerStars Hand #222960459832:  Hold'em No Limit ($0.05/$0.10 USD) - 2021/01/23 12:07:55 ET
Table 'Bohlinia III' 6-max Seat #1 is the button
Seat 1: hempju1ce ($11.81 in chips) 
Seat 3: yYanniky ($10.19 in chips) 
Seat 4: JohnSF7 ($10.40 in chips) 
Seat 5: 19ElGringo91 ($11.22 in chips) 
Seat 6: GrinZwe91! ($11.07 in chips) 
yYanniky: posts small blind $0.05
JohnSF7: posts big blind $0.10
*** HOLE CARDS ***
19ElGringo91: raises $0.20 to $0.30
GrinZwe91!: folds 
hempju1ce: calls $0.30
yYanniky: folds 
JohnSF7: folds 
*** FLOP *** [7d 5d 3h]
19ElGringo91: checks 
hempju1ce: checks 
*** TURN *** [7d 5d 3h] [Kd]
19ElGringo91: bets $0.54
hempju1ce: folds 
Uncalled bet ($0.54) returned to 19ElGringo91
19ElGringo91 collected $0.72 from pot
19ElGringo91: doesn't show hand 
*** SUMMARY ***
Total pot $0.75 | Rake $0.03 
Board [7d 5d 3h Kd]
Seat 1: hempju1ce (button) folded on the Turn
Seat 3: yYanniky (small blind) folded before Flop
Seat 4: JohnSF7 (big blind) folded before Flop
Seat 5: 19ElGringo91 collected ($0.72)
Seat 6: GrinZwe91! folded before Flop (didn't bet)



PokerStars Hand #222960480876:  Hold'em No Limit ($0.05/$0.10 USD) - 2021/01/23 12:08:29 ET
Table 'Bohlinia III' 6-max Seat #3 is the button
Seat 1: hempju1ce ($11.51 in chips) 
Seat 3: yYanniky ($10.14 in chips) 
Seat 4: JohnSF7 ($10.30 in chips) 
Seat 5: 19ElGringo91 ($11.64 in chips) 
Seat 6: GrinZwe91! ($11.07 in chips) 
JohnSF7: posts small blind $0.05
19ElGringo91: posts big blind $0.10
*** HOLE CARDS ***
GrinZwe91!: folds 
hempju1ce: folds 
yYanniky: raises $0.15 to $0.25
JohnSF7: folds 
19ElGringo91: folds 
Uncalled bet ($0.15) returned to yYanniky
yYanniky collected $0.25 from pot
yYanniky: doesn't show hand 
*** SUMMARY ***
Total pot $0.25 | Rake $0 
Seat 1: hempju1ce folded before Flop (didn't bet)
Seat 3: yYanniky (button) collected ($0.25)
Seat 4: JohnSF7 (small blind) folded before Flop
Seat 5: 19ElGringo91 (big blind) folded before Flop
Seat 6: GrinZwe91! folded before Flop (didn't bet)



PokerStars Hand #222960496323:  Hold'em No Limit ($0.05/$0.10 USD) - 2021/01/23 12:08:53 ET
Table 'Bohlinia III' 6-max Seat #4 is the button
Seat 1: hempju1ce ($11.51 in chips) 
Seat 3: yYanniky ($10.29 in chips) 
Seat 4: JohnSF7 ($10.25 in chips) 
Seat 5: 19ElGringo91 ($11.54 in chips) 
Seat 6: GrinZwe91! ($11.07 in chips) 
19ElGringo91: posts small blind $0.05
GrinZwe91!: posts big blind $0.10
vilemo20: sits out 
*** HOLE CARDS ***
hempju1ce: folds 
yYanniky: folds 
JohnSF7: folds 
19ElGringo91: raises $0.20 to $0.30
GrinZwe91!: folds 
Uncalled bet ($0.20) returned to 19ElGringo91
19ElGringo91 collected $0.20 from pot
19ElGringo91: doesn't show hand 
*** SUMMARY ***
Total pot $0.20 | Rake $0 
Seat 1: hempju1ce folded before Flop (didn't bet)
Seat 3: yYanniky folded before Flop (didn't bet)
Seat 4: JohnSF7 (button) folded before Flop (didn't bet)
Seat 5: 19ElGringo91 (small blind) collected ($0.20)
Seat 6: GrinZwe91! (big blind) folded before Flop



PokerStars Hand #222960504445:  Hold'em No Limit ($0.05/$0.10 USD) - 2021/01/23 12:09:06 ET
Table 'Bohlinia III' 6-max Seat #5 is the button
Seat 1: hempju1ce ($11.51 in chips) 
Seat 3: yYanniky ($10.29 in chips) 
Seat 4: JohnSF7 ($10.25 in chips) 
Seat 5: 19ElGringo91 ($11.64 in chips) 
Seat 6: GrinZwe91! ($10.97 in chips) 
GrinZwe91!: posts small blind $0.05
hempju1ce: posts big blind $0.10
vilemo20: sits out 
*** HOLE CARDS ***
yYanniky: folds 
JohnSF7: folds 
19ElGringo91: folds 
GrinZwe91!: folds 
Uncalled bet ($0.05) returned to hempju1ce
hempju1ce collected $0.10 from pot
hempju1ce: doesn't show hand 
*** SUMMARY ***
Total pot $0.10 | Rake $0 
Seat 1: hempju1ce (big blind) collected ($0.10)
Seat 3: yYanniky folded before Flop (didn't bet)
Seat 4: JohnSF7 folded before Flop (didn't bet)
Seat 5: 19ElGringo91 (button) folded before Flop (didn't bet)
Seat 6: GrinZwe91! (small blind) folded before Flop



PokerStars Hand #222960509993:  Hold'em No Limit ($0.05/$0.10 USD) - 2021/01/23 12:09:15 ET
Table 'Bohlinia III' 6-max Seat #6 is the button
Seat 1: hempju1ce ($11.56 in chips) 
Seat 2: vilemo20 ($11.18 in chips) 
Seat 3: yYanniky ($10.29 in chips) 
Seat 4: JohnSF7 ($10.25 in chips) 
Seat 5: 19ElGringo91 ($11.64 in chips) 
Seat 6: GrinZwe91! ($10.92 in chips) 
hempju1ce: posts small blind $0.05
vilemo20: posts big blind $0.10
*** HOLE CARDS ***
yYanniky: folds 
JohnSF7: folds 
19ElGringo91: folds 
GrinZwe91!: folds 
hempju1ce: folds 
Uncalled bet ($0.05) returned to vilemo20
vilemo20 collected $0.10 from pot
vilemo20: doesn't show hand 
*** SUMMARY ***
Total pot $0.10 | Rake $0 
Seat 1: hempju1ce (small blind) folded before Flop
Seat 2: vilemo20 (big blind) collected ($0.10)
Seat 3: yYanniky folded before Flop (didn't bet)
Seat 4: JohnSF7 folded before Flop (didn't bet)
Seat 5: 19ElGringo91 folded before Flop (didn't bet)
Seat 6: GrinZwe91! (button) folded before Flop (didn't bet)



PokerStars Hand #222960519658:  Hold'em No Limit ($0.05/$0.10 USD) - 2021/01/23 12:09:30 ET
Table 'Bohlinia III' 6-max Seat #1 is the button
Seat 1: hempju1ce ($11.51 in chips) 
Seat 2: vilemo20 ($11.23 in chips) 
Seat 3: yYanniky ($10.29 in chips) 
Seat 4: JohnSF7 ($10.25 in chips) 
Seat 5: 19ElGringo91 ($11.64 in chips) 
Seat 6: GrinZwe91! ($10.92 in chips) 
vilemo20: posts small blind $0.05
yYanniky: posts big blind $0.10
*** HOLE CARDS ***
JohnSF7: folds 
19ElGringo91: folds 
GrinZwe91!: folds 
hempju1ce: raises $0.10 to $0.20
vilemo20: folds 
yYanniky: raises $0.60 to $0.80
hempju1ce: folds 
Uncalled bet ($0.60) returned to yYanniky
yYanniky collected $0.45 from pot
yYanniky: doesn't show hand 
*** SUMMARY ***
Total pot $0.45 | Rake $0 
Seat 1: hempju1ce (button) folded before Flop
Seat 2: vilemo20 (small blind) folded before Flop
Seat 3: yYanniky (big blind) collected ($0.45)
Seat 4: JohnSF7 folded before Flop (didn't bet)
Seat 5: 19ElGringo91 folded before Flop (didn't bet)
Seat 6: GrinZwe91! folded before Flop (didn't bet)



PokerStars Hand #222960533814:  Hold'em No Limit ($0.05/$0.10 USD) - 2021/01/23 12:09:53 ET
Table 'Bohlinia III' 6-max Seat #2 is the button
Seat 1: hempju1ce ($11.31 in chips) 
Seat 2: vilemo20 ($11.18 in chips) 
Seat 3: yYanniky ($10.54 in chips) 
Seat 4: JohnSF7 ($10.25 in chips) 
Seat 5: 19ElGringo91 ($11.64 in chips) 
Seat 6: GrinZwe91! ($10.92 in chips) 
yYanniky: posts small blind $0.05
JohnSF7: posts big blind $0.10
*** HOLE CARDS ***
19ElGringo91: folds 
GrinZwe91!: folds 
hempju1ce: folds 
vilemo20: raises $0.15 to $0.25
yYanniky: folds 
JohnSF7: folds 
Uncalled bet ($0.15) returned to vilemo20
vilemo20 collected $0.25 from pot
vilemo20: doesn't show hand 
*** SUMMARY ***
Total pot $0.25 | Rake $0 
Seat 1: hempju1ce folded before Flop (didn't bet)
Seat 2: vilemo20 (button) collected ($0.25)
Seat 3: yYanniky (small blind) folded before Flop
Seat 4: JohnSF7 (big blind) folded before Flop
Seat 5: 19ElGringo91 folded before Flop (didn't bet)
Seat 6: GrinZwe91! folded before Flop (didn't bet)



PokerStars Hand #222960545880:  Hold'em No Limit ($0.05/$0.10 USD) - 2021/01/23 12:10:12 ET
Table 'Bohlinia III' 6-max Seat #3 is the button
Seat 1: hempju1ce ($11.31 in chips) 
Seat 2: vilemo20 ($11.33 in chips) 
Seat 3: yYanniky ($10.49 in chips) 
Seat 4: JohnSF7 ($10.15 in chips) 
Seat 5: 19ElGringo91 ($11.64 in chips) 
Seat 6: GrinZwe91! ($10.92 in chips) 
JohnSF7: posts small blind $0.05
19ElGringo91: posts big blind $0.10
*** HOLE CARDS ***
GrinZwe91!: folds 
hempju1ce: folds 
vilemo20: folds 
yYanniky: raises $0.15 to $0.25
JohnSF7: raises $0.75 to $1
19ElGringo91: folds 
yYanniky: folds 
Uncalled bet ($0.75) returned to JohnSF7
JohnSF7 collected $0.60 from pot
JohnSF7: doesn't show hand 
*** SUMMARY ***
Total pot $0.60 | Rake $0 
Seat 1: hempju1ce folded before Flop (didn't bet)
Seat 2: vilemo20 folded before Flop (didn't bet)
Seat 3: yYanniky (button) folded before Flop
Seat 4: JohnSF7 (small blind) collected ($0.60)
Seat 5: 19ElGringo91 (big blind) folded before Flop
Seat 6: GrinZwe91! folded before Flop (didn't bet)



PokerStars Hand #222960559028:  Hold'em No Limit ($0.05/$0.10 USD) - 2021/01/23 12:10:33 ET
Table 'Bohlinia III' 6-max Seat #4 is the button
Seat 1: hempju1ce ($11.31 in chips) 
Seat 2: vilemo20 ($11.33 in chips) 
Seat 3: yYanniky ($10.24 in chips) 
Seat 4: JohnSF7 ($10.50 in chips) 
Seat 5: 19ElGringo91 ($11.54 in chips) 
Seat 6: GrinZwe91! ($10.92 in chips) 
19ElGringo91: posts small blind $0.05
GrinZwe91!: posts big blind $0.10
*** HOLE CARDS ***
hempju1ce: folds 
vilemo20: folds 
yYanniky: folds 
JohnSF7: folds 
19ElGringo91: raises $0.20 to $0.30
GrinZwe91!: folds 
Uncalled bet ($0.20) returned to 19ElGringo91
19ElGringo91 collected $0.20 from pot
19ElGringo91: doesn't show hand 
*** SUMMARY ***
Total pot $0.20 | Rake $0 
Seat 1: hempju1ce folded before Flop (didn't bet)
Seat 2: vilemo20 folded before Flop (didn't bet)
Seat 3: yYanniky folded before Flop (didn't bet)
Seat 4: JohnSF7 (button) folded before Flop (didn't bet)
Seat 5: 19ElGringo91 (small blind) collected ($0.20)
Seat 6: GrinZwe91! (big blind) folded before Flop



PokerStars Hand #222960571011:  Hold'em No Limit ($0.05/$0.10 USD) - 2021/01/23 12:10:52 ET
Table 'Bohlinia III' 6-max Seat #5 is the button
Seat 1: hempju1ce ($11.31 in chips) 
Seat 2: vilemo20 ($11.33 in chips) 
Seat 3: yYanniky ($10.24 in chips) 
Seat 4: JohnSF7 ($10.50 in chips) 
Seat 5: 19ElGringo91 ($11.64 in chips) 
Seat 6: GrinZwe91! ($10.82 in chips) 
GrinZwe91!: posts small blind $0.05
hempju1ce: posts big blind $0.10
*** HOLE CARDS ***
vilemo20: folds 
yYanniky: folds 
JohnSF7: folds 
19ElGringo91: folds 
GrinZwe91!: folds 
Uncalled bet ($0.05) returned to hempju1ce
hempju1ce collected $0.10 from pot
hempju1ce: doesn't show hand 
*** SUMMARY ***
Total pot $0.10 | Rake $0 
Seat 1: hempju1ce (big blind) collected ($0.10)
Seat 2: vilemo20 folded before Flop (didn't bet)
Seat 3: yYanniky folded before Flop (didn't bet)
Seat 4: JohnSF7 folded before Flop (didn't bet)
Seat 5: 19ElGringo91 (button) folded before Flop (didn't bet)
Seat 6: GrinZwe91! (small blind) folded before Flop



PokerStars Hand #222960576978:  Hold'em No Limit ($0.05/$0.10 USD) - 2021/01/23 12:11:01 ET
Table 'Bohlinia III' 6-max Seat #6 is the button
Seat 1: hempju1ce ($11.36 in chips) 
Seat 2: vilemo20 ($11.33 in chips) 
Seat 3: yYanniky ($10.24 in chips) 
Seat 4: JohnSF7 ($10.50 in chips) 
Seat 5: 19ElGringo91 ($11.64 in chips) 
Seat 6: GrinZwe91! ($10.77 in chips) 
hempju1ce: posts small blind $0.05
vilemo20: posts big blind $0.10
*** HOLE CARDS ***
yYanniky: folds 
JohnSF7: folds 
19ElGringo91: folds 
GrinZwe91!: folds 
hempju1ce: calls $0.05
vilemo20: checks 
*** FLOP *** [3s Qc 6d]
hempju1ce: checks 
vilemo20: bets $0.15
hempju1ce: folds 
Uncalled bet ($0.15) returned to vilemo20
vilemo20 collected $0.19 from pot
vilemo20: doesn't show hand 
*** SUMMARY ***
Total pot $0.20 | Rake $0.01 
Board [3s Qc 6d]
Seat 1: hempju1ce (small blind) folded on the Flop
Seat 2: vilemo20 (big blind) collected ($0.19)
Seat 3: yYanniky folded before Flop (didn't bet)
Seat 4: JohnSF7 folded before Flop (didn't bet)
Seat 5: 19ElGringo91 folded before Flop (didn't bet)
Seat 6: GrinZwe91! (button) folded before Flop (didn't bet)



PokerStars Hand #222960596755:  Hold'em No Limit ($0.05/$0.10 USD) - 2021/01/23 12:11:33 ET
Table 'Bohlinia III' 6-max Seat #1 is the button
Seat 1: hempju1ce ($11.26 in chips) 
Seat 2: vilemo20 ($11.42 in chips) 
Seat 3: yYanniky ($10.24 in chips) 
Seat 4: JohnSF7 ($10.50 in chips) 
Seat 5: 19ElGringo91 ($11.64 in chips) 
Seat 6: GrinZwe91! ($10.77 in chips) 
vilemo20: posts small blind $0.05
yYanniky: posts big blind $0.10
*** HOLE CARDS ***
JohnSF7: folds 
19ElGringo91: folds 
GrinZwe91!: raises $0.20 to $0.30
hempju1ce: folds 
vilemo20: folds 
yYanniky: folds 
Uncalled bet ($0.20) returned to GrinZwe91!
GrinZwe91! collected $0.25 from pot
GrinZwe91!: doesn't show hand 
*** SUMMARY ***
Total pot $0.25 | Rake $0 
Seat 1: hempju1ce (button) folded before Flop (didn't bet)
Seat 2: vilemo20 (small blind) folded before Flop
Seat 3: yYanniky (big blind) folded before Flop
Seat 4: JohnSF7 folded before Flop (didn't bet)
Seat 5: 19ElGringo91 folded before Flop (didn't bet)
Seat 6: GrinZwe91! collected ($0.25)



PokerStars Hand #222960607430:  Hold'em No Limit ($0.05/$0.10 USD) - 2021/01/23 12:11:50 ET
Table 'Bohlinia III' 6-max Seat #2 is the button
Seat 1: hempju1ce ($11.26 in chips) 
Seat 2: vilemo20 ($11.37 in chips) 
Seat 3: yYanniky ($10.14 in chips) 
Seat 4: JohnSF7 ($10.50 in chips) 
Seat 5: 19ElGringo91 ($11.64 in chips) 
Seat 6: GrinZwe91! ($10.92 in chips) 
yYanniky: posts small blind $0.05
JohnSF7: posts big blind $0.10
*** HOLE CARDS ***
19ElGringo91: folds 
GrinZwe91!: raises $0.20 to $0.30
hempju1ce: folds 
vilemo20: folds 
yYanniky: folds 
JohnSF7: folds 
Uncalled bet ($0.20) returned to GrinZwe91!
GrinZwe91! collected $0.25 from pot
GrinZwe91!: doesn't show hand 
*** SUMMARY ***
Total pot $0.25 | Rake $0 
Seat 1: hempju1ce folded before Flop (didn't bet)
Seat 2: vilemo20 (button) folded before Flop (didn't bet)
Seat 3: yYanniky (small blind) folded before Flop
Seat 4: JohnSF7 (big blind) folded before Flop
Seat 5: 19ElGringo91 folded before Flop (didn't bet)
Seat 6: GrinZwe91! collected ($0.25)



PokerStars Hand #222960622287:  Hold'em No Limit ($0.05/$0.10 USD) - 2021/01/23 12:12:13 ET
Table 'Bohlinia III' 6-max Seat #3 is the button
Seat 1: hempju1ce ($11.26 in chips) 
Seat 2: vilemo20 ($11.37 in chips) 
Seat 3: yYanniky ($10.09 in chips) 
Seat 4: JohnSF7 ($10.40 in chips) 
Seat 5: 19ElGringo91 ($11.64 in chips) 
Seat 6: GrinZwe91! ($11.07 in chips) 
JohnSF7: posts small blind $0.05
19ElGringo91: posts big blind $0.10
*** HOLE CARDS ***
GrinZwe91!: folds 
hempju1ce: folds 
vilemo20: folds 
yYanniky: raises $0.15 to $0.25
JohnSF7: folds 
19ElGringo91: folds 
Uncalled bet ($0.15) returned to yYanniky
yYanniky collected $0.25 from pot
yYanniky: doesn't show hand 
*** SUMMARY ***
Total pot $0.25 | Rake $0 
Seat 1: hempju1ce folded before Flop (didn't bet)
Seat 2: vilemo20 folded before Flop (didn't bet)
Seat 3: yYanniky (button) collected ($0.25)
Seat 4: JohnSF7 (small blind) folded before Flop
Seat 5: 19ElGringo91 (big blind) folded before Flop
Seat 6: GrinZwe91! folded before Flop (didn't bet)



PokerStars Hand #222960630445:  Hold'em No Limit ($0.05/$0.10 USD) - 2021/01/23 12:12:26 ET
Table 'Bohlinia III' 6-max Seat #4 is the button
Seat 1: hempju1ce ($11.26 in chips) 
Seat 2: vilemo20 ($11.37 in chips) 
Seat 3: yYanniky ($10.24 in chips) 
Seat 4: JohnSF7 ($10.35 in chips) 
Seat 5: 19ElGringo91 ($11.54 in chips) 
Seat 6: GrinZwe91! ($11.07 in chips) 
19ElGringo91: posts small blind $0.05
GrinZwe91!: posts big blind $0.10
*** HOLE CARDS ***
hempju1ce: folds 
vilemo20: folds 
yYanniky: folds 
JohnSF7: folds 
19ElGringo91: folds 
Uncalled bet ($0.05) returned to GrinZwe91!
GrinZwe91! collected $0.10 from pot
GrinZwe91!: doesn't show hand 
*** SUMMARY ***
Total pot $0.10 | Rake $0 
Seat 1: hempju1ce folded before Flop (didn't bet)
Seat 2: vilemo20 folded before Flop (didn't bet)
Seat 3: yYanniky folded before Flop (didn't bet)
Seat 4: JohnSF7 (button) folded before Flop (didn't bet)
Seat 5: 19ElGringo91 (small blind) folded before Flop
Seat 6: GrinZwe91! (big blind) collected ($0.10)



PokerStars Hand #222960638591:  Hold'em No Limit ($0.05/$0.10 USD) - 2021/01/23 12:12:39 ET
Table 'Bohlinia III' 6-max Seat #5 is the button
Seat 1: hempju1ce ($11.26 in chips) 
Seat 2: vilemo20 ($11.37 in chips) 
Seat 3: yYanniky ($10.24 in chips) 
Seat 4: JohnSF7 ($10.35 in chips) 
Seat 5: 19ElGringo91 ($11.49 in chips) 
Seat 6: GrinZwe91! ($11.12 in chips) 
GrinZwe91!: posts small blind $0.05
hempju1ce: posts big blind $0.10
*** HOLE CARDS ***
vilemo20: folds 
yYanniky: folds 
JohnSF7: folds 
19ElGringo91: folds 
GrinZwe91!: folds 
Uncalled bet ($0.05) returned to hempju1ce
hempju1ce collected $0.10 from pot
hempju1ce: doesn't show hand 
*** SUMMARY ***
Total pot $0.10 | Rake $0 
Seat 1: hempju1ce (big blind) collected ($0.10)
Seat 2: vilemo20 folded before Flop (didn't bet)
Seat 3: yYanniky folded before Flop (didn't bet)
Seat 4: JohnSF7 folded before Flop (didn't bet)
Seat 5: 19ElGringo91 (button) folded before Flop (didn't bet)
Seat 6: GrinZwe91! (small blind) folded before Flop



PokerStars Hand #222960642926:  Hold'em No Limit ($0.05/$0.10 USD) - 2021/01/23 12:12:46 ET
Table 'Bohlinia III' 6-max Seat #6 is the button
Seat 1: hempju1ce ($11.31 in chips) 
Seat 2: vilemo20 ($11.37 in chips) 
Seat 3: yYanniky ($10.24 in chips) 
Seat 4: JohnSF7 ($10.35 in chips) 
Seat 5: 19ElGringo91 ($11.49 in chips) 
Seat 6: GrinZwe91! ($11.07 in chips) 
hempju1ce: posts small blind $0.05
vilemo20: posts big blind $0.10
*** HOLE CARDS ***
yYanniky: folds 
JohnSF7: raises $0.15 to $0.25
19ElGringo91: folds 
GrinZwe91!: folds 
hempju1ce: folds 
vilemo20: raises $0.65 to $0.90
JohnSF7: folds 
Uncalled bet ($0.65) returned to vilemo20
vilemo20 collected $0.55 from pot
vilemo20: doesn't show hand 
*** SUMMARY ***
Total pot $0.55 | Rake $0 
Seat 1: hempju1ce (small blind) folded before Flop
Seat 2: vilemo20 (big blind) collected ($0.55)
Seat 3: yYanniky folded before Flop (didn't bet)
Seat 4: JohnSF7 folded before Flop
Seat 5: 19ElGringo91 folded before Flop (didn't bet)
Seat 6: GrinZwe91! (button) folded before Flop (didn't bet)



PokerStars Hand #222960655660:  Hold'em No Limit ($0.05/$0.10 USD) - 2021/01/23 12:13:06 ET
Table 'Bohlinia III' 6-max Seat #1 is the button
Seat 1: hempju1ce ($11.26 in chips) 
Seat 2: vilemo20 ($11.67 in chips) 
Seat 3: yYanniky ($10.24 in chips) 
Seat 4: JohnSF7 ($10.10 in chips) 
Seat 5: 19ElGringo91 ($11.49 in chips) 
Seat 6: GrinZwe91! ($11.07 in chips) 
vilemo20: posts small blind $0.05
yYanniky: posts big blind $0.10
*** HOLE CARDS ***
JohnSF7: raises $0.15 to $0.25
19ElGringo91: folds 
GrinZwe91!: raises $0.65 to $0.90
hempju1ce: folds 
vilemo20: folds 
yYanniky: folds 
JohnSF7: folds 
Uncalled bet ($0.65) returned to GrinZwe91!
GrinZwe91! collected $0.65 from pot
GrinZwe91!: doesn't show hand 
*** SUMMARY ***
Total pot $0.65 | Rake $0 
Seat 1: hempju1ce (button) folded before Flop (didn't bet)
Seat 2: vilemo20 (small blind) folded before Flop
Seat 3: yYanniky (big blind) folded before Flop
Seat 4: JohnSF7 folded before Flop
Seat 5: 19ElGringo91 folded before Flop (didn't bet)
Seat 6: GrinZwe91! collected ($0.65)



PokerStars Hand #222960674907:  Hold'em No Limit ($0.05/$0.10 USD) - 2021/01/23 12:13:34 ET
Table 'Bohlinia III' 6-max Seat #2 is the button
Seat 1: hempju1ce ($11.26 in chips) 
Seat 2: vilemo20 ($11.62 in chips) 
Seat 3: yYanniky ($10.14 in chips) 
Seat 4: JohnSF7 ($10 in chips) 
Seat 5: 19ElGringo91 ($11.49 in chips) 
Seat 6: GrinZwe91! ($11.47 in chips) 
yYanniky: posts small blind $0.05
JohnSF7: posts big blind $0.10
*** HOLE CARDS ***
19ElGringo91: raises $0.20 to $0.30
GrinZwe91!: folds 
hempju1ce: folds 
vilemo20: folds 
yYanniky: folds 
JohnSF7: folds 
Uncalled bet ($0.20) returned to 19ElGringo91
19ElGringo91 collected $0.25 from pot
19ElGringo91: doesn't show hand 
*** SUMMARY ***
Total pot $0.25 | Rake $0 
Seat 1: hempju1ce folded before Flop (didn't bet)
Seat 2: vilemo20 (button) folded before Flop (didn't bet)
Seat 3: yYanniky (small blind) folded before Flop
Seat 4: JohnSF7 (big blind) folded before Flop
Seat 5: 19ElGringo91 collected ($0.25)
Seat 6: GrinZwe91! folded before Flop (didn't bet)



PokerStars Hand #222960682931:  Hold'em No Limit ($0.05/$0.10 USD) - 2021/01/23 12:13:47 ET
Table 'Bohlinia III' 6-max Seat #3 is the button
Seat 1: hempju1ce ($11.26 in chips) 
Seat 2: vilemo20 ($11.62 in chips) 
Seat 3: yYanniky ($10.09 in chips) 
Seat 4: JohnSF7 ($10 in chips) 
Seat 5: 19ElGringo91 ($11.64 in chips) 
Seat 6: GrinZwe91! ($11.47 in chips) 
JohnSF7: posts small blind $0.05
19ElGringo91: posts big blind $0.10
*** HOLE CARDS ***
GrinZwe91!: folds 
hempju1ce: calls $0.10
vilemo20: raises $0.30 to $0.40
yYanniky: folds 
JohnSF7: folds 
19ElGringo91: folds 
hempju1ce: calls $0.30
*** FLOP *** [6c Td Ks]
hempju1ce: checks 
vilemo20: checks 
*** TURN *** [6c Td Ks] [4s]
hempju1ce: checks 
vilemo20: checks 
*** RIVER *** [6c Td Ks 4s] [2s]
hempju1ce: checks 
vilemo20: bets $0.47
hempju1ce: folds 
Uncalled bet ($0.47) returned to vilemo20
vilemo20 collected $0.91 from pot
vilemo20: doesn't show hand 
*** SUMMARY ***
Total pot $0.95 | Rake $0.04 
Board [6c Td Ks 4s 2s]
Seat 1: hempju1ce folded on the River
Seat 2: vilemo20 collected ($0.91)
Seat 3: yYanniky (button) folded before Flop (didn't bet)
Seat 4: JohnSF7 (small blind) folded before Flop
Seat 5: 19ElGringo91 (big blind) folded before Flop
Seat 6: GrinZwe91! folded before Flop (didn't bet)



PokerStars Hand #222960707734:  Hold'em No Limit ($0.05/$0.10 USD) - 2021/01/23 12:14:27 ET
Table 'Bohlinia III' 6-max Seat #4 is the button
Seat 1: hempju1ce ($10.86 in chips) 
Seat 2: vilemo20 ($12.13 in chips) 
Seat 3: yYanniky ($10.09 in chips) 
Seat 4: JohnSF7 ($10 in chips) 
Seat 5: 19ElGringo91 ($11.54 in chips) 
Seat 6: GrinZwe91! ($11.47 in chips) 
19ElGringo91: posts small blind $0.05
GrinZwe91!: posts big blind $0.10
*** HOLE CARDS ***
hempju1ce: folds 
vilemo20: folds 
yYanniky: folds 
JohnSF7: folds 
19ElGringo91: folds 
Uncalled bet ($0.05) returned to GrinZwe91!
GrinZwe91! collected $0.10 from pot
GrinZwe91!: doesn't show hand 
*** SUMMARY ***
Total pot $0.10 | Rake $0 
Seat 1: hempju1ce folded before Flop (didn't bet)
Seat 2: vilemo20 folded before Flop (didn't bet)
Seat 3: yYanniky folded before Flop (didn't bet)
Seat 4: JohnSF7 (button) folded before Flop (didn't bet)
Seat 5: 19ElGringo91 (small blind) folded before Flop
Seat 6: GrinZwe91! (big blind) collected ($0.10)



PokerStars Hand #222960715823:  Hold'em No Limit ($0.05/$0.10 USD) - 2021/01/23 12:14:40 ET
Table 'Bohlinia III' 6-max Seat #5 is the button
Seat 1: hempju1ce ($10.86 in chips) 
Seat 2: vilemo20 ($12.13 in chips) 
Seat 3: yYanniky ($10.09 in chips) 
Seat 4: JohnSF7 ($10 in chips) 
Seat 5: 19ElGringo91 ($11.49 in chips) 
Seat 6: GrinZwe91! ($11.52 in chips) 
GrinZwe91!: posts small blind $0.05
hempju1ce: posts big blind $0.10
*** HOLE CARDS ***
vilemo20: folds 
yYanniky: folds 
JohnSF7: folds 
19ElGringo91: folds 
GrinZwe91!: raises $0.20 to $0.30
hempju1ce: folds 
Uncalled bet ($0.20) returned to GrinZwe91!
GrinZwe91! collected $0.20 from pot
GrinZwe91!: doesn't show hand 
*** SUMMARY ***
Total pot $0.20 | Rake $0 
Seat 1: hempju1ce (big blind) folded before Flop
Seat 2: vilemo20 folded before Flop (didn't bet)
Seat 3: yYanniky folded before Flop (didn't bet)
Seat 4: JohnSF7 folded before Flop (didn't bet)
Seat 5: 19ElGringo91 (button) folded before Flop (didn't bet)
Seat 6: GrinZwe91! (small blind) collected ($0.20)



PokerStars Hand #222960727153:  Hold'em No Limit ($0.05/$0.10 USD) - 2021/01/23 12:14:58 ET
Table 'Bohlinia III' 6-max Seat #6 is the button
Seat 1: hempju1ce ($10.76 in chips) 
Seat 2: vilemo20 ($12.13 in chips) 
Seat 3: yYanniky ($10.09 in chips) 
Seat 4: JohnSF7 ($10 in chips) 
Seat 5: 19ElGringo91 ($11.49 in chips) 
Seat 6: GrinZwe91! ($11.62 in chips) 
hempju1ce: posts small blind $0.05
vilemo20: posts big blind $0.10
*** HOLE CARDS ***
yYanniky: folds 
JohnSF7: folds 
19ElGringo91: folds 
GrinZwe91!: raises $0.20 to $0.30
hempju1ce: calls $0.25
vilemo20: folds 
*** FLOP *** [Jh 2h Qd]
hempju1ce: checks 
GrinZwe91!: bets $0.40
hempju1ce: calls $0.40
*** TURN *** [Jh 2h Qd] [7c]
hempju1ce: checks 
GrinZwe91! is connected 
GrinZwe91!: bets $0.80
hempju1ce: raises $0.80 to $1.60
GrinZwe91!: raises $2.40 to $4
hempju1ce: calls $2.40
*** RIVER *** [Jh 2h Qd 7c] [Kc]
hempju1ce: bets $6.06 and is all-in
GrinZwe91!: calls $6.06
*** SHOW DOWN ***
hempju1ce: shows [Ks Qs] (two pair, Kings and Queens)
GrinZwe91!: shows [7h Qh] (two pair, Queens and Sevens)
hempju1ce collected $20.65 from pot
*** SUMMARY ***
Total pot $21.62 | Rake $0.97 
Board [Jh 2h Qd 7c Kc]
Seat 1: hempju1ce (small blind) showed [Ks Qs] and won ($20.65) with two pair, Kings and Queens
Seat 2: vilemo20 (big blind) folded before Flop
Seat 3: yYanniky folded before Flop (didn't bet)
Seat 4: JohnSF7 folded before Flop (didn't bet)
Seat 5: 19ElGringo91 folded before Flop (didn't bet)
Seat 6: GrinZwe91! (button) showed [7h Qh] and lost with two pair, Queens and Sevens



PokerStars Hand #222960783682:  Hold'em No Limit ($0.05/$0.10 USD) - 2021/01/23 12:16:27 ET
Table 'Bohlinia III' 6-max Seat #1 is the button
Seat 1: hempju1ce ($20.65 in chips) 
Seat 2: vilemo20 ($12.03 in chips) 
Seat 3: yYanniky ($10.09 in chips) 
Seat 4: JohnSF7 ($10 in chips) 
Seat 5: 19ElGringo91 ($11.49 in chips) 
Seat 6: GrinZwe91! ($10 in chips) 
vilemo20: posts small blind $0.05
yYanniky: posts big blind $0.10
*** HOLE CARDS ***
JohnSF7: folds 
19ElGringo91: folds 
GrinZwe91!: raises $0.20 to $0.30
hempju1ce: calls $0.30
vilemo20: raises $1.10 to $1.40
yYanniky: folds 
GrinZwe91!: folds 
hempju1ce: folds 
Uncalled bet ($1.10) returned to vilemo20
vilemo20 collected $1 from pot
vilemo20: doesn't show hand 
*** SUMMARY ***
Total pot $1 | Rake $0 
Seat 1: hempju1ce (button) folded before Flop
Seat 2: vilemo20 (small blind) collected ($1)
Seat 3: yYanniky (big blind) folded before Flop
Seat 4: JohnSF7 folded before Flop (didn't bet)
Seat 5: 19ElGringo91 folded before Flop (didn't bet)
Seat 6: GrinZwe91! folded before Flop



PokerStars Hand #222960804393:  Hold'em No Limit ($0.05/$0.10 USD) - 2021/01/23 12:16:59 ET
Table 'Bohlinia III' 6-max Seat #2 is the button
Seat 1: hempju1ce ($20.35 in chips) 
Seat 2: vilemo20 ($12.73 in chips) 
Seat 3: yYanniky ($10 in chips) 
Seat 4: JohnSF7 ($10 in chips) 
Seat 5: 19ElGringo91 ($11.49 in chips) 
Seat 6: GrinZwe91! ($10 in chips) 
yYanniky: posts small blind $0.05
JohnSF7: posts big blind $0.10
*** HOLE CARDS ***
19ElGringo91: folds 
GrinZwe91!: folds 
hempju1ce: folds 
vilemo20: raises $0.15 to $0.25
yYanniky: folds 
JohnSF7: folds 
Uncalled bet ($0.15) returned to vilemo20
vilemo20 collected $0.25 from pot
vilemo20: doesn't show hand 
*** SUMMARY ***
Total pot $0.25 | Rake $0 
Seat 1: hempju1ce folded before Flop (didn't bet)
Seat 2: vilemo20 (button) collected ($0.25)
Seat 3: yYanniky (small blind) folded before Flop
Seat 4: JohnSF7 (big blind) folded before Flop
Seat 5: 19ElGringo91 folded before Flop (didn't bet)
Seat 6: GrinZwe91! folded before Flop (didn't bet)



PokerStars Hand #222960814507:  Hold'em No Limit ($0.05/$0.10 USD) - 2021/01/23 12:17:15 ET
Table 'Bohlinia III' 6-max Seat #3 is the button
Seat 1: hempju1ce ($20.35 in chips) 
Seat 2: vilemo20 ($12.88 in chips) 
Seat 3: yYanniky ($10 in chips) 
Seat 4: JohnSF7 ($10 in chips) 
Seat 5: 19ElGringo91 ($11.49 in chips) 
Seat 6: GrinZwe91! ($10 in chips) 
JohnSF7: posts small blind $0.05
19ElGringo91: posts big blind $0.10
*** HOLE CARDS ***
GrinZwe91!: folds 
hempju1ce: calls $0.10
vilemo20: folds 
yYanniky: folds 
JohnSF7: folds 
19ElGringo91: checks 
*** FLOP *** [As Th 6d]
19ElGringo91: checks 
hempju1ce: checks 
*** TURN *** [As Th 6d] [Ad]
19ElGringo91: checks 
hempju1ce: checks 
*** RIVER *** [As Th 6d Ad] [2s]
19ElGringo91: checks 
hempju1ce: checks 
*** SHOW DOWN ***
19ElGringo91: shows [Kc 4s] (a pair of Aces)
hempju1ce: shows [Ks Ts] (two pair, Aces and Tens)
hempju1ce collected $0.24 from pot
*** SUMMARY ***
Total pot $0.25 | Rake $0.01 
Board [As Th 6d Ad 2s]
Seat 1: hempju1ce showed [Ks Ts] and won ($0.24) with two pair, Aces and Tens
Seat 2: vilemo20 folded before Flop (didn't bet)
Seat 3: yYanniky (button) folded before Flop (didn't bet)
Seat 4: JohnSF7 (small blind) folded before Flop
Seat 5: 19ElGringo91 (big blind) showed [Kc 4s] and lost with a pair of Aces
Seat 6: GrinZwe91! folded before Flop (didn't bet)



PokerStars Hand #222960834097:  Hold'em No Limit ($0.05/$0.10 USD) - 2021/01/23 12:17:46 ET
Table 'Bohlinia III' 6-max Seat #4 is the button
Seat 1: hempju1ce ($20.49 in chips) 
Seat 2: vilemo20 ($12.88 in chips) 
Seat 3: yYanniky ($10 in chips) 
Seat 4: JohnSF7 ($10 in chips) 
Seat 5: 19ElGringo91 ($11.39 in chips) 
Seat 6: GrinZwe91! ($10 in chips) 
19ElGringo91: posts small blind $0.05
GrinZwe91!: posts big blind $0.10
*** HOLE CARDS ***
hempju1ce has timed out
hempju1ce: folds 
vilemo20: folds 
yYanniky: folds 
JohnSF7: raises $0.15 to $0.25
19ElGringo91: folds 
GrinZwe91!: folds 
Uncalled bet ($0.15) returned to JohnSF7
JohnSF7 collected $0.25 from pot
JohnSF7: doesn't show hand 
*** SUMMARY ***
Total pot $0.25 | Rake $0 
Seat 1: hempju1ce folded before Flop (didn't bet)
Seat 2: vilemo20 folded before Flop (didn't bet)
Seat 3: yYanniky folded before Flop (didn't bet)
Seat 4: JohnSF7 (button) collected ($0.25)
Seat 5: 19ElGringo91 (small blind) folded before Flop
Seat 6: GrinZwe91! (big blind) folded before Flop



PokerStars Hand #222960850738:  Hold'em No Limit ($0.05/$0.10 USD) - 2021/01/23 12:18:10 ET
Table 'Bohlinia III' 6-max Seat #5 is the button
Seat 2: vilemo20 ($12.88 in chips) 
Seat 3: yYanniky ($10 in chips) 
Seat 4: JohnSF7 ($10.15 in chips) 
Seat 5: 19ElGringo91 ($11.34 in chips) 
Seat 6: GrinZwe91! ($10 in chips) 
GrinZwe91!: posts small blind $0.05
vilemo20: posts big blind $0.10
*** HOLE CARDS ***
yYanniky: folds 
JohnSF7: folds 
19ElGringo91: raises $0.20 to $0.30
GrinZwe91!: folds 
vilemo20: folds 
Uncalled bet ($0.20) returned to 19ElGringo91
19ElGringo91 collected $0.25 from pot
19ElGringo91: doesn't show hand 
*** SUMMARY ***
Total pot $0.25 | Rake $0 
Seat 2: vilemo20 (big blind) folded before Flop
Seat 3: yYanniky folded before Flop (didn't bet)
Seat 4: JohnSF7 folded before Flop (didn't bet)
Seat 5: 19ElGringo91 (button) collected ($0.25)
Seat 6: GrinZwe91! (small blind) folded before Flop



PokerStars Hand #222960858489:  Hold'em No Limit ($0.05/$0.10 USD) - 2021/01/23 12:18:22 ET
Table 'Bohlinia III' 6-max Seat #6 is the button
Seat 2: vilemo20 ($12.78 in chips) 
Seat 3: yYanniky ($10 in chips) 
Seat 4: JohnSF7 ($10.15 in chips) 
Seat 5: 19ElGringo91 ($11.49 in chips) 
Seat 6: GrinZwe91! ($10 in chips) 
vilemo20: posts small blind $0.05
yYanniky: posts big blind $0.10
*** HOLE CARDS ***
JohnSF7: folds 
19ElGringo91: raises $0.20 to $0.30
GrinZwe91!: raises $0.60 to $0.90
vilemo20: folds 
yYanniky: folds 
19ElGringo91: calls $0.60
*** FLOP *** [Ac Kd Tc]
19ElGringo91: checks 
hempju1ce leaves the table
GrinZwe91!: checks 
*** TURN *** [Ac Kd Tc] [Td]
AK-47Rossiya joins the table at seat #1 
19ElGringo91: checks 
GrinZwe91!: checks 
*** RIVER *** [Ac Kd Tc Td] [4d]
19ElGringo91: checks 
GrinZwe91!: checks 
*** SHOW DOWN ***
19ElGringo91: shows [Ad Qc] (two pair, Aces and Tens)
GrinZwe91!: mucks hand 
19ElGringo91 collected $1.86 from pot
*** SUMMARY ***
Total pot $1.95 | Rake $0.09 
Board [Ac Kd Tc Td 4d]
Seat 2: vilemo20 (small blind) folded before Flop
Seat 3: yYanniky (big blind) folded before Flop
Seat 4: JohnSF7 folded before Flop (didn't bet)
Seat 5: 19ElGringo91 showed [Ad Qc] and won ($1.86) with two pair, Aces and Tens
Seat 6: GrinZwe91! (button) mucked



PokerStars Hand #222960884686:  Hold'em No Limit ($0.05/$0.10 USD) - 2021/01/23 12:19:03 ET
Table 'Bohlinia III' 6-max Seat #2 is the button
Seat 2: vilemo20 ($12.73 in chips) 
Seat 3: yYanniky ($10 in chips) 
Seat 4: JohnSF7 ($10.15 in chips) 
Seat 5: 19ElGringo91 ($12.45 in chips) 
Seat 6: GrinZwe91! ($10 in chips) 
yYanniky: posts small blind $0.05
JohnSF7: posts big blind $0.10
*** HOLE CARDS ***
19ElGringo91: folds 
GrinZwe91!: folds 
vilemo20: folds 
yYanniky: folds 
Uncalled bet ($0.05) returned to JohnSF7
JohnSF7 collected $0.10 from pot
JohnSF7: doesn't show hand 
*** SUMMARY ***
Total pot $0.10 | Rake $0 
Seat 2: vilemo20 (button) folded before Flop (didn't bet)
Seat 3: yYanniky (small blind) folded before Flop
Seat 4: JohnSF7 (big blind) collected ($0.10)
Seat 5: 19ElGringo91 folded before Flop (didn't bet)
Seat 6: GrinZwe91! folded before Flop (didn't bet)



PokerStars Hand #222960891626:  Hold'em No Limit ($0.05/$0.10 USD) - 2021/01/23 12:19:14 ET
Table 'Bohlinia III' 6-max Seat #3 is the button
Seat 2: vilemo20 ($12.73 in chips) 
Seat 3: yYanniky ($10 in chips) 
Seat 4: JohnSF7 ($10.20 in chips) 
Seat 6: GrinZwe91! ($10 in chips) 
JohnSF7: posts small blind $0.05
19ElGringo91: is sitting out 
GrinZwe91!: posts big blind $0.10
*** HOLE CARDS ***
vilemo20: raises $0.20 to $0.30
19ElGringo91 leaves the table
AK-47Rossiya leaves the table
yYanniky: calls $0.30
JohnSF7: folds 
GrinZwe91!: folds 
*** FLOP *** [7h 5s 4h]
vilemo20: bets $0.40
yYanniky: folds 
Uncalled bet ($0.40) returned to vilemo20
vilemo20 collected $0.72 from pot
vilemo20: doesn't show hand 
*** SUMMARY ***
Total pot $0.75 | Rake $0.03 
Board [7h 5s 4h]
Seat 2: vilemo20 collected ($0.72)
Seat 3: yYanniky (button) folded on the Flop
Seat 4: JohnSF7 (small blind) folded before Flop
Seat 6: GrinZwe91! (big blind) folded before Flop



PokerStars Hand #222960917503:  Hold'em No Limit ($0.05/$0.10 USD) - 2021/01/23 12:19:55 ET
Table 'Bohlinia III' 6-max Seat #4 is the button
Seat 3: yYanniky ($10 in chips) 
Seat 4: JohnSF7 ($10.15 in chips) 
Seat 6: GrinZwe91! ($10 in chips) 
GrinZwe91!: posts small blind $0.05
vilemo20: is sitting out 
yYanniky: posts big blind $0.10
*** HOLE CARDS ***
PS ChaoS joins the table at seat #5 
JohnSF7: raises $0.15 to $0.25
GrinZwe91!: folds 
yYanniky: folds 
Uncalled bet ($0.15) returned to JohnSF7
JohnSF7 collected $0.25 from pot
JohnSF7: doesn't show hand 
*** SUMMARY ***
Total pot $0.25 | Rake $0 
Seat 3: yYanniky (big blind) folded before Flop
Seat 4: JohnSF7 (button) collected ($0.25)
Seat 6: GrinZwe91! (small blind) folded before Flop



PokerStars Hand #222960925579:  Hold'em No Limit ($0.05/$0.10 USD) - 2021/01/23 12:20:08 ET
Table 'Bohlinia III' 6-max Seat #6 is the button
Seat 3: yYanniky ($10 in chips) 
Seat 4: JohnSF7 ($10.30 in chips) 
Seat 6: GrinZwe91! ($10 in chips) 
yYanniky: posts small blind $0.05
JohnSF7: posts big blind $0.10
PS ChaoS: sits out 
*** HOLE CARDS ***
GrinZwe91!: raises $0.20 to $0.30
yYanniky: folds 
JohnSF7: folds 
Uncalled bet ($0.20) returned to GrinZwe91!
GrinZwe91! collected $0.25 from pot
GrinZwe91!: doesn't show hand 
mastiko1996 joins the table at seat #1 
*** SUMMARY ***
Total pot $0.25 | Rake $0 
Seat 3: yYanniky (small blind) folded before Flop
Seat 4: JohnSF7 (big blind) folded before Flop
Seat 6: GrinZwe91! (button) collected ($0.25)



PokerStars Hand #222960932296:  Hold'em No Limit ($0.05/$0.10 USD) - 2021/01/23 12:20:19 ET
Table 'Bohlinia III' 6-max Seat #3 is the button
Seat 3: yYanniky ($10 in chips) 
Seat 4: JohnSF7 ($10.20 in chips) 
Seat 5: PS ChaoS ($8 in chips) 
Seat 6: GrinZwe91! ($10.15 in chips) 
JohnSF7: posts small blind $0.05
PS ChaoS: posts big blind $0.10
mastiko1996: sits out 
*** HOLE CARDS ***
GrinZwe91!: folds 
yYanniky: folds 
JohnSF7: raises $0.20 to $0.30
PS ChaoS: calls $0.20
*** FLOP *** [Jc 7h Ts]
JohnSF7: bets $0.31
PS ChaoS: calls $0.31
*** TURN *** [Jc 7h Ts] [Th]
JohnSF7: checks 
PS ChaoS: checks 
*** RIVER *** [Jc 7h Ts Th] [Jd]
JohnSF7: bets $0.64
PS ChaoS: folds 
Uncalled bet ($0.64) returned to JohnSF7
JohnSF7 collected $1.17 from pot
JohnSF7: doesn't show hand 
*** SUMMARY ***
Total pot $1.22 | Rake $0.05 
Board [Jc 7h Ts Th Jd]
Seat 3: yYanniky (button) folded before Flop (didn't bet)
Seat 4: JohnSF7 (small blind) collected ($1.17)
Seat 5: PS ChaoS (big blind) folded on the River
Seat 6: GrinZwe91! folded before Flop (didn't bet)



PokerStars Hand #222960966877:  Hold'em No Limit ($0.05/$0.10 USD) - 2021/01/23 12:21:13 ET
Table 'Bohlinia III' 6-max Seat #4 is the button
Seat 3: yYanniky ($10 in chips) 
Seat 4: JohnSF7 ($10.76 in chips) 
Seat 5: PS ChaoS ($7.39 in chips) 
Seat 6: GrinZwe91! ($10.15 in chips) 
PS ChaoS: posts small blind $0.05
GrinZwe91!: posts big blind $0.10
mastiko1996: sits out 
*** HOLE CARDS ***
yYanniky: raises $0.15 to $0.25
JohnSF7: raises $0.65 to $0.90
PS ChaoS: folds 
GrinZwe91!: folds 
yYanniky: folds 
Uncalled bet ($0.65) returned to JohnSF7
JohnSF7 collected $0.65 from pot
JohnSF7: doesn't show hand 
*** SUMMARY ***
Total pot $0.65 | Rake $0 
Seat 3: yYanniky folded before Flop
Seat 4: JohnSF7 (button) collected ($0.65)
Seat 5: PS ChaoS (small blind) folded before Flop
Seat 6: GrinZwe91! (big blind) folded before Flop



PokerStars Hand #222960982559:  Hold'em No Limit ($0.05/$0.10 USD) - 2021/01/23 12:21:38 ET
Table 'Bohlinia III' 6-max Seat #5 is the button
Seat 1: mastiko1996 ($10 in chips) 
Seat 3: yYanniky ($10 in chips) 
Seat 4: JohnSF7 ($11.16 in chips) 
Seat 5: PS ChaoS ($7.34 in chips) 
Seat 6: GrinZwe91! ($10.05 in chips) 
GrinZwe91!: posts small blind $0.05
mastiko1996: posts big blind $0.10
*** HOLE CARDS ***
yYanniky: folds 
JohnSF7: folds 
PS ChaoS: folds 
GrinZwe91!: folds 
Uncalled bet ($0.05) returned to mastiko1996
mastiko1996 collected $0.10 from pot
mastiko1996: doesn't show hand 
*** SUMMARY ***
Total pot $0.10 | Rake $0 
Seat 1: mastiko1996 (big blind) collected ($0.10)
Seat 3: yYanniky folded before Flop (didn't bet)
Seat 4: JohnSF7 folded before Flop (didn't bet)
Seat 5: PS ChaoS (button) folded before Flop (didn't bet)
Seat 6: GrinZwe91! (small blind) folded before Flop



PokerStars Hand #222960989106:  Hold'em No Limit ($0.05/$0.10 USD) - 2021/01/23 12:21:48 ET
Table 'Bohlinia III' 6-max Seat #6 is the button
Seat 1: mastiko1996 ($10.05 in chips) 
Seat 3: yYanniky ($10 in chips) 
Seat 4: JohnSF7 ($11.16 in chips) 
Seat 5: PS ChaoS ($7.34 in chips) 
Seat 6: GrinZwe91! ($10 in chips) 
mastiko1996: posts small blind $0.05
yYanniky: posts big blind $0.10
*** HOLE CARDS ***
JohnSF7: folds 
PS ChaoS: folds 
GrinZwe91!: folds 
mastiko1996: folds 
Uncalled bet ($0.05) returned to yYanniky
yYanniky collected $0.10 from pot
yYanniky: doesn't show hand 
*** SUMMARY ***
Total pot $0.10 | Rake $0 
Seat 1: mastiko1996 (small blind) folded before Flop
Seat 3: yYanniky (big blind) collected ($0.10)
Seat 4: JohnSF7 folded before Flop (didn't bet)
Seat 5: PS ChaoS folded before Flop (didn't bet)
Seat 6: GrinZwe91! (button) folded before Flop (didn't bet)



PokerStars Hand #222960994886:  Hold'em No Limit ($0.05/$0.10 USD) - 2021/01/23 12:21:58 ET
Table 'Bohlinia III' 6-max Seat #1 is the button
Seat 1: mastiko1996 ($10 in chips) 
Seat 3: yYanniky ($10.05 in chips) 
Seat 4: JohnSF7 ($11.16 in chips) 
Seat 5: PS ChaoS ($7.34 in chips) 
Seat 6: GrinZwe91! ($10 in chips) 
yYanniky: posts small blind $0.05
JohnSF7: posts big blind $0.10
*** HOLE CARDS ***
PS ChaoS has timed out
PS ChaoS: folds 
GrinZwe91!: raises $0.20 to $0.30
mastiko1996: folds 
yYanniky: folds 
JohnSF7: folds 
Uncalled bet ($0.20) returned to GrinZwe91!
GrinZwe91! collected $0.25 from pot
GrinZwe91!: doesn't show hand 
*** SUMMARY ***
Total pot $0.25 | Rake $0 
Seat 1: mastiko1996 (button) folded before Flop (didn't bet)
Seat 3: yYanniky (small blind) folded before Flop
Seat 4: JohnSF7 (big blind) folded before Flop
Seat 5: PS ChaoS folded before Flop (didn't bet)
Seat 6: GrinZwe91! collected ($0.25)



PokerStars Hand #222961009178:  Hold'em No Limit ($0.05/$0.10 USD) - 2021/01/23 12:22:20 ET
Table 'Bohlinia III' 6-max Seat #3 is the button
Seat 1: mastiko1996 ($10 in chips) 
Seat 3: yYanniky ($10 in chips) 
Seat 4: JohnSF7 ($11.06 in chips) 
Seat 5: PS ChaoS ($7.34 in chips) 
Seat 6: GrinZwe91! ($10.15 in chips) 
JohnSF7: posts small blind $0.05
PS ChaoS: posts big blind $0.10
vilemo20: sits out 
*** HOLE CARDS ***
GrinZwe91!: raises $0.20 to $0.30
mastiko1996: folds 
yYanniky: folds 
JohnSF7: folds 
PS ChaoS: folds 
Uncalled bet ($0.20) returned to GrinZwe91!
GrinZwe91! collected $0.25 from pot
GrinZwe91!: doesn't show hand 
*** SUMMARY ***
Total pot $0.25 | Rake $0 
Seat 1: mastiko1996 folded before Flop (didn't bet)
Seat 3: yYanniky (button) folded before Flop (didn't bet)
Seat 4: JohnSF7 (small blind) folded before Flop
Seat 5: PS ChaoS (big blind) folded before Flop
Seat 6: GrinZwe91! collected ($0.25)



PokerStars Hand #222961018007:  Hold'em No Limit ($0.05/$0.10 USD) - 2021/01/23 12:22:34 ET
Table 'Bohlinia III' 6-max Seat #4 is the button
Seat 1: mastiko1996 ($10 in chips) 
Seat 3: yYanniky ($10 in chips) 
Seat 4: JohnSF7 ($11.01 in chips) 
Seat 5: PS ChaoS ($7.24 in chips) 
Seat 6: GrinZwe91! ($10.30 in chips) 
PS ChaoS: posts small blind $0.05
GrinZwe91!: posts big blind $0.10
vilemo20: sits out 
*** HOLE CARDS ***
mastiko1996: raises $0.20 to $0.30
yYanniky: folds 
JohnSF7: folds 
PS ChaoS: folds 
GrinZwe91!: folds 
Uncalled bet ($0.20) returned to mastiko1996
mastiko1996 collected $0.25 from pot
mastiko1996: doesn't show hand 
*** SUMMARY ***
Total pot $0.25 | Rake $0 
Seat 1: mastiko1996 collected ($0.25)
Seat 3: yYanniky folded before Flop (didn't bet)
Seat 4: JohnSF7 (button) folded before Flop (didn't bet)
Seat 5: PS ChaoS (small blind) folded before Flop
Seat 6: GrinZwe91! (big blind) folded before Flop



PokerStars Hand #222961029432:  Hold'em No Limit ($0.05/$0.10 USD) - 2021/01/23 12:22:52 ET
Table 'Bohlinia III' 6-max Seat #5 is the button
Seat 2: vilemo20 ($13.15 in chips) 
Seat 3: yYanniky ($10 in chips) 
Seat 4: JohnSF7 ($11.01 in chips) 
Seat 5: PS ChaoS ($7.19 in chips) 
Seat 6: GrinZwe91! ($10.20 in chips) 
GrinZwe91!: posts small blind $0.05
mastiko1996: is sitting out 
vilemo20: posts big blind $0.10
*** HOLE CARDS ***
yYanniky: raises $0.17 to $0.27
mastiko1996 leaves the table
JohnSF7: folds 
PS ChaoS: folds 
GrinZwe91!: folds 
vilemo20: folds 
Uncalled bet ($0.17) returned to yYanniky
yYanniky collected $0.25 from pot
yYanniky: doesn't show hand 
*** SUMMARY ***
Total pot $0.25 | Rake $0 
Seat 2: vilemo20 (big blind) folded before Flop
Seat 3: yYanniky collected ($0.25)
Seat 4: JohnSF7 folded before Flop (didn't bet)
Seat 5: PS ChaoS (button) folded before Flop (didn't bet)
Seat 6: GrinZwe91! (small blind) folded before Flop



PokerStars Hand #222961038748:  Hold'em No Limit ($0.05/$0.10 USD) - 2021/01/23 12:23:07 ET
Table 'Bohlinia III' 6-max Seat #6 is the button
Seat 2: vilemo20 ($13.05 in chips) 
Seat 3: yYanniky ($10.15 in chips) 
Seat 4: JohnSF7 ($11.01 in chips) 
Seat 5: PS ChaoS ($7.19 in chips) 
Seat 6: GrinZwe91! ($10.15 in chips) 
vilemo20: posts small blind $0.05
yYanniky: posts big blind $0.10
*** HOLE CARDS ***
JohnSF7: folds 
PS ChaoS: folds 
GrinZwe91!: folds 
vilemo20: raises $0.20 to $0.30
yYanniky: calls $0.20
*** FLOP *** [6h Ts 5c]
vilemo20: bets $0.39
yYanniky: calls $0.39
*** TURN *** [6h Ts 5c] [Qh]
vilemo20: checks 
xucuo joins the table at seat #1 
yYanniky: checks 
*** RIVER *** [6h Ts 5c Qh] [6c]
vilemo20: bets $0.90
yYanniky: calls $0.90
*** SHOW DOWN ***
vilemo20: shows [9s 7s] (a pair of Sixes)
yYanniky: shows [Kh Th] (two pair, Tens and Sixes)
yYanniky collected $3.04 from pot
*** SUMMARY ***
Total pot $3.18 | Rake $0.14 
Board [6h Ts 5c Qh 6c]
Seat 2: vilemo20 (small blind) showed [9s 7s] and lost with a pair of Sixes
Seat 3: yYanniky (big blind) showed [Kh Th] and won ($3.04) with two pair, Tens and Sixes
Seat 4: JohnSF7 folded before Flop (didn't bet)
Seat 5: PS ChaoS folded before Flop (didn't bet)
Seat 6: GrinZwe91! (button) folded before Flop (didn't bet)



PokerStars Hand #222961085476:  Hold'em No Limit ($0.05/$0.10 USD) - 2021/01/23 12:24:08 ET
Table 'Bohlinia III' 6-max Seat #2 is the button
Seat 2: vilemo20 ($11.46 in chips) 
Seat 3: yYanniky ($11.60 in chips) 
Seat 4: JohnSF7 ($11.01 in chips) 
Seat 5: PS ChaoS ($7.19 in chips) 
Seat 6: GrinZwe91! ($10.15 in chips) 
yYanniky: posts small blind $0.05
JohnSF7: posts big blind $0.10
xucuo: sits out 
*** HOLE CARDS ***
PS ChaoS has timed out
PS ChaoS: folds 
GrinZwe91!: folds 
vilemo20: folds 
PS ChaoS is disconnected 
yYanniky: folds 
Uncalled bet ($0.05) returned to JohnSF7
JohnSF7 collected $0.10 from pot
JohnSF7: doesn't show hand 
*** SUMMARY ***
Total pot $0.10 | Rake $0 
Seat 2: vilemo20 (button) folded before Flop (didn't bet)
Seat 3: yYanniky (small blind) folded before Flop
Seat 4: JohnSF7 (big blind) collected ($0.10)
Seat 5: PS ChaoS folded before Flop (didn't bet)
Seat 6: GrinZwe91! folded before Flop (didn't bet)



PokerStars Hand #222961101129:  Hold'em No Limit ($0.05/$0.10 USD) - 2021/01/23 12:24:33 ET
Table 'Bohlinia III' 6-max Seat #3 is the button
Seat 2: vilemo20 ($11.46 in chips) 
Seat 3: yYanniky ($11.55 in chips) 
Seat 4: JohnSF7 ($11.06 in chips) 
Seat 6: GrinZwe91! ($10.15 in chips) 
JohnSF7: posts small blind $0.05
GrinZwe91!: posts big blind $0.10
xucuo: sits out 
*** HOLE CARDS ***
vilemo20: raises $0.20 to $0.30
yYanniky: folds 
JohnSF7: folds 
GrinZwe91!: folds 
Uncalled bet ($0.20) returned to vilemo20
vilemo20 collected $0.25 from pot
vilemo20: doesn't show hand 
*** SUMMARY ***
Total pot $0.25 | Rake $0 
Seat 2: vilemo20 collected ($0.25)
Seat 3: yYanniky (button) folded before Flop (didn't bet)
Seat 4: JohnSF7 (small blind) folded before Flop
Seat 6: GrinZwe91! (big blind) folded before Flop



PokerStars Hand #222961112193:  Hold'em No Limit ($0.05/$0.10 USD) - 2021/01/23 12:24:50 ET
Table 'Bohlinia III' 6-max Seat #4 is the button
Seat 1: xucuo ($10 in chips) 
Seat 2: vilemo20 ($11.61 in chips) 
Seat 3: yYanniky ($11.55 in chips) 
Seat 4: JohnSF7 ($11.01 in chips) 
Seat 6: GrinZwe91! ($10.05 in chips) 
GrinZwe91!: posts small blind $0.05
xucuo: posts big blind $0.10
*** HOLE CARDS ***
vilemo20: folds 
yYanniky: folds 
JohnSF7: raises $0.15 to $0.25
GrinZwe91!: folds 
xucuo: calls $0.15
*** FLOP *** [Jc 9s 4h]
xucuo: checks 
JohnSF7: bets $0.29
xucuo: folds 
Uncalled bet ($0.29) returned to JohnSF7
JohnSF7 collected $0.53 from pot
JohnSF7: doesn't show hand 
*** SUMMARY ***
Total pot $0.55 | Rake $0.02 
Board [Jc 9s 4h]
Seat 1: xucuo (big blind) folded on the Flop
Seat 2: vilemo20 folded before Flop (didn't bet)
Seat 3: yYanniky folded before Flop (didn't bet)
Seat 4: JohnSF7 (button) collected ($0.53)
Seat 6: GrinZwe91! (small blind) folded before Flop



PokerStars Hand #222961137698:  Hold'em No Limit ($0.05/$0.10 USD) - 2021/01/23 12:25:29 ET
Table 'Bohlinia III' 6-max Seat #6 is the button
Seat 1: xucuo ($10 in chips) 
Seat 2: vilemo20 ($11.61 in chips) 
Seat 3: yYanniky ($11.55 in chips) 
Seat 4: JohnSF7 ($11.29 in chips) 
Seat 6: GrinZwe91! ($10 in chips) 
xucuo: posts small blind $0.05
vilemo20: posts big blind $0.10
*** HOLE CARDS ***
yYanniky: folds 
JohnSF7: raises $0.15 to $0.25
GrinZwe91!: folds 
xucuo: folds 
vilemo20: folds 
Uncalled bet ($0.15) returned to JohnSF7
JohnSF7 collected $0.25 from pot
JohnSF7: doesn't show hand 
*** SUMMARY ***
Total pot $0.25 | Rake $0 
Seat 1: xucuo (small blind) folded before Flop
Seat 2: vilemo20 (big blind) folded before Flop
Seat 3: yYanniky folded before Flop (didn't bet)
Seat 4: JohnSF7 collected ($0.25)
Seat 6: GrinZwe91! (button) folded before Flop (didn't bet)



PokerStars Hand #222961146755:  Hold'em No Limit ($0.05/$0.10 USD) - 2021/01/23 12:25:43 ET
Table 'Bohlinia III' 6-max Seat #1 is the button
Seat 1: xucuo ($10 in chips) 
Seat 2: vilemo20 ($11.51 in chips) 
Seat 3: yYanniky ($11.55 in chips) 
Seat 4: JohnSF7 ($11.44 in chips) 
Seat 6: GrinZwe91! ($10 in chips) 
vilemo20: posts small blind $0.05
yYanniky: posts big blind $0.10
*** HOLE CARDS ***
JohnSF7: folds 
GrinZwe91!: raises $0.20 to $0.30
xucuo: folds 
vilemo20: folds 
yYanniky: folds 
Uncalled bet ($0.20) returned to GrinZwe91!
GrinZwe91! collected $0.25 from pot
GrinZwe91!: doesn't show hand 
*** SUMMARY ***
Total pot $0.25 | Rake $0 
Seat 1: xucuo (button) folded before Flop (didn't bet)
Seat 2: vilemo20 (small blind) folded before Flop
Seat 3: yYanniky (big blind) folded before Flop
Seat 4: JohnSF7 folded before Flop (didn't bet)
Seat 6: GrinZwe91! collected ($0.25)



PokerStars Hand #222961156396:  Hold'em No Limit ($0.05/$0.10 USD) - 2021/01/23 12:25:58 ET
Table 'Bohlinia III' 6-max Seat #2 is the button
Seat 1: xucuo ($10 in chips) 
Seat 2: vilemo20 ($11.46 in chips) 
Seat 3: yYanniky ($11.45 in chips) 
Seat 4: JohnSF7 ($11.44 in chips) 
Seat 6: GrinZwe91! ($10.15 in chips) 
yYanniky: posts small blind $0.05
JohnSF7: posts big blind $0.10
*** HOLE CARDS ***
GrinZwe91!: folds 
xucuo: raises $0.20 to $0.30
vilemo20: folds 
yYanniky: folds 
JohnSF7: folds 
Uncalled bet ($0.20) returned to xucuo
xucuo collected $0.25 from pot
xucuo: doesn't show hand 
*** SUMMARY ***
Total pot $0.25 | Rake $0 
Seat 1: xucuo collected ($0.25)
Seat 2: vilemo20 (button) folded before Flop (didn't bet)
Seat 3: yYanniky (small blind) folded before Flop
Seat 4: JohnSF7 (big blind) folded before Flop
Seat 6: GrinZwe91! folded before Flop (didn't bet)



PokerStars Hand #222961171640:  Hold'em No Limit ($0.05/$0.10 USD) - 2021/01/23 12:26:22 ET
Table 'Bohlinia III' 6-max Seat #3 is the button
Seat 1: xucuo ($10.15 in chips) 
Seat 2: vilemo20 ($11.46 in chips) 
Seat 3: yYanniky ($11.40 in chips) 
Seat 4: JohnSF7 ($11.34 in chips) 
Seat 6: GrinZwe91! ($10.15 in chips) 
JohnSF7: posts small blind $0.05
GrinZwe91!: posts big blind $0.10
*** HOLE CARDS ***
xucuo: raises $0.20 to $0.30
vilemo20: folds 
yYanniky: folds 
JohnSF7: folds 
GrinZwe91!: folds 
Uncalled bet ($0.20) returned to xucuo
xucuo collected $0.25 from pot
xucuo: doesn't show hand 
*** SUMMARY ***
Total pot $0.25 | Rake $0 
Seat 1: xucuo collected ($0.25)
Seat 2: vilemo20 folded before Flop (didn't bet)
Seat 3: yYanniky (button) folded before Flop (didn't bet)
Seat 4: JohnSF7 (small blind) folded before Flop
Seat 6: GrinZwe91! (big blind) folded before Flop



PokerStars Hand #222961179894:  Hold'em No Limit ($0.05/$0.10 USD) - 2021/01/23 12:26:34 ET
Table 'Bohlinia III' 6-max Seat #4 is the button
Seat 1: xucuo ($10.30 in chips) 
Seat 2: vilemo20 ($11.46 in chips) 
Seat 3: yYanniky ($11.40 in chips) 
Seat 4: JohnSF7 ($11.29 in chips) 
Seat 6: GrinZwe91! ($10.05 in chips) 
GrinZwe91!: posts small blind $0.05
xucuo: posts big blind $0.10
*** HOLE CARDS ***
vilemo20: raises $0.20 to $0.30
yYanniky: folds 
JohnSF7: folds 
GrinZwe91!: calls $0.25
xucuo: calls $0.20
*** FLOP *** [Td 4d 6d]
GrinZwe91!: checks 
xucuo: checks 
vilemo20: checks 
*** TURN *** [Td 4d 6d] [4c]
GrinZwe91!: checks 
xucuo: checks 
vilemo20: checks 
*** RIVER *** [Td 4d 6d 4c] [Jc]
GrinZwe91!: checks 
xucuo: checks 
vilemo20: checks 
*** SHOW DOWN ***
GrinZwe91!: shows [5h 5d] (two pair, Fives and Fours)
xucuo: mucks hand 
vilemo20: shows [Jd As] (two pair, Jacks and Fours)
vilemo20 collected $0.86 from pot
*** SUMMARY ***
Total pot $0.90 | Rake $0.04 
Board [Td 4d 6d 4c Jc]
Seat 1: xucuo (big blind) mucked
Seat 2: vilemo20 showed [Jd As] and won ($0.86) with two pair, Jacks and Fours
Seat 3: yYanniky folded before Flop (didn't bet)
Seat 4: JohnSF7 (button) folded before Flop (didn't bet)
Seat 6: GrinZwe91! (small blind) showed [5h 5d] and lost with two pair, Fives and Fours



PokerStars Hand #222961206869:  Hold'em No Limit ($0.05/$0.10 USD) - 2021/01/23 12:27:15 ET
Table 'Bohlinia III' 6-max Seat #6 is the button
Seat 1: xucuo ($10 in chips) 
Seat 2: vilemo20 ($12.02 in chips) 
Seat 3: yYanniky ($11.40 in chips) 
Seat 4: JohnSF7 ($11.29 in chips) 
Seat 6: GrinZwe91! ($10 in chips) 
xucuo: posts small blind $0.05
vilemo20: posts big blind $0.10
*** HOLE CARDS ***
yYanniky: folds 
JohnSF7: raises $0.15 to $0.25
GrinZwe91!: calls $0.25
xucuo: folds 
vilemo20: folds 
*** FLOP *** [Jc 4c 8s]
JohnSF7: bets $0.48
GrinZwe91!: folds 
Uncalled bet ($0.48) returned to JohnSF7
JohnSF7 collected $0.62 from pot
JohnSF7: doesn't show hand 
*** SUMMARY ***
Total pot $0.65 | Rake $0.03 
Board [Jc 4c 8s]
Seat 1: xucuo (small blind) folded before Flop
Seat 2: vilemo20 (big blind) folded before Flop
Seat 3: yYanniky folded before Flop (didn't bet)
Seat 4: JohnSF7 collected ($0.62)
Seat 6: GrinZwe91! (button) folded on the Flop



PokerStars Hand #222961224575:  Hold'em No Limit ($0.05/$0.10 USD) - 2021/01/23 12:27:43 ET
Table 'Bohlinia III' 6-max Seat #1 is the button
Seat 1: xucuo ($10 in chips) 
Seat 2: vilemo20 ($11.92 in chips) 
Seat 3: yYanniky ($11.40 in chips) 
Seat 4: JohnSF7 ($11.66 in chips) 
Seat 6: GrinZwe91! ($10 in chips) 
vilemo20: posts small blind $0.05
yYanniky: posts big blind $0.10
PS ChaoS: sits out 
*** HOLE CARDS ***
JohnSF7: folds 
GrinZwe91!: folds 
xucuo: folds 
vilemo20: folds 
Uncalled bet ($0.05) returned to yYanniky
yYanniky collected $0.10 from pot
yYanniky: doesn't show hand 
*** SUMMARY ***
Total pot $0.10 | Rake $0 
Seat 1: xucuo (button) folded before Flop (didn't bet)
Seat 2: vilemo20 (small blind) folded before Flop
Seat 3: yYanniky (big blind) collected ($0.10)
Seat 4: JohnSF7 folded before Flop (didn't bet)
Seat 6: GrinZwe91! folded before Flop (didn't bet)



PokerStars Hand #222961230082:  Hold'em No Limit ($0.05/$0.10 USD) - 2021/01/23 12:27:51 ET
Table 'Bohlinia III' 6-max Seat #2 is the button
Seat 1: xucuo ($10 in chips) 
Seat 2: vilemo20 ($11.87 in chips) 
Seat 3: yYanniky ($11.45 in chips) 
Seat 4: JohnSF7 ($11.66 in chips) 
Seat 6: GrinZwe91! ($10 in chips) 
yYanniky: posts small blind $0.05
JohnSF7: posts big blind $0.10
PS ChaoS: sits out 
*** HOLE CARDS ***
GrinZwe91!: folds 
xucuo: folds 
vilemo20: raises $0.15 to $0.25
yYanniky: raises $0.75 to $1
JohnSF7: folds 
vilemo20: folds 
Uncalled bet ($0.75) returned to yYanniky
yYanniky collected $0.60 from pot
yYanniky: doesn't show hand 
*** SUMMARY ***
Total pot $0.60 | Rake $0 
Seat 1: xucuo folded before Flop (didn't bet)
Seat 2: vilemo20 (button) folded before Flop
Seat 3: yYanniky (small blind) collected ($0.60)
Seat 4: JohnSF7 (big blind) folded before Flop
Seat 6: GrinZwe91! folded before Flop (didn't bet)



PokerStars Hand #222961241719:  Hold'em No Limit ($0.05/$0.10 USD) - 2021/01/23 12:28:09 ET
Table 'Bohlinia III' 6-max Seat #3 is the button
Seat 1: xucuo ($10 in chips) 
Seat 2: vilemo20 ($11.62 in chips) 
Seat 3: yYanniky ($11.80 in chips) 
Seat 4: JohnSF7 ($11.56 in chips) 
Seat 5: PS ChaoS ($7.19 in chips) 
Seat 6: GrinZwe91! ($10 in chips) 
JohnSF7: posts small blind $0.05
PS ChaoS: posts big blind $0.10
*** HOLE CARDS ***
GrinZwe91!: raises $0.20 to $0.30
xucuo: folds 
vilemo20: folds 
yYanniky: folds 
JohnSF7: folds 
PS ChaoS: folds 
Uncalled bet ($0.20) returned to GrinZwe91!
GrinZwe91! collected $0.25 from pot
GrinZwe91!: doesn't show hand 
*** SUMMARY ***
Total pot $0.25 | Rake $0 
Seat 1: xucuo folded before Flop (didn't bet)
Seat 2: vilemo20 folded before Flop (didn't bet)
Seat 3: yYanniky (button) folded before Flop (didn't bet)
Seat 4: JohnSF7 (small blind) folded before Flop
Seat 5: PS ChaoS (big blind) folded before Flop
Seat 6: GrinZwe91! collected ($0.25)



PokerStars Hand #222961250111:  Hold'em No Limit ($0.05/$0.10 USD) - 2021/01/23 12:28:22 ET
Table 'Bohlinia III' 6-max Seat #4 is the button
Seat 1: xucuo ($10 in chips) 
Seat 2: vilemo20 ($11.62 in chips) 
Seat 3: yYanniky ($11.80 in chips) 
Seat 4: JohnSF7 ($11.51 in chips) 
Seat 5: PS ChaoS ($7.09 in chips) 
Seat 6: GrinZwe91! ($10.15 in chips) 
PS ChaoS: posts small blind $0.05
GrinZwe91!: posts big blind $0.10
*** HOLE CARDS ***
xucuo: folds 
vilemo20: folds 
yYanniky: folds 
JohnSF7: raises $0.15 to $0.25
PS ChaoS: folds 
GrinZwe91!: folds 
Uncalled bet ($0.15) returned to JohnSF7
JohnSF7 collected $0.25 from pot
JohnSF7: doesn't show hand 
*** SUMMARY ***
Total pot $0.25 | Rake $0 
Seat 1: xucuo folded before Flop (didn't bet)
Seat 2: vilemo20 folded before Flop (didn't bet)
Seat 3: yYanniky folded before Flop (didn't bet)
Seat 4: JohnSF7 (button) collected ($0.25)
Seat 5: PS ChaoS (small blind) folded before Flop
Seat 6: GrinZwe91! (big blind) folded before Flop



PokerStars Hand #222961262687:  Hold'em No Limit ($0.05/$0.10 USD) - 2021/01/23 12:28:41 ET
Table 'Bohlinia III' 6-max Seat #5 is the button
Seat 1: xucuo ($10 in chips) 
Seat 2: vilemo20 ($11.62 in chips) 
Seat 3: yYanniky ($11.80 in chips) 
Seat 4: JohnSF7 ($11.66 in chips) 
Seat 5: PS ChaoS ($7.04 in chips) 
Seat 6: GrinZwe91! ($10.05 in chips) 
GrinZwe91!: posts small blind $0.05
xucuo: posts big blind $0.10
*** HOLE CARDS ***
vilemo20: folds 
yYanniky: folds 
JohnSF7: folds 
PS ChaoS: folds 
GrinZwe91!: folds 
Uncalled bet ($0.05) returned to xucuo
xucuo collected $0.10 from pot
*** SUMMARY ***
Total pot $0.10 | Rake $0 
Seat 1: xucuo (big blind) collected ($0.10)
Seat 2: vilemo20 folded before Flop (didn't bet)
Seat 3: yYanniky folded before Flop (didn't bet)
Seat 4: JohnSF7 folded before Flop (didn't bet)
Seat 5: PS ChaoS (button) folded before Flop (didn't bet)
Seat 6: GrinZwe91! (small blind) folded before Flop



PokerStars Hand #222961273688:  Hold'em No Limit ($0.05/$0.10 USD) - 2021/01/23 12:28:58 ET
Table 'Bohlinia III' 6-max Seat #6 is the button
Seat 1: xucuo ($10.05 in chips) 
Seat 2: vilemo20 ($11.62 in chips) 
Seat 3: yYanniky ($11.80 in chips) 
Seat 4: JohnSF7 ($11.66 in chips) 
Seat 5: PS ChaoS ($7.04 in chips) 
Seat 6: GrinZwe91! ($10 in chips) 
xucuo is connected 
xucuo: posts small blind $0.05
vilemo20: posts big blind $0.10
*** HOLE CARDS ***
yYanniky: raises $0.17 to $0.27
JohnSF7: folds 
PS ChaoS: folds 
GrinZwe91!: folds 
xucuo: calls $0.22
vilemo20: folds 
*** FLOP *** [7s 2s 3d]
xucuo: checks 
yYanniky: bets $0.23
xucuo: calls $0.23
*** TURN *** [7s 2s 3d] [Jd]
xucuo: checks 
yYanniky: checks 
*** RIVER *** [7s 2s 3d Jd] [5s]
xucuo: bets $0.80
yYanniky: folds 
Uncalled bet ($0.80) returned to xucuo
xucuo collected $1.05 from pot
xucuo: doesn't show hand 
*** SUMMARY ***
Total pot $1.10 | Rake $0.05 
Board [7s 2s 3d Jd 5s]
Seat 1: xucuo (small blind) collected ($1.05)
Seat 2: vilemo20 (big blind) folded before Flop
Seat 3: yYanniky folded on the River
Seat 4: JohnSF7 folded before Flop (didn't bet)
Seat 5: PS ChaoS folded before Flop (didn't bet)
Seat 6: GrinZwe91! (button) folded before Flop (didn't bet)



PokerStars Hand #222961305239:  Hold'em No Limit ($0.05/$0.10 USD) - 2021/01/23 12:29:47 ET
Table 'Bohlinia III' 6-max Seat #1 is the button
Seat 1: xucuo ($10.60 in chips) 
Seat 2: vilemo20 ($11.52 in chips) 
Seat 3: yYanniky ($11.30 in chips) 
Seat 4: JohnSF7 ($11.66 in chips) 
Seat 5: PS ChaoS ($7.04 in chips) 
Seat 6: GrinZwe91! ($10 in chips) 
vilemo20: posts small blind $0.05
yYanniky: posts big blind $0.10
*** HOLE CARDS ***
JohnSF7: folds 
PS ChaoS: raises $0.10 to $0.20
GrinZwe91!: folds 
xucuo: folds 
vilemo20: folds 
yYanniky: calls $0.10
*** FLOP *** [4s Kd Qc]
yYanniky: checks 
PS ChaoS: bets $0.20
yYanniky: folds 
Uncalled bet ($0.20) returned to PS ChaoS
PS ChaoS collected $0.43 from pot
PS ChaoS: doesn't show hand 
*** SUMMARY ***
Total pot $0.45 | Rake $0.02 
Board [4s Kd Qc]
Seat 1: xucuo (button) folded before Flop (didn't bet)
Seat 2: vilemo20 (small blind) folded before Flop
Seat 3: yYanniky (big blind) folded on the Flop
Seat 4: JohnSF7 folded before Flop (didn't bet)
Seat 5: PS ChaoS collected ($0.43)
Seat 6: GrinZwe91! folded before Flop (didn't bet)



PokerStars Hand #222961322872:  Hold'em No Limit ($0.05/$0.10 USD) - 2021/01/23 12:30:13 ET
Table 'Bohlinia III' 6-max Seat #2 is the button
Seat 1: xucuo ($10.60 in chips) 
Seat 2: vilemo20 ($11.47 in chips) 
Seat 3: yYanniky ($11.10 in chips) 
Seat 4: JohnSF7 ($11.66 in chips) 
Seat 5: PS ChaoS ($7.27 in chips) 
Seat 6: GrinZwe91! ($10 in chips) 
yYanniky: posts small blind $0.05
JohnSF7: posts big blind $0.10
*** HOLE CARDS ***
PS ChaoS: raises $0.10 to $0.20
GrinZwe91!: folds 
xucuo: folds 
vilemo20: folds 
yYanniky: folds 
JohnSF7: folds 
Uncalled bet ($0.10) returned to PS ChaoS
PS ChaoS collected $0.25 from pot
PS ChaoS: doesn't show hand 
*** SUMMARY ***
Total pot $0.25 | Rake $0 
Seat 1: xucuo folded before Flop (didn't bet)
Seat 2: vilemo20 (button) folded before Flop (didn't bet)
Seat 3: yYanniky (small blind) folded before Flop
Seat 4: JohnSF7 (big blind) folded before Flop
Seat 5: PS ChaoS collected ($0.25)
Seat 6: GrinZwe91! folded before Flop (didn't bet)



PokerStars Hand #222961339241:  Hold'em No Limit ($0.05/$0.10 USD) - 2021/01/23 12:30:38 ET
Table 'Bohlinia III' 6-max Seat #3 is the button
Seat 1: xucuo ($10.60 in chips) 
Seat 2: vilemo20 ($11.47 in chips) 
Seat 3: yYanniky ($11.05 in chips) 
Seat 4: JohnSF7 ($11.56 in chips) 
Seat 5: PS ChaoS ($7.42 in chips) 
Seat 6: GrinZwe91! ($10 in chips) 
JohnSF7: posts small blind $0.05
PS ChaoS: posts big blind $0.10
*** HOLE CARDS ***
GrinZwe91!: folds 
xucuo: folds 
vilemo20: folds 
yYanniky: folds 
JohnSF7: folds 
Uncalled bet ($0.05) returned to PS ChaoS
PS ChaoS collected $0.10 from pot
PS ChaoS: doesn't show hand 
*** SUMMARY ***
Total pot $0.10 | Rake $0 
Seat 1: xucuo folded before Flop (didn't bet)
Seat 2: vilemo20 folded before Flop (didn't bet)
Seat 3: yYanniky (button) folded before Flop (didn't bet)
Seat 4: JohnSF7 (small blind) folded before Flop
Seat 5: PS ChaoS (big blind) collected ($0.10)
Seat 6: GrinZwe91! folded before Flop (didn't bet)



PokerStars Hand #222961346523:  Hold'em No Limit ($0.05/$0.10 USD) - 2021/01/23 12:30:49 ET
Table 'Bohlinia III' 6-max Seat #4 is the button
Seat 1: xucuo ($10.60 in chips) 
Seat 2: vilemo20 ($11.47 in chips) 
Seat 3: yYanniky ($11.05 in chips) 
Seat 4: JohnSF7 ($11.51 in chips) 
Seat 5: PS ChaoS ($7.47 in chips) 
Seat 6: GrinZwe91! ($10 in chips) 
PS ChaoS: posts small blind $0.05
GrinZwe91!: posts big blind $0.10
*** HOLE CARDS ***
xucuo: folds 
vilemo20: folds 
yYanniky: folds 
JohnSF7: raises $0.15 to $0.25
PS ChaoS: calls $0.20
GrinZwe91!: folds 
*** FLOP *** [5d 3s 6c]
PS ChaoS: checks 
JohnSF7: checks 
*** TURN *** [5d 3s 6c] [Jc]
PS ChaoS: checks 
JohnSF7: bets $0.44
PS ChaoS: folds 
Uncalled bet ($0.44) returned to JohnSF7
JohnSF7 collected $0.57 from pot
JohnSF7: doesn't show hand 
*** SUMMARY ***
Total pot $0.60 | Rake $0.03 
Board [5d 3s 6c Jc]
Seat 1: xucuo folded before Flop (didn't bet)
Seat 2: vilemo20 folded before Flop (didn't bet)
Seat 3: yYanniky folded before Flop (didn't bet)
Seat 4: JohnSF7 (button) collected ($0.57)
Seat 5: PS ChaoS (small blind) folded on the Turn
Seat 6: GrinZwe91! (big blind) folded before Flop



PokerStars Hand #222961373631:  Hold'em No Limit ($0.05/$0.10 USD) - 2021/01/23 12:31:30 ET
Table 'Bohlinia III' 6-max Seat #5 is the button
Seat 1: xucuo ($10.60 in chips) 
Seat 2: vilemo20 ($11.47 in chips) 
Seat 3: yYanniky ($11.05 in chips) 
Seat 4: JohnSF7 ($11.83 in chips) 
Seat 5: PS ChaoS ($7.22 in chips) 
Seat 6: GrinZwe91! ($10 in chips) 
GrinZwe91!: posts small blind $0.05
xucuo: posts big blind $0.10
*** HOLE CARDS ***
vilemo20: folds 
yYanniky: folds 
JohnSF7: raises $0.15 to $0.25
PS ChaoS: folds 
GrinZwe91!: folds 
xucuo: folds 
Uncalled bet ($0.15) returned to JohnSF7
JohnSF7 collected $0.25 from pot
JohnSF7: doesn't show hand 
*** SUMMARY ***
Total pot $0.25 | Rake $0 
Seat 1: xucuo (big blind) folded before Flop
Seat 2: vilemo20 folded before Flop (didn't bet)
Seat 3: yYanniky folded before Flop (didn't bet)
Seat 4: JohnSF7 collected ($0.25)
Seat 5: PS ChaoS (button) folded before Flop (didn't bet)
Seat 6: GrinZwe91! (small blind) folded before Flop



PokerStars Hand #222961386102:  Hold'em No Limit ($0.05/$0.10 USD) - 2021/01/23 12:31:49 ET
Table 'Bohlinia III' 6-max Seat #6 is the button
Seat 1: xucuo ($10.50 in chips) 
Seat 2: vilemo20 ($11.47 in chips) 
Seat 3: yYanniky ($11.05 in chips) 
Seat 4: JohnSF7 ($11.98 in chips) 
Seat 5: PS ChaoS ($7.22 in chips) 
Seat 6: GrinZwe91! ($10 in chips) 
xucuo: posts small blind $0.05
vilemo20: posts big blind $0.10
*** HOLE CARDS ***
yYanniky: folds 
JohnSF7: folds 
PS ChaoS: raises $0.10 to $0.20
GrinZwe91!: folds 
xucuo: calls $0.15
vilemo20: folds 
*** FLOP *** [8s 2c 7h]
xucuo: bets $0.30
PS ChaoS: calls $0.30
*** TURN *** [8s 2c 7h] [Qc]
xucuo: checks 
PS ChaoS: bets $0.53
xucuo: calls $0.53
*** RIVER *** [8s 2c 7h Qc] [4d]
xucuo: checks 
PS ChaoS: checks 
*** SHOW DOWN ***
xucuo: shows [6c 4c] (a pair of Fours)
PS ChaoS: mucks hand 
xucuo collected $2.06 from pot
*** SUMMARY ***
Total pot $2.16 | Rake $0.10 
Board [8s 2c 7h Qc 4d]
Seat 1: xucuo (small blind) showed [6c 4c] and won ($2.06) with a pair of Fours
Seat 2: vilemo20 (big blind) folded before Flop
Seat 3: yYanniky folded before Flop (didn't bet)
Seat 4: JohnSF7 folded before Flop (didn't bet)
Seat 5: PS ChaoS mucked
Seat 6: GrinZwe91! (button) folded before Flop (didn't bet)



PokerStars Hand #222961413354:  Hold'em No Limit ($0.05/$0.10 USD) - 2021/01/23 12:32:30 ET
Table 'Bohlinia III' 6-max Seat #1 is the button
Seat 1: xucuo ($11.53 in chips) 
Seat 2: vilemo20 ($11.37 in chips) 
Seat 3: yYanniky ($11.05 in chips) 
Seat 4: JohnSF7 ($11.98 in chips) 
Seat 5: PS ChaoS ($6.19 in chips) 
Seat 6: GrinZwe91! ($10 in chips) 
vilemo20: posts small blind $0.05
yYanniky: posts big blind $0.10
*** HOLE CARDS ***
JohnSF7: folds 
PS ChaoS: folds 
GrinZwe91!: folds 
xucuo: folds 
vilemo20: raises $0.20 to $0.30
yYanniky: folds 
Uncalled bet ($0.20) returned to vilemo20
vilemo20 collected $0.20 from pot
vilemo20: doesn't show hand 
*** SUMMARY ***
Total pot $0.20 | Rake $0 
Seat 1: xucuo (button) folded before Flop (didn't bet)
Seat 2: vilemo20 (small blind) collected ($0.20)
Seat 3: yYanniky (big blind) folded before Flop
Seat 4: JohnSF7 folded before Flop (didn't bet)
Seat 5: PS ChaoS folded before Flop (didn't bet)
Seat 6: GrinZwe91! folded before Flop (didn't bet)



PokerStars Hand #222961421760:  Hold'em No Limit ($0.05/$0.10 USD) - 2021/01/23 12:32:42 ET
Table 'Bohlinia III' 6-max Seat #2 is the button
Seat 1: xucuo ($11.53 in chips) 
Seat 2: vilemo20 ($11.47 in chips) 
Seat 3: yYanniky ($10.95 in chips) 
Seat 4: JohnSF7 ($11.98 in chips) 
Seat 5: PS ChaoS ($6.19 in chips) 
Seat 6: GrinZwe91! ($10 in chips) 
yYanniky: posts small blind $0.05
JohnSF7: posts big blind $0.10
*** HOLE CARDS ***
PS ChaoS: calls $0.10
GrinZwe91!: folds 
xucuo: folds 
vilemo20: folds 
yYanniky: calls $0.05
JohnSF7: checks 
*** FLOP *** [4s 9s 2c]
yYanniky: checks 
JohnSF7: checks 
PS ChaoS: checks 
*** TURN *** [4s 9s 2c] [Kc]
yYanniky: checks 
JohnSF7: checks 
PS ChaoS: checks 
*** RIVER *** [4s 9s 2c Kc] [Qc]
yYanniky: checks 
JohnSF7: checks 
PS ChaoS: bets $0.29
yYanniky: folds 
JohnSF7: folds 
Uncalled bet ($0.29) returned to PS ChaoS
PS ChaoS collected $0.29 from pot
PS ChaoS: doesn't show hand 
*** SUMMARY ***
Total pot $0.30 | Rake $0.01 
Board [4s 9s 2c Kc Qc]
Seat 1: xucuo folded before Flop (didn't bet)
Seat 2: vilemo20 (button) folded before Flop (didn't bet)
Seat 3: yYanniky (small blind) folded on the River
Seat 4: JohnSF7 (big blind) folded on the River
Seat 5: PS ChaoS collected ($0.29)
Seat 6: GrinZwe91! folded before Flop (didn't bet)



PokerStars Hand #222961456484:  Hold'em No Limit ($0.05/$0.10 USD) - 2021/01/23 12:33:34 ET
Table 'Bohlinia III' 6-max Seat #3 is the button
Seat 1: xucuo ($11.53 in chips) 
Seat 2: vilemo20 ($11.47 in chips) 
Seat 3: yYanniky ($10.85 in chips) 
Seat 4: JohnSF7 ($11.88 in chips) 
Seat 5: PS ChaoS ($6.38 in chips) 
Seat 6: GrinZwe91! ($10 in chips) 
JohnSF7: posts small blind $0.05
PS ChaoS: posts big blind $0.10
*** HOLE CARDS ***
GrinZwe91!: folds 
xucuo: folds 
vilemo20: folds 
yYanniky: folds 
JohnSF7: raises $0.20 to $0.30
PS ChaoS: folds 
Uncalled bet ($0.20) returned to JohnSF7
JohnSF7 collected $0.20 from pot
JohnSF7: doesn't show hand 
*** SUMMARY ***
Total pot $0.20 | Rake $0 
Seat 1: xucuo folded before Flop (didn't bet)
Seat 2: vilemo20 folded before Flop (didn't bet)
Seat 3: yYanniky (button) folded before Flop (didn't bet)
Seat 4: JohnSF7 (small blind) collected ($0.20)
Seat 5: PS ChaoS (big blind) folded before Flop
Seat 6: GrinZwe91! folded before Flop (didn't bet)



PokerStars Hand #222961467766:  Hold'em No Limit ($0.05/$0.10 USD) - 2021/01/23 12:33:51 ET
Table 'Bohlinia III' 6-max Seat #4 is the button
Seat 1: xucuo ($11.53 in chips) 
Seat 2: vilemo20 ($11.47 in chips) 
Seat 3: yYanniky ($10.85 in chips) 
Seat 4: JohnSF7 ($11.98 in chips) 
Seat 5: PS ChaoS ($6.28 in chips) 
Seat 6: GrinZwe91! ($10 in chips) 
PS ChaoS: posts small blind $0.05
GrinZwe91!: posts big blind $0.10
*** HOLE CARDS ***
xucuo: calls $0.10
vilemo20: folds 
yYanniky: folds 
JohnSF7: folds 
PS ChaoS: raises $0.10 to $0.20
GrinZwe91!: folds 
xucuo: calls $0.10
*** FLOP *** [2c Tc 8s]
PS ChaoS: checks 
xucuo: checks 
*** TURN *** [2c Tc 8s] [Qh]
PS ChaoS: checks 
xucuo: checks 
*** RIVER *** [2c Tc 8s Qh] [3s]
PS ChaoS: checks 
xucuo: checks 
*** SHOW DOWN ***
PS ChaoS: shows [4s Ad] (high card Ace)
xucuo: mucks hand 
PS ChaoS collected $0.48 from pot
*** SUMMARY ***
Total pot $0.50 | Rake $0.02 
Board [2c Tc 8s Qh 3s]
Seat 1: xucuo mucked
Seat 2: vilemo20 folded before Flop (didn't bet)
Seat 3: yYanniky folded before Flop (didn't bet)
Seat 4: JohnSF7 (button) folded before Flop (didn't bet)
Seat 5: PS ChaoS (small blind) showed [4s Ad] and won ($0.48) with high card Ace
Seat 6: GrinZwe91! (big blind) folded before Flop



PokerStars Hand #222961499839:  Hold'em No Limit ($0.05/$0.10 USD) - 2021/01/23 12:34:39 ET
Table 'Bohlinia III' 6-max Seat #5 is the button
Seat 1: xucuo ($11.33 in chips) 
Seat 2: vilemo20 ($11.47 in chips) 
Seat 3: yYanniky ($10.85 in chips) 
Seat 4: JohnSF7 ($11.98 in chips) 
Seat 5: PS ChaoS ($6.56 in chips) 
Seat 6: GrinZwe91! ($10 in chips) 
GrinZwe91!: posts small blind $0.05
xucuo: posts big blind $0.10
*** HOLE CARDS ***
vilemo20: folds 
yYanniky: folds 
JohnSF7: folds 
PS ChaoS: folds 
GrinZwe91!: raises $0.20 to $0.30
xucuo: calls $0.20
*** FLOP *** [2d 7s Qs]
GrinZwe91!: checks 
xucuo: bets $0.30
GrinZwe91!: calls $0.30
*** TURN *** [2d 7s Qs] [8s]
GrinZwe91!: checks 
xucuo: checks 
*** RIVER *** [2d 7s Qs 8s] [5d]
GrinZwe91!: checks 
xucuo: checks 
*** SHOW DOWN ***
GrinZwe91!: shows [As Jh] (high card Ace)
xucuo: mucks hand 
GrinZwe91! collected $1.15 from pot
*** SUMMARY ***
Total pot $1.20 | Rake $0.05 
Board [2d 7s Qs 8s 5d]
Seat 1: xucuo (big blind) mucked
Seat 2: vilemo20 folded before Flop (didn't bet)
Seat 3: yYanniky folded before Flop (didn't bet)
Seat 4: JohnSF7 folded before Flop (didn't bet)
Seat 5: PS ChaoS (button) folded before Flop (didn't bet)
Seat 6: GrinZwe91! (small blind) showed [As Jh] and won ($1.15) with high card Ace



PokerStars Hand #222961527723:  Hold'em No Limit ($0.05/$0.10 USD) - 2021/01/23 12:35:20 ET
Table 'Bohlinia III' 6-max Seat #6 is the button
Seat 1: xucuo ($10.73 in chips) 
Seat 2: vilemo20 ($11.47 in chips) 
Seat 3: yYanniky ($10.85 in chips) 
Seat 4: JohnSF7 ($11.98 in chips) 
Seat 5: PS ChaoS ($6.56 in chips) 
Seat 6: GrinZwe91! ($10.55 in chips) 
xucuo: posts small blind $0.05
vilemo20: posts big blind $0.10
*** HOLE CARDS ***
yYanniky: folds 
JohnSF7: folds 
PS ChaoS: folds 
GrinZwe91!: folds 
xucuo: folds 
Uncalled bet ($0.05) returned to vilemo20
vilemo20 collected $0.10 from pot
vilemo20: doesn't show hand 
*** SUMMARY ***
Total pot $0.10 | Rake $0 
Seat 1: xucuo (small blind) folded before Flop
Seat 2: vilemo20 (big blind) collected ($0.10)
Seat 3: yYanniky folded before Flop (didn't bet)
Seat 4: JohnSF7 folded before Flop (didn't bet)
Seat 5: PS ChaoS folded before Flop (didn't bet)
Seat 6: GrinZwe91! (button) folded before Flop (didn't bet)



PokerStars Hand #222961534092:  Hold'em No Limit ($0.05/$0.10 USD) - 2021/01/23 12:35:30 ET
Table 'Bohlinia III' 6-max Seat #1 is the button
Seat 1: xucuo ($10.68 in chips) 
Seat 2: vilemo20 ($11.52 in chips) 
Seat 4: JohnSF7 ($11.98 in chips) 
Seat 5: PS ChaoS ($6.56 in chips) 
Seat 6: GrinZwe91! ($10.55 in chips) 
vilemo20: posts small blind $0.05
yYanniky: is sitting out 
JohnSF7: posts big blind $0.10
*** HOLE CARDS ***
PS ChaoS: folds 
GrinZwe91!: folds 
xucuo: calls $0.10
vilemo20: calls $0.05
JohnSF7: checks 
*** FLOP *** [6c Kd Ac]
vilemo20: checks 
JohnSF7: checks 
xucuo: bets $0.20
vilemo20: folds 
JohnSF7: folds 
Uncalled bet ($0.20) returned to xucuo
xucuo collected $0.29 from pot
xucuo: doesn't show hand 
*** SUMMARY ***
Total pot $0.30 | Rake $0.01 
Board [6c Kd Ac]
Seat 1: xucuo (button) collected ($0.29)
Seat 2: vilemo20 (small blind) folded on the Flop
Seat 4: JohnSF7 (big blind) folded on the Flop
Seat 5: PS ChaoS folded before Flop (didn't bet)
Seat 6: GrinZwe91! folded before Flop (didn't bet)



PokerStars Hand #222961554069:  Hold'em No Limit ($0.05/$0.10 USD) - 2021/01/23 12:36:00 ET
Table 'Bohlinia III' 6-max Seat #2 is the button
Seat 1: xucuo ($10.87 in chips) 
Seat 2: vilemo20 ($11.42 in chips) 
Seat 4: JohnSF7 ($11.88 in chips) 
Seat 5: PS ChaoS ($6.56 in chips) 
Seat 6: GrinZwe91! ($10.55 in chips) 
JohnSF7: posts small blind $0.05
PS ChaoS: posts big blind $0.10
*** HOLE CARDS ***
GrinZwe91!: folds 
xucuo: folds 
vilemo20: folds 
JohnSF7: raises $0.20 to $0.30
PS ChaoS: calls $0.20
*** FLOP *** [3c Qd 6s]
JohnSF7: checks 
PS ChaoS: checks 
*** TURN *** [3c Qd 6s] [Jd]
JohnSF7: checks 
PS ChaoS: bets $0.29
JohnSF7: folds 
Uncalled bet ($0.29) returned to PS ChaoS
PS ChaoS collected $0.57 from pot
PS ChaoS: doesn't show hand 
*** SUMMARY ***
Total pot $0.60 | Rake $0.03 
Board [3c Qd 6s Jd]
Seat 1: xucuo folded before Flop (didn't bet)
Seat 2: vilemo20 (button) folded before Flop (didn't bet)
Seat 4: JohnSF7 (small blind) folded on the Turn
Seat 5: PS ChaoS (big blind) collected ($0.57)
Seat 6: GrinZwe91! folded before Flop (didn't bet)



PokerStars Hand #222961578019:  Hold'em No Limit ($0.05/$0.10 USD) - 2021/01/23 12:36:35 ET
Table 'Bohlinia III' 6-max Seat #4 is the button
Seat 1: xucuo ($10.87 in chips) 
Seat 2: vilemo20 ($11.42 in chips) 
Seat 4: JohnSF7 ($11.58 in chips) 
Seat 5: PS ChaoS ($6.83 in chips) 
Seat 6: GrinZwe91! ($10.55 in chips) 
PS ChaoS: posts small blind $0.05
GrinZwe91!: posts big blind $0.10
*** HOLE CARDS ***
xucuo: raises $0.20 to $0.30
vilemo20: folds 
JohnSF7: folds 
PS ChaoS: calls $0.25
GrinZwe91!: folds 
*** FLOP *** [6d Qc 2d]
PS ChaoS: checks 
xucuo: bets $0.34
PS ChaoS: folds 
Uncalled bet ($0.34) returned to xucuo
xucuo collected $0.67 from pot
xucuo: doesn't show hand 
*** SUMMARY ***
Total pot $0.70 | Rake $0.03 
Board [6d Qc 2d]
Seat 1: xucuo collected ($0.67)
Seat 2: vilemo20 folded before Flop (didn't bet)
Seat 4: JohnSF7 (button) folded before Flop (didn't bet)
Seat 5: PS ChaoS (small blind) folded on the Flop
Seat 6: GrinZwe91! (big blind) folded before Flop



PokerStars Hand #222961592929:  Hold'em No Limit ($0.05/$0.10 USD) - 2021/01/23 12:36:58 ET
Table 'Bohlinia III' 6-max Seat #5 is the button
Seat 1: xucuo ($11.24 in chips) 
Seat 2: vilemo20 ($11.42 in chips) 
Seat 4: JohnSF7 ($11.58 in chips) 
Seat 5: PS ChaoS ($6.53 in chips) 
Seat 6: GrinZwe91! ($10.45 in chips) 
GrinZwe91!: posts small blind $0.05
xucuo: posts big blind $0.10
*** HOLE CARDS ***
vilemo20: folds 
JohnSF7: folds 
PS ChaoS: folds 
GrinZwe91!: folds 
Uncalled bet ($0.05) returned to xucuo
xucuo collected $0.10 from pot
xucuo: doesn't show hand 
*** SUMMARY ***
Total pot $0.10 | Rake $0 
Seat 1: xucuo (big blind) collected ($0.10)
Seat 2: vilemo20 folded before Flop (didn't bet)
Seat 4: JohnSF7 folded before Flop (didn't bet)
Seat 5: PS ChaoS (button) folded before Flop (didn't bet)
Seat 6: GrinZwe91! (small blind) folded before Flop



PokerStars Hand #222961601831:  Hold'em No Limit ($0.05/$0.10 USD) - 2021/01/23 12:37:11 ET
Table 'Bohlinia III' 6-max Seat #6 is the button
Seat 1: xucuo ($11.29 in chips) 
Seat 2: vilemo20 ($11.42 in chips) 
Seat 4: JohnSF7 ($11.58 in chips) 
Seat 5: PS ChaoS ($6.53 in chips) 
Seat 6: GrinZwe91! ($10.40 in chips) 
xucuo: posts small blind $0.05
vilemo20: posts big blind $0.10
*** HOLE CARDS ***
yYanniky leaves the table
JohnSF7: folds 
PS ChaoS: folds 
GrinZwe91!: folds 
xucuo: folds 
Uncalled bet ($0.05) returned to vilemo20
vilemo20 collected $0.10 from pot
vilemo20: doesn't show hand 
*** SUMMARY ***
Total pot $0.10 | Rake $0 
Seat 1: xucuo (small blind) folded before Flop
Seat 2: vilemo20 (big blind) collected ($0.10)
Seat 4: JohnSF7 folded before Flop (didn't bet)
Seat 5: PS ChaoS folded before Flop (didn't bet)
Seat 6: GrinZwe91! (button) folded before Flop (didn't bet)



PokerStars Hand #222961611820:  Hold'em No Limit ($0.05/$0.10 USD) - 2021/01/23 12:37:26 ET
Table 'Bohlinia III' 6-max Seat #1 is the button
Seat 1: xucuo ($11.24 in chips) 
Seat 2: vilemo20 ($11.47 in chips) 
Seat 4: JohnSF7 ($11.58 in chips) 
Seat 5: PS ChaoS ($6.53 in chips) 
Seat 6: GrinZwe91! ($10.40 in chips) 
vilemo20: posts small blind $0.05
JohnSF7: posts big blind $0.10
*** HOLE CARDS ***
PS ChaoS has timed out
PS ChaoS: folds 
GrinZwe91!: folds 
xucuo: folds 
vilemo20: folds 
Uncalled bet ($0.05) returned to JohnSF7
JohnSF7 collected $0.10 from pot
JohnSF7: doesn't show hand 
*** SUMMARY ***
Total pot $0.10 | Rake $0 
Seat 1: xucuo (button) folded before Flop (didn't bet)
Seat 2: vilemo20 (small blind) folded before Flop
Seat 4: JohnSF7 (big blind) collected ($0.10)
Seat 5: PS ChaoS folded before Flop (didn't bet)
Seat 6: GrinZwe91! folded before Flop (didn't bet)



PokerStars Hand #222961622796:  Hold'em No Limit ($0.05/$0.10 USD) - 2021/01/23 12:37:42 ET
Table 'Bohlinia III' 6-max Seat #2 is the button
Seat 1: xucuo ($11.24 in chips) 
Seat 2: vilemo20 ($11.42 in chips) 
Seat 4: JohnSF7 ($11.63 in chips) 
Seat 5: PS ChaoS ($6.53 in chips) 
Seat 6: GrinZwe91! ($10.40 in chips) 
JohnSF7: posts small blind $0.05
PS ChaoS: posts big blind $0.10
*** HOLE CARDS ***
GrinZwe91!: folds 
xucuo: folds 
vilemo20: folds 
JohnSF7: raises $0.20 to $0.30
PS ChaoS: calls $0.20
*** FLOP *** [5h 2h 3d]
JohnSF7: bets $0.31
PS ChaoS: calls $0.31
*** TURN *** [5h 2h 3d] [Ah]
JohnSF7: bets $0.90
PS ChaoS: folds 
Uncalled bet ($0.90) returned to JohnSF7
JohnSF7 collected $1.17 from pot
JohnSF7: doesn't show hand 
*** SUMMARY ***
Total pot $1.22 | Rake $0.05 
Board [5h 2h 3d Ah]
Seat 1: xucuo folded before Flop (didn't bet)
Seat 2: vilemo20 (button) folded before Flop (didn't bet)
Seat 4: JohnSF7 (small blind) collected ($1.17)
Seat 5: PS ChaoS (big blind) folded on the Turn
Seat 6: GrinZwe91! folded before Flop (didn't bet)



PokerStars Hand #222961644999:  Hold'em No Limit ($0.05/$0.10 USD) - 2021/01/23 12:38:16 ET
Table 'Bohlinia III' 6-max Seat #4 is the button
Seat 1: xucuo ($11.24 in chips) 
Seat 2: vilemo20 ($11.42 in chips) 
Seat 4: JohnSF7 ($12.19 in chips) 
Seat 5: PS ChaoS ($5.92 in chips) 
Seat 6: GrinZwe91! ($10.40 in chips) 
PS ChaoS: posts small blind $0.05
GrinZwe91!: posts big blind $0.10
*** HOLE CARDS ***
xucuo: folds 
vilemo20: folds 
ElPlazibato joins the table at seat #3 
JohnSF7: raises $0.15 to $0.25
PS ChaoS: folds 
GrinZwe91!: calls $0.15
*** FLOP *** [Qs 9h 4s]
GrinZwe91!: checks 
JohnSF7: bets $0.17
GrinZwe91!: calls $0.17
*** TURN *** [Qs 9h 4s] [4d]
GrinZwe91!: checks 
JohnSF7: bets $0.28
GrinZwe91!: folds 
Uncalled bet ($0.28) returned to JohnSF7
JohnSF7 collected $0.85 from pot
JohnSF7: doesn't show hand 
*** SUMMARY ***
Total pot $0.89 | Rake $0.04 
Board [Qs 9h 4s 4d]
Seat 1: xucuo folded before Flop (didn't bet)
Seat 2: vilemo20 folded before Flop (didn't bet)
Seat 4: JohnSF7 (button) collected ($0.85)
Seat 5: PS ChaoS (small blind) folded before Flop
Seat 6: GrinZwe91! (big blind) folded on the Turn



PokerStars Hand #222961672523:  Hold'em No Limit ($0.05/$0.10 USD) - 2021/01/23 12:38:57 ET
Table 'Bohlinia III' 6-max Seat #5 is the button
Seat 1: xucuo ($11.24 in chips) 
Seat 2: vilemo20 ($11.42 in chips) 
Seat 4: JohnSF7 ($12.62 in chips) 
Seat 5: PS ChaoS ($5.87 in chips) 
Seat 6: GrinZwe91! ($10 in chips) 
GrinZwe91!: posts small blind $0.05
xucuo: posts big blind $0.10
ElPlazibato: sits out 
*** HOLE CARDS ***
vilemo20: folds 
JohnSF7: folds 
PS ChaoS: raises $0.10 to $0.20
GrinZwe91!: calls $0.15
xucuo: folds 
*** FLOP *** [7c 2c 6c]
GrinZwe91!: checks 
vilemo20 leaves the table
PS ChaoS: bets $0.24
GrinZwe91!: calls $0.24
*** TURN *** [7c 2c 6c] [8s]
GrinZwe91!: checks 
JRGrist7 joins the table at seat #2 
PS ChaoS: checks 
*** RIVER *** [7c 2c 6c 8s] [Ts]
GrinZwe91!: checks 
PS ChaoS: checks 
*** SHOW DOWN ***
GrinZwe91!: shows [8h 8c] (three of a kind, Eights)
PS ChaoS: mucks hand 
GrinZwe91! collected $0.94 from pot
*** SUMMARY ***
Total pot $0.98 | Rake $0.04 
Board [7c 2c 6c 8s Ts]
Seat 1: xucuo (big blind) folded before Flop
Seat 2: vilemo20 folded before Flop (didn't bet)
Seat 4: JohnSF7 folded before Flop (didn't bet)
Seat 5: PS ChaoS (button) mucked
Seat 6: GrinZwe91! (small blind) showed [8h 8c] and won ($0.94) with three of a kind, Eights



PokerStars Hand #222961697065:  Hold'em No Limit ($0.05/$0.10 USD) - 2021/01/23 12:39:33 ET
Table 'Bohlinia III' 6-max Seat #6 is the button
Seat 1: xucuo ($11.14 in chips) 
Seat 2: JRGrist7 ($8 in chips) 
Seat 3: ElPlazibato ($4 in chips) 
Seat 4: JohnSF7 ($12.62 in chips) 
Seat 5: PS ChaoS ($5.43 in chips) 
Seat 6: GrinZwe91! ($10.50 in chips) 
xucuo: posts small blind $0.05
JRGrist7: posts big blind $0.10
ElPlazibato: posts big blind $0.10
*** HOLE CARDS ***
ElPlazibato: checks 
JohnSF7: folds 
PS ChaoS: raises $0.10 to $0.20
GrinZwe91!: folds 
xucuo: folds 
JRGrist7: folds 
ElPlazibato: folds 
Uncalled bet ($0.10) returned to PS ChaoS
PS ChaoS collected $0.35 from pot
PS ChaoS: doesn't show hand 
*** SUMMARY ***
Total pot $0.35 | Rake $0 
Seat 1: xucuo (small blind) folded before Flop
Seat 2: JRGrist7 (big blind) folded before Flop
Seat 3: ElPlazibato folded before Flop (didn't bet)
Seat 4: JohnSF7 folded before Flop (didn't bet)
Seat 5: PS ChaoS collected ($0.35)
Seat 6: GrinZwe91! (button) folded before Flop (didn't bet)



PokerStars Hand #222961707921:  Hold'em No Limit ($0.05/$0.10 USD) - 2021/01/23 12:39:49 ET
Table 'Bohlinia III' 6-max Seat #1 is the button
Seat 1: xucuo ($11.09 in chips) 
Seat 2: JRGrist7 ($7.90 in chips) 
Seat 3: ElPlazibato ($3.90 in chips) 
Seat 4: JohnSF7 ($12.62 in chips) 
Seat 5: PS ChaoS ($5.68 in chips) 
Seat 6: GrinZwe91! ($10.50 in chips) 
JRGrist7: posts small blind $0.05
ElPlazibato: posts big blind $0.10
*** HOLE CARDS ***
JohnSF7: folds 
PS ChaoS: folds 
GrinZwe91!: folds 
xucuo: folds 
JRGrist7: calls $0.05
ElPlazibato: checks 
*** FLOP *** [Js Jh Tc]
JRGrist7: bets $1.20
ElPlazibato: folds 
Uncalled bet ($1.20) returned to JRGrist7
JRGrist7 collected $0.19 from pot
JRGrist7: doesn't show hand 
*** SUMMARY ***
Total pot $0.20 | Rake $0.01 
Board [Js Jh Tc]
Seat 1: xucuo (button) folded before Flop (didn't bet)
Seat 2: JRGrist7 (small blind) collected ($0.19)
Seat 3: ElPlazibato (big blind) folded on the Flop
Seat 4: JohnSF7 folded before Flop (didn't bet)
Seat 5: PS ChaoS folded before Flop (didn't bet)
Seat 6: GrinZwe91! folded before Flop (didn't bet)



PokerStars Hand #222961720485:  Hold'em No Limit ($0.05/$0.10 USD) - 2021/01/23 12:40:08 ET
Table 'Bohlinia III' 6-max Seat #2 is the button
Seat 1: xucuo ($11.09 in chips) 
Seat 2: JRGrist7 ($7.99 in chips) 
Seat 3: ElPlazibato ($3.80 in chips) 
Seat 4: JohnSF7 ($12.62 in chips) 
Seat 5: PS ChaoS ($5.68 in chips) 
Seat 6: GrinZwe91! ($10.50 in chips) 
ElPlazibato: posts small blind $0.05
JohnSF7: posts big blind $0.10
*** HOLE CARDS ***
PS ChaoS: calls $0.10
GrinZwe91!: folds 
xucuo: folds 
JRGrist7: calls $0.10
ElPlazibato: calls $0.05
JohnSF7: checks 
*** FLOP *** [Kh 8h 2d]
ElPlazibato: checks 
JohnSF7: checks 
PS ChaoS: bets $0.10
JRGrist7: calls $0.10
ElPlazibato: folds 
JohnSF7: folds 
*** TURN *** [Kh 8h 2d] [7d]
PS ChaoS: bets $0.10
JRGrist7: calls $0.10
*** RIVER *** [Kh 8h 2d 7d] [2c]
PS ChaoS: bets $0.10
JRGrist7: calls $0.10
*** SHOW DOWN ***
PS ChaoS: shows [Qd 8d] (two pair, Eights and Deuces)
JRGrist7: shows [Kd 6s] (two pair, Kings and Deuces)
JRGrist7 collected $0.96 from pot
*** SUMMARY ***
Total pot $1 | Rake $0.04 
Board [Kh 8h 2d 7d 2c]
Seat 1: xucuo folded before Flop (didn't bet)
Seat 2: JRGrist7 (button) showed [Kd 6s] and won ($0.96) with two pair, Kings and Deuces
Seat 3: ElPlazibato (small blind) folded on the Flop
Seat 4: JohnSF7 (big blind) folded on the Flop
Seat 5: PS ChaoS showed [Qd 8d] and lost with two pair, Eights and Deuces
Seat 6: GrinZwe91! folded before Flop (didn't bet)



PokerStars Hand #222961755381:  Hold'em No Limit ($0.05/$0.10 USD) - 2021/01/23 12:40:59 ET
Table 'Bohlinia III' 6-max Seat #3 is the button
Seat 1: xucuo ($11.09 in chips) 
Seat 2: JRGrist7 ($8.55 in chips) 
Seat 3: ElPlazibato ($3.70 in chips) 
Seat 4: JohnSF7 ($12.52 in chips) 
Seat 5: PS ChaoS ($5.28 in chips) 
Seat 6: GrinZwe91! ($10.50 in chips) 
JohnSF7: posts small blind $0.05
PS ChaoS: posts big blind $0.10
*** HOLE CARDS ***
GrinZwe91!: folds 
xucuo: folds 
JRGrist7: folds 
ElPlazibato: raises $0.20 to $0.30
JohnSF7: calls $0.25
PS ChaoS: calls $0.20
*** FLOP *** [Ac 8d 6c]
JohnSF7: checks 
PS ChaoS: checks 
ElPlazibato: bets $0.43
JohnSF7: folds 
PS ChaoS: calls $0.43
*** TURN *** [Ac 8d 6c] [6s]
PS ChaoS: checks 
ElPlazibato: bets $0.84
PS ChaoS: calls $0.84
*** RIVER *** [Ac 8d 6c 6s] [7c]
PS ChaoS: bets $1.65
ElPlazibato: raises $0.48 to $2.13 and is all-in
PS ChaoS: calls $0.48
*** SHOW DOWN ***
ElPlazibato: shows [Tc 4c] (a flush, Ace high)
PS ChaoS: shows [8s Ah] (two pair, Aces and Eights)
ElPlazibato collected $7.35 from pot
*** SUMMARY ***
Total pot $7.70 | Rake $0.35 
Board [Ac 8d 6c 6s 7c]
Seat 1: xucuo folded before Flop (didn't bet)
Seat 2: JRGrist7 folded before Flop (didn't bet)
Seat 3: ElPlazibato (button) showed [Tc 4c] and won ($7.35) with a flush, Ace high
Seat 4: JohnSF7 (small blind) folded on the Flop
Seat 5: PS ChaoS (big blind) showed [8s Ah] and lost with two pair, Aces and Eights
Seat 6: GrinZwe91! folded before Flop (didn't bet)



PokerStars Hand #222961789584:  Hold'em No Limit ($0.05/$0.10 USD) - 2021/01/23 12:41:50 ET
Table 'Bohlinia III' 6-max Seat #5 is the button
Seat 1: xucuo ($11.09 in chips) 
Seat 2: JRGrist7 ($8.55 in chips) 
Seat 3: ElPlazibato ($7.35 in chips) 
Seat 5: PS ChaoS ($1.58 in chips) 
Seat 6: GrinZwe91! ($10.50 in chips) 
GrinZwe91!: posts small blind $0.05
xucuo: posts big blind $0.10
*** HOLE CARDS ***
JRGrist7: calls $0.10
ElPlazibato: folds 
PS ChaoS: folds 
PS ChaoS leaves the table
GrinZwe91!: folds 
xucuo: checks 
*** FLOP *** [Ts Ad Qh]
Astro439 joins the table at seat #5 
xucuo: checks 
JRGrist7: bets $0.50
xucuo: folds 
Uncalled bet ($0.50) returned to JRGrist7
JRGrist7 collected $0.24 from pot
JRGrist7: doesn't show hand 
*** SUMMARY ***
Total pot $0.25 | Rake $0.01 
Board [Ts Ad Qh]
Seat 1: xucuo (big blind) folded on the Flop
Seat 2: JRGrist7 collected ($0.24)
Seat 3: ElPlazibato folded before Flop (didn't bet)
Seat 5: PS ChaoS (button) folded before Flop (didn't bet)
Seat 6: GrinZwe91! (small blind) folded before Flop



PokerStars Hand #222961802530:  Hold'em No Limit ($0.05/$0.10 USD) - 2021/01/23 12:42:09 ET
Table 'Bohlinia III' 6-max Seat #6 is the button
Seat 1: xucuo ($10.99 in chips) 
Seat 2: JRGrist7 ($8.69 in chips) 
Seat 3: ElPlazibato ($7.35 in chips) 
Seat 6: GrinZwe91! ($10.45 in chips) 
xucuo: posts small blind $0.05
JRGrist7: posts big blind $0.10
Astro439: sits out 
*** HOLE CARDS ***
ElPlazibato: calls $0.10
GrinZwe91!: folds 
xucuo: folds 
JRGrist7: checks 
*** FLOP *** [6s Ad Kc]
JRGrist7: checks 
ElPlazibato: bets $0.12
JRGrist7: folds 
Uncalled bet ($0.12) returned to ElPlazibato
ElPlazibato collected $0.24 from pot
ElPlazibato: doesn't show hand 
*** SUMMARY ***
Total pot $0.25 | Rake $0.01 
Board [6s Ad Kc]
Seat 1: xucuo (small blind) folded before Flop
Seat 2: JRGrist7 (big blind) folded on the Flop
Seat 3: ElPlazibato collected ($0.24)
Seat 6: GrinZwe91! (button) folded before Flop (didn't bet)



PokerStars Hand #222961816322:  Hold'em No Limit ($0.05/$0.10 USD) - 2021/01/23 12:42:30 ET
Table 'Bohlinia III' 6-max Seat #1 is the button
Seat 1: xucuo ($10.94 in chips) 
Seat 2: JRGrist7 ($8.59 in chips) 
Seat 3: ElPlazibato ($7.49 in chips) 
Seat 6: GrinZwe91! ($10.45 in chips) 
JRGrist7: posts small blind $0.05
ElPlazibato: posts big blind $0.10
Astro439: sits out 
*** HOLE CARDS ***
GrinZwe91!: folds 
xucuo: calls $0.10
JRGrist7: calls $0.05
ElPlazibato: checks 
*** FLOP *** [8h 2d Ad]
JRGrist7: checks 
ElPlazibato: checks 
xucuo: checks 
*** TURN *** [8h 2d Ad] [6s]
JRGrist7: bets $0.20
ElPlazibato: folds 
xucuo: folds 
Uncalled bet ($0.20) returned to JRGrist7
JRGrist7 collected $0.29 from pot
JRGrist7: doesn't show hand 
*** SUMMARY ***
Total pot $0.30 | Rake $0.01 
Board [8h 2d Ad 6s]
Seat 1: xucuo (button) folded on the Turn
Seat 2: JRGrist7 (small blind) collected ($0.29)
Seat 3: ElPlazibato (big blind) folded on the Turn
Seat 6: GrinZwe91! folded before Flop (didn't bet)



PokerStars Hand #222961832460:  Hold'em No Limit ($0.05/$0.10 USD) - 2021/01/23 12:42:54 ET
Table 'Bohlinia III' 6-max Seat #2 is the button
Seat 1: xucuo ($10.84 in chips) 
Seat 2: JRGrist7 ($8.78 in chips) 
Seat 3: ElPlazibato ($7.39 in chips) 
Seat 5: Astro439 ($10 in chips) 
Seat 6: GrinZwe91! ($10.45 in chips) 
ElPlazibato: posts small blind $0.05
Astro439: posts big blind $0.10
*** HOLE CARDS ***
GrinZwe91!: folds 
xucuo: folds 
JRGrist7: calls $0.10
ElPlazibato: calls $0.05
Astro439: raises $0.40 to $0.50
JRGrist7: folds 
ElPlazibato: folds 
Uncalled bet ($0.40) returned to Astro439
Astro439 collected $0.30 from pot
*** SUMMARY ***
Total pot $0.30 | Rake $0 
Seat 1: xucuo folded before Flop (didn't bet)
Seat 2: JRGrist7 (button) folded before Flop
Seat 3: ElPlazibato (small blind) folded before Flop
Seat 5: Astro439 (big blind) collected ($0.30)
Seat 6: GrinZwe91! folded before Flop (didn't bet)



PokerStars Hand #222961841346:  Hold'em No Limit ($0.05/$0.10 USD) - 2021/01/23 12:43:07 ET
Table 'Bohlinia III' 6-max Seat #3 is the button
Seat 1: xucuo ($10.84 in chips) 
Seat 2: JRGrist7 ($8.68 in chips) 
Seat 3: ElPlazibato ($7.29 in chips) 
Seat 5: Astro439 ($10.20 in chips) 
Seat 6: GrinZwe91! ($10.45 in chips) 
Astro439: posts small blind $0.05
GrinZwe91!: posts big blind $0.10
*** HOLE CARDS ***
xucuo: folds 
JRGrist7: folds 
ElPlazibato: raises $0.20 to $0.30
Astro439: calls $0.25
GrinZwe91!: calls $0.20
*** FLOP *** [Jd 7d 5d]
Astro439: checks 
GrinZwe91!: checks 
ElPlazibato: bets $0.43
Astro439: folds 
GrinZwe91!: folds 
Uncalled bet ($0.43) returned to ElPlazibato
ElPlazibato collected $0.86 from pot
ElPlazibato: doesn't show hand 
*** SUMMARY ***
Total pot $0.90 | Rake $0.04 
Board [Jd 7d 5d]
Seat 1: xucuo folded before Flop (didn't bet)
Seat 2: JRGrist7 folded before Flop (didn't bet)
Seat 3: ElPlazibato (button) collected ($0.86)
Seat 5: Astro439 (small blind) folded on the Flop
Seat 6: GrinZwe91! (big blind) folded on the Flop



PokerStars Hand #222961862964:  Hold'em No Limit ($0.05/$0.10 USD) - 2021/01/23 12:43:39 ET
Table 'Bohlinia III' 6-max Seat #5 is the button
Seat 1: xucuo ($10.84 in chips) 
Seat 2: JRGrist7 ($8.68 in chips) 
Seat 3: ElPlazibato ($7.85 in chips) 
Seat 5: Astro439 ($10 in chips) 
Seat 6: GrinZwe91! ($10.15 in chips) 
GrinZwe91!: posts small blind $0.05
xucuo: posts big blind $0.10
*** HOLE CARDS ***
JRGrist7: folds 
ElPlazibato: folds 
Astro439: raises $0.20 to $0.30
GrinZwe91!: folds 
xucuo: calls $0.20
*** FLOP *** [5h 3d Jh]
xucuo: checks 
Astro439: bets $0.41
xucuo: folds 
Uncalled bet ($0.41) returned to Astro439
Astro439 collected $0.62 from pot
*** SUMMARY ***
Total pot $0.65 | Rake $0.03 
Board [5h 3d Jh]
Seat 1: xucuo (big blind) folded on the Flop
Seat 2: JRGrist7 folded before Flop (didn't bet)
Seat 3: ElPlazibato folded before Flop (didn't bet)
Seat 5: Astro439 (button) collected ($0.62)
Seat 6: GrinZwe91! (small blind) folded before Flop



PokerStars Hand #222961879661:  Hold'em No Limit ($0.05/$0.10 USD) - 2021/01/23 12:44:04 ET
Table 'Bohlinia III' 6-max Seat #6 is the button
Seat 1: xucuo ($10.54 in chips) 
Seat 2: JRGrist7 ($8.68 in chips) 
Seat 3: ElPlazibato ($7.85 in chips) 
Seat 5: Astro439 ($10.32 in chips) 
Seat 6: GrinZwe91! ($10.10 in chips) 
xucuo: posts small blind $0.05
JRGrist7: posts big blind $0.10
*** HOLE CARDS ***
ElPlazibato: folds 
Astro439: raises $0.20 to $0.30
GrinZwe91!: folds 
xucuo: folds 
JRGrist7: calls $0.20
*** FLOP *** [As 6h Qh]
JRGrist7: checks 
Astro439: bets $0.41
JRGrist7: folds 
Uncalled bet ($0.41) returned to Astro439
Astro439 collected $0.62 from pot
*** SUMMARY ***
Total pot $0.65 | Rake $0.03 
Board [As 6h Qh]
Seat 1: xucuo (small blind) folded before Flop
Seat 2: JRGrist7 (big blind) folded on the Flop
Seat 3: ElPlazibato folded before Flop (didn't bet)
Seat 5: Astro439 collected ($0.62)
Seat 6: GrinZwe91! (button) folded before Flop (didn't bet)



PokerStars Hand #222961891559:  Hold'em No Limit ($0.05/$0.10 USD) - 2021/01/23 12:44:22 ET
Table 'Bohlinia III' 6-max Seat #1 is the button
Seat 1: xucuo ($10.49 in chips) 
Seat 2: JRGrist7 ($8.38 in chips) 
Seat 3: ElPlazibato ($7.85 in chips) 
Seat 5: Astro439 ($10.64 in chips) 
Seat 6: GrinZwe91! ($10.10 in chips) 
JRGrist7: posts small blind $0.05
ElPlazibato: posts big blind $0.10
*** HOLE CARDS ***
Astro439: folds 
GrinZwe91!: folds 
xucuo: folds 
JRGrist7: calls $0.05
ElPlazibato: checks 
*** FLOP *** [Js Td 9s]
JRGrist7: bets $0.20
ElPlazibato: calls $0.20
*** TURN *** [Js Td 9s] [2d]
JRGrist7: bets $0.20
ElPlazibato: calls $0.20
*** RIVER *** [Js Td 9s 2d] [Jh]
JRGrist7: bets $0.30
ElPlazibato: raises $0.30 to $0.60
JRGrist7: calls $0.30
*** SHOW DOWN ***
ElPlazibato: shows [Kh Jd] (three of a kind, Jacks)
JRGrist7: mucks hand 
ElPlazibato collected $2.10 from pot
*** SUMMARY ***
Total pot $2.20 | Rake $0.10 
Board [Js Td 9s 2d Jh]
Seat 1: xucuo (button) folded before Flop (didn't bet)
Seat 2: JRGrist7 (small blind) mucked
Seat 3: ElPlazibato (big blind) showed [Kh Jd] and won ($2.10) with three of a kind, Jacks
Seat 5: Astro439 folded before Flop (didn't bet)
Seat 6: GrinZwe91! folded before Flop (didn't bet)



PokerStars Hand #222961908560:  Hold'em No Limit ($0.05/$0.10 USD) - 2021/01/23 12:44:47 ET
Table 'Bohlinia III' 6-max Seat #2 is the button
Seat 1: xucuo ($10.49 in chips) 
Seat 2: JRGrist7 ($7.28 in chips) 
Seat 3: ElPlazibato ($8.85 in chips) 
Seat 5: Astro439 ($10.64 in chips) 
Seat 6: GrinZwe91! ($10.10 in chips) 
ElPlazibato: posts small blind $0.05
Astro439: posts big blind $0.10
*** HOLE CARDS ***
GrinZwe91!: folds 
xucuo: calls $0.10
JRGrist7: calls $0.10
ElPlazibato: folds 
Astro439: checks 
*** FLOP *** [Ad 7h 3s]
Astro439: checks 
xucuo: checks 
JRGrist7: checks 
*** TURN *** [Ad 7h 3s] [6c]
Astro439: bets $0.26
xucuo: calls $0.26
JRGrist7: folds 
*** RIVER *** [Ad 7h 3s 6c] [Qs]
Astro439: bets $0.41
xucuo: calls $0.41
*** SHOW DOWN ***
Astro439: shows [5h 7s] (a pair of Sevens)
xucuo: shows [4h 7c] (a pair of Sevens)
Astro439 collected $0.81 from pot
xucuo collected $0.80 from pot
*** SUMMARY ***
Total pot $1.69 | Rake $0.08 
Board [Ad 7h 3s 6c Qs]
Seat 1: xucuo showed [4h 7c] and won ($0.80) with a pair of Sevens
Seat 2: JRGrist7 (button) folded on the Turn
Seat 3: ElPlazibato (small blind) folded before Flop
Seat 5: Astro439 (big blind) showed [5h 7s] and won ($0.81) with a pair of Sevens
Seat 6: GrinZwe91! folded before Flop (didn't bet)



PokerStars Hand #222961939593:  Hold'em No Limit ($0.05/$0.10 USD) - 2021/01/23 12:45:33 ET
Table 'Bohlinia III' 6-max Seat #3 is the button
Seat 1: xucuo ($10.52 in chips) 
Seat 2: JRGrist7 ($7.18 in chips) 
Seat 3: ElPlazibato ($8.80 in chips) 
Seat 5: Astro439 ($10.68 in chips) 
Seat 6: GrinZwe91! ($10.10 in chips) 
Astro439: posts small blind $0.05
GrinZwe91!: posts big blind $0.10
*** HOLE CARDS ***
xucuo: calls $0.10
JRGrist7: calls $0.10
ElPlazibato: folds 
Astro439: calls $0.05
GrinZwe91!: checks 
*** FLOP *** [4c 4s Qd]
Astro439: checks 
GrinZwe91!: checks 
xucuo: checks 
JRGrist7: checks 
*** TURN *** [4c 4s Qd] [Kd]
Astro439: checks 
GrinZwe91!: checks 
xucuo: checks 
JRGrist7: checks 
*** RIVER *** [4c 4s Qd Kd] [Ks]
Astro439: checks 
GrinZwe91!: checks 
xucuo: bets $0.10
JRGrist7: folds 
Astro439: calls $0.10
GrinZwe91!: folds 
*** SHOW DOWN ***
xucuo: shows [2c Kc] (a full house, Kings full of Fours)
Astro439: mucks hand 
xucuo collected $0.57 from pot
*** SUMMARY ***
Total pot $0.60 | Rake $0.03 
Board [4c 4s Qd Kd Ks]
Seat 1: xucuo showed [2c Kc] and won ($0.57) with a full house, Kings full of Fours
Seat 2: JRGrist7 folded on the River
Seat 3: ElPlazibato (button) folded before Flop (didn't bet)
Seat 5: Astro439 (small blind) mucked
Seat 6: GrinZwe91! (big blind) folded on the River



PokerStars Hand #222961972803:  Hold'em No Limit ($0.05/$0.10 USD) - 2021/01/23 12:46:22 ET
Table 'Bohlinia III' 6-max Seat #5 is the button
Seat 1: xucuo ($10.89 in chips) 
Seat 2: JRGrist7 ($7.08 in chips) 
Seat 3: ElPlazibato ($8.80 in chips) 
Seat 5: Astro439 ($10.48 in chips) 
Seat 6: GrinZwe91! ($10 in chips) 
GrinZwe91!: posts small blind $0.05
xucuo: posts big blind $0.10
JohnSF7: sits out 
*** HOLE CARDS ***
JRGrist7: folds 
ElPlazibato: folds 
Astro439: raises $0.20 to $0.30
GrinZwe91!: folds 
xucuo: calls $0.20
*** FLOP *** [4h 3d Kc]
xucuo: bets $0.31
Astro439: calls $0.31
*** TURN *** [4h 3d Kc] [Jc]
xucuo: bets $0.61
Astro439: calls $0.61
*** RIVER *** [4h 3d Kc Jc] [9c]
xucuo: bets $1.19
Astro439: calls $1.19
*** SHOW DOWN ***
xucuo: shows [Ah Qc] (high card Ace)
Astro439: shows [7d Ks] (a pair of Kings)
Astro439 collected $4.65 from pot
*** SUMMARY ***
Total pot $4.87 | Rake $0.22 
Board [4h 3d Kc Jc 9c]
Seat 1: xucuo (big blind) showed [Ah Qc] and lost with high card Ace
Seat 2: JRGrist7 folded before Flop (didn't bet)
Seat 3: ElPlazibato folded before Flop (didn't bet)
Seat 5: Astro439 (button) showed [7d Ks] and won ($4.65) with a pair of Kings
Seat 6: GrinZwe91! (small blind) folded before Flop



PokerStars Hand #222962012152:  Hold'em No Limit ($0.05/$0.10 USD) - 2021/01/23 12:47:20 ET
Table 'Bohlinia III' 6-max Seat #6 is the button
Seat 1: xucuo ($10 in chips) 
Seat 2: JRGrist7 ($7.08 in chips) 
Seat 3: ElPlazibato ($8.80 in chips) 
Seat 5: Astro439 ($12.72 in chips) 
Seat 6: GrinZwe91! ($10 in chips) 
xucuo: posts small blind $0.05
JRGrist7: posts big blind $0.10
JohnSF7: sits out 
*** HOLE CARDS ***
ElPlazibato: folds 
Astro439: raises $0.20 to $0.30
GrinZwe91!: folds 
xucuo: folds 
JRGrist7: folds 
Uncalled bet ($0.20) returned to Astro439
Astro439 collected $0.25 from pot
*** SUMMARY ***
Total pot $0.25 | Rake $0 
Seat 1: xucuo (small blind) folded before Flop
Seat 2: JRGrist7 (big blind) folded before Flop
Seat 3: ElPlazibato folded before Flop (didn't bet)
Seat 5: Astro439 collected ($0.25)
Seat 6: GrinZwe91! (button) folded before Flop (didn't bet)



PokerStars Hand #222962020500:  Hold'em No Limit ($0.05/$0.10 USD) - 2021/01/23 12:47:33 ET
Table 'Bohlinia III' 6-max Seat #1 is the button
Seat 1: xucuo ($10 in chips) 
Seat 2: JRGrist7 ($6.98 in chips) 
Seat 3: ElPlazibato ($8.80 in chips) 
Seat 5: Astro439 ($12.87 in chips) 
Seat 6: GrinZwe91! ($10 in chips) 
JRGrist7: posts small blind $0.05
ElPlazibato: posts big blind $0.10
JohnSF7: sits out 
*** HOLE CARDS ***
Astro439: folds 
GrinZwe91!: folds 
xucuo: folds 
JRGrist7: calls $0.05
ElPlazibato: raises $0.20 to $0.30
JRGrist7: calls $0.20
*** FLOP *** [4d Jh 7s]
JRGrist7: checks 
ElPlazibato: bets $0.29
JRGrist7: folds 
Uncalled bet ($0.29) returned to ElPlazibato
ElPlazibato collected $0.57 from pot
ElPlazibato: doesn't show hand 
*** SUMMARY ***
Total pot $0.60 | Rake $0.03 
Board [4d Jh 7s]
Seat 1: xucuo (button) folded before Flop (didn't bet)
Seat 2: JRGrist7 (small blind) folded on the Flop
Seat 3: ElPlazibato (big blind) collected ($0.57)
Seat 5: Astro439 folded before Flop (didn't bet)
Seat 6: GrinZwe91! folded before Flop (didn't bet)



PokerStars Hand #222962030171:  Hold'em No Limit ($0.05/$0.10 USD) - 2021/01/23 12:47:47 ET
Table 'Bohlinia III' 6-max Seat #2 is the button
Seat 1: xucuo ($10 in chips) 
Seat 2: JRGrist7 ($6.68 in chips) 
Seat 3: ElPlazibato ($9.07 in chips) 
Seat 4: JohnSF7 ($12.22 in chips) 
Seat 5: Astro439 ($12.87 in chips) 
Seat 6: GrinZwe91! ($10 in chips) 
ElPlazibato: posts small blind $0.05
JohnSF7: posts big blind $0.10
*** HOLE CARDS ***
Astro439: folds 
GrinZwe91!: folds 
xucuo: calls $0.10
JRGrist7: calls $0.10
ElPlazibato: calls $0.05
JohnSF7: checks 
*** FLOP *** [Kh Td 9s]
ElPlazibato: checks 
JohnSF7: checks 
xucuo: bets $0.19
JRGrist7: calls $0.19
ElPlazibato: calls $0.19
JohnSF7: folds 
*** TURN *** [Kh Td 9s] [Kd]
ElPlazibato: checks 
xucuo: checks 
JRGrist7: bets $0.30
ElPlazibato: folds 
xucuo: calls $0.30
*** RIVER *** [Kh Td 9s Kd] [9d]
xucuo: checks 
JRGrist7: bets $3.40
xucuo: raises $3.40 to $6.80
JRGrist7: calls $2.69 and is all-in
Uncalled bet ($0.71) returned to xucuo
*** SHOW DOWN ***
xucuo: shows [Ks Kc] (four of a kind, Kings)
JRGrist7: shows [Jc Ts] (two pair, Kings and Tens)
xucuo collected $13.13 from pot
*** SUMMARY ***
Total pot $13.75 | Rake $0.62 
Board [Kh Td 9s Kd 9d]
Seat 1: xucuo showed [Ks Kc] and won ($13.13) with four of a kind, Kings
Seat 2: JRGrist7 (button) showed [Jc Ts] and lost with two pair, Kings and Tens
Seat 3: ElPlazibato (small blind) folded on the Turn
Seat 4: JohnSF7 (big blind) folded on the Flop
Seat 5: Astro439 folded before Flop (didn't bet)
Seat 6: GrinZwe91! folded before Flop (didn't bet)



PokerStars Hand #222962063550:  Hold'em No Limit ($0.05/$0.10 USD) - 2021/01/23 12:48:37 ET
Table 'Bohlinia III' 6-max Seat #3 is the button
Seat 1: xucuo ($16.45 in chips) 
Seat 3: ElPlazibato ($8.78 in chips) 
Seat 4: JohnSF7 ($12.12 in chips) 
Seat 5: Astro439 ($12.87 in chips) 
Seat 6: GrinZwe91! ($10 in chips) 
JohnSF7: posts small blind $0.05
Astro439: posts big blind $0.10
*** HOLE CARDS ***
JRGrist7 is disconnected 
GrinZwe91!: folds 
xucuo: calls $0.10
ElPlazibato: folds 
JohnSF7: raises $0.40 to $0.50
Astro439: folds 
xucuo: folds 
Uncalled bet ($0.40) returned to JohnSF7
JohnSF7 collected $0.30 from pot
JohnSF7: doesn't show hand 
*** SUMMARY ***
Total pot $0.30 | Rake $0 
Seat 1: xucuo folded before Flop
Seat 3: ElPlazibato (button) folded before Flop (didn't bet)
Seat 4: JohnSF7 (small blind) collected ($0.30)
Seat 5: Astro439 (big blind) folded before Flop
Seat 6: GrinZwe91! folded before Flop (didn't bet)



PokerStars Hand #222962074486:  Hold'em No Limit ($0.05/$0.10 USD) - 2021/01/23 12:48:53 ET
Table 'Bohlinia III' 6-max Seat #4 is the button
Seat 1: xucuo ($16.35 in chips) 
Seat 3: ElPlazibato ($8.78 in chips) 
Seat 4: JohnSF7 ($12.32 in chips) 
Seat 5: Astro439 ($12.77 in chips) 
Seat 6: GrinZwe91! ($10 in chips) 
Astro439: posts small blind $0.05
GrinZwe91!: posts big blind $0.10
*** HOLE CARDS ***
xucuo: folds 
ElPlazibato: folds 
JohnSF7: folds 
Astro439: raises $0.20 to $0.30
GrinZwe91!: folds 
Uncalled bet ($0.20) returned to Astro439
Astro439 collected $0.20 from pot
*** SUMMARY ***
Total pot $0.20 | Rake $0 
Seat 1: xucuo folded before Flop (didn't bet)
Seat 3: ElPlazibato folded before Flop (didn't bet)
Seat 4: JohnSF7 (button) folded before Flop (didn't bet)
Seat 5: Astro439 (small blind) collected ($0.20)
Seat 6: GrinZwe91! (big blind) folded before Flop



PokerStars Hand #222962086288:  Hold'em No Limit ($0.05/$0.10 USD) - 2021/01/23 12:49:10 ET
Table 'Bohlinia III' 6-max Seat #5 is the button
Seat 1: xucuo ($16.35 in chips) 
Seat 3: ElPlazibato ($8.78 in chips) 
Seat 4: JohnSF7 ($12.32 in chips) 
Seat 5: Astro439 ($12.87 in chips) 
Seat 6: GrinZwe91! ($10 in chips) 
GrinZwe91!: posts small blind $0.05
xucuo: posts big blind $0.10
*** HOLE CARDS ***
ElPlazibato: folds 
JohnSF7: folds 
Astro439: raises $0.20 to $0.30
GrinZwe91!: calls $0.25
xucuo: calls $0.20
*** FLOP *** [5h Kc 4h]
GrinZwe91!: checks 
xucuo: checks 
Astro439: bets $0.53
GrinZwe91!: folds 
xucuo: folds 
Uncalled bet ($0.53) returned to Astro439
Astro439 collected $0.86 from pot
*** SUMMARY ***
Total pot $0.90 | Rake $0.04 
Board [5h Kc 4h]
Seat 1: xucuo (big blind) folded on the Flop
Seat 3: ElPlazibato folded before Flop (didn't bet)
Seat 4: JohnSF7 folded before Flop (didn't bet)
Seat 5: Astro439 (button) collected ($0.86)
Seat 6: GrinZwe91! (small blind) folded on the Flop



PokerStars Hand #222962109431:  Hold'em No Limit ($0.05/$0.10 USD) - 2021/01/23 12:49:45 ET
Table 'Bohlinia III' 6-max Seat #6 is the button
Seat 1: xucuo ($16.05 in chips) 
Seat 3: ElPlazibato ($8.78 in chips) 
Seat 4: JohnSF7 ($12.32 in chips) 
Seat 5: Astro439 ($13.43 in chips) 
Seat 6: GrinZwe91! ($10 in chips) 
xucuo: posts small blind $0.05
ElPlazibato: posts big blind $0.10
*** HOLE CARDS ***
JohnSF7: folds 
Astro439: raises $0.20 to $0.30
GrinZwe91!: folds 
xucuo: folds 
ElPlazibato: folds 
Uncalled bet ($0.20) returned to Astro439
Astro439 collected $0.25 from pot
*** SUMMARY ***
Total pot $0.25 | Rake $0 
Seat 1: xucuo (small blind) folded before Flop
Seat 3: ElPlazibato (big blind) folded before Flop
Seat 4: JohnSF7 folded before Flop (didn't bet)
Seat 5: Astro439 collected ($0.25)
Seat 6: GrinZwe91! (button) folded before Flop (didn't bet)



PokerStars Hand #222962117880:  Hold'em No Limit ($0.05/$0.10 USD) - 2021/01/23 12:49:57 ET
Table 'Bohlinia III' 6-max Seat #1 is the button
Seat 1: xucuo ($16 in chips) 
Seat 3: ElPlazibato ($8.68 in chips) 
Seat 4: JohnSF7 ($12.32 in chips) 
Seat 5: Astro439 ($13.58 in chips) 
Seat 6: GrinZwe91! ($10 in chips) 
ElPlazibato: posts small blind $0.05
JohnSF7: posts big blind $0.10
*** HOLE CARDS ***
Astro439: folds 
GrinZwe91!: folds 
xucuo: folds 
ElPlazibato: raises $0.20 to $0.30
JohnSF7: calls $0.20
*** FLOP *** [4c 5h Ah]
ElPlazibato: checks 
JohnSF7: checks 
*** TURN *** [4c 5h Ah] [7c]
ElPlazibato: checks 
JohnSF7: bets $0.31
ElPlazibato: folds 
Uncalled bet ($0.31) returned to JohnSF7
JohnSF7 collected $0.57 from pot
JohnSF7: doesn't show hand 
*** SUMMARY ***
Total pot $0.60 | Rake $0.03 
Board [4c 5h Ah 7c]
Seat 1: xucuo (button) folded before Flop (didn't bet)
Seat 3: ElPlazibato (small blind) folded on the Turn
Seat 4: JohnSF7 (big blind) collected ($0.57)
Seat 5: Astro439 folded before Flop (didn't bet)
Seat 6: GrinZwe91! folded before Flop (didn't bet)



PokerStars Hand #222962135635:  Hold'em No Limit ($0.05/$0.10 USD) - 2021/01/23 12:50:24 ET
Table 'Bohlinia III' 6-max Seat #3 is the button
Seat 1: xucuo ($16 in chips) 
Seat 3: ElPlazibato ($8.38 in chips) 
Seat 4: JohnSF7 ($12.59 in chips) 
Seat 5: Astro439 ($13.58 in chips) 
Seat 6: GrinZwe91! ($10 in chips) 
JohnSF7: posts small blind $0.05
Astro439: posts big blind $0.10
*** HOLE CARDS ***
GrinZwe91!: raises $0.20 to $0.30
xucuo: folds 
ElPlazibato: calls $0.30
JohnSF7: folds 
Astro439: raises $0.95 to $1.25
GrinZwe91!: folds 
ElPlazibato: calls $0.95
*** FLOP *** [6d Kc 7c]
Astro439: bets $1.36
ElPlazibato: folds 
Uncalled bet ($1.36) returned to Astro439
Astro439 collected $2.72 from pot
*** SUMMARY ***
Total pot $2.85 | Rake $0.13 
Board [6d Kc 7c]
Seat 1: xucuo folded before Flop (didn't bet)
Seat 3: ElPlazibato (button) folded on the Flop
Seat 4: JohnSF7 (small blind) folded before Flop
Seat 5: Astro439 (big blind) collected ($2.72)
Seat 6: GrinZwe91! folded before Flop



PokerStars Hand #222962165262:  Hold'em No Limit ($0.05/$0.10 USD) - 2021/01/23 12:51:07 ET
Table 'Bohlinia III' 6-max Seat #4 is the button
Seat 1: xucuo ($16 in chips) 
Seat 3: ElPlazibato ($7.13 in chips) 
Seat 4: JohnSF7 ($12.54 in chips) 
Seat 5: Astro439 ($15.05 in chips) 
Seat 6: GrinZwe91! ($10 in chips) 
Astro439: posts small blind $0.05
GrinZwe91!: posts big blind $0.10
*** HOLE CARDS ***
xucuo: calls $0.10
ElPlazibato: calls $0.10
JohnSF7: folds 
Astro439: calls $0.05
GrinZwe91!: checks 
*** FLOP *** [Ks As 3c]
Astro439: checks 
GrinZwe91!: bets $0.29
xucuo: calls $0.29
ElPlazibato: folds 
Astro439: calls $0.29
*** TURN *** [Ks As 3c] [Jd]
Astro439: checks 
GrinZwe91!: bets $0.91
xucuo: calls $0.91
Astro439: calls $0.91
*** RIVER *** [Ks As 3c Jd] [2c]
Astro439: checks 
GrinZwe91!: bets $2.40
xucuo: calls $2.40
Astro439: calls $2.40
*** SHOW DOWN ***
GrinZwe91!: shows [3h 3d] (three of a kind, Threes)
xucuo: mucks hand 
Astro439: mucks hand 
GrinZwe91! collected $10.70 from pot
*** SUMMARY ***
Total pot $11.20 | Rake $0.50 
Board [Ks As 3c Jd 2c]
Seat 1: xucuo mucked
Seat 3: ElPlazibato folded on the Flop
Seat 4: JohnSF7 (button) folded before Flop (didn't bet)
Seat 5: Astro439 (small blind) mucked
Seat 6: GrinZwe91! (big blind) showed [3h 3d] and won ($10.70) with three of a kind, Threes



PokerStars Hand #222962205971:  Hold'em No Limit ($0.05/$0.10 USD) - 2021/01/23 12:52:07 ET
Table 'Bohlinia III' 6-max Seat #5 is the button
Seat 1: xucuo ($12.30 in chips) 
Seat 3: ElPlazibato ($7.03 in chips) 
Seat 4: JohnSF7 ($12.54 in chips) 
Seat 5: Astro439 ($11.35 in chips) 
Seat 6: GrinZwe91! ($17 in chips) 
GrinZwe91!: posts small blind $0.05
xucuo: posts big blind $0.10
*** HOLE CARDS ***
ElPlazibato: folds 
JohnSF7: folds 
Astro439: raises $0.20 to $0.30
GrinZwe91!: folds 
xucuo: calls $0.20
*** FLOP *** [Qd Js Qc]
xucuo: checks 
Astro439: bets $0.31
xucuo: folds 
Uncalled bet ($0.31) returned to Astro439
Astro439 collected $0.62 from pot
*** SUMMARY ***
Total pot $0.65 | Rake $0.03 
Board [Qd Js Qc]
Seat 1: xucuo (big blind) folded on the Flop
Seat 3: ElPlazibato folded before Flop (didn't bet)
Seat 4: JohnSF7 folded before Flop (didn't bet)
Seat 5: Astro439 (button) collected ($0.62)
Seat 6: GrinZwe91! (small blind) folded before Flop



PokerStars Hand #222962221066:  Hold'em No Limit ($0.05/$0.10 USD) - 2021/01/23 12:52:30 ET
Table 'Bohlinia III' 6-max Seat #6 is the button
Seat 1: xucuo ($12 in chips) 
Seat 3: ElPlazibato ($7.03 in chips) 
Seat 4: JohnSF7 ($12.54 in chips) 
Seat 5: Astro439 ($11.67 in chips) 
Seat 6: GrinZwe91! ($16.95 in chips) 
xucuo: posts small blind $0.05
ElPlazibato: posts big blind $0.10
*** HOLE CARDS ***
JohnSF7: folds 
Astro439: raises $0.20 to $0.30
GrinZwe91!: folds 
xucuo: calls $0.25
ElPlazibato: calls $0.20
*** FLOP *** [7c Js 8c]
xucuo: checks 
ElPlazibato: checks 
Astro439: bets $0.63
xucuo: folds 
ElPlazibato: folds 
Uncalled bet ($0.63) returned to Astro439
Astro439 collected $0.86 from pot
*** SUMMARY ***
Total pot $0.90 | Rake $0.04 
Board [7c Js 8c]
Seat 1: xucuo (small blind) folded on the Flop
Seat 3: ElPlazibato (big blind) folded on the Flop
Seat 4: JohnSF7 folded before Flop (didn't bet)
Seat 5: Astro439 collected ($0.86)
Seat 6: GrinZwe91! (button) folded before Flop (didn't bet)



PokerStars Hand #222962236372:  Hold'em No Limit ($0.05/$0.10 USD) - 2021/01/23 12:52:53 ET
Table 'Bohlinia III' 6-max Seat #1 is the button
Seat 1: xucuo ($11.70 in chips) 
Seat 3: ElPlazibato ($6.73 in chips) 
Seat 4: JohnSF7 ($12.54 in chips) 
Seat 5: Astro439 ($12.23 in chips) 
Seat 6: GrinZwe91! ($16.95 in chips) 
ElPlazibato: posts small blind $0.05
JohnSF7: posts big blind $0.10
*** HOLE CARDS ***
Astro439: raises $0.20 to $0.30
GrinZwe91!: folds 
xucuo: folds 
ElPlazibato: raises $0.20 to $0.50
JohnSF7: folds 
Astro439: raises $1.20 to $1.70
xucuo is disconnected 
ElPlazibato: raises $1.20 to $2.90
Astro439: raises $9.33 to $12.23 and is all-in
ElPlazibato: calls $3.83 and is all-in
Uncalled bet ($5.50) returned to Astro439
*** FLOP *** [5c 4d 7s]
*** TURN *** [5c 4d 7s] [4c]
*** RIVER *** [5c 4d 7s 4c] [Qc]
*** SHOW DOWN ***
ElPlazibato: shows [As Kc] (a pair of Fours)
Astro439: shows [Ks Ad] (a pair of Fours)
ElPlazibato collected $6.48 from pot
Astro439 collected $6.47 from pot
*** SUMMARY ***
Total pot $13.56 | Rake $0.61 
Board [5c 4d 7s 4c Qc]
Seat 1: xucuo (button) folded before Flop (didn't bet)
Seat 3: ElPlazibato (small blind) showed [As Kc] and won ($6.48) with a pair of Fours
Seat 4: JohnSF7 (big blind) folded before Flop
Seat 5: Astro439 showed [Ks Ad] and won ($6.47) with a pair of Fours
Seat 6: GrinZwe91! folded before Flop (didn't bet)



PokerStars Hand #222962278589:  Hold'em No Limit ($0.05/$0.10 USD) - 2021/01/23 12:53:46 ET
Table 'Bohlinia III' 6-max Seat #3 is the button
Seat 1: xucuo ($11.70 in chips) 
Seat 3: ElPlazibato ($6.48 in chips) 
Seat 4: JohnSF7 ($12.44 in chips) 
Seat 5: Astro439 ($11.97 in chips) 
Seat 6: GrinZwe91! ($16.95 in chips) 
JohnSF7: posts small blind $0.05
Astro439: posts big blind $0.10
*** HOLE CARDS ***
GrinZwe91!: folds 
xucuo: calls $0.10
ElPlazibato: folds 
JohnSF7: folds 
Astro439: checks 
*** FLOP *** [Ts 5s 5d]
Astro439: checks 
xucuo: bets $0.24
Astro439: folds 
Uncalled bet ($0.24) returned to xucuo
xucuo collected $0.24 from pot
xucuo: doesn't show hand 
*** SUMMARY ***
Total pot $0.25 | Rake $0.01 
Board [Ts 5s 5d]
Seat 1: xucuo collected ($0.24)
Seat 3: ElPlazibato (button) folded before Flop (didn't bet)
Seat 4: JohnSF7 (small blind) folded before Flop
Seat 5: Astro439 (big blind) folded on the Flop
Seat 6: GrinZwe91! folded before Flop (didn't bet)



PokerStars Hand #222962291593:  Hold'em No Limit ($0.05/$0.10 USD) - 2021/01/23 12:54:05 ET
Table 'Bohlinia III' 6-max Seat #4 is the button
Seat 1: xucuo ($11.84 in chips) 
Seat 3: ElPlazibato ($6.48 in chips) 
Seat 4: JohnSF7 ($12.39 in chips) 
Seat 5: Astro439 ($11.87 in chips) 
Seat 6: GrinZwe91! ($16.95 in chips) 
Astro439: posts small blind $0.05
GrinZwe91!: posts big blind $0.10
*** HOLE CARDS ***
xucuo: calls $0.10
ElPlazibato: calls $0.10
JohnSF7: folds 
Astro439: calls $0.05
GrinZwe91!: checks 
*** FLOP *** [8h Jc 7s]
Astro439: checks 
GrinZwe91!: checks 
xucuo: checks 
ElPlazibato: bets $0.19
Astro439: folds 
GrinZwe91!: folds 
xucuo: calls $0.19
*** TURN *** [8h Jc 7s] [5c]
xucuo: checks 
ElPlazibato: checks 
*** RIVER *** [8h Jc 7s 5c] [Ts]
xucuo: checks 
ElPlazibato: checks 
*** SHOW DOWN ***
xucuo: shows [8c 6c] (a pair of Eights)
ElPlazibato: mucks hand 
xucuo collected $0.74 from pot
*** SUMMARY ***
Total pot $0.78 | Rake $0.04 
Board [8h Jc 7s 5c Ts]
Seat 1: xucuo showed [8c 6c] and won ($0.74) with a pair of Eights
Seat 3: ElPlazibato mucked
Seat 4: JohnSF7 (button) folded before Flop (didn't bet)
Seat 5: Astro439 (small blind) folded on the Flop
Seat 6: GrinZwe91! (big blind) folded on the Flop



PokerStars Hand #222962316960:  Hold'em No Limit ($0.05/$0.10 USD) - 2021/01/23 12:54:43 ET
Table 'Bohlinia III' 6-max Seat #5 is the button
Seat 1: xucuo ($12.29 in chips) 
Seat 3: ElPlazibato ($6.19 in chips) 
Seat 4: JohnSF7 ($12.39 in chips) 
Seat 5: Astro439 ($11.77 in chips) 
Seat 6: GrinZwe91! ($16.85 in chips) 
GrinZwe91!: posts small blind $0.05
xucuo: posts big blind $0.10
*** HOLE CARDS ***
ElPlazibato: calls $0.10
JohnSF7: folds 
Astro439: folds 
GrinZwe91!: folds 
xucuo: checks 
*** FLOP *** [Ad Jd 2c]
xucuo: checks 
ElPlazibato: bets $0.24
xucuo: folds 
Uncalled bet ($0.24) returned to ElPlazibato
ElPlazibato collected $0.24 from pot
ElPlazibato: doesn't show hand 
*** SUMMARY ***
Total pot $0.25 | Rake $0.01 
Board [Ad Jd 2c]
Seat 1: xucuo (big blind) folded on the Flop
Seat 3: ElPlazibato collected ($0.24)
Seat 4: JohnSF7 folded before Flop (didn't bet)
Seat 5: Astro439 (button) folded before Flop (didn't bet)
Seat 6: GrinZwe91! (small blind) folded before Flop



PokerStars Hand #222962335147:  Hold'em No Limit ($0.05/$0.10 USD) - 2021/01/23 12:55:11 ET
Table 'Bohlinia III' 6-max Seat #6 is the button
Seat 1: xucuo ($12.19 in chips) 
Seat 3: ElPlazibato ($6.33 in chips) 
Seat 4: JohnSF7 ($12.39 in chips) 
Seat 5: Astro439 ($11.77 in chips) 
Seat 6: GrinZwe91! ($16.80 in chips) 
xucuo: posts small blind $0.05
ElPlazibato: posts big blind $0.10
*** HOLE CARDS ***
JohnSF7: folds 
Astro439: folds 
GrinZwe91!: folds 
xucuo: raises $0.10 to $0.20
ElPlazibato: calls $0.10
*** FLOP *** [9h Tc 2h]
xucuo: bets $0.20
ElPlazibato: folds 
Uncalled bet ($0.20) returned to xucuo
xucuo collected $0.38 from pot
xucuo: doesn't show hand 
*** SUMMARY ***
Total pot $0.40 | Rake $0.02 
Board [9h Tc 2h]
Seat 1: xucuo (small blind) collected ($0.38)
Seat 3: ElPlazibato (big blind) folded on the Flop
Seat 4: JohnSF7 folded before Flop (didn't bet)
Seat 5: Astro439 folded before Flop (didn't bet)
Seat 6: GrinZwe91! (button) folded before Flop (didn't bet)



PokerStars Hand #222962344443:  Hold'em No Limit ($0.05/$0.10 USD) - 2021/01/23 12:55:29 ET
Table 'Bohlinia III' 6-max Seat #1 is the button
Seat 1: xucuo ($12.37 in chips) 
Seat 3: ElPlazibato ($6.13 in chips) 
Seat 4: JohnSF7 ($12.39 in chips) 
Seat 5: Astro439 ($11.77 in chips) 
Seat 6: GrinZwe91! ($16.80 in chips) 
ElPlazibato: posts small blind $0.05
JohnSF7: posts big blind $0.10
*** HOLE CARDS ***
Astro439: folds 
GrinZwe91!: folds 
xucuo: calls $0.10
ElPlazibato: raises $0.20 to $0.30
JohnSF7: folds 
xucuo: folds 
Uncalled bet ($0.20) returned to ElPlazibato
ElPlazibato collected $0.30 from pot
ElPlazibato: doesn't show hand 
*** SUMMARY ***
Total pot $0.30 | Rake $0 
Seat 1: xucuo (button) folded before Flop
Seat 3: ElPlazibato (small blind) collected ($0.30)
Seat 4: JohnSF7 (big blind) folded before Flop
Seat 5: Astro439 folded before Flop (didn't bet)
Seat 6: GrinZwe91! folded before Flop (didn't bet)



PokerStars Hand #222962353420:  Hold'em No Limit ($0.05/$0.10 USD) - 2021/01/23 12:55:48 ET
Table 'Bohlinia III' 6-max Seat #3 is the button
Seat 1: xucuo ($12.27 in chips) 
Seat 3: ElPlazibato ($6.33 in chips) 
Seat 4: JohnSF7 ($12.29 in chips) 
Seat 5: Astro439 ($11.77 in chips) 
Seat 6: GrinZwe91! ($16.80 in chips) 
JohnSF7: posts small blind $0.05
Astro439: posts big blind $0.10
*** HOLE CARDS ***
GrinZwe91!: folds 
xucuo: folds 
ElPlazibato: folds 
JohnSF7: folds 
Uncalled bet ($0.05) returned to Astro439
Astro439 collected $0.10 from pot
*** SUMMARY ***
Total pot $0.10 | Rake $0 
Seat 1: xucuo folded before Flop (didn't bet)
Seat 3: ElPlazibato (button) folded before Flop (didn't bet)
Seat 4: JohnSF7 (small blind) folded before Flop
Seat 5: Astro439 (big blind) collected ($0.10)
Seat 6: GrinZwe91! folded before Flop (didn't bet)



PokerStars Hand #222962360960:  Hold'em No Limit ($0.05/$0.10 USD) - 2021/01/23 12:56:03 ET
Table 'Bohlinia III' 6-max Seat #4 is the button
Seat 1: xucuo ($12.27 in chips) 
Seat 3: ElPlazibato ($6.33 in chips) 
Seat 4: JohnSF7 ($12.24 in chips) 
Seat 5: Astro439 ($11.82 in chips) 
Seat 6: GrinZwe91! ($16.80 in chips) 
Astro439: posts small blind $0.05
GrinZwe91!: posts big blind $0.10
*** HOLE CARDS ***
xucuo: folds 
ElPlazibato: raises $0.20 to $0.30
JohnSF7: folds 
Astro439: folds 
GrinZwe91!: folds 
Uncalled bet ($0.20) returned to ElPlazibato
ElPlazibato collected $0.25 from pot
ElPlazibato: doesn't show hand 
*** SUMMARY ***
Total pot $0.25 | Rake $0 
Seat 1: xucuo folded before Flop (didn't bet)
Seat 3: ElPlazibato collected ($0.25)
Seat 4: JohnSF7 (button) folded before Flop (didn't bet)
Seat 5: Astro439 (small blind) folded before Flop
Seat 6: GrinZwe91! (big blind) folded before Flop



PokerStars Hand #222962368290:  Hold'em No Limit ($0.05/$0.10 USD) - 2021/01/23 12:56:18 ET
Table 'Bohlinia III' 6-max Seat #5 is the button
Seat 1: xucuo ($12.27 in chips) 
Seat 3: ElPlazibato ($6.48 in chips) 
Seat 4: JohnSF7 ($12.24 in chips) 
Seat 5: Astro439 ($11.77 in chips) 
Seat 6: GrinZwe91! ($16.70 in chips) 
GrinZwe91!: posts small blind $0.05
xucuo: posts big blind $0.10
*** HOLE CARDS ***
ElPlazibato: folds 
JohnSF7: folds 
Astro439: raises $0.20 to $0.30
GrinZwe91!: folds 
xucuo: folds 
Uncalled bet ($0.20) returned to Astro439
Astro439 collected $0.25 from pot
*** SUMMARY ***
Total pot $0.25 | Rake $0 
Seat 1: xucuo (big blind) folded before Flop
Seat 3: ElPlazibato folded before Flop (didn't bet)
Seat 4: JohnSF7 folded before Flop (didn't bet)
Seat 5: Astro439 (button) collected ($0.25)
Seat 6: GrinZwe91! (small blind) folded before Flop



PokerStars Hand #222962376350:  Hold'em No Limit ($0.05/$0.10 USD) - 2021/01/23 12:56:34 ET
Table 'Bohlinia III' 6-max Seat #6 is the button
Seat 1: xucuo ($12.17 in chips) 
Seat 3: ElPlazibato ($6.48 in chips) 
Seat 4: JohnSF7 ($12.24 in chips) 
Seat 5: Astro439 ($11.92 in chips) 
Seat 6: GrinZwe91! ($16.65 in chips) 
xucuo: posts small blind $0.05
ElPlazibato: posts big blind $0.10
*** HOLE CARDS ***
JohnSF7: folds 
Astro439: folds 
GrinZwe91!: raises $0.20 to $0.30
xucuo: calls $0.25
ElPlazibato: calls $0.20
*** FLOP *** [7d 4s 4c]
xucuo: checks 
ElPlazibato: bets $0.86
GrinZwe91!: folds 
xucuo: folds 
Uncalled bet ($0.86) returned to ElPlazibato
ElPlazibato collected $0.86 from pot
JRGrist7 was removed from the table for failing to post
JRGrist7 leaves the table
ElPlazibato: doesn't show hand 
*** SUMMARY ***
Total pot $0.90 | Rake $0.04 
Board [7d 4s 4c]
Seat 1: xucuo (small blind) folded on the Flop
Seat 3: ElPlazibato (big blind) collected ($0.86)
Seat 4: JohnSF7 folded before Flop (didn't bet)
Seat 5: Astro439 folded before Flop (didn't bet)
Seat 6: GrinZwe91! (button) folded on the Flop



PokerStars Hand #222962387810:  Hold'em No Limit ($0.05/$0.10 USD) - 2021/01/23 12:56:57 ET
Table 'Bohlinia III' 6-max Seat #1 is the button
Seat 1: xucuo ($11.87 in chips) 
Seat 3: ElPlazibato ($7.04 in chips) 
Seat 4: JohnSF7 ($12.24 in chips) 
Seat 5: Astro439 ($11.92 in chips) 
Seat 6: GrinZwe91! ($16.35 in chips) 
ElPlazibato: posts small blind $0.05
JohnSF7: posts big blind $0.10
*** HOLE CARDS ***
Astro439: folds 
GrinZwe91!: raises $0.20 to $0.30
xucuo: folds 
ElPlazibato: calls $0.25
JohnSF7: folds 
*** FLOP *** [Qc 3d Qs]
Sve_Sve93 joins the table at seat #2 
ElPlazibato: bets $0.34
GrinZwe91!: folds 
Uncalled bet ($0.34) returned to ElPlazibato
ElPlazibato collected $0.67 from pot
ElPlazibato: doesn't show hand 
*** SUMMARY ***
Total pot $0.70 | Rake $0.03 
Board [Qc 3d Qs]
Seat 1: xucuo (button) folded before Flop (didn't bet)
Seat 3: ElPlazibato (small blind) collected ($0.67)
Seat 4: JohnSF7 (big blind) folded before Flop
Seat 5: Astro439 folded before Flop (didn't bet)
Seat 6: GrinZwe91! folded on the Flop



PokerStars Hand #222962398644:  Hold'em No Limit ($0.05/$0.10 USD) - 2021/01/23 12:57:20 ET
Table 'Bohlinia III' 6-max Seat #3 is the button
Seat 1: xucuo ($11.87 in chips) 
Seat 3: ElPlazibato ($7.41 in chips) 
Seat 4: JohnSF7 ($12.14 in chips) 
Seat 5: Astro439 ($11.92 in chips) 
Seat 6: GrinZwe91! ($16.05 in chips) 
JohnSF7: posts small blind $0.05
Astro439: posts big blind $0.10
Sve_Sve93: sits out 
*** HOLE CARDS ***
GrinZwe91!: folds 
xucuo: folds 
ElPlazibato: raises $0.20 to $0.30
JohnSF7: folds 
Astro439: folds 
Uncalled bet ($0.20) returned to ElPlazibato
ElPlazibato collected $0.25 from pot
ElPlazibato: doesn't show hand 
*** SUMMARY ***
Total pot $0.25 | Rake $0 
Seat 1: xucuo folded before Flop (didn't bet)
Seat 3: ElPlazibato (button) collected ($0.25)
Seat 4: JohnSF7 (small blind) folded before Flop
Seat 5: Astro439 (big blind) folded before Flop
Seat 6: GrinZwe91! folded before Flop (didn't bet)



PokerStars Hand #222962403643:  Hold'em No Limit ($0.05/$0.10 USD) - 2021/01/23 12:57:29 ET
Table 'Bohlinia III' 6-max Seat #4 is the button
Seat 1: xucuo ($11.87 in chips) 
Seat 3: ElPlazibato ($7.56 in chips) 
Seat 4: JohnSF7 ($12.09 in chips) 
Seat 5: Astro439 ($11.82 in chips) 
Seat 6: GrinZwe91! ($16.05 in chips) 
Astro439: posts small blind $0.05
GrinZwe91!: posts big blind $0.10
Sve_Sve93: sits out 
*** HOLE CARDS ***
xucuo: folds 
ElPlazibato: folds 
JohnSF7: folds 
Astro439: raises $0.20 to $0.30
GrinZwe91!: folds 
Uncalled bet ($0.20) returned to Astro439
Astro439 collected $0.20 from pot
*** SUMMARY ***
Total pot $0.20 | Rake $0 
Seat 1: xucuo folded before Flop (didn't bet)
Seat 3: ElPlazibato folded before Flop (didn't bet)
Seat 4: JohnSF7 (button) folded before Flop (didn't bet)
Seat 5: Astro439 (small blind) collected ($0.20)
Seat 6: GrinZwe91! (big blind) folded before Flop



PokerStars Hand #222962411386:  Hold'em No Limit ($0.05/$0.10 USD) - 2021/01/23 12:57:45 ET
Table 'Bohlinia III' 6-max Seat #5 is the button
Seat 1: xucuo ($11.87 in chips) 
Seat 3: ElPlazibato ($7.56 in chips) 
Seat 4: JohnSF7 ($12.09 in chips) 
Seat 5: Astro439 ($11.92 in chips) 
Seat 6: GrinZwe91! ($15.95 in chips) 
GrinZwe91!: posts small blind $0.05
xucuo: posts big blind $0.10
Sve_Sve93: sits out 
*** HOLE CARDS ***
ElPlazibato: raises $0.20 to $0.30
JohnSF7: folds 
Astro439: folds 
GrinZwe91!: folds 
xucuo: folds 
Uncalled bet ($0.20) returned to ElPlazibato
ElPlazibato collected $0.25 from pot
ElPlazibato: doesn't show hand 
*** SUMMARY ***
Total pot $0.25 | Rake $0 
Seat 1: xucuo (big blind) folded before Flop
Seat 3: ElPlazibato collected ($0.25)
Seat 4: JohnSF7 folded before Flop (didn't bet)
Seat 5: Astro439 (button) folded before Flop (didn't bet)
Seat 6: GrinZwe91! (small blind) folded before Flop



PokerStars Hand #222962417843:  Hold'em No Limit ($0.05/$0.10 USD) - 2021/01/23 12:57:58 ET
Table 'Bohlinia III' 6-max Seat #6 is the button
Seat 1: xucuo ($11.77 in chips) 
Seat 2: Sve_Sve93 ($10 in chips) 
Seat 3: ElPlazibato ($7.71 in chips) 
Seat 4: JohnSF7 ($12.09 in chips) 
Seat 5: Astro439 ($11.92 in chips) 
Seat 6: GrinZwe91! ($15.90 in chips) 
xucuo: posts small blind $0.05
Sve_Sve93: posts big blind $0.10
*** HOLE CARDS ***
ElPlazibato: raises $0.20 to $0.30
JohnSF7: folds 
Astro439: folds 
GrinZwe91!: folds 
xucuo: folds 
Sve_Sve93: folds 
Uncalled bet ($0.20) returned to ElPlazibato
ElPlazibato collected $0.25 from pot
ElPlazibato: doesn't show hand 
*** SUMMARY ***
Total pot $0.25 | Rake $0 
Seat 1: xucuo (small blind) folded before Flop
Seat 2: Sve_Sve93 (big blind) folded before Flop
Seat 3: ElPlazibato collected ($0.25)
Seat 4: JohnSF7 folded before Flop (didn't bet)
Seat 5: Astro439 folded before Flop (didn't bet)
Seat 6: GrinZwe91! (button) folded before Flop (didn't bet)



PokerStars Hand #222962423212:  Hold'em No Limit ($0.05/$0.10 USD) - 2021/01/23 12:58:09 ET
Table 'Bohlinia III' 6-max Seat #1 is the button
Seat 1: xucuo ($11.72 in chips) 
Seat 2: Sve_Sve93 ($10 in chips) 
Seat 3: ElPlazibato ($7.86 in chips) 
Seat 4: JohnSF7 ($12.09 in chips) 
Seat 5: Astro439 ($11.92 in chips) 
Seat 6: GrinZwe91! ($15.90 in chips) 
Sve_Sve93: posts small blind $0.05
ElPlazibato: posts big blind $0.10
*** HOLE CARDS ***
JohnSF7: folds 
Astro439: folds 
GrinZwe91!: folds 
xucuo: folds 
Sve_Sve93: raises $0.20 to $0.30
ElPlazibato: folds 
Uncalled bet ($0.20) returned to Sve_Sve93
Sve_Sve93 collected $0.20 from pot
Sve_Sve93: doesn't show hand 
*** SUMMARY ***
Total pot $0.20 | Rake $0 
Seat 1: xucuo (button) folded before Flop (didn't bet)
Seat 2: Sve_Sve93 (small blind) collected ($0.20)
Seat 3: ElPlazibato (big blind) folded before Flop
Seat 4: JohnSF7 folded before Flop (didn't bet)
Seat 5: Astro439 folded before Flop (didn't bet)
Seat 6: GrinZwe91! folded before Flop (didn't bet)



PokerStars Hand #222962431223:  Hold'em No Limit ($0.05/$0.10 USD) - 2021/01/23 12:58:25 ET
Table 'Bohlinia III' 6-max Seat #2 is the button
Seat 1: xucuo ($11.72 in chips) 
Seat 2: Sve_Sve93 ($10.10 in chips) 
Seat 3: ElPlazibato ($7.76 in chips) 
Seat 4: JohnSF7 ($12.09 in chips) 
Seat 5: Astro439 ($11.92 in chips) 
Seat 6: GrinZwe91! ($15.90 in chips) 
ElPlazibato: posts small blind $0.05
JohnSF7: posts big blind $0.10
*** HOLE CARDS ***
Astro439: folds 
GrinZwe91!: folds 
xucuo: calls $0.10
Sve_Sve93: folds 
ElPlazibato: folds 
JohnSF7: checks 
*** FLOP *** [6c 2s 8h]
JohnSF7: checks 
xucuo: bets $0.12
JohnSF7: folds 
Uncalled bet ($0.12) returned to xucuo
xucuo collected $0.24 from pot
xucuo: doesn't show hand 
*** SUMMARY ***
Total pot $0.25 | Rake $0.01 
Board [6c 2s 8h]
Seat 1: xucuo collected ($0.24)
Seat 2: Sve_Sve93 (button) folded before Flop (didn't bet)
Seat 3: ElPlazibato (small blind) folded before Flop
Seat 4: JohnSF7 (big blind) folded on the Flop
Seat 5: Astro439 folded before Flop (didn't bet)
Seat 6: GrinZwe91! folded before Flop (didn't bet)



PokerStars Hand #222962440813:  Hold'em No Limit ($0.05/$0.10 USD) - 2021/01/23 12:58:44 ET
Table 'Bohlinia III' 6-max Seat #3 is the button
Seat 1: xucuo ($11.86 in chips) 
Seat 2: Sve_Sve93 ($10.10 in chips) 
Seat 3: ElPlazibato ($7.71 in chips) 
Seat 4: JohnSF7 ($11.99 in chips) 
Seat 5: Astro439 ($11.92 in chips) 
Seat 6: GrinZwe91! ($15.90 in chips) 
JohnSF7: posts small blind $0.05
Astro439: posts big blind $0.10
*** HOLE CARDS ***
GrinZwe91!: folds 
xucuo: raises $0.20 to $0.30
Sve_Sve93: folds 
ElPlazibato: calls $0.30
JohnSF7: folds 
Astro439: folds 
*** FLOP *** [3h 4c 5d]
xucuo: bets $0.36
ElPlazibato: folds 
Uncalled bet ($0.36) returned to xucuo
xucuo collected $0.72 from pot
xucuo: doesn't show hand 
*** SUMMARY ***
Total pot $0.75 | Rake $0.03 
Board [3h 4c 5d]
Seat 1: xucuo collected ($0.72)
Seat 2: Sve_Sve93 folded before Flop (didn't bet)
Seat 3: ElPlazibato (button) folded on the Flop
Seat 4: JohnSF7 (small blind) folded before Flop
Seat 5: Astro439 (big blind) folded before Flop
Seat 6: GrinZwe91! folded before Flop (didn't bet)



PokerStars Hand #222962450769:  Hold'em No Limit ($0.05/$0.10 USD) - 2021/01/23 12:59:04 ET
Table 'Bohlinia III' 6-max Seat #4 is the button
Seat 1: xucuo ($12.28 in chips) 
Seat 2: Sve_Sve93 ($10.10 in chips) 
Seat 3: ElPlazibato ($7.41 in chips) 
Seat 4: JohnSF7 ($11.94 in chips) 
Seat 5: Astro439 ($11.82 in chips) 
Seat 6: GrinZwe91! ($15.90 in chips) 
Astro439: posts small blind $0.05
GrinZwe91!: posts big blind $0.10
*** HOLE CARDS ***
xucuo: raises $0.20 to $0.30
Sve_Sve93: folds 
ElPlazibato: calls $0.30
JohnSF7: calls $0.30
Astro439: folds 
GrinZwe91!: folds 
*** FLOP *** [2s 5d 6d]
xucuo: bets $0.50
ElPlazibato: folds 
JohnSF7: calls $0.50
*** TURN *** [2s 5d 6d] [6h]
xucuo: checks 
JohnSF7: checks 
*** RIVER *** [2s 5d 6d 6h] [3c]
xucuo: checks 
JohnSF7: checks 
*** SHOW DOWN ***
xucuo: shows [Qc Qh] (two pair, Queens and Sixes)
JohnSF7: mucks hand 
xucuo collected $1.96 from pot
*** SUMMARY ***
Total pot $2.05 | Rake $0.09 
Board [2s 5d 6d 6h 3c]
Seat 1: xucuo showed [Qc Qh] and won ($1.96) with two pair, Queens and Sixes
Seat 2: Sve_Sve93 folded before Flop (didn't bet)
Seat 3: ElPlazibato folded on the Flop
Seat 4: JohnSF7 (button) mucked
Seat 5: Astro439 (small blind) folded before Flop
Seat 6: GrinZwe91! (big blind) folded before Flop



PokerStars Hand #222962474483:  Hold'em No Limit ($0.05/$0.10 USD) - 2021/01/23 12:59:50 ET
Table 'Bohlinia III' 6-max Seat #5 is the button
Seat 1: xucuo ($13.44 in chips) 
Seat 2: Sve_Sve93 ($10.10 in chips) 
Seat 3: ElPlazibato ($7.11 in chips) 
Seat 4: JohnSF7 ($11.14 in chips) 
Seat 5: Astro439 ($11.77 in chips) 
Seat 6: GrinZwe91! ($15.80 in chips) 
GrinZwe91!: posts small blind $0.05
xucuo: posts big blind $0.10
*** HOLE CARDS ***
Sve_Sve93: folds 
ElPlazibato: folds 
JohnSF7: folds 
Astro439: raises $0.20 to $0.30
GrinZwe91!: folds 
xucuo: folds 
Uncalled bet ($0.20) returned to Astro439
Astro439 collected $0.25 from pot
*** SUMMARY ***
Total pot $0.25 | Rake $0 
Seat 1: xucuo (big blind) folded before Flop
Seat 2: Sve_Sve93 folded before Flop (didn't bet)
Seat 3: ElPlazibato folded before Flop (didn't bet)
Seat 4: JohnSF7 folded before Flop (didn't bet)
Seat 5: Astro439 (button) collected ($0.25)
Seat 6: GrinZwe91! (small blind) folded before Flop



PokerStars Hand #222962482548:  Hold'em No Limit ($0.05/$0.10 USD) - 2021/01/23 13:00:06 ET
Table 'Bohlinia III' 6-max Seat #6 is the button
Seat 1: xucuo ($13.34 in chips) 
Seat 2: Sve_Sve93 ($10.10 in chips) 
Seat 3: ElPlazibato ($7.11 in chips) 
Seat 4: JohnSF7 ($11.14 in chips) 
Seat 5: Astro439 ($11.92 in chips) 
Seat 6: GrinZwe91! ($15.75 in chips) 
xucuo: posts small blind $0.05
Sve_Sve93: posts big blind $0.10
*** HOLE CARDS ***
ElPlazibato: raises $0.20 to $0.30
JohnSF7: folds 
Astro439: raises $0.70 to $1
GrinZwe91!: folds 
xucuo: folds 
Sve_Sve93: folds 
ElPlazibato: raises $2.15 to $3.15
Astro439: raises $4.75 to $7.90
ElPlazibato: calls $3.96 and is all-in
Uncalled bet ($0.79) returned to Astro439
*** FLOP *** [Th 4c Jc]
*** TURN *** [Th 4c Jc] [7c]
*** RIVER *** [Th 4c Jc 7c] [2c]
*** SHOW DOWN ***
ElPlazibato: shows [Kh Kc] (a flush, King high)
Astro439: shows [Ac Kd] (a flush, Ace high)
Astro439 collected $13.72 from pot
*** SUMMARY ***
Total pot $14.37 | Rake $0.65 
Board [Th 4c Jc 7c 2c]
Seat 1: xucuo (small blind) folded before Flop
Seat 2: Sve_Sve93 (big blind) folded before Flop
Seat 3: ElPlazibato showed [Kh Kc] and lost with a flush, King high
Seat 4: JohnSF7 folded before Flop (didn't bet)
Seat 5: Astro439 showed [Ac Kd] and won ($13.72) with a flush, Ace high
Seat 6: GrinZwe91! (button) folded before Flop (didn't bet)



PokerStars Hand #222962506882:  Hold'em No Limit ($0.05/$0.10 USD) - 2021/01/23 13:00:52 ET
Table 'Bohlinia III' 6-max Seat #1 is the button
Seat 1: xucuo ($13.29 in chips) 
Seat 2: Sve_Sve93 ($10 in chips) 
Seat 4: JohnSF7 ($11.14 in chips) 
Seat 5: Astro439 ($18.53 in chips) 
Seat 6: GrinZwe91! ($15.75 in chips) 
Sve_Sve93: posts small blind $0.05
JohnSF7: posts big blind $0.10
*** HOLE CARDS ***
Astro439: folds 
GrinZwe91!: folds 
xucuo: folds 
Sve_Sve93: folds 
Uncalled bet ($0.05) returned to JohnSF7
JohnSF7 collected $0.10 from pot
JohnSF7: doesn't show hand 
*** SUMMARY ***
Total pot $0.10 | Rake $0 
Seat 1: xucuo (button) folded before Flop (didn't bet)
Seat 2: Sve_Sve93 (small blind) folded before Flop
Seat 4: JohnSF7 (big blind) collected ($0.10)
Seat 5: Astro439 folded before Flop (didn't bet)
Seat 6: GrinZwe91! folded before Flop (didn't bet)



PokerStars Hand #222962510897:  Hold'em No Limit ($0.05/$0.10 USD) - 2021/01/23 13:00:59 ET
Table 'Bohlinia III' 6-max Seat #2 is the button
Seat 1: xucuo ($13.29 in chips) 
Seat 2: Sve_Sve93 ($10 in chips) 
Seat 4: JohnSF7 ($11.19 in chips) 
Seat 5: Astro439 ($18.53 in chips) 
Seat 6: GrinZwe91! ($15.75 in chips) 
JohnSF7: posts small blind $0.05
Astro439: posts big blind $0.10
*** HOLE CARDS ***
GrinZwe91!: folds 
xucuo: calls $0.10
Sve_Sve93: folds 
JohnSF7: calls $0.05
Astro439: checks 
*** FLOP *** [9c 5h 6h]
JohnSF7: checks 
Astro439: checks 
xucuo: checks 
*** TURN *** [9c 5h 6h] [3c]
ElPlazibato leaves the table
JohnSF7: checks 
memojr29 joins the table at seat #3 
Astro439: bets $0.29
xucuo: folds 
JohnSF7: folds 
Uncalled bet ($0.29) returned to Astro439
Astro439 collected $0.29 from pot
*** SUMMARY ***
Total pot $0.30 | Rake $0.01 
Board [9c 5h 6h 3c]
Seat 1: xucuo folded on the Turn
Seat 2: Sve_Sve93 (button) folded before Flop (didn't bet)
Seat 4: JohnSF7 (small blind) folded on the Turn
Seat 5: Astro439 (big blind) collected ($0.29)
Seat 6: GrinZwe91! folded before Flop (didn't bet)



PokerStars Hand #222962526998:  Hold'em No Limit ($0.05/$0.10 USD) - 2021/01/23 13:01:26 ET
Table 'Bohlinia III' 6-max Seat #4 is the button
Seat 1: xucuo ($13.19 in chips) 
Seat 2: Sve_Sve93 ($10 in chips) 
Seat 4: JohnSF7 ($11.09 in chips) 
Seat 5: Astro439 ($18.72 in chips) 
Seat 6: GrinZwe91! ($15.75 in chips) 
Astro439: posts small blind $0.05
GrinZwe91!: posts big blind $0.10
memojr29: sits out 
*** HOLE CARDS ***
xucuo: calls $0.10
Sve_Sve93: folds 
JohnSF7: raises $0.30 to $0.40
Astro439: folds 
GrinZwe91!: folds 
xucuo: calls $0.30
*** FLOP *** [Jh 5c 2d]
xucuo: checks 
JohnSF7: bets $0.30
xucuo: folds 
Uncalled bet ($0.30) returned to JohnSF7
JohnSF7 collected $0.91 from pot
JohnSF7: doesn't show hand 
*** SUMMARY ***
Total pot $0.95 | Rake $0.04 
Board [Jh 5c 2d]
Seat 1: xucuo folded on the Flop
Seat 2: Sve_Sve93 folded before Flop (didn't bet)
Seat 4: JohnSF7 (button) collected ($0.91)
Seat 5: Astro439 (small blind) folded before Flop
Seat 6: GrinZwe91! (big blind) folded before Flop



PokerStars Hand #222962545724:  Hold'em No Limit ($0.05/$0.10 USD) - 2021/01/23 13:01:56 ET
Table 'Bohlinia III' 6-max Seat #5 is the button
Seat 1: xucuo ($12.79 in chips) 
Seat 2: Sve_Sve93 ($10 in chips) 
Seat 4: JohnSF7 ($11.60 in chips) 
Seat 5: Astro439 ($18.67 in chips) 
Seat 6: GrinZwe91! ($15.65 in chips) 
GrinZwe91!: posts small blind $0.05
xucuo: posts big blind $0.10
memojr29: sits out 
*** HOLE CARDS ***
Sve_Sve93: folds 
JohnSF7: raises $0.15 to $0.25
Astro439: folds 
GrinZwe91!: folds 
xucuo: folds 
Uncalled bet ($0.15) returned to JohnSF7
JohnSF7 collected $0.25 from pot
JohnSF7: doesn't show hand 
*** SUMMARY ***
Total pot $0.25 | Rake $0 
Seat 1: xucuo (big blind) folded before Flop
Seat 2: Sve_Sve93 folded before Flop (didn't bet)
Seat 4: JohnSF7 collected ($0.25)
Seat 5: Astro439 (button) folded before Flop (didn't bet)
Seat 6: GrinZwe91! (small blind) folded before Flop



PokerStars Hand #222962554843:  Hold'em No Limit ($0.05/$0.10 USD) - 2021/01/23 13:02:10 ET
Table 'Bohlinia III' 6-max Seat #6 is the button
Seat 1: xucuo ($12.69 in chips) 
Seat 2: Sve_Sve93 ($10 in chips) 
Seat 4: JohnSF7 ($11.75 in chips) 
Seat 5: Astro439 ($18.67 in chips) 
Seat 6: GrinZwe91! ($15.60 in chips) 
xucuo: posts small blind $0.05
Sve_Sve93: posts big blind $0.10
memojr29: sits out 
*** HOLE CARDS ***
JohnSF7: folds 
Astro439: folds 
GrinZwe91!: folds 
xucuo: folds 
Uncalled bet ($0.05) returned to Sve_Sve93
Sve_Sve93 collected $0.10 from pot
Sve_Sve93: doesn't show hand 
*** SUMMARY ***
Total pot $0.10 | Rake $0 
Seat 1: xucuo (small blind) folded before Flop
Seat 2: Sve_Sve93 (big blind) collected ($0.10)
Seat 4: JohnSF7 folded before Flop (didn't bet)
Seat 5: Astro439 folded before Flop (didn't bet)
Seat 6: GrinZwe91! (button) folded before Flop (didn't bet)



PokerStars Hand #222962559457:  Hold'em No Limit ($0.05/$0.10 USD) - 2021/01/23 13:02:17 ET
Table 'Bohlinia III' 6-max Seat #1 is the button
Seat 1: xucuo ($12.64 in chips) 
Seat 2: Sve_Sve93 ($10.05 in chips) 
Seat 3: memojr29 ($10 in chips) 
Seat 4: JohnSF7 ($11.75 in chips) 
Seat 5: Astro439 ($18.67 in chips) 
Seat 6: GrinZwe91! ($15.60 in chips) 
Sve_Sve93: posts small blind $0.05
memojr29: posts big blind $0.10
*** HOLE CARDS ***
JohnSF7: folds 
Astro439: folds 
GrinZwe91!: raises $0.20 to $0.30
xucuo: folds 
Sve_Sve93: folds 
memojr29: calls $0.20
*** FLOP *** [2c 9s 4s]
memojr29: checks 
GrinZwe91!: bets $0.40
memojr29: folds 
Uncalled bet ($0.40) returned to GrinZwe91!
GrinZwe91! collected $0.62 from pot
GrinZwe91!: doesn't show hand 
*** SUMMARY ***
Total pot $0.65 | Rake $0.03 
Board [2c 9s 4s]
Seat 1: xucuo (button) folded before Flop (didn't bet)
Seat 2: Sve_Sve93 (small blind) folded before Flop
Seat 3: memojr29 (big blind) folded on the Flop
Seat 4: JohnSF7 folded before Flop (didn't bet)
Seat 5: Astro439 folded before Flop (didn't bet)
Seat 6: GrinZwe91! collected ($0.62)



PokerStars Hand #222962586160:  Hold'em No Limit ($0.05/$0.10 USD) - 2021/01/23 13:02:57 ET
Table 'Bohlinia III' 6-max Seat #2 is the button
Seat 1: xucuo ($12.64 in chips) 
Seat 2: Sve_Sve93 ($10 in chips) 
Seat 3: memojr29 ($10 in chips) 
Seat 4: JohnSF7 ($11.75 in chips) 
Seat 5: Astro439 ($18.67 in chips) 
Seat 6: GrinZwe91! ($15.92 in chips) 
memojr29: posts small blind $0.05
JohnSF7: posts big blind $0.10
*** HOLE CARDS ***
Astro439: folds 
GrinZwe91!: folds 
xucuo: calls $0.10
Sve_Sve93: folds 
memojr29: folds 
JohnSF7: checks 
*** FLOP *** [Qd Qs 7d]
JohnSF7: checks 
xucuo: checks 
*** TURN *** [Qd Qs 7d] [Ts]
JohnSF7: checks 
xucuo: checks 
*** RIVER *** [Qd Qs 7d Ts] [9d]
JohnSF7: checks 
xucuo: checks 
*** SHOW DOWN ***
JohnSF7: shows [2d 4h] (a pair of Queens)
xucuo: shows [6c 5s] (a pair of Queens)
JohnSF7 collected $0.12 from pot
xucuo collected $0.12 from pot
*** SUMMARY ***
Total pot $0.25 | Rake $0.01 
Board [Qd Qs 7d Ts 9d]
Seat 1: xucuo showed [6c 5s] and won ($0.12) with a pair of Queens
Seat 2: Sve_Sve93 (button) folded before Flop (didn't bet)
Seat 3: memojr29 (small blind) folded before Flop
Seat 4: JohnSF7 (big blind) showed [2d 4h] and won ($0.12) with a pair of Queens
Seat 5: Astro439 folded before Flop (didn't bet)
Seat 6: GrinZwe91! folded before Flop (didn't bet)



PokerStars Hand #222962617743:  Hold'em No Limit ($0.05/$0.10 USD) - 2021/01/23 13:03:44 ET
Table 'Bohlinia III' 6-max Seat #3 is the button
Seat 1: xucuo ($12.66 in chips) 
Seat 2: Sve_Sve93 ($10 in chips) 
Seat 3: memojr29 ($10 in chips) 
Seat 4: JohnSF7 ($11.77 in chips) 
Seat 5: Astro439 ($18.67 in chips) 
Seat 6: GrinZwe91! ($15.92 in chips) 
JohnSF7: posts small blind $0.05
Astro439: posts big blind $0.10
*** HOLE CARDS ***
GrinZwe91!: folds 
xucuo: calls $0.10
Sve_Sve93: folds 
memojr29: raises $0.35 to $0.45
JohnSF7: calls $0.40
Astro439: folds 
xucuo: calls $0.35
*** FLOP *** [Jh 3d 5h]
JohnSF7: checks 
xucuo: checks 
memojr29: bets $0.91
JohnSF7: folds 
xucuo: folds 
Uncalled bet ($0.91) returned to memojr29
memojr29 collected $1.38 from pot
memojr29: doesn't show hand 
*** SUMMARY ***
Total pot $1.45 | Rake $0.07 
Board [Jh 3d 5h]
Seat 1: xucuo folded on the Flop
Seat 2: Sve_Sve93 folded before Flop (didn't bet)
Seat 3: memojr29 (button) collected ($1.38)
Seat 4: JohnSF7 (small blind) folded on the Flop
Seat 5: Astro439 (big blind) folded before Flop
Seat 6: GrinZwe91! folded before Flop (didn't bet)



PokerStars Hand #222962642415:  Hold'em No Limit ($0.05/$0.10 USD) - 2021/01/23 13:04:19 ET
Table 'Bohlinia III' 6-max Seat #4 is the button
Seat 1: xucuo ($12.21 in chips) 
Seat 2: Sve_Sve93 ($10 in chips) 
Seat 3: memojr29 ($10.93 in chips) 
Seat 4: JohnSF7 ($11.32 in chips) 
Seat 5: Astro439 ($18.57 in chips) 
Seat 6: GrinZwe91! ($15.92 in chips) 
Astro439: posts small blind $0.05
GrinZwe91!: posts big blind $0.10
*** HOLE CARDS ***
xucuo: folds 
Sve_Sve93: folds 
memojr29: raises $0.20 to $0.30
JohnSF7: folds 
Astro439: raises $0.70 to $1
GrinZwe91!: folds 
memojr29: folds 
Uncalled bet ($0.70) returned to Astro439
Astro439 collected $0.70 from pot
*** SUMMARY ***
Total pot $0.70 | Rake $0 
Seat 1: xucuo folded before Flop (didn't bet)
Seat 2: Sve_Sve93 folded before Flop (didn't bet)
Seat 3: memojr29 folded before Flop
Seat 4: JohnSF7 (button) folded before Flop (didn't bet)
Seat 5: Astro439 (small blind) collected ($0.70)
Seat 6: GrinZwe91! (big blind) folded before Flop



PokerStars Hand #222962666046:  Hold'em No Limit ($0.05/$0.10 USD) - 2021/01/23 13:04:54 ET
Table 'Bohlinia III' 6-max Seat #5 is the button
Seat 1: xucuo ($12.21 in chips) 
Seat 2: Sve_Sve93 ($10 in chips) 
Seat 3: memojr29 ($10.63 in chips) 
Seat 4: JohnSF7 ($11.32 in chips) 
Seat 5: Astro439 ($18.97 in chips) 
Seat 6: GrinZwe91! ($15.82 in chips) 
GrinZwe91!: posts small blind $0.05
xucuo: posts big blind $0.10
*** HOLE CARDS ***
Sve_Sve93: raises $0.20 to $0.30
memojr29: folds 
JohnSF7: folds 
Astro439: folds 
GrinZwe91!: calls $0.25
xucuo: folds 
*** FLOP *** [6h 4s 3d]
GrinZwe91!: checks 
Sve_Sve93: bets $0.34
GrinZwe91!: calls $0.34
*** TURN *** [6h 4s 3d] [Jh]
GrinZwe91!: checks 
Sve_Sve93: checks 
*** RIVER *** [6h 4s 3d Jh] [9s]
GrinZwe91!: checks 
Sve_Sve93: checks 
*** SHOW DOWN ***
GrinZwe91!: shows [Ad Qd] (high card Ace)
Sve_Sve93: mucks hand 
GrinZwe91! collected $1.32 from pot
*** SUMMARY ***
Total pot $1.38 | Rake $0.06 
Board [6h 4s 3d Jh 9s]
Seat 1: xucuo (big blind) folded before Flop
Seat 2: Sve_Sve93 mucked
Seat 3: memojr29 folded before Flop (didn't bet)
Seat 4: JohnSF7 folded before Flop (didn't bet)
Seat 5: Astro439 (button) folded before Flop (didn't bet)
Seat 6: GrinZwe91! (small blind) showed [Ad Qd] and won ($1.32) with high card Ace



PokerStars Hand #222962704018:  Hold'em No Limit ($0.05/$0.10 USD) - 2021/01/23 13:05:48 ET
Table 'Bohlinia III' 6-max Seat #6 is the button
Seat 1: xucuo ($12.11 in chips) 
Seat 2: Sve_Sve93 ($10 in chips) 
Seat 3: memojr29 ($10.63 in chips) 
Seat 4: JohnSF7 ($11.32 in chips) 
Seat 5: Astro439 ($18.97 in chips) 
Seat 6: GrinZwe91! ($16.50 in chips) 
xucuo: posts small blind $0.05
Sve_Sve93: posts big blind $0.10
*** HOLE CARDS ***
memojr29: raises $0.20 to $0.30
JohnSF7: folds 
Astro439: folds 
GrinZwe91!: folds 
xucuo: calls $0.25
Sve_Sve93: folds 
*** FLOP *** [2h 3s 8h]
xucuo: checks 
memojr29: bets $0.44
xucuo: calls $0.44
*** TURN *** [2h 3s 8h] [Ts]
xucuo: checks 
memojr29: bets $1
xucuo: calls $1
*** RIVER *** [2h 3s 8h Ts] [5h]
xucuo: bets $2.20
memojr29: calls $2.20
*** SHOW DOWN ***
xucuo: shows [Kd Td] (a pair of Tens)
memojr29: shows [Th Jh] (a flush, Jack high)
memojr29 collected $7.62 from pot
*** SUMMARY ***
Total pot $7.98 | Rake $0.36 
Board [2h 3s 8h Ts 5h]
Seat 1: xucuo (small blind) showed [Kd Td] and lost with a pair of Tens
Seat 2: Sve_Sve93 (big blind) folded before Flop
Seat 3: memojr29 showed [Th Jh] and won ($7.62) with a flush, Jack high
Seat 4: JohnSF7 folded before Flop (didn't bet)
Seat 5: Astro439 folded before Flop (didn't bet)
Seat 6: GrinZwe91! (button) folded before Flop (didn't bet)



PokerStars Hand #222962737919:  Hold'em No Limit ($0.05/$0.10 USD) - 2021/01/23 13:06:37 ET
Table 'Bohlinia III' 6-max Seat #1 is the button
Seat 1: xucuo ($10 in chips) 
Seat 2: Sve_Sve93 ($10 in chips) 
Seat 3: memojr29 ($14.31 in chips) 
Seat 4: JohnSF7 ($11.32 in chips) 
Seat 5: Astro439 ($18.97 in chips) 
Seat 6: GrinZwe91! ($16.50 in chips) 
Sve_Sve93: posts small blind $0.05
memojr29: posts big blind $0.10
*** HOLE CARDS ***
JohnSF7: folds 
Astro439: folds 
GrinZwe91!: folds 
xucuo: folds 
Sve_Sve93: raises $0.20 to $0.30
memojr29: folds 
Uncalled bet ($0.20) returned to Sve_Sve93
Sve_Sve93 collected $0.20 from pot
Sve_Sve93: doesn't show hand 
*** SUMMARY ***
Total pot $0.20 | Rake $0 
Seat 1: xucuo (button) folded before Flop (didn't bet)
Seat 2: Sve_Sve93 (small blind) collected ($0.20)
Seat 3: memojr29 (big blind) folded before Flop
Seat 4: JohnSF7 folded before Flop (didn't bet)
Seat 5: Astro439 folded before Flop (didn't bet)
Seat 6: GrinZwe91! folded before Flop (didn't bet)



PokerStars Hand #222962749715:  Hold'em No Limit ($0.05/$0.10 USD) - 2021/01/23 13:06:54 ET
Table 'Bohlinia III' 6-max Seat #2 is the button
Seat 1: xucuo ($10 in chips) 
Seat 2: Sve_Sve93 ($10.10 in chips) 
Seat 3: memojr29 ($14.21 in chips) 
Seat 4: JohnSF7 ($11.32 in chips) 
Seat 5: Astro439 ($18.97 in chips) 
Seat 6: GrinZwe91! ($16.50 in chips) 
memojr29: posts small blind $0.05
JohnSF7: posts big blind $0.10
*** HOLE CARDS ***
Astro439: folds 
GrinZwe91!: folds 
xucuo: calls $0.10
Sve_Sve93: folds 
memojr29: calls $0.05
JohnSF7: checks 
*** FLOP *** [Ks Kd 6h]
memojr29: checks 
JohnSF7: bets $0.16
xucuo: calls $0.16
memojr29: folds 
*** TURN *** [Ks Kd 6h] [2c]
JohnSF7: bets $0.45
xucuo: folds 
Uncalled bet ($0.45) returned to JohnSF7
JohnSF7 collected $0.59 from pot
JohnSF7: doesn't show hand 
*** SUMMARY ***
Total pot $0.62 | Rake $0.03 
Board [Ks Kd 6h 2c]
Seat 1: xucuo folded on the Turn
Seat 2: Sve_Sve93 (button) folded before Flop (didn't bet)
Seat 3: memojr29 (small blind) folded on the Flop
Seat 4: JohnSF7 (big blind) collected ($0.59)
Seat 5: Astro439 folded before Flop (didn't bet)
Seat 6: GrinZwe91! folded before Flop (didn't bet)



PokerStars Hand #222962779776:  Hold'em No Limit ($0.05/$0.10 USD) - 2021/01/23 13:07:38 ET
Table 'Bohlinia III' 6-max Seat #3 is the button
Seat 1: xucuo ($10 in chips) 
Seat 2: Sve_Sve93 ($10.10 in chips) 
Seat 3: memojr29 ($14.11 in chips) 
Seat 4: JohnSF7 ($11.65 in chips) 
Seat 5: Astro439 ($18.97 in chips) 
Seat 6: GrinZwe91! ($16.50 in chips) 
JohnSF7: posts small blind $0.05
Astro439: posts big blind $0.10
*** HOLE CARDS ***
GrinZwe91!: raises $0.20 to $0.30
xucuo: calls $0.30
Sve_Sve93: folds 
memojr29: calls $0.30
JohnSF7: folds 
Astro439: calls $0.20
*** FLOP *** [Jh 4h 8h]
Astro439: checks 
GrinZwe91!: checks 
xucuo: checks 
memojr29: checks 
*** TURN *** [Jh 4h 8h] [9h]
Astro439: bets $0.89
GrinZwe91!: folds 
xucuo: calls $0.89
memojr29: folds 
*** RIVER *** [Jh 4h 8h 9h] [3h]
Astro439: bets $2.14
xucuo: raises $2.26 to $4.40
Astro439: calls $2.26
*** SHOW DOWN ***
xucuo: shows [5h Ah] (a flush, Ace high)
Astro439: mucks hand 
xucuo collected $11.30 from pot
*** SUMMARY ***
Total pot $11.83 | Rake $0.53 
Board [Jh 4h 8h 9h 3h]
Seat 1: xucuo showed [5h Ah] and won ($11.30) with a flush, Ace high
Seat 2: Sve_Sve93 folded before Flop (didn't bet)
Seat 3: memojr29 (button) folded on the Turn
Seat 4: JohnSF7 (small blind) folded before Flop
Seat 5: Astro439 (big blind) mucked
Seat 6: GrinZwe91! folded on the Turn



PokerStars Hand #222962840123:  Hold'em No Limit ($0.05/$0.10 USD) - 2021/01/23 13:09:06 ET
Table 'Bohlinia III' 6-max Seat #4 is the button
Seat 1: xucuo ($15.71 in chips) 
Seat 2: Sve_Sve93 ($10.10 in chips) 
Seat 3: memojr29 ($13.81 in chips) 
Seat 4: JohnSF7 ($11.60 in chips) 
Seat 5: Astro439 ($13.38 in chips) 
Seat 6: GrinZwe91! ($16.20 in chips) 
Astro439: posts small blind $0.05
GrinZwe91!: posts big blind $0.10
*** HOLE CARDS ***
xucuo: folds 
Sve_Sve93: folds 
memojr29: raises $0.20 to $0.30
JohnSF7: folds 
Astro439: folds 
GrinZwe91!: folds 
Uncalled bet ($0.20) returned to memojr29
memojr29 collected $0.25 from pot
memojr29: doesn't show hand 
*** SUMMARY ***
Total pot $0.25 | Rake $0 
Seat 1: xucuo folded before Flop (didn't bet)
Seat 2: Sve_Sve93 folded before Flop (didn't bet)
Seat 3: memojr29 collected ($0.25)
Seat 4: JohnSF7 (button) folded before Flop (didn't bet)
Seat 5: Astro439 (small blind) folded before Flop
Seat 6: GrinZwe91! (big blind) folded before Flop



PokerStars Hand #222962849480:  Hold'em No Limit ($0.05/$0.10 USD) - 2021/01/23 13:09:19 ET
Table 'Bohlinia III' 6-max Seat #5 is the button
Seat 1: xucuo ($15.71 in chips) 
Seat 2: Sve_Sve93 ($10.10 in chips) 
Seat 3: memojr29 ($13.96 in chips) 
Seat 4: JohnSF7 ($11.60 in chips) 
Seat 5: Astro439 ($13.33 in chips) 
Seat 6: GrinZwe91! ($16.10 in chips) 
GrinZwe91!: posts small blind $0.05
xucuo: posts big blind $0.10
*** HOLE CARDS ***
Sve_Sve93: folds 
memojr29: folds 
JohnSF7: raises $0.15 to $0.25
Astro439: folds 
GrinZwe91!: folds 
xucuo: calls $0.15
*** FLOP *** [Qs Qh Ks]
xucuo: checks 
JohnSF7: checks 
*** TURN *** [Qs Qh Ks] [8h]
xucuo: checks 
JohnSF7: bets $0.29
xucuo: folds 
Uncalled bet ($0.29) returned to JohnSF7
JohnSF7 collected $0.53 from pot
JohnSF7: doesn't show hand 
*** SUMMARY ***
Total pot $0.55 | Rake $0.02 
Board [Qs Qh Ks 8h]
Seat 1: xucuo (big blind) folded on the Turn
Seat 2: Sve_Sve93 folded before Flop (didn't bet)
Seat 3: memojr29 folded before Flop (didn't bet)
Seat 4: JohnSF7 collected ($0.53)
Seat 5: Astro439 (button) folded before Flop (didn't bet)
Seat 6: GrinZwe91! (small blind) folded before Flop



PokerStars Hand #222962870289:  Hold'em No Limit ($0.05/$0.10 USD) - 2021/01/23 13:09:50 ET
Table 'Bohlinia III' 6-max Seat #6 is the button
Seat 1: xucuo ($15.46 in chips) 
Seat 2: Sve_Sve93 ($10.10 in chips) 
Seat 3: memojr29 ($13.96 in chips) 
Seat 4: JohnSF7 ($11.88 in chips) 
Seat 5: Astro439 ($13.33 in chips) 
Seat 6: GrinZwe91! ($16.05 in chips) 
xucuo: posts small blind $0.05
Sve_Sve93: posts big blind $0.10
*** HOLE CARDS ***
memojr29: raises $0.20 to $0.30
JohnSF7: folds 
Astro439: folds 
GrinZwe91!: calls $0.30
xucuo: calls $0.25
Sve_Sve93: folds 
*** FLOP *** [5h 9c 2s]
xucuo: checks 
memojr29: bets $0.48
GrinZwe91!: calls $0.48
xucuo: folds 
*** TURN *** [5h 9c 2s] [9h]
memojr29: bets $0.94
GrinZwe91!: folds 
Uncalled bet ($0.94) returned to memojr29
memojr29 collected $1.87 from pot
memojr29: doesn't show hand 
*** SUMMARY ***
Total pot $1.96 | Rake $0.09 
Board [5h 9c 2s 9h]
Seat 1: xucuo (small blind) folded on the Flop
Seat 2: Sve_Sve93 (big blind) folded before Flop
Seat 3: memojr29 collected ($1.87)
Seat 4: JohnSF7 folded before Flop (didn't bet)
Seat 5: Astro439 folded before Flop (didn't bet)
Seat 6: GrinZwe91! (button) folded on the Turn



PokerStars Hand #222962914131:  Hold'em No Limit ($0.05/$0.10 USD) - 2021/01/23 13:10:54 ET
Table 'Bohlinia III' 6-max Seat #1 is the button
Seat 1: xucuo ($15.16 in chips) 
Seat 2: Sve_Sve93 ($10 in chips) 
Seat 3: memojr29 ($15.05 in chips) 
Seat 4: JohnSF7 ($11.88 in chips) 
Seat 5: Astro439 ($13.33 in chips) 
Seat 6: GrinZwe91! ($15.27 in chips) 
Sve_Sve93: posts small blind $0.05
memojr29: posts big blind $0.10
*** HOLE CARDS ***
JohnSF7: folds 
Astro439: folds 
GrinZwe91!: folds 
xucuo: folds 
Sve_Sve93: folds 
Uncalled bet ($0.05) returned to memojr29
memojr29 collected $0.10 from pot
memojr29: doesn't show hand 
*** SUMMARY ***
Total pot $0.10 | Rake $0 
Seat 1: xucuo (button) folded before Flop (didn't bet)
Seat 2: Sve_Sve93 (small blind) folded before Flop
Seat 3: memojr29 (big blind) collected ($0.10)
Seat 4: JohnSF7 folded before Flop (didn't bet)
Seat 5: Astro439 folded before Flop (didn't bet)
Seat 6: GrinZwe91! folded before Flop (didn't bet)



PokerStars Hand #222962922547:  Hold'em No Limit ($0.05/$0.10 USD) - 2021/01/23 13:11:06 ET
Table 'Bohlinia III' 6-max Seat #2 is the button
Seat 1: xucuo ($15.16 in chips) 
Seat 2: Sve_Sve93 ($10 in chips) 
Seat 3: memojr29 ($15.10 in chips) 
Seat 4: JohnSF7 ($11.88 in chips) 
Seat 5: Astro439 ($13.33 in chips) 
Seat 6: GrinZwe91! ($15.27 in chips) 
memojr29: posts small blind $0.05
JohnSF7: posts big blind $0.10
*** HOLE CARDS ***
Astro439: folds 
GrinZwe91!: folds 
xucuo: calls $0.10
Sve_Sve93: folds 
memojr29: raises $0.40 to $0.50
JohnSF7: folds 
xucuo: calls $0.40
*** FLOP *** [Kd Tc 3c]
memojr29: bets $0.53
xucuo: raises $1.07 to $1.60
memojr29: folds 
Uncalled bet ($1.07) returned to xucuo
xucuo collected $2.06 from pot
xucuo: doesn't show hand 
*** SUMMARY ***
Total pot $2.16 | Rake $0.10 
Board [Kd Tc 3c]
Seat 1: xucuo collected ($2.06)
Seat 2: Sve_Sve93 (button) folded before Flop (didn't bet)
Seat 3: memojr29 (small blind) folded on the Flop
Seat 4: JohnSF7 (big blind) folded before Flop
Seat 5: Astro439 folded before Flop (didn't bet)
Seat 6: GrinZwe91! folded before Flop (didn't bet)



PokerStars Hand #222962949164:  Hold'em No Limit ($0.05/$0.10 USD) - 2021/01/23 13:11:45 ET
Table 'Bohlinia III' 6-max Seat #3 is the button
Seat 1: xucuo ($16.19 in chips) 
Seat 2: Sve_Sve93 ($10 in chips) 
Seat 3: memojr29 ($14.07 in chips) 
Seat 4: JohnSF7 ($11.78 in chips) 
Seat 5: Astro439 ($13.33 in chips) 
Seat 6: GrinZwe91! ($15.27 in chips) 
JohnSF7: posts small blind $0.05
Astro439: posts big blind $0.10
*** HOLE CARDS ***
GrinZwe91!: folds 
xucuo: folds 
Sve_Sve93: folds 
memojr29: folds 
JohnSF7: raises $0.20 to $0.30
Astro439: folds 
Uncalled bet ($0.20) returned to JohnSF7
JohnSF7 collected $0.20 from pot
JohnSF7: doesn't show hand 
*** SUMMARY ***
Total pot $0.20 | Rake $0 
Seat 1: xucuo folded before Flop (didn't bet)
Seat 2: Sve_Sve93 folded before Flop (didn't bet)
Seat 3: memojr29 (button) folded before Flop (didn't bet)
Seat 4: JohnSF7 (small blind) collected ($0.20)
Seat 5: Astro439 (big blind) folded before Flop
Seat 6: GrinZwe91! folded before Flop (didn't bet)



PokerStars Hand #222962960250:  Hold'em No Limit ($0.05/$0.10 USD) - 2021/01/23 13:12:01 ET
Table 'Bohlinia III' 6-max Seat #4 is the button
Seat 1: xucuo ($16.19 in chips) 
Seat 2: Sve_Sve93 ($10 in chips) 
Seat 3: memojr29 ($14.07 in chips) 
Seat 4: JohnSF7 ($11.88 in chips) 
Seat 5: Astro439 ($13.23 in chips) 
Seat 6: GrinZwe91! ($15.27 in chips) 
Astro439: posts small blind $0.05
GrinZwe91!: posts big blind $0.10
*** HOLE CARDS ***
xucuo: calls $0.10
Sve_Sve93: folds 
memojr29: folds 
JohnSF7: folds 
Astro439: calls $0.05
GrinZwe91!: checks 
*** FLOP *** [5h 7h 5d]
Astro439: checks 
GrinZwe91!: checks 
xucuo: bets $0.20
Astro439: folds 
GrinZwe91!: folds 
Uncalled bet ($0.20) returned to xucuo
xucuo collected $0.29 from pot
xucuo: doesn't show hand 
*** SUMMARY ***
Total pot $0.30 | Rake $0.01 
Board [5h 7h 5d]
Seat 1: xucuo collected ($0.29)
Seat 2: Sve_Sve93 folded before Flop (didn't bet)
Seat 3: memojr29 folded before Flop (didn't bet)
Seat 4: JohnSF7 (button) folded before Flop (didn't bet)
Seat 5: Astro439 (small blind) folded on the Flop
Seat 6: GrinZwe91! (big blind) folded on the Flop



PokerStars Hand #222962987915:  Hold'em No Limit ($0.05/$0.10 USD) - 2021/01/23 13:12:41 ET
Table 'Bohlinia III' 6-max Seat #5 is the button
Seat 1: xucuo ($16.38 in chips) 
Seat 2: Sve_Sve93 ($10 in chips) 
Seat 3: memojr29 ($14.07 in chips) 
Seat 4: JohnSF7 ($11.88 in chips) 
Seat 5: Astro439 ($13.13 in chips) 
Seat 6: GrinZwe91! ($15.17 in chips) 
GrinZwe91!: posts small blind $0.05
xucuo: posts big blind $0.10
*** HOLE CARDS ***
Sve_Sve93: folds 
memojr29: raises $0.20 to $0.30
JohnSF7: folds 
Astro439: folds 
GrinZwe91!: folds 
xucuo: folds 
Uncalled bet ($0.20) returned to memojr29
memojr29 collected $0.25 from pot
memojr29: doesn't show hand 
*** SUMMARY ***
Total pot $0.25 | Rake $0 
Seat 1: xucuo (big blind) folded before Flop
Seat 2: Sve_Sve93 folded before Flop (didn't bet)
Seat 3: memojr29 collected ($0.25)
Seat 4: JohnSF7 folded before Flop (didn't bet)
Seat 5: Astro439 (button) folded before Flop (didn't bet)
Seat 6: GrinZwe91! (small blind) folded before Flop



PokerStars Hand #222962997152:  Hold'em No Limit ($0.05/$0.10 USD) - 2021/01/23 13:12:55 ET
Table 'Bohlinia III' 6-max Seat #6 is the button
Seat 1: xucuo ($16.28 in chips) 
Seat 2: Sve_Sve93 ($10 in chips) 
Seat 3: memojr29 ($14.22 in chips) 
Seat 4: JohnSF7 ($11.88 in chips) 
Seat 5: Astro439 ($13.13 in chips) 
Seat 6: GrinZwe91! ($15.12 in chips) 
xucuo: posts small blind $0.05
Sve_Sve93: posts big blind $0.10
*** HOLE CARDS ***
memojr29: folds 
JohnSF7: folds 
Astro439: folds 
GrinZwe91!: raises $0.20 to $0.30
xucuo: folds 
Sve_Sve93: folds 
Uncalled bet ($0.20) returned to GrinZwe91!
GrinZwe91! collected $0.25 from pot
GrinZwe91!: doesn't show hand 
*** SUMMARY ***
Total pot $0.25 | Rake $0 
Seat 1: xucuo (small blind) folded before Flop
Seat 2: Sve_Sve93 (big blind) folded before Flop
Seat 3: memojr29 folded before Flop (didn't bet)
Seat 4: JohnSF7 folded before Flop (didn't bet)
Seat 5: Astro439 folded before Flop (didn't bet)
Seat 6: GrinZwe91! (button) collected ($0.25)



PokerStars Hand #222963009302:  Hold'em No Limit ($0.05/$0.10 USD) - 2021/01/23 13:13:13 ET
Table 'Bohlinia III' 6-max Seat #1 is the button
Seat 1: xucuo ($16.23 in chips) 
Seat 2: Sve_Sve93 ($10 in chips) 
Seat 3: memojr29 ($14.22 in chips) 
Seat 4: JohnSF7 ($11.88 in chips) 
Seat 5: Astro439 ($13.13 in chips) 
Seat 6: GrinZwe91! ($15.27 in chips) 
Sve_Sve93: posts small blind $0.05
memojr29: posts big blind $0.10
*** HOLE CARDS ***
JohnSF7: folds 
Astro439: raises $0.20 to $0.30
GrinZwe91!: folds 
xucuo: folds 
Sve_Sve93: folds 
memojr29: folds 
Uncalled bet ($0.20) returned to Astro439
Astro439 collected $0.25 from pot
*** SUMMARY ***
Total pot $0.25 | Rake $0 
Seat 1: xucuo (button) folded before Flop (didn't bet)
Seat 2: Sve_Sve93 (small blind) folded before Flop
Seat 3: memojr29 (big blind) folded before Flop
Seat 4: JohnSF7 folded before Flop (didn't bet)
Seat 5: Astro439 collected ($0.25)
Seat 6: GrinZwe91! folded before Flop (didn't bet)



PokerStars Hand #222963018634:  Hold'em No Limit ($0.05/$0.10 USD) - 2021/01/23 13:13:26 ET
Table 'Bohlinia III' 6-max Seat #2 is the button
Seat 1: xucuo ($16.23 in chips) 
Seat 2: Sve_Sve93 ($10 in chips) 
Seat 3: memojr29 ($14.12 in chips) 
Seat 4: JohnSF7 ($11.88 in chips) 
Seat 5: Astro439 ($13.28 in chips) 
Seat 6: GrinZwe91! ($15.27 in chips) 
memojr29: posts small blind $0.05
JohnSF7: posts big blind $0.10
*** HOLE CARDS ***
Astro439: raises $0.20 to $0.30
GrinZwe91!: folds 
xucuo: folds 
Sve_Sve93: calls $0.30
memojr29: folds 
JohnSF7: calls $0.20
*** FLOP *** [Kh 5s 5c]
JohnSF7: checks 
Astro439: bets $0.45
Sve_Sve93: calls $0.45
JohnSF7: folds 
*** TURN *** [Kh 5s 5c] [2d]
Astro439: checks 
Sve_Sve93: bets $0.89
Astro439: calls $0.89
*** RIVER *** [Kh 5s 5c 2d] [4c]
Astro439: checks 
Sve_Sve93: checks 
*** SHOW DOWN ***
Astro439: shows [Kd Ad] (two pair, Kings and Fives)
Sve_Sve93: mucks hand 
Astro439 collected $3.47 from pot
*** SUMMARY ***
Total pot $3.63 | Rake $0.16 
Board [Kh 5s 5c 2d 4c]
Seat 1: xucuo folded before Flop (didn't bet)
Seat 2: Sve_Sve93 (button) mucked
Seat 3: memojr29 (small blind) folded before Flop
Seat 4: JohnSF7 (big blind) folded on the Flop
Seat 5: Astro439 showed [Kd Ad] and won ($3.47) with two pair, Kings and Fives
Seat 6: GrinZwe91! folded before Flop (didn't bet)



PokerStars Hand #222963059577:  Hold'em No Limit ($0.05/$0.10 USD) - 2021/01/23 13:14:27 ET
Table 'Bohlinia III' 6-max Seat #3 is the button
Seat 1: xucuo ($16.23 in chips) 
Seat 2: Sve_Sve93 ($10 in chips) 
Seat 3: memojr29 ($14.07 in chips) 
Seat 4: JohnSF7 ($11.58 in chips) 
Seat 5: Astro439 ($15.11 in chips) 
Seat 6: GrinZwe91! ($15.27 in chips) 
JohnSF7: posts small blind $0.05
Astro439: posts big blind $0.10
*** HOLE CARDS ***
GrinZwe91!: folds 
xucuo: raises $0.20 to $0.30
Sve_Sve93: folds 
memojr29: folds 
JohnSF7: folds 
Astro439: folds 
Uncalled bet ($0.20) returned to xucuo
xucuo collected $0.25 from pot
xucuo: doesn't show hand 
*** SUMMARY ***
Total pot $0.25 | Rake $0 
Seat 1: xucuo collected ($0.25)
Seat 2: Sve_Sve93 folded before Flop (didn't bet)
Seat 3: memojr29 (button) folded before Flop (didn't bet)
Seat 4: JohnSF7 (small blind) folded before Flop
Seat 5: Astro439 (big blind) folded before Flop
Seat 6: GrinZwe91! folded before Flop (didn't bet)



PokerStars Hand #222963069499:  Hold'em No Limit ($0.05/$0.10 USD) - 2021/01/23 13:14:41 ET
Table 'Bohlinia III' 6-max Seat #4 is the button
Seat 1: xucuo ($16.38 in chips) 
Seat 2: Sve_Sve93 ($10 in chips) 
Seat 3: memojr29 ($14.07 in chips) 
Seat 4: JohnSF7 ($11.53 in chips) 
Seat 5: Astro439 ($15.01 in chips) 
Seat 6: GrinZwe91! ($15.27 in chips) 
Astro439: posts small blind $0.05
GrinZwe91!: posts big blind $0.10
*** HOLE CARDS ***
xucuo: folds 
Sve_Sve93: folds 
memojr29: folds 
JohnSF7: folds 
Astro439: folds 
Uncalled bet ($0.05) returned to GrinZwe91!
GrinZwe91! collected $0.10 from pot
GrinZwe91!: doesn't show hand 
*** SUMMARY ***
Total pot $0.10 | Rake $0 
Seat 1: xucuo folded before Flop (didn't bet)
Seat 2: Sve_Sve93 folded before Flop (didn't bet)
Seat 3: memojr29 folded before Flop (didn't bet)
Seat 4: JohnSF7 (button) folded before Flop (didn't bet)
Seat 5: Astro439 (small blind) folded before Flop
Seat 6: GrinZwe91! (big blind) collected ($0.10)



PokerStars Hand #222963077843:  Hold'em No Limit ($0.05/$0.10 USD) - 2021/01/23 13:14:54 ET
Table 'Bohlinia III' 6-max Seat #5 is the button
Seat 1: xucuo ($16.38 in chips) 
Seat 2: Sve_Sve93 ($10 in chips) 
Seat 3: memojr29 ($14.07 in chips) 
Seat 4: JohnSF7 ($11.53 in chips) 
Seat 5: Astro439 ($14.96 in chips) 
Seat 6: GrinZwe91! ($15.32 in chips) 
GrinZwe91!: posts small blind $0.05
xucuo: posts big blind $0.10
*** HOLE CARDS ***
Sve_Sve93: folds 
memojr29: folds 
JohnSF7: folds 
Astro439: raises $0.20 to $0.30
GrinZwe91!: folds 
xucuo: folds 
Uncalled bet ($0.20) returned to Astro439
Astro439 collected $0.25 from pot
*** SUMMARY ***
Total pot $0.25 | Rake $0 
Seat 1: xucuo (big blind) folded before Flop
Seat 2: Sve_Sve93 folded before Flop (didn't bet)
Seat 3: memojr29 folded before Flop (didn't bet)
Seat 4: JohnSF7 folded before Flop (didn't bet)
Seat 5: Astro439 (button) collected ($0.25)
Seat 6: GrinZwe91! (small blind) folded before Flop



PokerStars Hand #222963103309:  Hold'em No Limit ($0.05/$0.10 USD) - 2021/01/23 13:15:16 ET
Table 'Bohlinia III' 6-max Seat #6 is the button
Seat 1: xucuo ($16.28 in chips) 
Seat 2: Sve_Sve93 ($10 in chips) 
Seat 3: memojr29 ($14.07 in chips) 
Seat 4: JohnSF7 ($11.53 in chips) 
Seat 5: Astro439 ($15.11 in chips) 
Seat 6: GrinZwe91! ($15.27 in chips) 
xucuo: posts small blind $0.05
Sve_Sve93: posts big blind $0.10
*** HOLE CARDS ***
memojr29: folds 
JohnSF7: raises $0.15 to $0.25
Astro439: folds 
GrinZwe91!: calls $0.25
xucuo: calls $0.20
Sve_Sve93: folds 
*** FLOP *** [8h 4c Qd]
xucuo: checks 
JohnSF7: bets $0.45
GrinZwe91!: calls $0.45
xucuo: folds 
*** TURN *** [8h 4c Qd] [7d]
JohnSF7: bets $0.92
GrinZwe91!: raises $1.98 to $2.90
JohnSF7: folds 
Uncalled bet ($1.98) returned to GrinZwe91!
GrinZwe91! collected $3.43 from pot
GrinZwe91!: doesn't show hand 
*** SUMMARY ***
Total pot $3.59 | Rake $0.16 
Board [8h 4c Qd 7d]
Seat 1: xucuo (small blind) folded on the Flop
Seat 2: Sve_Sve93 (big blind) folded before Flop
Seat 3: memojr29 folded before Flop (didn't bet)
Seat 4: JohnSF7 folded on the Turn
Seat 5: Astro439 folded before Flop (didn't bet)
Seat 6: GrinZwe91! (button) collected ($3.43)



PokerStars Hand #222963147212:  Hold'em No Limit ($0.05/$0.10 USD) - 2021/01/23 13:16:16 ET
Table 'Bohlinia III' 6-max Seat #1 is the button
Seat 1: xucuo ($16.03 in chips) 
Seat 2: Sve_Sve93 ($10 in chips) 
Seat 3: memojr29 ($14.07 in chips) 
Seat 4: JohnSF7 ($10 in chips) 
Seat 5: Astro439 ($15.11 in chips) 
Seat 6: GrinZwe91! ($17.08 in chips) 
Sve_Sve93: posts small blind $0.05
memojr29: posts big blind $0.10
*** HOLE CARDS ***
JohnSF7: folds 
Astro439: folds 
GrinZwe91!: folds 
xucuo: folds 
Sve_Sve93: folds 
Uncalled bet ($0.05) returned to memojr29
memojr29 collected $0.10 from pot
memojr29: doesn't show hand 
*** SUMMARY ***
Total pot $0.10 | Rake $0 
Seat 1: xucuo (button) folded before Flop (didn't bet)
Seat 2: Sve_Sve93 (small blind) folded before Flop
Seat 3: memojr29 (big blind) collected ($0.10)
Seat 4: JohnSF7 folded before Flop (didn't bet)
Seat 5: Astro439 folded before Flop (didn't bet)
Seat 6: GrinZwe91! folded before Flop (didn't bet)



PokerStars Hand #222963160967:  Hold'em No Limit ($0.05/$0.10 USD) - 2021/01/23 13:16:35 ET
Table 'Bohlinia III' 6-max Seat #2 is the button
Seat 1: xucuo ($16.03 in chips) 
Seat 2: Sve_Sve93 ($10 in chips) 
Seat 3: memojr29 ($14.12 in chips) 
Seat 4: JohnSF7 ($10 in chips) 
Seat 5: Astro439 ($15.11 in chips) 
Seat 6: GrinZwe91! ($17.08 in chips) 
memojr29: posts small blind $0.05
JohnSF7: posts big blind $0.10
*** HOLE CARDS ***
Astro439: raises $0.20 to $0.30
GrinZwe91!: folds 
xucuo: raises $0.80 to $1.10
Sve_Sve93: folds 
memojr29: folds 
JohnSF7: folds 
Astro439: folds 
Uncalled bet ($0.80) returned to xucuo
xucuo collected $0.75 from pot
xucuo: doesn't show hand 
*** SUMMARY ***
Total pot $0.75 | Rake $0 
Seat 1: xucuo collected ($0.75)
Seat 2: Sve_Sve93 (button) folded before Flop (didn't bet)
Seat 3: memojr29 (small blind) folded before Flop
Seat 4: JohnSF7 (big blind) folded before Flop
Seat 5: Astro439 folded before Flop
Seat 6: GrinZwe91! folded before Flop (didn't bet)



PokerStars Hand #222963178055:  Hold'em No Limit ($0.05/$0.10 USD) - 2021/01/23 13:16:58 ET
Table 'Bohlinia III' 6-max Seat #3 is the button
Seat 1: xucuo ($16.48 in chips) 
Seat 2: Sve_Sve93 ($10 in chips) 
Seat 3: memojr29 ($14.07 in chips) 
Seat 4: JohnSF7 ($10 in chips) 
Seat 5: Astro439 ($14.81 in chips) 
Seat 6: GrinZwe91! ($17.08 in chips) 
JohnSF7: posts small blind $0.05
Astro439: posts big blind $0.10
*** HOLE CARDS ***
GrinZwe91!: folds 
xucuo: raises $0.30 to $0.40
Sve_Sve93: folds 
memojr29: folds 
JohnSF7: folds 
Astro439: calls $0.30
*** FLOP *** [5s 2s Jh]
Astro439: checks 
xucuo: bets $0.60
Astro439: folds 
Uncalled bet ($0.60) returned to xucuo
xucuo collected $0.81 from pot
xucuo: doesn't show hand 
*** SUMMARY ***
Total pot $0.85 | Rake $0.04 
Board [5s 2s Jh]
Seat 1: xucuo collected ($0.81)
Seat 2: Sve_Sve93 folded before Flop (didn't bet)
Seat 3: memojr29 (button) folded before Flop (didn't bet)
Seat 4: JohnSF7 (small blind) folded before Flop
Seat 5: Astro439 (big blind) folded on the Flop
Seat 6: GrinZwe91! folded before Flop (didn't bet)



PokerStars Hand #222963209109:  Hold'em No Limit ($0.05/$0.10 USD) - 2021/01/23 13:17:29 ET
Table 'Bohlinia III' 6-max Seat #4 is the button
Seat 1: xucuo ($16.89 in chips) 
Seat 2: Sve_Sve93 ($10 in chips) 
Seat 3: memojr29 ($14.07 in chips) 
Seat 4: JohnSF7 ($10 in chips) 
Seat 5: Astro439 ($14.41 in chips) 
Seat 6: GrinZwe91! ($17.08 in chips) 
Astro439: posts small blind $0.05
GrinZwe91!: posts big blind $0.10
*** HOLE CARDS ***
xucuo: folds 
Sve_Sve93: folds 
memojr29: folds 
JohnSF7: raises $0.15 to $0.25
Astro439: folds 
GrinZwe91!: calls $0.15
*** FLOP *** [Kh Kc 4s]
GrinZwe91!: checks 
JohnSF7: bets $0.17
GrinZwe91!: calls $0.17
*** TURN *** [Kh Kc 4s] [Tc]
GrinZwe91!: checks 
JohnSF7: checks 
*** RIVER *** [Kh Kc 4s Tc] [Qd]
GrinZwe91!: checks 
JohnSF7: checks 
*** SHOW DOWN ***
GrinZwe91!: shows [7h 7d] (two pair, Kings and Sevens)
JohnSF7: shows [Th As] (two pair, Kings and Tens)
JohnSF7 collected $0.85 from pot
*** SUMMARY ***
Total pot $0.89 | Rake $0.04 
Board [Kh Kc 4s Tc Qd]
Seat 1: xucuo folded before Flop (didn't bet)
Seat 2: Sve_Sve93 folded before Flop (didn't bet)
Seat 3: memojr29 folded before Flop (didn't bet)
Seat 4: JohnSF7 (button) showed [Th As] and won ($0.85) with two pair, Kings and Tens
Seat 5: Astro439 (small blind) folded before Flop
Seat 6: GrinZwe91! (big blind) showed [7h 7d] and lost with two pair, Kings and Sevens



PokerStars Hand #222963237789:  Hold'em No Limit ($0.05/$0.10 USD) - 2021/01/23 13:18:08 ET
Table 'Bohlinia III' 6-max Seat #5 is the button
Seat 1: xucuo ($16.89 in chips) 
Seat 2: Sve_Sve93 ($10 in chips) 
Seat 3: memojr29 ($14.07 in chips) 
Seat 4: JohnSF7 ($10.43 in chips) 
Seat 5: Astro439 ($14.36 in chips) 
Seat 6: GrinZwe91! ($16.66 in chips) 
GrinZwe91!: posts small blind $0.05
xucuo: posts big blind $0.10
*** HOLE CARDS ***
Sve_Sve93: folds 
memojr29: raises $0.20 to $0.30
JohnSF7: folds 
Astro439: folds 
GrinZwe91!: folds 
xucuo: folds 
Uncalled bet ($0.20) returned to memojr29
memojr29 collected $0.25 from pot
memojr29: doesn't show hand 
*** SUMMARY ***
Total pot $0.25 | Rake $0 
Seat 1: xucuo (big blind) folded before Flop
Seat 2: Sve_Sve93 folded before Flop (didn't bet)
Seat 3: memojr29 collected ($0.25)
Seat 4: JohnSF7 folded before Flop (didn't bet)
Seat 5: Astro439 (button) folded before Flop (didn't bet)
Seat 6: GrinZwe91! (small blind) folded before Flop



PokerStars Hand #222963248086:  Hold'em No Limit ($0.05/$0.10 USD) - 2021/01/23 13:18:21 ET
Table 'Bohlinia III' 6-max Seat #6 is the button
Seat 1: xucuo ($16.79 in chips) 
Seat 2: Sve_Sve93 ($10 in chips) 
Seat 3: memojr29 ($14.22 in chips) 
Seat 4: JohnSF7 ($10.43 in chips) 
Seat 5: Astro439 ($14.36 in chips) 
Seat 6: GrinZwe91! ($16.61 in chips) 
xucuo: posts small blind $0.05
Sve_Sve93: posts big blind $0.10
*** HOLE CARDS ***
memojr29: folds 
JohnSF7: folds 
Astro439: folds 
GrinZwe91!: folds 
xucuo: folds 
Uncalled bet ($0.05) returned to Sve_Sve93
Sve_Sve93 collected $0.10 from pot
Sve_Sve93: doesn't show hand 
*** SUMMARY ***
Total pot $0.10 | Rake $0 
Seat 1: xucuo (small blind) folded before Flop
Seat 2: Sve_Sve93 (big blind) collected ($0.10)
Seat 3: memojr29 folded before Flop (didn't bet)
Seat 4: JohnSF7 folded before Flop (didn't bet)
Seat 5: Astro439 folded before Flop (didn't bet)
Seat 6: GrinZwe91! (button) folded before Flop (didn't bet)



PokerStars Hand #222963254950:  Hold'em No Limit ($0.05/$0.10 USD) - 2021/01/23 13:18:30 ET
Table 'Bohlinia III' 6-max Seat #1 is the button
Seat 1: xucuo ($16.74 in chips) 
Seat 2: Sve_Sve93 ($10.05 in chips) 
Seat 3: memojr29 ($14.22 in chips) 
Seat 4: JohnSF7 ($10.43 in chips) 
Seat 5: Astro439 ($14.36 in chips) 
Seat 6: GrinZwe91! ($16.61 in chips) 
Sve_Sve93: posts small blind $0.05
memojr29: posts big blind $0.10
*** HOLE CARDS ***
JohnSF7: folds 
Astro439: raises $0.20 to $0.30
GrinZwe91!: folds 
xucuo: folds 
Sve_Sve93: folds 
memojr29: folds 
Uncalled bet ($0.20) returned to Astro439
Astro439 collected $0.25 from pot
*** SUMMARY ***
Total pot $0.25 | Rake $0 
Seat 1: xucuo (button) folded before Flop (didn't bet)
Seat 2: Sve_Sve93 (small blind) folded before Flop
Seat 3: memojr29 (big blind) folded before Flop
Seat 4: JohnSF7 folded before Flop (didn't bet)
Seat 5: Astro439 collected ($0.25)
Seat 6: GrinZwe91! folded before Flop (didn't bet)



PokerStars Hand #222963268654:  Hold'em No Limit ($0.05/$0.10 USD) - 2021/01/23 13:18:49 ET
Table 'Bohlinia III' 6-max Seat #2 is the button
Seat 1: xucuo ($16.74 in chips) 
Seat 2: Sve_Sve93 ($10 in chips) 
Seat 3: memojr29 ($14.12 in chips) 
Seat 4: JohnSF7 ($10.43 in chips) 
Seat 5: Astro439 ($14.51 in chips) 
Seat 6: GrinZwe91! ($16.61 in chips) 
memojr29: posts small blind $0.05
JohnSF7: posts big blind $0.10
*** HOLE CARDS ***
Astro439: folds 
GrinZwe91!: folds 
xucuo: folds 
Sve_Sve93: folds 
memojr29: raises $0.20 to $0.30
JohnSF7: folds 
Uncalled bet ($0.20) returned to memojr29
memojr29 collected $0.20 from pot
memojr29: doesn't show hand 
*** SUMMARY ***
Total pot $0.20 | Rake $0 
Seat 1: xucuo folded before Flop (didn't bet)
Seat 2: Sve_Sve93 (button) folded before Flop (didn't bet)
Seat 3: memojr29 (small blind) collected ($0.20)
Seat 4: JohnSF7 (big blind) folded before Flop
Seat 5: Astro439 folded before Flop (didn't bet)
Seat 6: GrinZwe91! folded before Flop (didn't bet)



PokerStars Hand #222963280361:  Hold'em No Limit ($0.05/$0.10 USD) - 2021/01/23 13:19:04 ET
Table 'Bohlinia III' 6-max Seat #3 is the button
Seat 1: xucuo ($16.74 in chips) 
Seat 2: Sve_Sve93 ($10 in chips) 
Seat 3: memojr29 ($14.22 in chips) 
Seat 4: JohnSF7 ($10.33 in chips) 
Seat 5: Astro439 ($14.51 in chips) 
Seat 6: GrinZwe91! ($16.61 in chips) 
JohnSF7: posts small blind $0.05
Astro439: posts big blind $0.10
*** HOLE CARDS ***
GrinZwe91!: folds 
xucuo: calls $0.10
Sve_Sve93: folds 
memojr29: raises $0.35 to $0.45
JohnSF7: folds 
Astro439: folds 
xucuo: folds 
Uncalled bet ($0.35) returned to memojr29
memojr29 collected $0.35 from pot
memojr29: doesn't show hand 
*** SUMMARY ***
Total pot $0.35 | Rake $0 
Seat 1: xucuo folded before Flop
Seat 2: Sve_Sve93 folded before Flop (didn't bet)
Seat 3: memojr29 (button) collected ($0.35)
Seat 4: JohnSF7 (small blind) folded before Flop
Seat 5: Astro439 (big blind) folded before Flop
Seat 6: GrinZwe91! folded before Flop (didn't bet)



PokerStars Hand #222963299061:  Hold'em No Limit ($0.05/$0.10 USD) - 2021/01/23 13:19:29 ET
Table 'Bohlinia III' 6-max Seat #4 is the button
Seat 1: xucuo ($16.64 in chips) 
Seat 2: Sve_Sve93 ($10 in chips) 
Seat 3: memojr29 ($14.47 in chips) 
Seat 4: JohnSF7 ($10.28 in chips) 
Seat 5: Astro439 ($14.41 in chips) 
Seat 6: GrinZwe91! ($16.61 in chips) 
Astro439: posts small blind $0.05
GrinZwe91!: posts big blind $0.10
*** HOLE CARDS ***
xucuo: calls $0.10
Sve_Sve93: folds 
memojr29: folds 
JohnSF7: folds 
Astro439: calls $0.05
GrinZwe91!: checks 
*** FLOP *** [Tc As 2d]
Astro439: bets $0.24
GrinZwe91!: calls $0.24
xucuo: folds 
*** TURN *** [Tc As 2d] [7h]
Astro439: checks 
GrinZwe91!: checks 
*** RIVER *** [Tc As 2d 7h] [4d]
Astro439: checks 
GrinZwe91!: bets $0.30
Astro439: calls $0.30
*** SHOW DOWN ***
GrinZwe91!: shows [Ac 9c] (a pair of Aces)
Astro439: mucks hand 
GrinZwe91! collected $1.32 from pot
*** SUMMARY ***
Total pot $1.38 | Rake $0.06 
Board [Tc As 2d 7h 4d]
Seat 1: xucuo folded on the Flop
Seat 2: Sve_Sve93 folded before Flop (didn't bet)
Seat 3: memojr29 folded before Flop (didn't bet)
Seat 4: JohnSF7 (button) folded before Flop (didn't bet)
Seat 5: Astro439 (small blind) mucked
Seat 6: GrinZwe91! (big blind) showed [Ac 9c] and won ($1.32) with a pair of Aces



PokerStars Hand #222963340846:  Hold'em No Limit ($0.05/$0.10 USD) - 2021/01/23 13:20:25 ET
Table 'Bohlinia III' 6-max Seat #5 is the button
Seat 1: xucuo ($16.54 in chips) 
Seat 2: Sve_Sve93 ($10 in chips) 
Seat 3: memojr29 ($14.47 in chips) 
Seat 4: JohnSF7 ($10.28 in chips) 
Seat 5: Astro439 ($13.77 in chips) 
Seat 6: GrinZwe91! ($17.29 in chips) 
GrinZwe91!: posts small blind $0.05
xucuo: posts big blind $0.10
*** HOLE CARDS ***
Sve_Sve93: folds 
memojr29: folds 
JohnSF7: folds 
Astro439: raises $0.20 to $0.30
GrinZwe91!: folds 
xucuo: folds 
Uncalled bet ($0.20) returned to Astro439
Astro439 collected $0.25 from pot
*** SUMMARY ***
Total pot $0.25 | Rake $0 
Seat 1: xucuo (big blind) folded before Flop
Seat 2: Sve_Sve93 folded before Flop (didn't bet)
Seat 3: memojr29 folded before Flop (didn't bet)
Seat 4: JohnSF7 folded before Flop (didn't bet)
Seat 5: Astro439 (button) collected ($0.25)
Seat 6: GrinZwe91! (small blind) folded before Flop



PokerStars Hand #222963354153:  Hold'em No Limit ($0.05/$0.10 USD) - 2021/01/23 13:20:43 ET
Table 'Bohlinia III' 6-max Seat #6 is the button
Seat 1: xucuo ($16.44 in chips) 
Seat 2: Sve_Sve93 ($10 in chips) 
Seat 3: memojr29 ($14.47 in chips) 
Seat 4: JohnSF7 ($10.28 in chips) 
Seat 5: Astro439 ($13.92 in chips) 
Seat 6: GrinZwe91! ($17.24 in chips) 
xucuo: posts small blind $0.05
Sve_Sve93: posts big blind $0.10
*** HOLE CARDS ***
memojr29: folds 
JohnSF7: folds 
Astro439: folds 
GrinZwe91!: folds 
xucuo: folds 
Uncalled bet ($0.05) returned to Sve_Sve93
Sve_Sve93 collected $0.10 from pot
Sve_Sve93: doesn't show hand 
*** SUMMARY ***
Total pot $0.10 | Rake $0 
Seat 1: xucuo (small blind) folded before Flop
Seat 2: Sve_Sve93 (big blind) collected ($0.10)
Seat 3: memojr29 folded before Flop (didn't bet)
Seat 4: JohnSF7 folded before Flop (didn't bet)
Seat 5: Astro439 folded before Flop (didn't bet)
Seat 6: GrinZwe91! (button) folded before Flop (didn't bet)



PokerStars Hand #222963360551:  Hold'em No Limit ($0.05/$0.10 USD) - 2021/01/23 13:20:51 ET
Table 'Bohlinia III' 6-max Seat #1 is the button
Seat 1: xucuo ($16.39 in chips) 
Seat 2: Sve_Sve93 ($10.05 in chips) 
Seat 3: memojr29 ($14.47 in chips) 
Seat 4: JohnSF7 ($10.28 in chips) 
Seat 5: Astro439 ($13.92 in chips) 
Seat 6: GrinZwe91! ($17.24 in chips) 
Sve_Sve93: posts small blind $0.05
memojr29: posts big blind $0.10
*** HOLE CARDS ***
JohnSF7: folds 
Astro439: folds 
GrinZwe91!: folds 
xucuo: folds 
Sve_Sve93: folds 
Uncalled bet ($0.05) returned to memojr29
memojr29 collected $0.10 from pot
*** SUMMARY ***
Total pot $0.10 | Rake $0 
Seat 1: xucuo (button) folded before Flop (didn't bet)
Seat 2: Sve_Sve93 (small blind) folded before Flop
Seat 3: memojr29 (big blind) collected ($0.10)
Seat 4: JohnSF7 folded before Flop (didn't bet)
Seat 5: Astro439 folded before Flop (didn't bet)
Seat 6: GrinZwe91! folded before Flop (didn't bet)



PokerStars Hand #222963376591:  Hold'em No Limit ($0.05/$0.10 USD) - 2021/01/23 13:21:13 ET
Table 'Bohlinia III' 6-max Seat #2 is the button
Seat 1: xucuo ($16.39 in chips) 
Seat 2: Sve_Sve93 ($10 in chips) 
Seat 3: memojr29 ($14.52 in chips) 
Seat 4: JohnSF7 ($10.28 in chips) 
Seat 5: Astro439 ($13.92 in chips) 
Seat 6: GrinZwe91! ($17.24 in chips) 
memojr29: posts small blind $0.05
JohnSF7: posts big blind $0.10
*** HOLE CARDS ***
Astro439: folds 
GrinZwe91!: folds 
xucuo: folds 
Sve_Sve93: folds 
memojr29: raises $0.20 to $0.30
JohnSF7: raises $0.70 to $1
memojr29: folds 
Uncalled bet ($0.70) returned to JohnSF7
JohnSF7 collected $0.60 from pot
JohnSF7: doesn't show hand 
*** SUMMARY ***
Total pot $0.60 | Rake $0 
Seat 1: xucuo folded before Flop (didn't bet)
Seat 2: Sve_Sve93 (button) folded before Flop (didn't bet)
Seat 3: memojr29 (small blind) folded before Flop
Seat 4: JohnSF7 (big blind) collected ($0.60)
Seat 5: Astro439 folded before Flop (didn't bet)
Seat 6: GrinZwe91! folded before Flop (didn't bet)



PokerStars Hand #222963401574:  Hold'em No Limit ($0.05/$0.10 USD) - 2021/01/23 13:21:46 ET
Table 'Bohlinia III' 6-max Seat #3 is the button
Seat 1: xucuo ($16.39 in chips) 
Seat 2: Sve_Sve93 ($10 in chips) 
Seat 3: memojr29 ($14.22 in chips) 
Seat 4: JohnSF7 ($10.58 in chips) 
Seat 5: Astro439 ($13.92 in chips) 
Seat 6: GrinZwe91! ($17.24 in chips) 
JohnSF7: posts small blind $0.05
Astro439: posts big blind $0.10
*** HOLE CARDS ***
GrinZwe91!: folds 
xucuo: folds 
Sve_Sve93: folds 
memojr29: raises $0.15 to $0.25
JohnSF7: folds 
Astro439: folds 
Uncalled bet ($0.15) returned to memojr29
memojr29 collected $0.25 from pot
memojr29: doesn't show hand 
*** SUMMARY ***
Total pot $0.25 | Rake $0 
Seat 1: xucuo folded before Flop (didn't bet)
Seat 2: Sve_Sve93 folded before Flop (didn't bet)
Seat 3: memojr29 (button) collected ($0.25)
Seat 4: JohnSF7 (small blind) folded before Flop
Seat 5: Astro439 (big blind) folded before Flop
Seat 6: GrinZwe91! folded before Flop (didn't bet)



PokerStars Hand #222963417678:  Hold'em No Limit ($0.05/$0.10 USD) - 2021/01/23 13:22:07 ET
Table 'Bohlinia III' 6-max Seat #4 is the button
Seat 1: xucuo ($16.39 in chips) 
Seat 2: Sve_Sve93 ($10 in chips) 
Seat 3: memojr29 ($14.37 in chips) 
Seat 4: JohnSF7 ($10.53 in chips) 
Seat 5: Astro439 ($13.82 in chips) 
Seat 6: GrinZwe91! ($17.24 in chips) 
Astro439: posts small blind $0.05
GrinZwe91!: posts big blind $0.10
*** HOLE CARDS ***
xucuo: raises $0.20 to $0.30
Sve_Sve93: raises $0.70 to $1
memojr29: folds 
JohnSF7: folds 
Astro439: folds 
GrinZwe91!: folds 
xucuo: calls $0.70
*** FLOP *** [Jh Kd Qd]
xucuo: checks 
Sve_Sve93: bets $1.03
xucuo: calls $1.03
*** TURN *** [Jh Kd Qd] [5h]
xucuo: checks 
Sve_Sve93: bets $2.70
xucuo: calls $2.70
*** RIVER *** [Jh Kd Qd 5h] [Ad]
xucuo: checks 
Sve_Sve93: checks 
*** SHOW DOWN ***
xucuo: shows [Ks As] (two pair, Aces and Kings)
Sve_Sve93: shows [Qh Qc] (three of a kind, Queens)
Sve_Sve93 collected $9.18 from pot
*** SUMMARY ***
Total pot $9.61 | Rake $0.43 
Board [Jh Kd Qd 5h Ad]
Seat 1: xucuo showed [Ks As] and lost with two pair, Aces and Kings
Seat 2: Sve_Sve93 showed [Qh Qc] and won ($9.18) with three of a kind, Queens
Seat 3: memojr29 folded before Flop (didn't bet)
Seat 4: JohnSF7 (button) folded before Flop (didn't bet)
Seat 5: Astro439 (small blind) folded before Flop
Seat 6: GrinZwe91! (big blind) folded before Flop



PokerStars Hand #222963468200:  Hold'em No Limit ($0.05/$0.10 USD) - 2021/01/23 13:23:14 ET
Table 'Bohlinia III' 6-max Seat #5 is the button
Seat 1: xucuo ($11.66 in chips) 
Seat 2: Sve_Sve93 ($14.45 in chips) 
Seat 3: memojr29 ($14.37 in chips) 
Seat 4: JohnSF7 ($10.53 in chips) 
Seat 5: Astro439 ($13.77 in chips) 
Seat 6: GrinZwe91! ($17.14 in chips) 
GrinZwe91!: posts small blind $0.05
xucuo: posts big blind $0.10
*** HOLE CARDS ***
Sve_Sve93: folds 
memojr29: raises $0.20 to $0.30
JohnSF7: folds 
Astro439: raises $0.60 to $0.90
GrinZwe91!: folds 
xucuo: folds 
memojr29: folds 
Uncalled bet ($0.60) returned to Astro439
Astro439 collected $0.75 from pot
*** SUMMARY ***
Total pot $0.75 | Rake $0 
Seat 1: xucuo (big blind) folded before Flop
Seat 2: Sve_Sve93 folded before Flop (didn't bet)
Seat 3: memojr29 folded before Flop
Seat 4: JohnSF7 folded before Flop (didn't bet)
Seat 5: Astro439 (button) collected ($0.75)
Seat 6: GrinZwe91! (small blind) folded before Flop



PokerStars Hand #222963493053:  Hold'em No Limit ($0.05/$0.10 USD) - 2021/01/23 13:23:47 ET
Table 'Bohlinia III' 6-max Seat #6 is the button
Seat 1: xucuo ($11.56 in chips) 
Seat 2: Sve_Sve93 ($14.45 in chips) 
Seat 3: memojr29 ($14.07 in chips) 
Seat 4: JohnSF7 ($10.53 in chips) 
Seat 5: Astro439 ($14.22 in chips) 
Seat 6: GrinZwe91! ($17.09 in chips) 
xucuo: posts small blind $0.05
Sve_Sve93: posts big blind $0.10
*** HOLE CARDS ***
memojr29: folds 
JohnSF7: raises $0.15 to $0.25
Astro439: folds 
GrinZwe91!: folds 
xucuo: folds 
Sve_Sve93: folds 
Uncalled bet ($0.15) returned to JohnSF7
JohnSF7 collected $0.25 from pot
JohnSF7: doesn't show hand 
*** SUMMARY ***
Total pot $0.25 | Rake $0 
Seat 1: xucuo (small blind) folded before Flop
Seat 2: Sve_Sve93 (big blind) folded before Flop
Seat 3: memojr29 folded before Flop (didn't bet)
Seat 4: JohnSF7 collected ($0.25)
Seat 5: Astro439 folded before Flop (didn't bet)
Seat 6: GrinZwe91! (button) folded before Flop (didn't bet)



PokerStars Hand #222963507092:  Hold'em No Limit ($0.05/$0.10 USD) - 2021/01/23 13:24:05 ET
Table 'Bohlinia III' 6-max Seat #1 is the button
Seat 1: xucuo ($11.51 in chips) 
Seat 2: Sve_Sve93 ($14.35 in chips) 
Seat 3: memojr29 ($14.07 in chips) 
Seat 4: JohnSF7 ($10.68 in chips) 
Seat 5: Astro439 ($14.22 in chips) 
Seat 6: GrinZwe91! ($17.09 in chips) 
Sve_Sve93: posts small blind $0.05
memojr29: posts big blind $0.10
*** HOLE CARDS ***
JohnSF7: folds 
Astro439: folds 
GrinZwe91!: folds 
xucuo: folds 
Sve_Sve93: raises $0.20 to $0.30
memojr29: folds 
Uncalled bet ($0.20) returned to Sve_Sve93
Sve_Sve93 collected $0.20 from pot
Sve_Sve93: doesn't show hand 
*** SUMMARY ***
Total pot $0.20 | Rake $0 
Seat 1: xucuo (button) folded before Flop (didn't bet)
Seat 2: Sve_Sve93 (small blind) collected ($0.20)
Seat 3: memojr29 (big blind) folded before Flop
Seat 4: JohnSF7 folded before Flop (didn't bet)
Seat 5: Astro439 folded before Flop (didn't bet)
Seat 6: GrinZwe91! folded before Flop (didn't bet)



PokerStars Hand #222963518590:  Hold'em No Limit ($0.05/$0.10 USD) - 2021/01/23 13:24:21 ET
Table 'Bohlinia III' 6-max Seat #2 is the button
Seat 1: xucuo ($11.51 in chips) 
Seat 2: Sve_Sve93 ($14.45 in chips) 
Seat 3: memojr29 ($13.97 in chips) 
Seat 4: JohnSF7 ($10.68 in chips) 
Seat 5: Astro439 ($14.22 in chips) 
Seat 6: GrinZwe91! ($17.09 in chips) 
memojr29: posts small blind $0.05
JohnSF7: posts big blind $0.10
*** HOLE CARDS ***
Astro439: raises $0.20 to $0.30
GrinZwe91!: folds 
xucuo: folds 
Sve_Sve93: folds 
memojr29: folds 
JohnSF7: raises $0.90 to $1.20
Astro439: folds 
Uncalled bet ($0.90) returned to JohnSF7
JohnSF7 collected $0.65 from pot
JohnSF7: doesn't show hand 
*** SUMMARY ***
Total pot $0.65 | Rake $0 
Seat 1: xucuo folded before Flop (didn't bet)
Seat 2: Sve_Sve93 (button) folded before Flop (didn't bet)
Seat 3: memojr29 (small blind) folded before Flop
Seat 4: JohnSF7 (big blind) collected ($0.65)
Seat 5: Astro439 folded before Flop
Seat 6: GrinZwe91! folded before Flop (didn't bet)



PokerStars Hand #222963539476:  Hold'em No Limit ($0.05/$0.10 USD) - 2021/01/23 13:24:48 ET
Table 'Bohlinia III' 6-max Seat #3 is the button
Seat 1: xucuo ($11.51 in chips) 
Seat 2: Sve_Sve93 ($14.45 in chips) 
Seat 3: memojr29 ($13.92 in chips) 
Seat 4: JohnSF7 ($11.03 in chips) 
Seat 5: Astro439 ($13.92 in chips) 
Seat 6: GrinZwe91! ($17.09 in chips) 
JohnSF7: posts small blind $0.05
Astro439: posts big blind $0.10
*** HOLE CARDS ***
GrinZwe91!: folds 
xucuo: folds 
Sve_Sve93: folds 
memojr29: folds 
JohnSF7: folds 
Uncalled bet ($0.05) returned to Astro439
Astro439 collected $0.10 from pot
*** SUMMARY ***
Total pot $0.10 | Rake $0 
Seat 1: xucuo folded before Flop (didn't bet)
Seat 2: Sve_Sve93 folded before Flop (didn't bet)
Seat 3: memojr29 (button) folded before Flop (didn't bet)
Seat 4: JohnSF7 (small blind) folded before Flop
Seat 5: Astro439 (big blind) collected ($0.10)
Seat 6: GrinZwe91! folded before Flop (didn't bet)



PokerStars Hand #222963549177:  Hold'em No Limit ($0.05/$0.10 USD) - 2021/01/23 13:25:01 ET
Table 'Bohlinia III' 6-max Seat #4 is the button
Seat 1: xucuo ($11.51 in chips) 
Seat 2: Sve_Sve93 ($14.45 in chips) 
Seat 3: memojr29 ($13.92 in chips) 
Seat 4: JohnSF7 ($10.98 in chips) 
Seat 5: Astro439 ($13.97 in chips) 
Seat 6: GrinZwe91! ($17.09 in chips) 
Astro439: posts small blind $0.05
GrinZwe91!: posts big blind $0.10
*** HOLE CARDS ***
xucuo: calls $0.10
Sve_Sve93: folds 
memojr29: folds 
JohnSF7: folds 
Astro439: folds 
GrinZwe91!: checks 
*** FLOP *** [Ts 7h 6d]
GrinZwe91!: checks 
xucuo: bets $0.12
GrinZwe91!: folds 
Uncalled bet ($0.12) returned to xucuo
xucuo collected $0.24 from pot
xucuo: doesn't show hand 
*** SUMMARY ***
Total pot $0.25 | Rake $0.01 
Board [Ts 7h 6d]
Seat 1: xucuo collected ($0.24)
Seat 2: Sve_Sve93 folded before Flop (didn't bet)
Seat 3: memojr29 folded before Flop (didn't bet)
Seat 4: JohnSF7 (button) folded before Flop (didn't bet)
Seat 5: Astro439 (small blind) folded before Flop
Seat 6: GrinZwe91! (big blind) folded on the Flop



PokerStars Hand #222963566194:  Hold'em No Limit ($0.05/$0.10 USD) - 2021/01/23 13:25:24 ET
Table 'Bohlinia III' 6-max Seat #5 is the button
Seat 1: xucuo ($11.65 in chips) 
Seat 2: Sve_Sve93 ($14.45 in chips) 
Seat 3: memojr29 ($13.92 in chips) 
Seat 4: JohnSF7 ($10.98 in chips) 
Seat 5: Astro439 ($13.92 in chips) 
Seat 6: GrinZwe91! ($16.99 in chips) 
GrinZwe91!: posts small blind $0.05
xucuo: posts big blind $0.10
*** HOLE CARDS ***
Sve_Sve93: folds 
memojr29: raises $0.20 to $0.30
JohnSF7: folds 
Astro439: folds 
GrinZwe91!: folds 
xucuo: calls $0.20
*** FLOP *** [6d 2s Qc]
xucuo: checks 
memojr29: bets $0.31
xucuo: calls $0.31
*** TURN *** [6d 2s Qc] [Qh]
xucuo: checks 
memojr29: bets $0.61
xucuo: calls $0.61
*** RIVER *** [6d 2s Qc Qh] [9s]
xucuo: bets $1.30
memojr29: folds 
Uncalled bet ($1.30) returned to xucuo
xucuo collected $2.38 from pot
xucuo: doesn't show hand 
*** SUMMARY ***
Total pot $2.49 | Rake $0.11 
Board [6d 2s Qc Qh 9s]
Seat 1: xucuo (big blind) collected ($2.38)
Seat 2: Sve_Sve93 folded before Flop (didn't bet)
Seat 3: memojr29 folded on the River
Seat 4: JohnSF7 folded before Flop (didn't bet)
Seat 5: Astro439 (button) folded before Flop (didn't bet)
Seat 6: GrinZwe91! (small blind) folded before Flop



PokerStars Hand #222963622163:  Hold'em No Limit ($0.05/$0.10 USD) - 2021/01/23 13:26:38 ET
Table 'Bohlinia III' 6-max Seat #6 is the button
Seat 1: xucuo ($12.81 in chips) 
Seat 2: Sve_Sve93 ($14.45 in chips) 
Seat 3: memojr29 ($12.70 in chips) 
Seat 4: JohnSF7 ($10.98 in chips) 
Seat 5: Astro439 ($13.92 in chips) 
Seat 6: GrinZwe91! ($16.94 in chips) 
xucuo: posts small blind $0.05
Sve_Sve93: posts big blind $0.10
*** HOLE CARDS ***
memojr29: folds 
JohnSF7: folds 
Astro439: raises $0.20 to $0.30
GrinZwe91!: folds 
xucuo: calls $0.25
Sve_Sve93: folds 
*** FLOP *** [5c Jh 3s]
xucuo: checks 
Astro439: bets $0.43
xucuo: folds 
Uncalled bet ($0.43) returned to Astro439
Astro439 collected $0.67 from pot
*** SUMMARY ***
Total pot $0.70 | Rake $0.03 
Board [5c Jh 3s]
Seat 1: xucuo (small blind) folded on the Flop
Seat 2: Sve_Sve93 (big blind) folded before Flop
Seat 3: memojr29 folded before Flop (didn't bet)
Seat 4: JohnSF7 folded before Flop (didn't bet)
Seat 5: Astro439 collected ($0.67)
Seat 6: GrinZwe91! (button) folded before Flop (didn't bet)



PokerStars Hand #222963649752:  Hold'em No Limit ($0.05/$0.10 USD) - 2021/01/23 13:27:14 ET
Table 'Bohlinia III' 6-max Seat #1 is the button
Seat 1: xucuo ($12.51 in chips) 
Seat 2: Sve_Sve93 ($14.35 in chips) 
Seat 3: memojr29 ($12.70 in chips) 
Seat 4: JohnSF7 ($10.98 in chips) 
Seat 5: Astro439 ($14.29 in chips) 
Seat 6: GrinZwe91! ($16.94 in chips) 
Sve_Sve93: posts small blind $0.05
memojr29: posts big blind $0.10
*** HOLE CARDS ***
JohnSF7: folds 
Astro439: folds 
GrinZwe91!: folds 
xucuo: calls $0.10
Sve_Sve93: folds 
memojr29: checks 
*** FLOP *** [9c Jc Jd]
memojr29: checks 
xucuo: checks 
*** TURN *** [9c Jc Jd] [2h]
memojr29: checks 
xucuo: checks 
*** RIVER *** [9c Jc Jd 2h] [Jh]
memojr29: checks 
xucuo: bets $0.24
memojr29: folds 
Uncalled bet ($0.24) returned to xucuo
xucuo collected $0.24 from pot
xucuo: doesn't show hand 
*** SUMMARY ***
Total pot $0.25 | Rake $0.01 
Board [9c Jc Jd 2h Jh]
Seat 1: xucuo (button) collected ($0.24)
Seat 2: Sve_Sve93 (small blind) folded before Flop
Seat 3: memojr29 (big blind) folded on the River
Seat 4: JohnSF7 folded before Flop (didn't bet)
Seat 5: Astro439 folded before Flop (didn't bet)
Seat 6: GrinZwe91! folded before Flop (didn't bet)



PokerStars Hand #222963669323:  Hold'em No Limit ($0.05/$0.10 USD) - 2021/01/23 13:27:40 ET
Table 'Bohlinia III' 6-max Seat #2 is the button
Seat 1: xucuo ($12.65 in chips) 
Seat 2: Sve_Sve93 ($14.30 in chips) 
Seat 3: memojr29 ($12.60 in chips) 
Seat 4: JohnSF7 ($10.98 in chips) 
Seat 5: Astro439 ($14.29 in chips) 
Seat 6: GrinZwe91! ($16.94 in chips) 
memojr29: posts small blind $0.05
JohnSF7: posts big blind $0.10
*** HOLE CARDS ***
Astro439: folds 
GrinZwe91!: folds 
xucuo: calls $0.10
Sve_Sve93: folds 
memojr29: raises $0.40 to $0.50
JohnSF7: folds 
xucuo: calls $0.40
*** FLOP *** [Td As 4d]
memojr29: bets $0.69
xucuo: calls $0.69
*** TURN *** [Td As 4d] [3c]
memojr29: bets $2.10
xucuo: folds 
Uncalled bet ($2.10) returned to memojr29
memojr29 collected $2.37 from pot
memojr29: doesn't show hand 
*** SUMMARY ***
Total pot $2.48 | Rake $0.11 
Board [Td As 4d 3c]
Seat 1: xucuo folded on the Turn
Seat 2: Sve_Sve93 (button) folded before Flop (didn't bet)
Seat 3: memojr29 (small blind) collected ($2.37)
Seat 4: JohnSF7 (big blind) folded before Flop
Seat 5: Astro439 folded before Flop (didn't bet)
Seat 6: GrinZwe91! folded before Flop (didn't bet)



PokerStars Hand #222963695126:  Hold'em No Limit ($0.05/$0.10 USD) - 2021/01/23 13:28:14 ET
Table 'Bohlinia III' 6-max Seat #3 is the button
Seat 1: xucuo ($11.46 in chips) 
Seat 2: Sve_Sve93 ($14.30 in chips) 
Seat 3: memojr29 ($13.78 in chips) 
Seat 4: JohnSF7 ($10.88 in chips) 
Seat 6: GrinZwe91! ($16.94 in chips) 
JohnSF7: posts small blind $0.05
Astro439: is sitting out 
GrinZwe91!: posts big blind $0.10
*** HOLE CARDS ***
xucuo: calls $0.10
Astro439 leaves the table
Sve_Sve93: folds 
memojr29: folds 
JohnSF7: raises $0.40 to $0.50
GrinZwe91!: folds 
xucuo: calls $0.40
*** FLOP *** [3s Qd 9d]
Valhalla1976 joins the table at seat #5 
JohnSF7: bets $0.58
xucuo: calls $0.58
*** TURN *** [3s Qd 9d] [7s]
JohnSF7: bets $1.19
xucuo: calls $1.19
*** RIVER *** [3s Qd 9d 7s] [9c]
JohnSF7: bets $2.44
xucuo: raises $2.44 to $4.88
JohnSF7: calls $2.44
*** SHOW DOWN ***
xucuo: shows [Th 9h] (three of a kind, Nines)
JohnSF7: mucks hand 
xucuo collected $13.75 from pot
*** SUMMARY ***
Total pot $14.40 | Rake $0.65 
Board [3s Qd 9d 7s 9c]
Seat 1: xucuo showed [Th 9h] and won ($13.75) with three of a kind, Nines
Seat 2: Sve_Sve93 folded before Flop (didn't bet)
Seat 3: memojr29 (button) folded before Flop (didn't bet)
Seat 4: JohnSF7 (small blind) mucked
Seat 6: GrinZwe91! (big blind) folded before Flop



PokerStars Hand #222963728343:  Hold'em No Limit ($0.05/$0.10 USD) - 2021/01/23 13:28:58 ET
Table 'Bohlinia III' 6-max Seat #4 is the button
Seat 1: xucuo ($18.06 in chips) 
Seat 2: Sve_Sve93 ($14.30 in chips) 
Seat 3: memojr29 ($13.78 in chips) 
Seat 4: JohnSF7 ($10 in chips) 
Seat 6: GrinZwe91! ($16.84 in chips) 
GrinZwe91!: posts small blind $0.05
xucuo: posts big blind $0.10
*** HOLE CARDS ***
Sve_Sve93: folds 
memojr29: folds 
JohnSF7: raises $0.15 to $0.25
GrinZwe91!: folds 
xucuo: calls $0.15
*** FLOP *** [9d 7d 6d]
xucuo: checks 
JohnSF7: bets $0.29
xucuo: folds 
Uncalled bet ($0.29) returned to JohnSF7
JohnSF7 collected $0.53 from pot
JohnSF7: doesn't show hand 
*** SUMMARY ***
Total pot $0.55 | Rake $0.02 
Board [9d 7d 6d]
Seat 1: xucuo (big blind) folded on the Flop
Seat 2: Sve_Sve93 folded before Flop (didn't bet)
Seat 3: memojr29 folded before Flop (didn't bet)
Seat 4: JohnSF7 (button) collected ($0.53)
Seat 6: GrinZwe91! (small blind) folded before Flop



PokerStars Hand #222963742839:  Hold'em No Limit ($0.05/$0.10 USD) - 2021/01/23 13:29:17 ET
Table 'Bohlinia III' 6-max Seat #6 is the button
Seat 1: xucuo ($17.81 in chips) 
Seat 2: Sve_Sve93 ($14.30 in chips) 
Seat 3: memojr29 ($13.78 in chips) 
Seat 4: JohnSF7 ($10.28 in chips) 
Seat 5: Valhalla1976 ($10 in chips) 
Seat 6: GrinZwe91! ($16.79 in chips) 
xucuo: posts small blind $0.05
Sve_Sve93: posts big blind $0.10
Valhalla1976: posts big blind $0.10
*** HOLE CARDS ***
memojr29: folds 
JohnSF7: raises $0.30 to $0.40
Valhalla1976: calls $0.30
GrinZwe91!: folds 
xucuo: calls $0.35
Sve_Sve93: folds 
*** FLOP *** [5c 7h 7s]
xucuo: checks 
JohnSF7: bets $0.68
Valhalla1976: folds 
xucuo: calls $0.68
*** TURN *** [5c 7h 7s] [Kh]
xucuo: bets $1.27
JohnSF7: calls $1.27
*** RIVER *** [5c 7h 7s Kh] [3d]
xucuo: checks 
JohnSF7: checks 
*** SHOW DOWN ***
xucuo: shows [Jh Jd] (two pair, Jacks and Sevens)
JohnSF7: mucks hand 
xucuo collected $4.97 from pot
*** SUMMARY ***
Total pot $5.20 | Rake $0.23 
Board [5c 7h 7s Kh 3d]
Seat 1: xucuo (small blind) showed [Jh Jd] and won ($4.97) with two pair, Jacks and Sevens
Seat 2: Sve_Sve93 (big blind) folded before Flop
Seat 3: memojr29 folded before Flop (didn't bet)
Seat 4: JohnSF7 mucked
Seat 5: Valhalla1976 folded on the Flop
Seat 6: GrinZwe91! (button) folded before Flop (didn't bet)



PokerStars Hand #222963774802:  Hold'em No Limit ($0.05/$0.10 USD) - 2021/01/23 13:30:00 ET
Table 'Bohlinia III' 6-max Seat #1 is the button
Seat 1: xucuo ($20.43 in chips) 
Seat 2: Sve_Sve93 ($14.20 in chips) 
Seat 3: memojr29 ($13.78 in chips) 
Seat 4: JohnSF7 ($10 in chips) 
Seat 5: Valhalla1976 ($9.60 in chips) 
Seat 6: GrinZwe91! ($16.79 in chips) 
Sve_Sve93: posts small blind $0.05
memojr29: posts big blind $0.10
*** HOLE CARDS ***
JohnSF7: folds 
Valhalla1976: raises $0.10 to $0.20
GrinZwe91!: raises $0.70 to $0.90
xucuo: folds 
Sve_Sve93: folds 
memojr29: folds 
Valhalla1976: folds 
Uncalled bet ($0.70) returned to GrinZwe91!
GrinZwe91! collected $0.55 from pot
GrinZwe91!: doesn't show hand 
*** SUMMARY ***
Total pot $0.55 | Rake $0 
Seat 1: xucuo (button) folded before Flop (didn't bet)
Seat 2: Sve_Sve93 (small blind) folded before Flop
Seat 3: memojr29 (big blind) folded before Flop
Seat 4: JohnSF7 folded before Flop (didn't bet)
Seat 5: Valhalla1976 folded before Flop
Seat 6: GrinZwe91! collected ($0.55)



PokerStars Hand #222963792575:  Hold'em No Limit ($0.05/$0.10 USD) - 2021/01/23 13:30:22 ET
Table 'Bohlinia III' 6-max Seat #2 is the button
Seat 1: xucuo ($20.43 in chips) 
Seat 2: Sve_Sve93 ($14.15 in chips) 
Seat 3: memojr29 ($13.68 in chips) 
Seat 4: JohnSF7 ($10 in chips) 
Seat 5: Valhalla1976 ($9.40 in chips) 
Seat 6: GrinZwe91! ($17.14 in chips) 
memojr29: posts small blind $0.05
JohnSF7: posts big blind $0.10
*** HOLE CARDS ***
Valhalla1976: calls $0.10
GrinZwe91!: folds 
xucuo: calls $0.10
Sve_Sve93: folds 
memojr29: raises $0.70 to $0.80
JohnSF7: folds 
Valhalla1976: folds 
xucuo: folds 
Uncalled bet ($0.70) returned to memojr29
memojr29 collected $0.40 from pot
memojr29: doesn't show hand 
*** SUMMARY ***
Total pot $0.40 | Rake $0 
Seat 1: xucuo folded before Flop
Seat 2: Sve_Sve93 (button) folded before Flop (didn't bet)
Seat 3: memojr29 (small blind) collected ($0.40)
Seat 4: JohnSF7 (big blind) folded before Flop
Seat 5: Valhalla1976 folded before Flop
Seat 6: GrinZwe91! folded before Flop (didn't bet)



PokerStars Hand #222963807229:  Hold'em No Limit ($0.05/$0.10 USD) - 2021/01/23 13:30:41 ET
Table 'Bohlinia III' 6-max Seat #3 is the button
Seat 1: xucuo ($20.33 in chips) 
Seat 2: Sve_Sve93 ($14.15 in chips) 
Seat 3: memojr29 ($13.98 in chips) 
Seat 4: JohnSF7 ($10 in chips) 
Seat 5: Valhalla1976 ($9.30 in chips) 
Seat 6: GrinZwe91! ($17.14 in chips) 
JohnSF7: posts small blind $0.05
Valhalla1976: posts big blind $0.10
*** HOLE CARDS ***
GrinZwe91!: folds 
xucuo: folds 
Sve_Sve93: folds 
memojr29: folds 
JohnSF7: folds 
Uncalled bet ($0.05) returned to Valhalla1976
Valhalla1976 collected $0.10 from pot
Valhalla1976: doesn't show hand 
*** SUMMARY ***
Total pot $0.10 | Rake $0 
Seat 1: xucuo folded before Flop (didn't bet)
Seat 2: Sve_Sve93 folded before Flop (didn't bet)
Seat 3: memojr29 (button) folded before Flop (didn't bet)
Seat 4: JohnSF7 (small blind) folded before Flop
Seat 5: Valhalla1976 (big blind) collected ($0.10)
Seat 6: GrinZwe91! folded before Flop (didn't bet)



PokerStars Hand #222963815752:  Hold'em No Limit ($0.05/$0.10 USD) - 2021/01/23 13:30:52 ET
Table 'Bohlinia III' 6-max Seat #4 is the button
Seat 1: xucuo ($20.33 in chips) 
Seat 2: Sve_Sve93 ($14.15 in chips) 
Seat 3: memojr29 ($13.98 in chips) 
Seat 4: JohnSF7 ($10 in chips) 
Seat 5: Valhalla1976 ($9.35 in chips) 
Seat 6: GrinZwe91! ($17.14 in chips) 
Valhalla1976: posts small blind $0.05
GrinZwe91!: posts big blind $0.10
*** HOLE CARDS ***
xucuo: calls $0.10
Sve_Sve93: folds 
memojr29: folds 
JohnSF7: folds 
Valhalla1976: calls $0.05
GrinZwe91!: checks 
*** FLOP *** [Ac Jh 8c]
Valhalla1976: bets $0.10
GrinZwe91!: folds 
xucuo: folds 
Uncalled bet ($0.10) returned to Valhalla1976
Valhalla1976 collected $0.29 from pot
Valhalla1976: doesn't show hand 
*** SUMMARY ***
Total pot $0.30 | Rake $0.01 
Board [Ac Jh 8c]
Seat 1: xucuo folded on the Flop
Seat 2: Sve_Sve93 folded before Flop (didn't bet)
Seat 3: memojr29 folded before Flop (didn't bet)
Seat 4: JohnSF7 (button) folded before Flop (didn't bet)
Seat 5: Valhalla1976 (small blind) collected ($0.29)
Seat 6: GrinZwe91! (big blind) folded on the Flop



PokerStars Hand #222963834192:  Hold'em No Limit ($0.05/$0.10 USD) - 2021/01/23 13:31:16 ET
Table 'Bohlinia III' 6-max Seat #5 is the button
Seat 1: xucuo ($20.23 in chips) 
Seat 2: Sve_Sve93 ($14.15 in chips) 
Seat 3: memojr29 ($13.98 in chips) 
Seat 5: Valhalla1976 ($9.54 in chips) 
Seat 6: GrinZwe91! ($17.04 in chips) 
GrinZwe91!: posts small blind $0.05
xucuo: posts big blind $0.10
*** HOLE CARDS ***
Sve_Sve93: folds 
memojr29: folds 
Valhalla1976: raises $0.20 to $0.30
GrinZwe91!: folds 
xucuo: calls $0.20
*** FLOP *** [Jd 5h 6h]
xucuo: checks 
Valhalla1976: bets $0.31
xucuo: raises $0.31 to $0.62
Valhalla1976: calls $0.31
*** TURN *** [Jd 5h 6h] [8c]
xucuo: bets $0.90
Valhalla1976: calls $0.90
*** RIVER *** [Jd 5h 6h 8c] [2s]
xucuo: bets $1.76
Valhalla1976: folds 
Uncalled bet ($1.76) returned to xucuo
xucuo collected $3.52 from pot
xucuo: doesn't show hand 
*** SUMMARY ***
Total pot $3.69 | Rake $0.17 
Board [Jd 5h 6h 8c 2s]
Seat 1: xucuo (big blind) collected ($3.52)
Seat 2: Sve_Sve93 folded before Flop (didn't bet)
Seat 3: memojr29 folded before Flop (didn't bet)
Seat 5: Valhalla1976 (button) folded on the River
Seat 6: GrinZwe91! (small blind) folded before Flop



PokerStars Hand #222963863397:  Hold'em No Limit ($0.05/$0.10 USD) - 2021/01/23 13:31:53 ET
Table 'Bohlinia III' 6-max Seat #6 is the button
Seat 1: xucuo ($21.93 in chips) 
Seat 2: Sve_Sve93 ($14.15 in chips) 
Seat 3: memojr29 ($13.98 in chips) 
Seat 5: Valhalla1976 ($7.72 in chips) 
Seat 6: GrinZwe91! ($16.99 in chips) 
xucuo: posts small blind $0.05
Sve_Sve93: posts big blind $0.10
*** HOLE CARDS ***
memojr29: raises $0.20 to $0.30
Valhalla1976: folds 
GrinZwe91!: folds 
xucuo: folds 
Sve_Sve93: folds 
Uncalled bet ($0.20) returned to memojr29
memojr29 collected $0.25 from pot
memojr29: doesn't show hand 
*** SUMMARY ***
Total pot $0.25 | Rake $0 
Seat 1: xucuo (small blind) folded before Flop
Seat 2: Sve_Sve93 (big blind) folded before Flop
Seat 3: memojr29 collected ($0.25)
Seat 5: Valhalla1976 folded before Flop (didn't bet)
Seat 6: GrinZwe91! (button) folded before Flop (didn't bet)



PokerStars Hand #222963871097:  Hold'em No Limit ($0.05/$0.10 USD) - 2021/01/23 13:32:03 ET
Table 'Bohlinia III' 6-max Seat #1 is the button
Seat 1: xucuo ($21.88 in chips) 
Seat 2: Sve_Sve93 ($14.05 in chips) 
Seat 3: memojr29 ($14.13 in chips) 
Seat 5: Valhalla1976 ($7.72 in chips) 
Seat 6: GrinZwe91! ($16.99 in chips) 
Sve_Sve93: posts small blind $0.05
memojr29: posts big blind $0.10
*** HOLE CARDS ***
Valhalla1976: raises $0.10 to $0.20
GrinZwe91!: folds 
xucuo: calls $0.20
Sve_Sve93: folds 
memojr29: folds 
*** FLOP *** [4d 4s 7s]
Valhalla1976: bets $0.10
xucuo: calls $0.10
*** TURN *** [4d 4s 7s] [6d]
Valhalla1976: bets $0.30
xucuo: calls $0.30
*** RIVER *** [4d 4s 7s 6d] [Ah]
Valhalla1976: bets $0.64
xucuo: folds 
Uncalled bet ($0.64) returned to Valhalla1976
Valhalla1976 collected $1.29 from pot
Valhalla1976: doesn't show hand 
*** SUMMARY ***
Total pot $1.35 | Rake $0.06 
Board [4d 4s 7s 6d Ah]
Seat 1: xucuo (button) folded on the River
Seat 2: Sve_Sve93 (small blind) folded before Flop
Seat 3: memojr29 (big blind) folded before Flop
Seat 5: Valhalla1976 collected ($1.29)
Seat 6: GrinZwe91! folded before Flop (didn't bet)



PokerStars Hand #222963907780:  Hold'em No Limit ($0.05/$0.10 USD) - 2021/01/23 13:32:50 ET
Table 'Bohlinia III' 6-max Seat #2 is the button
Seat 1: xucuo ($21.28 in chips) 
Seat 2: Sve_Sve93 ($14 in chips) 
Seat 3: memojr29 ($14.03 in chips) 
Seat 5: Valhalla1976 ($8.41 in chips) 
Seat 6: GrinZwe91! ($16.99 in chips) 
memojr29: posts small blind $0.05
Valhalla1976: posts big blind $0.10
*** HOLE CARDS ***
GrinZwe91!: folds 
xucuo: calls $0.10
Sve_Sve93: folds 
memojr29: folds 
Valhalla1976: raises $0.20 to $0.30
xucuo: calls $0.20
*** FLOP *** [Jh Qs 8d]
Valhalla1976: checks 
xucuo: checks 
*** TURN *** [Jh Qs 8d] [4s]
Valhalla1976: bets $0.31
xucuo: folds 
Uncalled bet ($0.31) returned to Valhalla1976
Valhalla1976 collected $0.62 from pot
Valhalla1976: doesn't show hand 
*** SUMMARY ***
Total pot $0.65 | Rake $0.03 
Board [Jh Qs 8d 4s]
Seat 1: xucuo folded on the Turn
Seat 2: Sve_Sve93 (button) folded before Flop (didn't bet)
Seat 3: memojr29 (small blind) folded before Flop
Seat 5: Valhalla1976 (big blind) collected ($0.62)
Seat 6: GrinZwe91! folded before Flop (didn't bet)



PokerStars Hand #222963931990:  Hold'em No Limit ($0.05/$0.10 USD) - 2021/01/23 13:33:21 ET
Table 'Bohlinia III' 6-max Seat #3 is the button
Seat 1: xucuo ($20.98 in chips) 
Seat 2: Sve_Sve93 ($14 in chips) 
Seat 3: memojr29 ($13.98 in chips) 
Seat 5: Valhalla1976 ($8.73 in chips) 
Seat 6: GrinZwe91! ($16.99 in chips) 
Valhalla1976: posts small blind $0.05
GrinZwe91!: posts big blind $0.10
*** HOLE CARDS ***
xucuo: raises $0.20 to $0.30
Sve_Sve93: folds 
memojr29: folds 
Valhalla1976: folds 
GrinZwe91!: folds 
Uncalled bet ($0.20) returned to xucuo
xucuo collected $0.25 from pot
xucuo: doesn't show hand 
*** SUMMARY ***
Total pot $0.25 | Rake $0 
Seat 1: xucuo collected ($0.25)
Seat 2: Sve_Sve93 folded before Flop (didn't bet)
Seat 3: memojr29 (button) folded before Flop (didn't bet)
Seat 5: Valhalla1976 (small blind) folded before Flop
Seat 6: GrinZwe91! (big blind) folded before Flop



PokerStars Hand #222963940021:  Hold'em No Limit ($0.05/$0.10 USD) - 2021/01/23 13:33:32 ET
Table 'Bohlinia III' 6-max Seat #5 is the button
Seat 1: xucuo ($21.13 in chips) 
Seat 2: Sve_Sve93 ($14 in chips) 
Seat 3: memojr29 ($13.98 in chips) 
Seat 5: Valhalla1976 ($8.68 in chips) 
Seat 6: GrinZwe91! ($16.89 in chips) 
GrinZwe91!: posts small blind $0.05
xucuo: posts big blind $0.10
*** HOLE CARDS ***
Sve_Sve93: folds 
memojr29: folds 
Valhalla1976: raises $0.20 to $0.30
GrinZwe91!: folds 
xucuo: calls $0.20
*** FLOP *** [Tc 3s 5h]
xucuo: bets $0.31
Valhalla1976: folds 
Uncalled bet ($0.31) returned to xucuo
xucuo collected $0.62 from pot
xucuo: doesn't show hand 
*** SUMMARY ***
Total pot $0.65 | Rake $0.03 
Board [Tc 3s 5h]
Seat 1: xucuo (big blind) collected ($0.62)
Seat 2: Sve_Sve93 folded before Flop (didn't bet)
Seat 3: memojr29 folded before Flop (didn't bet)
Seat 5: Valhalla1976 (button) folded on the Flop
Seat 6: GrinZwe91! (small blind) folded before Flop



PokerStars Hand #222963954593:  Hold'em No Limit ($0.05/$0.10 USD) - 2021/01/23 13:33:50 ET
Table 'Bohlinia III' 6-max Seat #6 is the button
Seat 1: xucuo ($21.45 in chips) 
Seat 2: Sve_Sve93 ($14 in chips) 
Seat 3: memojr29 ($13.98 in chips) 
Seat 5: Valhalla1976 ($8.38 in chips) 
Seat 6: GrinZwe91! ($16.84 in chips) 
xucuo: posts small blind $0.05
Sve_Sve93: posts big blind $0.10
*** HOLE CARDS ***
memojr29: folds 
Valhalla1976: folds 
GrinZwe91!: raises $0.20 to $0.30
xucuo: folds 
Sve_Sve93: calls $0.20
*** FLOP *** [Qh 8c Th]
Sve_Sve93: checks 
GrinZwe91!: bets $0.44
Sve_Sve93: calls $0.44
*** TURN *** [Qh 8c Th] [4c]
Sve_Sve93: checks 
GrinZwe91!: bets $1
Sve_Sve93: folds 
Uncalled bet ($1) returned to GrinZwe91!
GrinZwe91! collected $1.46 from pot
GrinZwe91!: doesn't show hand 
*** SUMMARY ***
Total pot $1.53 | Rake $0.07 
Board [Qh 8c Th 4c]
Seat 1: xucuo (small blind) folded before Flop
Seat 2: Sve_Sve93 (big blind) folded on the Turn
Seat 3: memojr29 folded before Flop (didn't bet)
Seat 5: Valhalla1976 folded before Flop (didn't bet)
Seat 6: GrinZwe91! (button) collected ($1.46)



PokerStars Hand #222963988184:  Hold'em No Limit ($0.05/$0.10 USD) - 2021/01/23 13:34:33 ET
Table 'Bohlinia III' 6-max Seat #1 is the button
Seat 1: xucuo ($21.40 in chips) 
Seat 2: Sve_Sve93 ($13.26 in chips) 
Seat 3: memojr29 ($13.98 in chips) 
Seat 5: Valhalla1976 ($8.38 in chips) 
Seat 6: GrinZwe91! ($17.56 in chips) 
Sve_Sve93: posts small blind $0.05
memojr29: posts big blind $0.10
JohnSF7: sits out 
*** HOLE CARDS ***
Valhalla1976: folds 
GrinZwe91!: raises $0.20 to $0.30
xucuo: folds 
Sve_Sve93: folds 
memojr29: calls $0.20
*** FLOP *** [8d 9c Jd]
memojr29: checks 
GrinZwe91!: bets $0.40
memojr29: raises $1.42 to $1.82
GrinZwe91!: calls $1.42
*** TURN *** [8d 9c Jd] [4c]
memojr29: bets $6
GrinZwe91!: folds 
Uncalled bet ($6) returned to memojr29
memojr29 collected $4.10 from pot
memojr29: doesn't show hand 
*** SUMMARY ***
Total pot $4.29 | Rake $0.19 
Board [8d 9c Jd 4c]
Seat 1: xucuo (button) folded before Flop (didn't bet)
Seat 2: Sve_Sve93 (small blind) folded before Flop
Seat 3: memojr29 (big blind) collected ($4.10)
Seat 5: Valhalla1976 folded before Flop (didn't bet)
Seat 6: GrinZwe91! folded on the Turn



PokerStars Hand #222964035319:  Hold'em No Limit ($0.05/$0.10 USD) - 2021/01/23 13:35:34 ET
Table 'Bohlinia III' 6-max Seat #2 is the button
Seat 1: xucuo ($21.40 in chips) 
Seat 2: Sve_Sve93 ($13.21 in chips) 
Seat 3: memojr29 ($15.96 in chips) 
Seat 4: JohnSF7 ($10 in chips) 
Seat 5: Valhalla1976 ($8.38 in chips) 
Seat 6: GrinZwe91! ($15.44 in chips) 
memojr29: posts small blind $0.05
JohnSF7: posts big blind $0.10
*** HOLE CARDS ***
Valhalla1976: folds 
GrinZwe91!: folds 
xucuo: calls $0.10
Sve_Sve93: folds 
memojr29: raises $0.40 to $0.50
JohnSF7: folds 
xucuo: folds 
Uncalled bet ($0.40) returned to memojr29
memojr29 collected $0.30 from pot
memojr29: doesn't show hand 
*** SUMMARY ***
Total pot $0.30 | Rake $0 
Seat 1: xucuo folded before Flop
Seat 2: Sve_Sve93 (button) folded before Flop (didn't bet)
Seat 3: memojr29 (small blind) collected ($0.30)
Seat 4: JohnSF7 (big blind) folded before Flop
Seat 5: Valhalla1976 folded before Flop (didn't bet)
Seat 6: GrinZwe91! folded before Flop (didn't bet)



PokerStars Hand #222964047391:  Hold'em No Limit ($0.05/$0.10 USD) - 2021/01/23 13:35:49 ET
Table 'Bohlinia III' 6-max Seat #3 is the button
Seat 1: xucuo ($21.30 in chips) 
Seat 2: Sve_Sve93 ($13.21 in chips) 
Seat 3: memojr29 ($16.16 in chips) 
Seat 4: JohnSF7 ($10 in chips) 
Seat 5: Valhalla1976 ($8.38 in chips) 
Seat 6: GrinZwe91! ($15.44 in chips) 
JohnSF7: posts small blind $0.05
Valhalla1976: posts big blind $0.10
*** HOLE CARDS ***
GrinZwe91!: folds 
xucuo: folds 
Sve_Sve93: folds 
memojr29: folds 
JohnSF7: raises $0.20 to $0.30
Valhalla1976: calls $0.20
*** FLOP *** [Jd 8c Kd]
JohnSF7: checks 
Valhalla1976: bets $0.28
JohnSF7: calls $0.28
*** TURN *** [Jd 8c Kd] [3c]
JohnSF7: checks 
Valhalla1976: bets $0.30
JohnSF7: calls $0.30
*** RIVER *** [Jd 8c Kd 3c] [Ts]
JohnSF7: checks 
Valhalla1976: bets $0.50
JohnSF7: calls $0.50
*** SHOW DOWN ***
Valhalla1976: shows [Js 7h] (a pair of Jacks)
JohnSF7: shows [Qh Jc] (a pair of Jacks - King+Queen kicker)
JohnSF7 collected $2.64 from pot
*** SUMMARY ***
Total pot $2.76 | Rake $0.12 
Board [Jd 8c Kd 3c Ts]
Seat 1: xucuo folded before Flop (didn't bet)
Seat 2: Sve_Sve93 folded before Flop (didn't bet)
Seat 3: memojr29 (button) folded before Flop (didn't bet)
Seat 4: JohnSF7 (small blind) showed [Qh Jc] and won ($2.64) with a pair of Jacks
Seat 5: Valhalla1976 (big blind) showed [Js 7h] and lost with a pair of Jacks
Seat 6: GrinZwe91! folded before Flop (didn't bet)



PokerStars Hand #222964082357:  Hold'em No Limit ($0.05/$0.10 USD) - 2021/01/23 13:36:35 ET
Table 'Bohlinia III' 6-max Seat #4 is the button
Seat 1: xucuo ($21.30 in chips) 
Seat 2: Sve_Sve93 ($13.21 in chips) 
Seat 3: memojr29 ($16.16 in chips) 
Seat 4: JohnSF7 ($11.26 in chips) 
Seat 5: Valhalla1976 ($7 in chips) 
Seat 6: GrinZwe91! ($15.44 in chips) 
Valhalla1976: posts small blind $0.05
GrinZwe91!: posts big blind $0.10
*** HOLE CARDS ***
xucuo: folds 
Sve_Sve93: folds 
memojr29: folds 
JohnSF7: folds 
Valhalla1976: raises $0.10 to $0.20
GrinZwe91!: raises $0.70 to $0.90
Valhalla1976: folds 
Uncalled bet ($0.70) returned to GrinZwe91!
GrinZwe91! collected $0.40 from pot
*** SUMMARY ***
Total pot $0.40 | Rake $0 
Seat 1: xucuo folded before Flop (didn't bet)
Seat 2: Sve_Sve93 folded before Flop (didn't bet)
Seat 3: memojr29 folded before Flop (didn't bet)
Seat 4: JohnSF7 (button) folded before Flop (didn't bet)
Seat 5: Valhalla1976 (small blind) folded before Flop
Seat 6: GrinZwe91! (big blind) collected ($0.40)



PokerStars Hand #222964099215:  Hold'em No Limit ($0.05/$0.10 USD) - 2021/01/23 13:36:56 ET
Table 'Bohlinia III' 6-max Seat #5 is the button
Seat 1: xucuo ($21.30 in chips) 
Seat 2: Sve_Sve93 ($13.21 in chips) 
Seat 3: memojr29 ($16.16 in chips) 
Seat 4: JohnSF7 ($11.26 in chips) 
Seat 5: Valhalla1976 ($6.80 in chips) 
Seat 6: GrinZwe91! ($15.64 in chips) 
GrinZwe91!: posts small blind $0.05
xucuo: posts big blind $0.10
*** HOLE CARDS ***
Sve_Sve93: folds 
memojr29: folds 
JohnSF7: folds 
Valhalla1976: raises $0.20 to $0.30
GrinZwe91!: calls $0.25
xucuo: raises $0.60 to $0.90
Valhalla1976: calls $0.60
GrinZwe91!: calls $0.60
*** FLOP *** [Ac 4d 6h]
GrinZwe91!: checks 
xucuo: bets $2.58
Valhalla1976: folds 
GrinZwe91!: calls $2.58
*** TURN *** [Ac 4d 6h] [Tc]
GrinZwe91!: checks 
xucuo: checks 
*** RIVER *** [Ac 4d 6h Tc] [7h]
GrinZwe91!: bets $4
xucuo: calls $4
*** SHOW DOWN ***
GrinZwe91!: shows [4c 4s] (three of a kind, Fours)
xucuo: mucks hand 
GrinZwe91! collected $15.15 from pot
*** SUMMARY ***
Total pot $15.86 | Rake $0.71 
Board [Ac 4d 6h Tc 7h]
Seat 1: xucuo (big blind) mucked
Seat 2: Sve_Sve93 folded before Flop (didn't bet)
Seat 3: memojr29 folded before Flop (didn't bet)
Seat 4: JohnSF7 folded before Flop (didn't bet)
Seat 5: Valhalla1976 (button) folded on the Flop
Seat 6: GrinZwe91! (small blind) showed [4c 4s] and won ($15.15) with three of a kind, Fours



PokerStars Hand #222964151646:  Hold'em No Limit ($0.05/$0.10 USD) - 2021/01/23 13:38:04 ET
Table 'Bohlinia III' 6-max Seat #6 is the button
Seat 1: xucuo ($13.82 in chips) 
Seat 2: Sve_Sve93 ($13.21 in chips) 
Seat 3: memojr29 ($16.16 in chips) 
Seat 4: JohnSF7 ($11.26 in chips) 
Seat 5: Valhalla1976 ($5.90 in chips) 
Seat 6: GrinZwe91! ($23.31 in chips) 
xucuo: posts small blind $0.05
Sve_Sve93: posts big blind $0.10
*** HOLE CARDS ***
memojr29: folds 
JohnSF7: folds 
Valhalla1976: folds 
GrinZwe91!: folds 
xucuo: folds 
Uncalled bet ($0.05) returned to Sve_Sve93
Sve_Sve93 collected $0.10 from pot
Sve_Sve93: doesn't show hand 
*** SUMMARY ***
Total pot $0.10 | Rake $0 
Seat 1: xucuo (small blind) folded before Flop
Seat 2: Sve_Sve93 (big blind) collected ($0.10)
Seat 3: memojr29 folded before Flop (didn't bet)
Seat 4: JohnSF7 folded before Flop (didn't bet)
Seat 5: Valhalla1976 folded before Flop (didn't bet)
Seat 6: GrinZwe91! (button) folded before Flop (didn't bet)



PokerStars Hand #222964161105:  Hold'em No Limit ($0.05/$0.10 USD) - 2021/01/23 13:38:16 ET
Table 'Bohlinia III' 6-max Seat #1 is the button
Seat 1: xucuo ($13.77 in chips) 
Seat 2: Sve_Sve93 ($13.26 in chips) 
Seat 3: memojr29 ($16.16 in chips) 
Seat 4: JohnSF7 ($11.26 in chips) 
Seat 5: Valhalla1976 ($5.90 in chips) 
Seat 6: GrinZwe91! ($23.31 in chips) 
Sve_Sve93: posts small blind $0.05
memojr29: posts big blind $0.10
*** HOLE CARDS ***
JohnSF7: folds 
Valhalla1976: raises $0.10 to $0.20
GrinZwe91!: folds 
xucuo: calls $0.20
Sve_Sve93: folds 
memojr29: folds 
*** FLOP *** [5h 2c 3c]
Valhalla1976: checks 
xucuo: bets $0.53
Valhalla1976: folds 
Uncalled bet ($0.53) returned to xucuo
xucuo collected $0.53 from pot
xucuo: doesn't show hand 
*** SUMMARY ***
Total pot $0.55 | Rake $0.02 
Board [5h 2c 3c]
Seat 1: xucuo (button) collected ($0.53)
Seat 2: Sve_Sve93 (small blind) folded before Flop
Seat 3: memojr29 (big blind) folded before Flop
Seat 4: JohnSF7 folded before Flop (didn't bet)
Seat 5: Valhalla1976 folded on the Flop
Seat 6: GrinZwe91! folded before Flop (didn't bet)



PokerStars Hand #222964330133:  Hold'em No Limit ($0.05/$0.10 USD) - 2021/01/23 13:41:55 ET
Table 'Bohlinia III' 6-max Seat #1 is the button
Seat 1: xucuo ($13.55 in chips) 
Seat 2: Sve_Sve93 ($13.11 in chips) 
Seat 3: memojr29 ($16.01 in chips) 
Seat 4: JohnSF7 ($11.82 in chips) 
Seat 5: Valhalla1976 ($6.22 in chips) 
Seat 6: GrinZwe91! ($22.86 in chips) 
Sve_Sve93: posts small blind $0.05
memojr29: posts big blind $0.10
*** HOLE CARDS ***
JohnSF7: folds 
Valhalla1976: raises $0.20 to $0.30
GrinZwe91!: folds 
xucuo: folds 
Sve_Sve93: folds 
memojr29: folds 
Uncalled bet ($0.20) returned to Valhalla1976
Valhalla1976 collected $0.25 from pot
Valhalla1976: doesn't show hand 
*** SUMMARY ***
Total pot $0.25 | Rake $0 
Seat 1: xucuo (button) folded before Flop (didn't bet)
Seat 2: Sve_Sve93 (small blind) folded before Flop
Seat 3: memojr29 (big blind) folded before Flop
Seat 4: JohnSF7 folded before Flop (didn't bet)
Seat 5: Valhalla1976 collected ($0.25)
Seat 6: GrinZwe91! folded before Flop (didn't bet)



PokerStars Hand #222964339178:  Hold'em No Limit ($0.05/$0.10 USD) - 2021/01/23 13:42:06 ET
Table 'Bohlinia III' 6-max Seat #2 is the button
Seat 1: xucuo ($13.55 in chips) 
Seat 2: Sve_Sve93 ($13.06 in chips) 
Seat 3: memojr29 ($15.91 in chips) 
Seat 4: JohnSF7 ($11.82 in chips) 
Seat 5: Valhalla1976 ($6.37 in chips) 
Seat 6: GrinZwe91! ($22.86 in chips) 
memojr29: posts small blind $0.05
JohnSF7: posts big blind $0.10
*** HOLE CARDS ***
Valhalla1976: folds 
GrinZwe91!: folds 
xucuo: folds 
Sve_Sve93: folds 
memojr29: folds 
Uncalled bet ($0.05) returned to JohnSF7
JohnSF7 collected $0.10 from pot
JohnSF7: doesn't show hand 
*** SUMMARY ***
Total pot $0.10 | Rake $0 
Seat 1: xucuo folded before Flop (didn't bet)
Seat 2: Sve_Sve93 (button) folded before Flop (didn't bet)
Seat 3: memojr29 (small blind) folded before Flop
Seat 4: JohnSF7 (big blind) collected ($0.10)
Seat 5: Valhalla1976 folded before Flop (didn't bet)
Seat 6: GrinZwe91! folded before Flop (didn't bet)



PokerStars Hand #222964350733:  Hold'em No Limit ($0.05/$0.10 USD) - 2021/01/23 13:42:21 ET
Table 'Bohlinia III' 6-max Seat #3 is the button
Seat 1: xucuo ($13.55 in chips) 
Seat 2: Sve_Sve93 ($13.06 in chips) 
Seat 3: memojr29 ($15.86 in chips) 
Seat 4: JohnSF7 ($11.87 in chips) 
Seat 5: Valhalla1976 ($6.37 in chips) 
Seat 6: GrinZwe91! ($22.86 in chips) 
JohnSF7: posts small blind $0.05
Valhalla1976: posts big blind $0.10
*** HOLE CARDS ***
GrinZwe91!: folds 
xucuo: raises $0.20 to $0.30
Sve_Sve93: calls $0.30
memojr29: folds 
JohnSF7: calls $0.25
Valhalla1976: calls $0.20
*** FLOP *** [9c Qs As]
JohnSF7: checks 
Valhalla1976: checks 
xucuo: bets $0.58
Sve_Sve93: folds 
JohnSF7: folds 
Valhalla1976: folds 
Uncalled bet ($0.58) returned to xucuo
xucuo collected $1.15 from pot
xucuo: doesn't show hand 
*** SUMMARY ***
Total pot $1.20 | Rake $0.05 
Board [9c Qs As]
Seat 1: xucuo collected ($1.15)
Seat 2: Sve_Sve93 folded on the Flop
Seat 3: memojr29 (button) folded before Flop (didn't bet)
Seat 4: JohnSF7 (small blind) folded on the Flop
Seat 5: Valhalla1976 (big blind) folded on the Flop
Seat 6: GrinZwe91! folded before Flop (didn't bet)



PokerStars Hand #222964378275:  Hold'em No Limit ($0.05/$0.10 USD) - 2021/01/23 13:42:57 ET
Table 'Bohlinia III' 6-max Seat #4 is the button
Seat 1: xucuo ($14.40 in chips) 
Seat 2: Sve_Sve93 ($12.76 in chips) 
Seat 3: memojr29 ($15.86 in chips) 
Seat 4: JohnSF7 ($11.57 in chips) 
Seat 5: Valhalla1976 ($6.07 in chips) 
Seat 6: GrinZwe91! ($22.86 in chips) 
Valhalla1976: posts small blind $0.05
GrinZwe91!: posts big blind $0.10
*** HOLE CARDS ***
xucuo: calls $0.10
Sve_Sve93: folds 
memojr29: folds 
JohnSF7: folds 
Valhalla1976: raises $0.10 to $0.20
GrinZwe91!: folds 
xucuo: calls $0.10
*** FLOP *** [Kd Ac 2h]
Valhalla1976: bets $0.48
xucuo: folds 
Uncalled bet ($0.48) returned to Valhalla1976
Valhalla1976 collected $0.48 from pot
Valhalla1976: doesn't show hand 
*** SUMMARY ***
Total pot $0.50 | Rake $0.02 
Board [Kd Ac 2h]
Seat 1: xucuo folded on the Flop
Seat 2: Sve_Sve93 folded before Flop (didn't bet)
Seat 3: memojr29 folded before Flop (didn't bet)
Seat 4: JohnSF7 (button) folded before Flop (didn't bet)
Seat 5: Valhalla1976 (small blind) collected ($0.48)
Seat 6: GrinZwe91! (big blind) folded before Flop



PokerStars Hand #222964399326:  Hold'em No Limit ($0.05/$0.10 USD) - 2021/01/23 13:43:24 ET
Table 'Bohlinia III' 6-max Seat #5 is the button
Seat 1: xucuo ($14.20 in chips) 
Seat 2: Sve_Sve93 ($12.76 in chips) 
Seat 3: memojr29 ($15.86 in chips) 
Seat 4: JohnSF7 ($11.57 in chips) 
Seat 5: Valhalla1976 ($6.35 in chips) 
Seat 6: GrinZwe91! ($22.76 in chips) 
GrinZwe91!: posts small blind $0.05
xucuo: posts big blind $0.10
*** HOLE CARDS ***
Sve_Sve93: folds 
memojr29: raises $0.20 to $0.30
JohnSF7: folds 
Valhalla1976: calls $0.30
GrinZwe91!: folds 
xucuo: calls $0.20
*** FLOP *** [3h 5s 3c]
xucuo: checks 
memojr29: checks 
Valhalla1976: bets $0.45
xucuo: calls $0.45
memojr29: folds 
*** TURN *** [3h 5s 3c] [8c]
xucuo: checks 
Valhalla1976: checks 
*** RIVER *** [3h 5s 3c 8c] [7h]
xucuo: checks 
Valhalla1976: checks 
*** SHOW DOWN ***
xucuo: shows [5d 3d] (a full house, Threes full of Fives)
Valhalla1976: mucks hand 
xucuo collected $1.77 from pot
*** SUMMARY ***
Total pot $1.85 | Rake $0.08 
Board [3h 5s 3c 8c 7h]
Seat 1: xucuo (big blind) showed [5d 3d] and won ($1.77) with a full house, Threes full of Fives
Seat 2: Sve_Sve93 folded before Flop (didn't bet)
Seat 3: memojr29 folded on the Flop
Seat 4: JohnSF7 folded before Flop (didn't bet)
Seat 5: Valhalla1976 (button) mucked
Seat 6: GrinZwe91! (small blind) folded before Flop



PokerStars Hand #222964442790:  Hold'em No Limit ($0.05/$0.10 USD) - 2021/01/23 13:44:13 ET
Table 'Bohlinia III' 6-max Seat #6 is the button
Seat 1: xucuo ($15.22 in chips) 
Seat 2: Sve_Sve93 ($12.76 in chips) 
Seat 3: memojr29 ($15.56 in chips) 
Seat 4: JohnSF7 ($11.57 in chips) 
Seat 5: Valhalla1976 ($5.60 in chips) 
Seat 6: GrinZwe91! ($22.71 in chips) 
xucuo: posts small blind $0.05
Sve_Sve93: posts big blind $0.10
*** HOLE CARDS ***
memojr29: folds 
JohnSF7: folds 
Valhalla1976: raises $0.10 to $0.20
GrinZwe91!: folds 
xucuo: folds 
Sve_Sve93: folds 
Uncalled bet ($0.10) returned to Valhalla1976
Valhalla1976 collected $0.25 from pot
Valhalla1976: doesn't show hand 
*** SUMMARY ***
Total pot $0.25 | Rake $0 
Seat 1: xucuo (small blind) folded before Flop
Seat 2: Sve_Sve93 (big blind) folded before Flop
Seat 3: memojr29 folded before Flop (didn't bet)
Seat 4: JohnSF7 folded before Flop (didn't bet)
Seat 5: Valhalla1976 collected ($0.25)
Seat 6: GrinZwe91! (button) folded before Flop (didn't bet)



PokerStars Hand #222964452919:  Hold'em No Limit ($0.05/$0.10 USD) - 2021/01/23 13:44:26 ET
Table 'Bohlinia III' 6-max Seat #1 is the button
Seat 1: xucuo ($15.17 in chips) 
Seat 2: Sve_Sve93 ($12.66 in chips) 
Seat 3: memojr29 ($15.56 in chips) 
Seat 4: JohnSF7 ($11.57 in chips) 
Seat 5: Valhalla1976 ($5.75 in chips) 
Seat 6: GrinZwe91! ($22.71 in chips) 
Sve_Sve93: posts small blind $0.05
memojr29: posts big blind $0.10
*** HOLE CARDS ***
JohnSF7: folds 
Valhalla1976: folds 
GrinZwe91!: raises $0.20 to $0.30
xucuo: folds 
Sve_Sve93: folds 
memojr29: calls $0.20
*** FLOP *** [As 8h Qh]
memojr29: checks 
GrinZwe91!: bets $0.40
memojr29: calls $0.40
*** TURN *** [As 8h Qh] [6d]
memojr29: checks 
GrinZwe91!: checks 
*** RIVER *** [As 8h Qh 6d] [4s]
memojr29: bets $1.38
GrinZwe91!: folds 
Uncalled bet ($1.38) returned to memojr29
memojr29 collected $1.38 from pot
memojr29: doesn't show hand 
*** SUMMARY ***
Total pot $1.45 | Rake $0.07 
Board [As 8h Qh 6d 4s]
Seat 1: xucuo (button) folded before Flop (didn't bet)
Seat 2: Sve_Sve93 (small blind) folded before Flop
Seat 3: memojr29 (big blind) collected ($1.38)
Seat 4: JohnSF7 folded before Flop (didn't bet)
Seat 5: Valhalla1976 folded before Flop (didn't bet)
Seat 6: GrinZwe91! folded on the River



PokerStars Hand #222964497591:  Hold'em No Limit ($0.05/$0.10 USD) - 2021/01/23 13:45:24 ET
Table 'Bohlinia III' 6-max Seat #2 is the button
Seat 1: xucuo ($15.17 in chips) 
Seat 2: Sve_Sve93 ($12.61 in chips) 
Seat 3: memojr29 ($16.24 in chips) 
Seat 4: JohnSF7 ($11.57 in chips) 
Seat 5: Valhalla1976 ($5.75 in chips) 
Seat 6: GrinZwe91! ($22.01 in chips) 
memojr29: posts small blind $0.05
JohnSF7: posts big blind $0.10
*** HOLE CARDS ***
Valhalla1976: calls $0.10
GrinZwe91!: folds 
xucuo: folds 
Sve_Sve93: folds 
memojr29: raises $0.40 to $0.50
JohnSF7: folds 
Valhalla1976: calls $0.40
*** FLOP *** [Jh 9h 4s]
memojr29: bets $0.69
Valhalla1976: folds 
Uncalled bet ($0.69) returned to memojr29
memojr29 collected $1.05 from pot
memojr29: doesn't show hand 
*** SUMMARY ***
Total pot $1.10 | Rake $0.05 
Board [Jh 9h 4s]
Seat 1: xucuo folded before Flop (didn't bet)
Seat 2: Sve_Sve93 (button) folded before Flop (didn't bet)
Seat 3: memojr29 (small blind) collected ($1.05)
Seat 4: JohnSF7 (big blind) folded before Flop
Seat 5: Valhalla1976 folded on the Flop
Seat 6: GrinZwe91! folded before Flop (didn't bet)



PokerStars Hand #222964519516:  Hold'em No Limit ($0.05/$0.10 USD) - 2021/01/23 13:45:52 ET
Table 'Bohlinia III' 6-max Seat #3 is the button
Seat 1: xucuo ($15.17 in chips) 
Seat 2: Sve_Sve93 ($12.61 in chips) 
Seat 3: memojr29 ($16.79 in chips) 
Seat 4: JohnSF7 ($11.47 in chips) 
Seat 5: Valhalla1976 ($5.25 in chips) 
Seat 6: GrinZwe91! ($22.01 in chips) 
JohnSF7: posts small blind $0.05
Valhalla1976: posts big blind $0.10
*** HOLE CARDS ***
GrinZwe91!: folds 
xucuo: folds 
Sve_Sve93: folds 
memojr29: folds 
JohnSF7: folds 
Uncalled bet ($0.05) returned to Valhalla1976
Valhalla1976 collected $0.10 from pot
Valhalla1976: doesn't show hand 
*** SUMMARY ***
Total pot $0.10 | Rake $0 
Seat 1: xucuo folded before Flop (didn't bet)
Seat 2: Sve_Sve93 folded before Flop (didn't bet)
Seat 3: memojr29 (button) folded before Flop (didn't bet)
Seat 4: JohnSF7 (small blind) folded before Flop
Seat 5: Valhalla1976 (big blind) collected ($0.10)
Seat 6: GrinZwe91! folded before Flop (didn't bet)



PokerStars Hand #222964525083:  Hold'em No Limit ($0.05/$0.10 USD) - 2021/01/23 13:45:59 ET
Table 'Bohlinia III' 6-max Seat #4 is the button
Seat 1: xucuo ($15.17 in chips) 
Seat 2: Sve_Sve93 ($12.61 in chips) 
Seat 3: memojr29 ($16.79 in chips) 
Seat 4: JohnSF7 ($11.42 in chips) 
Seat 5: Valhalla1976 ($5.30 in chips) 
Seat 6: GrinZwe91! ($22.01 in chips) 
Valhalla1976: posts small blind $0.05
GrinZwe91!: posts big blind $0.10
*** HOLE CARDS ***
xucuo: folds 
Sve_Sve93: folds 
memojr29: folds 
JohnSF7: folds 
Valhalla1976: raises $0.20 to $0.30
GrinZwe91!: folds 
Uncalled bet ($0.20) returned to Valhalla1976
Valhalla1976 collected $0.20 from pot
Valhalla1976: doesn't show hand 
*** SUMMARY ***
Total pot $0.20 | Rake $0 
Seat 1: xucuo folded before Flop (didn't bet)
Seat 2: Sve_Sve93 folded before Flop (didn't bet)
Seat 3: memojr29 folded before Flop (didn't bet)
Seat 4: JohnSF7 (button) folded before Flop (didn't bet)
Seat 5: Valhalla1976 (small blind) collected ($0.20)
Seat 6: GrinZwe91! (big blind) folded before Flop



PokerStars Hand #222964535216:  Hold'em No Limit ($0.05/$0.10 USD) - 2021/01/23 13:46:13 ET
Table 'Bohlinia III' 6-max Seat #5 is the button
Seat 1: xucuo ($15.17 in chips) 
Seat 2: Sve_Sve93 ($12.61 in chips) 
Seat 3: memojr29 ($16.79 in chips) 
Seat 4: JohnSF7 ($11.42 in chips) 
Seat 5: Valhalla1976 ($5.40 in chips) 
Seat 6: GrinZwe91! ($21.91 in chips) 
GrinZwe91!: posts small blind $0.05
xucuo: posts big blind $0.10
*** HOLE CARDS ***
Sve_Sve93: folds 
memojr29: folds 
JohnSF7: folds 
Valhalla1976: raises $0.10 to $0.20
GrinZwe91!: folds 
xucuo: calls $0.10
*** FLOP *** [Jc Qh 2s]
xucuo: bets $0.22
Valhalla1976: raises $0.22 to $0.44
xucuo: folds [2d]
Uncalled bet ($0.22) returned to Valhalla1976
Valhalla1976 collected $0.85 from pot
Valhalla1976: doesn't show hand 
*** SUMMARY ***
Total pot $0.89 | Rake $0.04 
Board [Jc Qh 2s]
Seat 1: xucuo (big blind) folded on the Flop
Seat 2: Sve_Sve93 folded before Flop (didn't bet)
Seat 3: memojr29 folded before Flop (didn't bet)
Seat 4: JohnSF7 folded before Flop (didn't bet)
Seat 5: Valhalla1976 (button) collected ($0.85)
Seat 6: GrinZwe91! (small blind) folded before Flop



PokerStars Hand #222964552228:  Hold'em No Limit ($0.05/$0.10 USD) - 2021/01/23 13:46:35 ET
Table 'Bohlinia III' 6-max Seat #6 is the button
Seat 1: xucuo ($14.75 in chips) 
Seat 2: Sve_Sve93 ($12.61 in chips) 
Seat 3: memojr29 ($16.79 in chips) 
Seat 4: JohnSF7 ($11.42 in chips) 
Seat 5: Valhalla1976 ($5.83 in chips) 
Seat 6: GrinZwe91! ($21.86 in chips) 
xucuo: posts small blind $0.05
Sve_Sve93: posts big blind $0.10
*** HOLE CARDS ***
memojr29: folds 
JohnSF7: folds 
Valhalla1976: folds 
GrinZwe91!: raises $0.20 to $0.30
xucuo: folds 
Sve_Sve93: calls $0.20
*** FLOP *** [Js 5c Qh]
Sve_Sve93: checks 
GrinZwe91!: bets $0.40
Sve_Sve93: raises $0.40 to $0.80
GrinZwe91!: calls $0.40
*** TURN *** [Js 5c Qh] [Ts]
Sve_Sve93: bets $1.08
GrinZwe91!: calls $1.08
*** RIVER *** [Js 5c Qh Ts] [Td]
Sve_Sve93: checks 
GrinZwe91!: checks 
*** SHOW DOWN ***
Sve_Sve93: shows [Qs Kd] (two pair, Queens and Tens)
GrinZwe91!: shows [Jh Qd] (two pair, Queens and Jacks)
GrinZwe91! collected $4.21 from pot
*** SUMMARY ***
Total pot $4.41 | Rake $0.20 
Board [Js 5c Qh Ts Td]
Seat 1: xucuo (small blind) folded before Flop
Seat 2: Sve_Sve93 (big blind) showed [Qs Kd] and lost with two pair, Queens and Tens
Seat 3: memojr29 folded before Flop (didn't bet)
Seat 4: JohnSF7 folded before Flop (didn't bet)
Seat 5: Valhalla1976 folded before Flop (didn't bet)
Seat 6: GrinZwe91! (button) showed [Jh Qd] and won ($4.21) with two pair, Queens and Jacks



PokerStars Hand #222964580333:  Hold'em No Limit ($0.05/$0.10 USD) - 2021/01/23 13:47:12 ET
Table 'Bohlinia III' 6-max Seat #1 is the button
Seat 1: xucuo ($14.70 in chips) 
Seat 2: Sve_Sve93 ($10.43 in chips) 
Seat 3: memojr29 ($16.79 in chips) 
Seat 4: JohnSF7 ($11.42 in chips) 
Seat 5: Valhalla1976 ($5.83 in chips) 
Seat 6: GrinZwe91! ($23.89 in chips) 
Sve_Sve93: posts small blind $0.05
memojr29: posts big blind $0.10
*** HOLE CARDS ***
JohnSF7: folds 
Valhalla1976: raises $0.20 to $0.30
GrinZwe91!: folds 
xucuo: folds 
Sve_Sve93: calls $0.25
memojr29: raises $1.20 to $1.50
Valhalla1976: folds 
Sve_Sve93: folds 
Uncalled bet ($1.20) returned to memojr29
memojr29 collected $0.90 from pot
memojr29: doesn't show hand 
*** SUMMARY ***
Total pot $0.90 | Rake $0 
Seat 1: xucuo (button) folded before Flop (didn't bet)
Seat 2: Sve_Sve93 (small blind) folded before Flop
Seat 3: memojr29 (big blind) collected ($0.90)
Seat 4: JohnSF7 folded before Flop (didn't bet)
Seat 5: Valhalla1976 folded before Flop
Seat 6: GrinZwe91! folded before Flop (didn't bet)



PokerStars Hand #222964605579:  Hold'em No Limit ($0.05/$0.10 USD) - 2021/01/23 13:47:45 ET
Table 'Bohlinia III' 6-max Seat #2 is the button
Seat 1: xucuo ($14.70 in chips) 
Seat 2: Sve_Sve93 ($10.13 in chips) 
Seat 3: memojr29 ($17.39 in chips) 
Seat 4: JohnSF7 ($11.42 in chips) 
Seat 5: Valhalla1976 ($5.53 in chips) 
Seat 6: GrinZwe91! ($23.89 in chips) 
memojr29: posts small blind $0.05
JohnSF7: posts big blind $0.10
*** HOLE CARDS ***
Valhalla1976: folds 
GrinZwe91!: folds 
xucuo: folds 
Sve_Sve93: raises $0.20 to $0.30
memojr29: raises $0.70 to $1
JohnSF7: folds 
Sve_Sve93: raises $1.70 to $2.70
memojr29: folds 
Uncalled bet ($1.70) returned to Sve_Sve93
Sve_Sve93 collected $2.10 from pot
Sve_Sve93: doesn't show hand 
*** SUMMARY ***
Total pot $2.10 | Rake $0 
Seat 1: xucuo folded before Flop (didn't bet)
Seat 2: Sve_Sve93 (button) collected ($2.10)
Seat 3: memojr29 (small blind) folded before Flop
Seat 4: JohnSF7 (big blind) folded before Flop
Seat 5: Valhalla1976 folded before Flop (didn't bet)
Seat 6: GrinZwe91! folded before Flop (didn't bet)



PokerStars Hand #222964630811:  Hold'em No Limit ($0.05/$0.10 USD) - 2021/01/23 13:48:18 ET
Table 'Bohlinia III' 6-max Seat #3 is the button
Seat 1: xucuo ($14.70 in chips) 
Seat 2: Sve_Sve93 ($11.23 in chips) 
Seat 3: memojr29 ($16.39 in chips) 
Seat 4: JohnSF7 ($11.32 in chips) 
Seat 5: Valhalla1976 ($5.53 in chips) 
Seat 6: GrinZwe91! ($23.89 in chips) 
JohnSF7: posts small blind $0.05
Valhalla1976: posts big blind $0.10
*** HOLE CARDS ***
GrinZwe91!: folds 
xucuo: folds 
Sve_Sve93: folds 
memojr29: folds 
JohnSF7: raises $0.20 to $0.30
Valhalla1976: calls $0.20
*** FLOP *** [5h 5d Jh]
JohnSF7: checks 
Valhalla1976: checks 
*** TURN *** [5h 5d Jh] [Ah]
JohnSF7: checks 
Valhalla1976: bets $0.57
JohnSF7: raises $1.23 to $1.80
Valhalla1976: folds 
Uncalled bet ($1.23) returned to JohnSF7
JohnSF7 collected $1.66 from pot
JohnSF7: doesn't show hand 
*** SUMMARY ***
Total pot $1.74 | Rake $0.08 
Board [5h 5d Jh Ah]
Seat 1: xucuo folded before Flop (didn't bet)
Seat 2: Sve_Sve93 folded before Flop (didn't bet)
Seat 3: memojr29 (button) folded before Flop (didn't bet)
Seat 4: JohnSF7 (small blind) collected ($1.66)
Seat 5: Valhalla1976 (big blind) folded on the Turn
Seat 6: GrinZwe91! folded before Flop (didn't bet)



PokerStars Hand #222964657985:  Hold'em No Limit ($0.05/$0.10 USD) - 2021/01/23 13:48:54 ET
Table 'Bohlinia III' 6-max Seat #4 is the button
Seat 1: xucuo ($14.70 in chips) 
Seat 2: Sve_Sve93 ($11.23 in chips) 
Seat 3: memojr29 ($16.39 in chips) 
Seat 4: JohnSF7 ($12.11 in chips) 
Seat 5: Valhalla1976 ($4.66 in chips) 
Seat 6: GrinZwe91! ($23.89 in chips) 
Valhalla1976: posts small blind $0.05
GrinZwe91!: posts big blind $0.10
*** HOLE CARDS ***
xucuo: calls $0.10
Sve_Sve93: folds 
memojr29: folds 
JohnSF7: folds 
Valhalla1976: calls $0.05
GrinZwe91!: checks 
*** FLOP *** [4c Td Ks]
Valhalla1976: checks 
GrinZwe91!: checks 
xucuo: checks 
*** TURN *** [4c Td Ks] [6d]
Valhalla1976: checks 
GrinZwe91!: checks 
xucuo: checks 
*** RIVER *** [4c Td Ks 6d] [5c]
Valhalla1976: bets $0.29
GrinZwe91!: folds 
xucuo: calls $0.29
*** SHOW DOWN ***
Valhalla1976: shows [2h Qc] (high card King)
xucuo: shows [Qs Ts] (a pair of Tens)
xucuo collected $0.84 from pot
*** SUMMARY ***
Total pot $0.88 | Rake $0.04 
Board [4c Td Ks 6d 5c]
Seat 1: xucuo showed [Qs Ts] and won ($0.84) with a pair of Tens
Seat 2: Sve_Sve93 folded before Flop (didn't bet)
Seat 3: memojr29 folded before Flop (didn't bet)
Seat 4: JohnSF7 (button) folded before Flop (didn't bet)
Seat 5: Valhalla1976 (small blind) showed [2h Qc] and lost with high card King
Seat 6: GrinZwe91! (big blind) folded on the River



PokerStars Hand #222964686638:  Hold'em No Limit ($0.05/$0.10 USD) - 2021/01/23 13:49:32 ET
Table 'Bohlinia III' 6-max Seat #5 is the button
Seat 1: xucuo ($15.15 in chips) 
Seat 2: Sve_Sve93 ($11.23 in chips) 
Seat 3: memojr29 ($16.39 in chips) 
Seat 4: JohnSF7 ($12.11 in chips) 
Seat 5: Valhalla1976 ($4.27 in chips) 
Seat 6: GrinZwe91! ($23.79 in chips) 
GrinZwe91!: posts small blind $0.05
xucuo: posts big blind $0.10
*** HOLE CARDS ***
Sve_Sve93: folds 
memojr29: folds 
JohnSF7: folds 
Valhalla1976: calls $0.10
GrinZwe91!: folds 
xucuo: checks 
*** FLOP *** [7h 8d Ac]
xucuo: checks 
Valhalla1976: checks 
*** TURN *** [7h 8d Ac] [7c]
xucuo: checks 
Valhalla1976: checks 
*** RIVER *** [7h 8d Ac 7c] [2h]
xucuo: checks 
Valhalla1976: checks 
*** SHOW DOWN ***
xucuo: shows [3d Qd] (a pair of Sevens)
Valhalla1976: shows [Ks 5c] (a pair of Sevens - Ace+King kicker)
Valhalla1976 collected $0.24 from pot
*** SUMMARY ***
Total pot $0.25 | Rake $0.01 
Board [7h 8d Ac 7c 2h]
Seat 1: xucuo (big blind) showed [3d Qd] and lost with a pair of Sevens
Seat 2: Sve_Sve93 folded before Flop (didn't bet)
Seat 3: memojr29 folded before Flop (didn't bet)
Seat 4: JohnSF7 folded before Flop (didn't bet)
Seat 5: Valhalla1976 (button) showed [Ks 5c] and won ($0.24) with a pair of Sevens
Seat 6: GrinZwe91! (small blind) folded before Flop



PokerStars Hand #222964704332:  Hold'em No Limit ($0.05/$0.10 USD) - 2021/01/23 13:49:55 ET
Table 'Bohlinia III' 6-max Seat #6 is the button
Seat 1: xucuo ($15.05 in chips) 
Seat 2: Sve_Sve93 ($11.23 in chips) 
Seat 3: memojr29 ($16.39 in chips) 
Seat 4: JohnSF7 ($12.11 in chips) 
Seat 5: Valhalla1976 ($4.41 in chips) 
Seat 6: GrinZwe91! ($23.74 in chips) 
xucuo: posts small blind $0.05
Sve_Sve93: posts big blind $0.10
*** HOLE CARDS ***
memojr29: folds 
JohnSF7: folds 
Valhalla1976: raises $0.10 to $0.20
GrinZwe91!: folds 
xucuo: calls $0.15
Sve_Sve93: folds 
*** FLOP *** [5s 9d Ah]
xucuo: checks 
Valhalla1976: bets $0.48
xucuo: folds 
Uncalled bet ($0.48) returned to Valhalla1976
Valhalla1976 collected $0.48 from pot
Valhalla1976: doesn't show hand 
*** SUMMARY ***
Total pot $0.50 | Rake $0.02 
Board [5s 9d Ah]
Seat 1: xucuo (small blind) folded on the Flop
Seat 2: Sve_Sve93 (big blind) folded before Flop
Seat 3: memojr29 folded before Flop (didn't bet)
Seat 4: JohnSF7 folded before Flop (didn't bet)
Seat 5: Valhalla1976 collected ($0.48)
Seat 6: GrinZwe91! (button) folded before Flop (didn't bet)



PokerStars Hand #222964721486:  Hold'em No Limit ($0.05/$0.10 USD) - 2021/01/23 13:50:17 ET
Table 'Bohlinia III' 6-max Seat #1 is the button
Seat 1: xucuo ($14.85 in chips) 
Seat 2: Sve_Sve93 ($11.13 in chips) 
Seat 3: memojr29 ($16.39 in chips) 
Seat 4: JohnSF7 ($12.11 in chips) 
Seat 5: Valhalla1976 ($4.69 in chips) 
Seat 6: GrinZwe91! ($23.74 in chips) 
Sve_Sve93: posts small blind $0.05
memojr29: posts big blind $0.10
*** HOLE CARDS ***
JohnSF7: raises $0.15 to $0.25
Valhalla1976: folds 
GrinZwe91!: folds 
xucuo: calls $0.25
Sve_Sve93: folds 
memojr29: raises $1.25 to $1.50
JohnSF7: calls $1.25
xucuo: folds 
*** FLOP *** [5s Kc 6s]
memojr29: bets $0.95
JohnSF7: calls $0.95
*** TURN *** [5s Kc 6s] [9h]
memojr29: checks 
JohnSF7: bets $1.64
memojr29: folds 
Uncalled bet ($1.64) returned to JohnSF7
JohnSF7 collected $4.97 from pot
JohnSF7: doesn't show hand 
*** SUMMARY ***
Total pot $5.20 | Rake $0.23 
Board [5s Kc 6s 9h]
Seat 1: xucuo (button) folded before Flop
Seat 2: Sve_Sve93 (small blind) folded before Flop
Seat 3: memojr29 (big blind) folded on the Turn
Seat 4: JohnSF7 collected ($4.97)
Seat 5: Valhalla1976 folded before Flop (didn't bet)
Seat 6: GrinZwe91! folded before Flop (didn't bet)



PokerStars Hand #222964769089:  Hold'em No Limit ($0.05/$0.10 USD) - 2021/01/23 13:51:20 ET
Table 'Bohlinia III' 6-max Seat #2 is the button
Seat 1: xucuo ($14.60 in chips) 
Seat 2: Sve_Sve93 ($11.08 in chips) 
Seat 3: memojr29 ($13.94 in chips) 
Seat 4: JohnSF7 ($14.63 in chips) 
Seat 5: Valhalla1976 ($4.69 in chips) 
Seat 6: GrinZwe91! ($23.74 in chips) 
memojr29: posts small blind $0.05
JohnSF7: posts big blind $0.10
*** HOLE CARDS ***
Valhalla1976: raises $0.20 to $0.30
GrinZwe91!: folds 
xucuo: raises $0.20 to $0.50
Sve_Sve93: folds 
memojr29: folds 
JohnSF7: folds 
Valhalla1976: calls $0.20
*** FLOP *** [Ad 2h 8d]
Valhalla1976: bets $1.10
xucuo: folds 
Uncalled bet ($1.10) returned to Valhalla1976
Valhalla1976 collected $1.10 from pot
Valhalla1976: doesn't show hand 
*** SUMMARY ***
Total pot $1.15 | Rake $0.05 
Board [Ad 2h 8d]
Seat 1: xucuo folded on the Flop
Seat 2: Sve_Sve93 (button) folded before Flop (didn't bet)
Seat 3: memojr29 (small blind) folded before Flop
Seat 4: JohnSF7 (big blind) folded before Flop
Seat 5: Valhalla1976 collected ($1.10)
Seat 6: GrinZwe91! folded before Flop (didn't bet)



PokerStars Hand #222964798902:  Hold'em No Limit ($0.05/$0.10 USD) - 2021/01/23 13:51:58 ET
Table 'Bohlinia III' 6-max Seat #3 is the button
Seat 1: xucuo ($14.10 in chips) 
Seat 2: Sve_Sve93 ($11.08 in chips) 
Seat 3: memojr29 ($13.89 in chips) 
Seat 4: JohnSF7 ($14.53 in chips) 
Seat 5: Valhalla1976 ($5.29 in chips) 
Seat 6: GrinZwe91! ($23.74 in chips) 
JohnSF7: posts small blind $0.05
Valhalla1976: posts big blind $0.10
*** HOLE CARDS ***
GrinZwe91!: folds 
xucuo: folds 
Sve_Sve93: folds 
memojr29: raises $0.15 to $0.25
JohnSF7: calls $0.20
Valhalla1976: calls $0.15
*** FLOP *** [3c Kd 2c]
JohnSF7: checks 
Valhalla1976: checks 
memojr29: bets $0.36
JohnSF7: folds 
Valhalla1976: folds 
Uncalled bet ($0.36) returned to memojr29
memojr29 collected $0.72 from pot
memojr29: doesn't show hand 
*** SUMMARY ***
Total pot $0.75 | Rake $0.03 
Board [3c Kd 2c]
Seat 1: xucuo folded before Flop (didn't bet)
Seat 2: Sve_Sve93 folded before Flop (didn't bet)
Seat 3: memojr29 (button) collected ($0.72)
Seat 4: JohnSF7 (small blind) folded on the Flop
Seat 5: Valhalla1976 (big blind) folded on the Flop
Seat 6: GrinZwe91! folded before Flop (didn't bet)



PokerStars Hand #222964824965:  Hold'em No Limit ($0.05/$0.10 USD) - 2021/01/23 13:52:33 ET
Table 'Bohlinia III' 6-max Seat #4 is the button
Seat 1: xucuo ($14.10 in chips) 
Seat 2: Sve_Sve93 ($11.08 in chips) 
Seat 3: memojr29 ($14.36 in chips) 
Seat 4: JohnSF7 ($14.28 in chips) 
Seat 5: Valhalla1976 ($5.04 in chips) 
Seat 6: GrinZwe91! ($23.74 in chips) 
Valhalla1976: posts small blind $0.05
GrinZwe91!: posts big blind $0.10
*** HOLE CARDS ***
xucuo: folds 
Sve_Sve93: raises $0.20 to $0.30
memojr29: folds 
JohnSF7: folds 
Valhalla1976: folds 
GrinZwe91!: folds 
Uncalled bet ($0.20) returned to Sve_Sve93
Sve_Sve93 collected $0.25 from pot
Sve_Sve93: doesn't show hand 
*** SUMMARY ***
Total pot $0.25 | Rake $0 
Seat 1: xucuo folded before Flop (didn't bet)
Seat 2: Sve_Sve93 collected ($0.25)
Seat 3: memojr29 folded before Flop (didn't bet)
Seat 4: JohnSF7 (button) folded before Flop (didn't bet)
Seat 5: Valhalla1976 (small blind) folded before Flop
Seat 6: GrinZwe91! (big blind) folded before Flop



PokerStars Hand #222964833607:  Hold'em No Limit ($0.05/$0.10 USD) - 2021/01/23 13:52:44 ET
Table 'Bohlinia III' 6-max Seat #5 is the button
Seat 1: xucuo ($14.10 in chips) 
Seat 2: Sve_Sve93 ($11.23 in chips) 
Seat 3: memojr29 ($14.36 in chips) 
Seat 4: JohnSF7 ($14.28 in chips) 
Seat 5: Valhalla1976 ($4.99 in chips) 
Seat 6: GrinZwe91! ($23.64 in chips) 
GrinZwe91!: posts small blind $0.05
xucuo: posts big blind $0.10
*** HOLE CARDS ***
Sve_Sve93: raises $0.20 to $0.30
memojr29: folds 
JohnSF7: folds 
Valhalla1976: calls $0.30
GrinZwe91!: folds 
xucuo: folds 
*** FLOP *** [Tc 7c Qc]
Sve_Sve93: bets $0.36
Valhalla1976: folds 
Uncalled bet ($0.36) returned to Sve_Sve93
Sve_Sve93 collected $0.72 from pot
Sve_Sve93: doesn't show hand 
*** SUMMARY ***
Total pot $0.75 | Rake $0.03 
Board [Tc 7c Qc]
Seat 1: xucuo (big blind) folded before Flop
Seat 2: Sve_Sve93 collected ($0.72)
Seat 3: memojr29 folded before Flop (didn't bet)
Seat 4: JohnSF7 folded before Flop (didn't bet)
Seat 5: Valhalla1976 (button) folded on the Flop
Seat 6: GrinZwe91! (small blind) folded before Flop



PokerStars Hand #222964851025:  Hold'em No Limit ($0.05/$0.10 USD) - 2021/01/23 13:53:07 ET
Table 'Bohlinia III' 6-max Seat #6 is the button
Seat 1: xucuo ($14 in chips) 
Seat 2: Sve_Sve93 ($11.65 in chips) 
Seat 3: memojr29 ($14.36 in chips) 
Seat 4: JohnSF7 ($14.28 in chips) 
Seat 5: Valhalla1976 ($4.69 in chips) 
Seat 6: GrinZwe91! ($23.59 in chips) 
xucuo: posts small blind $0.05
Sve_Sve93: posts big blind $0.10
*** HOLE CARDS ***
memojr29: folds 
JohnSF7: folds 
Valhalla1976: raises $0.20 to $0.30
GrinZwe91!: folds 
xucuo: calls $0.25
Sve_Sve93: folds 
*** FLOP *** [5d Kh 5s]
xucuo: bets $0.34
Valhalla1976: folds 
Uncalled bet ($0.34) returned to xucuo
xucuo collected $0.67 from pot
xucuo: doesn't show hand 
*** SUMMARY ***
Total pot $0.70 | Rake $0.03 
Board [5d Kh 5s]
Seat 1: xucuo (small blind) collected ($0.67)
Seat 2: Sve_Sve93 (big blind) folded before Flop
Seat 3: memojr29 folded before Flop (didn't bet)
Seat 4: JohnSF7 folded before Flop (didn't bet)
Seat 5: Valhalla1976 folded on the Flop
Seat 6: GrinZwe91! (button) folded before Flop (didn't bet)



PokerStars Hand #222964867985:  Hold'em No Limit ($0.05/$0.10 USD) - 2021/01/23 13:53:29 ET
Table 'Bohlinia III' 6-max Seat #1 is the button
Seat 1: xucuo ($14.37 in chips) 
Seat 2: Sve_Sve93 ($11.55 in chips) 
Seat 3: memojr29 ($14.36 in chips) 
Seat 4: JohnSF7 ($14.28 in chips) 
Seat 5: Valhalla1976 ($4.39 in chips) 
Seat 6: GrinZwe91! ($23.59 in chips) 
Sve_Sve93: posts small blind $0.05
memojr29: posts big blind $0.10
*** HOLE CARDS ***
JohnSF7: folds 
Valhalla1976: folds 
GrinZwe91!: folds 
xucuo: folds 
Sve_Sve93: folds 
Uncalled bet ($0.05) returned to memojr29
memojr29 collected $0.10 from pot
memojr29: doesn't show hand 
*** SUMMARY ***
Total pot $0.10 | Rake $0 
Seat 1: xucuo (button) folded before Flop (didn't bet)
Seat 2: Sve_Sve93 (small blind) folded before Flop
Seat 3: memojr29 (big blind) collected ($0.10)
Seat 4: JohnSF7 folded before Flop (didn't bet)
Seat 5: Valhalla1976 folded before Flop (didn't bet)
Seat 6: GrinZwe91! folded before Flop (didn't bet)



PokerStars Hand #222964877448:  Hold'em No Limit ($0.05/$0.10 USD) - 2021/01/23 13:53:42 ET
Table 'Bohlinia III' 6-max Seat #2 is the button
Seat 1: xucuo ($14.37 in chips) 
Seat 2: Sve_Sve93 ($11.50 in chips) 
Seat 3: memojr29 ($14.41 in chips) 
Seat 4: JohnSF7 ($14.28 in chips) 
Seat 5: Valhalla1976 ($4.39 in chips) 
Seat 6: GrinZwe91! ($23.59 in chips) 
memojr29: posts small blind $0.05
JohnSF7: posts big blind $0.10
*** HOLE CARDS ***
Valhalla1976: folds 
GrinZwe91!: raises $0.20 to $0.30
xucuo: folds 
Sve_Sve93: folds 
memojr29: folds 
JohnSF7: folds 
Uncalled bet ($0.20) returned to GrinZwe91!
GrinZwe91! collected $0.25 from pot
GrinZwe91!: doesn't show hand 
*** SUMMARY ***
Total pot $0.25 | Rake $0 
Seat 1: xucuo folded before Flop (didn't bet)
Seat 2: Sve_Sve93 (button) folded before Flop (didn't bet)
Seat 3: memojr29 (small blind) folded before Flop
Seat 4: JohnSF7 (big blind) folded before Flop
Seat 5: Valhalla1976 folded before Flop (didn't bet)
Seat 6: GrinZwe91! collected ($0.25)



PokerStars Hand #222964898835:  Hold'em No Limit ($0.05/$0.10 USD) - 2021/01/23 13:54:10 ET
Table 'Bohlinia III' 6-max Seat #3 is the button
Seat 1: xucuo ($14.37 in chips) 
Seat 2: Sve_Sve93 ($11.50 in chips) 
Seat 3: memojr29 ($14.36 in chips) 
Seat 4: JohnSF7 ($14.18 in chips) 
Seat 5: Valhalla1976 ($4.39 in chips) 
Seat 6: GrinZwe91! ($23.74 in chips) 
JohnSF7: posts small blind $0.05
Valhalla1976: posts big blind $0.10
*** HOLE CARDS ***
GrinZwe91!: folds 
xucuo: folds 
Sve_Sve93: folds 
memojr29: folds 
JohnSF7: raises $0.20 to $0.30
Valhalla1976: calls $0.20
*** FLOP *** [7h 7s Kd]
JohnSF7: bets $0.19
Valhalla1976: calls $0.19
*** TURN *** [7h 7s Kd] [Kc]
JohnSF7: checks 
Valhalla1976: bets $0.47
JohnSF7: folds 
Uncalled bet ($0.47) returned to Valhalla1976
Valhalla1976 collected $0.94 from pot
Valhalla1976: doesn't show hand 
*** SUMMARY ***
Total pot $0.98 | Rake $0.04 
Board [7h 7s Kd Kc]
Seat 1: xucuo folded before Flop (didn't bet)
Seat 2: Sve_Sve93 folded before Flop (didn't bet)
Seat 3: memojr29 (button) folded before Flop (didn't bet)
Seat 4: JohnSF7 (small blind) folded on the Turn
Seat 5: Valhalla1976 (big blind) collected ($0.94)
Seat 6: GrinZwe91! folded before Flop (didn't bet)



PokerStars Hand #222964918969:  Hold'em No Limit ($0.05/$0.10 USD) - 2021/01/23 13:54:37 ET
Table 'Bohlinia III' 6-max Seat #4 is the button
Seat 1: xucuo ($14.37 in chips) 
Seat 2: Sve_Sve93 ($11.50 in chips) 
Seat 3: memojr29 ($14.36 in chips) 
Seat 4: JohnSF7 ($13.69 in chips) 
Seat 5: Valhalla1976 ($4.84 in chips) 
Seat 6: GrinZwe91! ($23.74 in chips) 
Valhalla1976: posts small blind $0.05
GrinZwe91!: posts big blind $0.10
*** HOLE CARDS ***
xucuo: calls $0.10
Sve_Sve93: folds 
memojr29: folds 
JohnSF7: folds 
Valhalla1976: raises $0.40 to $0.50
GrinZwe91!: folds 
xucuo: folds 
Uncalled bet ($0.40) returned to Valhalla1976
Valhalla1976 collected $0.30 from pot
Valhalla1976: doesn't show hand 
*** SUMMARY ***
Total pot $0.30 | Rake $0 
Seat 1: xucuo folded before Flop
Seat 2: Sve_Sve93 folded before Flop (didn't bet)
Seat 3: memojr29 folded before Flop (didn't bet)
Seat 4: JohnSF7 (button) folded before Flop (didn't bet)
Seat 5: Valhalla1976 (small blind) collected ($0.30)
Seat 6: GrinZwe91! (big blind) folded before Flop



PokerStars Hand #222964934261:  Hold'em No Limit ($0.05/$0.10 USD) - 2021/01/23 13:54:57 ET
Table 'Bohlinia III' 6-max Seat #5 is the button
Seat 1: xucuo ($14.27 in chips) 
Seat 2: Sve_Sve93 ($11.50 in chips) 
Seat 3: memojr29 ($14.36 in chips) 
Seat 4: JohnSF7 ($13.69 in chips) 
Seat 5: Valhalla1976 ($5.04 in chips) 
Seat 6: GrinZwe91! ($23.64 in chips) 
GrinZwe91!: posts small blind $0.05
xucuo: posts big blind $0.10
*** HOLE CARDS ***
Sve_Sve93: folds 
memojr29: folds 
JohnSF7: folds 
Valhalla1976: raises $0.20 to $0.30
GrinZwe91!: folds 
xucuo: folds 
Uncalled bet ($0.20) returned to Valhalla1976
Valhalla1976 collected $0.25 from pot
Valhalla1976: doesn't show hand 
*** SUMMARY ***
Total pot $0.25 | Rake $0 
Seat 1: xucuo (big blind) folded before Flop
Seat 2: Sve_Sve93 folded before Flop (didn't bet)
Seat 3: memojr29 folded before Flop (didn't bet)
Seat 4: JohnSF7 folded before Flop (didn't bet)
Seat 5: Valhalla1976 (button) collected ($0.25)
Seat 6: GrinZwe91! (small blind) folded before Flop



PokerStars Hand #222964943712:  Hold'em No Limit ($0.05/$0.10 USD) - 2021/01/23 13:55:10 ET
Table 'Bohlinia III' 6-max Seat #6 is the button
Seat 1: xucuo ($14.17 in chips) 
Seat 2: Sve_Sve93 ($11.50 in chips) 
Seat 3: memojr29 ($14.36 in chips) 
Seat 4: JohnSF7 ($13.69 in chips) 
Seat 5: Valhalla1976 ($5.19 in chips) 
Seat 6: GrinZwe91! ($23.59 in chips) 
xucuo: posts small blind $0.05
Sve_Sve93: posts big blind $0.10
*** HOLE CARDS ***
memojr29: folds 
JohnSF7: folds 
Valhalla1976: calls $0.10
GrinZwe91!: raises $0.30 to $0.40
xucuo: folds 
Sve_Sve93: folds 
Valhalla1976: calls $0.30
*** FLOP *** [4h 3h 5h]
Valhalla1976: checks 
GrinZwe91!: bets $0.50
Valhalla1976: folds 
Uncalled bet ($0.50) returned to GrinZwe91!
GrinZwe91! collected $0.91 from pot
GrinZwe91!: doesn't show hand 
*** SUMMARY ***
Total pot $0.95 | Rake $0.04 
Board [4h 3h 5h]
Seat 1: xucuo (small blind) folded before Flop
Seat 2: Sve_Sve93 (big blind) folded before Flop
Seat 3: memojr29 folded before Flop (didn't bet)
Seat 4: JohnSF7 folded before Flop (didn't bet)
Seat 5: Valhalla1976 folded on the Flop
Seat 6: GrinZwe91! (button) collected ($0.91)



PokerStars Hand #222964960997:  Hold'em No Limit ($0.05/$0.10 USD) - 2021/01/23 13:55:46 ET
Table 'Bohlinia III' 6-max Seat #1 is the button
Seat 1: xucuo ($14.12 in chips) 
Seat 2: Sve_Sve93 ($11.40 in chips) 
Seat 3: memojr29 ($14.36 in chips) 
Seat 4: JohnSF7 ($13.69 in chips) 
Seat 5: Valhalla1976 ($4.79 in chips) 
Seat 6: GrinZwe91! ($24.10 in chips) 
Sve_Sve93: posts small blind $0.05
memojr29: posts big blind $0.10
*** HOLE CARDS ***
JohnSF7: folds 
Valhalla1976: folds 
GrinZwe91!: folds 
xucuo: calls $0.10
Sve_Sve93: folds 
memojr29: raises $0.50 to $0.60
xucuo: calls $0.50
*** FLOP *** [Js Qd 8s]
memojr29: bets $0.60
xucuo: folds 
Uncalled bet ($0.60) returned to memojr29
memojr29 collected $1.19 from pot
memojr29: doesn't show hand 
*** SUMMARY ***
Total pot $1.25 | Rake $0.06 
Board [Js Qd 8s]
Seat 1: xucuo (button) folded on the Flop
Seat 2: Sve_Sve93 (small blind) folded before Flop
Seat 3: memojr29 (big blind) collected ($1.19)
Seat 4: JohnSF7 folded before Flop (didn't bet)
Seat 5: Valhalla1976 folded before Flop (didn't bet)
Seat 6: GrinZwe91! folded before Flop (didn't bet)



PokerStars Hand #222964974210:  Hold'em No Limit ($0.05/$0.10 USD) - 2021/01/23 13:56:13 ET
Table 'Bohlinia III' 6-max Seat #2 is the button
Seat 1: xucuo ($13.52 in chips) 
Seat 2: Sve_Sve93 ($11.35 in chips) 
Seat 3: memojr29 ($14.95 in chips) 
Seat 4: JohnSF7 ($13.69 in chips) 
Seat 6: GrinZwe91! ($24.10 in chips) 
memojr29: posts small blind $0.05
JohnSF7: posts big blind $0.10
*** HOLE CARDS ***
GrinZwe91!: raises $0.20 to $0.30
xucuo: calls $0.30
Sve_Sve93: folds 
memojr29: folds 
JohnSF7: calls $0.20
*** FLOP *** [Ks 8d 2c]
JohnSF7: checks 
GrinZwe91!: bets $0.50
xucuo: folds 
JohnSF7: calls $0.50
*** TURN *** [Ks 8d 2c] [5c]
JohnSF7: checks 
GrinZwe91!: bets $1.20
JohnSF7: calls $1.20
*** RIVER *** [Ks 8d 2c 5c] [5d]
JohnSF7: checks 
GrinZwe91!: bets $1.80
JohnSF7: calls $1.80
*** SHOW DOWN ***
GrinZwe91!: shows [As Ah] (two pair, Aces and Fives)
JohnSF7: mucks hand 
GrinZwe91! collected $7.59 from pot
*** SUMMARY ***
Total pot $7.95 | Rake $0.36 
Board [Ks 8d 2c 5c 5d]
Seat 1: xucuo folded on the Flop
Seat 2: Sve_Sve93 (button) folded before Flop (didn't bet)
Seat 3: memojr29 (small blind) folded before Flop
Seat 4: JohnSF7 (big blind) mucked
Seat 6: GrinZwe91! showed [As Ah] and won ($7.59) with two pair, Aces and Fives



PokerStars Hand #222965007639:  Hold'em No Limit ($0.05/$0.10 USD) - 2021/01/23 13:57:23 ET
Table 'Bohlinia III' 6-max Seat #3 is the button
Seat 1: xucuo ($13.22 in chips) 
Seat 2: Sve_Sve93 ($11.35 in chips) 
Seat 3: memojr29 ($14.90 in chips) 
Seat 4: JohnSF7 ($10 in chips) 
Seat 5: Valhalla1976 ($4.79 in chips) 
Seat 6: GrinZwe91! ($27.89 in chips) 
JohnSF7: posts small blind $0.05
Valhalla1976: posts big blind $0.10
*** HOLE CARDS ***
GrinZwe91!: folds 
xucuo: folds 
Sve_Sve93: folds 
memojr29: folds 
JohnSF7: folds 
Uncalled bet ($0.05) returned to Valhalla1976
Valhalla1976 collected $0.10 from pot
Valhalla1976: doesn't show hand 
*** SUMMARY ***
Total pot $0.10 | Rake $0 
Seat 1: xucuo folded before Flop (didn't bet)
Seat 2: Sve_Sve93 folded before Flop (didn't bet)
Seat 3: memojr29 (button) folded before Flop (didn't bet)
Seat 4: JohnSF7 (small blind) folded before Flop
Seat 5: Valhalla1976 (big blind) collected ($0.10)
Seat 6: GrinZwe91! folded before Flop (didn't bet)



PokerStars Hand #222965014881:  Hold'em No Limit ($0.05/$0.10 USD) - 2021/01/23 13:57:38 ET
Table 'Bohlinia III' 6-max Seat #4 is the button
Seat 1: xucuo ($13.22 in chips) 
Seat 2: Sve_Sve93 ($11.35 in chips) 
Seat 3: memojr29 ($14.90 in chips) 
Seat 4: JohnSF7 ($10 in chips) 
Seat 5: Valhalla1976 ($4.84 in chips) 
Seat 6: GrinZwe91! ($27.89 in chips) 
Valhalla1976: posts small blind $0.05
GrinZwe91!: posts big blind $0.10
*** HOLE CARDS ***
xucuo: calls $0.10
Sve_Sve93: raises $0.20 to $0.30
memojr29: folds 
JohnSF7: calls $0.30
Valhalla1976: calls $0.25
GrinZwe91!: folds 
xucuo: calls $0.20
*** FLOP *** [6s 2h 3d]
Valhalla1976: checks 
xucuo: checks 
Sve_Sve93: checks 
JohnSF7: checks 
*** TURN *** [6s 2h 3d] [5h]
Valhalla1976: checks 
xucuo: checks 
Sve_Sve93: checks 
JohnSF7: checks 
*** RIVER *** [6s 2h 3d 5h] [Tc]
Valhalla1976: checks 
xucuo: checks 
Sve_Sve93: checks 
JohnSF7: checks 
*** SHOW DOWN ***
Valhalla1976: shows [9h Qh] (high card Queen)
xucuo: shows [9c Kc] (high card King)
Sve_Sve93: shows [8h 8s] (a pair of Eights)
JohnSF7: mucks hand 
Sve_Sve93 collected $1.24 from pot
*** SUMMARY ***
Total pot $1.30 | Rake $0.06 
Board [6s 2h 3d 5h Tc]
Seat 1: xucuo showed [9c Kc] and lost with high card King
Seat 2: Sve_Sve93 showed [8h 8s] and won ($1.24) with a pair of Eights
Seat 3: memojr29 folded before Flop (didn't bet)
Seat 4: JohnSF7 (button) mucked
Seat 5: Valhalla1976 (small blind) showed [9h Qh] and lost with high card Queen
Seat 6: GrinZwe91! (big blind) folded before Flop



PokerStars Hand #222965038503:  Hold'em No Limit ($0.05/$0.10 USD) - 2021/01/23 13:58:25 ET
Table 'Bohlinia III' 6-max Seat #5 is the button
Seat 1: xucuo ($12.92 in chips) 
Seat 2: Sve_Sve93 ($12.29 in chips) 
Seat 3: memojr29 ($14.90 in chips) 
Seat 4: JohnSF7 ($10 in chips) 
Seat 5: Valhalla1976 ($4.54 in chips) 
Seat 6: GrinZwe91! ($27.79 in chips) 
GrinZwe91!: posts small blind $0.05
xucuo: posts big blind $0.10
*** HOLE CARDS ***
Sve_Sve93: folds 
memojr29: folds 
JohnSF7: folds 
Valhalla1976: raises $0.10 to $0.20
GrinZwe91!: folds 
xucuo: folds 
Uncalled bet ($0.10) returned to Valhalla1976
Valhalla1976 collected $0.25 from pot
Valhalla1976: doesn't show hand 
*** SUMMARY ***
Total pot $0.25 | Rake $0 
Seat 1: xucuo (big blind) folded before Flop
Seat 2: Sve_Sve93 folded before Flop (didn't bet)
Seat 3: memojr29 folded before Flop (didn't bet)
Seat 4: JohnSF7 folded before Flop (didn't bet)
Seat 5: Valhalla1976 (button) collected ($0.25)
Seat 6: GrinZwe91! (small blind) folded before Flop



PokerStars Hand #222965044724:  Hold'em No Limit ($0.05/$0.10 USD) - 2021/01/23 13:58:38 ET
Table 'Bohlinia III' 6-max Seat #6 is the button
Seat 1: xucuo ($12.82 in chips) 
Seat 2: Sve_Sve93 ($12.29 in chips) 
Seat 3: memojr29 ($14.90 in chips) 
Seat 4: JohnSF7 ($10 in chips) 
Seat 5: Valhalla1976 ($4.69 in chips) 
Seat 6: GrinZwe91! ($27.74 in chips) 
xucuo: posts small blind $0.05
Sve_Sve93: posts big blind $0.10
*** HOLE CARDS ***
memojr29: raises $0.20 to $0.30
JohnSF7: folds 
Valhalla1976: folds 
GrinZwe91!: folds 
xucuo: folds 
Sve_Sve93: folds 
Uncalled bet ($0.20) returned to memojr29
memojr29 collected $0.25 from pot
memojr29: doesn't show hand 
*** SUMMARY ***
Total pot $0.25 | Rake $0 
Seat 1: xucuo (small blind) folded before Flop
Seat 2: Sve_Sve93 (big blind) folded before Flop
Seat 3: memojr29 collected ($0.25)
Seat 4: JohnSF7 folded before Flop (didn't bet)
Seat 5: Valhalla1976 folded before Flop (didn't bet)
Seat 6: GrinZwe91! (button) folded before Flop (didn't bet)



PokerStars Hand #222965049555:  Hold'em No Limit ($0.05/$0.10 USD) - 2021/01/23 13:58:48 ET
Table 'Bohlinia III' 6-max Seat #1 is the button
Seat 1: xucuo ($12.77 in chips) 
Seat 2: Sve_Sve93 ($12.19 in chips) 
Seat 3: memojr29 ($15.05 in chips) 
Seat 4: JohnSF7 ($10 in chips) 
Seat 5: Valhalla1976 ($4.69 in chips) 
Seat 6: GrinZwe91! ($27.74 in chips) 
Sve_Sve93: posts small blind $0.05
memojr29: posts big blind $0.10
*** HOLE CARDS ***
JohnSF7: raises $0.20 to $0.30
Valhalla1976: folds 
GrinZwe91!: folds 
xucuo: folds 
Sve_Sve93: folds 
memojr29: folds 
Uncalled bet ($0.20) returned to JohnSF7
JohnSF7 collected $0.25 from pot
JohnSF7: doesn't show hand 
*** SUMMARY ***
Total pot $0.25 | Rake $0 
Seat 1: xucuo (button) folded before Flop (didn't bet)
Seat 2: Sve_Sve93 (small blind) folded before Flop
Seat 3: memojr29 (big blind) folded before Flop
Seat 4: JohnSF7 collected ($0.25)
Seat 5: Valhalla1976 folded before Flop (didn't bet)
Seat 6: GrinZwe91! folded before Flop (didn't bet)



PokerStars Hand #222965057968:  Hold'em No Limit ($0.05/$0.10 USD) - 2021/01/23 13:59:05 ET
Table 'Bohlinia III' 6-max Seat #2 is the button
Seat 1: xucuo ($12.77 in chips) 
Seat 2: Sve_Sve93 ($12.14 in chips) 
Seat 3: memojr29 ($14.95 in chips) 
Seat 4: JohnSF7 ($10.15 in chips) 
Seat 5: Valhalla1976 ($4.69 in chips) 
Seat 6: GrinZwe91! ($27.74 in chips) 
memojr29: posts small blind $0.05
JohnSF7: posts big blind $0.10
*** HOLE CARDS ***
Valhalla1976: calls $0.10
GrinZwe91!: folds 
xucuo: calls $0.10
Sve_Sve93: folds 
memojr29: folds 
JohnSF7: checks 
*** FLOP *** [Jh 9s 5h]
JohnSF7: checks 
Valhalla1976: bets $0.33
xucuo: calls $0.33
JohnSF7: folds 
*** TURN *** [Jh 9s 5h] [Jd]
Valhalla1976: bets $0.30
xucuo: raises $0.30 to $0.60
Valhalla1976: raises $0.30 to $0.90
xucuo: raises $0.30 to $1.20
Valhalla1976: raises $3.06 to $4.26 and is all-in
xucuo: calls $3.06
*** RIVER *** [Jh 9s 5h Jd] [4h]
*** SHOW DOWN ***
Valhalla1976: shows [5c Jc] (a full house, Jacks full of Fives)
xucuo: shows [9h 9d] (a full house, Nines full of Jacks)
Valhalla1976 collected $9.10 from pot
*** SUMMARY ***
Total pot $9.53 | Rake $0.43 
Board [Jh 9s 5h Jd 4h]
Seat 1: xucuo showed [9h 9d] and lost with a full house, Nines full of Jacks
Seat 2: Sve_Sve93 (button) folded before Flop (didn't bet)
Seat 3: memojr29 (small blind) folded before Flop
Seat 4: JohnSF7 (big blind) folded on the Flop
Seat 5: Valhalla1976 showed [5c Jc] and won ($9.10) with a full house, Jacks full of Fives
Seat 6: GrinZwe91! folded before Flop (didn't bet)



PokerStars Hand #222965091874:  Hold'em No Limit ($0.05/$0.10 USD) - 2021/01/23 14:00:12 ET
Table 'Bohlinia III' 6-max Seat #3 is the button
Seat 1: xucuo ($10 in chips) 
Seat 2: Sve_Sve93 ($12.14 in chips) 
Seat 3: memojr29 ($14.90 in chips) 
Seat 4: JohnSF7 ($10.05 in chips) 
Seat 5: Valhalla1976 ($9.10 in chips) 
Seat 6: GrinZwe91! ($27.74 in chips) 
JohnSF7: posts small blind $0.05
Valhalla1976: posts big blind $0.10
*** HOLE CARDS ***
GrinZwe91!: folds 
xucuo: raises $0.20 to $0.30
Sve_Sve93: folds 
memojr29: folds 
JohnSF7: folds 
Valhalla1976: calls $0.20
*** FLOP *** [7s 6d Jh]
Valhalla1976: checks 
xucuo: checks 
*** TURN *** [7s 6d Jh] [7c]
Valhalla1976: bets $0.30
xucuo: folds 
Uncalled bet ($0.30) returned to Valhalla1976
Valhalla1976 collected $0.62 from pot
Valhalla1976: doesn't show hand 
*** SUMMARY ***
Total pot $0.65 | Rake $0.03 
Board [7s 6d Jh 7c]
Seat 1: xucuo folded on the Turn
Seat 2: Sve_Sve93 folded before Flop (didn't bet)
Seat 3: memojr29 (button) folded before Flop (didn't bet)
Seat 4: JohnSF7 (small blind) folded before Flop
Seat 5: Valhalla1976 (big blind) collected ($0.62)
Seat 6: GrinZwe91! folded before Flop (didn't bet)



PokerStars Hand #222965111534:  Hold'em No Limit ($0.05/$0.10 USD) - 2021/01/23 14:00:48 ET
Table 'Bohlinia III' 6-max Seat #4 is the button
Seat 1: xucuo ($10 in chips) 
Seat 2: Sve_Sve93 ($12.14 in chips) 
Seat 3: memojr29 ($14.90 in chips) 
Seat 4: JohnSF7 ($10 in chips) 
Seat 5: Valhalla1976 ($9.42 in chips) 
Seat 6: GrinZwe91! ($27.74 in chips) 
Valhalla1976: posts small blind $0.05
GrinZwe91!: posts big blind $0.10
*** HOLE CARDS ***
xucuo: calls $0.10
Sve_Sve93: folds 
memojr29: folds 
JohnSF7: folds 
Valhalla1976: calls $0.05
GrinZwe91!: checks 
*** FLOP *** [5h 5d Tc]
Valhalla1976: checks 
GrinZwe91!: checks 
xucuo: checks 
*** TURN *** [5h 5d Tc] [Kd]
Valhalla1976: checks 
GrinZwe91!: checks 
xucuo: checks 
*** RIVER *** [5h 5d Tc Kd] [Ac]
Valhalla1976: bets $0.29
GrinZwe91!: folds 
xucuo: folds 
Uncalled bet ($0.29) returned to Valhalla1976
Valhalla1976 collected $0.29 from pot
Valhalla1976: doesn't show hand 
*** SUMMARY ***
Total pot $0.30 | Rake $0.01 
Board [5h 5d Tc Kd Ac]
Seat 1: xucuo folded on the River
Seat 2: Sve_Sve93 folded before Flop (didn't bet)
Seat 3: memojr29 folded before Flop (didn't bet)
Seat 4: JohnSF7 (button) folded before Flop (didn't bet)
Seat 5: Valhalla1976 (small blind) collected ($0.29)
Seat 6: GrinZwe91! (big blind) folded on the River



PokerStars Hand #222965143153:  Hold'em No Limit ($0.05/$0.10 USD) - 2021/01/23 14:01:38 ET
Table 'Bohlinia III' 6-max Seat #5 is the button
Seat 1: xucuo ($10 in chips) 
Seat 2: Sve_Sve93 ($12.14 in chips) 
Seat 3: memojr29 ($14.90 in chips) 
Seat 4: JohnSF7 ($10 in chips) 
Seat 5: Valhalla1976 ($9.61 in chips) 
Seat 6: GrinZwe91! ($27.64 in chips) 
GrinZwe91!: posts small blind $0.05
xucuo: posts big blind $0.10
*** HOLE CARDS ***
Sve_Sve93: folds 
memojr29: folds 
JohnSF7: raises $0.15 to $0.25
Valhalla1976: calls $0.25
GrinZwe91!: folds 
xucuo: folds 
*** FLOP *** [Th 2h Qd]
JohnSF7: bets $0.34
Valhalla1976: calls $0.34
*** TURN *** [Th 2h Qd] [2c]
JohnSF7: bets $0.70
Valhalla1976: calls $0.70
*** RIVER *** [Th 2h Qd 2c] [As]
JohnSF7: checks 
Valhalla1976: bets $1.30
JohnSF7: folds 
Uncalled bet ($1.30) returned to Valhalla1976
Valhalla1976 collected $2.61 from pot
Valhalla1976: doesn't show hand 
*** SUMMARY ***
Total pot $2.73 | Rake $0.12 
Board [Th 2h Qd 2c As]
Seat 1: xucuo (big blind) folded before Flop
Seat 2: Sve_Sve93 folded before Flop (didn't bet)
Seat 3: memojr29 folded before Flop (didn't bet)
Seat 4: JohnSF7 folded on the River
Seat 5: Valhalla1976 (button) collected ($2.61)
Seat 6: GrinZwe91! (small blind) folded before Flop



PokerStars Hand #222965184650:  Hold'em No Limit ($0.05/$0.10 USD) - 2021/01/23 14:02:25 ET
Table 'Bohlinia III' 6-max Seat #6 is the button
Seat 1: xucuo ($10 in chips) 
Seat 2: Sve_Sve93 ($12.14 in chips) 
Seat 3: memojr29 ($14.90 in chips) 
Seat 4: JohnSF7 ($10 in chips) 
Seat 5: Valhalla1976 ($10.93 in chips) 
Seat 6: GrinZwe91! ($27.59 in chips) 
xucuo: posts small blind $0.05
Sve_Sve93: posts big blind $0.10
*** HOLE CARDS ***
memojr29: folds 
JohnSF7: raises $0.15 to $0.25
Valhalla1976: calls $0.25
GrinZwe91!: folds 
xucuo: folds 
Sve_Sve93: folds 
*** FLOP *** [Th Js 7d]
JohnSF7: bets $0.34
Valhalla1976: calls $0.34
*** TURN *** [Th Js 7d] [6h]
JohnSF7: bets $0.70
Valhalla1976: calls $0.70
*** RIVER *** [Th Js 7d 6h] [2c]
JohnSF7: checks 
Valhalla1976: bets $1.30
JohnSF7: calls $1.30
*** SHOW DOWN ***
Valhalla1976: shows [Qh 8d] (high card Queen)
JohnSF7: shows [Jd Ah] (a pair of Jacks)
JohnSF7 collected $5.09 from pot
*** SUMMARY ***
Total pot $5.33 | Rake $0.24 
Board [Th Js 7d 6h 2c]
Seat 1: xucuo (small blind) folded before Flop
Seat 2: Sve_Sve93 (big blind) folded before Flop
Seat 3: memojr29 folded before Flop (didn't bet)
Seat 4: JohnSF7 showed [Jd Ah] and won ($5.09) with a pair of Jacks
Seat 5: Valhalla1976 showed [Qh 8d] and lost with high card Queen
Seat 6: GrinZwe91! (button) folded before Flop (didn't bet)



PokerStars Hand #222965223326:  Hold'em No Limit ($0.05/$0.10 USD) - 2021/01/23 14:03:14 ET
Table 'Bohlinia III' 6-max Seat #1 is the button
Seat 1: xucuo ($10 in chips) 
Seat 2: Sve_Sve93 ($12.04 in chips) 
Seat 4: JohnSF7 ($12.50 in chips) 
Seat 5: Valhalla1976 ($8.34 in chips) 
Seat 6: GrinZwe91! ($27.59 in chips) 
Sve_Sve93: posts small blind $0.05
memojr29: is sitting out 
JohnSF7: posts big blind $0.10
*** HOLE CARDS ***
memojr29 leaves the table
Valhalla1976: folds 
GrinZwe91!: folds 
xucuo: calls $0.10
Sve_Sve93: folds 
JohnSF7: checks 
*** FLOP *** [3c 7h Ad]
GoodmanAR joins the table at seat #3 
JohnSF7: checks 
xucuo: checks 
*** TURN *** [3c 7h Ad] [5d]
JohnSF7: checks 
xucuo: bets $0.10
JohnSF7: calls $0.10
*** RIVER *** [3c 7h Ad 5d] [Ts]
JohnSF7: checks 
xucuo: bets $0.22
JohnSF7: folds 
Uncalled bet ($0.22) returned to xucuo
xucuo collected $0.43 from pot
xucuo: doesn't show hand 
*** SUMMARY ***
Total pot $0.45 | Rake $0.02 
Board [3c 7h Ad 5d Ts]
Seat 1: xucuo (button) collected ($0.43)
Seat 2: Sve_Sve93 (small blind) folded before Flop
Seat 4: JohnSF7 (big blind) folded on the River
Seat 5: Valhalla1976 folded before Flop (didn't bet)
Seat 6: GrinZwe91! folded before Flop (didn't bet)



PokerStars Hand #222965261902:  Hold'em No Limit ($0.05/$0.10 USD) - 2021/01/23 14:04:04 ET
Table 'Bohlinia III' 6-max Seat #2 is the button
Seat 1: xucuo ($10.23 in chips) 
Seat 2: Sve_Sve93 ($11.99 in chips) 
Seat 4: JohnSF7 ($12.30 in chips) 
Seat 5: Valhalla1976 ($8.34 in chips) 
Seat 6: GrinZwe91! ($27.59 in chips) 
JohnSF7: posts small blind $0.05
Valhalla1976: posts big blind $0.10
*** HOLE CARDS ***
GrinZwe91!: folds 
xucuo: calls $0.10
Sve_Sve93: folds 
JohnSF7: folds 
Valhalla1976: checks 
*** FLOP *** [2d Qd Ad]
Valhalla1976: checks 
xucuo: checks 
*** TURN *** [2d Qd Ad] [Jc]
Valhalla1976: checks 
xucuo: checks 
*** RIVER *** [2d Qd Ad Jc] [6h]
Valhalla1976: checks 
xucuo: checks 
*** SHOW DOWN ***
Valhalla1976: shows [5h Th] (high card Ace)
xucuo: shows [Ts 9d] (high card Ace - Queen+Jack+Ten+Nine kicker)
xucuo collected $0.24 from pot
*** SUMMARY ***
Total pot $0.25 | Rake $0.01 
Board [2d Qd Ad Jc 6h]
Seat 1: xucuo showed [Ts 9d] and won ($0.24) with high card Ace
Seat 2: Sve_Sve93 (button) folded before Flop (didn't bet)
Seat 4: JohnSF7 (small blind) folded before Flop
Seat 5: Valhalla1976 (big blind) showed [5h Th] and lost with high card Ace
Seat 6: GrinZwe91! folded before Flop (didn't bet)



PokerStars Hand #222965282911:  Hold'em No Limit ($0.05/$0.10 USD) - 2021/01/23 14:04:31 ET
Table 'Bohlinia III' 6-max Seat #4 is the button
Seat 1: xucuo ($10.37 in chips) 
Seat 2: Sve_Sve93 ($11.99 in chips) 
Seat 4: JohnSF7 ($12.25 in chips) 
Seat 5: Valhalla1976 ($8.24 in chips) 
Seat 6: GrinZwe91! ($27.59 in chips) 
Valhalla1976: posts small blind $0.05
GrinZwe91!: posts big blind $0.10
GoodmanAR: sits out 
*** HOLE CARDS ***
xucuo: folds 
Sve_Sve93: folds 
JohnSF7: folds 
Valhalla1976: raises $0.20 to $0.30
GrinZwe91!: folds 
Uncalled bet ($0.20) returned to Valhalla1976
Valhalla1976 collected $0.20 from pot
Valhalla1976: doesn't show hand 
*** SUMMARY ***
Total pot $0.20 | Rake $0 
Seat 1: xucuo folded before Flop (didn't bet)
Seat 2: Sve_Sve93 folded before Flop (didn't bet)
Seat 4: JohnSF7 (button) folded before Flop (didn't bet)
Seat 5: Valhalla1976 (small blind) collected ($0.20)
Seat 6: GrinZwe91! (big blind) folded before Flop



PokerStars Hand #222965296737:  Hold'em No Limit ($0.05/$0.10 USD) - 2021/01/23 14:04:48 ET
Table 'Bohlinia III' 6-max Seat #5 is the button
Seat 1: xucuo ($10.37 in chips) 
Seat 2: Sve_Sve93 ($11.99 in chips) 
Seat 4: JohnSF7 ($12.25 in chips) 
Seat 5: Valhalla1976 ($8.34 in chips) 
Seat 6: GrinZwe91! ($27.49 in chips) 
GrinZwe91!: posts small blind $0.05
xucuo: posts big blind $0.10
GoodmanAR: sits out 
*** HOLE CARDS ***
Sve_Sve93: folds 
JohnSF7: folds 
Valhalla1976: raises $0.20 to $0.30
GrinZwe91!: folds 
xucuo: calls $0.20
*** FLOP *** [Jd 2s Kc]
xucuo: checks 
Valhalla1976: checks 
*** TURN *** [Jd 2s Kc] [8d]
xucuo: bets $0.31
Valhalla1976: calls $0.31
*** RIVER *** [Jd 2s Kc 8d] [7c]
xucuo: bets $1.21
Valhalla1976: calls $1.21
*** SHOW DOWN ***
xucuo: shows [Ts 9h] (a straight, Seven to Jack)
Valhalla1976: mucks hand 
xucuo collected $3.52 from pot
*** SUMMARY ***
Total pot $3.69 | Rake $0.17 
Board [Jd 2s Kc 8d 7c]
Seat 1: xucuo (big blind) showed [Ts 9h] and won ($3.52) with a straight, Seven to Jack
Seat 2: Sve_Sve93 folded before Flop (didn't bet)
Seat 4: JohnSF7 folded before Flop (didn't bet)
Seat 5: Valhalla1976 (button) mucked
Seat 6: GrinZwe91! (small blind) folded before Flop



PokerStars Hand #222965328935:  Hold'em No Limit ($0.05/$0.10 USD) - 2021/01/23 14:05:28 ET
Table 'Bohlinia III' 6-max Seat #6 is the button
Seat 1: xucuo ($12.07 in chips) 
Seat 2: Sve_Sve93 ($11.99 in chips) 
Seat 4: JohnSF7 ($12.25 in chips) 
Seat 5: Valhalla1976 ($6.52 in chips) 
Seat 6: GrinZwe91! ($27.44 in chips) 
xucuo: posts small blind $0.05
Sve_Sve93: posts big blind $0.10
GoodmanAR: sits out 
*** HOLE CARDS ***
JohnSF7: raises $0.15 to $0.25
Valhalla1976: calls $0.25
GrinZwe91!: folds 
xucuo: folds 
Sve_Sve93: folds 
*** FLOP *** [Th Ah Td]
JohnSF7: bets $0.34
Valhalla1976: folds 
Uncalled bet ($0.34) returned to JohnSF7
JohnSF7 collected $0.62 from pot
JohnSF7: doesn't show hand 
*** SUMMARY ***
Total pot $0.65 | Rake $0.03 
Board [Th Ah Td]
Seat 1: xucuo (small blind) folded before Flop
Seat 2: Sve_Sve93 (big blind) folded before Flop
Seat 4: JohnSF7 collected ($0.62)
Seat 5: Valhalla1976 folded on the Flop
Seat 6: GrinZwe91! (button) folded before Flop (didn't bet)



PokerStars Hand #222965342638:  Hold'em No Limit ($0.05/$0.10 USD) - 2021/01/23 14:05:46 ET
Table 'Bohlinia III' 6-max Seat #1 is the button
Seat 1: xucuo ($12.02 in chips) 
Seat 2: Sve_Sve93 ($11.89 in chips) 
Seat 3: GoodmanAR ($10 in chips) 
Seat 4: JohnSF7 ($12.62 in chips) 
Seat 5: Valhalla1976 ($6.27 in chips) 
Seat 6: GrinZwe91! ($27.44 in chips) 
Sve_Sve93: posts small blind $0.05
GoodmanAR: posts big blind $0.10
*** HOLE CARDS ***
JohnSF7: folds 
Valhalla1976: raises $0.20 to $0.30
GrinZwe91!: folds 
xucuo: calls $0.30
Sve_Sve93: folds 
GoodmanAR: folds 
*** FLOP *** [3c Tc Kc]
Valhalla1976: bets $0.36
xucuo: folds 
Uncalled bet ($0.36) returned to Valhalla1976
Valhalla1976 collected $0.72 from pot
Valhalla1976: doesn't show hand 
*** SUMMARY ***
Total pot $0.75 | Rake $0.03 
Board [3c Tc Kc]
Seat 1: xucuo (button) folded on the Flop
Seat 2: Sve_Sve93 (small blind) folded before Flop
Seat 3: GoodmanAR (big blind) folded before Flop
Seat 4: JohnSF7 folded before Flop (didn't bet)
Seat 5: Valhalla1976 collected ($0.72)
Seat 6: GrinZwe91! folded before Flop (didn't bet)



PokerStars Hand #222965364643:  Hold'em No Limit ($0.05/$0.10 USD) - 2021/01/23 14:06:14 ET
Table 'Bohlinia III' 6-max Seat #2 is the button
Seat 1: xucuo ($11.72 in chips) 
Seat 2: Sve_Sve93 ($11.84 in chips) 
Seat 3: GoodmanAR ($10 in chips) 
Seat 4: JohnSF7 ($12.62 in chips) 
Seat 5: Valhalla1976 ($6.69 in chips) 
Seat 6: GrinZwe91! ($27.44 in chips) 
GoodmanAR: posts small blind $0.05
JohnSF7: posts big blind $0.10
*** HOLE CARDS ***
Valhalla1976: raises $0.40 to $0.50
GrinZwe91!: folds 
xucuo: folds 
Sve_Sve93: folds 
GoodmanAR: folds 
JohnSF7: folds 
Uncalled bet ($0.40) returned to Valhalla1976
Valhalla1976 collected $0.25 from pot
Valhalla1976: doesn't show hand 
*** SUMMARY ***
Total pot $0.25 | Rake $0 
Seat 1: xucuo folded before Flop (didn't bet)
Seat 2: Sve_Sve93 (button) folded before Flop (didn't bet)
Seat 3: GoodmanAR (small blind) folded before Flop
Seat 4: JohnSF7 (big blind) folded before Flop
Seat 5: Valhalla1976 collected ($0.25)
Seat 6: GrinZwe91! folded before Flop (didn't bet)



PokerStars Hand #222965378929:  Hold'em No Limit ($0.05/$0.10 USD) - 2021/01/23 14:06:32 ET
Table 'Bohlinia III' 6-max Seat #3 is the button
Seat 1: xucuo ($11.72 in chips) 
Seat 2: Sve_Sve93 ($11.84 in chips) 
Seat 3: GoodmanAR ($10 in chips) 
Seat 4: JohnSF7 ($12.52 in chips) 
Seat 5: Valhalla1976 ($6.84 in chips) 
Seat 6: GrinZwe91! ($27.44 in chips) 
JohnSF7: posts small blind $0.05
Valhalla1976: posts big blind $0.10
*** HOLE CARDS ***
GrinZwe91!: folds 
xucuo: folds 
Sve_Sve93: folds 
GoodmanAR: folds 
JohnSF7: raises $0.20 to $0.30
Valhalla1976: calls $0.20
*** FLOP *** [7c 6s Ts]
JohnSF7: checks 
Valhalla1976: checks 
*** TURN *** [7c 6s Ts] [Ad]
JohnSF7: checks 
Valhalla1976: bets $0.28
JohnSF7: folds 
Uncalled bet ($0.28) returned to Valhalla1976
Valhalla1976 collected $0.57 from pot
Valhalla1976: doesn't show hand 
*** SUMMARY ***
Total pot $0.60 | Rake $0.03 
Board [7c 6s Ts Ad]
Seat 1: xucuo folded before Flop (didn't bet)
Seat 2: Sve_Sve93 folded before Flop (didn't bet)
Seat 3: GoodmanAR (button) folded before Flop (didn't bet)
Seat 4: JohnSF7 (small blind) folded on the Turn
Seat 5: Valhalla1976 (big blind) collected ($0.57)
Seat 6: GrinZwe91! folded before Flop (didn't bet)



PokerStars Hand #222965406577:  Hold'em No Limit ($0.05/$0.10 USD) - 2021/01/23 14:07:06 ET
Table 'Bohlinia III' 6-max Seat #4 is the button
Seat 1: xucuo ($11.72 in chips) 
Seat 2: Sve_Sve93 ($11.84 in chips) 
Seat 3: GoodmanAR ($10 in chips) 
Seat 4: JohnSF7 ($12.22 in chips) 
Seat 5: Valhalla1976 ($7.11 in chips) 
Seat 6: GrinZwe91! ($27.44 in chips) 
Valhalla1976: posts small blind $0.05
GrinZwe91!: posts big blind $0.10
*** HOLE CARDS ***
xucuo: folds 
Sve_Sve93: raises $0.20 to $0.30
GoodmanAR: folds 
JohnSF7: folds 
Valhalla1976: folds 
GrinZwe91!: folds 
Uncalled bet ($0.20) returned to Sve_Sve93
Sve_Sve93 collected $0.25 from pot
Sve_Sve93: doesn't show hand 
*** SUMMARY ***
Total pot $0.25 | Rake $0 
Seat 1: xucuo folded before Flop (didn't bet)
Seat 2: Sve_Sve93 collected ($0.25)
Seat 3: GoodmanAR folded before Flop (didn't bet)
Seat 4: JohnSF7 (button) folded before Flop (didn't bet)
Seat 5: Valhalla1976 (small blind) folded before Flop
Seat 6: GrinZwe91! (big blind) folded before Flop



PokerStars Hand #222965417979:  Hold'em No Limit ($0.05/$0.10 USD) - 2021/01/23 14:07:21 ET
Table 'Bohlinia III' 6-max Seat #5 is the button
Seat 1: xucuo ($11.72 in chips) 
Seat 2: Sve_Sve93 ($11.99 in chips) 
Seat 3: GoodmanAR ($10 in chips) 
Seat 4: JohnSF7 ($12.22 in chips) 
Seat 5: Valhalla1976 ($7.06 in chips) 
Seat 6: GrinZwe91! ($27.34 in chips) 
GrinZwe91!: posts small blind $0.05
xucuo: posts big blind $0.10
*** HOLE CARDS ***
Sve_Sve93: folds 
GoodmanAR: folds 
JohnSF7: raises $0.15 to $0.25
Valhalla1976: calls $0.25
GrinZwe91!: folds 
xucuo: calls $0.15
*** FLOP *** [Jc Kh 4s]
xucuo: checks 
JohnSF7: bets $0.42
Valhalla1976: folds 
xucuo: folds 
Uncalled bet ($0.42) returned to JohnSF7
JohnSF7 collected $0.76 from pot
JohnSF7: doesn't show hand 
*** SUMMARY ***
Total pot $0.80 | Rake $0.04 
Board [Jc Kh 4s]
Seat 1: xucuo (big blind) folded on the Flop
Seat 2: Sve_Sve93 folded before Flop (didn't bet)
Seat 3: GoodmanAR folded before Flop (didn't bet)
Seat 4: JohnSF7 collected ($0.76)
Seat 5: Valhalla1976 (button) folded on the Flop
Seat 6: GrinZwe91! (small blind) folded before Flop



PokerStars Hand #222965446966:  Hold'em No Limit ($0.05/$0.10 USD) - 2021/01/23 14:07:58 ET
Table 'Bohlinia III' 6-max Seat #6 is the button
Seat 1: xucuo ($11.47 in chips) 
Seat 2: Sve_Sve93 ($11.99 in chips) 
Seat 3: GoodmanAR ($10 in chips) 
Seat 4: JohnSF7 ($12.73 in chips) 
Seat 5: Valhalla1976 ($6.81 in chips) 
Seat 6: GrinZwe91! ($27.29 in chips) 
xucuo: posts small blind $0.05
Sve_Sve93: posts big blind $0.10
*** HOLE CARDS ***
GoodmanAR: folds 
JohnSF7: folds 
Valhalla1976: raises $0.10 to $0.20
GrinZwe91!: folds 
xucuo: folds 
Sve_Sve93: folds 
Uncalled bet ($0.10) returned to Valhalla1976
Valhalla1976 collected $0.25 from pot
Valhalla1976: doesn't show hand 
*** SUMMARY ***
Total pot $0.25 | Rake $0 
Seat 1: xucuo (small blind) folded before Flop
Seat 2: Sve_Sve93 (big blind) folded before Flop
Seat 3: GoodmanAR folded before Flop (didn't bet)
Seat 4: JohnSF7 folded before Flop (didn't bet)
Seat 5: Valhalla1976 collected ($0.25)
Seat 6: GrinZwe91! (button) folded before Flop (didn't bet)



PokerStars Hand #222965453912:  Hold'em No Limit ($0.05/$0.10 USD) - 2021/01/23 14:08:06 ET
Table 'Bohlinia III' 6-max Seat #1 is the button
Seat 1: xucuo ($11.42 in chips) 
Seat 2: Sve_Sve93 ($11.89 in chips) 
Seat 3: GoodmanAR ($10 in chips) 
Seat 4: JohnSF7 ($12.73 in chips) 
Seat 5: Valhalla1976 ($6.96 in chips) 
Seat 6: GrinZwe91! ($27.29 in chips) 
Sve_Sve93: posts small blind $0.05
GoodmanAR: posts big blind $0.10
*** HOLE CARDS ***
JohnSF7: folds 
Valhalla1976: raises $0.40 to $0.50
GrinZwe91!: folds 
xucuo: folds 
Sve_Sve93: folds 
GoodmanAR: calls $0.40
*** FLOP *** [3s Ts Ac]
GoodmanAR: checks 
Valhalla1976: checks 
*** TURN *** [3s Ts Ac] [Ah]
GoodmanAR: bets $0.55
Valhalla1976: raises $0.55 to $1.10
GoodmanAR: calls $0.55
*** RIVER *** [3s Ts Ac Ah] [Kh]
GoodmanAR: checks 
Valhalla1976: checks 
*** SHOW DOWN ***
GoodmanAR: shows [Qs 9s] (a pair of Aces)
Valhalla1976: shows [7d 7h] (two pair, Aces and Sevens)
Valhalla1976 collected $3.10 from pot
*** SUMMARY ***
Total pot $3.25 | Rake $0.15 
Board [3s Ts Ac Ah Kh]
Seat 1: xucuo (button) folded before Flop (didn't bet)
Seat 2: Sve_Sve93 (small blind) folded before Flop
Seat 3: GoodmanAR (big blind) showed [Qs 9s] and lost with a pair of Aces
Seat 4: JohnSF7 folded before Flop (didn't bet)
Seat 5: Valhalla1976 showed [7d 7h] and won ($3.10) with two pair, Aces and Sevens
Seat 6: GrinZwe91! folded before Flop (didn't bet)



PokerStars Hand #222965500782:  Hold'em No Limit ($0.05/$0.10 USD) - 2021/01/23 14:09:05 ET
Table 'Bohlinia III' 6-max Seat #2 is the button
Seat 1: xucuo ($11.42 in chips) 
Seat 2: Sve_Sve93 ($11.84 in chips) 
Seat 3: GoodmanAR ($10 in chips) 
Seat 4: JohnSF7 ($12.73 in chips) 
Seat 5: Valhalla1976 ($8.46 in chips) 
Seat 6: GrinZwe91! ($27.29 in chips) 
GoodmanAR: posts small blind $0.05
JohnSF7: posts big blind $0.10
*** HOLE CARDS ***
Valhalla1976: folds 
GrinZwe91!: folds 
xucuo: folds 
xucuo leaves the table
Sve_Sve93: folds 
GoodmanAR: raises $0.20 to $0.30
Skiednis01 joins the table at seat #1 
JohnSF7: folds 
Uncalled bet ($0.20) returned to GoodmanAR
GoodmanAR collected $0.20 from pot
GoodmanAR: doesn't show hand 
*** SUMMARY ***
Total pot $0.20 | Rake $0 
Seat 1: xucuo folded before Flop (didn't bet)
Seat 2: Sve_Sve93 (button) folded before Flop (didn't bet)
Seat 3: GoodmanAR (small blind) collected ($0.20)
Seat 4: JohnSF7 (big blind) folded before Flop
Seat 5: Valhalla1976 folded before Flop (didn't bet)
Seat 6: GrinZwe91! folded before Flop (didn't bet)



PokerStars Hand #222965512156:  Hold'em No Limit ($0.05/$0.10 USD) - 2021/01/23 14:09:19 ET
Table 'Bohlinia III' 6-max Seat #3 is the button
Seat 2: Sve_Sve93 ($11.84 in chips) 
Seat 3: GoodmanAR ($10.10 in chips) 
Seat 4: JohnSF7 ($12.63 in chips) 
Seat 5: Valhalla1976 ($8.46 in chips) 
Seat 6: GrinZwe91! ($27.29 in chips) 
JohnSF7: posts small blind $0.05
Valhalla1976: posts big blind $0.10
Skiednis01: sits out 
*** HOLE CARDS ***
GrinZwe91!: folds 
Sve_Sve93: folds 
GoodmanAR: folds 
JohnSF7: folds 
Uncalled bet ($0.05) returned to Valhalla1976
Valhalla1976 collected $0.10 from pot
Valhalla1976: doesn't show hand 
*** SUMMARY ***
Total pot $0.10 | Rake $0 
Seat 2: Sve_Sve93 folded before Flop (didn't bet)
Seat 3: GoodmanAR (button) folded before Flop (didn't bet)
Seat 4: JohnSF7 (small blind) folded before Flop
Seat 5: Valhalla1976 (big blind) collected ($0.10)
Seat 6: GrinZwe91! folded before Flop (didn't bet)



PokerStars Hand #222965519104:  Hold'em No Limit ($0.05/$0.10 USD) - 2021/01/23 14:09:28 ET
Table 'Bohlinia III' 6-max Seat #4 is the button
Seat 2: Sve_Sve93 ($11.84 in chips) 
Seat 3: GoodmanAR ($10.10 in chips) 
Seat 4: JohnSF7 ($12.58 in chips) 
Seat 5: Valhalla1976 ($8.51 in chips) 
Seat 6: GrinZwe91! ($27.29 in chips) 
Valhalla1976: posts small blind $0.05
GrinZwe91!: posts big blind $0.10
Skiednis01: sits out 
*** HOLE CARDS ***
Sve_Sve93: folds 
GoodmanAR: folds 
JohnSF7: folds 
Valhalla1976: calls $0.05
GrinZwe91!: checks 
*** FLOP *** [3h Td 3d]
Valhalla1976: bets $0.10
GrinZwe91!: folds 
Uncalled bet ($0.10) returned to Valhalla1976
Valhalla1976 collected $0.19 from pot
Valhalla1976: doesn't show hand 
*** SUMMARY ***
Total pot $0.20 | Rake $0.01 
Board [3h Td 3d]
Seat 2: Sve_Sve93 folded before Flop (didn't bet)
Seat 3: GoodmanAR folded before Flop (didn't bet)
Seat 4: JohnSF7 (button) folded before Flop (didn't bet)
Seat 5: Valhalla1976 (small blind) collected ($0.19)
Seat 6: GrinZwe91! (big blind) folded on the Flop



PokerStars Hand #222965535047:  Hold'em No Limit ($0.05/$0.10 USD) - 2021/01/23 14:09:48 ET
Table 'Bohlinia III' 6-max Seat #5 is the button
Seat 1: Skiednis01 ($10 in chips) 
Seat 2: Sve_Sve93 ($11.84 in chips) 
Seat 3: GoodmanAR ($10.10 in chips) 
Seat 4: JohnSF7 ($12.58 in chips) 
Seat 5: Valhalla1976 ($8.60 in chips) 
Seat 6: GrinZwe91! ($27.19 in chips) 
GrinZwe91!: posts small blind $0.05
Skiednis01: posts big blind $0.10
*** HOLE CARDS ***
Sve_Sve93: folds 
GoodmanAR: raises $0.20 to $0.30
JohnSF7: folds 
Valhalla1976: calls $0.30
GrinZwe91!: folds 
Skiednis01: folds 
*** FLOP *** [8d 3d Qc]
GoodmanAR: checks 
Valhalla1976: bets $0.36
GoodmanAR: folds 
Uncalled bet ($0.36) returned to Valhalla1976
Valhalla1976 collected $0.72 from pot
Valhalla1976: doesn't show hand 
*** SUMMARY ***
Total pot $0.75 | Rake $0.03 
Board [8d 3d Qc]
Seat 1: Skiednis01 (big blind) folded before Flop
Seat 2: Sve_Sve93 folded before Flop (didn't bet)
Seat 3: GoodmanAR folded on the Flop
Seat 4: JohnSF7 folded before Flop (didn't bet)
Seat 5: Valhalla1976 (button) collected ($0.72)
Seat 6: GrinZwe91! (small blind) folded before Flop



PokerStars Hand #222965552205:  Hold'em No Limit ($0.05/$0.10 USD) - 2021/01/23 14:10:10 ET
Table 'Bohlinia III' 6-max Seat #6 is the button
Seat 1: Skiednis01 ($10 in chips) 
Seat 2: Sve_Sve93 ($11.84 in chips) 
Seat 3: GoodmanAR ($10 in chips) 
Seat 4: JohnSF7 ($12.58 in chips) 
Seat 5: Valhalla1976 ($9.02 in chips) 
Seat 6: GrinZwe91! ($27.14 in chips) 
Skiednis01: posts small blind $0.05
Sve_Sve93: posts big blind $0.10
*** HOLE CARDS ***
GoodmanAR: folds 
JohnSF7: folds 
Valhalla1976: raises $0.10 to $0.20
GrinZwe91!: folds 
Skiednis01: folds 
Sve_Sve93: calls $0.10
*** FLOP *** [2d 6d Kh]
Sve_Sve93: checks 
Valhalla1976: checks 
*** TURN *** [2d 6d Kh] [Ad]
Sve_Sve93: bets $0.30
Valhalla1976: raises $0.30 to $0.60
Sve_Sve93: raises $1.20 to $1.80
Valhalla1976: calls $1.20
*** RIVER *** [2d 6d Kh Ad] [7s]
Sve_Sve93: bets $2.70
Valhalla1976: folds 
Uncalled bet ($2.70) returned to Sve_Sve93
Sve_Sve93 collected $3.87 from pot
Sve_Sve93: doesn't show hand 
*** SUMMARY ***
Total pot $4.05 | Rake $0.18 
Board [2d 6d Kh Ad 7s]
Seat 1: Skiednis01 (small blind) folded before Flop
Seat 2: Sve_Sve93 (big blind) collected ($3.87)
Seat 3: GoodmanAR folded before Flop (didn't bet)
Seat 4: JohnSF7 folded before Flop (didn't bet)
Seat 5: Valhalla1976 folded on the River
Seat 6: GrinZwe91! (button) folded before Flop (didn't bet)



PokerStars Hand #222965596778:  Hold'em No Limit ($0.05/$0.10 USD) - 2021/01/23 14:11:07 ET
Table 'Bohlinia III' 6-max Seat #1 is the button
Seat 1: Skiednis01 ($10 in chips) 
Seat 2: Sve_Sve93 ($13.71 in chips) 
Seat 3: GoodmanAR ($10 in chips) 
Seat 4: JohnSF7 ($12.58 in chips) 
Seat 5: Valhalla1976 ($7.02 in chips) 
Seat 6: GrinZwe91! ($27.14 in chips) 
Sve_Sve93: posts small blind $0.05
GoodmanAR: posts big blind $0.10
*** HOLE CARDS ***
JohnSF7: folds 
Valhalla1976: raises $0.20 to $0.30
GrinZwe91!: folds 
Skiednis01: calls $0.30
Sve_Sve93: folds 
GoodmanAR: folds 
*** FLOP *** [Qd Qs Tc]
Valhalla1976: bets $0.36
Skiednis01: folds 
Uncalled bet ($0.36) returned to Valhalla1976
Valhalla1976 collected $0.72 from pot
Valhalla1976: doesn't show hand 
*** SUMMARY ***
Total pot $0.75 | Rake $0.03 
Board [Qd Qs Tc]
Seat 1: Skiednis01 (button) folded on the Flop
Seat 2: Sve_Sve93 (small blind) folded before Flop
Seat 3: GoodmanAR (big blind) folded before Flop
Seat 4: JohnSF7 folded before Flop (didn't bet)
Seat 5: Valhalla1976 collected ($0.72)
Seat 6: GrinZwe91! folded before Flop (didn't bet)



PokerStars Hand #222965619879:  Hold'em No Limit ($0.05/$0.10 USD) - 2021/01/23 14:11:36 ET
Table 'Bohlinia III' 6-max Seat #2 is the button
Seat 1: Skiednis01 ($10 in chips) 
Seat 2: Sve_Sve93 ($13.66 in chips) 
Seat 3: GoodmanAR ($10 in chips) 
Seat 4: JohnSF7 ($12.58 in chips) 
Seat 5: Valhalla1976 ($7.44 in chips) 
Seat 6: GrinZwe91! ($27.14 in chips) 
GoodmanAR: posts small blind $0.05
JohnSF7: posts big blind $0.10
*** HOLE CARDS ***
Valhalla1976: folds 
GrinZwe91!: folds 
Skiednis01: folds 
Sve_Sve93: folds 
GoodmanAR: raises $0.20 to $0.30
JohnSF7: folds 
Uncalled bet ($0.20) returned to GoodmanAR
GoodmanAR collected $0.20 from pot
GoodmanAR: doesn't show hand 
*** SUMMARY ***
Total pot $0.20 | Rake $0 
Seat 1: Skiednis01 folded before Flop (didn't bet)
Seat 2: Sve_Sve93 (button) folded before Flop (didn't bet)
Seat 3: GoodmanAR (small blind) collected ($0.20)
Seat 4: JohnSF7 (big blind) folded before Flop
Seat 5: Valhalla1976 folded before Flop (didn't bet)
Seat 6: GrinZwe91! folded before Flop (didn't bet)



PokerStars Hand #222965632934:  Hold'em No Limit ($0.05/$0.10 USD) - 2021/01/23 14:11:53 ET
Table 'Bohlinia III' 6-max Seat #3 is the button
Seat 1: Skiednis01 ($10 in chips) 
Seat 2: Sve_Sve93 ($13.66 in chips) 
Seat 3: GoodmanAR ($10.10 in chips) 
Seat 4: JohnSF7 ($12.48 in chips) 
Seat 5: Valhalla1976 ($7.44 in chips) 
Seat 6: GrinZwe91! ($27.14 in chips) 
JohnSF7: posts small blind $0.05
Valhalla1976: posts big blind $0.10
*** HOLE CARDS ***
GrinZwe91!: folds 
Skiednis01: raises $0.15 to $0.25
Sve_Sve93: folds 
GoodmanAR: folds 
JohnSF7: folds 
Valhalla1976: raises $0.15 to $0.40
Skiednis01: folds 
Uncalled bet ($0.15) returned to Valhalla1976
Valhalla1976 collected $0.55 from pot
Valhalla1976: doesn't show hand 
*** SUMMARY ***
Total pot $0.55 | Rake $0 
Seat 1: Skiednis01 folded before Flop
Seat 2: Sve_Sve93 folded before Flop (didn't bet)
Seat 3: GoodmanAR (button) folded before Flop (didn't bet)
Seat 4: JohnSF7 (small blind) folded before Flop
Seat 5: Valhalla1976 (big blind) collected ($0.55)
Seat 6: GrinZwe91! folded before Flop (didn't bet)



PokerStars Hand #222965656584:  Hold'em No Limit ($0.05/$0.10 USD) - 2021/01/23 14:12:23 ET
Table 'Bohlinia III' 6-max Seat #4 is the button
Seat 1: Skiednis01 ($10 in chips) 
Seat 2: Sve_Sve93 ($13.66 in chips) 
Seat 3: GoodmanAR ($10.10 in chips) 
Seat 4: JohnSF7 ($12.43 in chips) 
Seat 5: Valhalla1976 ($7.74 in chips) 
Seat 6: GrinZwe91! ($27.14 in chips) 
Valhalla1976: posts small blind $0.05
GrinZwe91!: posts big blind $0.10
*** HOLE CARDS ***
Skiednis01: folds 
Sve_Sve93: raises $0.10 to $0.20
GoodmanAR: folds 
JohnSF7: folds 
Valhalla1976: calls $0.15
GrinZwe91!: folds 
*** FLOP *** [9d Kd 8c]
Valhalla1976: checks 
Sve_Sve93: bets $0.24
Valhalla1976: folds 
Uncalled bet ($0.24) returned to Sve_Sve93
Sve_Sve93 collected $0.48 from pot
Sve_Sve93: doesn't show hand 
*** SUMMARY ***
Total pot $0.50 | Rake $0.02 
Board [9d Kd 8c]
Seat 1: Skiednis01 folded before Flop (didn't bet)
Seat 2: Sve_Sve93 collected ($0.48)
Seat 3: GoodmanAR folded before Flop (didn't bet)
Seat 4: JohnSF7 (button) folded before Flop (didn't bet)
Seat 5: Valhalla1976 (small blind) folded on the Flop
Seat 6: GrinZwe91! (big blind) folded before Flop



PokerStars Hand #222965670843:  Hold'em No Limit ($0.05/$0.10 USD) - 2021/01/23 14:12:41 ET
Table 'Bohlinia III' 6-max Seat #5 is the button
Seat 1: Skiednis01 ($10 in chips) 
Seat 2: Sve_Sve93 ($13.94 in chips) 
Seat 3: GoodmanAR ($10.10 in chips) 
Seat 4: JohnSF7 ($12.43 in chips) 
Seat 5: Valhalla1976 ($7.54 in chips) 
Seat 6: GrinZwe91! ($27.04 in chips) 
GrinZwe91!: posts small blind $0.05
Skiednis01: posts big blind $0.10
*** HOLE CARDS ***
Sve_Sve93: raises $0.10 to $0.20
GoodmanAR: calls $0.20
JohnSF7: folds 
Valhalla1976: calls $0.20
GrinZwe91!: folds 
Skiednis01: calls $0.10
*** FLOP *** [4s Jc Ks]
Skiednis01: checks 
Sve_Sve93: checks 
GoodmanAR: checks 
Valhalla1976: bets $0.40
Skiednis01: calls $0.40
Sve_Sve93: folds 
GoodmanAR: folds 
*** TURN *** [4s Jc Ks] [Js]
Skiednis01: checks 
Valhalla1976: bets $0.60
Skiednis01: folds 
Uncalled bet ($0.60) returned to Valhalla1976
Valhalla1976 collected $1.58 from pot
Valhalla1976: doesn't show hand 
*** SUMMARY ***
Total pot $1.65 | Rake $0.07 
Board [4s Jc Ks Js]
Seat 1: Skiednis01 (big blind) folded on the Turn
Seat 2: Sve_Sve93 folded on the Flop
Seat 3: GoodmanAR folded on the Flop
Seat 4: JohnSF7 folded before Flop (didn't bet)
Seat 5: Valhalla1976 (button) collected ($1.58)
Seat 6: GrinZwe91! (small blind) folded before Flop



PokerStars Hand #222965719392:  Hold'em No Limit ($0.05/$0.10 USD) - 2021/01/23 14:13:42 ET
Table 'Bohlinia III' 6-max Seat #6 is the button
Seat 1: Skiednis01 ($10 in chips) 
Seat 2: Sve_Sve93 ($13.74 in chips) 
Seat 3: GoodmanAR ($10 in chips) 
Seat 4: JohnSF7 ($12.43 in chips) 
Seat 5: Valhalla1976 ($8.52 in chips) 
Seat 6: GrinZwe91! ($26.99 in chips) 
Skiednis01: posts small blind $0.05
Sve_Sve93: posts big blind $0.10
*** HOLE CARDS ***
GoodmanAR: folds 
JohnSF7: folds 
Valhalla1976: raises $0.10 to $0.20
GrinZwe91!: folds 
Skiednis01: folds 
Sve_Sve93: folds 
Uncalled bet ($0.10) returned to Valhalla1976
Valhalla1976 collected $0.25 from pot
Valhalla1976: doesn't show hand 
*** SUMMARY ***
Total pot $0.25 | Rake $0 
Seat 1: Skiednis01 (small blind) folded before Flop
Seat 2: Sve_Sve93 (big blind) folded before Flop
Seat 3: GoodmanAR folded before Flop (didn't bet)
Seat 4: JohnSF7 folded before Flop (didn't bet)
Seat 5: Valhalla1976 collected ($0.25)
Seat 6: GrinZwe91! (button) folded before Flop (didn't bet)



PokerStars Hand #222965732591:  Hold'em No Limit ($0.05/$0.10 USD) - 2021/01/23 14:13:59 ET
Table 'Bohlinia III' 6-max Seat #1 is the button
Seat 1: Skiednis01 ($10 in chips) 
Seat 2: Sve_Sve93 ($13.64 in chips) 
Seat 3: GoodmanAR ($10 in chips) 
Seat 4: JohnSF7 ($12.43 in chips) 
Seat 5: Valhalla1976 ($8.67 in chips) 
Seat 6: GrinZwe91! ($26.99 in chips) 
Sve_Sve93: posts small blind $0.05
GoodmanAR: posts big blind $0.10
*** HOLE CARDS ***
JohnSF7: folds 
Valhalla1976: raises $0.40 to $0.50
GrinZwe91!: folds 
Skiednis01: folds 
Sve_Sve93: raises $1 to $1.50
GoodmanAR: folds 
Valhalla1976: calls $1
*** FLOP *** [3s Ts 6c]
Sve_Sve93: bets $1.48
Valhalla1976: folds 
Uncalled bet ($1.48) returned to Sve_Sve93
Sve_Sve93 collected $2.96 from pot
Sve_Sve93: doesn't show hand 
*** SUMMARY ***
Total pot $3.10 | Rake $0.14 
Board [3s Ts 6c]
Seat 1: Skiednis01 (button) folded before Flop (didn't bet)
Seat 2: Sve_Sve93 (small blind) collected ($2.96)
Seat 3: GoodmanAR (big blind) folded before Flop
Seat 4: JohnSF7 folded before Flop (didn't bet)
Seat 5: Valhalla1976 folded on the Flop
Seat 6: GrinZwe91! folded before Flop (didn't bet)



PokerStars Hand #222965763206:  Hold'em No Limit ($0.05/$0.10 USD) - 2021/01/23 14:14:37 ET
Table 'Bohlinia III' 6-max Seat #2 is the button
Seat 1: Skiednis01 ($10 in chips) 
Seat 2: Sve_Sve93 ($15.10 in chips) 
Seat 3: GoodmanAR ($10 in chips) 
Seat 4: JohnSF7 ($12.43 in chips) 
Seat 5: Valhalla1976 ($7.17 in chips) 
Seat 6: GrinZwe91! ($26.99 in chips) 
GoodmanAR: posts small blind $0.05
JohnSF7: posts big blind $0.10
*** HOLE CARDS ***
Valhalla1976: folds 
GrinZwe91!: folds 
Skiednis01: folds 
Sve_Sve93: folds 
GoodmanAR: folds 
Uncalled bet ($0.05) returned to JohnSF7
JohnSF7 collected $0.10 from pot
JohnSF7: doesn't show hand 
*** SUMMARY ***
Total pot $0.10 | Rake $0 
Seat 1: Skiednis01 folded before Flop (didn't bet)
Seat 2: Sve_Sve93 (button) folded before Flop (didn't bet)
Seat 3: GoodmanAR (small blind) folded before Flop
Seat 4: JohnSF7 (big blind) collected ($0.10)
Seat 5: Valhalla1976 folded before Flop (didn't bet)
Seat 6: GrinZwe91! folded before Flop (didn't bet)



PokerStars Hand #222965771616:  Hold'em No Limit ($0.05/$0.10 USD) - 2021/01/23 14:14:48 ET
Table 'Bohlinia III' 6-max Seat #3 is the button
Seat 1: Skiednis01 ($10 in chips) 
Seat 2: Sve_Sve93 ($15.10 in chips) 
Seat 3: GoodmanAR ($10 in chips) 
Seat 4: JohnSF7 ($12.48 in chips) 
Seat 5: Valhalla1976 ($7.17 in chips) 
Seat 6: GrinZwe91! ($26.99 in chips) 
JohnSF7: posts small blind $0.05
Valhalla1976: posts big blind $0.10
*** HOLE CARDS ***
GrinZwe91!: raises $0.20 to $0.30
Skiednis01: folds 
Sve_Sve93: folds 
GoodmanAR: folds 
JohnSF7: folds 
Valhalla1976: calls $0.20
*** FLOP *** [5d Js Kd]
Valhalla1976: checks 
GrinZwe91!: checks 
*** TURN *** [5d Js Kd] [Jc]
Valhalla1976: checks 
GrinZwe91!: bets $0.40
Valhalla1976: folds 
Uncalled bet ($0.40) returned to GrinZwe91!
GrinZwe91! collected $0.62 from pot
GrinZwe91!: doesn't show hand 
*** SUMMARY ***
Total pot $0.65 | Rake $0.03 
Board [5d Js Kd Jc]
Seat 1: Skiednis01 folded before Flop (didn't bet)
Seat 2: Sve_Sve93 folded before Flop (didn't bet)
Seat 3: GoodmanAR (button) folded before Flop (didn't bet)
Seat 4: JohnSF7 (small blind) folded before Flop
Seat 5: Valhalla1976 (big blind) folded on the Turn
Seat 6: GrinZwe91! collected ($0.62)



PokerStars Hand #222965810853:  Hold'em No Limit ($0.05/$0.10 USD) - 2021/01/23 14:15:37 ET
Table 'Bohlinia III' 6-max Seat #4 is the button
Seat 1: Skiednis01 ($10 in chips) 
Seat 2: Sve_Sve93 ($15.10 in chips) 
Seat 3: GoodmanAR ($10 in chips) 
Seat 4: JohnSF7 ($12.43 in chips) 
Seat 5: Valhalla1976 ($6.87 in chips) 
Seat 6: GrinZwe91! ($27.31 in chips) 
Valhalla1976: posts small blind $0.05
GrinZwe91!: posts big blind $0.10
*** HOLE CARDS ***
Skiednis01: folds 
Sve_Sve93: raises $0.20 to $0.30
GoodmanAR: folds 
JohnSF7: folds 
Valhalla1976: calls $0.25
GrinZwe91!: folds 
*** FLOP *** [Qc 7s 2c]
Valhalla1976: checks 
Sve_Sve93: bets $0.34
Valhalla1976: folds 
Uncalled bet ($0.34) returned to Sve_Sve93
Sve_Sve93 collected $0.67 from pot
Sve_Sve93: doesn't show hand 
*** SUMMARY ***
Total pot $0.70 | Rake $0.03 
Board [Qc 7s 2c]
Seat 1: Skiednis01 folded before Flop (didn't bet)
Seat 2: Sve_Sve93 collected ($0.67)
Seat 3: GoodmanAR folded before Flop (didn't bet)
Seat 4: JohnSF7 (button) folded before Flop (didn't bet)
Seat 5: Valhalla1976 (small blind) folded on the Flop
Seat 6: GrinZwe91! (big blind) folded before Flop



PokerStars Hand #222965843971:  Hold'em No Limit ($0.05/$0.10 USD) - 2021/01/23 14:16:17 ET
Table 'Bohlinia III' 6-max Seat #5 is the button
Seat 1: Skiednis01 ($10 in chips) 
Seat 2: Sve_Sve93 ($15.47 in chips) 
Seat 3: GoodmanAR ($10 in chips) 
Seat 4: JohnSF7 ($12.43 in chips) 
Seat 5: Valhalla1976 ($6.57 in chips) 
Seat 6: GrinZwe91! ($27.21 in chips) 
GrinZwe91!: posts small blind $0.05
Skiednis01: posts big blind $0.10
*** HOLE CARDS ***
Sve_Sve93: folds 
GoodmanAR: raises $0.20 to $0.30
JohnSF7: folds 
Valhalla1976: folds 
GrinZwe91!: folds 
Skiednis01: folds 
Uncalled bet ($0.20) returned to GoodmanAR
GoodmanAR collected $0.25 from pot
GoodmanAR: doesn't show hand 
*** SUMMARY ***
Total pot $0.25 | Rake $0 
Seat 1: Skiednis01 (big blind) folded before Flop
Seat 2: Sve_Sve93 folded before Flop (didn't bet)
Seat 3: GoodmanAR collected ($0.25)
Seat 4: JohnSF7 folded before Flop (didn't bet)
Seat 5: Valhalla1976 (button) folded before Flop (didn't bet)
Seat 6: GrinZwe91! (small blind) folded before Flop



PokerStars Hand #222965858309:  Hold'em No Limit ($0.05/$0.10 USD) - 2021/01/23 14:16:35 ET
Table 'Bohlinia III' 6-max Seat #6 is the button
Seat 1: Skiednis01 ($10 in chips) 
Seat 2: Sve_Sve93 ($15.47 in chips) 
Seat 3: GoodmanAR ($10.15 in chips) 
Seat 4: JohnSF7 ($12.43 in chips) 
Seat 5: Valhalla1976 ($6.57 in chips) 
Seat 6: GrinZwe91! ($27.16 in chips) 
Skiednis01: posts small blind $0.05
Sve_Sve93: posts big blind $0.10
*** HOLE CARDS ***
GoodmanAR: folds 
JohnSF7: folds 
Valhalla1976 has timed out
Valhalla1976: folds 
GrinZwe91!: folds 
Skiednis01: folds 
Uncalled bet ($0.05) returned to Sve_Sve93
Sve_Sve93 collected $0.10 from pot
Sve_Sve93: doesn't show hand 
*** SUMMARY ***
Total pot $0.10 | Rake $0 
Seat 1: Skiednis01 (small blind) folded before Flop
Seat 2: Sve_Sve93 (big blind) collected ($0.10)
Seat 3: GoodmanAR folded before Flop (didn't bet)
Seat 4: JohnSF7 folded before Flop (didn't bet)
Seat 5: Valhalla1976 folded before Flop (didn't bet)
Seat 6: GrinZwe91! (button) folded before Flop (didn't bet)



PokerStars Hand #222965876607:  Hold'em No Limit ($0.05/$0.10 USD) - 2021/01/23 14:16:58 ET
Table 'Bohlinia III' 6-max Seat #1 is the button
Seat 1: Skiednis01 ($10 in chips) 
Seat 2: Sve_Sve93 ($15.52 in chips) 
Seat 3: GoodmanAR ($10.15 in chips) 
Seat 4: JohnSF7 ($12.43 in chips) 
Seat 5: Valhalla1976 ($6.57 in chips) 
Seat 6: GrinZwe91! ($27.16 in chips) 
Sve_Sve93: posts small blind $0.05
GoodmanAR: posts big blind $0.10
*** HOLE CARDS ***
JohnSF7: folds 
Valhalla1976: folds 
GrinZwe91!: folds 
Skiednis01: folds 
Sve_Sve93: folds 
Uncalled bet ($0.05) returned to GoodmanAR
GoodmanAR collected $0.10 from pot
GoodmanAR: doesn't show hand 
*** SUMMARY ***
Total pot $0.10 | Rake $0 
Seat 1: Skiednis01 (button) folded before Flop (didn't bet)
Seat 2: Sve_Sve93 (small blind) folded before Flop
Seat 3: GoodmanAR (big blind) collected ($0.10)
Seat 4: JohnSF7 folded before Flop (didn't bet)
Seat 5: Valhalla1976 folded before Flop (didn't bet)
Seat 6: GrinZwe91! folded before Flop (didn't bet)



PokerStars Hand #222965884343:  Hold'em No Limit ($0.05/$0.10 USD) - 2021/01/23 14:17:07 ET
Table 'Bohlinia III' 6-max Seat #2 is the button
Seat 1: Skiednis01 ($10 in chips) 
Seat 2: Sve_Sve93 ($15.47 in chips) 
Seat 3: GoodmanAR ($10.20 in chips) 
Seat 4: JohnSF7 ($12.43 in chips) 
Seat 5: Valhalla1976 ($6.57 in chips) 
Seat 6: GrinZwe91! ($27.16 in chips) 
GoodmanAR: posts small blind $0.05
JohnSF7: posts big blind $0.10
*** HOLE CARDS ***
Valhalla1976: folds 
GrinZwe91!: folds 
Skiednis01: folds 
Sve_Sve93: folds 
GoodmanAR: folds 
Uncalled bet ($0.05) returned to JohnSF7
JohnSF7 collected $0.10 from pot
JohnSF7: doesn't show hand 
*** SUMMARY ***
Total pot $0.10 | Rake $0 
Seat 1: Skiednis01 folded before Flop (didn't bet)
Seat 2: Sve_Sve93 (button) folded before Flop (didn't bet)
Seat 3: GoodmanAR (small blind) folded before Flop
Seat 4: JohnSF7 (big blind) collected ($0.10)
Seat 5: Valhalla1976 folded before Flop (didn't bet)
Seat 6: GrinZwe91! folded before Flop (didn't bet)



PokerStars Hand #222965897858:  Hold'em No Limit ($0.05/$0.10 USD) - 2021/01/23 14:17:24 ET
Table 'Bohlinia III' 6-max Seat #3 is the button
Seat 1: Skiednis01 ($10 in chips) 
Seat 2: Sve_Sve93 ($15.47 in chips) 
Seat 3: GoodmanAR ($10.15 in chips) 
Seat 4: JohnSF7 ($12.48 in chips) 
Seat 5: Valhalla1976 ($6.57 in chips) 
Seat 6: GrinZwe91! ($27.16 in chips) 
JohnSF7: posts small blind $0.05
Valhalla1976: posts big blind $0.10
*** HOLE CARDS ***
GrinZwe91!: folds 
Skiednis01: folds 
Sve_Sve93: folds 
GoodmanAR: raises $0.15 to $0.25
JohnSF7: calls $0.20
Valhalla1976: calls $0.15
*** FLOP *** [3c 4s 5s]
JohnSF7: checks 
Valhalla1976: bets $0.36
GoodmanAR: calls $0.36
JohnSF7: folds 
*** TURN *** [3c 4s 5s] [Qh]
Valhalla1976: checks 
GoodmanAR: bets $1.75
Valhalla1976: folds 
Uncalled bet ($1.75) returned to GoodmanAR
GoodmanAR collected $1.40 from pot
GoodmanAR: doesn't show hand 
*** SUMMARY ***
Total pot $1.47 | Rake $0.07 
Board [3c 4s 5s Qh]
Seat 1: Skiednis01 folded before Flop (didn't bet)
Seat 2: Sve_Sve93 folded before Flop (didn't bet)
Seat 3: GoodmanAR (button) collected ($1.40)
Seat 4: JohnSF7 (small blind) folded on the Flop
Seat 5: Valhalla1976 (big blind) folded on the Turn
Seat 6: GrinZwe91! folded before Flop (didn't bet)



PokerStars Hand #222965957177:  Hold'em No Limit ($0.05/$0.10 USD) - 2021/01/23 14:18:39 ET
Table 'Bohlinia III' 6-max Seat #4 is the button
Seat 1: Skiednis01 ($10 in chips) 
Seat 2: Sve_Sve93 ($15.47 in chips) 
Seat 3: GoodmanAR ($10.94 in chips) 
Seat 4: JohnSF7 ($12.23 in chips) 
Seat 5: Valhalla1976 ($5.96 in chips) 
Seat 6: GrinZwe91! ($27.16 in chips) 
Valhalla1976: posts small blind $0.05
GrinZwe91!: posts big blind $0.10
*** HOLE CARDS ***
Skiednis01: raises $0.15 to $0.25
Sve_Sve93: folds 
GoodmanAR: folds 
JohnSF7: folds 
Valhalla1976: folds 
GrinZwe91!: calls $0.15
*** FLOP *** [8h Qh Jh]
GrinZwe91!: checks 
Skiednis01: checks 
*** TURN *** [8h Qh Jh] [8c]
GrinZwe91!: bets $0.30
Skiednis01: folds 
Uncalled bet ($0.30) returned to GrinZwe91!
GrinZwe91! collected $0.53 from pot
GrinZwe91!: doesn't show hand 
*** SUMMARY ***
Total pot $0.55 | Rake $0.02 
Board [8h Qh Jh 8c]
Seat 1: Skiednis01 folded on the Turn
Seat 2: Sve_Sve93 folded before Flop (didn't bet)
Seat 3: GoodmanAR folded before Flop (didn't bet)
Seat 4: JohnSF7 (button) folded before Flop (didn't bet)
Seat 5: Valhalla1976 (small blind) folded before Flop
Seat 6: GrinZwe91! (big blind) collected ($0.53)



PokerStars Hand #222965980302:  Hold'em No Limit ($0.05/$0.10 USD) - 2021/01/23 14:19:09 ET
Table 'Bohlinia III' 6-max Seat #5 is the button
Seat 1: Skiednis01 ($10 in chips) 
Seat 2: Sve_Sve93 ($15.47 in chips) 
Seat 3: GoodmanAR ($10.94 in chips) 
Seat 4: JohnSF7 ($12.23 in chips) 
Seat 5: Valhalla1976 ($5.91 in chips) 
Seat 6: GrinZwe91! ($27.44 in chips) 
GrinZwe91!: posts small blind $0.05
Skiednis01: posts big blind $0.10
*** HOLE CARDS ***
Sve_Sve93: folds 
GoodmanAR: folds 
JohnSF7: folds 
Valhalla1976: calls $0.10
GrinZwe91!: folds 
Skiednis01: raises $0.20 to $0.30
Valhalla1976: calls $0.20
*** FLOP *** [6d 5d 4c]
Skiednis01: bets $0.31
Valhalla1976: raises $0.31 to $0.62
Skiednis01: calls $0.31
*** TURN *** [6d 5d 4c] [Ah]
Skiednis01: checks 
Valhalla1976: bets $0.90
Skiednis01: folds 
Uncalled bet ($0.90) returned to Valhalla1976
Valhalla1976 collected $1.80 from pot
Valhalla1976: doesn't show hand 
*** SUMMARY ***
Total pot $1.89 | Rake $0.09 
Board [6d 5d 4c Ah]
Seat 1: Skiednis01 (big blind) folded on the Turn
Seat 2: Sve_Sve93 folded before Flop (didn't bet)
Seat 3: GoodmanAR folded before Flop (didn't bet)
Seat 4: JohnSF7 folded before Flop (didn't bet)
Seat 5: Valhalla1976 (button) collected ($1.80)
Seat 6: GrinZwe91! (small blind) folded before Flop



PokerStars Hand #222966011959:  Hold'em No Limit ($0.05/$0.10 USD) - 2021/01/23 14:19:49 ET
Table 'Bohlinia III' 6-max Seat #6 is the button
Seat 1: Skiednis01 ($10 in chips) 
Seat 2: Sve_Sve93 ($15.47 in chips) 
Seat 3: GoodmanAR ($10.94 in chips) 
Seat 4: JohnSF7 ($12.23 in chips) 
Seat 5: Valhalla1976 ($6.79 in chips) 
Seat 6: GrinZwe91! ($27.39 in chips) 
Skiednis01: posts small blind $0.05
Sve_Sve93: posts big blind $0.10
*** HOLE CARDS ***
GoodmanAR: folds 
JohnSF7: raises $0.15 to $0.25
Valhalla1976: folds 
GrinZwe91!: folds 
Skiednis01: calls $0.20
Sve_Sve93: calls $0.15
*** FLOP *** [2s 6s 6d]
Skiednis01: checks 
Sve_Sve93: checks 
JohnSF7: bets $0.40
Skiednis01: raises $0.50 to $0.90
Sve_Sve93: folds 
JohnSF7: folds 
Uncalled bet ($0.50) returned to Skiednis01
Skiednis01 collected $1.48 from pot
Skiednis01: doesn't show hand 
*** SUMMARY ***
Total pot $1.55 | Rake $0.07 
Board [2s 6s 6d]
Seat 1: Skiednis01 (small blind) collected ($1.48)
Seat 2: Sve_Sve93 (big blind) folded on the Flop
Seat 3: GoodmanAR folded before Flop (didn't bet)
Seat 4: JohnSF7 folded on the Flop
Seat 5: Valhalla1976 folded before Flop (didn't bet)
Seat 6: GrinZwe91! (button) folded before Flop (didn't bet)



PokerStars Hand #222966062976:  Hold'em No Limit ($0.05/$0.10 USD) - 2021/01/23 14:20:54 ET
Table 'Bohlinia III' 6-max Seat #1 is the button
Seat 1: Skiednis01 ($10.83 in chips) 
Seat 2: Sve_Sve93 ($15.22 in chips) 
Seat 3: GoodmanAR ($10.94 in chips) 
Seat 4: JohnSF7 ($11.58 in chips) 
Seat 5: Valhalla1976 ($6.79 in chips) 
Seat 6: GrinZwe91! ($27.39 in chips) 
Sve_Sve93: posts small blind $0.05
GoodmanAR: posts big blind $0.10
*** HOLE CARDS ***
JohnSF7: folds 
Valhalla1976: folds 
GrinZwe91!: folds 
Skiednis01: folds 
Sve_Sve93: raises $0.20 to $0.30
GoodmanAR: folds 
Uncalled bet ($0.20) returned to Sve_Sve93
Sve_Sve93 collected $0.20 from pot
Sve_Sve93: doesn't show hand 
*** SUMMARY ***
Total pot $0.20 | Rake $0 
Seat 1: Skiednis01 (button) folded before Flop (didn't bet)
Seat 2: Sve_Sve93 (small blind) collected ($0.20)
Seat 3: GoodmanAR (big blind) folded before Flop
Seat 4: JohnSF7 folded before Flop (didn't bet)
Seat 5: Valhalla1976 folded before Flop (didn't bet)
Seat 6: GrinZwe91! folded before Flop (didn't bet)



PokerStars Hand #222966074911:  Hold'em No Limit ($0.05/$0.10 USD) - 2021/01/23 14:21:09 ET
Table 'Bohlinia III' 6-max Seat #2 is the button
Seat 1: Skiednis01 ($10.83 in chips) 
Seat 2: Sve_Sve93 ($15.32 in chips) 
Seat 3: GoodmanAR ($10.84 in chips) 
Seat 4: JohnSF7 ($11.58 in chips) 
Seat 5: Valhalla1976 ($6.79 in chips) 
Seat 6: GrinZwe91! ($27.39 in chips) 
GoodmanAR: posts small blind $0.05
JohnSF7: posts big blind $0.10
*** HOLE CARDS ***
Valhalla1976: raises $0.10 to $0.20
GrinZwe91!: folds 
Skiednis01: folds 
Sve_Sve93: folds 
GoodmanAR: folds 
JohnSF7: folds 
Uncalled bet ($0.10) returned to Valhalla1976
Valhalla1976 collected $0.25 from pot
Valhalla1976: doesn't show hand 
*** SUMMARY ***
Total pot $0.25 | Rake $0 
Seat 1: Skiednis01 folded before Flop (didn't bet)
Seat 2: Sve_Sve93 (button) folded before Flop (didn't bet)
Seat 3: GoodmanAR (small blind) folded before Flop
Seat 4: JohnSF7 (big blind) folded before Flop
Seat 5: Valhalla1976 collected ($0.25)
Seat 6: GrinZwe91! folded before Flop (didn't bet)



PokerStars Hand #222966084867:  Hold'em No Limit ($0.05/$0.10 USD) - 2021/01/23 14:21:18 ET
Table 'Bohlinia III' 6-max Seat #3 is the button
Seat 1: Skiednis01 ($10.83 in chips) 
Seat 2: Sve_Sve93 ($15.32 in chips) 
Seat 3: GoodmanAR ($10.79 in chips) 
Seat 4: JohnSF7 ($11.48 in chips) 
Seat 5: Valhalla1976 ($6.94 in chips) 
Seat 6: GrinZwe91! ($27.39 in chips) 
JohnSF7: posts small blind $0.05
Valhalla1976: posts big blind $0.10
*** HOLE CARDS ***
GrinZwe91!: folds 
Skiednis01: raises $0.15 to $0.25
Sve_Sve93: calls $0.25
GoodmanAR: folds 
JohnSF7: folds 
Valhalla1976: folds 
*** FLOP *** [4h Ts 9c]
Skiednis01: checks 
Sve_Sve93: bets $0.31
Skiednis01: calls $0.31
*** TURN *** [4h Ts 9c] [Ks]
Skiednis01: checks 
Sve_Sve93: bets $0.61
Skiednis01: calls $0.61
*** RIVER *** [4h Ts 9c Ks] [2c]
Skiednis01: checks 
Sve_Sve93: checks 
*** SHOW DOWN ***
Skiednis01: shows [Qh As] (high card Ace)
Sve_Sve93: shows [Th Ah] (a pair of Tens)
Sve_Sve93 collected $2.38 from pot
*** SUMMARY ***
Total pot $2.49 | Rake $0.11 
Board [4h Ts 9c Ks 2c]
Seat 1: Skiednis01 showed [Qh As] and lost with high card Ace
Seat 2: Sve_Sve93 showed [Th Ah] and won ($2.38) with a pair of Tens
Seat 3: GoodmanAR (button) folded before Flop (didn't bet)
Seat 4: JohnSF7 (small blind) folded before Flop
Seat 5: Valhalla1976 (big blind) folded before Flop
Seat 6: GrinZwe91! folded before Flop (didn't bet)



PokerStars Hand #222966119996:  Hold'em No Limit ($0.05/$0.10 USD) - 2021/01/23 14:22:03 ET
Table 'Bohlinia III' 6-max Seat #4 is the button
Seat 1: Skiednis01 ($10 in chips) 
Seat 2: Sve_Sve93 ($16.53 in chips) 
Seat 3: GoodmanAR ($10.79 in chips) 
Seat 4: JohnSF7 ($11.43 in chips) 
Seat 5: Valhalla1976 ($6.84 in chips) 
Seat 6: GrinZwe91! ($27.39 in chips) 
Valhalla1976: posts small blind $0.05
GrinZwe91!: posts big blind $0.10
*** HOLE CARDS ***
Skiednis01: folds 
Sve_Sve93: folds 
GoodmanAR: raises $0.20 to $0.30
JohnSF7: folds 
Valhalla1976: calls $0.25
GrinZwe91!: folds 
*** FLOP *** [Ad 3s 5d]
Valhalla1976: checks 
GoodmanAR: checks 
*** TURN *** [Ad 3s 5d] [7h]
Valhalla1976: bets $0.33
GoodmanAR: calls $0.33
*** RIVER *** [Ad 3s 5d 7h] [Js]
Valhalla1976: bets $0.65
GoodmanAR: folds 
Uncalled bet ($0.65) returned to Valhalla1976
Valhalla1976 collected $1.30 from pot
Valhalla1976: doesn't show hand 
*** SUMMARY ***
Total pot $1.36 | Rake $0.06 
Board [Ad 3s 5d 7h Js]
Seat 1: Skiednis01 folded before Flop (didn't bet)
Seat 2: Sve_Sve93 folded before Flop (didn't bet)
Seat 3: GoodmanAR folded on the River
Seat 4: JohnSF7 (button) folded before Flop (didn't bet)
Seat 5: Valhalla1976 (small blind) collected ($1.30)
Seat 6: GrinZwe91! (big blind) folded before Flop



PokerStars Hand #222966164106:  Hold'em No Limit ($0.05/$0.10 USD) - 2021/01/23 14:22:59 ET
Table 'Bohlinia III' 6-max Seat #5 is the button
Seat 1: Skiednis01 ($10 in chips) 
Seat 2: Sve_Sve93 ($16.53 in chips) 
Seat 3: GoodmanAR ($10.16 in chips) 
Seat 4: JohnSF7 ($11.43 in chips) 
Seat 5: Valhalla1976 ($7.51 in chips) 
Seat 6: GrinZwe91! ($27.29 in chips) 
GrinZwe91!: posts small blind $0.05
Skiednis01: posts big blind $0.10
*** HOLE CARDS ***
Sve_Sve93: folds 
GoodmanAR: folds 
JohnSF7: folds 
Valhalla1976: raises $0.10 to $0.20
GrinZwe91!: folds 
Skiednis01: calls $0.10
*** FLOP *** [3s 2d Ah]
Skiednis01: bets $0.22
Valhalla1976: folds 
Uncalled bet ($0.22) returned to Skiednis01
Skiednis01 collected $0.43 from pot
Skiednis01: doesn't show hand 
*** SUMMARY ***
Total pot $0.45 | Rake $0.02 
Board [3s 2d Ah]
Seat 1: Skiednis01 (big blind) collected ($0.43)
Seat 2: Sve_Sve93 folded before Flop (didn't bet)
Seat 3: GoodmanAR folded before Flop (didn't bet)
Seat 4: JohnSF7 folded before Flop (didn't bet)
Seat 5: Valhalla1976 (button) folded on the Flop
Seat 6: GrinZwe91! (small blind) folded before Flop



PokerStars Hand #222966193006:  Hold'em No Limit ($0.05/$0.10 USD) - 2021/01/23 14:23:36 ET
Table 'Bohlinia III' 6-max Seat #6 is the button
Seat 1: Skiednis01 ($10.23 in chips) 
Seat 2: Sve_Sve93 ($16.53 in chips) 
Seat 3: GoodmanAR ($10.16 in chips) 
Seat 4: JohnSF7 ($11.43 in chips) 
Seat 5: Valhalla1976 ($7.31 in chips) 
Seat 6: GrinZwe91! ($27.24 in chips) 
Skiednis01: posts small blind $0.05
Sve_Sve93: posts big blind $0.10
*** HOLE CARDS ***
GoodmanAR: folds 
JohnSF7: folds 
Valhalla1976: folds 
GrinZwe91!: folds 
Valhalla1976 leaves the table
Skiednis01: raises $0.15 to $0.25
Sve_Sve93: folds 
Uncalled bet ($0.15) returned to Skiednis01
Skiednis01 collected $0.20 from pot
Skiednis01: doesn't show hand 
*** SUMMARY ***
Total pot $0.20 | Rake $0 
Seat 1: Skiednis01 (small blind) collected ($0.20)
Seat 2: Sve_Sve93 (big blind) folded before Flop
Seat 3: GoodmanAR folded before Flop (didn't bet)
Seat 4: JohnSF7 folded before Flop (didn't bet)
Seat 5: Valhalla1976 folded before Flop (didn't bet)
Seat 6: GrinZwe91! (button) folded before Flop (didn't bet)



PokerStars Hand #222966206316:  Hold'em No Limit ($0.05/$0.10 USD) - 2021/01/23 14:23:53 ET
Table 'Bohlinia III' 6-max Seat #1 is the button
Seat 1: Skiednis01 ($10.33 in chips) 
Seat 2: Sve_Sve93 ($16.43 in chips) 
Seat 3: GoodmanAR ($10.16 in chips) 
Seat 4: JohnSF7 ($11.43 in chips) 
Seat 6: GrinZwe91! ($27.24 in chips) 
Sve_Sve93: posts small blind $0.05
GoodmanAR: posts big blind $0.10
*** HOLE CARDS ***
JohnSF7: folds 
GrinZwe91!: folds 
Skiednis01: raises $0.15 to $0.25
Sve_Sve93: folds 
KIIsSharkMan joins the table at seat #5 
GoodmanAR: folds 
Uncalled bet ($0.15) returned to Skiednis01
Skiednis01 collected $0.25 from pot
Skiednis01: doesn't show hand 
*** SUMMARY ***
Total pot $0.25 | Rake $0 
Seat 1: Skiednis01 (button) collected ($0.25)
Seat 2: Sve_Sve93 (small blind) folded before Flop
Seat 3: GoodmanAR (big blind) folded before Flop
Seat 4: JohnSF7 folded before Flop (didn't bet)
Seat 6: GrinZwe91! folded before Flop (didn't bet)



PokerStars Hand #222966216934:  Hold'em No Limit ($0.05/$0.10 USD) - 2021/01/23 14:24:07 ET
Table 'Bohlinia III' 6-max Seat #2 is the button
Seat 1: Skiednis01 ($10.48 in chips) 
Seat 2: Sve_Sve93 ($16.38 in chips) 
Seat 3: GoodmanAR ($10.06 in chips) 
Seat 4: JohnSF7 ($11.43 in chips) 
Seat 6: GrinZwe91! ($27.24 in chips) 
GoodmanAR: posts small blind $0.05
JohnSF7: posts big blind $0.10
KIIsSharkMan: sits out 
*** HOLE CARDS ***
GrinZwe91!: folds 
Skiednis01: raises $0.15 to $0.25
Sve_Sve93: folds 
GoodmanAR: folds 
JohnSF7: folds 
Uncalled bet ($0.15) returned to Skiednis01
Skiednis01 collected $0.25 from pot
Skiednis01: doesn't show hand 
*** SUMMARY ***
Total pot $0.25 | Rake $0 
Seat 1: Skiednis01 collected ($0.25)
Seat 2: Sve_Sve93 (button) folded before Flop (didn't bet)
Seat 3: GoodmanAR (small blind) folded before Flop
Seat 4: JohnSF7 (big blind) folded before Flop
Seat 6: GrinZwe91! folded before Flop (didn't bet)



PokerStars Hand #222966226575:  Hold'em No Limit ($0.05/$0.10 USD) - 2021/01/23 14:24:19 ET
Table 'Bohlinia III' 6-max Seat #3 is the button
Seat 1: Skiednis01 ($10.63 in chips) 
Seat 2: Sve_Sve93 ($16.38 in chips) 
Seat 3: GoodmanAR ($10.01 in chips) 
Seat 4: JohnSF7 ($11.33 in chips) 
Seat 5: KIIsSharkMan ($10 in chips) 
Seat 6: GrinZwe91! ($27.24 in chips) 
JohnSF7: posts small blind $0.05
KIIsSharkMan: posts big blind $0.10
*** HOLE CARDS ***
GrinZwe91!: folds 
Skiednis01: folds 
Sve_Sve93: raises $0.20 to $0.30
GoodmanAR: raises $0.60 to $0.90
JohnSF7: folds 
KIIsSharkMan: folds 
Sve_Sve93: raises $1.70 to $2.60
GoodmanAR: folds 
Uncalled bet ($1.70) returned to Sve_Sve93
Sve_Sve93 collected $1.95 from pot
Sve_Sve93: doesn't show hand 
*** SUMMARY ***
Total pot $1.95 | Rake $0 
Seat 1: Skiednis01 folded before Flop (didn't bet)
Seat 2: Sve_Sve93 collected ($1.95)
Seat 3: GoodmanAR (button) folded before Flop
Seat 4: JohnSF7 (small blind) folded before Flop
Seat 5: KIIsSharkMan (big blind) folded before Flop
Seat 6: GrinZwe91! folded before Flop (didn't bet)



PokerStars Hand #222966259966:  Hold'em No Limit ($0.05/$0.10 USD) - 2021/01/23 14:25:01 ET
Table 'Bohlinia III' 6-max Seat #4 is the button
Seat 1: Skiednis01 ($10.63 in chips) 
Seat 2: Sve_Sve93 ($17.43 in chips) 
Seat 3: GoodmanAR ($10 in chips) 
Seat 4: JohnSF7 ($11.28 in chips) 
Seat 5: KIIsSharkMan ($10 in chips) 
Seat 6: GrinZwe91! ($27.24 in chips) 
KIIsSharkMan: posts small blind $0.05
GrinZwe91!: posts big blind $0.10
*** HOLE CARDS ***
Skiednis01: folds 
Sve_Sve93: folds 
GoodmanAR: folds 
JohnSF7: folds 
KIIsSharkMan: raises $0.20 to $0.30
GrinZwe91!: folds 
Uncalled bet ($0.20) returned to KIIsSharkMan
KIIsSharkMan collected $0.20 from pot
KIIsSharkMan: doesn't show hand 
*** SUMMARY ***
Total pot $0.20 | Rake $0 
Seat 1: Skiednis01 folded before Flop (didn't bet)
Seat 2: Sve_Sve93 folded before Flop (didn't bet)
Seat 3: GoodmanAR folded before Flop (didn't bet)
Seat 4: JohnSF7 (button) folded before Flop (didn't bet)
Seat 5: KIIsSharkMan (small blind) collected ($0.20)
Seat 6: GrinZwe91! (big blind) folded before Flop



PokerStars Hand #222966271731:  Hold'em No Limit ($0.05/$0.10 USD) - 2021/01/23 14:25:16 ET
Table 'Bohlinia III' 6-max Seat #5 is the button
Seat 1: Skiednis01 ($10.63 in chips) 
Seat 2: Sve_Sve93 ($17.43 in chips) 
Seat 3: GoodmanAR ($10 in chips) 
Seat 4: JohnSF7 ($11.28 in chips) 
Seat 5: KIIsSharkMan ($10.10 in chips) 
Seat 6: GrinZwe91! ($27.14 in chips) 
GrinZwe91!: posts small blind $0.05
Skiednis01: posts big blind $0.10
*** HOLE CARDS ***
Sve_Sve93: folds 
GoodmanAR: folds 
JohnSF7: folds 
KIIsSharkMan: folds 
GrinZwe91!: raises $0.20 to $0.30
Skiednis01: folds 
Uncalled bet ($0.20) returned to GrinZwe91!
GrinZwe91! collected $0.20 from pot
GrinZwe91!: doesn't show hand 
*** SUMMARY ***
Total pot $0.20 | Rake $0 
Seat 1: Skiednis01 (big blind) folded before Flop
Seat 2: Sve_Sve93 folded before Flop (didn't bet)
Seat 3: GoodmanAR folded before Flop (didn't bet)
Seat 4: JohnSF7 folded before Flop (didn't bet)
Seat 5: KIIsSharkMan (button) folded before Flop (didn't bet)
Seat 6: GrinZwe91! (small blind) collected ($0.20)



PokerStars Hand #222966289767:  Hold'em No Limit ($0.05/$0.10 USD) - 2021/01/23 14:25:40 ET
Table 'Bohlinia III' 6-max Seat #6 is the button
Seat 1: Skiednis01 ($10.53 in chips) 
Seat 2: Sve_Sve93 ($17.43 in chips) 
Seat 3: GoodmanAR ($10 in chips) 
Seat 4: JohnSF7 ($11.28 in chips) 
Seat 5: KIIsSharkMan ($10.10 in chips) 
Seat 6: GrinZwe91! ($27.24 in chips) 
Skiednis01: posts small blind $0.05
Sve_Sve93: posts big blind $0.10
*** HOLE CARDS ***
GoodmanAR: folds 
JohnSF7: raises $0.15 to $0.25
KIIsSharkMan: folds 
GrinZwe91!: folds 
Skiednis01: folds 
Sve_Sve93: folds 
Uncalled bet ($0.15) returned to JohnSF7
JohnSF7 collected $0.25 from pot
JohnSF7: doesn't show hand 
*** SUMMARY ***
Total pot $0.25 | Rake $0 
Seat 1: Skiednis01 (small blind) folded before Flop
Seat 2: Sve_Sve93 (big blind) folded before Flop
Seat 3: GoodmanAR folded before Flop (didn't bet)
Seat 4: JohnSF7 collected ($0.25)
Seat 5: KIIsSharkMan folded before Flop (didn't bet)
Seat 6: GrinZwe91! (button) folded before Flop (didn't bet)



PokerStars Hand #222966303111:  Hold'em No Limit ($0.05/$0.10 USD) - 2021/01/23 14:25:57 ET
Table 'Bohlinia III' 6-max Seat #1 is the button
Seat 1: Skiednis01 ($10.48 in chips) 
Seat 2: Sve_Sve93 ($17.33 in chips) 
Seat 4: JohnSF7 ($11.43 in chips) 
Seat 5: KIIsSharkMan ($10.10 in chips) 
Seat 6: GrinZwe91! ($27.24 in chips) 
Sve_Sve93: posts small blind $0.05
GoodmanAR: is sitting out 
JohnSF7: posts big blind $0.10
*** HOLE CARDS ***
GoodmanAR leaves the table
KIIsSharkMan: folds 
GrinZwe91!: folds 
Skiednis01: folds 
Sve_Sve93: folds 
Uncalled bet ($0.05) returned to JohnSF7
JohnSF7 collected $0.10 from pot
JohnSF7: doesn't show hand 
*** SUMMARY ***
Total pot $0.10 | Rake $0 
Seat 1: Skiednis01 (button) folded before Flop (didn't bet)
Seat 2: Sve_Sve93 (small blind) folded before Flop
Seat 4: JohnSF7 (big blind) collected ($0.10)
Seat 5: KIIsSharkMan folded before Flop (didn't bet)
Seat 6: GrinZwe91! folded before Flop (didn't bet)



PokerStars Hand #222966310680:  Hold'em No Limit ($0.05/$0.10 USD) - 2021/01/23 14:26:07 ET
Table 'Bohlinia III' 6-max Seat #2 is the button
Seat 1: Skiednis01 ($10.48 in chips) 
Seat 2: Sve_Sve93 ($17.28 in chips) 
Seat 4: JohnSF7 ($11.48 in chips) 
Seat 5: KIIsSharkMan ($10.10 in chips) 
Seat 6: GrinZwe91! ($27.24 in chips) 
JohnSF7: posts small blind $0.05
KIIsSharkMan: posts big blind $0.10
*** HOLE CARDS ***
GrinZwe91!: folds 
Skiednis01: raises $0.15 to $0.25
Sve_Sve93: folds 
JohnSF7: folds 
KIIsSharkMan: folds 
Uncalled bet ($0.15) returned to Skiednis01
Skiednis01 collected $0.25 from pot
Skiednis01: doesn't show hand 
*** SUMMARY ***
Total pot $0.25 | Rake $0 
Seat 1: Skiednis01 collected ($0.25)
Seat 2: Sve_Sve93 (button) folded before Flop (didn't bet)
Seat 4: JohnSF7 (small blind) folded before Flop
Seat 5: KIIsSharkMan (big blind) folded before Flop
Seat 6: GrinZwe91! folded before Flop (didn't bet)



PokerStars Hand #222966317806:  Hold'em No Limit ($0.05/$0.10 USD) - 2021/01/23 14:26:16 ET
Table 'Bohlinia III' 6-max Seat #4 is the button
Seat 1: Skiednis01 ($10.63 in chips) 
Seat 2: Sve_Sve93 ($17.28 in chips) 
Seat 4: JohnSF7 ($11.43 in chips) 
Seat 5: KIIsSharkMan ($10 in chips) 
Seat 6: GrinZwe91! ($27.24 in chips) 
KIIsSharkMan: posts small blind $0.05
GrinZwe91!: posts big blind $0.10
*** HOLE CARDS ***
Skiednis01: folds 
Sve_Sve93: raises $0.20 to $0.30
JohnSF7: folds 
KIIsSharkMan: folds 
0nix770 joins the table at seat #3 
GrinZwe91!: folds 
Uncalled bet ($0.20) returned to Sve_Sve93
Sve_Sve93 collected $0.25 from pot
Sve_Sve93: doesn't show hand 
*** SUMMARY ***
Total pot $0.25 | Rake $0 
Seat 1: Skiednis01 folded before Flop (didn't bet)
Seat 2: Sve_Sve93 collected ($0.25)
Seat 4: JohnSF7 (button) folded before Flop (didn't bet)
Seat 5: KIIsSharkMan (small blind) folded before Flop
Seat 6: GrinZwe91! (big blind) folded before Flop



PokerStars Hand #222966328281:  Hold'em No Limit ($0.05/$0.10 USD) - 2021/01/23 14:26:30 ET
Table 'Bohlinia III' 6-max Seat #5 is the button
Seat 1: Skiednis01 ($10.63 in chips) 
Seat 2: Sve_Sve93 ($17.43 in chips) 
Seat 4: JohnSF7 ($11.43 in chips) 
Seat 5: KIIsSharkMan ($9.95 in chips) 
Seat 6: GrinZwe91! ($27.14 in chips) 
GrinZwe91!: posts small blind $0.05
Skiednis01: posts big blind $0.10
0nix770: sits out 
*** HOLE CARDS ***
Sve_Sve93: raises $0.20 to $0.30
JohnSF7: raises $0.60 to $0.90
KIIsSharkMan: folds 
GrinZwe91! is disconnected 
GrinZwe91! is connected 
GrinZwe91!: folds 
Skiednis01: folds 
Sve_Sve93: calls $0.60
*** FLOP *** [6d 6c 9s]
Sve_Sve93: checks 
JohnSF7: bets $0.61
Sve_Sve93: calls $0.61
*** TURN *** [6d 6c 9s] [4h]
Sve_Sve93: checks 
JohnSF7: checks 
*** RIVER *** [6d 6c 9s 4h] [9c]
Sve_Sve93: checks 
JohnSF7: checks 
*** SHOW DOWN ***
Sve_Sve93: shows [Ac Js] (two pair, Nines and Sixes)
JohnSF7: shows [As Qs] (two pair, Nines and Sixes)
Sve_Sve93 collected $1.52 from pot
JohnSF7 collected $1.51 from pot
*** SUMMARY ***
Total pot $3.17 | Rake $0.14 
Board [6d 6c 9s 4h 9c]
Seat 1: Skiednis01 (big blind) folded before Flop
Seat 2: Sve_Sve93 showed [Ac Js] and won ($1.52) with two pair, Nines and Sixes
Seat 4: JohnSF7 showed [As Qs] and won ($1.51) with two pair, Nines and Sixes
Seat 5: KIIsSharkMan (button) folded before Flop (didn't bet)
Seat 6: GrinZwe91! (small blind) folded before Flop



PokerStars Hand #222966408566:  Hold'em No Limit ($0.05/$0.10 USD) - 2021/01/23 14:28:06 ET
Table 'Bohlinia III' 6-max Seat #6 is the button
Seat 1: Skiednis01 ($10.53 in chips) 
Seat 2: Sve_Sve93 ($17.44 in chips) 
Seat 4: JohnSF7 ($11.43 in chips) 
Seat 5: KIIsSharkMan ($9.95 in chips) 
Seat 6: GrinZwe91! ($27.09 in chips) 
Skiednis01: posts small blind $0.05
Sve_Sve93: posts big blind $0.10
0nix770: sits out 
*** HOLE CARDS ***
JohnSF7: folds 
KIIsSharkMan has timed out
KIIsSharkMan: folds 
GrinZwe91!: folds 
Skiednis01: folds 
Uncalled bet ($0.05) returned to Sve_Sve93
Sve_Sve93 collected $0.10 from pot
Sve_Sve93: doesn't show hand 
*** SUMMARY ***
Total pot $0.10 | Rake $0 
Seat 1: Skiednis01 (small blind) folded before Flop
Seat 2: Sve_Sve93 (big blind) collected ($0.10)
Seat 4: JohnSF7 folded before Flop (didn't bet)
Seat 5: KIIsSharkMan folded before Flop (didn't bet)
Seat 6: GrinZwe91! (button) folded before Flop (didn't bet)



PokerStars Hand #222966421667:  Hold'em No Limit ($0.05/$0.10 USD) - 2021/01/23 14:28:23 ET
Table 'Bohlinia III' 6-max Seat #1 is the button
Seat 1: Skiednis01 ($10.48 in chips) 
Seat 2: Sve_Sve93 ($17.49 in chips) 
Seat 3: 0nix770 ($10 in chips) 
Seat 4: JohnSF7 ($11.43 in chips) 
Seat 5: KIIsSharkMan ($9.95 in chips) 
Seat 6: GrinZwe91! ($27.09 in chips) 
Sve_Sve93: posts small blind $0.05
0nix770: posts big blind $0.10
*** HOLE CARDS ***
JohnSF7: folds 
KIIsSharkMan: raises $0.15 to $0.25
GrinZwe91!: folds 
Skiednis01: folds 
Sve_Sve93: calls $0.20
0nix770: calls $0.15
*** FLOP *** [2s Js 8c]
Sve_Sve93: checks 
0nix770: checks 
KIIsSharkMan: bets $0.38
Sve_Sve93: folds 
0nix770: folds 
Uncalled bet ($0.38) returned to KIIsSharkMan
KIIsSharkMan collected $0.72 from pot
KIIsSharkMan: doesn't show hand 
*** SUMMARY ***
Total pot $0.75 | Rake $0.03 
Board [2s Js 8c]
Seat 1: Skiednis01 (button) folded before Flop (didn't bet)
Seat 2: Sve_Sve93 (small blind) folded on the Flop
Seat 3: 0nix770 (big blind) folded on the Flop
Seat 4: JohnSF7 folded before Flop (didn't bet)
Seat 5: KIIsSharkMan collected ($0.72)
Seat 6: GrinZwe91! folded before Flop (didn't bet)



PokerStars Hand #222966457063:  Hold'em No Limit ($0.05/$0.10 USD) - 2021/01/23 14:29:09 ET
Table 'Bohlinia III' 6-max Seat #2 is the button
Seat 1: Skiednis01 ($10.48 in chips) 
Seat 2: Sve_Sve93 ($17.24 in chips) 
Seat 3: 0nix770 ($10 in chips) 
Seat 5: KIIsSharkMan ($10.42 in chips) 
Seat 6: GrinZwe91! ($27.09 in chips) 
0nix770: posts small blind $0.05
JohnSF7: is sitting out 
KIIsSharkMan: posts big blind $0.10
*** HOLE CARDS ***
GrinZwe91!: folds 
JohnSF7 leaves the table
Skiednis01: raises $0.15 to $0.25
Sve_Sve93: folds 
corrado160g joins the table at seat #4 
0nix770: raises $0.75 to $1
KIIsSharkMan: raises $2.25 to $3.25
Skiednis01: folds 
0nix770: folds 
Uncalled bet ($2.25) returned to KIIsSharkMan
KIIsSharkMan collected $2.25 from pot
KIIsSharkMan: doesn't show hand 
*** SUMMARY ***
Total pot $2.25 | Rake $0 
Seat 1: Skiednis01 folded before Flop
Seat 2: Sve_Sve93 (button) folded before Flop (didn't bet)
Seat 3: 0nix770 (small blind) folded before Flop
Seat 5: KIIsSharkMan (big blind) collected ($2.25)
Seat 6: GrinZwe91! folded before Flop (didn't bet)



PokerStars Hand #222966483913:  Hold'em No Limit ($0.05/$0.10 USD) - 2021/01/23 14:29:44 ET
Table 'Bohlinia III' 6-max Seat #3 is the button
Seat 1: Skiednis01 ($10.23 in chips) 
Seat 2: Sve_Sve93 ($17.24 in chips) 
Seat 3: 0nix770 ($10 in chips) 
Seat 5: KIIsSharkMan ($11.67 in chips) 
Seat 6: GrinZwe91! ($27.09 in chips) 
KIIsSharkMan: posts small blind $0.05
GrinZwe91!: posts big blind $0.10
*** HOLE CARDS ***
Skiednis01: raises $0.15 to $0.25
Sve_Sve93: folds 
0nix770: folds 
KIIsSharkMan: folds 
GrinZwe91!: raises $0.65 to $0.90
Skiednis01: calls $0.65
*** FLOP *** [8d 3h Th]
GrinZwe91!: checks 
Skiednis01: checks 
*** TURN *** [8d 3h Th] [6s]
GrinZwe91!: checks 
Skiednis01: checks 
*** RIVER *** [8d 3h Th 6s] [2c]
GrinZwe91!: checks 
Skiednis01: bets $1
GrinZwe91!: calls $1
*** SHOW DOWN ***
Skiednis01: shows [Kh As] (high card Ace)
GrinZwe91!: shows [Ac Kc] (high card Ace)
GrinZwe91! collected $1.84 from pot
Skiednis01 collected $1.84 from pot
*** SUMMARY ***
Total pot $3.85 | Rake $0.17 
Board [8d 3h Th 6s 2c]
Seat 1: Skiednis01 showed [Kh As] and won ($1.84) with high card Ace
Seat 2: Sve_Sve93 folded before Flop (didn't bet)
Seat 3: 0nix770 (button) folded before Flop (didn't bet)
Seat 5: KIIsSharkMan (small blind) folded before Flop
Seat 6: GrinZwe91! (big blind) showed [Ac Kc] and won ($1.84) with high card Ace



PokerStars Hand #222966552205:  Hold'em No Limit ($0.05/$0.10 USD) - 2021/01/23 14:31:00 ET
Table 'Bohlinia III' 6-max Seat #5 is the button
Seat 1: Skiednis01 ($10.17 in chips) 
Seat 2: Sve_Sve93 ($17.24 in chips) 
Seat 3: 0nix770 ($10 in chips) 
Seat 4: corrado160g ($9.90 in chips) 
Seat 5: KIIsSharkMan ($11.62 in chips) 
Seat 6: GrinZwe91! ($27.03 in chips) 
GrinZwe91!: posts small blind $0.05
Skiednis01: posts big blind $0.10
corrado160g: posts big blind $0.10
*** HOLE CARDS ***
Sve_Sve93: folds 
0nix770: folds 
corrado160g: checks 
KIIsSharkMan: folds 
GrinZwe91!: folds 
Skiednis01: checks 
*** FLOP *** [9d 7c 8h]
Skiednis01: bets $0.10
corrado160g: calls $0.10
*** TURN *** [9d 7c 8h] [Th]
Skiednis01: checks 
corrado160g: checks 
*** RIVER *** [9d 7c 8h Th] [Jh]
Skiednis01: checks 
corrado160g: bets $0.10
Skiednis01: calls $0.10
*** SHOW DOWN ***
corrado160g: shows [9s Kd] (a straight, Seven to Jack)
Skiednis01: shows [As 7h] (a straight, Seven to Jack)
Skiednis01 collected $0.31 from pot
corrado160g collected $0.31 from pot
*** SUMMARY ***
Total pot $0.65 | Rake $0.03 
Board [9d 7c 8h Th Jh]
Seat 1: Skiednis01 (big blind) showed [As 7h] and won ($0.31) with a straight, Seven to Jack
Seat 2: Sve_Sve93 folded before Flop (didn't bet)
Seat 3: 0nix770 folded before Flop (didn't bet)
Seat 4: corrado160g showed [9s Kd] and won ($0.31) with a straight, Seven to Jack
Seat 5: KIIsSharkMan (button) folded before Flop (didn't bet)
Seat 6: GrinZwe91! (small blind) folded before Flop



PokerStars Hand #222966599137:  Hold'em No Limit ($0.05/$0.10 USD) - 2021/01/23 14:31:59 ET
Table 'Bohlinia III' 6-max Seat #6 is the button
Seat 1: Skiednis01 ($10.18 in chips) 
Seat 2: Sve_Sve93 ($17.24 in chips) 
Seat 3: 0nix770 ($10 in chips) 
Seat 4: corrado160g ($9.91 in chips) 
Seat 5: KIIsSharkMan ($11.62 in chips) 
Seat 6: GrinZwe91! ($26.98 in chips) 
Skiednis01: posts small blind $0.05
Sve_Sve93: posts big blind $0.10
*** HOLE CARDS ***
0nix770: folds 
corrado160g: folds 
KIIsSharkMan: folds 
GrinZwe91!: folds 
Skiednis01: raises $0.15 to $0.25
Sve_Sve93: calls $0.15
*** FLOP *** [Tc 8h 2d]
Skiednis01: checks 
Sve_Sve93: checks 
*** TURN *** [Tc 8h 2d] [9c]
Skiednis01: bets $0.24
Sve_Sve93: folds 
Uncalled bet ($0.24) returned to Skiednis01
Skiednis01 collected $0.48 from pot
Skiednis01: doesn't show hand 
*** SUMMARY ***
Total pot $0.50 | Rake $0.02 
Board [Tc 8h 2d 9c]
Seat 1: Skiednis01 (small blind) collected ($0.48)
Seat 2: Sve_Sve93 (big blind) folded on the Turn
Seat 3: 0nix770 folded before Flop (didn't bet)
Seat 4: corrado160g folded before Flop (didn't bet)
Seat 5: KIIsSharkMan folded before Flop (didn't bet)
Seat 6: GrinZwe91! (button) folded before Flop (didn't bet)



PokerStars Hand #222966626273:  Hold'em No Limit ($0.05/$0.10 USD) - 2021/01/23 14:32:34 ET
Table 'Bohlinia III' 6-max Seat #1 is the button
Seat 1: Skiednis01 ($10.41 in chips) 
Seat 2: Sve_Sve93 ($16.99 in chips) 
Seat 3: 0nix770 ($10 in chips) 
Seat 4: corrado160g ($9.91 in chips) 
Seat 5: KIIsSharkMan ($11.62 in chips) 
Seat 6: GrinZwe91! ($26.98 in chips) 
Sve_Sve93: posts small blind $0.05
0nix770: posts big blind $0.10
*** HOLE CARDS ***
corrado160g: folds 
KIIsSharkMan: folds 
GrinZwe91!: folds 
Skiednis01: folds 
Sve_Sve93: raises $0.20 to $0.30
0nix770: folds 
Uncalled bet ($0.20) returned to Sve_Sve93
Sve_Sve93 collected $0.20 from pot
Sve_Sve93: doesn't show hand 
*** SUMMARY ***
Total pot $0.20 | Rake $0 
Seat 1: Skiednis01 (button) folded before Flop (didn't bet)
Seat 2: Sve_Sve93 (small blind) collected ($0.20)
Seat 3: 0nix770 (big blind) folded before Flop
Seat 4: corrado160g folded before Flop (didn't bet)
Seat 5: KIIsSharkMan folded before Flop (didn't bet)
Seat 6: GrinZwe91! folded before Flop (didn't bet)



PokerStars Hand #222966637931:  Hold'em No Limit ($0.05/$0.10 USD) - 2021/01/23 14:32:49 ET
Table 'Bohlinia III' 6-max Seat #2 is the button
Seat 1: Skiednis01 ($10.41 in chips) 
Seat 2: Sve_Sve93 ($17.09 in chips) 
Seat 3: 0nix770 ($10 in chips) 
Seat 4: corrado160g ($9.91 in chips) 
Seat 5: KIIsSharkMan ($11.62 in chips) 
Seat 6: GrinZwe91! ($26.98 in chips) 
0nix770: posts small blind $0.05
corrado160g: posts big blind $0.10
*** HOLE CARDS ***
KIIsSharkMan: folds 
GrinZwe91!: folds 
Skiednis01: folds 
Sve_Sve93: folds 
0nix770: raises $0.20 to $0.30
corrado160g: folds 
Uncalled bet ($0.20) returned to 0nix770
0nix770 collected $0.20 from pot
0nix770: doesn't show hand 
*** SUMMARY ***
Total pot $0.20 | Rake $0 
Seat 1: Skiednis01 folded before Flop (didn't bet)
Seat 2: Sve_Sve93 (button) folded before Flop (didn't bet)
Seat 3: 0nix770 (small blind) collected ($0.20)
Seat 4: corrado160g (big blind) folded before Flop
Seat 5: KIIsSharkMan folded before Flop (didn't bet)
Seat 6: GrinZwe91! folded before Flop (didn't bet)



PokerStars Hand #222966653434:  Hold'em No Limit ($0.05/$0.10 USD) - 2021/01/23 14:33:08 ET
Table 'Bohlinia III' 6-max Seat #3 is the button
Seat 1: Skiednis01 ($10.41 in chips) 
Seat 2: Sve_Sve93 ($17.09 in chips) 
Seat 3: 0nix770 ($10.10 in chips) 
Seat 4: corrado160g ($9.81 in chips) 
Seat 5: KIIsSharkMan ($11.62 in chips) 
Seat 6: GrinZwe91! ($26.98 in chips) 
corrado160g: posts small blind $0.05
KIIsSharkMan: posts big blind $0.10
*** HOLE CARDS ***
GrinZwe91!: raises $0.20 to $0.30
Skiednis01: folds 
Sve_Sve93: folds 
0nix770: folds 
corrado160g: folds 
KIIsSharkMan: folds 
Uncalled bet ($0.20) returned to GrinZwe91!
GrinZwe91! collected $0.25 from pot
GrinZwe91!: doesn't show hand 
*** SUMMARY ***
Total pot $0.25 | Rake $0 
Seat 1: Skiednis01 folded before Flop (didn't bet)
Seat 2: Sve_Sve93 folded before Flop (didn't bet)
Seat 3: 0nix770 (button) folded before Flop (didn't bet)
Seat 4: corrado160g (small blind) folded before Flop
Seat 5: KIIsSharkMan (big blind) folded before Flop
Seat 6: GrinZwe91! collected ($0.25)



PokerStars Hand #222966670179:  Hold'em No Limit ($0.05/$0.10 USD) - 2021/01/23 14:33:30 ET
Table 'Bohlinia III' 6-max Seat #4 is the button
Seat 1: Skiednis01 ($10.41 in chips) 
Seat 2: Sve_Sve93 ($17.09 in chips) 
Seat 3: 0nix770 ($10.10 in chips) 
Seat 4: corrado160g ($9.76 in chips) 
Seat 5: KIIsSharkMan ($11.52 in chips) 
Seat 6: GrinZwe91! ($27.13 in chips) 
KIIsSharkMan: posts small blind $0.05
GrinZwe91!: posts big blind $0.10
*** HOLE CARDS ***
Skiednis01: folds 
Sve_Sve93: folds 
0nix770: raises $0.15 to $0.25
corrado160g: calls $0.25
KIIsSharkMan: raises $0.85 to $1.10
GrinZwe91!: folds 
0nix770: folds 
corrado160g: folds 
Uncalled bet ($0.85) returned to KIIsSharkMan
KIIsSharkMan collected $0.85 from pot
KIIsSharkMan: doesn't show hand 
*** SUMMARY ***
Total pot $0.85 | Rake $0 
Seat 1: Skiednis01 folded before Flop (didn't bet)
Seat 2: Sve_Sve93 folded before Flop (didn't bet)
Seat 3: 0nix770 folded before Flop
Seat 4: corrado160g (button) folded before Flop
Seat 5: KIIsSharkMan (small blind) collected ($0.85)
Seat 6: GrinZwe91! (big blind) folded before Flop



PokerStars Hand #222966693384:  Hold'em No Limit ($0.05/$0.10 USD) - 2021/01/23 14:33:59 ET
Table 'Bohlinia III' 6-max Seat #5 is the button
Seat 1: Skiednis01 ($10.41 in chips) 
Seat 2: Sve_Sve93 ($17.09 in chips) 
Seat 3: 0nix770 ($10 in chips) 
Seat 4: corrado160g ($9.51 in chips) 
Seat 5: KIIsSharkMan ($12.12 in chips) 
Seat 6: GrinZwe91! ($27.03 in chips) 
GrinZwe91!: posts small blind $0.05
Skiednis01: posts big blind $0.10
*** HOLE CARDS ***
Sve_Sve93: folds 
0nix770 has timed out
0nix770: folds 
corrado160g: folds 
KIIsSharkMan: raises $0.20 to $0.30
GrinZwe91!: folds 
Skiednis01: folds 
Uncalled bet ($0.20) returned to KIIsSharkMan
KIIsSharkMan collected $0.25 from pot
KIIsSharkMan: doesn't show hand 
*** SUMMARY ***
Total pot $0.25 | Rake $0 
Seat 1: Skiednis01 (big blind) folded before Flop
Seat 2: Sve_Sve93 folded before Flop (didn't bet)
Seat 3: 0nix770 folded before Flop (didn't bet)
Seat 4: corrado160g folded before Flop (didn't bet)
Seat 5: KIIsSharkMan (button) collected ($0.25)
Seat 6: GrinZwe91! (small blind) folded before Flop



PokerStars Hand #222966726059:  Hold'em No Limit ($0.05/$0.10 USD) - 2021/01/23 14:34:42 ET
Table 'Bohlinia III' 6-max Seat #6 is the button
Seat 1: Skiednis01 ($10.31 in chips) 
Seat 2: Sve_Sve93 ($17.09 in chips) 
Seat 3: 0nix770 ($10 in chips) 
Seat 4: corrado160g ($9.51 in chips) 
Seat 5: KIIsSharkMan ($12.27 in chips) 
Seat 6: GrinZwe91! ($26.98 in chips) 
Skiednis01: posts small blind $0.05
Sve_Sve93: posts big blind $0.10
*** HOLE CARDS ***
0nix770: folds 
corrado160g: raises $0.10 to $0.20
KIIsSharkMan: folds 
GrinZwe91!: raises $0.70 to $0.90
Skiednis01: folds 
Sve_Sve93: folds 
corrado160g: calls $0.70
*** FLOP *** [8s 8d Th]
corrado160g: bets $0.93
GrinZwe91!: folds 
Uncalled bet ($0.93) returned to corrado160g
corrado160g collected $1.86 from pot
corrado160g: doesn't show hand 
*** SUMMARY ***
Total pot $1.95 | Rake $0.09 
Board [8s 8d Th]
Seat 1: Skiednis01 (small blind) folded before Flop
Seat 2: Sve_Sve93 (big blind) folded before Flop
Seat 3: 0nix770 folded before Flop (didn't bet)
Seat 4: corrado160g collected ($1.86)
Seat 5: KIIsSharkMan folded before Flop (didn't bet)
Seat 6: GrinZwe91! (button) folded on the Flop



PokerStars Hand #222966762599:  Hold'em No Limit ($0.05/$0.10 USD) - 2021/01/23 14:35:28 ET
Table 'Bohlinia III' 6-max Seat #1 is the button
Seat 1: Skiednis01 ($10.26 in chips) 
Seat 2: Sve_Sve93 ($16.99 in chips) 
Seat 3: 0nix770 ($10 in chips) 
Seat 4: corrado160g ($10.47 in chips) 
Seat 5: KIIsSharkMan ($12.27 in chips) 
Seat 6: GrinZwe91! ($26.08 in chips) 
Sve_Sve93: posts small blind $0.05
0nix770: posts big blind $0.10
*** HOLE CARDS ***
corrado160g: calls $0.10
KIIsSharkMan: folds 
GrinZwe91!: raises $0.30 to $0.40
Skiednis01: folds 
Sve_Sve93: folds 
0nix770: folds 
corrado160g: calls $0.30
*** FLOP *** [Ks 2d Kc]
corrado160g: bets $0.46
GrinZwe91!: folds 
Uncalled bet ($0.46) returned to corrado160g
corrado160g collected $0.91 from pot
corrado160g: doesn't show hand 
*** SUMMARY ***
Total pot $0.95 | Rake $0.04 
Board [Ks 2d Kc]
Seat 1: Skiednis01 (button) folded before Flop (didn't bet)
Seat 2: Sve_Sve93 (small blind) folded before Flop
Seat 3: 0nix770 (big blind) folded before Flop
Seat 4: corrado160g collected ($0.91)
Seat 5: KIIsSharkMan folded before Flop (didn't bet)
Seat 6: GrinZwe91! folded on the Flop



PokerStars Hand #222966781519:  Hold'em No Limit ($0.05/$0.10 USD) - 2021/01/23 14:35:52 ET
Table 'Bohlinia III' 6-max Seat #2 is the button
Seat 1: Skiednis01 ($10.26 in chips) 
Seat 2: Sve_Sve93 ($16.94 in chips) 
Seat 3: 0nix770 ($10 in chips) 
Seat 4: corrado160g ($10.98 in chips) 
Seat 5: KIIsSharkMan ($12.27 in chips) 
Seat 6: GrinZwe91! ($25.68 in chips) 
0nix770: posts small blind $0.05
corrado160g: posts big blind $0.10
*** HOLE CARDS ***
KIIsSharkMan: folds 
GrinZwe91!: folds 
Skiednis01: folds 
Sve_Sve93: folds 
0nix770: folds 
Uncalled bet ($0.05) returned to corrado160g
corrado160g collected $0.10 from pot
corrado160g: doesn't show hand 
*** SUMMARY ***
Total pot $0.10 | Rake $0 
Seat 1: Skiednis01 folded before Flop (didn't bet)
Seat 2: Sve_Sve93 (button) folded before Flop (didn't bet)
Seat 3: 0nix770 (small blind) folded before Flop
Seat 4: corrado160g (big blind) collected ($0.10)
Seat 5: KIIsSharkMan folded before Flop (didn't bet)
Seat 6: GrinZwe91! folded before Flop (didn't bet)



PokerStars Hand #222966788824:  Hold'em No Limit ($0.05/$0.10 USD) - 2021/01/23 14:36:02 ET
Table 'Bohlinia III' 6-max Seat #3 is the button
Seat 1: Skiednis01 ($10.26 in chips) 
Seat 2: Sve_Sve93 ($16.94 in chips) 
Seat 3: 0nix770 ($10 in chips) 
Seat 4: corrado160g ($11.03 in chips) 
Seat 5: KIIsSharkMan ($12.27 in chips) 
Seat 6: GrinZwe91! ($25.68 in chips) 
corrado160g: posts small blind $0.05
KIIsSharkMan: posts big blind $0.10
*** HOLE CARDS ***
GrinZwe91!: folds 
Skiednis01: raises $0.15 to $0.25
Sve_Sve93: folds 
0nix770: folds 
corrado160g: calls $0.20
KIIsSharkMan: calls $0.15
*** FLOP *** [5s Jc 2d]
corrado160g: checks 
KIIsSharkMan: checks 
Skiednis01: bets $0.40
corrado160g: folds 
KIIsSharkMan: folds 
Uncalled bet ($0.40) returned to Skiednis01
Skiednis01 collected $0.72 from pot
Skiednis01: doesn't show hand 
*** SUMMARY ***
Total pot $0.75 | Rake $0.03 
Board [5s Jc 2d]
Seat 1: Skiednis01 collected ($0.72)
Seat 2: Sve_Sve93 folded before Flop (didn't bet)
Seat 3: 0nix770 (button) folded before Flop (didn't bet)
Seat 4: corrado160g (small blind) folded on the Flop
Seat 5: KIIsSharkMan (big blind) folded on the Flop
Seat 6: GrinZwe91! folded before Flop (didn't bet)



PokerStars Hand #222966823612:  Hold'em No Limit ($0.05/$0.10 USD) - 2021/01/23 14:36:45 ET
Table 'Bohlinia III' 6-max Seat #4 is the button
Seat 1: Skiednis01 ($10.73 in chips) 
Seat 2: Sve_Sve93 ($16.94 in chips) 
Seat 3: 0nix770 ($10 in chips) 
Seat 4: corrado160g ($10.78 in chips) 
Seat 5: KIIsSharkMan ($12.02 in chips) 
Seat 6: GrinZwe91! ($25.68 in chips) 
KIIsSharkMan: posts small blind $0.05
GrinZwe91!: posts big blind $0.10
*** HOLE CARDS ***
Skiednis01: folds 
Sve_Sve93: folds 
0nix770: raises $0.15 to $0.25
corrado160g: calls $0.25
KIIsSharkMan: folds 
GrinZwe91!: folds 
*** FLOP *** [7s Ts 6d]
0nix770: checks 
corrado160g: bets $0.20
0nix770: folds 
Uncalled bet ($0.20) returned to corrado160g
corrado160g collected $0.62 from pot
corrado160g: doesn't show hand 
*** SUMMARY ***
Total pot $0.65 | Rake $0.03 
Board [7s Ts 6d]
Seat 1: Skiednis01 folded before Flop (didn't bet)
Seat 2: Sve_Sve93 folded before Flop (didn't bet)
Seat 3: 0nix770 folded on the Flop
Seat 4: corrado160g (button) collected ($0.62)
Seat 5: KIIsSharkMan (small blind) folded before Flop
Seat 6: GrinZwe91! (big blind) folded before Flop



PokerStars Hand #222966847443:  Hold'em No Limit ($0.05/$0.10 USD) - 2021/01/23 14:37:16 ET
Table 'Bohlinia III' 6-max Seat #5 is the button
Seat 1: Skiednis01 ($10.73 in chips) 
Seat 2: Sve_Sve93 ($16.94 in chips) 
Seat 3: 0nix770 ($10 in chips) 
Seat 4: corrado160g ($11.15 in chips) 
Seat 5: KIIsSharkMan ($11.97 in chips) 
Seat 6: GrinZwe91! ($25.58 in chips) 
GrinZwe91!: posts small blind $0.05
Skiednis01: posts big blind $0.10
*** HOLE CARDS ***
Sve_Sve93: folds 
0nix770: folds 
corrado160g: folds 
KIIsSharkMan: raises $0.20 to $0.30
GrinZwe91!: folds 
Skiednis01: folds 
Uncalled bet ($0.20) returned to KIIsSharkMan
KIIsSharkMan collected $0.25 from pot
KIIsSharkMan: doesn't show hand 
*** SUMMARY ***
Total pot $0.25 | Rake $0 
Seat 1: Skiednis01 (big blind) folded before Flop
Seat 2: Sve_Sve93 folded before Flop (didn't bet)
Seat 3: 0nix770 folded before Flop (didn't bet)
Seat 4: corrado160g folded before Flop (didn't bet)
Seat 5: KIIsSharkMan (button) collected ($0.25)
Seat 6: GrinZwe91! (small blind) folded before Flop



PokerStars Hand #222966859906:  Hold'em No Limit ($0.05/$0.10 USD) - 2021/01/23 14:37:32 ET
Table 'Bohlinia III' 6-max Seat #6 is the button
Seat 1: Skiednis01 ($10.63 in chips) 
Seat 2: Sve_Sve93 ($16.94 in chips) 
Seat 3: 0nix770 ($10 in chips) 
Seat 4: corrado160g ($11.15 in chips) 
Seat 5: KIIsSharkMan ($12.12 in chips) 
Seat 6: GrinZwe91! ($25.53 in chips) 
Skiednis01: posts small blind $0.05
Sve_Sve93: posts big blind $0.10
*** HOLE CARDS ***
0nix770: folds 
corrado160g: folds 
KIIsSharkMan has timed out
KIIsSharkMan: folds 
GrinZwe91!: folds 
Skiednis01: raises $0.15 to $0.25
Sve_Sve93: folds 
Uncalled bet ($0.15) returned to Skiednis01
Skiednis01 collected $0.20 from pot
Skiednis01: doesn't show hand 
*** SUMMARY ***
Total pot $0.20 | Rake $0 
Seat 1: Skiednis01 (small blind) collected ($0.20)
Seat 2: Sve_Sve93 (big blind) folded before Flop
Seat 3: 0nix770 folded before Flop (didn't bet)
Seat 4: corrado160g folded before Flop (didn't bet)
Seat 5: KIIsSharkMan folded before Flop (didn't bet)
Seat 6: GrinZwe91! (button) folded before Flop (didn't bet)



PokerStars Hand #222966882246:  Hold'em No Limit ($0.05/$0.10 USD) - 2021/01/23 14:38:00 ET
Table 'Bohlinia III' 6-max Seat #1 is the button
Seat 1: Skiednis01 ($10.73 in chips) 
Seat 2: Sve_Sve93 ($16.84 in chips) 
Seat 3: 0nix770 ($10 in chips) 
Seat 4: corrado160g ($11.15 in chips) 
Seat 5: KIIsSharkMan ($12.12 in chips) 
Seat 6: GrinZwe91! ($25.53 in chips) 
Sve_Sve93: posts small blind $0.05
0nix770: posts big blind $0.10
*** HOLE CARDS ***
corrado160g: raises $0.10 to $0.20
KIIsSharkMan: calls $0.20
GrinZwe91!: folds 
Skiednis01: folds 
Sve_Sve93: folds 
0nix770: folds 
*** FLOP *** [4c Th Js]
corrado160g: checks 
KIIsSharkMan: checks 
*** TURN *** [4c Th Js] [Jh]
corrado160g: checks 
KIIsSharkMan: checks 
*** RIVER *** [4c Th Js Jh] [7c]
corrado160g: bets $0.30
KIIsSharkMan: calls $0.30
*** SHOW DOWN ***
corrado160g: shows [4s 4h] (a full house, Fours full of Jacks)
KIIsSharkMan: mucks hand 
corrado160g collected $1.10 from pot
*** SUMMARY ***
Total pot $1.15 | Rake $0.05 
Board [4c Th Js Jh 7c]
Seat 1: Skiednis01 (button) folded before Flop (didn't bet)
Seat 2: Sve_Sve93 (small blind) folded before Flop
Seat 3: 0nix770 (big blind) folded before Flop
Seat 4: corrado160g showed [4s 4h] and won ($1.10) with a full house, Fours full of Jacks
Seat 5: KIIsSharkMan mucked
Seat 6: GrinZwe91! folded before Flop (didn't bet)



PokerStars Hand #222966909827:  Hold'em No Limit ($0.05/$0.10 USD) - 2021/01/23 14:38:36 ET
Table 'Bohlinia III' 6-max Seat #2 is the button
Seat 1: Skiednis01 ($10.73 in chips) 
Seat 2: Sve_Sve93 ($16.79 in chips) 
Seat 3: 0nix770 ($10 in chips) 
Seat 4: corrado160g ($11.75 in chips) 
Seat 5: KIIsSharkMan ($11.62 in chips) 
Seat 6: GrinZwe91! ($25.53 in chips) 
0nix770: posts small blind $0.05
corrado160g: posts big blind $0.10
*** HOLE CARDS ***
KIIsSharkMan: folds 
GrinZwe91!: folds 
Skiednis01: raises $0.15 to $0.25
Sve_Sve93: calls $0.25
0nix770: folds 
corrado160g: folds 
*** FLOP *** [7c 9h 5c]
corrado160g leaves the table
Skiednis01: bets $0.31
Sve_Sve93: folds 
Uncalled bet ($0.31) returned to Skiednis01
Skiednis01 collected $0.62 from pot
Skiednis01: doesn't show hand 
darachr joins the table at seat #4 
*** SUMMARY ***
Total pot $0.65 | Rake $0.03 
Board [7c 9h 5c]
Seat 1: Skiednis01 collected ($0.62)
Seat 2: Sve_Sve93 (button) folded on the Flop
Seat 3: 0nix770 (small blind) folded before Flop
Seat 4: corrado160g (big blind) folded before Flop
Seat 5: KIIsSharkMan folded before Flop (didn't bet)
Seat 6: GrinZwe91! folded before Flop (didn't bet)



PokerStars Hand #222966929658:  Hold'em No Limit ($0.05/$0.10 USD) - 2021/01/23 14:39:01 ET
Table 'Bohlinia III' 6-max Seat #3 is the button
Seat 1: Skiednis01 ($11.10 in chips) 
Seat 2: Sve_Sve93 ($16.54 in chips) 
Seat 3: 0nix770 ($10 in chips) 
Seat 5: KIIsSharkMan ($11.62 in chips) 
Seat 6: GrinZwe91! ($25.53 in chips) 
KIIsSharkMan: posts small blind $0.05
GrinZwe91!: posts big blind $0.10
*** HOLE CARDS ***
Skiednis01: raises $0.15 to $0.25
Sve_Sve93: folds 
0nix770: calls $0.25
KIIsSharkMan: folds 
GrinZwe91!: folds 
*** FLOP *** [3d 4d 4h]
Skiednis01: bets $0.31
0nix770: folds 
Uncalled bet ($0.31) returned to Skiednis01
Skiednis01 collected $0.62 from pot
Skiednis01: doesn't show hand 
*** SUMMARY ***
Total pot $0.65 | Rake $0.03 
Board [3d 4d 4h]
Seat 1: Skiednis01 collected ($0.62)
Seat 2: Sve_Sve93 folded before Flop (didn't bet)
Seat 3: 0nix770 (button) folded on the Flop
Seat 5: KIIsSharkMan (small blind) folded before Flop
Seat 6: GrinZwe91! (big blind) folded before Flop



PokerStars Hand #222964183398:  Hold'em No Limit ($0.05/$0.10 USD) - 2021/01/23 13:38:45 ET
Table 'Bohlinia III' 6-max Seat #2 is the button
Seat 1: xucuo ($14.10 in chips) 
Seat 2: Sve_Sve93 ($13.21 in chips) 
Seat 3: memojr29 ($16.06 in chips) 
Seat 4: JohnSF7 ($11.26 in chips) 
Seat 5: Valhalla1976 ($5.70 in chips) 
Seat 6: GrinZwe91! ($23.31 in chips) 
memojr29: posts small blind $0.05
JohnSF7: posts big blind $0.10
*** HOLE CARDS ***
Valhalla1976: folds 
GrinZwe91!: raises $0.20 to $0.30
xucuo: calls $0.30
Sve_Sve93: folds 
memojr29: folds 
JohnSF7: calls $0.20
*** FLOP *** [As 3s 8d]
JohnSF7: checks 
GrinZwe91! is disconnected 
GrinZwe91! is connected 
GrinZwe91!: checks 
xucuo: checks 
*** TURN *** [As 3s 8d] [2h]
JohnSF7: checks 
GrinZwe91!: checks 
xucuo: checks 
*** RIVER *** [As 3s 8d 2h] [Th]
JohnSF7: bets $0.70
GrinZwe91!: folds 
xucuo: folds 
Uncalled bet ($0.70) returned to JohnSF7
JohnSF7 collected $0.91 from pot
JohnSF7: doesn't show hand 
*** SUMMARY ***
Total pot $0.95 | Rake $0.04 
Board [As 3s 8d 2h Th]
Seat 1: xucuo folded on the River
Seat 2: Sve_Sve93 (button) folded before Flop (didn't bet)
Seat 3: memojr29 (small blind) folded before Flop
Seat 4: JohnSF7 (big blind) collected ($0.91)
Seat 5: Valhalla1976 folded before Flop (didn't bet)
Seat 6: GrinZwe91! folded on the River



PokerStars Hand #222964258573:  Hold'em No Limit ($0.05/$0.10 USD) - 2021/01/23 13:40:22 ET
Table 'Bohlinia III' 6-max Seat #3 is the button
Seat 1: xucuo ($13.80 in chips) 
Seat 2: Sve_Sve93 ($13.21 in chips) 
Seat 3: memojr29 ($16.01 in chips) 
Seat 4: JohnSF7 ($11.87 in chips) 
Seat 5: Valhalla1976 ($5.70 in chips) 
Seat 6: GrinZwe91! ($23.01 in chips) 
JohnSF7: posts small blind $0.05
Valhalla1976: posts big blind $0.10
*** HOLE CARDS ***
GrinZwe91!: folds 
xucuo: folds 
Sve_Sve93: folds 
memojr29: folds 
JohnSF7: calls $0.05
Valhalla1976: checks 
*** FLOP *** [Th 8s 4h]
JohnSF7: checks 
Valhalla1976: checks 
*** TURN *** [Th 8s 4h] [Ts]
JohnSF7: bets $0.10
Valhalla1976: raises $0.10 to $0.20
JohnSF7: calls $0.10
*** RIVER *** [Th 8s 4h Ts] [7d]
JohnSF7: checks 
Valhalla1976: bets $0.57
JohnSF7: folds 
Uncalled bet ($0.57) returned to Valhalla1976
Valhalla1976 collected $0.57 from pot
Valhalla1976: doesn't show hand 
*** SUMMARY ***
Total pot $0.60 | Rake $0.03 
Board [Th 8s 4h Ts 7d]
Seat 1: xucuo folded before Flop (didn't bet)
Seat 2: Sve_Sve93 folded before Flop (didn't bet)
Seat 3: memojr29 (button) folded before Flop (didn't bet)
Seat 4: JohnSF7 (small blind) folded on the River
Seat 5: Valhalla1976 (big blind) collected ($0.57)
Seat 6: GrinZwe91! folded before Flop (didn't bet)



PokerStars Hand #222964286960:  Hold'em No Limit ($0.05/$0.10 USD) - 2021/01/23 13:40:59 ET
Table 'Bohlinia III' 6-max Seat #4 is the button
Seat 1: xucuo ($13.80 in chips) 
Seat 2: Sve_Sve93 ($13.21 in chips) 
Seat 3: memojr29 ($16.01 in chips) 
Seat 4: JohnSF7 ($11.57 in chips) 
Seat 5: Valhalla1976 ($5.97 in chips) 
Seat 6: GrinZwe91! ($23.01 in chips) 
Valhalla1976: posts small blind $0.05
GrinZwe91!: posts big blind $0.10
*** HOLE CARDS ***
xucuo: calls $0.10
Sve_Sve93: folds 
memojr29: folds 
JohnSF7: raises $0.30 to $0.40
Valhalla1976: folds 
GrinZwe91!: folds 
xucuo: folds 
Uncalled bet ($0.30) returned to JohnSF7
JohnSF7 collected $0.35 from pot
JohnSF7: doesn't show hand 
*** SUMMARY ***
Total pot $0.35 | Rake $0 
Seat 1: xucuo folded before Flop
Seat 2: Sve_Sve93 folded before Flop (didn't bet)
Seat 3: memojr29 folded before Flop (didn't bet)
Seat 4: JohnSF7 (button) collected ($0.35)
Seat 5: Valhalla1976 (small blind) folded before Flop
Seat 6: GrinZwe91! (big blind) folded before Flop



PokerStars Hand #222964308458:  Hold'em No Limit ($0.05/$0.10 USD) - 2021/01/23 13:41:27 ET
Table 'Bohlinia III' 6-max Seat #5 is the button
Seat 1: xucuo ($13.70 in chips) 
Seat 2: Sve_Sve93 ($13.21 in chips) 
Seat 3: memojr29 ($16.01 in chips) 
Seat 4: JohnSF7 ($11.82 in chips) 
Seat 5: Valhalla1976 ($5.92 in chips) 
Seat 6: GrinZwe91! ($22.91 in chips) 
GrinZwe91!: posts small blind $0.05
xucuo: posts big blind $0.10
*** HOLE CARDS ***
Sve_Sve93: folds 
memojr29: folds 
JohnSF7: folds 
Valhalla1976: raises $0.10 to $0.20
GrinZwe91!: folds 
xucuo: folds 
Uncalled bet ($0.10) returned to Valhalla1976
Valhalla1976 collected $0.25 from pot
Valhalla1976: doesn't show hand 
*** SUMMARY ***
Total pot $0.25 | Rake $0 
Seat 1: xucuo (big blind) folded before Flop
Seat 2: Sve_Sve93 folded before Flop (didn't bet)
Seat 3: memojr29 folded before Flop (didn't bet)
Seat 4: JohnSF7 folded before Flop (didn't bet)
Seat 5: Valhalla1976 (button) collected ($0.25)
Seat 6: GrinZwe91! (small blind) folded before Flop



PokerStars Hand #222964318989:  Hold'em No Limit ($0.05/$0.10 USD) - 2021/01/23 13:41:40 ET
Table 'Bohlinia III' 6-max Seat #6 is the button
Seat 1: xucuo ($13.60 in chips) 
Seat 2: Sve_Sve93 ($13.21 in chips) 
Seat 3: memojr29 ($16.01 in chips) 
Seat 4: JohnSF7 ($11.82 in chips) 
Seat 5: Valhalla1976 ($6.07 in chips) 
Seat 6: GrinZwe91! ($22.86 in chips) 
xucuo: posts small blind $0.05
Sve_Sve93: posts big blind $0.10
*** HOLE CARDS ***
memojr29: folds 
JohnSF7: folds 
Valhalla1976: raises $0.20 to $0.30
GrinZwe91!: folds 
xucuo: folds 
Sve_Sve93: folds 
Uncalled bet ($0.20) returned to Valhalla1976
Valhalla1976 collected $0.25 from pot
Valhalla1976: doesn't show hand 
*** SUMMARY ***
Total pot $0.25 | Rake $0 
Seat 1: xucuo (small blind) folded before Flop
Seat 2: Sve_Sve93 (big blind) folded before Flop
Seat 3: memojr29 folded before Flop (didn't bet)
Seat 4: JohnSF7 folded before Flop (didn't bet)
Seat 5: Valhalla1976 collected ($0.25)
Seat 6: GrinZwe91! (button) folded before Flop (didn't bet)



PokerStars Hand #222966948903:  Hold'em No Limit ($0.05/$0.10 USD) - 2021/01/23 14:39:26 ET
Table 'Bohlinia III' 6-max Seat #5 is the button
Seat 1: Skiednis01 ($11.47 in chips) 
Seat 2: Sve_Sve93 ($16.54 in chips) 
Seat 3: 0nix770 ($10 in chips) 
Seat 4: darachr ($8 in chips) 
Seat 5: KIIsSharkMan ($11.57 in chips) 
Seat 6: GrinZwe91! ($25.43 in chips) 
GrinZwe91!: posts small blind $0.05
Skiednis01: posts big blind $0.10
darachr: posts big blind $0.10
*** HOLE CARDS ***
Sve_Sve93: folds 
0nix770: raises $0.30 to $0.40
darachr: calls $0.30
KIIsSharkMan: calls $0.40
GrinZwe91!: folds 
Skiednis01: calls $0.30
*** FLOP *** [8c 5s 8h]
Skiednis01: checks 
0nix770: checks 
darachr: checks 
KIIsSharkMan: checks 
*** TURN *** [8c 5s 8h] [As]
Skiednis01: checks 
0nix770: checks 
darachr: bets $0.79
KIIsSharkMan: calls $0.79
Skiednis01: folds 
0nix770: folds 
*** RIVER *** [8c 5s 8h As] [5c]
darachr: bets $0.90
KIIsSharkMan: folds 
Uncalled bet ($0.90) returned to darachr
darachr collected $3.08 from pot
darachr: doesn't show hand 
*** SUMMARY ***
Total pot $3.23 | Rake $0.15 
Board [8c 5s 8h As 5c]
Seat 1: Skiednis01 (big blind) folded on the Turn
Seat 2: Sve_Sve93 folded before Flop (didn't bet)
Seat 3: 0nix770 folded on the Turn
Seat 4: darachr collected ($3.08)
Seat 5: KIIsSharkMan (button) folded on the River
Seat 6: GrinZwe91! (small blind) folded before Flop



PokerStars Hand #222967005179:  Hold'em No Limit ($0.05/$0.10 USD) - 2021/01/23 14:40:38 ET
Table 'Bohlinia III' 6-max Seat #6 is the button
Seat 1: Skiednis01 ($11.07 in chips) 
Seat 2: Sve_Sve93 ($16.54 in chips) 
Seat 3: 0nix770 ($10 in chips) 
Seat 4: darachr ($9.89 in chips) 
Seat 5: KIIsSharkMan ($10.38 in chips) 
Seat 6: GrinZwe91! ($25.38 in chips) 
Skiednis01: posts small blind $0.05
Sve_Sve93: posts big blind $0.10
*** HOLE CARDS ***
0nix770: folds 
darachr: calls $0.10
KIIsSharkMan: raises $0.35 to $0.45
GrinZwe91!: folds 
Skiednis01: folds 
Sve_Sve93: folds 
darachr: folds 
Uncalled bet ($0.35) returned to KIIsSharkMan
KIIsSharkMan collected $0.35 from pot
KIIsSharkMan: doesn't show hand 
*** SUMMARY ***
Total pot $0.35 | Rake $0 
Seat 1: Skiednis01 (small blind) folded before Flop
Seat 2: Sve_Sve93 (big blind) folded before Flop
Seat 3: 0nix770 folded before Flop (didn't bet)
Seat 4: darachr folded before Flop
Seat 5: KIIsSharkMan collected ($0.35)
Seat 6: GrinZwe91! (button) folded before Flop (didn't bet)



PokerStars Hand #222967026480:  Hold'em No Limit ($0.05/$0.10 USD) - 2021/01/23 14:41:05 ET
Table 'Bohlinia III' 6-max Seat #1 is the button
Seat 1: Skiednis01 ($11.02 in chips) 
Seat 2: Sve_Sve93 ($16.44 in chips) 
Seat 3: 0nix770 ($10 in chips) 
Seat 4: darachr ($9.79 in chips) 
Seat 5: KIIsSharkMan ($10.63 in chips) 
Seat 6: GrinZwe91! ($25.38 in chips) 
Sve_Sve93: posts small blind $0.05
0nix770: posts big blind $0.10
*** HOLE CARDS ***
darachr: raises $0.20 to $0.30
KIIsSharkMan: calls $0.30
GrinZwe91!: folds 
Skiednis01: folds 
Sve_Sve93: folds 
0nix770: calls $0.20
*** FLOP *** [8c Td 3s]
0nix770: checks 
darachr: checks 
KIIsSharkMan: bets $0.48
0nix770: folds 
darachr: folds 
Uncalled bet ($0.48) returned to KIIsSharkMan
KIIsSharkMan collected $0.91 from pot
KIIsSharkMan: doesn't show hand 
*** SUMMARY ***
Total pot $0.95 | Rake $0.04 
Board [8c Td 3s]
Seat 1: Skiednis01 (button) folded before Flop (didn't bet)
Seat 2: Sve_Sve93 (small blind) folded before Flop
Seat 3: 0nix770 (big blind) folded on the Flop
Seat 4: darachr folded on the Flop
Seat 5: KIIsSharkMan collected ($0.91)
Seat 6: GrinZwe91! folded before Flop (didn't bet)



PokerStars Hand #222967054591:  Hold'em No Limit ($0.05/$0.10 USD) - 2021/01/23 14:41:41 ET
Table 'Bohlinia III' 6-max Seat #2 is the button
Seat 1: Skiednis01 ($11.02 in chips) 
Seat 2: Sve_Sve93 ($16.39 in chips) 
Seat 3: 0nix770 ($10 in chips) 
Seat 4: darachr ($9.49 in chips) 
Seat 5: KIIsSharkMan ($11.24 in chips) 
Seat 6: GrinZwe91! ($25.38 in chips) 
0nix770: posts small blind $0.05
darachr: posts big blind $0.10
*** HOLE CARDS ***
KIIsSharkMan: folds 
GrinZwe91!: folds 
Skiednis01: folds 
Sve_Sve93: folds 
0nix770: raises $0.20 to $0.30
darachr: calls $0.20
*** FLOP *** [Jc 6h 7c]
0nix770: bets $0.28
darachr: folds 
Uncalled bet ($0.28) returned to 0nix770
0nix770 collected $0.57 from pot
0nix770: doesn't show hand 
*** SUMMARY ***
Total pot $0.60 | Rake $0.03 
Board [Jc 6h 7c]
Seat 1: Skiednis01 folded before Flop (didn't bet)
Seat 2: Sve_Sve93 (button) folded before Flop (didn't bet)
Seat 3: 0nix770 (small blind) collected ($0.57)
Seat 4: darachr (big blind) folded on the Flop
Seat 5: KIIsSharkMan folded before Flop (didn't bet)
Seat 6: GrinZwe91! folded before Flop (didn't bet)



PokerStars Hand #222967082908:  Hold'em No Limit ($0.05/$0.10 USD) - 2021/01/23 14:42:17 ET
Table 'Bohlinia III' 6-max Seat #3 is the button
Seat 1: Skiednis01 ($11.02 in chips) 
Seat 2: Sve_Sve93 ($16.39 in chips) 
Seat 3: 0nix770 ($10.27 in chips) 
Seat 4: darachr ($9.19 in chips) 
Seat 5: KIIsSharkMan ($11.24 in chips) 
Seat 6: GrinZwe91! ($25.38 in chips) 
darachr: posts small blind $0.05
KIIsSharkMan: posts big blind $0.10
*** HOLE CARDS ***
GrinZwe91!: folds 
Skiednis01: folds 
Sve_Sve93: folds 
0nix770: folds 
darachr: calls $0.05
KIIsSharkMan: raises $0.30 to $0.40
darachr: folds 
Uncalled bet ($0.30) returned to KIIsSharkMan
KIIsSharkMan collected $0.20 from pot
KIIsSharkMan: doesn't show hand 
*** SUMMARY ***
Total pot $0.20 | Rake $0 
Seat 1: Skiednis01 folded before Flop (didn't bet)
Seat 2: Sve_Sve93 folded before Flop (didn't bet)
Seat 3: 0nix770 (button) folded before Flop (didn't bet)
Seat 4: darachr (small blind) folded before Flop
Seat 5: KIIsSharkMan (big blind) collected ($0.20)
Seat 6: GrinZwe91! folded before Flop (didn't bet)



PokerStars Hand #222967102151:  Hold'em No Limit ($0.05/$0.10 USD) - 2021/01/23 14:42:42 ET
Table 'Bohlinia III' 6-max Seat #4 is the button
Seat 1: Skiednis01 ($11.02 in chips) 
Seat 2: Sve_Sve93 ($16.39 in chips) 
Seat 3: 0nix770 ($10.27 in chips) 
Seat 4: darachr ($9.09 in chips) 
Seat 5: KIIsSharkMan ($11.34 in chips) 
KIIsSharkMan: posts small blind $0.05
GrinZwe91!: is sitting out 
Skiednis01: posts big blind $0.10
*** HOLE CARDS ***
GrinZwe91! leaves the table
Sve_Sve93: folds 
0nix770: folds 
darachr: folds 
darachr leaves the table
KIIsSharkMan: folds 
Uncalled bet ($0.05) returned to Skiednis01
Skiednis01 collected $0.10 from pot
Skiednis01: doesn't show hand 
*** SUMMARY ***
Total pot $0.10 | Rake $0 
Seat 1: Skiednis01 (big blind) collected ($0.10)
Seat 2: Sve_Sve93 folded before Flop (didn't bet)
Seat 3: 0nix770 folded before Flop (didn't bet)
Seat 4: darachr (button) folded before Flop (didn't bet)
Seat 5: KIIsSharkMan (small blind) folded before Flop



PokerStars Hand #222967108780:  Hold'em No Limit ($0.05/$0.10 USD) - 2021/01/23 14:42:50 ET
Table 'Bohlinia III' 6-max Seat #5 is the button
Seat 1: Skiednis01 ($11.07 in chips) 
Seat 2: Sve_Sve93 ($16.39 in chips) 
Seat 3: 0nix770 ($10.27 in chips) 
Seat 5: KIIsSharkMan ($11.29 in chips) 
Skiednis01: posts small blind $0.05
Sve_Sve93: posts big blind $0.10
*** HOLE CARDS ***
kpa1992 joins the table at seat #6 
0nix770: raises $0.15 to $0.25
KIIsSharkMan: folds 
Skiednis01: folds 
Sve_Sve93: folds 
Uncalled bet ($0.15) returned to 0nix770
0nix770 collected $0.25 from pot
0nix770: doesn't show hand 
*** SUMMARY ***
Total pot $0.25 | Rake $0 
Seat 1: Skiednis01 (small blind) folded before Flop
Seat 2: Sve_Sve93 (big blind) folded before Flop
Seat 3: 0nix770 collected ($0.25)
Seat 5: KIIsSharkMan (button) folded before Flop (didn't bet)



PokerStars Hand #222967119825:  Hold'em No Limit ($0.05/$0.10 USD) - 2021/01/23 14:43:04 ET
Table 'Bohlinia III' 6-max Seat #1 is the button
Seat 1: Skiednis01 ($11.02 in chips) 
Seat 2: Sve_Sve93 ($16.29 in chips) 
Seat 3: 0nix770 ($10.42 in chips) 
Seat 5: KIIsSharkMan ($11.29 in chips) 
Sve_Sve93: posts small blind $0.05
0nix770: posts big blind $0.10
kpa1992: sits out 
*** HOLE CARDS ***
KIIsSharkMan: folds 
Skiednis01: raises $0.15 to $0.25
Sve_Sve93: folds 
0nix770: folds 
Uncalled bet ($0.15) returned to Skiednis01
Skiednis01 collected $0.25 from pot
Skiednis01: doesn't show hand 
*** SUMMARY ***
Total pot $0.25 | Rake $0 
Seat 1: Skiednis01 (button) collected ($0.25)
Seat 2: Sve_Sve93 (small blind) folded before Flop
Seat 3: 0nix770 (big blind) folded before Flop
Seat 5: KIIsSharkMan folded before Flop (didn't bet)



PokerStars Hand #222967127274:  Hold'em No Limit ($0.05/$0.10 USD) - 2021/01/23 14:43:14 ET
Table 'Bohlinia III' 6-max Seat #2 is the button
Seat 1: Skiednis01 ($11.17 in chips) 
Seat 2: Sve_Sve93 ($16.24 in chips) 
Seat 3: 0nix770 ($10.32 in chips) 
Seat 5: KIIsSharkMan ($11.29 in chips) 
0nix770: posts small blind $0.05
KIIsSharkMan: posts big blind $0.10
kpa1992: sits out 
*** HOLE CARDS ***
Skiednis01: raises $0.15 to $0.25
Sve_Sve93: folds 
0nix770: folds 
KiraLasVegas joins the table at seat #4 
KIIsSharkMan: raises $0.75 to $1
Skiednis01: calls $0.75
*** FLOP *** [9c 6h 5h]
KIIsSharkMan: bets $1.04
Skiednis01: raises $1.96 to $3
KIIsSharkMan: folds 
Uncalled bet ($1.96) returned to Skiednis01
Skiednis01 collected $3.94 from pot
Skiednis01: doesn't show hand 
*** SUMMARY ***
Total pot $4.13 | Rake $0.19 
Board [9c 6h 5h]
Seat 1: Skiednis01 collected ($3.94)
Seat 2: Sve_Sve93 (button) folded before Flop (didn't bet)
Seat 3: 0nix770 (small blind) folded before Flop
Seat 5: KIIsSharkMan (big blind) folded on the Flop



PokerStars Hand #222967171402:  Hold'em No Limit ($0.05/$0.10 USD) - 2021/01/23 14:44:10 ET
Table 'Bohlinia III' 6-max Seat #3 is the button
Seat 1: Skiednis01 ($13.07 in chips) 
Seat 2: Sve_Sve93 ($16.24 in chips) 
Seat 3: 0nix770 ($10.27 in chips) 
Seat 5: KIIsSharkMan ($9.25 in chips) 
Seat 6: kpa1992 ($4 in chips) 
KIIsSharkMan: posts small blind $0.05
kpa1992: posts big blind $0.10
*** HOLE CARDS ***
Skiednis01: raises $0.15 to $0.25
Sve_Sve93: folds 
0nix770: folds 
KIIsSharkMan: folds 
kpa1992: folds 
Uncalled bet ($0.15) returned to Skiednis01
Skiednis01 collected $0.25 from pot
Skiednis01: doesn't show hand 
*** SUMMARY ***
Total pot $0.25 | Rake $0 
Seat 1: Skiednis01 collected ($0.25)
Seat 2: Sve_Sve93 folded before Flop (didn't bet)
Seat 3: 0nix770 (button) folded before Flop (didn't bet)
Seat 5: KIIsSharkMan (small blind) folded before Flop
Seat 6: kpa1992 (big blind) folded before Flop



PokerStars Hand #222967184055:  Hold'em No Limit ($0.05/$0.10 USD) - 2021/01/23 14:44:26 ET
Table 'Bohlinia III' 6-max Seat #5 is the button
Seat 1: Skiednis01 ($13.22 in chips) 
Seat 2: Sve_Sve93 ($16.24 in chips) 
Seat 3: 0nix770 ($10.27 in chips) 
Seat 5: KIIsSharkMan ($9.20 in chips) 
Seat 6: kpa1992 ($3.90 in chips) 
kpa1992: posts small blind $0.05
Skiednis01: posts big blind $0.10
KiraLasVegas: sits out 
*** HOLE CARDS ***
Sve_Sve93: folds 
0nix770: folds 
KIIsSharkMan: folds 
kpa1992: calls $0.05
Skiednis01: checks 
*** FLOP *** [5s 2c 5h]
kpa1992: checks 
Skiednis01: checks 
*** TURN *** [5s 2c 5h] [6c]
kpa1992: checks 
Skiednis01: checks 
*** RIVER *** [5s 2c 5h 6c] [Jc]
kpa1992: bets $0.10
Skiednis01: raises $0.39 to $0.49
kpa1992: folds 
Uncalled bet ($0.39) returned to Skiednis01
Skiednis01 collected $0.38 from pot
Skiednis01: doesn't show hand 
*** SUMMARY ***
Total pot $0.40 | Rake $0.02 
Board [5s 2c 5h 6c Jc]
Seat 1: Skiednis01 (big blind) collected ($0.38)
Seat 2: Sve_Sve93 folded before Flop (didn't bet)
Seat 3: 0nix770 folded before Flop (didn't bet)
Seat 5: KIIsSharkMan (button) folded before Flop (didn't bet)
Seat 6: kpa1992 (small blind) folded on the River



PokerStars Hand #222967211198:  Hold'em No Limit ($0.05/$0.10 USD) - 2021/01/23 14:45:01 ET
Table 'Bohlinia III' 6-max Seat #6 is the button
Seat 1: Skiednis01 ($13.40 in chips) 
Seat 2: Sve_Sve93 ($16.24 in chips) 
Seat 3: 0nix770 ($10.27 in chips) 
Seat 5: KIIsSharkMan ($9.20 in chips) 
Seat 6: kpa1992 ($3.70 in chips) 
Skiednis01: posts small blind $0.05
Sve_Sve93: posts big blind $0.10
KiraLasVegas: sits out 
*** HOLE CARDS ***
0nix770: raises $0.20 to $0.30
KIIsSharkMan: calls $0.30
kpa1992: calls $0.30
Skiednis01: folds 
Sve_Sve93: folds 
*** FLOP *** [2d 9s 5c]
0nix770: checks 
KIIsSharkMan: bets $0.66
kpa1992: folds 
0nix770: folds 
Uncalled bet ($0.66) returned to KIIsSharkMan
KIIsSharkMan collected $1 from pot
KIIsSharkMan: doesn't show hand 
*** SUMMARY ***
Total pot $1.05 | Rake $0.05 
Board [2d 9s 5c]
Seat 1: Skiednis01 (small blind) folded before Flop
Seat 2: Sve_Sve93 (big blind) folded before Flop
Seat 3: 0nix770 folded on the Flop
Seat 5: KIIsSharkMan collected ($1)
Seat 6: kpa1992 (button) folded on the Flop



PokerStars Hand #222967257728:  Hold'em No Limit ($0.05/$0.10 USD) - 2021/01/23 14:46:01 ET
Table 'Bohlinia III' 6-max Seat #1 is the button
Seat 1: Skiednis01 ($13.35 in chips) 
Seat 2: Sve_Sve93 ($16.14 in chips) 
Seat 3: 0nix770 ($10 in chips) 
Seat 5: KIIsSharkMan ($9.90 in chips) 
Seat 6: kpa1992 ($3.40 in chips) 
Sve_Sve93: posts small blind $0.05
0nix770: posts big blind $0.10
KiraLasVegas: sits out 
*** HOLE CARDS ***
KIIsSharkMan: folds 
kpa1992: raises $0.10 to $0.20
Skiednis01: folds 
Sve_Sve93: folds 
0nix770: calls $0.10
*** FLOP *** [Kh 7s Kd]
0nix770: checks 
kpa1992: checks 
*** TURN *** [Kh 7s Kd] [3d]
0nix770: checks 
kpa1992: bets $0.10
0nix770: calls $0.10
*** RIVER *** [Kh 7s Kd 3d] [Kc]
0nix770: checks 
kpa1992: bets $1
0nix770: folds 
Uncalled bet ($1) returned to kpa1992
kpa1992 collected $0.62 from pot
*** SUMMARY ***
Total pot $0.65 | Rake $0.03 
Board [Kh 7s Kd 3d Kc]
Seat 1: Skiednis01 (button) folded before Flop (didn't bet)
Seat 2: Sve_Sve93 (small blind) folded before Flop
Seat 3: 0nix770 (big blind) folded on the River
Seat 5: KIIsSharkMan folded before Flop (didn't bet)
Seat 6: kpa1992 collected ($0.62)



PokerStars Hand #222967285287:  Hold'em No Limit ($0.05/$0.10 USD) - 2021/01/23 14:46:37 ET
Table 'Bohlinia III' 6-max Seat #2 is the button
Seat 1: Skiednis01 ($13.35 in chips) 
Seat 2: Sve_Sve93 ($16.09 in chips) 
Seat 3: 0nix770 ($10 in chips) 
Seat 4: KiraLasVegas ($10 in chips) 
Seat 5: KIIsSharkMan ($9.90 in chips) 
Seat 6: kpa1992 ($3.72 in chips) 
0nix770: posts small blind $0.05
KiraLasVegas: posts big blind $0.10
*** HOLE CARDS ***
KIIsSharkMan has timed out
KIIsSharkMan: folds 
kpa1992: folds 
Skiednis01: folds 
Sve_Sve93: folds 
0nix770: raises $0.20 to $0.30
KiraLasVegas: calls $0.20
*** FLOP *** [Js 8d Qd]
0nix770: bets $0.29
KiraLasVegas: calls $0.29
*** TURN *** [Js 8d Qd] [Qh]
0nix770: checks 
KiraLasVegas: checks 
*** RIVER *** [Js 8d Qd Qh] [Ks]
0nix770: bets $0.74
KiraLasVegas: calls $0.74
*** SHOW DOWN ***
0nix770: shows [Ad Tc] (a straight, Ten to Ace)
KiraLasVegas: mucks hand 
0nix770 collected $2.54 from pot
*** SUMMARY ***
Total pot $2.66 | Rake $0.12 
Board [Js 8d Qd Qh Ks]
Seat 1: Skiednis01 folded before Flop (didn't bet)
Seat 2: Sve_Sve93 (button) folded before Flop (didn't bet)
Seat 3: 0nix770 (small blind) showed [Ad Tc] and won ($2.54) with a straight, Ten to Ace
Seat 4: KiraLasVegas (big blind) mucked
Seat 5: KIIsSharkMan folded before Flop (didn't bet)
Seat 6: kpa1992 folded before Flop (didn't bet)



PokerStars Hand #222967338127:  Hold'em No Limit ($0.05/$0.10 USD) - 2021/01/23 14:47:45 ET
Table 'Bohlinia III' 6-max Seat #3 is the button
Seat 1: Skiednis01 ($13.35 in chips) 
Seat 2: Sve_Sve93 ($16.09 in chips) 
Seat 3: 0nix770 ($11.21 in chips) 
Seat 4: KiraLasVegas ($10 in chips) 
Seat 5: KIIsSharkMan ($10 in chips) 
Seat 6: kpa1992 ($3.72 in chips) 
KiraLasVegas: posts small blind $0.05
KIIsSharkMan: posts big blind $0.10
*** HOLE CARDS ***
kpa1992: folds 
Skiednis01: raises $0.15 to $0.25
Sve_Sve93: folds 
0nix770: folds 
KiraLasVegas: folds 
KIIsSharkMan: folds 
Uncalled bet ($0.15) returned to Skiednis01
Skiednis01 collected $0.25 from pot
Skiednis01: doesn't show hand 
*** SUMMARY ***
Total pot $0.25 | Rake $0 
Seat 1: Skiednis01 collected ($0.25)
Seat 2: Sve_Sve93 folded before Flop (didn't bet)
Seat 3: 0nix770 (button) folded before Flop (didn't bet)
Seat 4: KiraLasVegas (small blind) folded before Flop
Seat 5: KIIsSharkMan (big blind) folded before Flop
Seat 6: kpa1992 folded before Flop (didn't bet)



PokerStars Hand #222967351108:  Hold'em No Limit ($0.05/$0.10 USD) - 2021/01/23 14:48:02 ET
Table 'Bohlinia III' 6-max Seat #4 is the button
Seat 1: Skiednis01 ($13.50 in chips) 
Seat 2: Sve_Sve93 ($16.09 in chips) 
Seat 3: 0nix770 ($11.21 in chips) 
Seat 4: KiraLasVegas ($10 in chips) 
Seat 5: KIIsSharkMan ($9.90 in chips) 
Seat 6: kpa1992 ($3.72 in chips) 
KIIsSharkMan: posts small blind $0.05
kpa1992: posts big blind $0.10
*** HOLE CARDS ***
Skiednis01: raises $0.15 to $0.25
Sve_Sve93: folds 
0nix770: folds 
KiraLasVegas: folds 
KIIsSharkMan: calls $0.20
kpa1992: calls $0.15
*** FLOP *** [Kc Jh 6h]
KIIsSharkMan: checks 
kpa1992: checks 
Skiednis01: checks 
*** TURN *** [Kc Jh 6h] [2d]
KIIsSharkMan: bets $0.48
kpa1992: folds 
Skiednis01: folds 
Uncalled bet ($0.48) returned to KIIsSharkMan
KIIsSharkMan collected $0.72 from pot
KIIsSharkMan: doesn't show hand 
*** SUMMARY ***
Total pot $0.75 | Rake $0.03 
Board [Kc Jh 6h 2d]
Seat 1: Skiednis01 folded on the Turn
Seat 2: Sve_Sve93 folded before Flop (didn't bet)
Seat 3: 0nix770 folded before Flop (didn't bet)
Seat 4: KiraLasVegas (button) folded before Flop (didn't bet)
Seat 5: KIIsSharkMan (small blind) collected ($0.72)
Seat 6: kpa1992 (big blind) folded on the Turn



PokerStars Hand #222967382331:  Hold'em No Limit ($0.05/$0.10 USD) - 2021/01/23 14:48:42 ET
Table 'Bohlinia III' 6-max Seat #5 is the button
Seat 1: Skiednis01 ($13.25 in chips) 
Seat 2: Sve_Sve93 ($16.09 in chips) 
Seat 3: 0nix770 ($11.21 in chips) 
Seat 4: KiraLasVegas ($10 in chips) 
Seat 5: KIIsSharkMan ($10.37 in chips) 
Seat 6: kpa1992 ($3.47 in chips) 
kpa1992: posts small blind $0.05
Skiednis01: posts big blind $0.10
*** HOLE CARDS ***
Sve_Sve93: folds 
0nix770: folds 
KiraLasVegas: folds 
KIIsSharkMan: folds 
kpa1992: calls $0.05
Skiednis01: checks 
*** FLOP *** [8c Tc Jc]
kpa1992: bets $0.20
Skiednis01: folds 
Uncalled bet ($0.20) returned to kpa1992
kpa1992 collected $0.19 from pot
*** SUMMARY ***
Total pot $0.20 | Rake $0.01 
Board [8c Tc Jc]
Seat 1: Skiednis01 (big blind) folded on the Flop
Seat 2: Sve_Sve93 folded before Flop (didn't bet)
Seat 3: 0nix770 folded before Flop (didn't bet)
Seat 4: KiraLasVegas folded before Flop (didn't bet)
Seat 5: KIIsSharkMan (button) folded before Flop (didn't bet)
Seat 6: kpa1992 (small blind) collected ($0.19)



PokerStars Hand #222967404699:  Hold'em No Limit ($0.05/$0.10 USD) - 2021/01/23 14:49:11 ET
Table 'Bohlinia III' 6-max Seat #6 is the button
Seat 1: Skiednis01 ($13.15 in chips) 
Seat 2: Sve_Sve93 ($16.09 in chips) 
Seat 3: 0nix770 ($11.21 in chips) 
Seat 4: KiraLasVegas ($10 in chips) 
Seat 5: KIIsSharkMan ($10.37 in chips) 
Seat 6: kpa1992 ($3.56 in chips) 
Skiednis01: posts small blind $0.05
Sve_Sve93: posts big blind $0.10
*** HOLE CARDS ***
0nix770: folds 
KiraLasVegas: raises $0.20 to $0.30
KIIsSharkMan: folds 
kpa1992: folds 
Skiednis01: raises $0.50 to $0.80
Sve_Sve93: folds 
KiraLasVegas: folds 
Uncalled bet ($0.50) returned to Skiednis01
Skiednis01 collected $0.70 from pot
Skiednis01: doesn't show hand 
*** SUMMARY ***
Total pot $0.70 | Rake $0 
Seat 1: Skiednis01 (small blind) collected ($0.70)
Seat 2: Sve_Sve93 (big blind) folded before Flop
Seat 3: 0nix770 folded before Flop (didn't bet)
Seat 4: KiraLasVegas folded before Flop
Seat 5: KIIsSharkMan folded before Flop (didn't bet)
Seat 6: kpa1992 (button) folded before Flop (didn't bet)



PokerStars Hand #222967426344:  Hold'em No Limit ($0.05/$0.10 USD) - 2021/01/23 14:49:39 ET
Table 'Bohlinia III' 6-max Seat #1 is the button
Seat 1: Skiednis01 ($13.55 in chips) 
Seat 2: Sve_Sve93 ($15.99 in chips) 
Seat 3: 0nix770 ($11.21 in chips) 
Seat 4: KiraLasVegas ($10 in chips) 
Seat 5: KIIsSharkMan ($10.37 in chips) 
Seat 6: kpa1992 ($3.56 in chips) 
Sve_Sve93: posts small blind $0.05
0nix770: posts big blind $0.10
*** HOLE CARDS ***
KiraLasVegas: folds 
KIIsSharkMan: folds 
kpa1992: folds 
Skiednis01: folds 
Sve_Sve93: folds 
Uncalled bet ($0.05) returned to 0nix770
0nix770 collected $0.10 from pot
0nix770: doesn't show hand 
KiraLasVegas leaves the table
*** SUMMARY ***
Total pot $0.10 | Rake $0 
Seat 1: Skiednis01 (button) folded before Flop (didn't bet)
Seat 2: Sve_Sve93 (small blind) folded before Flop
Seat 3: 0nix770 (big blind) collected ($0.10)
Seat 4: KiraLasVegas folded before Flop (didn't bet)
Seat 5: KIIsSharkMan folded before Flop (didn't bet)
Seat 6: kpa1992 folded before Flop (didn't bet)



PokerStars Hand #222967434405:  Hold'em No Limit ($0.05/$0.10 USD) - 2021/01/23 14:49:49 ET
Table 'Bohlinia III' 6-max Seat #2 is the button
Seat 1: Skiednis01 ($13.55 in chips) 
Seat 2: Sve_Sve93 ($15.94 in chips) 
Seat 3: 0nix770 ($11.26 in chips) 
Seat 5: KIIsSharkMan ($10.37 in chips) 
Seat 6: kpa1992 ($3.56 in chips) 
0nix770: posts small blind $0.05
KIIsSharkMan: posts big blind $0.10
*** HOLE CARDS ***
robotov joins the table at seat #4 
kpa1992: folds 
Skiednis01: folds 
Sve_Sve93: raises $0.20 to $0.30
0nix770: folds 
KIIsSharkMan: folds 
Uncalled bet ($0.20) returned to Sve_Sve93
Sve_Sve93 collected $0.25 from pot
Sve_Sve93: doesn't show hand 
*** SUMMARY ***
Total pot $0.25 | Rake $0 
Seat 1: Skiednis01 folded before Flop (didn't bet)
Seat 2: Sve_Sve93 (button) collected ($0.25)
Seat 3: 0nix770 (small blind) folded before Flop
Seat 5: KIIsSharkMan (big blind) folded before Flop
Seat 6: kpa1992 folded before Flop (didn't bet)



PokerStars Hand #222967443412:  Hold'em No Limit ($0.05/$0.10 USD) - 2021/01/23 14:50:01 ET
Table 'Bohlinia III' 6-max Seat #3 is the button
Seat 1: Skiednis01 ($13.55 in chips) 
Seat 2: Sve_Sve93 ($16.09 in chips) 
Seat 3: 0nix770 ($11.21 in chips) 
Seat 5: KIIsSharkMan ($10.27 in chips) 
Seat 6: kpa1992 ($3.56 in chips) 
KIIsSharkMan: posts small blind $0.05
kpa1992: posts big blind $0.10
*** HOLE CARDS ***
Skiednis01: folds 
Sve_Sve93: raises $0.20 to $0.30
0nix770: folds 
KIIsSharkMan: folds 
kpa1992: folds 
Uncalled bet ($0.20) returned to Sve_Sve93
Sve_Sve93 collected $0.25 from pot
Sve_Sve93: doesn't show hand 
*** SUMMARY ***
Total pot $0.25 | Rake $0 
Seat 1: Skiednis01 folded before Flop (didn't bet)
Seat 2: Sve_Sve93 collected ($0.25)
Seat 3: 0nix770 (button) folded before Flop (didn't bet)
Seat 5: KIIsSharkMan (small blind) folded before Flop
Seat 6: kpa1992 (big blind) folded before Flop



PokerStars Hand #222967454961:  Hold'em No Limit ($0.05/$0.10 USD) - 2021/01/23 14:50:16 ET
Table 'Bohlinia III' 6-max Seat #5 is the button
Seat 1: Skiednis01 ($13.55 in chips) 
Seat 2: Sve_Sve93 ($16.24 in chips) 
Seat 3: 0nix770 ($11.21 in chips) 
Seat 5: KIIsSharkMan ($10.22 in chips) 
Seat 6: kpa1992 ($3.46 in chips) 
kpa1992: posts small blind $0.05
Skiednis01: posts big blind $0.10
robotov: sits out 
*** HOLE CARDS ***
Sve_Sve93: folds 
0nix770: folds 
KIIsSharkMan: folds 
kpa1992: folds 
Uncalled bet ($0.05) returned to Skiednis01
Skiednis01 collected $0.10 from pot
Skiednis01: doesn't show hand 
*** SUMMARY ***
Total pot $0.10 | Rake $0 
Seat 1: Skiednis01 (big blind) collected ($0.10)
Seat 2: Sve_Sve93 folded before Flop (didn't bet)
Seat 3: 0nix770 folded before Flop (didn't bet)
Seat 5: KIIsSharkMan (button) folded before Flop (didn't bet)
Seat 6: kpa1992 (small blind) folded before Flop



PokerStars Hand #222967465068:  Hold'em No Limit ($0.05/$0.10 USD) - 2021/01/23 14:50:29 ET
Table 'Bohlinia III' 6-max Seat #6 is the button
Seat 1: Skiednis01 ($13.60 in chips) 
Seat 2: Sve_Sve93 ($16.24 in chips) 
Seat 3: 0nix770 ($11.21 in chips) 
Seat 5: KIIsSharkMan ($10.22 in chips) 
Seat 6: kpa1992 ($3.41 in chips) 
Skiednis01: posts small blind $0.05
Sve_Sve93: posts big blind $0.10
robotov: sits out 
*** HOLE CARDS ***
0nix770: raises $0.20 to $0.30
KIIsSharkMan: folds 
kpa1992: folds 
Skiednis01: folds 
Sve_Sve93: folds 
Uncalled bet ($0.20) returned to 0nix770
0nix770 collected $0.25 from pot
0nix770: doesn't show hand 
*** SUMMARY ***
Total pot $0.25 | Rake $0 
Seat 1: Skiednis01 (small blind) folded before Flop
Seat 2: Sve_Sve93 (big blind) folded before Flop
Seat 3: 0nix770 collected ($0.25)
Seat 5: KIIsSharkMan folded before Flop (didn't bet)
Seat 6: kpa1992 (button) folded before Flop (didn't bet)



PokerStars Hand #222967473025:  Hold'em No Limit ($0.05/$0.10 USD) - 2021/01/23 14:50:39 ET
Table 'Bohlinia III' 6-max Seat #1 is the button
Seat 1: Skiednis01 ($13.55 in chips) 
Seat 2: Sve_Sve93 ($16.14 in chips) 
Seat 3: 0nix770 ($11.36 in chips) 
Seat 5: KIIsSharkMan ($10.22 in chips) 
Seat 6: kpa1992 ($3.41 in chips) 
Sve_Sve93: posts small blind $0.05
0nix770: posts big blind $0.10
robotov: sits out 
*** HOLE CARDS ***
KIIsSharkMan: folds 
kpa1992: folds 
Skiednis01: raises $0.15 to $0.25
Sve_Sve93: folds 
0nix770: raises $0.75 to $1
Skiednis01: folds 
Uncalled bet ($0.75) returned to 0nix770
0nix770 collected $0.55 from pot
0nix770: doesn't show hand 
*** SUMMARY ***
Total pot $0.55 | Rake $0 
Seat 1: Skiednis01 (button) folded before Flop
Seat 2: Sve_Sve93 (small blind) folded before Flop
Seat 3: 0nix770 (big blind) collected ($0.55)
Seat 5: KIIsSharkMan folded before Flop (didn't bet)
Seat 6: kpa1992 folded before Flop (didn't bet)



PokerStars Hand #222967494140:  Hold'em No Limit ($0.05/$0.10 USD) - 2021/01/23 14:51:07 ET
Table 'Bohlinia III' 6-max Seat #2 is the button
Seat 1: Skiednis01 ($13.30 in chips) 
Seat 2: Sve_Sve93 ($16.09 in chips) 
Seat 3: 0nix770 ($11.66 in chips) 
Seat 4: robotov ($10 in chips) 
Seat 5: KIIsSharkMan ($10.22 in chips) 
Seat 6: kpa1992 ($3.41 in chips) 
0nix770: posts small blind $0.05
robotov: posts big blind $0.10
*** HOLE CARDS ***
KIIsSharkMan: folds 
kpa1992: folds 
Skiednis01: raises $0.15 to $0.25
Sve_Sve93: folds 
0nix770: folds 
robotov: raises $0.55 to $0.80
Skiednis01: folds 
Uncalled bet ($0.55) returned to robotov
robotov collected $0.55 from pot
robotov: doesn't show hand 
*** SUMMARY ***
Total pot $0.55 | Rake $0 
Seat 1: Skiednis01 folded before Flop
Seat 2: Sve_Sve93 (button) folded before Flop (didn't bet)
Seat 3: 0nix770 (small blind) folded before Flop
Seat 4: robotov (big blind) collected ($0.55)
Seat 5: KIIsSharkMan folded before Flop (didn't bet)
Seat 6: kpa1992 folded before Flop (didn't bet)



PokerStars Hand #222967513651:  Hold'em No Limit ($0.05/$0.10 USD) - 2021/01/23 14:51:32 ET
Table 'Bohlinia III' 6-max Seat #3 is the button
Seat 1: Skiednis01 ($13.05 in chips) 
Seat 2: Sve_Sve93 ($16.09 in chips) 
Seat 3: 0nix770 ($11.61 in chips) 
Seat 4: robotov ($10.30 in chips) 
Seat 5: KIIsSharkMan ($10.22 in chips) 
Seat 6: kpa1992 ($3.41 in chips) 
robotov: posts small blind $0.05
KIIsSharkMan: posts big blind $0.10
*** HOLE CARDS ***
kpa1992: folds 
Skiednis01: folds 
Sve_Sve93: raises $0.20 to $0.30
0nix770: folds 
robotov: folds 
KIIsSharkMan: calls $0.20
*** FLOP *** [5s 8d Td]
KIIsSharkMan: checks 
Sve_Sve93: bets $0.31
KIIsSharkMan: calls $0.31
*** TURN *** [5s 8d Td] [As]
KIIsSharkMan: checks 
Sve_Sve93: bets $0.61
KIIsSharkMan: raises $1.29 to $1.90
Sve_Sve93: folds 
Uncalled bet ($1.29) returned to KIIsSharkMan
KIIsSharkMan collected $2.38 from pot
KIIsSharkMan: doesn't show hand 
*** SUMMARY ***
Total pot $2.49 | Rake $0.11 
Board [5s 8d Td As]
Seat 1: Skiednis01 folded before Flop (didn't bet)
Seat 2: Sve_Sve93 folded on the Turn
Seat 3: 0nix770 (button) folded before Flop (didn't bet)
Seat 4: robotov (small blind) folded before Flop
Seat 5: KIIsSharkMan (big blind) collected ($2.38)
Seat 6: kpa1992 folded before Flop (didn't bet)



PokerStars Hand #222967554718:  Hold'em No Limit ($0.05/$0.10 USD) - 2021/01/23 14:52:25 ET
Table 'Bohlinia III' 6-max Seat #4 is the button
Seat 1: Skiednis01 ($13.05 in chips) 
Seat 2: Sve_Sve93 ($14.87 in chips) 
Seat 3: 0nix770 ($11.61 in chips) 
Seat 4: robotov ($10.25 in chips) 
Seat 5: KIIsSharkMan ($11.38 in chips) 
Seat 6: kpa1992 ($3.41 in chips) 
KIIsSharkMan: posts small blind $0.05
kpa1992: posts big blind $0.10
*** HOLE CARDS ***
Skiednis01: folds 
Sve_Sve93: folds 
0nix770: folds 
robotov: raises $0.15 to $0.25
KIIsSharkMan: folds 
kpa1992: folds 
Uncalled bet ($0.15) returned to robotov
robotov collected $0.25 from pot
robotov: doesn't show hand 
*** SUMMARY ***
Total pot $0.25 | Rake $0 
Seat 1: Skiednis01 folded before Flop (didn't bet)
Seat 2: Sve_Sve93 folded before Flop (didn't bet)
Seat 3: 0nix770 folded before Flop (didn't bet)
Seat 4: robotov (button) collected ($0.25)
Seat 5: KIIsSharkMan (small blind) folded before Flop
Seat 6: kpa1992 (big blind) folded before Flop



PokerStars Hand #222967562193:  Hold'em No Limit ($0.05/$0.10 USD) - 2021/01/23 14:52:35 ET
Table 'Bohlinia III' 6-max Seat #5 is the button
Seat 1: Skiednis01 ($13.05 in chips) 
Seat 2: Sve_Sve93 ($14.87 in chips) 
Seat 3: 0nix770 ($11.61 in chips) 
Seat 4: robotov ($10.40 in chips) 
Seat 5: KIIsSharkMan ($11.33 in chips) 
Seat 6: kpa1992 ($3.31 in chips) 
kpa1992: posts small blind $0.05
Skiednis01: posts big blind $0.10
*** HOLE CARDS ***
Sve_Sve93: folds 
0nix770: folds 
robotov: folds 
KIIsSharkMan: raises $0.20 to $0.30
kpa1992: calls $0.25
Skiednis01: calls $0.20
*** FLOP *** [6s 8h 2s]
kpa1992: checks 
Skiednis01: checks 
KIIsSharkMan: checks 
*** TURN *** [6s 8h 2s] [3c]
kpa1992: checks 
Skiednis01: checks 
KIIsSharkMan: bets $0.28
kpa1992: folds 
Skiednis01: folds 
Uncalled bet ($0.28) returned to KIIsSharkMan
KIIsSharkMan collected $0.86 from pot
KIIsSharkMan: doesn't show hand 
*** SUMMARY ***
Total pot $0.90 | Rake $0.04 
Board [6s 8h 2s 3c]
Seat 1: Skiednis01 (big blind) folded on the Turn
Seat 2: Sve_Sve93 folded before Flop (didn't bet)
Seat 3: 0nix770 folded before Flop (didn't bet)
Seat 4: robotov folded before Flop (didn't bet)
Seat 5: KIIsSharkMan (button) collected ($0.86)
Seat 6: kpa1992 (small blind) folded on the Turn



PokerStars Hand #222967611563:  Hold'em No Limit ($0.05/$0.10 USD) - 2021/01/23 14:53:39 ET
Table 'Bohlinia III' 6-max Seat #6 is the button
Seat 1: Skiednis01 ($12.75 in chips) 
Seat 2: Sve_Sve93 ($14.87 in chips) 
Seat 3: 0nix770 ($11.61 in chips) 
Seat 4: robotov ($10.40 in chips) 
Seat 5: KIIsSharkMan ($11.89 in chips) 
Seat 6: kpa1992 ($3.01 in chips) 
Skiednis01: posts small blind $0.05
Sve_Sve93: posts big blind $0.10
*** HOLE CARDS ***
0nix770: raises $0.20 to $0.30
robotov: folds 
KIIsSharkMan: folds 
kpa1992: folds 
Skiednis01: folds 
Sve_Sve93: folds 
Uncalled bet ($0.20) returned to 0nix770
0nix770 collected $0.25 from pot
0nix770: doesn't show hand 
*** SUMMARY ***
Total pot $0.25 | Rake $0 
Seat 1: Skiednis01 (small blind) folded before Flop
Seat 2: Sve_Sve93 (big blind) folded before Flop
Seat 3: 0nix770 collected ($0.25)
Seat 4: robotov folded before Flop (didn't bet)
Seat 5: KIIsSharkMan folded before Flop (didn't bet)
Seat 6: kpa1992 (button) folded before Flop (didn't bet)



PokerStars Hand #222967624316:  Hold'em No Limit ($0.05/$0.10 USD) - 2021/01/23 14:53:48 ET
Table 'Bohlinia III' 6-max Seat #1 is the button
Seat 1: Skiednis01 ($12.70 in chips) 
Seat 2: Sve_Sve93 ($14.77 in chips) 
Seat 3: 0nix770 ($11.76 in chips) 
Seat 4: robotov ($10.40 in chips) 
Seat 5: KIIsSharkMan ($11.89 in chips) 
Seat 6: kpa1992 ($3.01 in chips) 
Sve_Sve93: posts small blind $0.05
0nix770: posts big blind $0.10
*** HOLE CARDS ***
robotov: folds 
KIIsSharkMan: folds 
kpa1992: raises $0.10 to $0.20
Skiednis01: calls $0.20
Sve_Sve93: folds 
0nix770: calls $0.10
*** FLOP *** [As 8s 7s]
0nix770: checks 
kpa1992: bets $0.20
Skiednis01: folds 
0nix770: folds 
Uncalled bet ($0.20) returned to kpa1992
kpa1992 collected $0.62 from pot
*** SUMMARY ***
Total pot $0.65 | Rake $0.03 
Board [As 8s 7s]
Seat 1: Skiednis01 (button) folded on the Flop
Seat 2: Sve_Sve93 (small blind) folded before Flop
Seat 3: 0nix770 (big blind) folded on the Flop
Seat 4: robotov folded before Flop (didn't bet)
Seat 5: KIIsSharkMan folded before Flop (didn't bet)
Seat 6: kpa1992 collected ($0.62)



PokerStars Hand #222967660541:  Hold'em No Limit ($0.05/$0.10 USD) - 2021/01/23 14:54:35 ET
Table 'Bohlinia III' 6-max Seat #2 is the button
Seat 1: Skiednis01 ($12.50 in chips) 
Seat 2: Sve_Sve93 ($14.72 in chips) 
Seat 3: 0nix770 ($11.56 in chips) 
Seat 4: robotov ($10.40 in chips) 
Seat 5: KIIsSharkMan ($11.89 in chips) 
Seat 6: kpa1992 ($3.43 in chips) 
0nix770: posts small blind $0.05
robotov: posts big blind $0.10
*** HOLE CARDS ***
KIIsSharkMan: raises $0.15 to $0.25
kpa1992: folds 
Skiednis01: folds 
Sve_Sve93: folds 
0nix770: folds 
robotov: folds 
Uncalled bet ($0.15) returned to KIIsSharkMan
KIIsSharkMan collected $0.25 from pot
KIIsSharkMan: doesn't show hand 
*** SUMMARY ***
Total pot $0.25 | Rake $0 
Seat 1: Skiednis01 folded before Flop (didn't bet)
Seat 2: Sve_Sve93 (button) folded before Flop (didn't bet)
Seat 3: 0nix770 (small blind) folded before Flop
Seat 4: robotov (big blind) folded before Flop
Seat 5: KIIsSharkMan collected ($0.25)
Seat 6: kpa1992 folded before Flop (didn't bet)



PokerStars Hand #222967676432:  Hold'em No Limit ($0.05/$0.10 USD) - 2021/01/23 14:54:56 ET
Table 'Bohlinia III' 6-max Seat #3 is the button
Seat 1: Skiednis01 ($12.50 in chips) 
Seat 2: Sve_Sve93 ($14.72 in chips) 
Seat 3: 0nix770 ($11.51 in chips) 
Seat 4: robotov ($10.30 in chips) 
Seat 5: KIIsSharkMan ($12.04 in chips) 
Seat 6: kpa1992 ($3.43 in chips) 
robotov: posts small blind $0.05
KIIsSharkMan: posts big blind $0.10
*** HOLE CARDS ***
kpa1992: folds 
Skiednis01: folds 
Sve_Sve93: raises $0.20 to $0.30
0nix770: folds 
robotov: folds 
KIIsSharkMan: folds 
Uncalled bet ($0.20) returned to Sve_Sve93
Sve_Sve93 collected $0.25 from pot
Sve_Sve93: doesn't show hand 
*** SUMMARY ***
Total pot $0.25 | Rake $0 
Seat 1: Skiednis01 folded before Flop (didn't bet)
Seat 2: Sve_Sve93 collected ($0.25)
Seat 3: 0nix770 (button) folded before Flop (didn't bet)
Seat 4: robotov (small blind) folded before Flop
Seat 5: KIIsSharkMan (big blind) folded before Flop
Seat 6: kpa1992 folded before Flop (didn't bet)



PokerStars Hand #222967691618:  Hold'em No Limit ($0.05/$0.10 USD) - 2021/01/23 14:55:18 ET
Table 'Bohlinia III' 6-max Seat #4 is the button
Seat 1: Skiednis01 ($12.50 in chips) 
Seat 2: Sve_Sve93 ($14.87 in chips) 
Seat 3: 0nix770 ($11.51 in chips) 
Seat 4: robotov ($10.25 in chips) 
Seat 5: KIIsSharkMan ($11.94 in chips) 
Seat 6: kpa1992 ($3.43 in chips) 
KIIsSharkMan: posts small blind $0.05
kpa1992: posts big blind $0.10
*** HOLE CARDS ***
Skiednis01: folds 
Sve_Sve93: folds 
0nix770: folds 
robotov: folds 
KIIsSharkMan: folds 
Uncalled bet ($0.05) returned to kpa1992
kpa1992 collected $0.10 from pot
*** SUMMARY ***
Total pot $0.10 | Rake $0 
Seat 1: Skiednis01 folded before Flop (didn't bet)
Seat 2: Sve_Sve93 folded before Flop (didn't bet)
Seat 3: 0nix770 folded before Flop (didn't bet)
Seat 4: robotov (button) folded before Flop (didn't bet)
Seat 5: KIIsSharkMan (small blind) folded before Flop
Seat 6: kpa1992 (big blind) collected ($0.10)



PokerStars Hand #222967695933:  Hold'em No Limit ($0.05/$0.10 USD) - 2021/01/23 14:55:27 ET
Table 'Bohlinia III' 6-max Seat #5 is the button
Seat 1: Skiednis01 ($12.50 in chips) 
Seat 2: Sve_Sve93 ($14.87 in chips) 
Seat 3: 0nix770 ($11.51 in chips) 
Seat 4: robotov ($10.25 in chips) 
Seat 5: KIIsSharkMan ($11.89 in chips) 
Seat 6: kpa1992 ($3.48 in chips) 
kpa1992: posts small blind $0.05
Skiednis01: posts big blind $0.10
*** HOLE CARDS ***
Sve_Sve93: folds 
0nix770: folds 
robotov: folds 
KIIsSharkMan: folds 
kpa1992: folds 
Uncalled bet ($0.05) returned to Skiednis01
Skiednis01 collected $0.10 from pot
Skiednis01: doesn't show hand 
*** SUMMARY ***
Total pot $0.10 | Rake $0 
Seat 1: Skiednis01 (big blind) collected ($0.10)
Seat 2: Sve_Sve93 folded before Flop (didn't bet)
Seat 3: 0nix770 folded before Flop (didn't bet)
Seat 4: robotov folded before Flop (didn't bet)
Seat 5: KIIsSharkMan (button) folded before Flop (didn't bet)
Seat 6: kpa1992 (small blind) folded before Flop



PokerStars Hand #222967699789:  Hold'em No Limit ($0.05/$0.10 USD) - 2021/01/23 14:55:34 ET
Table 'Bohlinia III' 6-max Seat #6 is the button
Seat 1: Skiednis01 ($12.55 in chips) 
Seat 2: Sve_Sve93 ($14.87 in chips) 
Seat 3: 0nix770 ($11.51 in chips) 
Seat 4: robotov ($10.25 in chips) 
Seat 5: KIIsSharkMan ($11.89 in chips) 
Seat 6: kpa1992 ($3.43 in chips) 
Skiednis01: posts small blind $0.05
Sve_Sve93: posts big blind $0.10
*** HOLE CARDS ***
0nix770: folds 
robotov: raises $0.20 to $0.30
KIIsSharkMan: folds 
kpa1992: calls $0.30
Skiednis01: folds 
Sve_Sve93: folds 
*** FLOP *** [Ac 5d Ks]
robotov: checks 
kpa1992: bets $0.20
robotov: folds 
Uncalled bet ($0.20) returned to kpa1992
kpa1992 collected $0.72 from pot
*** SUMMARY ***
Total pot $0.75 | Rake $0.03 
Board [Ac 5d Ks]
Seat 1: Skiednis01 (small blind) folded before Flop
Seat 2: Sve_Sve93 (big blind) folded before Flop
Seat 3: 0nix770 folded before Flop (didn't bet)
Seat 4: robotov folded on the Flop
Seat 5: KIIsSharkMan folded before Flop (didn't bet)
Seat 6: kpa1992 (button) collected ($0.72)



PokerStars Hand #222967713842:  Hold'em No Limit ($0.05/$0.10 USD) - 2021/01/23 14:56:00 ET
Table 'Bohlinia III' 6-max Seat #1 is the button
Seat 1: Skiednis01 ($12.50 in chips) 
Seat 2: Sve_Sve93 ($14.77 in chips) 
Seat 3: 0nix770 ($11.51 in chips) 
Seat 4: robotov ($10 in chips) 
Seat 5: KIIsSharkMan ($11.89 in chips) 
Seat 6: kpa1992 ($3.85 in chips) 
Sve_Sve93: posts small blind $0.05
0nix770: posts big blind $0.10
*** HOLE CARDS ***
robotov: folds 
KIIsSharkMan: folds 
kpa1992: folds 
Skiednis01: raises $0.15 to $0.25
Sve_Sve93: folds 
0nix770: calls $0.15
*** FLOP *** [4h 9s Tc]
0nix770: checks 
Skiednis01: bets $0.27
0nix770: folds 
Uncalled bet ($0.27) returned to Skiednis01
Skiednis01 collected $0.53 from pot
Skiednis01: doesn't show hand 
*** SUMMARY ***
Total pot $0.55 | Rake $0.02 
Board [4h 9s Tc]
Seat 1: Skiednis01 (button) collected ($0.53)
Seat 2: Sve_Sve93 (small blind) folded before Flop
Seat 3: 0nix770 (big blind) folded on the Flop
Seat 4: robotov folded before Flop (didn't bet)
Seat 5: KIIsSharkMan folded before Flop (didn't bet)
Seat 6: kpa1992 folded before Flop (didn't bet)



PokerStars Hand #222967731602:  Hold'em No Limit ($0.05/$0.10 USD) - 2021/01/23 14:56:34 ET
Table 'Bohlinia III' 6-max Seat #2 is the button
Seat 1: Skiednis01 ($12.78 in chips) 
Seat 2: Sve_Sve93 ($14.72 in chips) 
Seat 3: 0nix770 ($11.26 in chips) 
Seat 4: robotov ($10 in chips) 
Seat 5: KIIsSharkMan ($11.89 in chips) 
Seat 6: kpa1992 ($3.85 in chips) 
0nix770: posts small blind $0.05
robotov: posts big blind $0.10
*** HOLE CARDS ***
KIIsSharkMan: folds 
kpa1992: folds 
Skiednis01: folds 
Sve_Sve93: folds 
0nix770: raises $0.20 to $0.30
robotov: calls $0.20
*** FLOP *** [5s Jd 7h]
0nix770: bets $0.23
robotov: folds 
Uncalled bet ($0.23) returned to 0nix770
0nix770 collected $0.57 from pot
0nix770: doesn't show hand 
*** SUMMARY ***
Total pot $0.60 | Rake $0.03 
Board [5s Jd 7h]
Seat 1: Skiednis01 folded before Flop (didn't bet)
Seat 2: Sve_Sve93 (button) folded before Flop (didn't bet)
Seat 3: 0nix770 (small blind) collected ($0.57)
Seat 4: robotov (big blind) folded on the Flop
Seat 5: KIIsSharkMan folded before Flop (didn't bet)
Seat 6: kpa1992 folded before Flop (didn't bet)



PokerStars Hand #222967757031:  Hold'em No Limit ($0.05/$0.10 USD) - 2021/01/23 14:57:21 ET
Table 'Bohlinia III' 6-max Seat #3 is the button
Seat 1: Skiednis01 ($12.78 in chips) 
Seat 2: Sve_Sve93 ($14.72 in chips) 
Seat 3: 0nix770 ($11.53 in chips) 
Seat 4: robotov ($10 in chips) 
Seat 5: KIIsSharkMan ($11.89 in chips) 
Seat 6: kpa1992 ($3.85 in chips) 
robotov: posts small blind $0.05
KIIsSharkMan: posts big blind $0.10
*** HOLE CARDS ***
kpa1992: folds 
Skiednis01: folds 
Sve_Sve93: folds 
0nix770: folds 
robotov: folds 
Uncalled bet ($0.05) returned to KIIsSharkMan
KIIsSharkMan collected $0.10 from pot
KIIsSharkMan: doesn't show hand 
*** SUMMARY ***
Total pot $0.10 | Rake $0 
Seat 1: Skiednis01 folded before Flop (didn't bet)
Seat 2: Sve_Sve93 folded before Flop (didn't bet)
Seat 3: 0nix770 (button) folded before Flop (didn't bet)
Seat 4: robotov (small blind) folded before Flop
Seat 5: KIIsSharkMan (big blind) collected ($0.10)
Seat 6: kpa1992 folded before Flop (didn't bet)



PokerStars Hand #222967762297:  Hold'em No Limit ($0.05/$0.10 USD) - 2021/01/23 14:57:31 ET
Table 'Bohlinia III' 6-max Seat #4 is the button
Seat 1: Skiednis01 ($12.78 in chips) 
Seat 2: Sve_Sve93 ($14.72 in chips) 
Seat 3: 0nix770 ($11.53 in chips) 
Seat 4: robotov ($10 in chips) 
Seat 5: KIIsSharkMan ($11.94 in chips) 
Seat 6: kpa1992 ($3.85 in chips) 
KIIsSharkMan: posts small blind $0.05
kpa1992: posts big blind $0.10
*** HOLE CARDS ***
Skiednis01: folds 
Sve_Sve93: folds 
0nix770: folds 
robotov: folds 
KIIsSharkMan: raises $0.20 to $0.30
kpa1992: calls $0.20
*** FLOP *** [Td 5d 8h]
KIIsSharkMan: checks 
kpa1992: checks 
*** TURN *** [Td 5d 8h] [Jd]
KIIsSharkMan: checks 
kpa1992: bets $0.20
KIIsSharkMan: calls $0.20
*** RIVER *** [Td 5d 8h Jd] [4s]
KIIsSharkMan: checks 
kpa1992: bets $0.50
KIIsSharkMan: calls $0.50
*** SHOW DOWN ***
kpa1992: shows [2d Ad] (a flush, Ace high)
KIIsSharkMan: mucks hand 
kpa1992 collected $1.91 from pot
*** SUMMARY ***
Total pot $2 | Rake $0.09 
Board [Td 5d 8h Jd 4s]
Seat 1: Skiednis01 folded before Flop (didn't bet)
Seat 2: Sve_Sve93 folded before Flop (didn't bet)
Seat 3: 0nix770 folded before Flop (didn't bet)
Seat 4: robotov (button) folded before Flop (didn't bet)
Seat 5: KIIsSharkMan (small blind) mucked
Seat 6: kpa1992 (big blind) showed [2d Ad] and won ($1.91) with a flush, Ace high



PokerStars Hand #222967799058:  Hold'em No Limit ($0.05/$0.10 USD) - 2021/01/23 14:58:40 ET
Table 'Bohlinia III' 6-max Seat #5 is the button
Seat 1: Skiednis01 ($12.78 in chips) 
Seat 2: Sve_Sve93 ($14.72 in chips) 
Seat 3: 0nix770 ($11.53 in chips) 
Seat 4: robotov ($10 in chips) 
Seat 5: KIIsSharkMan ($10.94 in chips) 
Seat 6: kpa1992 ($4.76 in chips) 
kpa1992: posts small blind $0.05
Skiednis01: posts big blind $0.10
*** HOLE CARDS ***
Sve_Sve93: folds 
0nix770: folds 
robotov: folds 
KIIsSharkMan: raises $0.20 to $0.30
kpa1992: folds 
Skiednis01: calls $0.20
*** FLOP *** [Tc 4c Td]
Skiednis01: checks 
KIIsSharkMan: checks 
*** TURN *** [Tc 4c Td] [6s]
Skiednis01: checks 
KIIsSharkMan: bets $0.41
Skiednis01: calls $0.41
*** RIVER *** [Tc 4c Td 6s] [8s]
Skiednis01: checks 
KIIsSharkMan: checks 
*** SHOW DOWN ***
Skiednis01: shows [3d 3c] (two pair, Tens and Threes)
KIIsSharkMan: mucks hand 
Skiednis01 collected $1.40 from pot
*** SUMMARY ***
Total pot $1.47 | Rake $0.07 
Board [Tc 4c Td 6s 8s]
Seat 1: Skiednis01 (big blind) showed [3d 3c] and won ($1.40) with two pair, Tens and Threes
Seat 2: Sve_Sve93 folded before Flop (didn't bet)
Seat 3: 0nix770 folded before Flop (didn't bet)
Seat 4: robotov folded before Flop (didn't bet)
Seat 5: KIIsSharkMan (button) mucked
Seat 6: kpa1992 (small blind) folded before Flop



PokerStars Hand #222967827381:  Hold'em No Limit ($0.05/$0.10 USD) - 2021/01/23 14:59:33 ET
Table 'Bohlinia III' 6-max Seat #6 is the button
Seat 1: Skiednis01 ($13.47 in chips) 
Seat 2: Sve_Sve93 ($14.72 in chips) 
Seat 3: 0nix770 ($11.53 in chips) 
Seat 4: robotov ($10 in chips) 
Seat 5: KIIsSharkMan ($10.23 in chips) 
Seat 6: kpa1992 ($4.71 in chips) 
Skiednis01: posts small blind $0.05
Sve_Sve93: posts big blind $0.10
*** HOLE CARDS ***
0nix770: folds 
robotov: folds 
KIIsSharkMan: folds 
kpa1992: folds 
Skiednis01: raises $0.15 to $0.25
Sve_Sve93: calls $0.15
*** FLOP *** [Qh 5d Ts]
Skiednis01: bets $0.24
Sve_Sve93: calls $0.24
*** TURN *** [Qh 5d Ts] [8c]
Skiednis01: checks 
Sve_Sve93: checks 
*** RIVER *** [Qh 5d Ts 8c] [8h]
Skiednis01: bets $0.60
Sve_Sve93: calls $0.60
*** SHOW DOWN ***
Skiednis01: shows [Ac 7s] (a pair of Eights)
Sve_Sve93: shows [7h 7d] (two pair, Eights and Sevens)
Sve_Sve93 collected $2.08 from pot
*** SUMMARY ***
Total pot $2.18 | Rake $0.10 
Board [Qh 5d Ts 8c 8h]
Seat 1: Skiednis01 (small blind) showed [Ac 7s] and lost with a pair of Eights
Seat 2: Sve_Sve93 (big blind) showed [7h 7d] and won ($2.08) with two pair, Eights and Sevens
Seat 3: 0nix770 folded before Flop (didn't bet)
Seat 4: robotov folded before Flop (didn't bet)
Seat 5: KIIsSharkMan folded before Flop (didn't bet)
Seat 6: kpa1992 (button) folded before Flop (didn't bet)



PokerStars Hand #222967860641:  Hold'em No Limit ($0.05/$0.10 USD) - 2021/01/23 15:00:32 ET
Table 'Bohlinia III' 6-max Seat #1 is the button
Seat 1: Skiednis01 ($12.38 in chips) 
Seat 2: Sve_Sve93 ($15.71 in chips) 
Seat 3: 0nix770 ($11.53 in chips) 
Seat 4: robotov ($10 in chips) 
Seat 5: KIIsSharkMan ($10.23 in chips) 
Seat 6: kpa1992 ($4.71 in chips) 
Sve_Sve93: posts small blind $0.05
0nix770: posts big blind $0.10
*** HOLE CARDS ***
robotov: folds 
KIIsSharkMan: folds 
kpa1992: folds 
Skiednis01: raises $0.15 to $0.25
Sve_Sve93: folds 
0nix770: folds 
Uncalled bet ($0.15) returned to Skiednis01
Skiednis01 collected $0.25 from pot
Skiednis01: doesn't show hand 
*** SUMMARY ***
Total pot $0.25 | Rake $0 
Seat 1: Skiednis01 (button) collected ($0.25)
Seat 2: Sve_Sve93 (small blind) folded before Flop
Seat 3: 0nix770 (big blind) folded before Flop
Seat 4: robotov folded before Flop (didn't bet)
Seat 5: KIIsSharkMan folded before Flop (didn't bet)
Seat 6: kpa1992 folded before Flop (didn't bet)



PokerStars Hand #222967866701:  Hold'em No Limit ($0.05/$0.10 USD) - 2021/01/23 15:00:42 ET
Table 'Bohlinia III' 6-max Seat #2 is the button
Seat 1: Skiednis01 ($12.53 in chips) 
Seat 2: Sve_Sve93 ($15.66 in chips) 
Seat 3: 0nix770 ($11.43 in chips) 
Seat 4: robotov ($10 in chips) 
Seat 5: KIIsSharkMan ($10.23 in chips) 
Seat 6: kpa1992 ($4.71 in chips) 
0nix770: posts small blind $0.05
robotov: posts big blind $0.10
*** HOLE CARDS ***
KIIsSharkMan: folds 
kpa1992: folds 
Skiednis01: folds 
Sve_Sve93: folds 
0nix770: folds 
Uncalled bet ($0.05) returned to robotov
robotov collected $0.10 from pot
robotov: doesn't show hand 
*** SUMMARY ***
Total pot $0.10 | Rake $0 
Seat 1: Skiednis01 folded before Flop (didn't bet)
Seat 2: Sve_Sve93 (button) folded before Flop (didn't bet)
Seat 3: 0nix770 (small blind) folded before Flop
Seat 4: robotov (big blind) collected ($0.10)
Seat 5: KIIsSharkMan folded before Flop (didn't bet)
Seat 6: kpa1992 folded before Flop (didn't bet)



PokerStars Hand #222967871566:  Hold'em No Limit ($0.05/$0.10 USD) - 2021/01/23 15:00:50 ET
Table 'Bohlinia III' 6-max Seat #3 is the button
Seat 1: Skiednis01 ($12.53 in chips) 
Seat 2: Sve_Sve93 ($15.66 in chips) 
Seat 3: 0nix770 ($11.38 in chips) 
Seat 4: robotov ($10.05 in chips) 
Seat 5: KIIsSharkMan ($10.23 in chips) 
Seat 6: kpa1992 ($4.71 in chips) 
robotov: posts small blind $0.05
KIIsSharkMan: posts big blind $0.10
*** HOLE CARDS ***
kpa1992: folds 
Skiednis01: raises $0.15 to $0.25
Sve_Sve93: raises $0.65 to $0.90
0nix770: folds 
robotov: folds 
KIIsSharkMan: calls $0.80
Skiednis01: folds 
*** FLOP *** [Kc Qd Js]
KIIsSharkMan: checks 
Sve_Sve93: bets $1.01
KIIsSharkMan: folds 
Uncalled bet ($1.01) returned to Sve_Sve93
Sve_Sve93 collected $2.01 from pot
Sve_Sve93: doesn't show hand 
*** SUMMARY ***
Total pot $2.10 | Rake $0.09 
Board [Kc Qd Js]
Seat 1: Skiednis01 folded before Flop
Seat 2: Sve_Sve93 collected ($2.01)
Seat 3: 0nix770 (button) folded before Flop (didn't bet)
Seat 4: robotov (small blind) folded before Flop
Seat 5: KIIsSharkMan (big blind) folded on the Flop
Seat 6: kpa1992 folded before Flop (didn't bet)



PokerStars Hand #222967912332:  Hold'em No Limit ($0.05/$0.10 USD) - 2021/01/23 15:01:39 ET
Table 'Bohlinia III' 6-max Seat #4 is the button
Seat 1: Skiednis01 ($12.28 in chips) 
Seat 2: Sve_Sve93 ($16.77 in chips) 
Seat 3: 0nix770 ($11.38 in chips) 
Seat 4: robotov ($10 in chips) 
Seat 5: KIIsSharkMan ($9.33 in chips) 
Seat 6: kpa1992 ($4.71 in chips) 
KIIsSharkMan: posts small blind $0.05
kpa1992: posts big blind $0.10
*** HOLE CARDS ***
Skiednis01: raises $0.15 to $0.25
Sve_Sve93: folds 
0nix770: raises $0.65 to $0.90
robotov: folds 
KIIsSharkMan: folds 
kpa1992: folds 
Skiednis01: folds 
Uncalled bet ($0.65) returned to 0nix770
0nix770 collected $0.65 from pot
0nix770: doesn't show hand 
*** SUMMARY ***
Total pot $0.65 | Rake $0 
Seat 1: Skiednis01 folded before Flop
Seat 2: Sve_Sve93 folded before Flop (didn't bet)
Seat 3: 0nix770 collected ($0.65)
Seat 4: robotov (button) folded before Flop (didn't bet)
Seat 5: KIIsSharkMan (small blind) folded before Flop
Seat 6: kpa1992 (big blind) folded before Flop



PokerStars Hand #222967930734:  Hold'em No Limit ($0.05/$0.10 USD) - 2021/01/23 15:02:04 ET
Table 'Bohlinia III' 6-max Seat #5 is the button
Seat 1: Skiednis01 ($12.03 in chips) 
Seat 2: Sve_Sve93 ($16.77 in chips) 
Seat 3: 0nix770 ($11.78 in chips) 
Seat 4: robotov ($10 in chips) 
Seat 5: KIIsSharkMan ($9.28 in chips) 
Seat 6: kpa1992 ($4.61 in chips) 
kpa1992: posts small blind $0.05
Skiednis01: posts big blind $0.10
*** HOLE CARDS ***
Sve_Sve93: folds 
0nix770: folds 
robotov: folds 
KIIsSharkMan: folds 
kpa1992: folds 
Uncalled bet ($0.05) returned to Skiednis01
Skiednis01 collected $0.10 from pot
Skiednis01: doesn't show hand 
*** SUMMARY ***
Total pot $0.10 | Rake $0 
Seat 1: Skiednis01 (big blind) collected ($0.10)
Seat 2: Sve_Sve93 folded before Flop (didn't bet)
Seat 3: 0nix770 folded before Flop (didn't bet)
Seat 4: robotov folded before Flop (didn't bet)
Seat 5: KIIsSharkMan (button) folded before Flop (didn't bet)
Seat 6: kpa1992 (small blind) folded before Flop



PokerStars Hand #222967936801:  Hold'em No Limit ($0.05/$0.10 USD) - 2021/01/23 15:02:12 ET
Table 'Bohlinia III' 6-max Seat #6 is the button
Seat 1: Skiednis01 ($12.08 in chips) 
Seat 2: Sve_Sve93 ($16.77 in chips) 
Seat 3: 0nix770 ($11.78 in chips) 
Seat 4: robotov ($10 in chips) 
Seat 5: KIIsSharkMan ($9.28 in chips) 
Seat 6: kpa1992 ($4.56 in chips) 
Skiednis01: posts small blind $0.05
Sve_Sve93: posts big blind $0.10
*** HOLE CARDS ***
0nix770: raises $0.20 to $0.30
robotov: folds 
KIIsSharkMan: raises $0.75 to $1.05
kpa1992: folds 
Skiednis01: folds 
Sve_Sve93: folds 
0nix770: calls $0.75
*** FLOP *** [8s Kh As]
0nix770: checks 
KIIsSharkMan: bets $1.14
0nix770: folds 
Uncalled bet ($1.14) returned to KIIsSharkMan
KIIsSharkMan collected $2.15 from pot
KIIsSharkMan: doesn't show hand 
*** SUMMARY ***
Total pot $2.25 | Rake $0.10 
Board [8s Kh As]
Seat 1: Skiednis01 (small blind) folded before Flop
Seat 2: Sve_Sve93 (big blind) folded before Flop
Seat 3: 0nix770 folded on the Flop
Seat 4: robotov folded before Flop (didn't bet)
Seat 5: KIIsSharkMan collected ($2.15)
Seat 6: kpa1992 (button) folded before Flop (didn't bet)



PokerStars Hand #222967973844:  Hold'em No Limit ($0.05/$0.10 USD) - 2021/01/23 15:02:59 ET
Table 'Bohlinia III' 6-max Seat #1 is the button
Seat 1: Skiednis01 ($12.03 in chips) 
Seat 2: Sve_Sve93 ($16.67 in chips) 
Seat 3: 0nix770 ($10.73 in chips) 
Seat 4: robotov ($10 in chips) 
Seat 5: KIIsSharkMan ($10.38 in chips) 
Seat 6: kpa1992 ($4.56 in chips) 
Sve_Sve93: posts small blind $0.05
0nix770: posts big blind $0.10
*** HOLE CARDS ***
robotov: folds 
KIIsSharkMan: folds 
kpa1992: calls $0.10
Skiednis01: raises $0.35 to $0.45
Sve_Sve93: folds 
0nix770: calls $0.35
kpa1992: calls $0.35
*** FLOP *** [4h 5s Qd]
0nix770: checks 
kpa1992: checks 
Skiednis01: bets $0.67
0nix770: folds 
kpa1992: folds 
Uncalled bet ($0.67) returned to Skiednis01
Skiednis01 collected $1.34 from pot
Skiednis01: doesn't show hand 
*** SUMMARY ***
Total pot $1.40 | Rake $0.06 
Board [4h 5s Qd]
Seat 1: Skiednis01 (button) collected ($1.34)
Seat 2: Sve_Sve93 (small blind) folded before Flop
Seat 3: 0nix770 (big blind) folded on the Flop
Seat 4: robotov folded before Flop (didn't bet)
Seat 5: KIIsSharkMan folded before Flop (didn't bet)
Seat 6: kpa1992 folded on the Flop



PokerStars Hand #222967997952:  Hold'em No Limit ($0.05/$0.10 USD) - 2021/01/23 15:03:29 ET
Table 'Bohlinia III' 6-max Seat #2 is the button
Seat 1: Skiednis01 ($12.92 in chips) 
Seat 2: Sve_Sve93 ($16.62 in chips) 
Seat 3: 0nix770 ($10.28 in chips) 
Seat 5: KIIsSharkMan ($10.38 in chips) 
Seat 6: kpa1992 ($4.11 in chips) 
0nix770: posts small blind $0.05
robotov: is sitting out 
KIIsSharkMan: posts big blind $0.10
*** HOLE CARDS ***
kpa1992: calls $0.10
Skiednis01: folds 
Sve_Sve93: folds 
0nix770: raises $0.30 to $0.40
KIIsSharkMan: calls $0.30
kpa1992: calls $0.30
*** FLOP *** [4c 4d 6h]
0nix770: checks 
robotov leaves the table
KIIsSharkMan: bets $0.61
4Skill joins the table at seat #4 
kpa1992: folds 
0nix770: folds 
Uncalled bet ($0.61) returned to KIIsSharkMan
KIIsSharkMan collected $1.15 from pot
KIIsSharkMan: doesn't show hand 
*** SUMMARY ***
Total pot $1.20 | Rake $0.05 
Board [4c 4d 6h]
Seat 1: Skiednis01 folded before Flop (didn't bet)
Seat 2: Sve_Sve93 (button) folded before Flop (didn't bet)
Seat 3: 0nix770 (small blind) folded on the Flop
Seat 5: KIIsSharkMan (big blind) collected ($1.15)
Seat 6: kpa1992 folded on the Flop



PokerStars Hand #222968025143:  Hold'em No Limit ($0.05/$0.10 USD) - 2021/01/23 15:04:03 ET
Table 'Bohlinia III' 6-max Seat #3 is the button
Seat 1: Skiednis01 ($12.92 in chips) 
Seat 2: Sve_Sve93 ($16.62 in chips) 
Seat 3: 0nix770 ($10 in chips) 
Seat 5: KIIsSharkMan ($11.13 in chips) 
Seat 6: kpa1992 ($3.71 in chips) 
KIIsSharkMan: posts small blind $0.05
kpa1992: posts big blind $0.10
*** HOLE CARDS ***
Skiednis01: folds 
Sve_Sve93: raises $0.20 to $0.30
0nix770: folds 
KIIsSharkMan: folds 
kpa1992: folds 
Uncalled bet ($0.20) returned to Sve_Sve93
Sve_Sve93 collected $0.25 from pot
Sve_Sve93: doesn't show hand 
*** SUMMARY ***
Total pot $0.25 | Rake $0 
Seat 1: Skiednis01 folded before Flop (didn't bet)
Seat 2: Sve_Sve93 collected ($0.25)
Seat 3: 0nix770 (button) folded before Flop (didn't bet)
Seat 5: KIIsSharkMan (small blind) folded before Flop
Seat 6: kpa1992 (big blind) folded before Flop



PokerStars Hand #222968037629:  Hold'em No Limit ($0.05/$0.10 USD) - 2021/01/23 15:04:18 ET
Table 'Bohlinia III' 6-max Seat #5 is the button
Seat 1: Skiednis01 ($12.92 in chips) 
Seat 2: Sve_Sve93 ($16.77 in chips) 
Seat 3: 0nix770 ($10 in chips) 
Seat 5: KIIsSharkMan ($11.08 in chips) 
Seat 6: kpa1992 ($3.61 in chips) 
kpa1992: posts small blind $0.05
Skiednis01: posts big blind $0.10
4Skill: sits out 
*** HOLE CARDS ***
Sve_Sve93: folds 
0nix770: folds 
KIIsSharkMan: folds 
kpa1992: folds 
Uncalled bet ($0.05) returned to Skiednis01
Skiednis01 collected $0.10 from pot
Skiednis01: doesn't show hand 
*** SUMMARY ***
Total pot $0.10 | Rake $0 
Seat 1: Skiednis01 (big blind) collected ($0.10)
Seat 2: Sve_Sve93 folded before Flop (didn't bet)
Seat 3: 0nix770 folded before Flop (didn't bet)
Seat 5: KIIsSharkMan (button) folded before Flop (didn't bet)
Seat 6: kpa1992 (small blind) folded before Flop



PokerStars Hand #222968045415:  Hold'em No Limit ($0.05/$0.10 USD) - 2021/01/23 15:04:28 ET
Table 'Bohlinia III' 6-max Seat #6 is the button
Seat 1: Skiednis01 ($12.97 in chips) 
Seat 2: Sve_Sve93 ($16.77 in chips) 
Seat 3: 0nix770 ($10 in chips) 
Seat 5: KIIsSharkMan ($11.08 in chips) 
Seat 6: kpa1992 ($3.56 in chips) 
Skiednis01: posts small blind $0.05
Sve_Sve93: posts big blind $0.10
4Skill: sits out 
*** HOLE CARDS ***
0nix770: raises $0.20 to $0.30
KIIsSharkMan: folds 
kpa1992: folds 
Skiednis01: folds 
Sve_Sve93: folds 
Uncalled bet ($0.20) returned to 0nix770
0nix770 collected $0.25 from pot
0nix770: doesn't show hand 
*** SUMMARY ***
Total pot $0.25 | Rake $0 
Seat 1: Skiednis01 (small blind) folded before Flop
Seat 2: Sve_Sve93 (big blind) folded before Flop
Seat 3: 0nix770 collected ($0.25)
Seat 5: KIIsSharkMan folded before Flop (didn't bet)
Seat 6: kpa1992 (button) folded before Flop (didn't bet)



PokerStars Hand #222968055074:  Hold'em No Limit ($0.05/$0.10 USD) - 2021/01/23 15:04:40 ET
Table 'Bohlinia III' 6-max Seat #1 is the button
Seat 1: Skiednis01 ($12.92 in chips) 
Seat 2: Sve_Sve93 ($16.67 in chips) 
Seat 3: 0nix770 ($10.15 in chips) 
Seat 5: KIIsSharkMan ($11.08 in chips) 
Seat 6: kpa1992 ($3.56 in chips) 
Sve_Sve93: posts small blind $0.05
0nix770: posts big blind $0.10
4Skill: sits out 
*** HOLE CARDS ***
KIIsSharkMan: folds 
kpa1992: calls $0.10
Skiednis01: folds 
Sve_Sve93: raises $0.30 to $0.40
0nix770: folds 
kpa1992: calls $0.30
*** FLOP *** [5s Ac 9h]
Sve_Sve93: bets $0.43
kpa1992: raises $0.43 to $0.86
Sve_Sve93: raises $2.58 to $3.44
kpa1992: calls $2.30 and is all-in
Uncalled bet ($0.28) returned to Sve_Sve93
*** TURN *** [5s Ac 9h] [6h]
*** RIVER *** [5s Ac 9h 6h] [9d]
*** SHOW DOWN ***
Sve_Sve93: shows [Ad Qs] (two pair, Aces and Nines)
kpa1992: shows [3s As] (two pair, Aces and Nines - lower kicker)
Sve_Sve93 collected $6.90 from pot
*** SUMMARY ***
Total pot $7.22 | Rake $0.32 
Board [5s Ac 9h 6h 9d]
Seat 1: Skiednis01 (button) folded before Flop (didn't bet)
Seat 2: Sve_Sve93 (small blind) showed [Ad Qs] and won ($6.90) with two pair, Aces and Nines
Seat 3: 0nix770 (big blind) folded before Flop
Seat 5: KIIsSharkMan folded before Flop (didn't bet)
Seat 6: kpa1992 showed [3s As] and lost with two pair, Aces and Nines



PokerStars Hand #222968097095:  Hold'em No Limit ($0.05/$0.10 USD) - 2021/01/23 15:05:30 ET
Table 'Bohlinia III' 6-max Seat #2 is the button
Seat 1: Skiednis01 ($12.92 in chips) 
Seat 2: Sve_Sve93 ($20.01 in chips) 
Seat 3: 0nix770 ($10.05 in chips) 
Seat 4: 4Skill ($10 in chips) 
Seat 5: KIIsSharkMan ($11.08 in chips) 
0nix770: posts small blind $0.05
4Skill: posts big blind $0.10
*** HOLE CARDS ***
KIIsSharkMan: raises $0.15 to $0.25
Skiednis01: folds 
Sve_Sve93: folds 
kpa1992 leaves the table
0nix770: folds 
4Skill: folds 
Uncalled bet ($0.15) returned to KIIsSharkMan
KIIsSharkMan collected $0.25 from pot
KIIsSharkMan: doesn't show hand 
*** SUMMARY ***
Total pot $0.25 | Rake $0 
Seat 1: Skiednis01 folded before Flop (didn't bet)
Seat 2: Sve_Sve93 (button) folded before Flop (didn't bet)
Seat 3: 0nix770 (small blind) folded before Flop
Seat 4: 4Skill (big blind) folded before Flop
Seat 5: KIIsSharkMan collected ($0.25)



PokerStars Hand #222968107040:  Hold'em No Limit ($0.05/$0.10 USD) - 2021/01/23 15:05:42 ET
Table 'Bohlinia III' 6-max Seat #3 is the button
Seat 1: Skiednis01 ($12.92 in chips) 
Seat 2: Sve_Sve93 ($20.01 in chips) 
Seat 3: 0nix770 ($10 in chips) 
Seat 4: 4Skill ($10 in chips) 
Seat 5: KIIsSharkMan ($11.23 in chips) 
4Skill: posts small blind $0.05
JammesAngler joins the table at seat #6 
KIIsSharkMan: posts big blind $0.10
*** HOLE CARDS ***
Skiednis01: folds 
Sve_Sve93: folds 
0nix770: raises $0.13 to $0.23
4Skill: folds 
KIIsSharkMan: folds 
Uncalled bet ($0.13) returned to 0nix770
0nix770 collected $0.25 from pot
0nix770: doesn't show hand 
*** SUMMARY ***
Total pot $0.25 | Rake $0 
Seat 1: Skiednis01 folded before Flop (didn't bet)
Seat 2: Sve_Sve93 folded before Flop (didn't bet)
Seat 3: 0nix770 (button) collected ($0.25)
Seat 4: 4Skill (small blind) folded before Flop
Seat 5: KIIsSharkMan (big blind) folded before Flop



PokerStars Hand #222968118447:  Hold'em No Limit ($0.05/$0.10 USD) - 2021/01/23 15:05:55 ET
Table 'Bohlinia III' 6-max Seat #4 is the button
Seat 1: Skiednis01 ($12.92 in chips) 
Seat 2: Sve_Sve93 ($20.01 in chips) 
Seat 3: 0nix770 ($10.15 in chips) 
Seat 4: 4Skill ($10 in chips) 
Seat 5: KIIsSharkMan ($11.13 in chips) 
Seat 6: JammesAngler ($10 in chips) 
KIIsSharkMan: posts small blind $0.05
JammesAngler: posts big blind $0.10
*** HOLE CARDS ***
Skiednis01: folds 
Sve_Sve93: folds 
0nix770: folds 
4Skill: raises $0.20 to $0.30
KIIsSharkMan: folds 
JammesAngler: calls $0.20
*** FLOP *** [8d Tc Ts]
JammesAngler: checks 
4Skill: bets $0.21
JammesAngler: calls $0.21
*** TURN *** [8d Tc Ts] [Jc]
JammesAngler: checks 
4Skill: checks 
*** RIVER *** [8d Tc Ts Jc] [7c]
JammesAngler: checks 
4Skill: checks 
*** SHOW DOWN ***
JammesAngler: shows [Kh 9s] (a straight, Seven to Jack)
4Skill: mucks hand 
JammesAngler collected $1.02 from pot
*** SUMMARY ***
Total pot $1.07 | Rake $0.05 
Board [8d Tc Ts Jc 7c]
Seat 1: Skiednis01 folded before Flop (didn't bet)
Seat 2: Sve_Sve93 folded before Flop (didn't bet)
Seat 3: 0nix770 folded before Flop (didn't bet)
Seat 4: 4Skill (button) mucked
Seat 5: KIIsSharkMan (small blind) folded before Flop
Seat 6: JammesAngler (big blind) showed [Kh 9s] and won ($1.02) with a straight, Seven to Jack



PokerStars Hand #222968183378:  Hold'em No Limit ($0.05/$0.10 USD) - 2021/01/23 15:07:13 ET
Table 'Bohlinia III' 6-max Seat #5 is the button
Seat 1: Skiednis01 ($12.92 in chips) 
Seat 2: Sve_Sve93 ($20.01 in chips) 
Seat 3: 0nix770 ($10.15 in chips) 
Seat 4: 4Skill ($10 in chips) 
Seat 5: KIIsSharkMan ($11.08 in chips) 
Seat 6: JammesAngler ($10.51 in chips) 
JammesAngler: posts small blind $0.05
Skiednis01: posts big blind $0.10
*** HOLE CARDS ***
Sve_Sve93: folds 
0nix770: folds 
4Skill: raises $0.20 to $0.30
KIIsSharkMan: calls $0.30
JammesAngler: folds 
Skiednis01: folds 
*** FLOP *** [Js 5d 3s]
4Skill: bets $0.36
KIIsSharkMan: calls $0.36
*** TURN *** [Js 5d 3s] [3c]
4Skill: checks 
KIIsSharkMan: bets $0.92
4Skill: calls $0.92
*** RIVER *** [Js 5d 3s 3c] [5h]
4Skill: checks 
KIIsSharkMan: checks 
*** SHOW DOWN ***
4Skill: shows [6s 6c] (two pair, Sixes and Fives)
KIIsSharkMan: shows [Jd Qc] (two pair, Jacks and Fives)
KIIsSharkMan collected $3.16 from pot
*** SUMMARY ***
Total pot $3.31 | Rake $0.15 
Board [Js 5d 3s 3c 5h]
Seat 1: Skiednis01 (big blind) folded before Flop
Seat 2: Sve_Sve93 folded before Flop (didn't bet)
Seat 3: 0nix770 folded before Flop (didn't bet)
Seat 4: 4Skill showed [6s 6c] and lost with two pair, Sixes and Fives
Seat 5: KIIsSharkMan (button) showed [Jd Qc] and won ($3.16) with two pair, Jacks and Fives
Seat 6: JammesAngler (small blind) folded before Flop



PokerStars Hand #222968240098:  Hold'em No Limit ($0.05/$0.10 USD) - 2021/01/23 15:08:21 ET
Table 'Bohlinia III' 6-max Seat #6 is the button
Seat 1: Skiednis01 ($12.82 in chips) 
Seat 2: Sve_Sve93 ($20.01 in chips) 
Seat 3: 0nix770 ($10.15 in chips) 
Seat 4: 4Skill ($10 in chips) 
Seat 5: KIIsSharkMan ($12.66 in chips) 
Seat 6: JammesAngler ($10.46 in chips) 
Skiednis01: posts small blind $0.05
Sve_Sve93: posts big blind $0.10
*** HOLE CARDS ***
0nix770: folds 
4Skill: folds 
KIIsSharkMan: folds 
JammesAngler: folds 
0nix770 leaves the table
Skiednis01: raises $0.15 to $0.25
Sve_Sve93: folds 
Uncalled bet ($0.15) returned to Skiednis01
Skiednis01 collected $0.20 from pot
Skiednis01: doesn't show hand 
*** SUMMARY ***
Total pot $0.20 | Rake $0 
Seat 1: Skiednis01 (small blind) collected ($0.20)
Seat 2: Sve_Sve93 (big blind) folded before Flop
Seat 3: 0nix770 folded before Flop (didn't bet)
Seat 4: 4Skill folded before Flop (didn't bet)
Seat 5: KIIsSharkMan folded before Flop (didn't bet)
Seat 6: JammesAngler (button) folded before Flop (didn't bet)



PokerStars Hand #222968252407:  Hold'em No Limit ($0.05/$0.10 USD) - 2021/01/23 15:08:35 ET
Table 'Bohlinia III' 6-max Seat #1 is the button
Seat 1: Skiednis01 ($12.92 in chips) 
Seat 2: Sve_Sve93 ($19.91 in chips) 
Seat 4: 4Skill ($10 in chips) 
Seat 5: KIIsSharkMan ($12.66 in chips) 
Seat 6: JammesAngler ($10.46 in chips) 
Sve_Sve93: posts small blind $0.05
4Skill: posts big blind $0.10
*** HOLE CARDS ***
KIIsSharkMan: folds 
JammesAngler: folds 
Skiednis01: folds 
Sve_Sve93: raises $0.20 to $0.30
evgen777942 joins the table at seat #3 
4Skill: calls $0.20
*** FLOP *** [Jh Jd 8s]
Sve_Sve93: bets $0.29
4Skill: folds 
Uncalled bet ($0.29) returned to Sve_Sve93
Sve_Sve93 collected $0.57 from pot
Sve_Sve93: doesn't show hand 
*** SUMMARY ***
Total pot $0.60 | Rake $0.03 
Board [Jh Jd 8s]
Seat 1: Skiednis01 (button) folded before Flop (didn't bet)
Seat 2: Sve_Sve93 (small blind) collected ($0.57)
Seat 4: 4Skill (big blind) folded on the Flop
Seat 5: KIIsSharkMan folded before Flop (didn't bet)
Seat 6: JammesAngler folded before Flop (didn't bet)



PokerStars Hand #222968272369:  Hold'em No Limit ($0.05/$0.10 USD) - 2021/01/23 15:08:59 ET
Table 'Bohlinia III' 6-max Seat #2 is the button
Seat 1: Skiednis01 ($12.92 in chips) 
Seat 2: Sve_Sve93 ($20.18 in chips) 
Seat 4: 4Skill ($10 in chips) 
Seat 5: KIIsSharkMan ($12.66 in chips) 
Seat 6: JammesAngler ($10.46 in chips) 
4Skill: posts small blind $0.05
KIIsSharkMan: posts big blind $0.10
*** HOLE CARDS ***
JammesAngler: folds 
Skiednis01: raises $0.15 to $0.25
Sve_Sve93: calls $0.25
4Skill: folds 
KIIsSharkMan: folds 
*** FLOP *** [Qs 6s Kd]
Skiednis01: bets $0.31
Sve_Sve93: raises $0.69 to $1
Skiednis01: calls $0.69
*** TURN *** [Qs 6s Kd] [5d]
Skiednis01: bets $1.27
Sve_Sve93: raises $2.54 to $3.81
Skiednis01: folds 
Uncalled bet ($2.54) returned to Sve_Sve93
Sve_Sve93 collected $4.96 from pot
Sve_Sve93: doesn't show hand 
*** SUMMARY ***
Total pot $5.19 | Rake $0.23 
Board [Qs 6s Kd 5d]
Seat 1: Skiednis01 folded on the Turn
Seat 2: Sve_Sve93 (button) collected ($4.96)
Seat 4: 4Skill (small blind) folded before Flop
Seat 5: KIIsSharkMan (big blind) folded before Flop
Seat 6: JammesAngler folded before Flop (didn't bet)



PokerStars Hand #222968312310:  Hold'em No Limit ($0.05/$0.10 USD) - 2021/01/23 15:09:47 ET
Table 'Bohlinia III' 6-max Seat #4 is the button
Seat 1: Skiednis01 ($10.40 in chips) 
Seat 2: Sve_Sve93 ($22.62 in chips) 
Seat 3: evgen777942 ($4 in chips) 
Seat 4: 4Skill ($10 in chips) 
Seat 5: KIIsSharkMan ($12.56 in chips) 
Seat 6: JammesAngler ($10.46 in chips) 
KIIsSharkMan: posts small blind $0.05
JammesAngler: posts big blind $0.10
evgen777942: posts big blind $0.10
*** HOLE CARDS ***
Skiednis01: folds 
Sve_Sve93: folds 
evgen777942: raises $0.10 to $0.20
4Skill: folds 
KIIsSharkMan: folds 
JammesAngler: folds 
Uncalled bet ($0.10) returned to evgen777942
evgen777942 collected $0.25 from pot
evgen777942: doesn't show hand 
*** SUMMARY ***
Total pot $0.25 | Rake $0 
Seat 1: Skiednis01 folded before Flop (didn't bet)
Seat 2: Sve_Sve93 folded before Flop (didn't bet)
Seat 3: evgen777942 collected ($0.25)
Seat 4: 4Skill (button) folded before Flop (didn't bet)
Seat 5: KIIsSharkMan (small blind) folded before Flop
Seat 6: JammesAngler (big blind) folded before Flop



PokerStars Hand #222968322232:  Hold'em No Limit ($0.05/$0.10 USD) - 2021/01/23 15:09:59 ET
Table 'Bohlinia III' 6-max Seat #5 is the button
Seat 1: Skiednis01 ($10.40 in chips) 
Seat 2: Sve_Sve93 ($22.62 in chips) 
Seat 3: evgen777942 ($4.15 in chips) 
Seat 4: 4Skill ($10 in chips) 
Seat 5: KIIsSharkMan ($12.51 in chips) 
Seat 6: JammesAngler ($10.36 in chips) 
JammesAngler: posts small blind $0.05
Skiednis01: posts big blind $0.10
*** HOLE CARDS ***
Sve_Sve93: folds 
evgen777942: folds 
4Skill: folds 
KIIsSharkMan: raises $0.20 to $0.30
JammesAngler: folds 
Skiednis01: calls $0.20
*** FLOP *** [5h 3c 6s]
Skiednis01: checks 
KIIsSharkMan: bets $0.33
Skiednis01: calls $0.33
*** TURN *** [5h 3c 6s] [Kc]
Skiednis01: checks 
KIIsSharkMan: bets $0.66
Skiednis01: raises $1.29 to $1.95
KIIsSharkMan: calls $1.29
*** RIVER *** [5h 3c 6s Kc] [7d]
Skiednis01: checks 
KIIsSharkMan: bets $4.98
Skiednis01: folds 
Uncalled bet ($4.98) returned to KIIsSharkMan
KIIsSharkMan collected $4.98 from pot
KIIsSharkMan: doesn't show hand 
*** SUMMARY ***
Total pot $5.21 | Rake $0.23 
Board [5h 3c 6s Kc 7d]
Seat 1: Skiednis01 (big blind) folded on the River
Seat 2: Sve_Sve93 folded before Flop (didn't bet)
Seat 3: evgen777942 folded before Flop (didn't bet)
Seat 4: 4Skill folded before Flop (didn't bet)
Seat 5: KIIsSharkMan (button) collected ($4.98)
Seat 6: JammesAngler (small blind) folded before Flop



PokerStars Hand #222968372993:  Hold'em No Limit ($0.05/$0.10 USD) - 2021/01/23 15:10:59 ET
Table 'Bohlinia III' 6-max Seat #6 is the button
Seat 1: Skiednis01 ($10 in chips) 
Seat 2: Sve_Sve93 ($22.62 in chips) 
Seat 3: evgen777942 ($4.15 in chips) 
Seat 4: 4Skill ($10 in chips) 
Seat 5: KIIsSharkMan ($14.91 in chips) 
Seat 6: JammesAngler ($10.31 in chips) 
Skiednis01: posts small blind $0.05
Sve_Sve93: posts big blind $0.10
*** HOLE CARDS ***
evgen777942: folds 
4Skill: folds 
KIIsSharkMan: folds 
JammesAngler: folds 
Skiednis01: raises $0.15 to $0.25
Sve_Sve93: folds 
Uncalled bet ($0.15) returned to Skiednis01
Skiednis01 collected $0.20 from pot
Skiednis01: doesn't show hand 
*** SUMMARY ***
Total pot $0.20 | Rake $0 
Seat 1: Skiednis01 (small blind) collected ($0.20)
Seat 2: Sve_Sve93 (big blind) folded before Flop
Seat 3: evgen777942 folded before Flop (didn't bet)
Seat 4: 4Skill folded before Flop (didn't bet)
Seat 5: KIIsSharkMan folded before Flop (didn't bet)
Seat 6: JammesAngler (button) folded before Flop (didn't bet)



PokerStars Hand #222968386388:  Hold'em No Limit ($0.05/$0.10 USD) - 2021/01/23 15:11:15 ET
Table 'Bohlinia III' 6-max Seat #1 is the button
Seat 1: Skiednis01 ($10.10 in chips) 
Seat 2: Sve_Sve93 ($22.52 in chips) 
Seat 3: evgen777942 ($4.15 in chips) 
Seat 4: 4Skill ($10 in chips) 
Seat 5: KIIsSharkMan ($14.91 in chips) 
Seat 6: JammesAngler ($10.31 in chips) 
Sve_Sve93: posts small blind $0.05
evgen777942: posts big blind $0.10
*** HOLE CARDS ***
4Skill: raises $0.20 to $0.30
KIIsSharkMan: calls $0.30
JammesAngler: folds 
Skiednis01: folds 
Sve_Sve93: folds 
evgen777942: calls $0.20
*** FLOP *** [7h 4s 3d]
evgen777942: bets $0.46
4Skill: folds 
KIIsSharkMan: calls $0.46
*** TURN *** [7h 4s 3d] [Kh]
evgen777942: bets $0.90
KIIsSharkMan: calls $0.90
*** RIVER *** [7h 4s 3d Kh] [4d]
evgen777942: checks 
KIIsSharkMan: bets $2.49
evgen777942: folds 
Uncalled bet ($2.49) returned to KIIsSharkMan
KIIsSharkMan collected $3.50 from pot
KIIsSharkMan: doesn't show hand 
*** SUMMARY ***
Total pot $3.67 | Rake $0.17 
Board [7h 4s 3d Kh 4d]
Seat 1: Skiednis01 (button) folded before Flop (didn't bet)
Seat 2: Sve_Sve93 (small blind) folded before Flop
Seat 3: evgen777942 (big blind) folded on the River
Seat 4: 4Skill folded on the Flop
Seat 5: KIIsSharkMan collected ($3.50)
Seat 6: JammesAngler folded before Flop (didn't bet)



PokerStars Hand #222968468619:  Hold'em No Limit ($0.05/$0.10 USD) - 2021/01/23 15:12:45 ET
Table 'Bohlinia III' 6-max Seat #2 is the button
Seat 1: Skiednis01 ($10.10 in chips) 
Seat 2: Sve_Sve93 ($22.47 in chips) 
Seat 3: evgen777942 ($2.49 in chips) 
Seat 4: 4Skill ($10 in chips) 
Seat 5: KIIsSharkMan ($16.75 in chips) 
Seat 6: JammesAngler ($10.31 in chips) 
evgen777942: posts small blind $0.05
4Skill: posts big blind $0.10
*** HOLE CARDS ***
KIIsSharkMan: folds 
JammesAngler: raises $0.20 to $0.30
Skiednis01: folds 
Sve_Sve93: raises $0.70 to $1
evgen777942: calls $0.95
4Skill: folds 
JammesAngler: calls $0.70
*** FLOP *** [Kc 3s 2s]
evgen777942: bets $1.49 and is all-in
JammesAngler: folds 
Sve_Sve93: calls $1.49
*** TURN *** [Kc 3s 2s] [2c]
*** RIVER *** [Kc 3s 2s 2c] [Ad]
*** SHOW DOWN ***
evgen777942: shows [6d 6s] (two pair, Sixes and Deuces)
Sve_Sve93: shows [Th Ts] (two pair, Tens and Deuces)
Sve_Sve93 collected $5.81 from pot
*** SUMMARY ***
Total pot $6.08 | Rake $0.27 
Board [Kc 3s 2s 2c Ad]
Seat 1: Skiednis01 folded before Flop (didn't bet)
Seat 2: Sve_Sve93 (button) showed [Th Ts] and won ($5.81) with two pair, Tens and Deuces
Seat 3: evgen777942 (small blind) showed [6d 6s] and lost with two pair, Sixes and Deuces
Seat 4: 4Skill (big blind) folded before Flop
Seat 5: KIIsSharkMan folded before Flop (didn't bet)
Seat 6: JammesAngler folded on the Flop



PokerStars Hand #222968521074:  Hold'em No Limit ($0.05/$0.10 USD) - 2021/01/23 15:13:47 ET
Table 'Bohlinia III' 6-max Seat #4 is the button
Seat 1: Skiednis01 ($10.10 in chips) 
Seat 2: Sve_Sve93 ($25.79 in chips) 
Seat 4: 4Skill ($10 in chips) 
Seat 5: KIIsSharkMan ($16.75 in chips) 
Seat 6: JammesAngler ($10 in chips) 
KIIsSharkMan: posts small blind $0.05
JammesAngler: posts big blind $0.10
*** HOLE CARDS ***
Skiednis01: folds 
Sve_Sve93: folds 
4Skill: raises $0.15 to $0.25
KIIsSharkMan: folds 
JammesAngler: calls $0.15
*** FLOP *** [Th As 4c]
JammesAngler: checks 
4Skill: bets $0.30
JammesAngler: folds 
Uncalled bet ($0.30) returned to 4Skill
4Skill collected $0.53 from pot
4Skill: doesn't show hand 
*** SUMMARY ***
Total pot $0.55 | Rake $0.02 
Board [Th As 4c]
Seat 1: Skiednis01 folded before Flop (didn't bet)
Seat 2: Sve_Sve93 folded before Flop (didn't bet)
Seat 4: 4Skill (button) collected ($0.53)
Seat 5: KIIsSharkMan (small blind) folded before Flop
Seat 6: JammesAngler (big blind) folded on the Flop



PokerStars Hand #222968557116:  Hold'em No Limit ($0.05/$0.10 USD) - 2021/01/23 15:14:30 ET
Table 'Bohlinia III' 6-max Seat #5 is the button
Seat 1: Skiednis01 ($10.10 in chips) 
Seat 2: Sve_Sve93 ($25.79 in chips) 
Seat 3: evgen777942 ($4 in chips) 
Seat 4: 4Skill ($10.28 in chips) 
Seat 5: KIIsSharkMan ($16.70 in chips) 
Seat 6: JammesAngler ($10 in chips) 
JammesAngler: posts small blind $0.05
Skiednis01: posts big blind $0.10
*** HOLE CARDS ***
Sve_Sve93: folds 
evgen777942: folds 
4Skill: folds 
KIIsSharkMan: folds 
JammesAngler: raises $0.20 to $0.30
Skiednis01: calls $0.20
*** FLOP *** [3s Tc Ac]
JammesAngler: bets $0.44
Skiednis01: calls $0.44
*** TURN *** [3s Tc Ac] [8h]
JammesAngler: bets $1.10
Skiednis01: calls $1.10
*** RIVER *** [3s Tc Ac 8h] [2d]
JammesAngler: bets $2.74
Skiednis01: folds 
Uncalled bet ($2.74) returned to JammesAngler
JammesAngler collected $3.51 from pot
JammesAngler: doesn't show hand 
*** SUMMARY ***
Total pot $3.68 | Rake $0.17 
Board [3s Tc Ac 8h 2d]
Seat 1: Skiednis01 (big blind) folded on the River
Seat 2: Sve_Sve93 folded before Flop (didn't bet)
Seat 3: evgen777942 folded before Flop (didn't bet)
Seat 4: 4Skill folded before Flop (didn't bet)
Seat 5: KIIsSharkMan (button) folded before Flop (didn't bet)
Seat 6: JammesAngler (small blind) collected ($3.51)



PokerStars Hand #222968614468:  Hold'em No Limit ($0.05/$0.10 USD) - 2021/01/23 15:15:38 ET
Table 'Bohlinia III' 6-max Seat #6 is the button
Seat 1: Skiednis01 ($10 in chips) 
Seat 2: Sve_Sve93 ($25.79 in chips) 
Seat 3: evgen777942 ($4 in chips) 
Seat 4: 4Skill ($10.28 in chips) 
Seat 5: KIIsSharkMan ($16.70 in chips) 
Seat 6: JammesAngler ($11.67 in chips) 
Skiednis01: posts small blind $0.05
Sve_Sve93: posts big blind $0.10
*** HOLE CARDS ***
evgen777942: raises $0.10 to $0.20
4Skill: folds 
KIIsSharkMan: raises $0.55 to $0.75
JammesAngler: calls $0.75
Skiednis01: folds 
Sve_Sve93: folds 
evgen777942: calls $0.55
*** FLOP *** [7d Ac 7s]
evgen777942: checks 
KIIsSharkMan: checks 
JammesAngler: checks 
*** TURN *** [7d Ac 7s] [Qh]
evgen777942: bets $0.30
KIIsSharkMan: calls $0.30
JammesAngler: calls $0.30
*** RIVER *** [7d Ac 7s Qh] [9d]
evgen777942: bets $0.80
KIIsSharkMan: folds 
JammesAngler: calls $0.80
*** SHOW DOWN ***
evgen777942: shows [Ks Qc] (two pair, Queens and Sevens)
JammesAngler: shows [Kd Qd] (two pair, Queens and Sevens)
evgen777942 collected $2.34 from pot
JammesAngler collected $2.34 from pot
*** SUMMARY ***
Total pot $4.90 | Rake $0.22 
Board [7d Ac 7s Qh 9d]
Seat 1: Skiednis01 (small blind) folded before Flop
Seat 2: Sve_Sve93 (big blind) folded before Flop
Seat 3: evgen777942 showed [Ks Qc] and won ($2.34) with two pair, Queens and Sevens
Seat 4: 4Skill folded before Flop (didn't bet)
Seat 5: KIIsSharkMan folded on the River
Seat 6: JammesAngler (button) showed [Kd Qd] and won ($2.34) with two pair, Queens and Sevens



PokerStars Hand #222968706004:  Hold'em No Limit ($0.05/$0.10 USD) - 2021/01/23 15:17:25 ET
Table 'Bohlinia III' 6-max Seat #1 is the button
Seat 1: Skiednis01 ($10 in chips) 
Seat 2: Sve_Sve93 ($25.69 in chips) 
Seat 3: evgen777942 ($4.49 in chips) 
Seat 4: 4Skill ($10.28 in chips) 
Seat 5: KIIsSharkMan ($15.65 in chips) 
Seat 6: JammesAngler ($12.16 in chips) 
Sve_Sve93: posts small blind $0.05
evgen777942: posts big blind $0.10
*** HOLE CARDS ***
4Skill: folds 
KIIsSharkMan: folds 
JammesAngler: folds 
Skiednis01: raises $0.15 to $0.25
Sve_Sve93: folds 
evgen777942: calls $0.15
*** FLOP *** [9h 7s Ts]
evgen777942: checks 
Skiednis01: bets $0.27
evgen777942: calls $0.27
*** TURN *** [9h 7s Ts] [6s]
evgen777942: checks 
Skiednis01: checks 
*** RIVER *** [9h 7s Ts 6s] [3d]
evgen777942: bets $0.20
Skiednis01: calls $0.20
*** SHOW DOWN ***
evgen777942: shows [7h Kc] (a pair of Sevens)
Skiednis01: shows [Jd 9s] (a pair of Nines)
Skiednis01 collected $1.42 from pot
*** SUMMARY ***
Total pot $1.49 | Rake $0.07 
Board [9h 7s Ts 6s 3d]
Seat 1: Skiednis01 (button) showed [Jd 9s] and won ($1.42) with a pair of Nines
Seat 2: Sve_Sve93 (small blind) folded before Flop
Seat 3: evgen777942 (big blind) showed [7h Kc] and lost with a pair of Sevens
Seat 4: 4Skill folded before Flop (didn't bet)
Seat 5: KIIsSharkMan folded before Flop (didn't bet)
Seat 6: JammesAngler folded before Flop (didn't bet)



PokerStars Hand #222968741998:  Hold'em No Limit ($0.05/$0.10 USD) - 2021/01/23 15:18:07 ET
Table 'Bohlinia III' 6-max Seat #2 is the button
Seat 1: Skiednis01 ($10.70 in chips) 
Seat 2: Sve_Sve93 ($25.64 in chips) 
Seat 3: evgen777942 ($3.77 in chips) 
Seat 5: KIIsSharkMan ($15.65 in chips) 
Seat 6: JammesAngler ($12.16 in chips) 
evgen777942: posts small blind $0.05
4Skill: is sitting out 
KIIsSharkMan: posts big blind $0.10
*** HOLE CARDS ***
JammesAngler: folds 
Skiednis01: raises $0.15 to $0.25
4Skill leaves the table
Sve_Sve93: calls $0.25
evgen777942: folds 
KIIsSharkMan: folds 
*** FLOP *** [6h Qh Ad]
winn07 joins the table at seat #4 
Skiednis01: bets $0.31
Sve_Sve93: folds 
Uncalled bet ($0.31) returned to Skiednis01
Skiednis01 collected $0.62 from pot
Skiednis01: doesn't show hand 
*** SUMMARY ***
Total pot $0.65 | Rake $0.03 
Board [6h Qh Ad]
Seat 1: Skiednis01 collected ($0.62)
Seat 2: Sve_Sve93 (button) folded on the Flop
Seat 3: evgen777942 (small blind) folded before Flop
Seat 5: KIIsSharkMan (big blind) folded before Flop
Seat 6: JammesAngler folded before Flop (didn't bet)



PokerStars Hand #222968758248:  Hold'em No Limit ($0.05/$0.10 USD) - 2021/01/23 15:18:26 ET
Table 'Bohlinia III' 6-max Seat #3 is the button
Seat 1: Skiednis01 ($11.07 in chips) 
Seat 2: Sve_Sve93 ($25.39 in chips) 
Seat 3: evgen777942 ($3.72 in chips) 
Seat 5: KIIsSharkMan ($15.55 in chips) 
Seat 6: JammesAngler ($12.16 in chips) 
KIIsSharkMan: posts small blind $0.05
JammesAngler: posts big blind $0.10
*** HOLE CARDS ***
Skiednis01: raises $0.15 to $0.25
Sve_Sve93: folds 
evgen777942: folds 
KIIsSharkMan: calls $0.20
JammesAngler: folds 
*** FLOP *** [Kc 6d 7c]
KIIsSharkMan: checks 
Skiednis01: checks 
*** TURN *** [Kc 6d 7c] [4c]
KIIsSharkMan: bets $0.19
Skiednis01: folds 
Uncalled bet ($0.19) returned to KIIsSharkMan
KIIsSharkMan collected $0.57 from pot
KIIsSharkMan: doesn't show hand 
*** SUMMARY ***
Total pot $0.60 | Rake $0.03 
Board [Kc 6d 7c 4c]
Seat 1: Skiednis01 folded on the Turn
Seat 2: Sve_Sve93 folded before Flop (didn't bet)
Seat 3: evgen777942 (button) folded before Flop (didn't bet)
Seat 5: KIIsSharkMan (small blind) collected ($0.57)
Seat 6: JammesAngler (big blind) folded before Flop



PokerStars Hand #222968785247:  Hold'em No Limit ($0.05/$0.10 USD) - 2021/01/23 15:18:58 ET
Table 'Bohlinia III' 6-max Seat #5 is the button
Seat 1: Skiednis01 ($10.82 in chips) 
Seat 2: Sve_Sve93 ($25.39 in chips) 
Seat 3: evgen777942 ($3.72 in chips) 
Seat 5: KIIsSharkMan ($15.87 in chips) 
Seat 6: JammesAngler ($12.06 in chips) 
JammesAngler: posts small blind $0.05
Skiednis01: posts big blind $0.10
winn07: sits out 
*** HOLE CARDS ***
winn07 leaves the table
Sve_Sve93: folds 
maltsevig joins the table at seat #4 
evgen777942: folds 
KIIsSharkMan: raises $0.20 to $0.30
JammesAngler: folds 
Skiednis01: calls $0.20
*** FLOP *** [7c 7h 2c]
Skiednis01: checks 
KIIsSharkMan: bets $0.41
Skiednis01: calls $0.41
*** TURN *** [7c 7h 2c] [4h]
Skiednis01: checks 
KIIsSharkMan: bets $0.92
Skiednis01: folds 
Uncalled bet ($0.92) returned to KIIsSharkMan
KIIsSharkMan collected $1.40 from pot
KIIsSharkMan: doesn't show hand 
*** SUMMARY ***
Total pot $1.47 | Rake $0.07 
Board [7c 7h 2c 4h]
Seat 1: Skiednis01 (big blind) folded on the Turn
Seat 2: Sve_Sve93 folded before Flop (didn't bet)
Seat 3: evgen777942 folded before Flop (didn't bet)
Seat 5: KIIsSharkMan (button) collected ($1.40)
Seat 6: JammesAngler (small blind) folded before Flop



PokerStars Hand #222968841267:  Hold'em No Limit ($0.05/$0.10 USD) - 2021/01/23 15:20:04 ET
Table 'Bohlinia III' 6-max Seat #6 is the button
Seat 1: Skiednis01 ($10.11 in chips) 
Seat 2: Sve_Sve93 ($25.39 in chips) 
Seat 3: evgen777942 ($3.72 in chips) 
Seat 5: KIIsSharkMan ($16.56 in chips) 
Seat 6: JammesAngler ($12.01 in chips) 
Skiednis01: posts small blind $0.05
Sve_Sve93: posts big blind $0.10
maltsevig: sits out 
*** HOLE CARDS ***
evgen777942: raises $0.10 to $0.20
KIIsSharkMan: folds 
JammesAngler: folds 
Skiednis01: folds 
Sve_Sve93: folds 
Uncalled bet ($0.10) returned to evgen777942
evgen777942 collected $0.25 from pot
evgen777942: doesn't show hand 
*** SUMMARY ***
Total pot $0.25 | Rake $0 
Seat 1: Skiednis01 (small blind) folded before Flop
Seat 2: Sve_Sve93 (big blind) folded before Flop
Seat 3: evgen777942 collected ($0.25)
Seat 5: KIIsSharkMan folded before Flop (didn't bet)
Seat 6: JammesAngler (button) folded before Flop (didn't bet)



PokerStars Hand #222968851412:  Hold'em No Limit ($0.05/$0.10 USD) - 2021/01/23 15:20:15 ET
Table 'Bohlinia III' 6-max Seat #1 is the button
Seat 1: Skiednis01 ($10.06 in chips) 
Seat 2: Sve_Sve93 ($25.29 in chips) 
Seat 3: evgen777942 ($3.87 in chips) 
Seat 5: KIIsSharkMan ($16.56 in chips) 
Seat 6: JammesAngler ($12.01 in chips) 
Sve_Sve93: posts small blind $0.05
evgen777942: posts big blind $0.10
maltsevig: sits out 
*** HOLE CARDS ***
KIIsSharkMan: folds 
JammesAngler: folds 
Skiednis01: folds 
Sve_Sve93: folds 
Uncalled bet ($0.05) returned to evgen777942
evgen777942 collected $0.10 from pot
evgen777942: doesn't show hand 
*** SUMMARY ***
Total pot $0.10 | Rake $0 
Seat 1: Skiednis01 (button) folded before Flop (didn't bet)
Seat 2: Sve_Sve93 (small blind) folded before Flop
Seat 3: evgen777942 (big blind) collected ($0.10)
Seat 5: KIIsSharkMan folded before Flop (didn't bet)
Seat 6: JammesAngler folded before Flop (didn't bet)



PokerStars Hand #222968864768:  Hold'em No Limit ($0.05/$0.10 USD) - 2021/01/23 15:20:31 ET
Table 'Bohlinia III' 6-max Seat #2 is the button
Seat 1: Skiednis01 ($10.06 in chips) 
Seat 2: Sve_Sve93 ($25.24 in chips) 
Seat 3: evgen777942 ($3.92 in chips) 
Seat 4: maltsevig ($10 in chips) 
Seat 5: KIIsSharkMan ($16.56 in chips) 
Seat 6: JammesAngler ($12.01 in chips) 
evgen777942: posts small blind $0.05
maltsevig: posts big blind $0.10
*** HOLE CARDS ***
KIIsSharkMan: folds 
JammesAngler: raises $0.20 to $0.30
Skiednis01: calls $0.30
Sve_Sve93: folds 
evgen777942: calls $0.25
maltsevig: folds 
*** FLOP *** [7c Jh Qd]
evgen777942: checks 
JammesAngler: checks 
Skiednis01: bets $0.50
evgen777942: folds 
JammesAngler: folds 
Uncalled bet ($0.50) returned to Skiednis01
Skiednis01 collected $0.96 from pot
Skiednis01: doesn't show hand 
*** SUMMARY ***
Total pot $1 | Rake $0.04 
Board [7c Jh Qd]
Seat 1: Skiednis01 collected ($0.96)
Seat 2: Sve_Sve93 (button) folded before Flop (didn't bet)
Seat 3: evgen777942 (small blind) folded on the Flop
Seat 4: maltsevig (big blind) folded before Flop
Seat 5: KIIsSharkMan folded before Flop (didn't bet)
Seat 6: JammesAngler folded on the Flop



PokerStars Hand #222968905987:  Hold'em No Limit ($0.05/$0.10 USD) - 2021/01/23 15:21:19 ET
Table 'Bohlinia III' 6-max Seat #3 is the button
Seat 1: Skiednis01 ($10.72 in chips) 
Seat 2: Sve_Sve93 ($25.24 in chips) 
Seat 3: evgen777942 ($3.62 in chips) 
Seat 4: maltsevig ($10 in chips) 
Seat 5: KIIsSharkMan ($16.56 in chips) 
Seat 6: JammesAngler ($11.71 in chips) 
maltsevig: posts small blind $0.05
KIIsSharkMan: posts big blind $0.10
*** HOLE CARDS ***
JammesAngler: folds 
Skiednis01: raises $0.15 to $0.25
Sve_Sve93: folds 
evgen777942: calls $0.25
maltsevig: folds 
KIIsSharkMan: calls $0.15
*** FLOP *** [9h 8d 6c]
KIIsSharkMan: checks 
Skiednis01: bets $0.38
evgen777942: folds 
KIIsSharkMan: calls $0.38
*** TURN *** [9h 8d 6c] [8c]
KIIsSharkMan: checks 
Skiednis01: bets $0.75
KIIsSharkMan: calls $0.75
*** RIVER *** [9h 8d 6c 8c] [3d]
KIIsSharkMan: checks 
Skiednis01: checks 
*** SHOW DOWN ***
KIIsSharkMan: shows [Jc Qc] (a pair of Eights)
Skiednis01: shows [As 9s] (two pair, Nines and Eights)
Skiednis01 collected $2.92 from pot
*** SUMMARY ***
Total pot $3.06 | Rake $0.14 
Board [9h 8d 6c 8c 3d]
Seat 1: Skiednis01 showed [As 9s] and won ($2.92) with two pair, Nines and Eights
Seat 2: Sve_Sve93 folded before Flop (didn't bet)
Seat 3: evgen777942 (button) folded on the Flop
Seat 4: maltsevig (small blind) folded before Flop
Seat 5: KIIsSharkMan (big blind) showed [Jc Qc] and lost with a pair of Eights
Seat 6: JammesAngler folded before Flop (didn't bet)



PokerStars Hand #222968961531:  Hold'em No Limit ($0.05/$0.10 USD) - 2021/01/23 15:22:23 ET
Table 'Bohlinia III' 6-max Seat #4 is the button
Seat 1: Skiednis01 ($12.26 in chips) 
Seat 2: Sve_Sve93 ($25.24 in chips) 
Seat 3: evgen777942 ($3.37 in chips) 
Seat 4: maltsevig ($10 in chips) 
Seat 5: KIIsSharkMan ($15.18 in chips) 
Seat 6: JammesAngler ($11.71 in chips) 
KIIsSharkMan: posts small blind $0.05
JammesAngler: posts big blind $0.10
*** HOLE CARDS ***
Skiednis01: folds 
Sve_Sve93: raises $0.20 to $0.30
evgen777942: calls $0.30
maltsevig: folds 
KIIsSharkMan: folds 
JammesAngler: folds 
*** FLOP *** [Qc As 3h]
Sve_Sve93: bets $0.36
evgen777942: folds 
Uncalled bet ($0.36) returned to Sve_Sve93
Sve_Sve93 collected $0.72 from pot
Sve_Sve93: doesn't show hand 
*** SUMMARY ***
Total pot $0.75 | Rake $0.03 
Board [Qc As 3h]
Seat 1: Skiednis01 folded before Flop (didn't bet)
Seat 2: Sve_Sve93 collected ($0.72)
Seat 3: evgen777942 folded on the Flop
Seat 4: maltsevig (button) folded before Flop (didn't bet)
Seat 5: KIIsSharkMan (small blind) folded before Flop
Seat 6: JammesAngler (big blind) folded before Flop



PokerStars Hand #222968976406:  Hold'em No Limit ($0.05/$0.10 USD) - 2021/01/23 15:22:40 ET
Table 'Bohlinia III' 6-max Seat #5 is the button
Seat 1: Skiednis01 ($12.26 in chips) 
Seat 2: Sve_Sve93 ($25.66 in chips) 
Seat 3: evgen777942 ($3.07 in chips) 
Seat 4: maltsevig ($10 in chips) 
Seat 5: KIIsSharkMan ($15.13 in chips) 
Seat 6: JammesAngler ($11.61 in chips) 
JammesAngler: posts small blind $0.05
Skiednis01: posts big blind $0.10
*** HOLE CARDS ***
Sve_Sve93: folds 
evgen777942: folds 
maltsevig: folds 
maltsevig was removed from the table for failing to post
maltsevig leaves the table
KIIsSharkMan: folds 
JammesAngler: raises $0.15 to $0.25
DimaLesnoy joins the table at seat #4 
Skiednis01: calls $0.15
*** FLOP *** [Js 6d 7s]
JammesAngler: bets $0.37
Skiednis01: raises $0.43 to $0.80
JammesAngler: calls $0.43
*** TURN *** [Js 6d 7s] [Kd]
JammesAngler: checks 
Skiednis01: bets $1.10
JammesAngler: calls $1.10
*** RIVER *** [Js 6d 7s Kd] [4c]
JammesAngler: checks 
Skiednis01: bets $3
JammesAngler has timed out
JammesAngler: folds 
Uncalled bet ($3) returned to Skiednis01
Skiednis01 collected $4.11 from pot
Skiednis01: doesn't show hand 
*** SUMMARY ***
Total pot $4.30 | Rake $0.19 
Board [Js 6d 7s Kd 4c]
Seat 1: Skiednis01 (big blind) collected ($4.11)
Seat 2: Sve_Sve93 folded before Flop (didn't bet)
Seat 3: evgen777942 folded before Flop (didn't bet)
Seat 4: maltsevig folded before Flop (didn't bet)
Seat 5: KIIsSharkMan (button) folded before Flop (didn't bet)
Seat 6: JammesAngler (small blind) folded on the River



PokerStars Hand #222969057996:  Hold'em No Limit ($0.05/$0.10 USD) - 2021/01/23 15:24:15 ET
Table 'Bohlinia III' 6-max Seat #6 is the button
Seat 1: Skiednis01 ($14.22 in chips) 
Seat 2: Sve_Sve93 ($25.66 in chips) 
Seat 3: evgen777942 ($3.07 in chips) 
Seat 5: KIIsSharkMan ($15.13 in chips) 
Seat 6: JammesAngler ($10 in chips) 
Skiednis01: posts small blind $0.05
Sve_Sve93: posts big blind $0.10
DimaLesnoy: sits out 
*** HOLE CARDS ***
evgen777942: folds 
KIIsSharkMan: folds 
JammesAngler: folds 
Skiednis01: raises $0.15 to $0.25
Sve_Sve93: folds 
Uncalled bet ($0.15) returned to Skiednis01
Skiednis01 collected $0.20 from pot
Skiednis01: doesn't show hand 
*** SUMMARY ***
Total pot $0.20 | Rake $0 
Seat 1: Skiednis01 (small blind) collected ($0.20)
Seat 2: Sve_Sve93 (big blind) folded before Flop
Seat 3: evgen777942 folded before Flop (didn't bet)
Seat 5: KIIsSharkMan folded before Flop (didn't bet)
Seat 6: JammesAngler (button) folded before Flop (didn't bet)



PokerStars Hand #222969071324:  Hold'em No Limit ($0.05/$0.10 USD) - 2021/01/23 15:24:30 ET
Table 'Bohlinia III' 6-max Seat #1 is the button
Seat 1: Skiednis01 ($14.32 in chips) 
Seat 2: Sve_Sve93 ($25.56 in chips) 
Seat 3: evgen777942 ($3.07 in chips) 
Seat 5: KIIsSharkMan ($15.13 in chips) 
Seat 6: JammesAngler ($10 in chips) 
Sve_Sve93: posts small blind $0.05
evgen777942: posts big blind $0.10
DimaLesnoy: sits out 
*** HOLE CARDS ***
KIIsSharkMan: raises $0.15 to $0.25
JammesAngler: folds 
Skiednis01: folds 
Sve_Sve93: folds 
evgen777942: calls $0.15
*** FLOP *** [Jd 3s Ks]
evgen777942: checks 
KIIsSharkMan: bets $0.35
evgen777942: calls $0.35
*** TURN *** [Jd 3s Ks] [9s]
evgen777942: checks 
KIIsSharkMan: bets $0.63
evgen777942: raises $0.63 to $1.26
KIIsSharkMan: calls $0.63
*** RIVER *** [Jd 3s Ks 9s] [4s]
evgen777942: bets $1.21 and is all-in
KIIsSharkMan: calls $1.21
*** SHOW DOWN ***
evgen777942: shows [Th Kd] (a pair of Kings)
KIIsSharkMan: shows [Qs Jc] (a flush, King high)
KIIsSharkMan collected $5.91 from pot
*** SUMMARY ***
Total pot $6.19 | Rake $0.28 
Board [Jd 3s Ks 9s 4s]
Seat 1: Skiednis01 (button) folded before Flop (didn't bet)
Seat 2: Sve_Sve93 (small blind) folded before Flop
Seat 3: evgen777942 (big blind) showed [Th Kd] and lost with a pair of Kings
Seat 5: KIIsSharkMan showed [Qs Jc] and won ($5.91) with a flush, King high
Seat 6: JammesAngler folded before Flop (didn't bet)



PokerStars Hand #222969123034:  Hold'em No Limit ($0.05/$0.10 USD) - 2021/01/23 15:25:31 ET
Table 'Bohlinia III' 6-max Seat #2 is the button
Seat 1: Skiednis01 ($14.32 in chips) 
Seat 2: Sve_Sve93 ($25.51 in chips) 
Seat 5: KIIsSharkMan ($17.97 in chips) 
Seat 6: JammesAngler ($10 in chips) 
KIIsSharkMan: posts small blind $0.05
JammesAngler: posts big blind $0.10
*** HOLE CARDS ***
Skiednis01: folds 
evgen777942 leaves the table
Sve_Sve93: raises $0.20 to $0.30
KIIsSharkMan: folds 
JammesAngler: folds 
Uncalled bet ($0.20) returned to Sve_Sve93
Sve_Sve93 collected $0.25 from pot
Sve_Sve93: doesn't show hand 
*** SUMMARY ***
Total pot $0.25 | Rake $0 
Seat 1: Skiednis01 folded before Flop (didn't bet)
Seat 2: Sve_Sve93 (button) collected ($0.25)
Seat 5: KIIsSharkMan (small blind) folded before Flop
Seat 6: JammesAngler (big blind) folded before Flop



PokerStars Hand #222969132330:  Hold'em No Limit ($0.05/$0.10 USD) - 2021/01/23 15:25:41 ET
Table 'Bohlinia III' 6-max Seat #5 is the button
Seat 1: Skiednis01 ($14.32 in chips) 
Seat 2: Sve_Sve93 ($25.66 in chips) 
Seat 5: KIIsSharkMan ($17.92 in chips) 
Seat 6: JammesAngler ($10 in chips) 
JammesAngler: posts small blind $0.05
Skiednis01: posts big blind $0.10
DimaLesnoy: sits out 
*** HOLE CARDS ***
Sve_Sve93: folds 
LisInSky joins the table at seat #3 
KIIsSharkMan: raises $0.20 to $0.30
JammesAngler: folds 
Skiednis01: folds 
Uncalled bet ($0.20) returned to KIIsSharkMan
KIIsSharkMan collected $0.25 from pot
KIIsSharkMan: doesn't show hand 
*** SUMMARY ***
Total pot $0.25 | Rake $0 
Seat 1: Skiednis01 (big blind) folded before Flop
Seat 2: Sve_Sve93 folded before Flop (didn't bet)
Seat 5: KIIsSharkMan (button) collected ($0.25)
Seat 6: JammesAngler (small blind) folded before Flop



PokerStars Hand #222969147837:  Hold'em No Limit ($0.05/$0.10 USD) - 2021/01/23 15:25:59 ET
Table 'Bohlinia III' 6-max Seat #6 is the button
Seat 1: Skiednis01 ($14.22 in chips) 
Seat 2: Sve_Sve93 ($25.66 in chips) 
Seat 5: KIIsSharkMan ($18.07 in chips) 
Seat 6: JammesAngler ($10 in chips) 
Skiednis01: posts small blind $0.05
Sve_Sve93: posts big blind $0.10
LisInSky: sits out 
DimaLesnoy: sits out 
*** HOLE CARDS ***
KIIsSharkMan: folds 
JammesAngler: raises $0.15 to $0.25
Skiednis01: folds 
Sve_Sve93: folds 
Uncalled bet ($0.15) returned to JammesAngler
JammesAngler collected $0.25 from pot
JammesAngler: doesn't show hand 
*** SUMMARY ***
Total pot $0.25 | Rake $0 
Seat 1: Skiednis01 (small blind) folded before Flop
Seat 2: Sve_Sve93 (big blind) folded before Flop
Seat 5: KIIsSharkMan folded before Flop (didn't bet)
Seat 6: JammesAngler (button) collected ($0.25)



PokerStars Hand #222969158806:  Hold'em No Limit ($0.05/$0.10 USD) - 2021/01/23 15:26:12 ET
Table 'Bohlinia III' 6-max Seat #1 is the button
Seat 1: Skiednis01 ($14.17 in chips) 
Seat 2: Sve_Sve93 ($25.56 in chips) 
Seat 3: LisInSky ($10 in chips) 
Seat 5: KIIsSharkMan ($18.07 in chips) 
Seat 6: JammesAngler ($10.15 in chips) 
Sve_Sve93: posts small blind $0.05
LisInSky: posts big blind $0.10
DimaLesnoy: sits out 
*** HOLE CARDS ***
KIIsSharkMan: folds 
JammesAngler: folds 
Skiednis01: raises $0.15 to $0.25
Sve_Sve93: folds 
LisInSky: calls $0.15
*** FLOP *** [Tc 7d Qs]
LisInSky: checks 
Skiednis01: bets $0.27
LisInSky: raises $0.63 to $0.90
Skiednis01: calls $0.63
*** TURN *** [Tc 7d Qs] [6c]
LisInSky: checks 
Skiednis01: checks 
*** RIVER *** [Tc 7d Qs 6c] [Ad]
LisInSky: bets $1.68
Skiednis01: folds 
Uncalled bet ($1.68) returned to LisInSky
LisInSky collected $2.24 from pot
LisInSky: doesn't show hand 
*** SUMMARY ***
Total pot $2.35 | Rake $0.11 
Board [Tc 7d Qs 6c Ad]
Seat 1: Skiednis01 (button) folded on the River
Seat 2: Sve_Sve93 (small blind) folded before Flop
Seat 3: LisInSky (big blind) collected ($2.24)
Seat 5: KIIsSharkMan folded before Flop (didn't bet)
Seat 6: JammesAngler folded before Flop (didn't bet)



PokerStars Hand #222969206953:  Hold'em No Limit ($0.05/$0.10 USD) - 2021/01/23 15:27:09 ET
Table 'Bohlinia III' 6-max Seat #2 is the button
Seat 1: Skiednis01 ($13.02 in chips) 
Seat 2: Sve_Sve93 ($25.51 in chips) 
Seat 3: LisInSky ($11.09 in chips) 
Seat 4: DimaLesnoy ($10 in chips) 
Seat 5: KIIsSharkMan ($18.07 in chips) 
Seat 6: JammesAngler ($10.15 in chips) 
LisInSky: posts small blind $0.05
DimaLesnoy: posts big blind $0.10
*** HOLE CARDS ***
KIIsSharkMan: folds 
JammesAngler: folds 
Skiednis01: raises $0.15 to $0.25
Sve_Sve93: folds 
LisInSky: raises $0.75 to $1
DimaLesnoy: folds 
Skiednis01: folds 
Uncalled bet ($0.75) returned to LisInSky
LisInSky collected $0.60 from pot
LisInSky: doesn't show hand 
*** SUMMARY ***
Total pot $0.60 | Rake $0 
Seat 1: Skiednis01 folded before Flop
Seat 2: Sve_Sve93 (button) folded before Flop (didn't bet)
Seat 3: LisInSky (small blind) collected ($0.60)
Seat 4: DimaLesnoy (big blind) folded before Flop
Seat 5: KIIsSharkMan folded before Flop (didn't bet)
Seat 6: JammesAngler folded before Flop (didn't bet)



PokerStars Hand #222969226349:  Hold'em No Limit ($0.05/$0.10 USD) - 2021/01/23 15:27:31 ET
Table 'Bohlinia III' 6-max Seat #3 is the button
Seat 1: Skiednis01 ($12.77 in chips) 
Seat 2: Sve_Sve93 ($25.51 in chips) 
Seat 3: LisInSky ($11.44 in chips) 
Seat 4: DimaLesnoy ($10 in chips) 
Seat 5: KIIsSharkMan ($18.07 in chips) 
Seat 6: JammesAngler ($10.15 in chips) 
DimaLesnoy: posts small blind $0.05
KIIsSharkMan: posts big blind $0.10
*** HOLE CARDS ***
JammesAngler: folds 
Skiednis01: folds 
Sve_Sve93: folds 
LisInSky: raises $0.12 to $0.22
DimaLesnoy: folds 
KIIsSharkMan: raises $0.78 to $1
LisInSky: folds 
Uncalled bet ($0.78) returned to KIIsSharkMan
KIIsSharkMan collected $0.49 from pot
KIIsSharkMan: doesn't show hand 
*** SUMMARY ***
Total pot $0.49 | Rake $0 
Seat 1: Skiednis01 folded before Flop (didn't bet)
Seat 2: Sve_Sve93 folded before Flop (didn't bet)
Seat 3: LisInSky (button) folded before Flop
Seat 4: DimaLesnoy (small blind) folded before Flop
Seat 5: KIIsSharkMan (big blind) collected ($0.49)
Seat 6: JammesAngler folded before Flop (didn't bet)



PokerStars Hand #222969248711:  Hold'em No Limit ($0.05/$0.10 USD) - 2021/01/23 15:27:57 ET
Table 'Bohlinia III' 6-max Seat #4 is the button
Seat 1: Skiednis01 ($12.77 in chips) 
Seat 2: Sve_Sve93 ($25.51 in chips) 
Seat 3: LisInSky ($11.22 in chips) 
Seat 4: DimaLesnoy ($10 in chips) 
Seat 5: KIIsSharkMan ($18.34 in chips) 
Seat 6: JammesAngler ($10.15 in chips) 
KIIsSharkMan: posts small blind $0.05
JammesAngler: posts big blind $0.10
*** HOLE CARDS ***
Skiednis01: folds 
Sve_Sve93: folds 
LisInSky: folds 
DimaLesnoy: raises $0.12 to $0.22
KIIsSharkMan: folds 
JammesAngler: raises $0.78 to $1
DimaLesnoy: folds 
Uncalled bet ($0.78) returned to JammesAngler
JammesAngler collected $0.49 from pot
JammesAngler: doesn't show hand 
*** SUMMARY ***
Total pot $0.49 | Rake $0 
Seat 1: Skiednis01 folded before Flop (didn't bet)
Seat 2: Sve_Sve93 folded before Flop (didn't bet)
Seat 3: LisInSky folded before Flop (didn't bet)
Seat 4: DimaLesnoy (button) folded before Flop
Seat 5: KIIsSharkMan (small blind) folded before Flop
Seat 6: JammesAngler (big blind) collected ($0.49)



PokerStars Hand #222969261849:  Hold'em No Limit ($0.05/$0.10 USD) - 2021/01/23 15:28:13 ET
Table 'Bohlinia III' 6-max Seat #5 is the button
Seat 1: Skiednis01 ($12.77 in chips) 
Seat 2: Sve_Sve93 ($25.51 in chips) 
Seat 3: LisInSky ($11.22 in chips) 
Seat 4: DimaLesnoy ($10 in chips) 
Seat 5: KIIsSharkMan ($18.29 in chips) 
Seat 6: JammesAngler ($10.42 in chips) 
JammesAngler: posts small blind $0.05
Skiednis01: posts big blind $0.10
*** HOLE CARDS ***
Sve_Sve93: folds 
LisInSky: raises $0.15 to $0.25
DimaLesnoy: raises $0.50 to $0.75
KIIsSharkMan: folds 
JammesAngler: folds 
Skiednis01: folds 
LisInSky: folds 
Uncalled bet ($0.50) returned to DimaLesnoy
DimaLesnoy collected $0.65 from pot
DimaLesnoy: doesn't show hand 
*** SUMMARY ***
Total pot $0.65 | Rake $0 
Seat 1: Skiednis01 (big blind) folded before Flop
Seat 2: Sve_Sve93 folded before Flop (didn't bet)
Seat 3: LisInSky folded before Flop
Seat 4: DimaLesnoy collected ($0.65)
Seat 5: KIIsSharkMan (button) folded before Flop (didn't bet)
Seat 6: JammesAngler (small blind) folded before Flop



PokerStars Hand #222969278278:  Hold'em No Limit ($0.05/$0.10 USD) - 2021/01/23 15:28:32 ET
Table 'Bohlinia III' 6-max Seat #6 is the button
Seat 1: Skiednis01 ($12.67 in chips) 
Seat 2: Sve_Sve93 ($25.51 in chips) 
Seat 3: LisInSky ($10.97 in chips) 
Seat 4: DimaLesnoy ($10.40 in chips) 
Seat 5: KIIsSharkMan ($18.29 in chips) 
Seat 6: JammesAngler ($10.37 in chips) 
Skiednis01: posts small blind $0.05
Sve_Sve93: posts big blind $0.10
*** HOLE CARDS ***
LisInSky: raises $0.15 to $0.25
DimaLesnoy: calls $0.25
KIIsSharkMan: raises $0.90 to $1.15
JammesAngler: folds 
Skiednis01: folds 
Sve_Sve93: folds 
LisInSky: calls $0.90
DimaLesnoy: calls $0.90
*** FLOP *** [7d 9h 3h]
LisInSky: checks 
DimaLesnoy: checks 
KIIsSharkMan: bets $2.27
LisInSky: folds 
DimaLesnoy: calls $2.27
*** TURN *** [7d 9h 3h] [4s]
DimaLesnoy: checks 
KIIsSharkMan: bets $7.77
DimaLesnoy: calls $6.98 and is all-in
Uncalled bet ($0.79) returned to KIIsSharkMan
*** FIRST RIVER *** [7d 9h 3h 4s] [5h]
*** SECOND RIVER *** [7d 9h 3h 4s] [Th]
*** FIRST SHOW DOWN ***
DimaLesnoy: shows [7h 7c] (three of a kind, Sevens)
KIIsSharkMan: shows [Ac Qc] (high card Ace)
DimaLesnoy collected $10.56 from pot
*** SECOND SHOW DOWN ***
DimaLesnoy: shows [7h 7c] (three of a kind, Sevens)
KIIsSharkMan: shows [Ac Qc] (high card Ace)
DimaLesnoy collected $10.55 from pot
*** SUMMARY ***
Total pot $22.10 | Rake $0.99 
Hand was run twice
FIRST Board [7d 9h 3h 4s 5h]
SECOND Board [7d 9h 3h 4s Th]
Seat 1: Skiednis01 (small blind) folded before Flop
Seat 2: Sve_Sve93 (big blind) folded before Flop
Seat 3: LisInSky folded on the Flop
Seat 4: DimaLesnoy showed [7h 7c] and won ($10.56) with three of a kind, Sevens, and won ($10.55) with three of a kind, Sevens
Seat 5: KIIsSharkMan showed [Ac Qc] and lost with high card Ace, and lost with high card Ace
Seat 6: JammesAngler (button) folded before Flop (didn't bet)



PokerStars Hand #222969343853:  Hold'em No Limit ($0.05/$0.10 USD) - 2021/01/23 15:29:48 ET
Table 'Bohlinia III' 6-max Seat #1 is the button
Seat 1: Skiednis01 ($12.62 in chips) 
Seat 2: Sve_Sve93 ($25.41 in chips) 
Seat 3: LisInSky ($10 in chips) 
Seat 4: DimaLesnoy ($21.11 in chips) 
Seat 5: KIIsSharkMan ($7.89 in chips) 
Seat 6: JammesAngler ($10.37 in chips) 
Sve_Sve93: posts small blind $0.05
LisInSky: posts big blind $0.10
*** HOLE CARDS ***
DimaLesnoy: folds 
KIIsSharkMan: folds 
JammesAngler: raises $0.20 to $0.30
Skiednis01: folds 
Sve_Sve93: calls $0.25
LisInSky: folds 
*** FLOP *** [Jh 4c 5d]
Sve_Sve93: checks 
JammesAngler: checks 
*** TURN *** [Jh 4c 5d] [Td]
Sve_Sve93: checks 
JammesAngler: checks 
*** RIVER *** [Jh 4c 5d Td] [Jc]
Sve_Sve93: checks 
JammesAngler: checks 
*** SHOW DOWN ***
Sve_Sve93: shows [9h Ah] (a pair of Jacks)
JammesAngler: shows [7h 7d] (two pair, Jacks and Sevens)
JammesAngler collected $0.67 from pot
*** SUMMARY ***
Total pot $0.70 | Rake $0.03 
Board [Jh 4c 5d Td Jc]
Seat 1: Skiednis01 (button) folded before Flop (didn't bet)
Seat 2: Sve_Sve93 (small blind) showed [9h Ah] and lost with a pair of Jacks
Seat 3: LisInSky (big blind) folded before Flop
Seat 4: DimaLesnoy folded before Flop (didn't bet)
Seat 5: KIIsSharkMan folded before Flop (didn't bet)
Seat 6: JammesAngler showed [7h 7d] and won ($0.67) with two pair, Jacks and Sevens



PokerStars Hand #222969395590:  Hold'em No Limit ($0.05/$0.10 USD) - 2021/01/23 15:30:48 ET
Table 'Bohlinia III' 6-max Seat #2 is the button
Seat 1: Skiednis01 ($12.62 in chips) 
Seat 2: Sve_Sve93 ($25.11 in chips) 
Seat 3: LisInSky ($10 in chips) 
Seat 4: DimaLesnoy ($21.11 in chips) 
Seat 5: KIIsSharkMan ($10 in chips) 
Seat 6: JammesAngler ($10.74 in chips) 
LisInSky: posts small blind $0.05
DimaLesnoy: posts big blind $0.10
*** HOLE CARDS ***
KIIsSharkMan: folds 
JammesAngler: raises $0.20 to $0.30
Skiednis01: folds 
Sve_Sve93: folds 
LisInSky: folds 
DimaLesnoy: folds 
Uncalled bet ($0.20) returned to JammesAngler
JammesAngler collected $0.25 from pot
JammesAngler: doesn't show hand 
*** SUMMARY ***
Total pot $0.25 | Rake $0 
Seat 1: Skiednis01 folded before Flop (didn't bet)
Seat 2: Sve_Sve93 (button) folded before Flop (didn't bet)
Seat 3: LisInSky (small blind) folded before Flop
Seat 4: DimaLesnoy (big blind) folded before Flop
Seat 5: KIIsSharkMan folded before Flop (didn't bet)
Seat 6: JammesAngler collected ($0.25)



PokerStars Hand #222969408358:  Hold'em No Limit ($0.05/$0.10 USD) - 2021/01/23 15:31:03 ET
Table 'Bohlinia III' 6-max Seat #3 is the button
Seat 1: Skiednis01 ($12.62 in chips) 
Seat 2: Sve_Sve93 ($25.11 in chips) 
Seat 3: LisInSky ($10 in chips) 
Seat 4: DimaLesnoy ($21.01 in chips) 
Seat 5: KIIsSharkMan ($10 in chips) 
Seat 6: JammesAngler ($10.89 in chips) 
DimaLesnoy: posts small blind $0.05
KIIsSharkMan: posts big blind $0.10
*** HOLE CARDS ***
JammesAngler: folds 
Skiednis01: raises $0.15 to $0.25
Sve_Sve93: folds 
LisInSky: folds 
DimaLesnoy: folds 
KIIsSharkMan: folds 
Uncalled bet ($0.15) returned to Skiednis01
Skiednis01 collected $0.25 from pot
Skiednis01: doesn't show hand 
*** SUMMARY ***
Total pot $0.25 | Rake $0 
Seat 1: Skiednis01 collected ($0.25)
Seat 2: Sve_Sve93 folded before Flop (didn't bet)
Seat 3: LisInSky (button) folded before Flop (didn't bet)
Seat 4: DimaLesnoy (small blind) folded before Flop
Seat 5: KIIsSharkMan (big blind) folded before Flop
Seat 6: JammesAngler folded before Flop (didn't bet)



PokerStars Hand #222969428497:  Hold'em No Limit ($0.05/$0.10 USD) - 2021/01/23 15:31:13 ET
Table 'Bohlinia III' 6-max Seat #4 is the button
Seat 1: Skiednis01 ($12.77 in chips) 
Seat 2: Sve_Sve93 ($25.11 in chips) 
Seat 3: LisInSky ($10 in chips) 
Seat 4: DimaLesnoy ($20.96 in chips) 
Seat 5: KIIsSharkMan ($9.90 in chips) 
Seat 6: JammesAngler ($10.89 in chips) 
KIIsSharkMan: posts small blind $0.05
JammesAngler: posts big blind $0.10
*** HOLE CARDS ***
Skiednis01: folds 
Sve_Sve93: folds 
LisInSky: raises $0.15 to $0.25
DimaLesnoy: folds 
KIIsSharkMan: calls $0.20
JammesAngler: raises $0.95 to $1.20
LisInSky: folds 
KIIsSharkMan: calls $0.95
*** FLOP *** [6s Kd Qs]
KIIsSharkMan: checks 
JammesAngler: bets $1.97
KIIsSharkMan: calls $1.97
*** TURN *** [6s Kd Qs] [8h]
KIIsSharkMan: checks 
JammesAngler: bets $2.70
KIIsSharkMan: folds 
Uncalled bet ($2.70) returned to JammesAngler
JammesAngler collected $6.29 from pot
JammesAngler: doesn't show hand 
*** SUMMARY ***
Total pot $6.59 | Rake $0.30 
Board [6s Kd Qs 8h]
Seat 1: Skiednis01 folded before Flop (didn't bet)
Seat 2: Sve_Sve93 folded before Flop (didn't bet)
Seat 3: LisInSky folded before Flop
Seat 4: DimaLesnoy (button) folded before Flop (didn't bet)
Seat 5: KIIsSharkMan (small blind) folded on the Turn
Seat 6: JammesAngler (big blind) collected ($6.29)



PokerStars Hand #222969484677:  Hold'em No Limit ($0.05/$0.10 USD) - 2021/01/23 15:32:18 ET
Table 'Bohlinia III' 6-max Seat #5 is the button
Seat 1: Skiednis01 ($12.77 in chips) 
Seat 2: Sve_Sve93 ($25.11 in chips) 
Seat 3: LisInSky ($10 in chips) 
Seat 4: DimaLesnoy ($20.96 in chips) 
Seat 5: KIIsSharkMan ($6.73 in chips) 
Seat 6: JammesAngler ($14.01 in chips) 
JammesAngler: posts small blind $0.05
Skiednis01: posts big blind $0.10
*** HOLE CARDS ***
Sve_Sve93: folds 
LisInSky: folds 
DimaLesnoy: folds 
KIIsSharkMan: folds 
JammesAngler: raises $0.20 to $0.30
Skiednis01: raises $0.40 to $0.70
JammesAngler: folds 
Uncalled bet ($0.40) returned to Skiednis01
Skiednis01 collected $0.60 from pot
Skiednis01: doesn't show hand 
*** SUMMARY ***
Total pot $0.60 | Rake $0 
Seat 1: Skiednis01 (big blind) collected ($0.60)
Seat 2: Sve_Sve93 folded before Flop (didn't bet)
Seat 3: LisInSky folded before Flop (didn't bet)
Seat 4: DimaLesnoy folded before Flop (didn't bet)
Seat 5: KIIsSharkMan (button) folded before Flop (didn't bet)
Seat 6: JammesAngler (small blind) folded before Flop



PokerStars Hand #222969506186:  Hold'em No Limit ($0.05/$0.10 USD) - 2021/01/23 15:32:43 ET
Table 'Bohlinia III' 6-max Seat #6 is the button
Seat 1: Skiednis01 ($13.07 in chips) 
Seat 2: Sve_Sve93 ($25.11 in chips) 
Seat 3: LisInSky ($10 in chips) 
Seat 4: DimaLesnoy ($20.96 in chips) 
Seat 5: KIIsSharkMan ($10 in chips) 
Seat 6: JammesAngler ($13.71 in chips) 
Skiednis01: posts small blind $0.05
Sve_Sve93: posts big blind $0.10
*** HOLE CARDS ***
LisInSky: folds 
DimaLesnoy: folds 
KIIsSharkMan: raises $0.15 to $0.25
JammesAngler: folds 
Skiednis01: folds 
Sve_Sve93: folds 
Uncalled bet ($0.15) returned to KIIsSharkMan
KIIsSharkMan collected $0.25 from pot
KIIsSharkMan: doesn't show hand 
*** SUMMARY ***
Total pot $0.25 | Rake $0 
Seat 1: Skiednis01 (small blind) folded before Flop
Seat 2: Sve_Sve93 (big blind) folded before Flop
Seat 3: LisInSky folded before Flop (didn't bet)
Seat 4: DimaLesnoy folded before Flop (didn't bet)
Seat 5: KIIsSharkMan collected ($0.25)
Seat 6: JammesAngler (button) folded before Flop (didn't bet)



PokerStars Hand #222969520429:  Hold'em No Limit ($0.05/$0.10 USD) - 2021/01/23 15:32:59 ET
Table 'Bohlinia III' 6-max Seat #1 is the button
Seat 1: Skiednis01 ($13.02 in chips) 
Seat 2: Sve_Sve93 ($25.01 in chips) 
Seat 4: DimaLesnoy ($20.96 in chips) 
Seat 5: KIIsSharkMan ($10.15 in chips) 
Seat 6: JammesAngler ($13.71 in chips) 
Sve_Sve93: posts small blind $0.05
LisInSky: is sitting out 
DimaLesnoy: posts big blind $0.10
*** HOLE CARDS ***
KIIsSharkMan: raises $0.15 to $0.25
JammesAngler: folds 
LisInSky leaves the table
Skiednis01: calls $0.25
Sve_Sve93: calls $0.20
johnyspb1 joins the table at seat #3 
DimaLesnoy: folds 
*** FLOP *** [2d Jd Ah]
Sve_Sve93: checks 
KIIsSharkMan: checks 
Skiednis01: bets $0.41
Sve_Sve93: calls $0.41
KIIsSharkMan: calls $0.41
*** TURN *** [2d Jd Ah] [8h]
Sve_Sve93: checks 
KIIsSharkMan: checks 
Skiednis01: bets $1
Sve_Sve93: calls $1
KIIsSharkMan: folds 
*** RIVER *** [2d Jd Ah 8h] [4h]
Sve_Sve93: checks 
Skiednis01: bets $3.90
Sve_Sve93: raises $19.45 to $23.35 and is all-in
Skiednis01: folds 
Uncalled bet ($19.45) returned to Sve_Sve93
Sve_Sve93 collected $11.35 from pot
Sve_Sve93: doesn't show hand 
*** SUMMARY ***
Total pot $11.88 | Rake $0.53 
Board [2d Jd Ah 8h 4h]
Seat 1: Skiednis01 (button) folded on the River
Seat 2: Sve_Sve93 (small blind) collected ($11.35)
Seat 4: DimaLesnoy (big blind) folded before Flop
Seat 5: KIIsSharkMan folded on the Turn
Seat 6: JammesAngler folded before Flop (didn't bet)



PokerStars Hand #222969622602:  Hold'em No Limit ($0.05/$0.10 USD) - 2021/01/23 15:34:56 ET
Table 'Bohlinia III' 6-max Seat #2 is the button
Seat 1: Skiednis01 ($10 in chips) 
Seat 2: Sve_Sve93 ($30.80 in chips) 
Seat 4: DimaLesnoy ($20.86 in chips) 
Seat 5: KIIsSharkMan ($10 in chips) 
Seat 6: JammesAngler ($13.71 in chips) 
DimaLesnoy: posts small blind $0.05
KIIsSharkMan: posts big blind $0.10
*** HOLE CARDS ***
JammesAngler: folds 
Skiednis01: raises $0.15 to $0.25
Sve_Sve93: folds 
DimaLesnoy: folds 
KIIsSharkMan: folds 
Uncalled bet ($0.15) returned to Skiednis01
Skiednis01 collected $0.25 from pot
Skiednis01: doesn't show hand 
*** SUMMARY ***
Total pot $0.25 | Rake $0 
Seat 1: Skiednis01 collected ($0.25)
Seat 2: Sve_Sve93 (button) folded before Flop (didn't bet)
Seat 4: DimaLesnoy (small blind) folded before Flop
Seat 5: KIIsSharkMan (big blind) folded before Flop
Seat 6: JammesAngler folded before Flop (didn't bet)



PokerStars Hand #222969632103:  Hold'em No Limit ($0.05/$0.10 USD) - 2021/01/23 15:35:07 ET
Table 'Bohlinia III' 6-max Seat #4 is the button
Seat 1: Skiednis01 ($10.15 in chips) 
Seat 2: Sve_Sve93 ($30.80 in chips) 
Seat 3: johnyspb1 ($10 in chips) 
Seat 4: DimaLesnoy ($20.81 in chips) 
Seat 5: KIIsSharkMan ($9.90 in chips) 
Seat 6: JammesAngler ($13.71 in chips) 
KIIsSharkMan: posts small blind $0.05
JammesAngler: posts big blind $0.10
johnyspb1: posts big blind $0.10
*** HOLE CARDS ***
Skiednis01: folds 
Sve_Sve93: folds 
johnyspb1: checks 
DimaLesnoy: folds 
KIIsSharkMan: folds 
JammesAngler: checks 
*** FLOP *** [5h 5c 5d]
JammesAngler: checks 
johnyspb1: checks 
*** TURN *** [5h 5c 5d] [4s]
JammesAngler: checks 
johnyspb1: checks 
*** RIVER *** [5h 5c 5d 4s] [8c]
JammesAngler: bets $0.30
johnyspb1: folds 
Uncalled bet ($0.30) returned to JammesAngler
JammesAngler collected $0.24 from pot
JammesAngler: doesn't show hand 
*** SUMMARY ***
Total pot $0.25 | Rake $0.01 
Board [5h 5c 5d 4s 8c]
Seat 1: Skiednis01 folded before Flop (didn't bet)
Seat 2: Sve_Sve93 folded before Flop (didn't bet)
Seat 3: johnyspb1 folded on the River (didn't bet)
Seat 4: DimaLesnoy (button) folded before Flop (didn't bet)
Seat 5: KIIsSharkMan (small blind) folded before Flop
Seat 6: JammesAngler (big blind) collected ($0.24)



PokerStars Hand #222969673106:  Hold'em No Limit ($0.05/$0.10 USD) - 2021/01/23 15:35:55 ET
Table 'Bohlinia III' 6-max Seat #5 is the button
Seat 1: Skiednis01 ($10.15 in chips) 
Seat 2: Sve_Sve93 ($30.80 in chips) 
Seat 3: johnyspb1 ($10 in chips) 
Seat 4: DimaLesnoy ($20.81 in chips) 
Seat 5: KIIsSharkMan ($9.85 in chips) 
Seat 6: JammesAngler ($13.85 in chips) 
JammesAngler: posts small blind $0.05
Skiednis01: posts big blind $0.10
*** HOLE CARDS ***
Sve_Sve93: folds 
johnyspb1: folds 
DimaLesnoy: folds 
KIIsSharkMan: raises $0.20 to $0.30
JammesAngler: folds 
Skiednis01: folds 
Uncalled bet ($0.20) returned to KIIsSharkMan
KIIsSharkMan collected $0.25 from pot
KIIsSharkMan: doesn't show hand 
*** SUMMARY ***
Total pot $0.25 | Rake $0 
Seat 1: Skiednis01 (big blind) folded before Flop
Seat 2: Sve_Sve93 folded before Flop (didn't bet)
Seat 3: johnyspb1 folded before Flop (didn't bet)
Seat 4: DimaLesnoy folded before Flop (didn't bet)
Seat 5: KIIsSharkMan (button) collected ($0.25)
Seat 6: JammesAngler (small blind) folded before Flop



PokerStars Hand #222969696250:  Hold'em No Limit ($0.05/$0.10 USD) - 2021/01/23 15:36:23 ET
Table 'Bohlinia III' 6-max Seat #6 is the button
Seat 1: Skiednis01 ($10.05 in chips) 
Seat 2: Sve_Sve93 ($30.80 in chips) 
Seat 3: johnyspb1 ($10 in chips) 
Seat 4: DimaLesnoy ($20.81 in chips) 
Seat 5: KIIsSharkMan ($10 in chips) 
Seat 6: JammesAngler ($13.80 in chips) 
Skiednis01: posts small blind $0.05
Sve_Sve93: posts big blind $0.10
*** HOLE CARDS ***
johnyspb1: folds 
DimaLesnoy: raises $0.20 to $0.30
KIIsSharkMan: folds 
JammesAngler: raises $0.60 to $0.90
Skiednis01: folds 
Sve_Sve93: folds 
DimaLesnoy: calls $0.60
*** FLOP *** [Kd 8h 7s]
DimaLesnoy: checks 
JammesAngler: bets $1
DimaLesnoy: folds 
Uncalled bet ($1) returned to JammesAngler
JammesAngler collected $1.86 from pot
JammesAngler: doesn't show hand 
*** SUMMARY ***
Total pot $1.95 | Rake $0.09 
Board [Kd 8h 7s]
Seat 1: Skiednis01 (small blind) folded before Flop
Seat 2: Sve_Sve93 (big blind) folded before Flop
Seat 3: johnyspb1 folded before Flop (didn't bet)
Seat 4: DimaLesnoy folded on the Flop
Seat 5: KIIsSharkMan folded before Flop (didn't bet)
Seat 6: JammesAngler (button) collected ($1.86)



PokerStars Hand #222969717839:  Hold'em No Limit ($0.05/$0.10 USD) - 2021/01/23 15:36:48 ET
Table 'Bohlinia III' 6-max Seat #1 is the button
Seat 1: Skiednis01 ($10 in chips) 
Seat 2: Sve_Sve93 ($30.70 in chips) 
Seat 3: johnyspb1 ($10 in chips) 
Seat 4: DimaLesnoy ($19.91 in chips) 
Seat 5: KIIsSharkMan ($10 in chips) 
Seat 6: JammesAngler ($14.76 in chips) 
Sve_Sve93: posts small blind $0.05
johnyspb1: posts big blind $0.10
*** HOLE CARDS ***
DimaLesnoy: raises $0.20 to $0.30
KIIsSharkMan has timed out
KIIsSharkMan: folds 
JammesAngler: folds 
Skiednis01: folds 
Sve_Sve93: folds 
johnyspb1: calls $0.20
*** FLOP *** [Kh Js Td]
johnyspb1: checks 
DimaLesnoy: bets $0.27
johnyspb1: folds 
Uncalled bet ($0.27) returned to DimaLesnoy
DimaLesnoy collected $0.62 from pot
DimaLesnoy: doesn't show hand 
*** SUMMARY ***
Total pot $0.65 | Rake $0.03 
Board [Kh Js Td]
Seat 1: Skiednis01 (button) folded before Flop (didn't bet)
Seat 2: Sve_Sve93 (small blind) folded before Flop
Seat 3: johnyspb1 (big blind) folded on the Flop
Seat 4: DimaLesnoy collected ($0.62)
Seat 5: KIIsSharkMan folded before Flop (didn't bet)
Seat 6: JammesAngler folded before Flop (didn't bet)



PokerStars Hand #222969754098:  Hold'em No Limit ($0.05/$0.10 USD) - 2021/01/23 15:37:31 ET
Table 'Bohlinia III' 6-max Seat #2 is the button
Seat 1: Skiednis01 ($10 in chips) 
Seat 2: Sve_Sve93 ($30.65 in chips) 
Seat 3: johnyspb1 ($10 in chips) 
Seat 4: DimaLesnoy ($20.23 in chips) 
Seat 5: KIIsSharkMan ($10 in chips) 
Seat 6: JammesAngler ($14.76 in chips) 
johnyspb1: posts small blind $0.05
DimaLesnoy: posts big blind $0.10
*** HOLE CARDS ***
KIIsSharkMan: folds 
JammesAngler: raises $0.20 to $0.30
Skiednis01: calls $0.30
Sve_Sve93: folds 
johnyspb1: folds 
DimaLesnoy: folds 
*** FLOP *** [6d Ah 4c]
JammesAngler: bets $0.30
Skiednis01: calls $0.30
*** TURN *** [6d Ah 4c] [6s]
JammesAngler: checks 
Skiednis01: bets $0.65
JammesAngler: folds 
Uncalled bet ($0.65) returned to Skiednis01
Skiednis01 collected $1.29 from pot
Skiednis01: doesn't show hand 
*** SUMMARY ***
Total pot $1.35 | Rake $0.06 
Board [6d Ah 4c 6s]
Seat 1: Skiednis01 collected ($1.29)
Seat 2: Sve_Sve93 (button) folded before Flop (didn't bet)
Seat 3: johnyspb1 (small blind) folded before Flop
Seat 4: DimaLesnoy (big blind) folded before Flop
Seat 5: KIIsSharkMan folded before Flop (didn't bet)
Seat 6: JammesAngler folded on the Turn



PokerStars Hand #222969796572:  Hold'em No Limit ($0.05/$0.10 USD) - 2021/01/23 15:38:21 ET
Table 'Bohlinia III' 6-max Seat #3 is the button
Seat 1: Skiednis01 ($10.69 in chips) 
Seat 2: Sve_Sve93 ($30.65 in chips) 
Seat 3: johnyspb1 ($10 in chips) 
Seat 4: DimaLesnoy ($20.13 in chips) 
Seat 5: KIIsSharkMan ($10 in chips) 
Seat 6: JammesAngler ($14.16 in chips) 
DimaLesnoy: posts small blind $0.05
KIIsSharkMan: posts big blind $0.10
*** HOLE CARDS ***
JammesAngler: folds 
Skiednis01: folds 
Sve_Sve93: folds 
johnyspb1: folds 
DimaLesnoy: raises $0.20 to $0.30
KIIsSharkMan: folds 
Uncalled bet ($0.20) returned to DimaLesnoy
DimaLesnoy collected $0.20 from pot
DimaLesnoy: doesn't show hand 
*** SUMMARY ***
Total pot $0.20 | Rake $0 
Seat 1: Skiednis01 folded before Flop (didn't bet)
Seat 2: Sve_Sve93 folded before Flop (didn't bet)
Seat 3: johnyspb1 (button) folded before Flop (didn't bet)
Seat 4: DimaLesnoy (small blind) collected ($0.20)
Seat 5: KIIsSharkMan (big blind) folded before Flop
Seat 6: JammesAngler folded before Flop (didn't bet)



PokerStars Hand #222969812281:  Hold'em No Limit ($0.05/$0.10 USD) - 2021/01/23 15:38:39 ET
Table 'Bohlinia III' 6-max Seat #4 is the button
Seat 1: Skiednis01 ($10.69 in chips) 
Seat 2: Sve_Sve93 ($30.65 in chips) 
Seat 3: johnyspb1 ($10 in chips) 
Seat 4: DimaLesnoy ($20.23 in chips) 
Seat 5: KIIsSharkMan ($9.90 in chips) 
Seat 6: JammesAngler ($14.16 in chips) 
KIIsSharkMan: posts small blind $0.05
JammesAngler: posts big blind $0.10
*** HOLE CARDS ***
Skiednis01: folds 
Sve_Sve93: folds 
johnyspb1: folds 
DimaLesnoy: raises $0.12 to $0.22
KIIsSharkMan: folds 
JammesAngler: calls $0.12
*** FLOP *** [6s 8c 7s]
JammesAngler: checks 
DimaLesnoy: bets $0.20
JammesAngler: calls $0.20
*** TURN *** [6s 8c 7s] [6c]
JammesAngler: checks 
DimaLesnoy: bets $0.47
JammesAngler: calls $0.47
*** RIVER *** [6s 8c 7s 6c] [3d]
JammesAngler: checks 
DimaLesnoy: checks 
*** SHOW DOWN ***
JammesAngler: shows [5h 7h] (two pair, Sevens and Sixes)
DimaLesnoy: mucks hand 
JammesAngler collected $1.75 from pot
*** SUMMARY ***
Total pot $1.83 | Rake $0.08 
Board [6s 8c 7s 6c 3d]
Seat 1: Skiednis01 folded before Flop (didn't bet)
Seat 2: Sve_Sve93 folded before Flop (didn't bet)
Seat 3: johnyspb1 folded before Flop (didn't bet)
Seat 4: DimaLesnoy (button) mucked
Seat 5: KIIsSharkMan (small blind) folded before Flop
Seat 6: JammesAngler (big blind) showed [5h 7h] and won ($1.75) with two pair, Sevens and Sixes



PokerStars Hand #222969854699:  Hold'em No Limit ($0.05/$0.10 USD) - 2021/01/23 15:39:21 ET
Table 'Bohlinia III' 6-max Seat #5 is the button
Seat 1: Skiednis01 ($10.69 in chips) 
Seat 2: Sve_Sve93 ($30.65 in chips) 
Seat 3: johnyspb1 ($10 in chips) 
Seat 4: DimaLesnoy ($19.34 in chips) 
Seat 5: KIIsSharkMan ($9.85 in chips) 
Seat 6: JammesAngler ($15.02 in chips) 
JammesAngler: posts small blind $0.05
Skiednis01: posts big blind $0.10
*** HOLE CARDS ***
Sve_Sve93: folds 
johnyspb1: folds 
DimaLesnoy: folds 
KIIsSharkMan: folds 
JammesAngler: raises $0.20 to $0.30
Skiednis01: calls $0.20
*** FLOP *** [9c Ad 8c]
JammesAngler: bets $0.24
Skiednis01: calls $0.24
*** TURN *** [9c Ad 8c] [Kc]
JammesAngler: checks 
Skiednis01: bets $0.52
JammesAngler: calls $0.52
*** RIVER *** [9c Ad 8c Kc] [Js]
JammesAngler: checks 
Skiednis01: checks 
*** SHOW DOWN ***
JammesAngler: shows [Tc Kd] (a pair of Kings)
Skiednis01: mucks hand 
JammesAngler collected $2.02 from pot
*** SUMMARY ***
Total pot $2.12 | Rake $0.10 
Board [9c Ad 8c Kc Js]
Seat 1: Skiednis01 (big blind) mucked
Seat 2: Sve_Sve93 folded before Flop (didn't bet)
Seat 3: johnyspb1 folded before Flop (didn't bet)
Seat 4: DimaLesnoy folded before Flop (didn't bet)
Seat 5: KIIsSharkMan (button) folded before Flop (didn't bet)
Seat 6: JammesAngler (small blind) showed [Tc Kd] and won ($2.02) with a pair of Kings



PokerStars Hand #222969888497:  Hold'em No Limit ($0.05/$0.10 USD) - 2021/01/23 15:40:01 ET
Table 'Bohlinia III' 6-max Seat #6 is the button
Seat 1: Skiednis01 ($10 in chips) 
Seat 2: Sve_Sve93 ($30.65 in chips) 
Seat 3: johnyspb1 ($10 in chips) 
Seat 4: DimaLesnoy ($19.34 in chips) 
Seat 5: KIIsSharkMan ($9.85 in chips) 
Seat 6: JammesAngler ($15.98 in chips) 
Skiednis01: posts small blind $0.05
Sve_Sve93: posts big blind $0.10
*** HOLE CARDS ***
johnyspb1: folds 
DimaLesnoy: folds 
KIIsSharkMan: folds 
JammesAngler: folds 
Skiednis01: folds 
Uncalled bet ($0.05) returned to Sve_Sve93
Sve_Sve93 collected $0.10 from pot
Sve_Sve93: doesn't show hand 
*** SUMMARY ***
Total pot $0.10 | Rake $0 
Seat 1: Skiednis01 (small blind) folded before Flop
Seat 2: Sve_Sve93 (big blind) collected ($0.10)
Seat 3: johnyspb1 folded before Flop (didn't bet)
Seat 4: DimaLesnoy folded before Flop (didn't bet)
Seat 5: KIIsSharkMan folded before Flop (didn't bet)
Seat 6: JammesAngler (button) folded before Flop (didn't bet)



PokerStars Hand #222969899411:  Hold'em No Limit ($0.05/$0.10 USD) - 2021/01/23 15:40:14 ET
Table 'Bohlinia III' 6-max Seat #1 is the button
Seat 1: Skiednis01 ($10 in chips) 
Seat 2: Sve_Sve93 ($30.70 in chips) 
Seat 3: johnyspb1 ($10 in chips) 
Seat 4: DimaLesnoy ($19.34 in chips) 
Seat 5: KIIsSharkMan ($9.85 in chips) 
Seat 6: JammesAngler ($15.98 in chips) 
Sve_Sve93: posts small blind $0.05
johnyspb1: posts big blind $0.10
*** HOLE CARDS ***
DimaLesnoy: raises $0.20 to $0.30
KIIsSharkMan: folds 
JammesAngler: folds 
Skiednis01: folds 
Sve_Sve93: calls $0.25
johnyspb1: folds 
*** FLOP *** [4h 5s Qh]
Sve_Sve93: bets $0.34
DimaLesnoy: folds 
Uncalled bet ($0.34) returned to Sve_Sve93
Sve_Sve93 collected $0.67 from pot
Sve_Sve93: doesn't show hand 
*** SUMMARY ***
Total pot $0.70 | Rake $0.03 
Board [4h 5s Qh]
Seat 1: Skiednis01 (button) folded before Flop (didn't bet)
Seat 2: Sve_Sve93 (small blind) collected ($0.67)
Seat 3: johnyspb1 (big blind) folded before Flop
Seat 4: DimaLesnoy folded on the Flop
Seat 5: KIIsSharkMan folded before Flop (didn't bet)
Seat 6: JammesAngler folded before Flop (didn't bet)



PokerStars Hand #222969926784:  Hold'em No Limit ($0.05/$0.10 USD) - 2021/01/23 15:40:46 ET
Table 'Bohlinia III' 6-max Seat #2 is the button
Seat 1: Skiednis01 ($10 in chips) 
Seat 2: Sve_Sve93 ($31.07 in chips) 
Seat 3: johnyspb1 ($10 in chips) 
Seat 4: DimaLesnoy ($19.04 in chips) 
Seat 5: KIIsSharkMan ($10 in chips) 
Seat 6: JammesAngler ($15.98 in chips) 
johnyspb1: posts small blind $0.05
DimaLesnoy: posts big blind $0.10
*** HOLE CARDS ***
KIIsSharkMan: folds 
JammesAngler: folds 
Skiednis01: folds 
Sve_Sve93: folds 
johnyspb1: folds 
Uncalled bet ($0.05) returned to DimaLesnoy
DimaLesnoy collected $0.10 from pot
DimaLesnoy: doesn't show hand 
*** SUMMARY ***
Total pot $0.10 | Rake $0 
Seat 1: Skiednis01 folded before Flop (didn't bet)
Seat 2: Sve_Sve93 (button) folded before Flop (didn't bet)
Seat 3: johnyspb1 (small blind) folded before Flop
Seat 4: DimaLesnoy (big blind) collected ($0.10)
Seat 5: KIIsSharkMan folded before Flop (didn't bet)
Seat 6: JammesAngler folded before Flop (didn't bet)



PokerStars Hand #222969935093:  Hold'em No Limit ($0.05/$0.10 USD) - 2021/01/23 15:40:56 ET
Table 'Bohlinia III' 6-max Seat #3 is the button
Seat 1: Skiednis01 ($10 in chips) 
Seat 2: Sve_Sve93 ($31.07 in chips) 
Seat 3: johnyspb1 ($10 in chips) 
Seat 4: DimaLesnoy ($19.09 in chips) 
Seat 5: KIIsSharkMan ($10 in chips) 
Seat 6: JammesAngler ($15.98 in chips) 
DimaLesnoy: posts small blind $0.05
KIIsSharkMan: posts big blind $0.10
*** HOLE CARDS ***
JammesAngler: folds 
Skiednis01: folds 
Sve_Sve93: folds 
johnyspb1: folds 
DimaLesnoy: raises $0.20 to $0.30
KIIsSharkMan: raises $0.60 to $0.90
DimaLesnoy: calls $0.60
*** FLOP *** [Jh 5d 4d]
DimaLesnoy: checks 
KIIsSharkMan: bets $1.14
DimaLesnoy: folds 
Uncalled bet ($1.14) returned to KIIsSharkMan
KIIsSharkMan collected $1.72 from pot
KIIsSharkMan: doesn't show hand 
*** SUMMARY ***
Total pot $1.80 | Rake $0.08 
Board [Jh 5d 4d]
Seat 1: Skiednis01 folded before Flop (didn't bet)
Seat 2: Sve_Sve93 folded before Flop (didn't bet)
Seat 3: johnyspb1 (button) folded before Flop (didn't bet)
Seat 4: DimaLesnoy (small blind) folded on the Flop
Seat 5: KIIsSharkMan (big blind) collected ($1.72)
Seat 6: JammesAngler folded before Flop (didn't bet)



PokerStars Hand #222969963534:  Hold'em No Limit ($0.05/$0.10 USD) - 2021/01/23 15:41:30 ET
Table 'Bohlinia III' 6-max Seat #4 is the button
Seat 1: Skiednis01 ($10 in chips) 
Seat 2: Sve_Sve93 ($31.07 in chips) 
Seat 3: johnyspb1 ($10 in chips) 
Seat 4: DimaLesnoy ($18.19 in chips) 
Seat 5: KIIsSharkMan ($10.82 in chips) 
Seat 6: JammesAngler ($15.98 in chips) 
KIIsSharkMan: posts small blind $0.05
JammesAngler: posts big blind $0.10
*** HOLE CARDS ***
Skiednis01: folds 
Sve_Sve93: folds 
johnyspb1: folds 
DimaLesnoy: folds 
KIIsSharkMan: folds 
Uncalled bet ($0.05) returned to JammesAngler
JammesAngler collected $0.10 from pot
JammesAngler: doesn't show hand 
*** SUMMARY ***
Total pot $0.10 | Rake $0 
Seat 1: Skiednis01 folded before Flop (didn't bet)
Seat 2: Sve_Sve93 folded before Flop (didn't bet)
Seat 3: johnyspb1 folded before Flop (didn't bet)
Seat 4: DimaLesnoy (button) folded before Flop (didn't bet)
Seat 5: KIIsSharkMan (small blind) folded before Flop
Seat 6: JammesAngler (big blind) collected ($0.10)



PokerStars Hand #222969976605:  Hold'em No Limit ($0.05/$0.10 USD) - 2021/01/23 15:41:46 ET
Table 'Bohlinia III' 6-max Seat #5 is the button
Seat 1: Skiednis01 ($10 in chips) 
Seat 2: Sve_Sve93 ($31.07 in chips) 
Seat 3: johnyspb1 ($10 in chips) 
Seat 4: DimaLesnoy ($18.19 in chips) 
Seat 5: KIIsSharkMan ($10.77 in chips) 
Seat 6: JammesAngler ($16.03 in chips) 
JammesAngler: posts small blind $0.05
Skiednis01: posts big blind $0.10
*** HOLE CARDS ***
Sve_Sve93: folds 
johnyspb1: folds 
DimaLesnoy: raises $0.15 to $0.25
KIIsSharkMan: folds 
JammesAngler: folds 
Skiednis01: raises $0.45 to $0.70
DimaLesnoy: calls $0.45
*** FLOP *** [As Qs 3c]
Skiednis01: bets $0.69
DimaLesnoy: calls $0.69
*** TURN *** [As Qs 3c] [Td]
Skiednis01: bets $1.35
DimaLesnoy: calls $1.35
*** RIVER *** [As Qs 3c Td] [9c]
Skiednis01: checks 
DimaLesnoy: checks 
*** SHOW DOWN ***
Skiednis01: shows [Ah 6c] (a pair of Aces)
DimaLesnoy: shows [Ad Jd] (a pair of Aces - Queen+Jack kicker)
DimaLesnoy collected $5.28 from pot
*** SUMMARY ***
Total pot $5.53 | Rake $0.25 
Board [As Qs 3c Td 9c]
Seat 1: Skiednis01 (big blind) showed [Ah 6c] and lost with a pair of Aces
Seat 2: Sve_Sve93 folded before Flop (didn't bet)
Seat 3: johnyspb1 folded before Flop (didn't bet)
Seat 4: DimaLesnoy showed [Ad Jd] and won ($5.28) with a pair of Aces
Seat 5: KIIsSharkMan (button) folded before Flop (didn't bet)
Seat 6: JammesAngler (small blind) folded before Flop



PokerStars Hand #222970036814:  Hold'em No Limit ($0.05/$0.10 USD) - 2021/01/23 15:42:57 ET
Table 'Bohlinia III' 6-max Seat #6 is the button
Seat 1: Skiednis01 ($10 in chips) 
Seat 2: Sve_Sve93 ($31.07 in chips) 
Seat 3: johnyspb1 ($10 in chips) 
Seat 4: DimaLesnoy ($20.73 in chips) 
Seat 5: KIIsSharkMan ($10.77 in chips) 
Seat 6: JammesAngler ($15.98 in chips) 
Skiednis01: posts small blind $0.05
Sve_Sve93: posts big blind $0.10
*** HOLE CARDS ***
johnyspb1: folds 
DimaLesnoy: folds 
KIIsSharkMan: raises $0.15 to $0.25
JammesAngler: folds 
Skiednis01: folds 
Sve_Sve93: folds 
Uncalled bet ($0.15) returned to KIIsSharkMan
KIIsSharkMan collected $0.25 from pot
KIIsSharkMan: doesn't show hand 
*** SUMMARY ***
Total pot $0.25 | Rake $0 
Seat 1: Skiednis01 (small blind) folded before Flop
Seat 2: Sve_Sve93 (big blind) folded before Flop
Seat 3: johnyspb1 folded before Flop (didn't bet)
Seat 4: DimaLesnoy folded before Flop (didn't bet)
Seat 5: KIIsSharkMan collected ($0.25)
Seat 6: JammesAngler (button) folded before Flop (didn't bet)



PokerStars Hand #222970054669:  Hold'em No Limit ($0.05/$0.10 USD) - 2021/01/23 15:43:18 ET
Table 'Bohlinia III' 6-max Seat #1 is the button
Seat 1: Skiednis01 ($10 in chips) 
Seat 2: Sve_Sve93 ($30.97 in chips) 
Seat 3: johnyspb1 ($10 in chips) 
Seat 4: DimaLesnoy ($20.73 in chips) 
Seat 5: KIIsSharkMan ($10.92 in chips) 
Seat 6: JammesAngler ($15.98 in chips) 
Sve_Sve93: posts small blind $0.05
johnyspb1: posts big blind $0.10
*** HOLE CARDS ***
DimaLesnoy: folds 
KIIsSharkMan: folds 
JammesAngler: folds 
Skiednis01: folds 
Sve_Sve93: raises $0.10 to $0.20
johnyspb1: folds 
Uncalled bet ($0.10) returned to Sve_Sve93
Sve_Sve93 collected $0.20 from pot
Sve_Sve93: doesn't show hand 
*** SUMMARY ***
Total pot $0.20 | Rake $0 
Seat 1: Skiednis01 (button) folded before Flop (didn't bet)
Seat 2: Sve_Sve93 (small blind) collected ($0.20)
Seat 3: johnyspb1 (big blind) folded before Flop
Seat 4: DimaLesnoy folded before Flop (didn't bet)
Seat 5: KIIsSharkMan folded before Flop (didn't bet)
Seat 6: JammesAngler folded before Flop (didn't bet)



PokerStars Hand #222970067492:  Hold'em No Limit ($0.05/$0.10 USD) - 2021/01/23 15:43:33 ET
Table 'Bohlinia III' 6-max Seat #2 is the button
Seat 1: Skiednis01 ($10 in chips) 
Seat 2: Sve_Sve93 ($31.07 in chips) 
Seat 3: johnyspb1 ($10 in chips) 
Seat 4: DimaLesnoy ($20.73 in chips) 
Seat 5: KIIsSharkMan ($10.92 in chips) 
Seat 6: JammesAngler ($15.98 in chips) 
johnyspb1: posts small blind $0.05
DimaLesnoy: posts big blind $0.10
*** HOLE CARDS ***
KIIsSharkMan: raises $0.15 to $0.25
JammesAngler: folds 
Skiednis01: folds 
Sve_Sve93: folds 
johnyspb1: folds 
DimaLesnoy: folds 
Uncalled bet ($0.15) returned to KIIsSharkMan
KIIsSharkMan collected $0.25 from pot
KIIsSharkMan: doesn't show hand 
*** SUMMARY ***
Total pot $0.25 | Rake $0 
Seat 1: Skiednis01 folded before Flop (didn't bet)
Seat 2: Sve_Sve93 (button) folded before Flop (didn't bet)
Seat 3: johnyspb1 (small blind) folded before Flop
Seat 4: DimaLesnoy (big blind) folded before Flop
Seat 5: KIIsSharkMan collected ($0.25)
Seat 6: JammesAngler folded before Flop (didn't bet)



PokerStars Hand #222970077277:  Hold'em No Limit ($0.05/$0.10 USD) - 2021/01/23 15:43:45 ET
Table 'Bohlinia III' 6-max Seat #3 is the button
Seat 1: Skiednis01 ($10 in chips) 
Seat 2: Sve_Sve93 ($31.07 in chips) 
Seat 3: johnyspb1 ($10 in chips) 
Seat 4: DimaLesnoy ($20.63 in chips) 
Seat 5: KIIsSharkMan ($11.07 in chips) 
Seat 6: JammesAngler ($15.98 in chips) 
DimaLesnoy: posts small blind $0.05
KIIsSharkMan: posts big blind $0.10
*** HOLE CARDS ***
JammesAngler: folds 
Skiednis01: folds 
Sve_Sve93: folds 
johnyspb1: raises $0.15 to $0.25
DimaLesnoy: folds 
KIIsSharkMan: folds 
Uncalled bet ($0.15) returned to johnyspb1
johnyspb1 collected $0.25 from pot
johnyspb1: doesn't show hand 
*** SUMMARY ***
Total pot $0.25 | Rake $0 
Seat 1: Skiednis01 folded before Flop (didn't bet)
Seat 2: Sve_Sve93 folded before Flop (didn't bet)
Seat 3: johnyspb1 (button) collected ($0.25)
Seat 4: DimaLesnoy (small blind) folded before Flop
Seat 5: KIIsSharkMan (big blind) folded before Flop
Seat 6: JammesAngler folded before Flop (didn't bet)



PokerStars Hand #222970084648:  Hold'em No Limit ($0.05/$0.10 USD) - 2021/01/23 15:43:54 ET
Table 'Bohlinia III' 6-max Seat #4 is the button
Seat 1: Skiednis01 ($10 in chips) 
Seat 2: Sve_Sve93 ($31.07 in chips) 
Seat 3: johnyspb1 ($10.15 in chips) 
Seat 4: DimaLesnoy ($20.58 in chips) 
Seat 5: KIIsSharkMan ($10.97 in chips) 
Seat 6: JammesAngler ($15.98 in chips) 
KIIsSharkMan: posts small blind $0.05
JammesAngler: posts big blind $0.10
*** HOLE CARDS ***
Skiednis01: raises $0.15 to $0.25
Sve_Sve93: folds 
johnyspb1: folds 
DimaLesnoy: folds 
KIIsSharkMan: folds 
JammesAngler: folds 
Uncalled bet ($0.15) returned to Skiednis01
Skiednis01 collected $0.25 from pot
Skiednis01: doesn't show hand 
*** SUMMARY ***
Total pot $0.25 | Rake $0 
Seat 1: Skiednis01 collected ($0.25)
Seat 2: Sve_Sve93 folded before Flop (didn't bet)
Seat 3: johnyspb1 folded before Flop (didn't bet)
Seat 4: DimaLesnoy (button) folded before Flop (didn't bet)
Seat 5: KIIsSharkMan (small blind) folded before Flop
Seat 6: JammesAngler (big blind) folded before Flop



PokerStars Hand #222970105017:  Hold'em No Limit ($0.05/$0.10 USD) - 2021/01/23 15:44:18 ET
Table 'Bohlinia III' 6-max Seat #5 is the button
Seat 1: Skiednis01 ($10.15 in chips) 
Seat 2: Sve_Sve93 ($31.07 in chips) 
Seat 3: johnyspb1 ($10.15 in chips) 
Seat 4: DimaLesnoy ($20.58 in chips) 
Seat 5: KIIsSharkMan ($10.92 in chips) 
Seat 6: JammesAngler ($15.88 in chips) 
JammesAngler: posts small blind $0.05
Skiednis01: posts big blind $0.10
*** HOLE CARDS ***
Sve_Sve93: folds 
johnyspb1: folds 
DimaLesnoy: folds 
KIIsSharkMan: folds 
JammesAngler: folds 
Uncalled bet ($0.05) returned to Skiednis01
Skiednis01 collected $0.10 from pot
Skiednis01: doesn't show hand 
*** SUMMARY ***
Total pot $0.10 | Rake $0 
Seat 1: Skiednis01 (big blind) collected ($0.10)
Seat 2: Sve_Sve93 folded before Flop (didn't bet)
Seat 3: johnyspb1 folded before Flop (didn't bet)
Seat 4: DimaLesnoy folded before Flop (didn't bet)
Seat 5: KIIsSharkMan (button) folded before Flop (didn't bet)
Seat 6: JammesAngler (small blind) folded before Flop



PokerStars Hand #222970126999:  Hold'em No Limit ($0.05/$0.10 USD) - 2021/01/23 15:44:44 ET
Table 'Bohlinia III' 6-max Seat #6 is the button
Seat 1: Skiednis01 ($10.20 in chips) 
Seat 2: Sve_Sve93 ($31.07 in chips) 
Seat 3: johnyspb1 ($10.15 in chips) 
Seat 4: DimaLesnoy ($20.58 in chips) 
Seat 5: KIIsSharkMan ($10.92 in chips) 
Seat 6: JammesAngler ($15.83 in chips) 
Skiednis01: posts small blind $0.05
Sve_Sve93: posts big blind $0.10
*** HOLE CARDS ***
johnyspb1: folds 
DimaLesnoy: folds 
KIIsSharkMan: folds 
JammesAngler: folds 
Skiednis01: folds 
Uncalled bet ($0.05) returned to Sve_Sve93
Sve_Sve93 collected $0.10 from pot
Sve_Sve93: doesn't show hand 
*** SUMMARY ***
Total pot $0.10 | Rake $0 
Seat 1: Skiednis01 (small blind) folded before Flop
Seat 2: Sve_Sve93 (big blind) collected ($0.10)
Seat 3: johnyspb1 folded before Flop (didn't bet)
Seat 4: DimaLesnoy folded before Flop (didn't bet)
Seat 5: KIIsSharkMan folded before Flop (didn't bet)
Seat 6: JammesAngler (button) folded before Flop (didn't bet)



PokerStars Hand #222970133443:  Hold'em No Limit ($0.05/$0.10 USD) - 2021/01/23 15:44:52 ET
Table 'Bohlinia III' 6-max Seat #1 is the button
Seat 1: Skiednis01 ($10.15 in chips) 
Seat 2: Sve_Sve93 ($31.12 in chips) 
Seat 3: johnyspb1 ($10.15 in chips) 
Seat 4: DimaLesnoy ($20.58 in chips) 
Seat 5: KIIsSharkMan ($10.92 in chips) 
Seat 6: JammesAngler ($15.83 in chips) 
Sve_Sve93: posts small blind $0.05
johnyspb1: posts big blind $0.10
*** HOLE CARDS ***
DimaLesnoy: folds 
KIIsSharkMan has timed out
KIIsSharkMan: folds 
JammesAngler: folds 
Skiednis01: raises $0.15 to $0.25
Sve_Sve93: folds 
johnyspb1: folds 
Uncalled bet ($0.15) returned to Skiednis01
Skiednis01 collected $0.25 from pot
Skiednis01: doesn't show hand 
*** SUMMARY ***
Total pot $0.25 | Rake $0 
Seat 1: Skiednis01 (button) collected ($0.25)
Seat 2: Sve_Sve93 (small blind) folded before Flop
Seat 3: johnyspb1 (big blind) folded before Flop
Seat 4: DimaLesnoy folded before Flop (didn't bet)
Seat 5: KIIsSharkMan folded before Flop (didn't bet)
Seat 6: JammesAngler folded before Flop (didn't bet)



PokerStars Hand #222970151983:  Hold'em No Limit ($0.05/$0.10 USD) - 2021/01/23 15:45:14 ET
Table 'Bohlinia III' 6-max Seat #2 is the button
Seat 1: Skiednis01 ($10.30 in chips) 
Seat 2: Sve_Sve93 ($31.07 in chips) 
Seat 3: johnyspb1 ($10.05 in chips) 
Seat 4: DimaLesnoy ($20.58 in chips) 
Seat 5: KIIsSharkMan ($10.92 in chips) 
Seat 6: JammesAngler ($15.83 in chips) 
johnyspb1: posts small blind $0.05
DimaLesnoy: posts big blind $0.10
*** HOLE CARDS ***
KIIsSharkMan: folds 
JammesAngler: folds 
Skiednis01: raises $0.15 to $0.25
Sve_Sve93: calls $0.25
johnyspb1: raises $1.27 to $1.52
DimaLesnoy: folds 
Skiednis01: folds 
Sve_Sve93: folds 
Uncalled bet ($1.27) returned to johnyspb1
johnyspb1 collected $0.85 from pot
johnyspb1: doesn't show hand 
*** SUMMARY ***
Total pot $0.85 | Rake $0 
Seat 1: Skiednis01 folded before Flop
Seat 2: Sve_Sve93 (button) folded before Flop
Seat 3: johnyspb1 (small blind) collected ($0.85)
Seat 4: DimaLesnoy (big blind) folded before Flop
Seat 5: KIIsSharkMan folded before Flop (didn't bet)
Seat 6: JammesAngler folded before Flop (didn't bet)



PokerStars Hand #222970186429:  Hold'em No Limit ($0.05/$0.10 USD) - 2021/01/23 15:45:55 ET
Table 'Bohlinia III' 6-max Seat #3 is the button
Seat 1: Skiednis01 ($10.05 in chips) 
Seat 2: Sve_Sve93 ($30.82 in chips) 
Seat 3: johnyspb1 ($10.65 in chips) 
Seat 4: DimaLesnoy ($20.48 in chips) 
Seat 5: KIIsSharkMan ($10.92 in chips) 
Seat 6: JammesAngler ($15.83 in chips) 
DimaLesnoy: posts small blind $0.05
KIIsSharkMan: posts big blind $0.10
*** HOLE CARDS ***
JammesAngler: folds 
Skiednis01: folds 
Sve_Sve93: folds 
johnyspb1: raises $0.15 to $0.25
DimaLesnoy: folds 
KIIsSharkMan: folds 
Uncalled bet ($0.15) returned to johnyspb1
johnyspb1 collected $0.25 from pot
johnyspb1: doesn't show hand 
*** SUMMARY ***
Total pot $0.25 | Rake $0 
Seat 1: Skiednis01 folded before Flop (didn't bet)
Seat 2: Sve_Sve93 folded before Flop (didn't bet)
Seat 3: johnyspb1 (button) collected ($0.25)
Seat 4: DimaLesnoy (small blind) folded before Flop
Seat 5: KIIsSharkMan (big blind) folded before Flop
Seat 6: JammesAngler folded before Flop (didn't bet)



PokerStars Hand #222970211541:  Hold'em No Limit ($0.05/$0.10 USD) - 2021/01/23 15:46:24 ET
Table 'Bohlinia III' 6-max Seat #4 is the button
Seat 1: Skiednis01 ($10.05 in chips) 
Seat 2: Sve_Sve93 ($30.82 in chips) 
Seat 3: johnyspb1 ($10.80 in chips) 
Seat 4: DimaLesnoy ($20.43 in chips) 
Seat 5: KIIsSharkMan ($10.82 in chips) 
Seat 6: JammesAngler ($15.83 in chips) 
KIIsSharkMan: posts small blind $0.05
JammesAngler: posts big blind $0.10
*** HOLE CARDS ***
Skiednis01: folds 
Sve_Sve93: folds 
johnyspb1: folds 
DimaLesnoy: raises $0.12 to $0.22
KIIsSharkMan: folds 
JammesAngler: folds 
Uncalled bet ($0.12) returned to DimaLesnoy
DimaLesnoy collected $0.25 from pot
DimaLesnoy: doesn't show hand 
*** SUMMARY ***
Total pot $0.25 | Rake $0 
Seat 1: Skiednis01 folded before Flop (didn't bet)
Seat 2: Sve_Sve93 folded before Flop (didn't bet)
Seat 3: johnyspb1 folded before Flop (didn't bet)
Seat 4: DimaLesnoy (button) collected ($0.25)
Seat 5: KIIsSharkMan (small blind) folded before Flop
Seat 6: JammesAngler (big blind) folded before Flop



PokerStars Hand #222970221672:  Hold'em No Limit ($0.05/$0.10 USD) - 2021/01/23 15:46:37 ET
Table 'Bohlinia III' 6-max Seat #5 is the button
Seat 1: Skiednis01 ($10.05 in chips) 
Seat 2: Sve_Sve93 ($30.82 in chips) 
Seat 3: johnyspb1 ($10.80 in chips) 
Seat 4: DimaLesnoy ($20.58 in chips) 
Seat 5: KIIsSharkMan ($10.77 in chips) 
Seat 6: JammesAngler ($15.73 in chips) 
JammesAngler: posts small blind $0.05
Skiednis01: posts big blind $0.10
*** HOLE CARDS ***
Sve_Sve93: folds 
johnyspb1: folds 
DimaLesnoy: folds 
KIIsSharkMan: folds 
JammesAngler: raises $0.20 to $0.30
Skiednis01: folds 
Uncalled bet ($0.20) returned to JammesAngler
JammesAngler collected $0.20 from pot
JammesAngler: doesn't show hand 
*** SUMMARY ***
Total pot $0.20 | Rake $0 
Seat 1: Skiednis01 (big blind) folded before Flop
Seat 2: Sve_Sve93 folded before Flop (didn't bet)
Seat 3: johnyspb1 folded before Flop (didn't bet)
Seat 4: DimaLesnoy folded before Flop (didn't bet)
Seat 5: KIIsSharkMan (button) folded before Flop (didn't bet)
Seat 6: JammesAngler (small blind) collected ($0.20)



PokerStars Hand #222970232151:  Hold'em No Limit ($0.05/$0.10 USD) - 2021/01/23 15:46:49 ET
Table 'Bohlinia III' 6-max Seat #6 is the button
Seat 1: Skiednis01 ($10 in chips) 
Seat 3: johnyspb1 ($10.80 in chips) 
Seat 4: DimaLesnoy ($20.58 in chips) 
Seat 5: KIIsSharkMan ($10.77 in chips) 
Seat 6: JammesAngler ($15.83 in chips) 
Skiednis01: posts small blind $0.05
Sve_Sve93: is sitting out 
johnyspb1: posts big blind $0.10
*** HOLE CARDS ***
Sve_Sve93 leaves the table
DimaLesnoy: folds 
KIIsSharkMan: folds 
shtorman joins the table at seat #2 
JammesAngler: raises $0.15 to $0.25
Skiednis01: folds 
johnyspb1: folds 
Uncalled bet ($0.15) returned to JammesAngler
JammesAngler collected $0.25 from pot
JammesAngler: doesn't show hand 
*** SUMMARY ***
Total pot $0.25 | Rake $0 
Seat 1: Skiednis01 (small blind) folded before Flop
Seat 3: johnyspb1 (big blind) folded before Flop
Seat 4: DimaLesnoy folded before Flop (didn't bet)
Seat 5: KIIsSharkMan folded before Flop (didn't bet)
Seat 6: JammesAngler (button) collected ($0.25)



PokerStars Hand #222970247006:  Hold'em No Limit ($0.05/$0.10 USD) - 2021/01/23 15:47:07 ET
Table 'Bohlinia III' 6-max Seat #1 is the button
Seat 1: Skiednis01 ($10 in chips) 
Seat 3: johnyspb1 ($10.70 in chips) 
Seat 4: DimaLesnoy ($20.58 in chips) 
Seat 5: KIIsSharkMan ($10.77 in chips) 
Seat 6: JammesAngler ($15.98 in chips) 
johnyspb1: posts small blind $0.05
DimaLesnoy: posts big blind $0.10
*** HOLE CARDS ***
KIIsSharkMan: raises $0.15 to $0.25
JammesAngler: raises $0.65 to $0.90
Skiednis01: folds 
johnyspb1: folds 
DimaLesnoy: folds 
KIIsSharkMan: calls $0.65
*** FLOP *** [7d 3c 3s]
KIIsSharkMan: checks 
JammesAngler: checks 
*** TURN *** [7d 3c 3s] [6d]
KIIsSharkMan: bets $1.23
JammesAngler: folds 
Uncalled bet ($1.23) returned to KIIsSharkMan
KIIsSharkMan collected $1.86 from pot
KIIsSharkMan: doesn't show hand 
*** SUMMARY ***
Total pot $1.95 | Rake $0.09 
Board [7d 3c 3s 6d]
Seat 1: Skiednis01 (button) folded before Flop (didn't bet)
Seat 3: johnyspb1 (small blind) folded before Flop
Seat 4: DimaLesnoy (big blind) folded before Flop
Seat 5: KIIsSharkMan collected ($1.86)
Seat 6: JammesAngler folded on the Turn



PokerStars Hand #222970292349:  Hold'em No Limit ($0.05/$0.10 USD) - 2021/01/23 15:48:01 ET
Table 'Bohlinia III' 6-max Seat #3 is the button
Seat 1: Skiednis01 ($10 in chips) 
Seat 2: shtorman ($4.68 in chips) 
Seat 3: johnyspb1 ($10.65 in chips) 
Seat 4: DimaLesnoy ($20.48 in chips) 
Seat 6: JammesAngler ($15.08 in chips) 
DimaLesnoy: posts small blind $0.05
KIIsSharkMan: is sitting out 
JammesAngler: posts big blind $0.10
shtorman: posts big blind $0.10
*** HOLE CARDS ***
Skiednis01: raises $0.20 to $0.30
KIIsSharkMan leaves the table
shtorman: folds 
johnyspb1: folds 
4Skill joins the table at seat #5 
DimaLesnoy: folds 
JammesAngler: folds 
Uncalled bet ($0.20) returned to Skiednis01
Skiednis01 collected $0.35 from pot
Skiednis01: doesn't show hand 
*** SUMMARY ***
Total pot $0.35 | Rake $0 
Seat 1: Skiednis01 collected ($0.35)
Seat 2: shtorman folded before Flop (didn't bet)
Seat 3: johnyspb1 (button) folded before Flop (didn't bet)
Seat 4: DimaLesnoy (small blind) folded before Flop
Seat 6: JammesAngler (big blind) folded before Flop



PokerStars Hand #222970307446:  Hold'em No Limit ($0.05/$0.10 USD) - 2021/01/23 15:48:20 ET
Table 'Bohlinia III' 6-max Seat #4 is the button
Seat 1: Skiednis01 ($10.25 in chips) 
Seat 2: shtorman ($4.58 in chips) 
Seat 3: johnyspb1 ($10.65 in chips) 
Seat 4: DimaLesnoy ($20.43 in chips) 
Seat 6: JammesAngler ($14.98 in chips) 
JammesAngler: posts small blind $0.05
Skiednis01: posts big blind $0.10
*** HOLE CARDS ***
shtorman: folds 
johnyspb1: raises $0.20 to $0.30
DimaLesnoy: folds 
JammesAngler: folds 
Skiednis01: folds 
Uncalled bet ($0.20) returned to johnyspb1
johnyspb1 collected $0.25 from pot
johnyspb1: doesn't show hand 
*** SUMMARY ***
Total pot $0.25 | Rake $0 
Seat 1: Skiednis01 (big blind) folded before Flop
Seat 2: shtorman folded before Flop (didn't bet)
Seat 3: johnyspb1 collected ($0.25)
Seat 4: DimaLesnoy (button) folded before Flop (didn't bet)
Seat 6: JammesAngler (small blind) folded before Flop



PokerStars Hand #222970334315:  Hold'em No Limit ($0.05/$0.10 USD) - 2021/01/23 15:48:52 ET
Table 'Bohlinia III' 6-max Seat #6 is the button
Seat 1: Skiednis01 ($10.15 in chips) 
Seat 2: shtorman ($4.58 in chips) 
Seat 3: johnyspb1 ($10.80 in chips) 
Seat 4: DimaLesnoy ($20.43 in chips) 
Seat 6: JammesAngler ($14.93 in chips) 
Skiednis01: posts small blind $0.05
shtorman: posts big blind $0.10
4Skill: sits out 
*** HOLE CARDS ***
johnyspb1: folds 
DimaLesnoy: folds 
JammesAngler: raises $0.15 to $0.25
Skiednis01: folds 
shtorman: calls $0.15
*** FLOP *** [Ac 6s Ts]
shtorman: checks 
JammesAngler: bets $0.22
shtorman: calls $0.22
*** TURN *** [Ac 6s Ts] [4c]
shtorman: checks 
JammesAngler: checks 
*** RIVER *** [Ac 6s Ts 4c] [8h]
shtorman: bets $0.47
JammesAngler: folds 
Uncalled bet ($0.47) returned to shtorman
shtorman collected $0.95 from pot
shtorman: doesn't show hand 
*** SUMMARY ***
Total pot $0.99 | Rake $0.04 
Board [Ac 6s Ts 4c 8h]
Seat 1: Skiednis01 (small blind) folded before Flop
Seat 2: shtorman (big blind) collected ($0.95)
Seat 3: johnyspb1 folded before Flop (didn't bet)
Seat 4: DimaLesnoy folded before Flop (didn't bet)
Seat 6: JammesAngler (button) folded on the River



PokerStars Hand #222970378347:  Hold'em No Limit ($0.05/$0.10 USD) - 2021/01/23 15:49:45 ET
Table 'Bohlinia III' 6-max Seat #1 is the button
Seat 1: Skiednis01 ($10.10 in chips) 
Seat 2: shtorman ($5.06 in chips) 
Seat 3: johnyspb1 ($10.80 in chips) 
Seat 4: DimaLesnoy ($20.43 in chips) 
Seat 6: JammesAngler ($14.46 in chips) 
shtorman: posts small blind $0.05
johnyspb1: posts big blind $0.10
4Skill: sits out 
*** HOLE CARDS ***
DimaLesnoy: folds 
JammesAngler: raises $0.20 to $0.30
Skiednis01: calls $0.30
shtorman: folds 
johnyspb1: folds 
*** FLOP *** [6d 8d 8h]
JammesAngler: checks 
Skiednis01: checks 
*** TURN *** [6d 8d 8h] [5s]
JammesAngler: checks 
Skiednis01: bets $0.36
JammesAngler: folds 
Uncalled bet ($0.36) returned to Skiednis01
Skiednis01 collected $0.72 from pot
Skiednis01: doesn't show hand 
*** SUMMARY ***
Total pot $0.75 | Rake $0.03 
Board [6d 8d 8h 5s]
Seat 1: Skiednis01 (button) collected ($0.72)
Seat 2: shtorman (small blind) folded before Flop
Seat 3: johnyspb1 (big blind) folded before Flop
Seat 4: DimaLesnoy folded before Flop (didn't bet)
Seat 6: JammesAngler folded on the Turn



PokerStars Hand #222970411387:  Hold'em No Limit ($0.05/$0.10 USD) - 2021/01/23 15:50:24 ET
Table 'Bohlinia III' 6-max Seat #2 is the button
Seat 1: Skiednis01 ($10.52 in chips) 
Seat 2: shtorman ($5.01 in chips) 
Seat 3: johnyspb1 ($10.70 in chips) 
Seat 4: DimaLesnoy ($20.43 in chips) 
Seat 6: JammesAngler ($14.16 in chips) 
johnyspb1: posts small blind $0.05
DimaLesnoy: posts big blind $0.10
4Skill: sits out 
*** HOLE CARDS ***
JammesAngler: raises $0.20 to $0.30
Skiednis01: folds 
shtorman: calls $0.30
johnyspb1: folds 
DimaLesnoy: folds 
*** FLOP *** [Qh 9h 7h]
JammesAngler: bets $0.30
shtorman: calls $0.30
*** TURN *** [Qh 9h 7h] [4c]
JammesAngler: checks 
shtorman: checks 
*** RIVER *** [Qh 9h 7h 4c] [5s]
JammesAngler: checks 
shtorman: checks 
*** SHOW DOWN ***
JammesAngler: shows [8s 8h] (a pair of Eights)
shtorman: mucks hand 
JammesAngler collected $1.29 from pot
*** SUMMARY ***
Total pot $1.35 | Rake $0.06 
Board [Qh 9h 7h 4c 5s]
Seat 1: Skiednis01 folded before Flop (didn't bet)
Seat 2: shtorman (button) mucked
Seat 3: johnyspb1 (small blind) folded before Flop
Seat 4: DimaLesnoy (big blind) folded before Flop
Seat 6: JammesAngler showed [8s 8h] and won ($1.29) with a pair of Eights



PokerStars Hand #222970434961:  Hold'em No Limit ($0.05/$0.10 USD) - 2021/01/23 15:50:53 ET
Table 'Bohlinia III' 6-max Seat #3 is the button
Seat 1: Skiednis01 ($10.52 in chips) 
Seat 2: shtorman ($4.41 in chips) 
Seat 3: johnyspb1 ($10.65 in chips) 
Seat 4: DimaLesnoy ($20.33 in chips) 
Seat 5: 4Skill ($10.28 in chips) 
Seat 6: JammesAngler ($14.85 in chips) 
DimaLesnoy: posts small blind $0.05
4Skill: posts big blind $0.10
*** HOLE CARDS ***
JammesAngler: folds 
Skiednis01: raises $0.15 to $0.25
shtorman: folds 
johnyspb1: folds 
DimaLesnoy: folds 
4Skill: folds 
Uncalled bet ($0.15) returned to Skiednis01
Skiednis01 collected $0.25 from pot
Skiednis01: doesn't show hand 
*** SUMMARY ***
Total pot $0.25 | Rake $0 
Seat 1: Skiednis01 collected ($0.25)
Seat 2: shtorman folded before Flop (didn't bet)
Seat 3: johnyspb1 (button) folded before Flop (didn't bet)
Seat 4: DimaLesnoy (small blind) folded before Flop
Seat 5: 4Skill (big blind) folded before Flop
Seat 6: JammesAngler folded before Flop (didn't bet)



PokerStars Hand #222970453932:  Hold'em No Limit ($0.05/$0.10 USD) - 2021/01/23 15:51:16 ET
Table 'Bohlinia III' 6-max Seat #4 is the button
Seat 1: Skiednis01 ($10.67 in chips) 
Seat 2: shtorman ($4.41 in chips) 
Seat 3: johnyspb1 ($10.65 in chips) 
Seat 4: DimaLesnoy ($20.28 in chips) 
Seat 5: 4Skill ($10.18 in chips) 
Seat 6: JammesAngler ($14.85 in chips) 
4Skill: posts small blind $0.05
JammesAngler: posts big blind $0.10
*** HOLE CARDS ***
Skiednis01: folds 
shtorman: calls $0.10
johnyspb1: folds 
DimaLesnoy: raises $0.30 to $0.40
4Skill: folds 
JammesAngler: folds 
shtorman: calls $0.30
*** FLOP *** [Qh Qd 7d]
shtorman: checks 
DimaLesnoy: checks 
*** TURN *** [Qh Qd 7d] [2h]
shtorman: bets $0.45
DimaLesnoy: folds 
Uncalled bet ($0.45) returned to shtorman
shtorman collected $0.91 from pot
shtorman: doesn't show hand 
*** SUMMARY ***
Total pot $0.95 | Rake $0.04 
Board [Qh Qd 7d 2h]
Seat 1: Skiednis01 folded before Flop (didn't bet)
Seat 2: shtorman collected ($0.91)
Seat 3: johnyspb1 folded before Flop (didn't bet)
Seat 4: DimaLesnoy (button) folded on the Turn
Seat 5: 4Skill (small blind) folded before Flop
Seat 6: JammesAngler (big blind) folded before Flop



PokerStars Hand #222970522418:  Hold'em No Limit ($0.05/$0.10 USD) - 2021/01/23 15:52:37 ET
Table 'Bohlinia III' 6-max Seat #5 is the button
Seat 1: Skiednis01 ($10.67 in chips) 
Seat 2: shtorman ($4.92 in chips) 
Seat 3: johnyspb1 ($10.65 in chips) 
Seat 4: DimaLesnoy ($19.88 in chips) 
Seat 5: 4Skill ($10.13 in chips) 
Seat 6: JammesAngler ($14.75 in chips) 
JammesAngler: posts small blind $0.05
Skiednis01: posts big blind $0.10
*** HOLE CARDS ***
shtorman: folds 
johnyspb1: raises $0.20 to $0.30
DimaLesnoy: folds 
4Skill: folds 
JammesAngler: folds 
Skiednis01: folds 
Uncalled bet ($0.20) returned to johnyspb1
johnyspb1 collected $0.25 from pot
johnyspb1: doesn't show hand 
*** SUMMARY ***
Total pot $0.25 | Rake $0 
Seat 1: Skiednis01 (big blind) folded before Flop
Seat 2: shtorman folded before Flop (didn't bet)
Seat 3: johnyspb1 collected ($0.25)
Seat 4: DimaLesnoy folded before Flop (didn't bet)
Seat 5: 4Skill (button) folded before Flop (didn't bet)
Seat 6: JammesAngler (small blind) folded before Flop



PokerStars Hand #222970539829:  Hold'em No Limit ($0.05/$0.10 USD) - 2021/01/23 15:52:58 ET
Table 'Bohlinia III' 6-max Seat #6 is the button
Seat 1: Skiednis01 ($10.57 in chips) 
Seat 2: shtorman ($4.92 in chips) 
Seat 3: johnyspb1 ($10.80 in chips) 
Seat 4: DimaLesnoy ($19.88 in chips) 
Seat 5: 4Skill ($10.13 in chips) 
Seat 6: JammesAngler ($14.70 in chips) 
Skiednis01: posts small blind $0.05
shtorman: posts big blind $0.10
*** HOLE CARDS ***
johnyspb1: folds 
DimaLesnoy: folds 
4Skill: folds 
JammesAngler: raises $0.15 to $0.25
Skiednis01: folds 
shtorman: calls $0.15
*** FLOP *** [7d Tc Kd]
shtorman: checks 
JammesAngler: bets $0.41
shtorman: calls $0.41
*** TURN *** [7d Tc Kd] [Ah]
shtorman: checks 
JammesAngler: bets $1.57
shtorman: raises $2.69 to $4.26 and is all-in
JammesAngler: calls $2.69
JammesAngler has timed out
*** RIVER *** [7d Tc Kd Ah] [Qc]
*** SHOW DOWN ***
shtorman: shows [Js Qd] (a straight, Ten to Ace)
JammesAngler: shows [7c 7h] (three of a kind, Sevens)
shtorman collected $9.44 from pot
*** SUMMARY ***
Total pot $9.89 | Rake $0.45 
Board [7d Tc Kd Ah Qc]
Seat 1: Skiednis01 (small blind) folded before Flop
Seat 2: shtorman (big blind) showed [Js Qd] and won ($9.44) with a straight, Ten to Ace
Seat 3: johnyspb1 folded before Flop (didn't bet)
Seat 4: DimaLesnoy folded before Flop (didn't bet)
Seat 5: 4Skill folded before Flop (didn't bet)
Seat 6: JammesAngler (button) showed [7c 7h] and lost with three of a kind, Sevens



PokerStars Hand #222970600965:  Hold'em No Limit ($0.05/$0.10 USD) - 2021/01/23 15:54:12 ET
Table 'Bohlinia III' 6-max Seat #1 is the button
Seat 1: Skiednis01 ($10.52 in chips) 
Seat 2: shtorman ($9.44 in chips) 
Seat 3: johnyspb1 ($10.80 in chips) 
Seat 4: DimaLesnoy ($19.88 in chips) 
Seat 5: 4Skill ($10.13 in chips) 
Seat 6: JammesAngler ($10 in chips) 
shtorman: posts small blind $0.05
johnyspb1: posts big blind $0.10
*** HOLE CARDS ***
DimaLesnoy: folds 
4Skill: raises $0.20 to $0.30
JammesAngler: folds 
Skiednis01: folds 
shtorman: folds 
johnyspb1: calls $0.20
*** FLOP *** [Ah Kc 3s]
johnyspb1: checks 
4Skill: bets $0.31
johnyspb1: raises $0.47 to $0.78
4Skill: folds 
Uncalled bet ($0.47) returned to johnyspb1
johnyspb1 collected $1.21 from pot
johnyspb1: doesn't show hand 
*** SUMMARY ***
Total pot $1.27 | Rake $0.06 
Board [Ah Kc 3s]
Seat 1: Skiednis01 (button) folded before Flop (didn't bet)
Seat 2: shtorman (small blind) folded before Flop
Seat 3: johnyspb1 (big blind) collected ($1.21)
Seat 4: DimaLesnoy folded before Flop (didn't bet)
Seat 5: 4Skill folded on the Flop
Seat 6: JammesAngler folded before Flop (didn't bet)



PokerStars Hand #222970630634:  Hold'em No Limit ($0.05/$0.10 USD) - 2021/01/23 15:54:48 ET
Table 'Bohlinia III' 6-max Seat #2 is the button
Seat 1: Skiednis01 ($10.52 in chips) 
Seat 2: shtorman ($9.39 in chips) 
Seat 3: johnyspb1 ($11.40 in chips) 
Seat 4: DimaLesnoy ($19.88 in chips) 
Seat 5: 4Skill ($10 in chips) 
Seat 6: JammesAngler ($10 in chips) 
johnyspb1: posts small blind $0.05
DimaLesnoy: posts big blind $0.10
*** HOLE CARDS ***
4Skill: folds 
JammesAngler: folds 
Skiednis01: raises $0.15 to $0.25
shtorman: folds 
johnyspb1: raises $0.82 to $1.07
DimaLesnoy: folds 
Skiednis01: folds 
Uncalled bet ($0.82) returned to johnyspb1
johnyspb1 collected $0.60 from pot
johnyspb1: doesn't show hand 
*** SUMMARY ***
Total pot $0.60 | Rake $0 
Seat 1: Skiednis01 folded before Flop
Seat 2: shtorman (button) folded before Flop (didn't bet)
Seat 3: johnyspb1 (small blind) collected ($0.60)
Seat 4: DimaLesnoy (big blind) folded before Flop
Seat 5: 4Skill folded before Flop (didn't bet)
Seat 6: JammesAngler folded before Flop (didn't bet)



PokerStars Hand #222970657619:  Hold'em No Limit ($0.05/$0.10 USD) - 2021/01/23 15:55:26 ET
Table 'Bohlinia III' 6-max Seat #3 is the button
Seat 1: Skiednis01 ($10.27 in chips) 
Seat 2: shtorman ($9.39 in chips) 
Seat 3: johnyspb1 ($11.75 in chips) 
Seat 4: DimaLesnoy ($19.78 in chips) 
Seat 5: 4Skill ($10 in chips) 
Seat 6: JammesAngler ($10 in chips) 
DimaLesnoy: posts small blind $0.05
4Skill: posts big blind $0.10
*** HOLE CARDS ***
JammesAngler: folds 
Skiednis01: folds 
shtorman: calls $0.10
johnyspb1: folds 
DimaLesnoy: folds 
4Skill: checks 
*** FLOP *** [Ts Ac 5d]
4Skill: checks 
shtorman: bets $0.10
4Skill: folds 
Uncalled bet ($0.10) returned to shtorman
shtorman collected $0.24 from pot
shtorman: doesn't show hand 
*** SUMMARY ***
Total pot $0.25 | Rake $0.01 
Board [Ts Ac 5d]
Seat 1: Skiednis01 folded before Flop (didn't bet)
Seat 2: shtorman collected ($0.24)
Seat 3: johnyspb1 (button) folded before Flop (didn't bet)
Seat 4: DimaLesnoy (small blind) folded before Flop
Seat 5: 4Skill (big blind) folded on the Flop
Seat 6: JammesAngler folded before Flop (didn't bet)



PokerStars Hand #222970670888:  Hold'em No Limit ($0.05/$0.10 USD) - 2021/01/23 15:55:50 ET
Table 'Bohlinia III' 6-max Seat #4 is the button
Seat 1: Skiednis01 ($10.27 in chips) 
Seat 2: shtorman ($9.53 in chips) 
Seat 3: johnyspb1 ($11.75 in chips) 
Seat 4: DimaLesnoy ($19.73 in chips) 
Seat 5: 4Skill ($10 in chips) 
Seat 6: JammesAngler ($10 in chips) 
4Skill: posts small blind $0.05
JammesAngler: posts big blind $0.10
*** HOLE CARDS ***
Skiednis01: folds 
shtorman: calls $0.10
johnyspb1: folds 
DimaLesnoy: folds 
4Skill: calls $0.05
JammesAngler: raises $0.50 to $0.60
shtorman: calls $0.50
4Skill: folds 
*** FLOP *** [Ks Qd Ac]
JammesAngler: bets $0.97
shtorman: folds 
Uncalled bet ($0.97) returned to JammesAngler
JammesAngler collected $1.24 from pot
JammesAngler: doesn't show hand 
*** SUMMARY ***
Total pot $1.30 | Rake $0.06 
Board [Ks Qd Ac]
Seat 1: Skiednis01 folded before Flop (didn't bet)
Seat 2: shtorman folded on the Flop
Seat 3: johnyspb1 folded before Flop (didn't bet)
Seat 4: DimaLesnoy (button) folded before Flop (didn't bet)
Seat 5: 4Skill (small blind) folded before Flop
Seat 6: JammesAngler (big blind) collected ($1.24)



PokerStars Hand #222970700615:  Hold'em No Limit ($0.05/$0.10 USD) - 2021/01/23 15:56:34 ET
Table 'Bohlinia III' 6-max Seat #5 is the button
Seat 1: Skiednis01 ($10.27 in chips) 
Seat 2: shtorman ($8.93 in chips) 
Seat 3: johnyspb1 ($11.75 in chips) 
Seat 4: DimaLesnoy ($19.73 in chips) 
Seat 5: 4Skill ($10 in chips) 
Seat 6: JammesAngler ($10.64 in chips) 
JammesAngler: posts small blind $0.05
Skiednis01: posts big blind $0.10
*** HOLE CARDS ***
shtorman: folds 
johnyspb1: folds 
DimaLesnoy: folds 
4Skill: folds 
JammesAngler: folds 
Uncalled bet ($0.05) returned to Skiednis01
Skiednis01 collected $0.10 from pot
Skiednis01: doesn't show hand 
*** SUMMARY ***
Total pot $0.10 | Rake $0 
Seat 1: Skiednis01 (big blind) collected ($0.10)
Seat 2: shtorman folded before Flop (didn't bet)
Seat 3: johnyspb1 folded before Flop (didn't bet)
Seat 4: DimaLesnoy folded before Flop (didn't bet)
Seat 5: 4Skill (button) folded before Flop (didn't bet)
Seat 6: JammesAngler (small blind) folded before Flop



PokerStars Hand #222970716615:  Hold'em No Limit ($0.05/$0.10 USD) - 2021/01/23 15:57:02 ET
Table 'Bohlinia III' 6-max Seat #6 is the button
Seat 1: Skiednis01 ($10.32 in chips) 
Seat 2: shtorman ($8.93 in chips) 
Seat 3: johnyspb1 ($11.75 in chips) 
Seat 4: DimaLesnoy ($19.73 in chips) 
Seat 5: 4Skill ($10 in chips) 
Seat 6: JammesAngler ($10.59 in chips) 
Skiednis01: posts small blind $0.05
shtorman: posts big blind $0.10
*** HOLE CARDS ***
johnyspb1: folds 
DimaLesnoy: folds 
4Skill: raises $0.20 to $0.30
JammesAngler: folds 
Skiednis01: folds 
shtorman: folds 
Uncalled bet ($0.20) returned to 4Skill
4Skill collected $0.25 from pot
4Skill: doesn't show hand 
*** SUMMARY ***
Total pot $0.25 | Rake $0 
Seat 1: Skiednis01 (small blind) folded before Flop
Seat 2: shtorman (big blind) folded before Flop
Seat 3: johnyspb1 folded before Flop (didn't bet)
Seat 4: DimaLesnoy folded before Flop (didn't bet)
Seat 5: 4Skill collected ($0.25)
Seat 6: JammesAngler (button) folded before Flop (didn't bet)



PokerStars Hand #222970724682:  Hold'em No Limit ($0.05/$0.10 USD) - 2021/01/23 15:57:16 ET
Table 'Bohlinia III' 6-max Seat #1 is the button
Seat 1: Skiednis01 ($10.27 in chips) 
Seat 2: shtorman ($8.83 in chips) 
Seat 3: johnyspb1 ($11.75 in chips) 
Seat 4: DimaLesnoy ($19.73 in chips) 
Seat 5: 4Skill ($10.15 in chips) 
Seat 6: JammesAngler ($10.59 in chips) 
shtorman: posts small blind $0.05
johnyspb1: posts big blind $0.10
*** HOLE CARDS ***
DimaLesnoy: folds 
4Skill: folds 
JammesAngler: folds 
Skiednis01: raises $0.15 to $0.25
shtorman: folds 
johnyspb1: folds 
Uncalled bet ($0.15) returned to Skiednis01
Skiednis01 collected $0.25 from pot
Skiednis01: doesn't show hand 
*** SUMMARY ***
Total pot $0.25 | Rake $0 
Seat 1: Skiednis01 (button) collected ($0.25)
Seat 2: shtorman (small blind) folded before Flop
Seat 3: johnyspb1 (big blind) folded before Flop
Seat 4: DimaLesnoy folded before Flop (didn't bet)
Seat 5: 4Skill folded before Flop (didn't bet)
Seat 6: JammesAngler folded before Flop (didn't bet)



PokerStars Hand #222970733650:  Hold'em No Limit ($0.05/$0.10 USD) - 2021/01/23 15:57:32 ET
Table 'Bohlinia III' 6-max Seat #2 is the button
Seat 1: Skiednis01 ($10.42 in chips) 
Seat 2: shtorman ($8.78 in chips) 
Seat 3: johnyspb1 ($11.65 in chips) 
Seat 4: DimaLesnoy ($19.73 in chips) 
Seat 5: 4Skill ($10.15 in chips) 
Seat 6: JammesAngler ($10.59 in chips) 
johnyspb1: posts small blind $0.05
DimaLesnoy: posts big blind $0.10
*** HOLE CARDS ***
4Skill: folds 
JammesAngler: folds 
Skiednis01: raises $0.15 to $0.25
shtorman: calls $0.25
johnyspb1: folds 
DimaLesnoy: folds 
*** FLOP *** [Jd Ks 9d]
Skiednis01: bets $0.31
shtorman: calls $0.31
*** TURN *** [Jd Ks 9d] [Jh]
Skiednis01: checks 
shtorman: checks 
*** RIVER *** [Jd Ks 9d Jh] [3c]
Skiednis01: bets $0.61
shtorman: folds 
Uncalled bet ($0.61) returned to Skiednis01
Skiednis01 collected $1.21 from pot
Skiednis01: doesn't show hand 
*** SUMMARY ***
Total pot $1.27 | Rake $0.06 
Board [Jd Ks 9d Jh 3c]
Seat 1: Skiednis01 collected ($1.21)
Seat 2: shtorman (button) folded on the River
Seat 3: johnyspb1 (small blind) folded before Flop
Seat 4: DimaLesnoy (big blind) folded before Flop
Seat 5: 4Skill folded before Flop (didn't bet)
Seat 6: JammesAngler folded before Flop (didn't bet)



PokerStars Hand #222970758269:  Hold'em No Limit ($0.05/$0.10 USD) - 2021/01/23 15:58:15 ET
Table 'Bohlinia III' 6-max Seat #3 is the button
Seat 1: Skiednis01 ($11.07 in chips) 
Seat 2: shtorman ($8.22 in chips) 
Seat 3: johnyspb1 ($11.60 in chips) 
Seat 4: DimaLesnoy ($19.63 in chips) 
Seat 5: 4Skill ($10.15 in chips) 
Seat 6: JammesAngler ($10.59 in chips) 
DimaLesnoy: posts small blind $0.05
4Skill: posts big blind $0.10
*** HOLE CARDS ***
JammesAngler: raises $0.20 to $0.30
Skiednis01: calls $0.30
shtorman: folds 
johnyspb1: folds 
DimaLesnoy: folds 
4Skill: folds 
*** FLOP *** [4s 4c Ks]
JammesAngler: bets $0.30
Skiednis01: calls $0.30
*** TURN *** [4s 4c Ks] [Qc]
JammesAngler: checks 
Skiednis01: bets $0.65
JammesAngler: folds 
Uncalled bet ($0.65) returned to Skiednis01
Skiednis01 collected $1.29 from pot
Skiednis01: doesn't show hand 
*** SUMMARY ***
Total pot $1.35 | Rake $0.06 
Board [4s 4c Ks Qc]
Seat 1: Skiednis01 collected ($1.29)
Seat 2: shtorman folded before Flop (didn't bet)
Seat 3: johnyspb1 (button) folded before Flop (didn't bet)
Seat 4: DimaLesnoy (small blind) folded before Flop
Seat 5: 4Skill (big blind) folded before Flop
Seat 6: JammesAngler folded on the Turn



PokerStars Hand #222970786322:  Hold'em No Limit ($0.05/$0.10 USD) - 2021/01/23 15:59:04 ET
Table 'Bohlinia III' 6-max Seat #4 is the button
Seat 1: Skiednis01 ($11.76 in chips) 
Seat 2: shtorman ($8.22 in chips) 
Seat 3: johnyspb1 ($11.60 in chips) 
Seat 4: DimaLesnoy ($19.58 in chips) 
Seat 5: 4Skill ($10.05 in chips) 
Seat 6: JammesAngler ($10 in chips) 
4Skill: posts small blind $0.05
JammesAngler: posts big blind $0.10
*** HOLE CARDS ***
Skiednis01: folds 
shtorman: folds 
johnyspb1: raises $0.15 to $0.25
DimaLesnoy: raises $0.50 to $0.75
4Skill: folds 
JammesAngler: folds 
johnyspb1: calls $0.50
*** FLOP *** [Qh 3c Th]
johnyspb1: checks 
DimaLesnoy: bets $0.68
johnyspb1: folds 
Uncalled bet ($0.68) returned to DimaLesnoy
DimaLesnoy collected $1.58 from pot
DimaLesnoy: doesn't show hand 
*** SUMMARY ***
Total pot $1.65 | Rake $0.07 
Board [Qh 3c Th]
Seat 1: Skiednis01 folded before Flop (didn't bet)
Seat 2: shtorman folded before Flop (didn't bet)
Seat 3: johnyspb1 folded on the Flop
Seat 4: DimaLesnoy (button) collected ($1.58)
Seat 5: 4Skill (small blind) folded before Flop
Seat 6: JammesAngler (big blind) folded before Flop



PokerStars Hand #222970808671:  Hold'em No Limit ($0.05/$0.10 USD) - 2021/01/23 15:59:44 ET
Table 'Bohlinia III' 6-max Seat #5 is the button
Seat 1: Skiednis01 ($11.76 in chips) 
Seat 2: shtorman ($8.22 in chips) 
Seat 3: johnyspb1 ($10.85 in chips) 
Seat 4: DimaLesnoy ($20.41 in chips) 
Seat 5: 4Skill ($10 in chips) 
Seat 6: JammesAngler ($10 in chips) 
JammesAngler: posts small blind $0.05
Skiednis01: posts big blind $0.10
*** HOLE CARDS ***
shtorman: calls $0.10
johnyspb1: raises $0.30 to $0.40
DimaLesnoy: folds 
4Skill: folds 
JammesAngler: folds 
Skiednis01: calls $0.30
shtorman: calls $0.30
*** FLOP *** [2s Qd 7c]
Skiednis01: checks 
shtorman: checks 
johnyspb1: bets $1.19
Skiednis01: folds 
shtorman: folds 
Uncalled bet ($1.19) returned to johnyspb1
johnyspb1 collected $1.19 from pot
johnyspb1: doesn't show hand 
*** SUMMARY ***
Total pot $1.25 | Rake $0.06 
Board [2s Qd 7c]
Seat 1: Skiednis01 (big blind) folded on the Flop
Seat 2: shtorman folded on the Flop
Seat 3: johnyspb1 collected ($1.19)
Seat 4: DimaLesnoy folded before Flop (didn't bet)
Seat 5: 4Skill (button) folded before Flop (didn't bet)
Seat 6: JammesAngler (small blind) folded before Flop



PokerStars Hand #222970828935:  Hold'em No Limit ($0.05/$0.10 USD) - 2021/01/23 16:00:18 ET
Table 'Bohlinia III' 6-max Seat #6 is the button
Seat 1: Skiednis01 ($11.36 in chips) 
Seat 2: shtorman ($7.82 in chips) 
Seat 3: johnyspb1 ($11.64 in chips) 
Seat 4: DimaLesnoy ($20.41 in chips) 
Seat 5: 4Skill ($10 in chips) 
Seat 6: JammesAngler ($10 in chips) 
Skiednis01: posts small blind $0.05
shtorman: posts big blind $0.10
*** HOLE CARDS ***
johnyspb1: folds 
DimaLesnoy: folds 
4Skill: folds 
JammesAngler: raises $0.15 to $0.25
Skiednis01: folds 
shtorman: calls $0.15
*** FLOP *** [Qd 3d Th]
shtorman: checks 
JammesAngler: bets $0.22
shtorman: folds 
Uncalled bet ($0.22) returned to JammesAngler
JammesAngler collected $0.53 from pot
JammesAngler: doesn't show hand 
*** SUMMARY ***
Total pot $0.55 | Rake $0.02 
Board [Qd 3d Th]
Seat 1: Skiednis01 (small blind) folded before Flop
Seat 2: shtorman (big blind) folded on the Flop
Seat 3: johnyspb1 folded before Flop (didn't bet)
Seat 4: DimaLesnoy folded before Flop (didn't bet)
Seat 5: 4Skill folded before Flop (didn't bet)
Seat 6: JammesAngler (button) collected ($0.53)



PokerStars Hand #222970840813:  Hold'em No Limit ($0.05/$0.10 USD) - 2021/01/23 16:00:37 ET
Table 'Bohlinia III' 6-max Seat #1 is the button
Seat 1: Skiednis01 ($11.31 in chips) 
Seat 2: shtorman ($7.57 in chips) 
Seat 4: DimaLesnoy ($20.41 in chips) 
Seat 5: 4Skill ($10 in chips) 
Seat 6: JammesAngler ($10.28 in chips) 
shtorman: posts small blind $0.05
johnyspb1: is sitting out 
DimaLesnoy: posts big blind $0.10
*** HOLE CARDS ***
johnyspb1 leaves the table
pudge.3096 joins the table at seat #3 
4Skill: folds 
JammesAngler: raises $0.20 to $0.30
Skiednis01: folds 
shtorman: folds 
DimaLesnoy: folds 
Uncalled bet ($0.20) returned to JammesAngler
JammesAngler collected $0.25 from pot
JammesAngler: doesn't show hand 
*** SUMMARY ***
Total pot $0.25 | Rake $0 
Seat 1: Skiednis01 (button) folded before Flop (didn't bet)
Seat 2: shtorman (small blind) folded before Flop
Seat 4: DimaLesnoy (big blind) folded before Flop
Seat 5: 4Skill folded before Flop (didn't bet)
Seat 6: JammesAngler collected ($0.25)



PokerStars Hand #222970848396:  Hold'em No Limit ($0.05/$0.10 USD) - 2021/01/23 16:00:49 ET
Table 'Bohlinia III' 6-max Seat #2 is the button
Seat 1: Skiednis01 ($11.31 in chips) 
Seat 2: shtorman ($7.52 in chips) 
Seat 4: DimaLesnoy ($20.31 in chips) 
Seat 5: 4Skill ($10 in chips) 
Seat 6: JammesAngler ($10.43 in chips) 
DimaLesnoy: posts small blind $0.05
4Skill: posts big blind $0.10
*** HOLE CARDS ***
JammesAngler: folds 
Skiednis01: raises $0.15 to $0.25
shtorman: folds 
DimaLesnoy: folds 
4Skill: calls $0.15
*** FLOP *** [Qh 4s 8d]
4Skill: checks 
Skiednis01: bets $0.27
4Skill: calls $0.27
*** TURN *** [Qh 4s 8d] [Th]
4Skill: checks 
Skiednis01: bets $0.70
4Skill: calls $0.70
*** RIVER *** [Qh 4s 8d Th] [5c]
4Skill: checks 
Skiednis01: checks 
*** SHOW DOWN ***
4Skill: shows [Ts Qc] (two pair, Queens and Tens)
Skiednis01: mucks hand 
4Skill collected $2.38 from pot
*** SUMMARY ***
Total pot $2.49 | Rake $0.11 
Board [Qh 4s 8d Th 5c]
Seat 1: Skiednis01 mucked
Seat 2: shtorman (button) folded before Flop (didn't bet)
Seat 4: DimaLesnoy (small blind) folded before Flop
Seat 5: 4Skill (big blind) showed [Ts Qc] and won ($2.38) with two pair, Queens and Tens
Seat 6: JammesAngler folded before Flop (didn't bet)



PokerStars Hand #222970885065:  Hold'em No Limit ($0.05/$0.10 USD) - 2021/01/23 16:01:42 ET
Table 'Bohlinia III' 6-max Seat #4 is the button
Seat 1: Skiednis01 ($10.09 in chips) 
Seat 2: shtorman ($7.52 in chips) 
Seat 4: DimaLesnoy ($20.26 in chips) 
Seat 5: 4Skill ($11.16 in chips) 
Seat 6: JammesAngler ($10.43 in chips) 
4Skill: posts small blind $0.05
JammesAngler: posts big blind $0.10
pudge.3096: sits out 
*** HOLE CARDS ***
Skiednis01: folds 
shtorman: folds 
DimaLesnoy: raises $0.12 to $0.22
4Skill: calls $0.17
JammesAngler: folds 
*** FLOP *** [Qs 9d 3h]
4Skill: checks 
DimaLesnoy: bets $0.22
4Skill: calls $0.22
*** TURN *** [Qs 9d 3h] [8d]
4Skill: checks 
DimaLesnoy: checks 
*** RIVER *** [Qs 9d 3h 8d] [3c]
4Skill: bets $0.47
DimaLesnoy: raises $1.33 to $1.80
4Skill: folds 
Uncalled bet ($1.33) returned to DimaLesnoy
DimaLesnoy collected $1.83 from pot
DimaLesnoy: doesn't show hand 
*** SUMMARY ***
Total pot $1.92 | Rake $0.09 
Board [Qs 9d 3h 8d 3c]
Seat 1: Skiednis01 folded before Flop (didn't bet)
Seat 2: shtorman folded before Flop (didn't bet)
Seat 4: DimaLesnoy (button) collected ($1.83)
Seat 5: 4Skill (small blind) folded on the River
Seat 6: JammesAngler (big blind) folded before Flop



PokerStars Hand #222970938476:  Hold'em No Limit ($0.05/$0.10 USD) - 2021/01/23 16:02:50 ET
Table 'Bohlinia III' 6-max Seat #5 is the button
Seat 1: Skiednis01 ($10.09 in chips) 
Seat 2: shtorman ($7.52 in chips) 
Seat 4: DimaLesnoy ($21.18 in chips) 
Seat 5: 4Skill ($10.25 in chips) 
Seat 6: JammesAngler ($10.33 in chips) 
JammesAngler: posts small blind $0.05
Skiednis01: posts big blind $0.10
pudge.3096: sits out 
*** HOLE CARDS ***
shtorman: folds 
DimaLesnoy: folds 
4Skill: folds 
JammesAngler: raises $0.20 to $0.30
Skiednis01: calls $0.20
*** FLOP *** [9s 3c 2h]
JammesAngler: bets $0.24
Skiednis01: calls $0.24
*** TURN *** [9s 3c 2h] [8h]
JammesAngler: checks 
Skiednis01: bets $0.52
JammesAngler: calls $0.52
*** RIVER *** [9s 3c 2h 8h] [6c]
JammesAngler: checks 
Skiednis01: checks 
*** SHOW DOWN ***
JammesAngler: shows [4s As] (high card Ace)
Skiednis01: shows [3h Ks] (a pair of Threes)
Skiednis01 collected $2.02 from pot
*** SUMMARY ***
Total pot $2.12 | Rake $0.10 
Board [9s 3c 2h 8h 6c]
Seat 1: Skiednis01 (big blind) showed [3h Ks] and won ($2.02) with a pair of Threes
Seat 2: shtorman folded before Flop (didn't bet)
Seat 4: DimaLesnoy folded before Flop (didn't bet)
Seat 5: 4Skill (button) folded before Flop (didn't bet)
Seat 6: JammesAngler (small blind) showed [4s As] and lost with high card Ace



PokerStars Hand #222970979190:  Hold'em No Limit ($0.05/$0.10 USD) - 2021/01/23 16:03:41 ET
Table 'Bohlinia III' 6-max Seat #6 is the button
Seat 1: Skiednis01 ($11.05 in chips) 
Seat 2: shtorman ($7.52 in chips) 
Seat 4: DimaLesnoy ($21.18 in chips) 
Seat 5: 4Skill ($10.25 in chips) 
Seat 6: JammesAngler ($10 in chips) 
Skiednis01: posts small blind $0.05
shtorman: posts big blind $0.10
pudge.3096: sits out 
*** HOLE CARDS ***
DimaLesnoy: folds 
4Skill: raises $0.20 to $0.30
JammesAngler: folds 
Skiednis01: folds 
shtorman: calls $0.20
*** FLOP *** [4h 5s 4d]
shtorman: bets $0.31
4Skill: folds 
Uncalled bet ($0.31) returned to shtorman
shtorman collected $0.62 from pot
shtorman: doesn't show hand 
*** SUMMARY ***
Total pot $0.65 | Rake $0.03 
Board [4h 5s 4d]
Seat 1: Skiednis01 (small blind) folded before Flop
Seat 2: shtorman (big blind) collected ($0.62)
Seat 4: DimaLesnoy folded before Flop (didn't bet)
Seat 5: 4Skill folded on the Flop
Seat 6: JammesAngler (button) folded before Flop (didn't bet)



PokerStars Hand #222970997774:  Hold'em No Limit ($0.05/$0.10 USD) - 2021/01/23 16:04:02 ET
Table 'Bohlinia III' 6-max Seat #1 is the button
Seat 1: Skiednis01 ($11 in chips) 
Seat 2: shtorman ($7.84 in chips) 
Seat 3: pudge.3096 ($10 in chips) 
Seat 4: DimaLesnoy ($21.18 in chips) 
Seat 5: 4Skill ($10 in chips) 
Seat 6: JammesAngler ($10 in chips) 
shtorman: posts small blind $0.05
pudge.3096: posts big blind $0.10
*** HOLE CARDS ***
DimaLesnoy: raises $0.20 to $0.30
4Skill: folds 
JammesAngler: folds 
Skiednis01: folds 
shtorman: folds 
pudge.3096: calls $0.20
*** FLOP *** [2c 7d Qd]
pudge.3096: checks 
DimaLesnoy: checks 
*** TURN *** [2c 7d Qd] [9d]
pudge.3096: checks 
DimaLesnoy: checks 
*** RIVER *** [2c 7d Qd 9d] [4c]
pudge.3096: checks 
DimaLesnoy: checks 
*** SHOW DOWN ***
pudge.3096: shows [Ah Td] (high card Ace)
DimaLesnoy: mucks hand 
pudge.3096 collected $0.62 from pot
*** SUMMARY ***
Total pot $0.65 | Rake $0.03 
Board [2c 7d Qd 9d 4c]
Seat 1: Skiednis01 (button) folded before Flop (didn't bet)
Seat 2: shtorman (small blind) folded before Flop
Seat 3: pudge.3096 (big blind) showed [Ah Td] and won ($0.62) with high card Ace
Seat 4: DimaLesnoy mucked
Seat 5: 4Skill folded before Flop (didn't bet)
Seat 6: JammesAngler folded before Flop (didn't bet)



PokerStars Hand #222971022328:  Hold'em No Limit ($0.05/$0.10 USD) - 2021/01/23 16:04:32 ET
Table 'Bohlinia III' 6-max Seat #2 is the button
Seat 1: Skiednis01 ($11 in chips) 
Seat 2: shtorman ($7.79 in chips) 
Seat 3: pudge.3096 ($10.32 in chips) 
Seat 4: DimaLesnoy ($20.88 in chips) 
Seat 5: 4Skill ($10 in chips) 
Seat 6: JammesAngler ($10 in chips) 
pudge.3096: posts small blind $0.05
DimaLesnoy: posts big blind $0.10
*** HOLE CARDS ***
4Skill: folds 
JammesAngler: folds 
Skiednis01: raises $0.15 to $0.25
shtorman: folds 
pudge.3096: folds 
DimaLesnoy: folds 
Uncalled bet ($0.15) returned to Skiednis01
Skiednis01 collected $0.25 from pot
Skiednis01: doesn't show hand 
*** SUMMARY ***
Total pot $0.25 | Rake $0 
Seat 1: Skiednis01 collected ($0.25)
Seat 2: shtorman (button) folded before Flop (didn't bet)
Seat 3: pudge.3096 (small blind) folded before Flop
Seat 4: DimaLesnoy (big blind) folded before Flop
Seat 5: 4Skill folded before Flop (didn't bet)
Seat 6: JammesAngler folded before Flop (didn't bet)



PokerStars Hand #222971040787:  Hold'em No Limit ($0.05/$0.10 USD) - 2021/01/23 16:04:54 ET
Table 'Bohlinia III' 6-max Seat #3 is the button
Seat 1: Skiednis01 ($11.15 in chips) 
Seat 2: shtorman ($7.79 in chips) 
Seat 3: pudge.3096 ($10.27 in chips) 
Seat 4: DimaLesnoy ($20.78 in chips) 
Seat 5: 4Skill ($10 in chips) 
Seat 6: JammesAngler ($10 in chips) 
DimaLesnoy: posts small blind $0.05
4Skill: posts big blind $0.10
*** HOLE CARDS ***
JammesAngler: folds 
Skiednis01: folds 
shtorman: folds 
pudge.3096: folds 
DimaLesnoy: raises $0.20 to $0.30
4Skill: raises $0.60 to $0.90
DimaLesnoy: folds 
Uncalled bet ($0.60) returned to 4Skill
4Skill collected $0.60 from pot
4Skill: doesn't show hand 
*** SUMMARY ***
Total pot $0.60 | Rake $0 
Seat 1: Skiednis01 folded before Flop (didn't bet)
Seat 2: shtorman folded before Flop (didn't bet)
Seat 3: pudge.3096 (button) folded before Flop (didn't bet)
Seat 4: DimaLesnoy (small blind) folded before Flop
Seat 5: 4Skill (big blind) collected ($0.60)
Seat 6: JammesAngler folded before Flop (didn't bet)



PokerStars Hand #222971052728:  Hold'em No Limit ($0.05/$0.10 USD) - 2021/01/23 16:05:08 ET
Table 'Bohlinia III' 6-max Seat #4 is the button
Seat 1: Skiednis01 ($11.15 in chips) 
Seat 2: shtorman ($7.79 in chips) 
Seat 3: pudge.3096 ($10.27 in chips) 
Seat 4: DimaLesnoy ($20.48 in chips) 
Seat 5: 4Skill ($10.30 in chips) 
Seat 6: JammesAngler ($10 in chips) 
4Skill: posts small blind $0.05
JammesAngler: posts big blind $0.10
*** HOLE CARDS ***
Skiednis01: folds 
shtorman: calls $0.10
pudge.3096: folds 
DimaLesnoy: folds 
4Skill: calls $0.05
JammesAngler: checks 
*** FLOP *** [Ah 2d 3d]
4Skill: checks 
JammesAngler: checks 
shtorman: bets $0.14
4Skill: calls $0.14
JammesAngler: calls $0.14
*** TURN *** [Ah 2d 3d] [9d]
4Skill: checks 
JammesAngler: checks 
shtorman: bets $0.69
4Skill: folds 
JammesAngler: calls $0.69
*** RIVER *** [Ah 2d 3d 9d] [7h]
JammesAngler: checks 
shtorman: bets $2.01
JammesAngler: calls $2.01
*** SHOW DOWN ***
shtorman: shows [Js Ac] (a pair of Aces)
JammesAngler: mucks hand 
shtorman collected $5.84 from pot
*** SUMMARY ***
Total pot $6.12 | Rake $0.28 
Board [Ah 2d 3d 9d 7h]
Seat 1: Skiednis01 folded before Flop (didn't bet)
Seat 2: shtorman showed [Js Ac] and won ($5.84) with a pair of Aces
Seat 3: pudge.3096 folded before Flop (didn't bet)
Seat 4: DimaLesnoy (button) folded before Flop (didn't bet)
Seat 5: 4Skill (small blind) folded on the Turn
Seat 6: JammesAngler (big blind) mucked



PokerStars Hand #222971117543:  Hold'em No Limit ($0.05/$0.10 USD) - 2021/01/23 16:06:26 ET
Table 'Bohlinia III' 6-max Seat #5 is the button
Seat 1: Skiednis01 ($11.15 in chips) 
Seat 2: shtorman ($10.69 in chips) 
Seat 3: pudge.3096 ($10.27 in chips) 
Seat 4: DimaLesnoy ($20.48 in chips) 
Seat 5: 4Skill ($10.06 in chips) 
Seat 6: JammesAngler ($10 in chips) 
JammesAngler: posts small blind $0.05
Skiednis01: posts big blind $0.10
*** HOLE CARDS ***
shtorman: calls $0.10
pudge.3096: raises $0.40 to $0.50
DimaLesnoy: folds 
4Skill: folds 
JammesAngler: folds 
Skiednis01: folds 
shtorman: calls $0.40
*** FLOP *** [7c Qc 9s]
shtorman: checks 
pudge.3096: bets $0.55
shtorman: calls $0.55
*** TURN *** [7c Qc 9s] [3d]
shtorman: checks 
pudge.3096: bets $1.61
shtorman: calls $1.61
*** RIVER *** [7c Qc 9s 3d] [3c]
shtorman: checks 
pudge.3096: bets $4.20
shtorman: raises $3.83 to $8.03 and is all-in
pudge.3096: calls $3.41 and is all-in
Uncalled bet ($0.42) returned to shtorman
*** SHOW DOWN ***
shtorman: shows [9d 9h] (a full house, Nines full of Threes)
pudge.3096: shows [Kc Tc] (a flush, King high)
shtorman collected $19.76 from pot
*** SUMMARY ***
Total pot $20.69 | Rake $0.93 
Board [7c Qc 9s 3d 3c]
Seat 1: Skiednis01 (big blind) folded before Flop
Seat 2: shtorman showed [9d 9h] and won ($19.76) with a full house, Nines full of Threes
Seat 3: pudge.3096 showed [Kc Tc] and lost with a flush, King high
Seat 4: DimaLesnoy folded before Flop (didn't bet)
Seat 5: 4Skill (button) folded before Flop (didn't bet)
Seat 6: JammesAngler (small blind) folded before Flop



PokerStars Hand #222971183694:  Hold'em No Limit ($0.05/$0.10 USD) - 2021/01/23 16:07:45 ET
Table 'Bohlinia III' 6-max Seat #6 is the button
Seat 1: Skiednis01 ($11.05 in chips) 
Seat 2: shtorman ($20.18 in chips) 
Seat 3: pudge.3096 ($10 in chips) 
Seat 4: DimaLesnoy ($20.48 in chips) 
Seat 5: 4Skill ($10.06 in chips) 
Seat 6: JammesAngler ($10 in chips) 
Skiednis01: posts small blind $0.05
shtorman: posts big blind $0.10
*** HOLE CARDS ***
pudge.3096: folds 
DimaLesnoy: folds 
4Skill: raises $0.20 to $0.30
JammesAngler: raises $0.60 to $0.90
Skiednis01: folds 
shtorman: folds 
4Skill: folds 
Uncalled bet ($0.60) returned to JammesAngler
JammesAngler collected $0.75 from pot
JammesAngler: doesn't show hand 
*** SUMMARY ***
Total pot $0.75 | Rake $0 
Seat 1: Skiednis01 (small blind) folded before Flop
Seat 2: shtorman (big blind) folded before Flop
Seat 3: pudge.3096 folded before Flop (didn't bet)
Seat 4: DimaLesnoy folded before Flop (didn't bet)
Seat 5: 4Skill folded before Flop
Seat 6: JammesAngler (button) collected ($0.75)



PokerStars Hand #222971204596:  Hold'em No Limit ($0.05/$0.10 USD) - 2021/01/23 16:08:11 ET
Table 'Bohlinia III' 6-max Seat #1 is the button
Seat 1: Skiednis01 ($11 in chips) 
Seat 2: shtorman ($20.08 in chips) 
Seat 3: pudge.3096 ($10 in chips) 
Seat 4: DimaLesnoy ($20.48 in chips) 
Seat 5: 4Skill ($10 in chips) 
Seat 6: JammesAngler ($10.45 in chips) 
shtorman: posts small blind $0.05
pudge.3096: posts big blind $0.10
*** HOLE CARDS ***
DimaLesnoy is disconnected 
DimaLesnoy has timed out while being disconnected
DimaLesnoy: folds 
4Skill: raises $0.20 to $0.30
JammesAngler: folds 
Skiednis01: folds 
shtorman: folds 
pudge.3096: folds 
Uncalled bet ($0.20) returned to 4Skill
4Skill collected $0.25 from pot
4Skill: doesn't show hand 
*** SUMMARY ***
Total pot $0.25 | Rake $0 
Seat 1: Skiednis01 (button) folded before Flop (didn't bet)
Seat 2: shtorman (small blind) folded before Flop
Seat 3: pudge.3096 (big blind) folded before Flop
Seat 4: DimaLesnoy folded before Flop (didn't bet)
Seat 5: 4Skill collected ($0.25)
Seat 6: JammesAngler folded before Flop (didn't bet)



PokerStars Hand #222971229494:  Hold'em No Limit ($0.05/$0.10 USD) - 2021/01/23 16:08:41 ET
Table 'Bohlinia III' 6-max Seat #2 is the button
Seat 1: Skiednis01 ($11 in chips) 
Seat 2: shtorman ($20.03 in chips) 
Seat 3: pudge.3096 ($10 in chips) 
Seat 5: 4Skill ($10.15 in chips) 
Seat 6: JammesAngler ($10.45 in chips) 
pudge.3096: posts small blind $0.05
4Skill: posts big blind $0.10
*** HOLE CARDS ***
JammesAngler: folds 
Skiednis01: raises $0.15 to $0.25
shtorman: folds 
pudge.3096: folds 
4Skill: folds 
Uncalled bet ($0.15) returned to Skiednis01
Skiednis01 collected $0.25 from pot
Skiednis01: doesn't show hand 
*** SUMMARY ***
Total pot $0.25 | Rake $0 
Seat 1: Skiednis01 collected ($0.25)
Seat 2: shtorman (button) folded before Flop (didn't bet)
Seat 3: pudge.3096 (small blind) folded before Flop
Seat 5: 4Skill (big blind) folded before Flop
Seat 6: JammesAngler folded before Flop (didn't bet)



PokerStars Hand #222971239240:  Hold'em No Limit ($0.05/$0.10 USD) - 2021/01/23 16:08:52 ET
Table 'Bohlinia III' 6-max Seat #3 is the button
Seat 1: Skiednis01 ($11.15 in chips) 
Seat 2: shtorman ($20.03 in chips) 
Seat 3: pudge.3096 ($10 in chips) 
Seat 5: 4Skill ($10.05 in chips) 
Seat 6: JammesAngler ($10.45 in chips) 
4Skill: posts small blind $0.05
JammesAngler: posts big blind $0.10
*** HOLE CARDS ***
Skiednis01: folds 
shtorman: calls $0.10
pudge.3096: folds 
4Skill: folds 
JammesAngler: checks 
*** FLOP *** [Jd Qc 5c]
JammesAngler: checks 
shtorman: bets $0.10
JammesAngler: folds 
Uncalled bet ($0.10) returned to shtorman
shtorman collected $0.24 from pot
shtorman: doesn't show hand 
*** SUMMARY ***
Total pot $0.25 | Rake $0.01 
Board [Jd Qc 5c]
Seat 1: Skiednis01 folded before Flop (didn't bet)
Seat 2: shtorman collected ($0.24)
Seat 3: pudge.3096 (button) folded before Flop (didn't bet)
Seat 5: 4Skill (small blind) folded before Flop
Seat 6: JammesAngler (big blind) folded on the Flop



PokerStars Hand #222971251823:  Hold'em No Limit ($0.05/$0.10 USD) - 2021/01/23 16:09:08 ET
Table 'Bohlinia III' 6-max Seat #5 is the button
Seat 1: Skiednis01 ($11.15 in chips) 
Seat 2: shtorman ($20.17 in chips) 
Seat 3: pudge.3096 ($10 in chips) 
Seat 5: 4Skill ($10 in chips) 
Seat 6: JammesAngler ($10.35 in chips) 
JammesAngler: posts small blind $0.05
Skiednis01: posts big blind $0.10
*** HOLE CARDS ***
shtorman: folds 
pudge.3096: raises $0.20 to $0.30
4Skill: folds 
JammesAngler: folds 
Skiednis01: folds 
Uncalled bet ($0.20) returned to pudge.3096
pudge.3096 collected $0.25 from pot
pudge.3096: doesn't show hand 
*** SUMMARY ***
Total pot $0.25 | Rake $0 
Seat 1: Skiednis01 (big blind) folded before Flop
Seat 2: shtorman folded before Flop (didn't bet)
Seat 3: pudge.3096 collected ($0.25)
Seat 5: 4Skill (button) folded before Flop (didn't bet)
Seat 6: JammesAngler (small blind) folded before Flop



PokerStars Hand #222971264666:  Hold'em No Limit ($0.05/$0.10 USD) - 2021/01/23 16:09:23 ET
Table 'Bohlinia III' 6-max Seat #6 is the button
Seat 1: Skiednis01 ($11.05 in chips) 
Seat 2: shtorman ($20.17 in chips) 
Seat 3: pudge.3096 ($10.15 in chips) 
Seat 5: 4Skill ($10 in chips) 
Seat 6: JammesAngler ($10.30 in chips) 
Skiednis01: posts small blind $0.05
shtorman: posts big blind $0.10
*** HOLE CARDS ***
pudge.3096: folds 
4Skill: folds 
JammesAngler: folds 
Skiednis01: folds 
Uncalled bet ($0.05) returned to shtorman
shtorman collected $0.10 from pot
shtorman: doesn't show hand 
*** SUMMARY ***
Total pot $0.10 | Rake $0 
Seat 1: Skiednis01 (small blind) folded before Flop
Seat 2: shtorman (big blind) collected ($0.10)
Seat 3: pudge.3096 folded before Flop (didn't bet)
Seat 5: 4Skill folded before Flop (didn't bet)
Seat 6: JammesAngler (button) folded before Flop (didn't bet)



PokerStars Hand #222971272692:  Hold'em No Limit ($0.05/$0.10 USD) - 2021/01/23 16:09:33 ET
Table 'Bohlinia III' 6-max Seat #1 is the button
Seat 1: Skiednis01 ($11 in chips) 
Seat 2: shtorman ($20.22 in chips) 
Seat 3: pudge.3096 ($10.15 in chips) 
Seat 5: 4Skill ($10 in chips) 
Seat 6: JammesAngler ($10.30 in chips) 
shtorman: posts small blind $0.05
pudge.3096: posts big blind $0.10
*** HOLE CARDS ***
4Skill: folds 
JammesAngler: raises $0.20 to $0.30
Skiednis01: calls $0.30
shtorman: calls $0.25
pudge.3096: calls $0.20
*** FLOP *** [Td 8s Tc]
shtorman: checks 
pudge.3096: checks 
JammesAngler: checks 
Skiednis01: bets $0.58
shtorman: calls $0.58
pudge.3096: folds 
JammesAngler: folds 
*** TURN *** [Td 8s Tc] [Kd]
shtorman: checks 
Skiednis01: checks 
*** RIVER *** [Td 8s Tc Kd] [As]
shtorman: bets $1.12
Skiednis01: folds 
Uncalled bet ($1.12) returned to shtorman
shtorman collected $2.25 from pot
shtorman: doesn't show hand 
*** SUMMARY ***
Total pot $2.36 | Rake $0.11 
Board [Td 8s Tc Kd As]
Seat 1: Skiednis01 (button) folded on the River
Seat 2: shtorman (small blind) collected ($2.25)
Seat 3: pudge.3096 (big blind) folded on the Flop
Seat 5: 4Skill folded before Flop (didn't bet)
Seat 6: JammesAngler folded on the Flop



PokerStars Hand #222971326411:  Hold'em No Limit ($0.05/$0.10 USD) - 2021/01/23 16:10:36 ET
Table 'Bohlinia III' 6-max Seat #2 is the button
Seat 1: Skiednis01 ($10.12 in chips) 
Seat 2: shtorman ($21.59 in chips) 
Seat 3: pudge.3096 ($10 in chips) 
Seat 5: 4Skill ($10 in chips) 
Seat 6: JammesAngler ($10 in chips) 
pudge.3096: posts small blind $0.05
4Skill: posts big blind $0.10
*** HOLE CARDS ***
JammesAngler: folds 
Skiednis01: folds 
shtorman: calls $0.10
pudge.3096: folds 
4Skill: checks 
*** FLOP *** [6h 6d 5c]
4Skill: checks 
shtorman: checks 
*** TURN *** [6h 6d 5c] [Ad]
4Skill: checks 
shtorman: checks 
*** RIVER *** [6h 6d 5c Ad] [2s]
4Skill: checks 
shtorman: bets $0.10
4Skill: folds 
Uncalled bet ($0.10) returned to shtorman
shtorman collected $0.24 from pot
shtorman: doesn't show hand 
*** SUMMARY ***
Total pot $0.25 | Rake $0.01 
Board [6h 6d 5c Ad 2s]
Seat 1: Skiednis01 folded before Flop (didn't bet)
Seat 2: shtorman (button) collected ($0.24)
Seat 3: pudge.3096 (small blind) folded before Flop
Seat 5: 4Skill (big blind) folded on the River
Seat 6: JammesAngler folded before Flop (didn't bet)



PokerStars Hand #222971357238:  Hold'em No Limit ($0.05/$0.10 USD) - 2021/01/23 16:11:13 ET
Table 'Bohlinia III' 6-max Seat #3 is the button
Seat 1: Skiednis01 ($10.12 in chips) 
Seat 2: shtorman ($21.73 in chips) 
Seat 3: pudge.3096 ($10 in chips) 
Seat 5: 4Skill ($10 in chips) 
Seat 6: JammesAngler ($10 in chips) 
4Skill: posts small blind $0.05
JammesAngler: posts big blind $0.10
*** HOLE CARDS ***
Skiednis01: folds 
shtorman: calls $0.10
pudge.3096: folds 
4Skill: folds 
JammesAngler: checks 
*** FLOP *** [4s 5d 8h]
JammesAngler: checks 
shtorman: bets $0.10
JammesAngler: calls $0.10
*** TURN *** [4s 5d 8h] [Qh]
JammesAngler: checks 
shtorman: bets $0.10
JammesAngler: calls $0.10
*** RIVER *** [4s 5d 8h Qh] [5c]
JammesAngler: checks 
shtorman: bets $0.31
JammesAngler: folds 
Uncalled bet ($0.31) returned to shtorman
shtorman collected $0.62 from pot
shtorman: doesn't show hand 
*** SUMMARY ***
Total pot $0.65 | Rake $0.03 
Board [4s 5d 8h Qh 5c]
Seat 1: Skiednis01 folded before Flop (didn't bet)
Seat 2: shtorman collected ($0.62)
Seat 3: pudge.3096 (button) folded before Flop (didn't bet)
Seat 5: 4Skill (small blind) folded before Flop
Seat 6: JammesAngler (big blind) folded on the River



PokerStars Hand #222971386995:  Hold'em No Limit ($0.05/$0.10 USD) - 2021/01/23 16:11:50 ET
Table 'Bohlinia III' 6-max Seat #5 is the button
Seat 1: Skiednis01 ($10.12 in chips) 
Seat 2: shtorman ($22.05 in chips) 
Seat 3: pudge.3096 ($10 in chips) 
Seat 5: 4Skill ($10 in chips) 
Seat 6: JammesAngler ($10 in chips) 
JammesAngler: posts small blind $0.05
Skiednis01: posts big blind $0.10
*** HOLE CARDS ***
shtorman: folds 
pudge.3096: folds 
4Skill: folds 
JammesAngler: raises $0.20 to $0.30
Skiednis01: folds 
Uncalled bet ($0.20) returned to JammesAngler
JammesAngler collected $0.20 from pot
JammesAngler: doesn't show hand 
*** SUMMARY ***
Total pot $0.20 | Rake $0 
Seat 1: Skiednis01 (big blind) folded before Flop
Seat 2: shtorman folded before Flop (didn't bet)
Seat 3: pudge.3096 folded before Flop (didn't bet)
Seat 5: 4Skill (button) folded before Flop (didn't bet)
Seat 6: JammesAngler (small blind) collected ($0.20)



PokerStars Hand #222971400288:  Hold'em No Limit ($0.05/$0.10 USD) - 2021/01/23 16:12:06 ET
Table 'Bohlinia III' 6-max Seat #6 is the button
Seat 1: Skiednis01 ($10.02 in chips) 
Seat 2: shtorman ($22.05 in chips) 
Seat 3: pudge.3096 ($10 in chips) 
Seat 5: 4Skill ($10 in chips) 
Seat 6: JammesAngler ($10.10 in chips) 
Skiednis01: posts small blind $0.05
shtorman: posts big blind $0.10
DimaLesnoy: sits out 
*** HOLE CARDS ***
pudge.3096: folds 
4Skill: raises $0.20 to $0.30
JammesAngler: folds 
Skiednis01: raises $0.50 to $0.80
shtorman: folds 
4Skill: calls $0.50
*** FLOP *** [4d Kh Ts]
Skiednis01: bets $0.81
4Skill: calls $0.81
*** TURN *** [4d Kh Ts] [7d]
Skiednis01: bets $1.59
4Skill: folds 
Uncalled bet ($1.59) returned to Skiednis01
Skiednis01 collected $3.17 from pot
Skiednis01: doesn't show hand 
*** SUMMARY ***
Total pot $3.32 | Rake $0.15 
Board [4d Kh Ts 7d]
Seat 1: Skiednis01 (small blind) collected ($3.17)
Seat 2: shtorman (big blind) folded before Flop
Seat 3: pudge.3096 folded before Flop (didn't bet)
Seat 5: 4Skill folded on the Turn
Seat 6: JammesAngler (button) folded before Flop (didn't bet)



PokerStars Hand #222971457134:  Hold'em No Limit ($0.05/$0.10 USD) - 2021/01/23 16:13:06 ET
Table 'Bohlinia III' 6-max Seat #1 is the button
Seat 1: Skiednis01 ($11.58 in chips) 
Seat 2: shtorman ($21.95 in chips) 
Seat 3: pudge.3096 ($10 in chips) 
Seat 5: 4Skill ($10 in chips) 
Seat 6: JammesAngler ($10.10 in chips) 
shtorman: posts small blind $0.05
pudge.3096: posts big blind $0.10
DimaLesnoy: sits out 
*** HOLE CARDS ***
4Skill: folds 
JammesAngler: folds 
Skiednis01: folds 
shtorman: calls $0.05
pudge.3096: raises $0.40 to $0.50
shtorman: calls $0.40
*** FLOP *** [9c 3d Ks]
shtorman: checks 
pudge.3096: bets $0.48
shtorman: folds 
Uncalled bet ($0.48) returned to pudge.3096
pudge.3096 collected $0.96 from pot
pudge.3096: doesn't show hand 
*** SUMMARY ***
Total pot $1 | Rake $0.04 
Board [9c 3d Ks]
Seat 1: Skiednis01 (button) folded before Flop (didn't bet)
Seat 2: shtorman (small blind) folded on the Flop
Seat 3: pudge.3096 (big blind) collected ($0.96)
Seat 5: 4Skill folded before Flop (didn't bet)
Seat 6: JammesAngler folded before Flop (didn't bet)



PokerStars Hand #222971472302:  Hold'em No Limit ($0.05/$0.10 USD) - 2021/01/23 16:13:24 ET
Table 'Bohlinia III' 6-max Seat #2 is the button
Seat 1: Skiednis01 ($11.58 in chips) 
Seat 2: shtorman ($21.45 in chips) 
Seat 3: pudge.3096 ($10.46 in chips) 
Seat 4: DimaLesnoy ($20.48 in chips) 
Seat 5: 4Skill ($10 in chips) 
Seat 6: JammesAngler ($10.10 in chips) 
pudge.3096: posts small blind $0.05
DimaLesnoy: posts big blind $0.10
*** HOLE CARDS ***
4Skill: folds 
JammesAngler: folds 
Skiednis01: folds 
shtorman is disconnected 
shtorman has timed out while being disconnected
shtorman: folds 
pudge.3096: raises $0.15 to $0.25
DimaLesnoy: folds 
Uncalled bet ($0.15) returned to pudge.3096
pudge.3096 collected $0.20 from pot
pudge.3096: doesn't show hand 
*** SUMMARY ***
Total pot $0.20 | Rake $0 
Seat 1: Skiednis01 folded before Flop (didn't bet)
Seat 2: shtorman (button) folded before Flop (didn't bet)
Seat 3: pudge.3096 (small blind) collected ($0.20)
Seat 4: DimaLesnoy (big blind) folded before Flop
Seat 5: 4Skill folded before Flop (didn't bet)
Seat 6: JammesAngler folded before Flop (didn't bet)



PokerStars Hand #222971497567:  Hold'em No Limit ($0.05/$0.10 USD) - 2021/01/23 16:13:55 ET
Table 'Bohlinia III' 6-max Seat #3 is the button
Seat 1: Skiednis01 ($11.58 in chips) 
Seat 3: pudge.3096 ($10.56 in chips) 
Seat 4: DimaLesnoy ($20.38 in chips) 
Seat 5: 4Skill ($10 in chips) 
Seat 6: JammesAngler ($10.10 in chips) 
DimaLesnoy: posts small blind $0.05
4Skill: posts big blind $0.10
*** HOLE CARDS ***
JammesAngler: folds 
Skiednis01: folds 
JammesAngler leaves the table
pudge.3096: raises $0.15 to $0.25
DimaLesnoy: folds 
4Skill: raises $0.65 to $0.90
dragon82000 joins the table at seat #6 
pudge.3096: folds 
Uncalled bet ($0.65) returned to 4Skill
4Skill collected $0.55 from pot
4Skill: doesn't show hand 
*** SUMMARY ***
Total pot $0.55 | Rake $0 
Seat 1: Skiednis01 folded before Flop (didn't bet)
Seat 3: pudge.3096 (button) folded before Flop
Seat 4: DimaLesnoy (small blind) folded before Flop
Seat 5: 4Skill (big blind) collected ($0.55)
Seat 6: JammesAngler folded before Flop (didn't bet)



PokerStars Hand #222971514578:  Hold'em No Limit ($0.05/$0.10 USD) - 2021/01/23 16:14:15 ET
Table 'Bohlinia III' 6-max Seat #4 is the button
Seat 1: Skiednis01 ($11.58 in chips) 
Seat 3: pudge.3096 ($10.31 in chips) 
Seat 4: DimaLesnoy ($20.33 in chips) 
Seat 5: 4Skill ($10.30 in chips) 
Seat 6: dragon82000 ($10 in chips) 
4Skill: posts small blind $0.05
dragon82000: posts big blind $0.10
*** HOLE CARDS ***
Skiednis01: folds 
pudge.3096: raises $0.20 to $0.30
DimaLesnoy: calls $0.30
4Skill: folds 
dragon82000: folds 
*** FLOP *** [Th As Jd]
pudge.3096: bets $0.23
dragon82000 leaves the table
DimaLesnoy: folds 
Uncalled bet ($0.23) returned to pudge.3096
pudge.3096 collected $0.72 from pot
pudge.3096: doesn't show hand 
*** SUMMARY ***
Total pot $0.75 | Rake $0.03 
Board [Th As Jd]
Seat 1: Skiednis01 folded before Flop (didn't bet)
Seat 3: pudge.3096 collected ($0.72)
Seat 4: DimaLesnoy (button) folded on the Flop
Seat 5: 4Skill (small blind) folded before Flop
Seat 6: dragon82000 (big blind) folded before Flop



PokerStars Hand #222971533788:  Hold'em No Limit ($0.05/$0.10 USD) - 2021/01/23 16:14:38 ET
Table 'Bohlinia III' 6-max Seat #5 is the button
Seat 1: Skiednis01 ($11.58 in chips) 
Seat 3: pudge.3096 ($10.73 in chips) 
Seat 4: DimaLesnoy ($20.03 in chips) 
Seat 5: 4Skill ($10.25 in chips) 
Skiednis01: posts small blind $0.05
darryn1973 joins the table at seat #6 
pudge.3096: posts big blind $0.10
*** HOLE CARDS ***
DimaLesnoy: folds 
4Skill: raises $0.15 to $0.25
Skiednis01: folds 
pudge.3096: folds 
Uncalled bet ($0.15) returned to 4Skill
4Skill collected $0.25 from pot
4Skill: doesn't show hand 
*** SUMMARY ***
Total pot $0.25 | Rake $0 
Seat 1: Skiednis01 (small blind) folded before Flop
Seat 3: pudge.3096 (big blind) folded before Flop
Seat 4: DimaLesnoy folded before Flop (didn't bet)
Seat 5: 4Skill (button) collected ($0.25)



PokerStars Hand #222971544100:  Hold'em No Limit ($0.05/$0.10 USD) - 2021/01/23 16:14:51 ET
Table 'Bohlinia III' 6-max Seat #1 is the button
Seat 1: Skiednis01 ($11.53 in chips) 
Seat 3: pudge.3096 ($10.63 in chips) 
Seat 4: DimaLesnoy ($20.03 in chips) 
Seat 5: 4Skill ($10.40 in chips) 
pudge.3096: posts small blind $0.05
DimaLesnoy: posts big blind $0.10
darryn1973: sits out 
*** HOLE CARDS ***
4Skill: folds 
Skiednis01: folds 
shtorman is disconnected 
pudge.3096: folds 
Uncalled bet ($0.05) returned to DimaLesnoy
DimaLesnoy collected $0.10 from pot
DimaLesnoy: doesn't show hand 
*** SUMMARY ***
Total pot $0.10 | Rake $0 
Seat 1: Skiednis01 (button) folded before Flop (didn't bet)
Seat 3: pudge.3096 (small blind) folded before Flop
Seat 4: DimaLesnoy (big blind) collected ($0.10)
Seat 5: 4Skill folded before Flop (didn't bet)



PokerStars Hand #222971551019:  Hold'em No Limit ($0.05/$0.10 USD) - 2021/01/23 16:14:59 ET
Table 'Bohlinia III' 6-max Seat #3 is the button
Seat 1: Skiednis01 ($11.53 in chips) 
Seat 3: pudge.3096 ($10.58 in chips) 
Seat 4: DimaLesnoy ($20.08 in chips) 
Seat 6: darryn1973 ($10 in chips) 
DimaLesnoy: posts small blind $0.05
4Skill: is sitting out 
darryn1973: posts big blind $0.10
*** HOLE CARDS ***
Skiednis01: folds 
4Skill leaves the table
pudge.3096: raises $0.15 to $0.25
motron069 joins the table at seat #5 
DimaLesnoy: folds 
darryn1973: calls $0.15
*** FLOP *** [9d Qh Kh]
darryn1973: checks 
pudge.3096: checks 
*** TURN *** [9d Qh Kh] [Qd]
darryn1973: checks 
pudge.3096: checks 
*** RIVER *** [9d Qh Kh Qd] [Ad]
darryn1973: checks 
pudge.3096: checks 
*** SHOW DOWN ***
darryn1973: shows [8c Ac] (two pair, Aces and Queens)
pudge.3096: mucks hand 
darryn1973 collected $0.53 from pot
*** SUMMARY ***
Total pot $0.55 | Rake $0.02 
Board [9d Qh Kh Qd Ad]
Seat 1: Skiednis01 folded before Flop (didn't bet)
Seat 3: pudge.3096 (button) mucked
Seat 4: DimaLesnoy (small blind) folded before Flop
Seat 6: darryn1973 (big blind) showed [8c Ac] and won ($0.53) with two pair, Aces and Queens



PokerStars Hand #222971580716:  Hold'em No Limit ($0.05/$0.10 USD) - 2021/01/23 16:15:34 ET
Table 'Bohlinia III' 6-max Seat #4 is the button
Seat 1: Skiednis01 ($11.53 in chips) 
Seat 3: pudge.3096 ($10.33 in chips) 
Seat 4: DimaLesnoy ($20.03 in chips) 
Seat 6: darryn1973 ($10.28 in chips) 
darryn1973: posts small blind $0.05
Skiednis01: posts big blind $0.10
*** HOLE CARDS ***
pudge.3096: folds 
DimaLesnoy: folds 
darryn1973: raises $0.15 to $0.25
Skiednis01: calls $0.15
*** FLOP *** [5s Kh Qs]
darryn1973: checks 
Skiednis01: bets $0.24
darryn1973: folds 
Uncalled bet ($0.24) returned to Skiednis01
Skiednis01 collected $0.48 from pot
Skiednis01: doesn't show hand 
*** SUMMARY ***
Total pot $0.50 | Rake $0.02 
Board [5s Kh Qs]
Seat 1: Skiednis01 (big blind) collected ($0.48)
Seat 3: pudge.3096 folded before Flop (didn't bet)
Seat 4: DimaLesnoy (button) folded before Flop (didn't bet)
Seat 6: darryn1973 (small blind) folded on the Flop



PokerStars Hand #222971608936:  Hold'em No Limit ($0.05/$0.10 USD) - 2021/01/23 16:16:07 ET
Table 'Bohlinia III' 6-max Seat #6 is the button
Seat 1: Skiednis01 ($11.76 in chips) 
Seat 3: pudge.3096 ($10.33 in chips) 
Seat 4: DimaLesnoy ($20.03 in chips) 
Seat 6: darryn1973 ($10.03 in chips) 
Skiednis01: posts small blind $0.05
pudge.3096: posts big blind $0.10
motron069 is disconnected 
motron069 has timed out while disconnected
motron069: is sitting out 
*** HOLE CARDS ***
DimaLesnoy: raises $0.15 to $0.25
darryn1973: folds 
Skiednis01: raises $0.55 to $0.80
pudge.3096: folds 
DimaLesnoy: folds 
Uncalled bet ($0.55) returned to Skiednis01
Skiednis01 collected $0.60 from pot
Skiednis01: doesn't show hand 
*** SUMMARY ***
Total pot $0.60 | Rake $0 
Seat 1: Skiednis01 (small blind) collected ($0.60)
Seat 3: pudge.3096 (big blind) folded before Flop
Seat 4: DimaLesnoy folded before Flop
Seat 6: darryn1973 (button) folded before Flop (didn't bet)



PokerStars Hand #222971630188:  Hold'em No Limit ($0.05/$0.10 USD) - 2021/01/23 16:16:31 ET
Table 'Bohlinia III' 6-max Seat #1 is the button
Seat 1: Skiednis01 ($12.11 in chips) 
Seat 3: pudge.3096 ($10.23 in chips) 
Seat 4: DimaLesnoy ($19.78 in chips) 
Seat 6: darryn1973 ($10.03 in chips) 
pudge.3096: posts small blind $0.05
DimaLesnoy: posts big blind $0.10
*** HOLE CARDS ***
darryn1973: folds 
Skiednis01: raises $0.15 to $0.25
pudge.3096: folds 
DimaLesnoy: folds 
Uncalled bet ($0.15) returned to Skiednis01
Skiednis01 collected $0.25 from pot
Skiednis01: doesn't show hand 
*** SUMMARY ***
Total pot $0.25 | Rake $0 
Seat 1: Skiednis01 (button) collected ($0.25)
Seat 3: pudge.3096 (small blind) folded before Flop
Seat 4: DimaLesnoy (big blind) folded before Flop
Seat 6: darryn1973 folded before Flop (didn't bet)



PokerStars Hand #222971639191:  Hold'em No Limit ($0.05/$0.10 USD) - 2021/01/23 16:16:42 ET
Table 'Bohlinia III' 6-max Seat #3 is the button
Seat 1: Skiednis01 ($12.26 in chips) 
Seat 3: pudge.3096 ($10.18 in chips) 
Seat 4: DimaLesnoy ($19.68 in chips) 
Seat 6: darryn1973 ($10.03 in chips) 
DimaLesnoy: posts small blind $0.05
darryn1973: posts big blind $0.10
*** HOLE CARDS ***
Skiednis01: folds 
pudge.3096: folds 
DimaLesnoy: raises $0.20 to $0.30
darryn1973: calls $0.20
*** FLOP *** [5c Ts 3s]
DimaLesnoy: checks 
darryn1973: checks 
*** TURN *** [5c Ts 3s] [3h]
DimaLesnoy: bets $0.40
darryn1973: folds 
Uncalled bet ($0.40) returned to DimaLesnoy
DimaLesnoy collected $0.57 from pot
DimaLesnoy: doesn't show hand 
*** SUMMARY ***
Total pot $0.60 | Rake $0.03 
Board [5c Ts 3s 3h]
Seat 1: Skiednis01 folded before Flop (didn't bet)
Seat 3: pudge.3096 (button) folded before Flop (didn't bet)
Seat 4: DimaLesnoy (small blind) collected ($0.57)
Seat 6: darryn1973 (big blind) folded on the Turn



PokerStars Hand #222971669750:  Hold'em No Limit ($0.05/$0.10 USD) - 2021/01/23 16:17:17 ET
Table 'Bohlinia III' 6-max Seat #4 is the button
Seat 1: Skiednis01 ($12.26 in chips) 
Seat 3: pudge.3096 ($10.18 in chips) 
Seat 4: DimaLesnoy ($19.95 in chips) 
Seat 6: darryn1973 ($10 in chips) 
darryn1973: posts small blind $0.05
Skiednis01: posts big blind $0.10
*** HOLE CARDS ***
pudge.3096: folds 
DimaLesnoy: raises $0.12 to $0.22
darryn1973: calls $0.17
Skiednis01: calls $0.12
*** FLOP *** [3h Kh 7h]
darryn1973: checks 
Skiednis01: checks 
DimaLesnoy: checks 
*** TURN *** [3h Kh 7h] [4d]
motron069 leaves the table
darryn1973: bets $0.20
Yearyeah joins the table at seat #5 
Skiednis01: calls $0.20
DimaLesnoy: folds 
*** RIVER *** [3h Kh 7h 4d] [9c]
darryn1973: checks 
Skiednis01: bets $0.51
darryn1973: folds 
Uncalled bet ($0.51) returned to Skiednis01
Skiednis01 collected $1.01 from pot
Skiednis01: doesn't show hand 
*** SUMMARY ***
Total pot $1.06 | Rake $0.05 
Board [3h Kh 7h 4d 9c]
Seat 1: Skiednis01 (big blind) collected ($1.01)
Seat 3: pudge.3096 folded before Flop (didn't bet)
Seat 4: DimaLesnoy (button) folded on the Turn
Seat 6: darryn1973 (small blind) folded on the River



PokerStars Hand #222971709111:  Hold'em No Limit ($0.05/$0.10 USD) - 2021/01/23 16:18:03 ET
Table 'Bohlinia III' 6-max Seat #6 is the button
Seat 1: Skiednis01 ($12.85 in chips) 
Seat 3: pudge.3096 ($10.18 in chips) 
Seat 4: DimaLesnoy ($19.73 in chips) 
Seat 5: Yearyeah ($4.81 in chips) 
Seat 6: darryn1973 ($10 in chips) 
Skiednis01: posts small blind $0.05
pudge.3096: posts big blind $0.10
Yearyeah: posts big blind $0.10
*** HOLE CARDS ***
DimaLesnoy: raises $0.30 to $0.40
Yearyeah: folds 
darryn1973: calls $0.40
Skiednis01: folds 
pudge.3096: folds 
*** FLOP *** [Ks 9s 9h]
DimaLesnoy: checks 
darryn1973: bets $0.30
DimaLesnoy: calls $0.30
*** TURN *** [Ks 9s 9h] [Ad]
DimaLesnoy: checks 
darryn1973: checks 
*** RIVER *** [Ks 9s 9h Ad] [3d]
DimaLesnoy: bets $1.12
darryn1973: folds 
Uncalled bet ($1.12) returned to DimaLesnoy
DimaLesnoy collected $1.58 from pot
DimaLesnoy: doesn't show hand 
*** SUMMARY ***
Total pot $1.65 | Rake $0.07 
Board [Ks 9s 9h Ad 3d]
Seat 1: Skiednis01 (small blind) folded before Flop
Seat 3: pudge.3096 (big blind) folded before Flop
Seat 4: DimaLesnoy collected ($1.58)
Seat 5: Yearyeah folded before Flop (didn't bet)
Seat 6: darryn1973 (button) folded on the River



PokerStars Hand #222971754651:  Hold'em No Limit ($0.05/$0.10 USD) - 2021/01/23 16:18:55 ET
Table 'Bohlinia III' 6-max Seat #1 is the button
Seat 1: Skiednis01 ($12.80 in chips) 
Seat 3: pudge.3096 ($10.08 in chips) 
Seat 4: DimaLesnoy ($20.61 in chips) 
Seat 5: Yearyeah ($4.71 in chips) 
Seat 6: darryn1973 ($10 in chips) 
pudge.3096: posts small blind $0.05
DimaLesnoy: posts big blind $0.10
*** HOLE CARDS ***
Yearyeah: calls $0.10
darryn1973: raises $0.10 to $0.20
Skiednis01: folds 
pudge.3096: folds 
DimaLesnoy: folds 
Yearyeah: calls $0.10
*** FLOP *** [4d 7c Ac]
Yearyeah: bets $0.10
darryn1973: calls $0.10
*** TURN *** [4d 7c Ac] [Kd]
Yearyeah: bets $0.10
darryn1973: calls $0.10
*** RIVER *** [4d 7c Ac Kd] [Qd]
Yearyeah: bets $0.10
darryn1973: calls $0.10
*** SHOW DOWN ***
Yearyeah: shows [6d Kh] (a pair of Kings)
darryn1973: mucks hand 
Yearyeah collected $1.10 from pot
*** SUMMARY ***
Total pot $1.15 | Rake $0.05 
Board [4d 7c Ac Kd Qd]
Seat 1: Skiednis01 (button) folded before Flop (didn't bet)
Seat 3: pudge.3096 (small blind) folded before Flop
Seat 4: DimaLesnoy (big blind) folded before Flop
Seat 5: Yearyeah showed [6d Kh] and won ($1.10) with a pair of Kings
Seat 6: darryn1973 mucked



PokerStars Hand #222971780151:  Hold'em No Limit ($0.05/$0.10 USD) - 2021/01/23 16:19:25 ET
Table 'Bohlinia III' 6-max Seat #3 is the button
Seat 1: Skiednis01 ($12.80 in chips) 
Seat 3: pudge.3096 ($10.03 in chips) 
Seat 4: DimaLesnoy ($20.51 in chips) 
Seat 5: Yearyeah ($5.31 in chips) 
Seat 6: darryn1973 ($10 in chips) 
DimaLesnoy: posts small blind $0.05
Yearyeah: posts big blind $0.10
*** HOLE CARDS ***
darryn1973: folds 
Skiednis01: raises $0.15 to $0.25
pudge.3096: raises $0.55 to $0.80
DimaLesnoy: folds 
Yearyeah: folds 
Skiednis01: folds 
Uncalled bet ($0.55) returned to pudge.3096
pudge.3096 collected $0.65 from pot
pudge.3096: doesn't show hand 
*** SUMMARY ***
Total pot $0.65 | Rake $0 
Seat 1: Skiednis01 folded before Flop
Seat 3: pudge.3096 (button) collected ($0.65)
Seat 4: DimaLesnoy (small blind) folded before Flop
Seat 5: Yearyeah (big blind) folded before Flop
Seat 6: darryn1973 folded before Flop (didn't bet)



PokerStars Hand #222971799328:  Hold'em No Limit ($0.05/$0.10 USD) - 2021/01/23 16:19:47 ET
Table 'Bohlinia III' 6-max Seat #4 is the button
Seat 1: Skiednis01 ($12.55 in chips) 
Seat 3: pudge.3096 ($10.43 in chips) 
Seat 4: DimaLesnoy ($20.46 in chips) 
Seat 5: Yearyeah ($5.21 in chips) 
Seat 6: darryn1973 ($10 in chips) 
Yearyeah: posts small blind $0.05
darryn1973: posts big blind $0.10
*** HOLE CARDS ***
Skiednis01: folds 
pudge.3096: folds 
DimaLesnoy: folds 
Yearyeah: calls $0.05
darryn1973: checks 
*** FLOP *** [Jh 3d Kc]
Yearyeah: bets $0.10
darryn1973: calls $0.10
*** TURN *** [Jh 3d Kc] [Js]
Yearyeah: bets $0.10
darryn1973: calls $0.10
*** RIVER *** [Jh 3d Kc Js] [5h]
Yearyeah: bets $0.10
darryn1973: calls $0.10
*** SHOW DOWN ***
Yearyeah: shows [4c Ks] (two pair, Kings and Jacks)
darryn1973: shows [Th Kh] (two pair, Kings and Jacks - Ten kicker)
darryn1973 collected $0.76 from pot
*** SUMMARY ***
Total pot $0.80 | Rake $0.04 
Board [Jh 3d Kc Js 5h]
Seat 1: Skiednis01 folded before Flop (didn't bet)
Seat 3: pudge.3096 folded before Flop (didn't bet)
Seat 4: DimaLesnoy (button) folded before Flop (didn't bet)
Seat 5: Yearyeah (small blind) showed [4c Ks] and lost with two pair, Kings and Jacks
Seat 6: darryn1973 (big blind) showed [Th Kh] and won ($0.76) with two pair, Kings and Jacks



PokerStars Hand #222971821446:  Hold'em No Limit ($0.05/$0.10 USD) - 2021/01/23 16:20:13 ET
Table 'Bohlinia III' 6-max Seat #5 is the button
Seat 1: Skiednis01 ($12.55 in chips) 
Seat 3: pudge.3096 ($10.43 in chips) 
Seat 4: DimaLesnoy ($20.46 in chips) 
Seat 5: Yearyeah ($4.81 in chips) 
Seat 6: darryn1973 ($10.36 in chips) 
darryn1973: posts small blind $0.05
Skiednis01: posts big blind $0.10
*** HOLE CARDS ***
pudge.3096: folds 
DimaLesnoy: folds 
Yearyeah: calls $0.10
darryn1973: raises $0.20 to $0.30
Skiednis01: folds 
Yearyeah: calls $0.20
*** FLOP *** [Ad 8s 9c]
darryn1973: bets $0.30
Yearyeah: calls $0.30
*** TURN *** [Ad 8s 9c] [2h]
darryn1973: checks 
Yearyeah: checks 
*** RIVER *** [Ad 8s 9c 2h] [6s]
darryn1973: bets $0.70
Yearyeah: folds 
Uncalled bet ($0.70) returned to darryn1973
darryn1973 collected $1.24 from pot
*** SUMMARY ***
Total pot $1.30 | Rake $0.06 
Board [Ad 8s 9c 2h 6s]
Seat 1: Skiednis01 (big blind) folded before Flop
Seat 3: pudge.3096 folded before Flop (didn't bet)
Seat 4: DimaLesnoy folded before Flop (didn't bet)
Seat 5: Yearyeah (button) folded on the River
Seat 6: darryn1973 (small blind) collected ($1.24)



PokerStars Hand #222971850729:  Hold'em No Limit ($0.05/$0.10 USD) - 2021/01/23 16:20:47 ET
Table 'Bohlinia III' 6-max Seat #6 is the button
Seat 1: Skiednis01 ($12.45 in chips) 
Seat 3: pudge.3096 ($10.43 in chips) 
Seat 4: DimaLesnoy ($20.46 in chips) 
Seat 5: Yearyeah ($4.21 in chips) 
Seat 6: darryn1973 ($11 in chips) 
Skiednis01: posts small blind $0.05
pudge.3096: posts big blind $0.10
*** HOLE CARDS ***
DimaLesnoy: raises $0.20 to $0.30
Yearyeah: calls $0.30
darryn1973: folds 
Skiednis01: folds 
pudge.3096: folds 
*** FLOP *** [Kc 7s 5c]
DimaLesnoy: checks 
Yearyeah: bets $0.10
DimaLesnoy: calls $0.10
*** TURN *** [Kc 7s 5c] [3d]
DimaLesnoy: checks 
Yearyeah: bets $0.10
DimaLesnoy: folds 
Uncalled bet ($0.10) returned to Yearyeah
Yearyeah collected $0.91 from pot
shtorman was removed from the table for failing to post
shtorman leaves the table
Yearyeah: doesn't show hand 
*** SUMMARY ***
Total pot $0.95 | Rake $0.04 
Board [Kc 7s 5c 3d]
Seat 1: Skiednis01 (small blind) folded before Flop
Seat 3: pudge.3096 (big blind) folded before Flop
Seat 4: DimaLesnoy folded on the Turn
Seat 5: Yearyeah collected ($0.91)
Seat 6: darryn1973 (button) folded before Flop (didn't bet)



PokerStars Hand #222971876831:  Hold'em No Limit ($0.05/$0.10 USD) - 2021/01/23 16:21:17 ET
Table 'Bohlinia III' 6-max Seat #1 is the button
Seat 1: Skiednis01 ($12.40 in chips) 
Seat 3: pudge.3096 ($10.33 in chips) 
Seat 4: DimaLesnoy ($20.06 in chips) 
Seat 5: Yearyeah ($4.72 in chips) 
Seat 6: darryn1973 ($11 in chips) 
pudge.3096: posts small blind $0.05
DimaLesnoy: posts big blind $0.10
*** HOLE CARDS ***
Yearyeah: calls $0.10
darryn1973: raises $0.20 to $0.30
Skiednis01: folds 
pudge.3096: raises $0.90 to $1.20
DimaLesnoy: folds 
Yearyeah: folds 
darryn1973: calls $0.90
*** FLOP *** [2h 3s 7h]
pudge.3096: bets $0.79
darryn1973: calls $0.79
*** TURN *** [2h 3s 7h] [9h]
Croppers123 joins the table at seat #2 
pudge.3096: checks 
darryn1973: bets $2
pudge.3096: folds 
Uncalled bet ($2) returned to darryn1973
darryn1973 collected $3.99 from pot
*** SUMMARY ***
Total pot $4.18 | Rake $0.19 
Board [2h 3s 7h 9h]
Seat 1: Skiednis01 (button) folded before Flop (didn't bet)
Seat 3: pudge.3096 (small blind) folded on the Turn
Seat 4: DimaLesnoy (big blind) folded before Flop
Seat 5: Yearyeah folded before Flop
Seat 6: darryn1973 collected ($3.99)



PokerStars Hand #222971909338:  Hold'em No Limit ($0.05/$0.10 USD) - 2021/01/23 16:21:55 ET
Table 'Bohlinia III' 6-max Seat #3 is the button
Seat 1: Skiednis01 ($12.40 in chips) 
Seat 3: pudge.3096 ($10 in chips) 
Seat 4: DimaLesnoy ($19.96 in chips) 
Seat 5: Yearyeah ($4.62 in chips) 
Seat 6: darryn1973 ($13 in chips) 
DimaLesnoy: posts small blind $0.05
Yearyeah: posts big blind $0.10
Croppers123: sits out 
*** HOLE CARDS ***
darryn1973: raises $0.20 to $0.30
Skiednis01: folds 
pudge.3096: folds 
DimaLesnoy: folds 
Yearyeah: calls $0.20
*** FLOP *** [Ah 6d Jc]
Yearyeah: bets $0.10
darryn1973: raises $0.41 to $0.51
Yearyeah: calls $0.41
*** TURN *** [Ah 6d Jc] [7h]
Yearyeah: bets $0.10
darryn1973: raises $12.09 to $12.19 and is all-in
Yearyeah: calls $3.71 and is all-in
Uncalled bet ($8.38) returned to darryn1973
*** RIVER *** [Ah 6d Jc 7h] [5s]
*** SHOW DOWN ***
Yearyeah: shows [Kh 8h] (high card Ace)
darryn1973: shows [Ad Qh] (a pair of Aces)
darryn1973 collected $8.87 from pot
*** SUMMARY ***
Total pot $9.29 | Rake $0.42 
Board [Ah 6d Jc 7h 5s]
Seat 1: Skiednis01 folded before Flop (didn't bet)
Seat 3: pudge.3096 (button) folded before Flop (didn't bet)
Seat 4: DimaLesnoy (small blind) folded before Flop
Seat 5: Yearyeah (big blind) showed [Kh 8h] and lost with high card Ace
Seat 6: darryn1973 showed [Ad Qh] and won ($8.87) with a pair of Aces



PokerStars Hand #222971941303:  Hold'em No Limit ($0.05/$0.10 USD) - 2021/01/23 16:22:32 ET
Table 'Bohlinia III' 6-max Seat #4 is the button
Seat 1: Skiednis01 ($12.40 in chips) 
Seat 3: pudge.3096 ($10 in chips) 
Seat 4: DimaLesnoy ($19.91 in chips) 
Seat 6: darryn1973 ($17.25 in chips) 
darryn1973: posts small blind $0.05
Skiednis01: posts big blind $0.10
Croppers123: sits out 
*** HOLE CARDS ***
pudge.3096: folds 
DimaLesnoy: raises $0.12 to $0.22
darryn1973: calls $0.17
Skiednis01: folds 
*** FLOP *** [Kc 9d 5s]
darryn1973: checks 
DimaLesnoy: bets $0.22
darryn1973: folds 
Uncalled bet ($0.22) returned to DimaLesnoy
DimaLesnoy collected $0.52 from pot
DimaLesnoy: doesn't show hand 
*** SUMMARY ***
Total pot $0.54 | Rake $0.02 
Board [Kc 9d 5s]
Seat 1: Skiednis01 (big blind) folded before Flop
Seat 3: pudge.3096 folded before Flop (didn't bet)
Seat 4: DimaLesnoy (button) collected ($0.52)
Seat 6: darryn1973 (small blind) folded on the Flop



PokerStars Hand #222971956694:  Hold'em No Limit ($0.05/$0.10 USD) - 2021/01/23 16:22:50 ET
Table 'Bohlinia III' 6-max Seat #6 is the button
Seat 1: Skiednis01 ($12.30 in chips) 
Seat 2: Croppers123 ($5 in chips) 
Seat 3: pudge.3096 ($10 in chips) 
Seat 4: DimaLesnoy ($20.21 in chips) 
Seat 5: Yearyeah ($4 in chips) 
Seat 6: darryn1973 ($17.03 in chips) 
Skiednis01: posts small blind $0.05
Croppers123: posts big blind $0.10
Yearyeah: posts small blind $0.05
*** HOLE CARDS ***
pudge.3096: folds 
DimaLesnoy: raises $0.20 to $0.30
Yearyeah: folds 
darryn1973: folds 
Skiednis01: folds 
Croppers123: calls $0.20
*** FLOP *** [2d 5h 4d]
Croppers123: bets $0.20
DimaLesnoy: calls $0.20
*** TURN *** [2d 5h 4d] [6d]
Croppers123: bets $1
DimaLesnoy: calls $1
*** RIVER *** [2d 5h 4d 6d] [5d]
Croppers123: checks 
DimaLesnoy: bets $4.62
Croppers123: folds 
Uncalled bet ($4.62) returned to DimaLesnoy
DimaLesnoy collected $2.96 from pot
DimaLesnoy: doesn't show hand 
*** SUMMARY ***
Total pot $3.10 | Rake $0.14 
Board [2d 5h 4d 6d 5d]
Seat 1: Skiednis01 (small blind) folded before Flop
Seat 2: Croppers123 (big blind) folded on the River
Seat 3: pudge.3096 folded before Flop (didn't bet)
Seat 4: DimaLesnoy collected ($2.96)
Seat 5: Yearyeah folded before Flop (didn't bet)
Seat 6: darryn1973 (button) folded before Flop (didn't bet)



PokerStars Hand #222972003757:  Hold'em No Limit ($0.05/$0.10 USD) - 2021/01/23 16:23:37 ET
Table 'Bohlinia III' 6-max Seat #1 is the button
Seat 1: Skiednis01 ($12.25 in chips) 
Seat 2: Croppers123 ($3.50 in chips) 
Seat 3: pudge.3096 ($10 in chips) 
Seat 4: DimaLesnoy ($21.67 in chips) 
Seat 5: Yearyeah ($3.95 in chips) 
Seat 6: darryn1973 ($17.03 in chips) 
Croppers123: posts small blind $0.05
pudge.3096: posts big blind $0.10
*** HOLE CARDS ***
DimaLesnoy: folds 
Yearyeah: calls $0.10
darryn1973: folds 
Skiednis01: folds 
Croppers123: calls $0.05
pudge.3096: raises $0.40 to $0.50
Yearyeah: calls $0.40
Croppers123: calls $0.40
*** FLOP *** [Kd Tc 6c]
Croppers123: checks 
pudge.3096: bets $0.46
Yearyeah: calls $0.46
Croppers123: calls $0.46
*** TURN *** [Kd Tc 6c] [7c]
Croppers123: checks 
pudge.3096: checks 
Yearyeah: bets $0.10
Croppers123: calls $0.10
pudge.3096: calls $0.10
*** RIVER *** [Kd Tc 6c 7c] [5h]
Croppers123: bets $1
pudge.3096: folds 
Yearyeah: calls $1
*** SHOW DOWN ***
Croppers123: shows [Kc Js] (a pair of Kings)
Yearyeah: shows [Kh 5d] (two pair, Kings and Fives)
Yearyeah collected $4.95 from pot
*** SUMMARY ***
Total pot $5.18 | Rake $0.23 
Board [Kd Tc 6c 7c 5h]
Seat 1: Skiednis01 (button) folded before Flop (didn't bet)
Seat 2: Croppers123 (small blind) showed [Kc Js] and lost with a pair of Kings
Seat 3: pudge.3096 (big blind) folded on the River
Seat 4: DimaLesnoy folded before Flop (didn't bet)
Seat 5: Yearyeah showed [Kh 5d] and won ($4.95) with two pair, Kings and Fives
Seat 6: darryn1973 folded before Flop (didn't bet)



PokerStars Hand #222972049373:  Hold'em No Limit ($0.05/$0.10 USD) - 2021/01/23 16:24:31 ET
Table 'Bohlinia III' 6-max Seat #2 is the button
Seat 1: Skiednis01 ($12.25 in chips) 
Seat 2: Croppers123 ($1.44 in chips) 
Seat 3: pudge.3096 ($10 in chips) 
Seat 4: DimaLesnoy ($21.67 in chips) 
Seat 5: Yearyeah ($6.84 in chips) 
Seat 6: darryn1973 ($17.03 in chips) 
pudge.3096: posts small blind $0.05
DimaLesnoy: posts big blind $0.10
*** HOLE CARDS ***
Yearyeah: calls $0.10
darryn1973: folds 
Skiednis01: folds 
Croppers123: folds 
pudge.3096: folds 
DimaLesnoy: checks 
*** FLOP *** [Tc Td 4h]
DimaLesnoy: checks 
Yearyeah: checks 
*** TURN *** [Tc Td 4h] [9h]
DimaLesnoy: checks 
Yearyeah: checks 
*** RIVER *** [Tc Td 4h 9h] [7s]
DimaLesnoy: checks 
Yearyeah: bets $0.10
DimaLesnoy: calls $0.10
*** SHOW DOWN ***
Yearyeah: shows [As 7d] (two pair, Tens and Sevens)
DimaLesnoy: mucks hand 
Yearyeah collected $0.43 from pot
*** SUMMARY ***
Total pot $0.45 | Rake $0.02 
Board [Tc Td 4h 9h 7s]
Seat 1: Skiednis01 folded before Flop (didn't bet)
Seat 2: Croppers123 (button) folded before Flop (didn't bet)
Seat 3: pudge.3096 (small blind) folded before Flop
Seat 4: DimaLesnoy (big blind) mucked
Seat 5: Yearyeah showed [As 7d] and won ($0.43) with two pair, Tens and Sevens
Seat 6: darryn1973 folded before Flop (didn't bet)



PokerStars Hand #222972085706:  Hold'em No Limit ($0.05/$0.10 USD) - 2021/01/23 16:25:14 ET
Table 'Bohlinia III' 6-max Seat #3 is the button
Seat 1: Skiednis01 ($12.25 in chips) 
Seat 2: Croppers123 ($1.44 in chips) 
Seat 3: pudge.3096 ($10 in chips) 
Seat 4: DimaLesnoy ($21.47 in chips) 
Seat 5: Yearyeah ($7.07 in chips) 
Seat 6: darryn1973 ($17.03 in chips) 
DimaLesnoy: posts small blind $0.05
Yearyeah: posts big blind $0.10
*** HOLE CARDS ***
darryn1973: raises $0.15 to $0.25
Skiednis01: folds 
Croppers123: folds 
pudge.3096: folds 
DimaLesnoy: folds 
Yearyeah: folds 
Uncalled bet ($0.15) returned to darryn1973
darryn1973 collected $0.25 from pot
*** SUMMARY ***
Total pot $0.25 | Rake $0 
Seat 1: Skiednis01 folded before Flop (didn't bet)
Seat 2: Croppers123 folded before Flop (didn't bet)
Seat 3: pudge.3096 (button) folded before Flop (didn't bet)
Seat 4: DimaLesnoy (small blind) folded before Flop
Seat 5: Yearyeah (big blind) folded before Flop
Seat 6: darryn1973 collected ($0.25)



PokerStars Hand #222972101240:  Hold'em No Limit ($0.05/$0.10 USD) - 2021/01/23 16:25:32 ET
Table 'Bohlinia III' 6-max Seat #4 is the button
Seat 1: Skiednis01 ($12.25 in chips) 
Seat 2: Croppers123 ($1.44 in chips) 
Seat 3: pudge.3096 ($10 in chips) 
Seat 4: DimaLesnoy ($21.42 in chips) 
Seat 5: Yearyeah ($6.97 in chips) 
Seat 6: darryn1973 ($17.18 in chips) 
Yearyeah: posts small blind $0.05
darryn1973: posts big blind $0.10
*** HOLE CARDS ***
Skiednis01: folds 
Croppers123: calls $0.10
pudge.3096: raises $0.40 to $0.50
DimaLesnoy: folds 
Yearyeah: folds 
darryn1973: folds 
Croppers123: calls $0.40
*** FLOP *** [3h Ks Jc]
Croppers123: checks 
pudge.3096: checks 
*** TURN *** [3h Ks Jc] [8c]
Croppers123: bets $0.30
pudge.3096: folds 
Uncalled bet ($0.30) returned to Croppers123
Croppers123 collected $1.10 from pot
Croppers123: doesn't show hand 
*** SUMMARY ***
Total pot $1.15 | Rake $0.05 
Board [3h Ks Jc 8c]
Seat 1: Skiednis01 folded before Flop (didn't bet)
Seat 2: Croppers123 collected ($1.10)
Seat 3: pudge.3096 folded on the Turn
Seat 4: DimaLesnoy (button) folded before Flop (didn't bet)
Seat 5: Yearyeah (small blind) folded before Flop
Seat 6: darryn1973 (big blind) folded before Flop



PokerStars Hand #222972133566:  Hold'em No Limit ($0.05/$0.10 USD) - 2021/01/23 16:26:10 ET
Table 'Bohlinia III' 6-max Seat #5 is the button
Seat 1: Skiednis01 ($12.25 in chips) 
Seat 2: Croppers123 ($2.04 in chips) 
Seat 3: pudge.3096 ($10 in chips) 
Seat 4: DimaLesnoy ($21.42 in chips) 
Seat 5: Yearyeah ($6.92 in chips) 
Seat 6: darryn1973 ($17.08 in chips) 
darryn1973: posts small blind $0.05
Skiednis01: posts big blind $0.10
*** HOLE CARDS ***
Croppers123: folds 
pudge.3096: raises $0.20 to $0.30
DimaLesnoy: folds 
Yearyeah: folds 
darryn1973: folds 
Skiednis01: calls $0.20
*** FLOP *** [5d 9h Qc]
Skiednis01: bets $0.31
pudge.3096: calls $0.31
*** TURN *** [5d 9h Qc] [Qd]
Skiednis01: bets $0.61
pudge.3096: folds 
Uncalled bet ($0.61) returned to Skiednis01
Skiednis01 collected $1.21 from pot
Skiednis01: doesn't show hand 
*** SUMMARY ***
Total pot $1.27 | Rake $0.06 
Board [5d 9h Qc Qd]
Seat 1: Skiednis01 (big blind) collected ($1.21)
Seat 2: Croppers123 folded before Flop (didn't bet)
Seat 3: pudge.3096 folded on the Turn
Seat 4: DimaLesnoy folded before Flop (didn't bet)
Seat 5: Yearyeah (button) folded before Flop (didn't bet)
Seat 6: darryn1973 (small blind) folded before Flop



PokerStars Hand #222972189063:  Hold'em No Limit ($0.05/$0.10 USD) - 2021/01/23 16:27:15 ET
Table 'Bohlinia III' 6-max Seat #6 is the button
Seat 1: Skiednis01 ($12.85 in chips) 
Seat 2: Croppers123 ($2.04 in chips) 
Seat 3: pudge.3096 ($10 in chips) 
Seat 4: DimaLesnoy ($21.42 in chips) 
Seat 5: Yearyeah ($6.92 in chips) 
Seat 6: darryn1973 ($17.03 in chips) 
Skiednis01: posts small blind $0.05
Croppers123: posts big blind $0.10
*** HOLE CARDS ***
pudge.3096: raises $0.20 to $0.30
DimaLesnoy: folds 
Yearyeah has timed out
Yearyeah: folds 
darryn1973: folds 
Skiednis01: folds 
Croppers123: calls $0.20
*** FLOP *** [3c 6s Kd]
Croppers123: bets $0.40
pudge.3096: calls $0.40
*** TURN *** [3c 6s Kd] [Qh]
Croppers123: checks 
pudge.3096: bets $1.04
Croppers123: folds 
Uncalled bet ($1.04) returned to pudge.3096
pudge.3096 collected $1.38 from pot
pudge.3096: doesn't show hand 
*** SUMMARY ***
Total pot $1.45 | Rake $0.07 
Board [3c 6s Kd Qh]
Seat 1: Skiednis01 (small blind) folded before Flop
Seat 2: Croppers123 (big blind) folded on the Turn
Seat 3: pudge.3096 collected ($1.38)
Seat 4: DimaLesnoy folded before Flop (didn't bet)
Seat 5: Yearyeah folded before Flop (didn't bet)
Seat 6: darryn1973 (button) folded before Flop (didn't bet)



PokerStars Hand #222972227476:  Hold'em No Limit ($0.05/$0.10 USD) - 2021/01/23 16:28:01 ET
Table 'Bohlinia III' 6-max Seat #1 is the button
Seat 1: Skiednis01 ($12.80 in chips) 
Seat 2: Croppers123 ($1.34 in chips) 
Seat 3: pudge.3096 ($10.68 in chips) 
Seat 4: DimaLesnoy ($21.42 in chips) 
Seat 6: darryn1973 ($17.03 in chips) 
Croppers123: posts small blind $0.05
pudge.3096: posts big blind $0.10
*** HOLE CARDS ***
DimaLesnoy: folds 
darryn1973: raises $0.20 to $0.30
Skiednis01: raises $0.40 to $0.70
Croppers123: folds 
pudge.3096: folds 
darryn1973: folds 
Uncalled bet ($0.40) returned to Skiednis01
Skiednis01 collected $0.75 from pot
Skiednis01: doesn't show hand 
*** SUMMARY ***
Total pot $0.75 | Rake $0 
Seat 1: Skiednis01 (button) collected ($0.75)
Seat 2: Croppers123 (small blind) folded before Flop
Seat 3: pudge.3096 (big blind) folded before Flop
Seat 4: DimaLesnoy folded before Flop (didn't bet)
Seat 6: darryn1973 folded before Flop



PokerStars Hand #222972259383:  Hold'em No Limit ($0.05/$0.10 USD) - 2021/01/23 16:28:38 ET
Table 'Bohlinia III' 6-max Seat #2 is the button
Seat 1: Skiednis01 ($13.25 in chips) 
Seat 2: Croppers123 ($1.29 in chips) 
Seat 3: pudge.3096 ($10.58 in chips) 
Seat 4: DimaLesnoy ($21.42 in chips) 
Seat 6: darryn1973 ($16.73 in chips) 
pudge.3096: posts small blind $0.05
DimaLesnoy: posts big blind $0.10
*** HOLE CARDS ***
darryn1973: folds 
Yearyeah is disconnected 
Skiednis01: raises $0.15 to $0.25
Croppers123: calls $0.25
pudge.3096: raises $1.05 to $1.30
DimaLesnoy: folds 
Skiednis01: folds 
Croppers123: calls $1.04 and is all-in
Uncalled bet ($0.01) returned to pudge.3096
*** FLOP *** [4c 4s 5h]
*** TURN *** [4c 4s 5h] [7c]
*** RIVER *** [4c 4s 5h 7c] [2h]
*** SHOW DOWN ***
pudge.3096: shows [Kd As] (a pair of Fours)
Croppers123: shows [9s Ks] (a pair of Fours - lower kicker)
pudge.3096 collected $2.80 from pot
*** SUMMARY ***
Total pot $2.93 | Rake $0.13 
Board [4c 4s 5h 7c 2h]
Seat 1: Skiednis01 folded before Flop
Seat 2: Croppers123 (button) showed [9s Ks] and lost with a pair of Fours
Seat 3: pudge.3096 (small blind) showed [Kd As] and won ($2.80) with a pair of Fours
Seat 4: DimaLesnoy (big blind) folded before Flop
Seat 6: darryn1973 folded before Flop (didn't bet)



PokerStars Hand #222972295425:  Hold'em No Limit ($0.05/$0.10 USD) - 2021/01/23 16:29:21 ET
Table 'Bohlinia III' 6-max Seat #3 is the button
Seat 1: Skiednis01 ($13 in chips) 
Seat 3: pudge.3096 ($12.09 in chips) 
Seat 4: DimaLesnoy ($21.32 in chips) 
Seat 5: Yearyeah ($6.92 in chips) 
Seat 6: darryn1973 ($16.73 in chips) 
DimaLesnoy: posts small blind $0.05
Yearyeah: posts big blind $0.10
*** HOLE CARDS ***
darryn1973: folds 
Skiednis01: raises $0.15 to $0.25
Croppers123 leaves the table
pudge.3096: folds 
DimaLesnoy: folds 
Yearyeah: calls $0.15
*** FLOP *** [9s 4c 3h]
Yearyeah: checks 
Skiednis01: bets $0.27
Yearyeah: calls $0.27
*** TURN *** [9s 4c 3h] [Ad]
Yearyeah: checks 
Skiednis01: checks 
*** RIVER *** [9s 4c 3h Ad] [4s]
Yearyeah: checks 
Skiednis01: checks 
*** SHOW DOWN ***
Yearyeah: shows [Qd Js] (a pair of Fours)
Skiednis01: shows [6c 6h] (two pair, Sixes and Fours)
Skiednis01 collected $1.04 from pot
*** SUMMARY ***
Total pot $1.09 | Rake $0.05 
Board [9s 4c 3h Ad 4s]
Seat 1: Skiednis01 showed [6c 6h] and won ($1.04) with two pair, Sixes and Fours
Seat 3: pudge.3096 (button) folded before Flop (didn't bet)
Seat 4: DimaLesnoy (small blind) folded before Flop
Seat 5: Yearyeah (big blind) showed [Qd Js] and lost with a pair of Fours
Seat 6: darryn1973 folded before Flop (didn't bet)



PokerStars Hand #222972315955:  Hold'em No Limit ($0.05/$0.10 USD) - 2021/01/23 16:29:45 ET
Table 'Bohlinia III' 6-max Seat #4 is the button
Seat 1: Skiednis01 ($13.52 in chips) 
Seat 3: pudge.3096 ($12.09 in chips) 
Seat 4: DimaLesnoy ($21.27 in chips) 
Seat 5: Yearyeah ($6.40 in chips) 
Seat 6: darryn1973 ($16.73 in chips) 
Yearyeah: posts small blind $0.05
darryn1973: posts big blind $0.10
*** HOLE CARDS ***
Skiednis01: raises $0.15 to $0.25
pudge.3096: folds 
DimaLesnoy: folds 
Yearyeah: calls $0.20
darryn1973: calls $0.15
*** FLOP *** [Ad 3s 9h]
Yearyeah: checks 
darryn1973: checks 
Skiednis01: bets $0.36
Yearyeah: calls $0.36
b4udejas joins the table at seat #2 
darryn1973: folds 
*** TURN *** [Ad 3s 9h] [Th]
Yearyeah: bets $0.10
Skiednis01: raises $0.90 to $1
Yearyeah: calls $0.90
*** RIVER *** [Ad 3s 9h Th] [2c]
Yearyeah: bets $0.10
Skiednis01: calls $0.10
*** SHOW DOWN ***
Yearyeah: shows [5s 5d] (a pair of Fives)
Skiednis01: shows [As 6h] (a pair of Aces)
Skiednis01 collected $3.50 from pot
*** SUMMARY ***
Total pot $3.67 | Rake $0.17 
Board [Ad 3s 9h Th 2c]
Seat 1: Skiednis01 showed [As 6h] and won ($3.50) with a pair of Aces
Seat 3: pudge.3096 folded before Flop (didn't bet)
Seat 4: DimaLesnoy (button) folded before Flop (didn't bet)
Seat 5: Yearyeah (small blind) showed [5s 5d] and lost with a pair of Fives
Seat 6: darryn1973 (big blind) folded on the Flop



PokerStars Hand #222972359334:  Hold'em No Limit ($0.05/$0.10 USD) - 2021/01/23 16:30:35 ET
Table 'Bohlinia III' 6-max Seat #5 is the button
Seat 2: b4udejas ($4.01 in chips) 
Seat 3: pudge.3096 ($12.09 in chips) 
Seat 4: DimaLesnoy ($21.27 in chips) 
Seat 5: Yearyeah ($4.69 in chips) 
Seat 6: darryn1973 ($16.48 in chips) 
darryn1973: posts small blind $0.05
Skiednis01: is sitting out 
b4udejas: posts big blind $0.10
*** HOLE CARDS ***
pudge.3096: folds 
DimaLesnoy: folds 
Yearyeah: folds 
Skiednis01 leaves the table
darryn1973: folds 
Uncalled bet ($0.05) returned to b4udejas
larson090 joins the table at seat #1 
b4udejas collected $0.10 from pot
b4udejas: doesn't show hand 
*** SUMMARY ***
Total pot $0.10 | Rake $0 
Seat 2: b4udejas (big blind) collected ($0.10)
Seat 3: pudge.3096 folded before Flop (didn't bet)
Seat 4: DimaLesnoy folded before Flop (didn't bet)
Seat 5: Yearyeah (button) folded before Flop (didn't bet)
Seat 6: darryn1973 (small blind) folded before Flop



PokerStars Hand #222972368941:  Hold'em No Limit ($0.05/$0.10 USD) - 2021/01/23 16:30:47 ET
Table 'Bohlinia III' 6-max Seat #6 is the button
Seat 2: b4udejas ($4.06 in chips) 
Seat 3: pudge.3096 ($12.09 in chips) 
Seat 4: DimaLesnoy ($21.27 in chips) 
Seat 5: Yearyeah ($4.69 in chips) 
Seat 6: darryn1973 ($16.43 in chips) 
b4udejas: posts small blind $0.05
pudge.3096: posts big blind $0.10
*** HOLE CARDS ***
DimaLesnoy: folds 
Yearyeah: folds 
darryn1973: raises $0.15 to $0.25
b4udejas: calls $0.20
pudge.3096: folds 
*** FLOP *** [Jh Ac 4s]
b4udejas: checks 
darryn1973: checks 
*** TURN *** [Jh Ac 4s] [8d]
b4udejas: checks 
darryn1973: checks 
*** RIVER *** [Jh Ac 4s 8d] [Kc]
b4udejas: checks 
darryn1973: checks 
*** SHOW DOWN ***
b4udejas: shows [Ad 5s] (a pair of Aces)
darryn1973: mucks hand 
b4udejas collected $0.57 from pot
*** SUMMARY ***
Total pot $0.60 | Rake $0.03 
Board [Jh Ac 4s 8d Kc]
Seat 2: b4udejas (small blind) showed [Ad 5s] and won ($0.57) with a pair of Aces
Seat 3: pudge.3096 (big blind) folded before Flop
Seat 4: DimaLesnoy folded before Flop (didn't bet)
Seat 5: Yearyeah folded before Flop (didn't bet)
Seat 6: darryn1973 (button) mucked



PokerStars Hand #222972411860:  Hold'em No Limit ($0.05/$0.10 USD) - 2021/01/23 16:31:33 ET
Table 'Bohlinia III' 6-max Seat #2 is the button
Seat 2: b4udejas ($4.38 in chips) 
Seat 3: pudge.3096 ($11.99 in chips) 
Seat 4: DimaLesnoy ($21.27 in chips) 
Seat 5: Yearyeah ($4.69 in chips) 
pudge.3096: posts small blind $0.05
DimaLesnoy: posts big blind $0.10
larson090: sits out 
*** HOLE CARDS ***
Yearyeah: folds 
b4udejas: raises $0.20 to $0.30
pudge.3096: folds 
DimaLesnoy: folds 
Uncalled bet ($0.20) returned to b4udejas
b4udejas collected $0.25 from pot
b4udejas: doesn't show hand 
*** SUMMARY ***
Total pot $0.25 | Rake $0 
Seat 2: b4udejas (button) collected ($0.25)
Seat 3: pudge.3096 (small blind) folded before Flop
Seat 4: DimaLesnoy (big blind) folded before Flop
Seat 5: Yearyeah folded before Flop (didn't bet)



PokerStars Hand #222972421247:  Hold'em No Limit ($0.05/$0.10 USD) - 2021/01/23 16:31:44 ET
Table 'Bohlinia III' 6-max Seat #3 is the button
Seat 2: b4udejas ($4.53 in chips) 
Seat 3: pudge.3096 ($11.94 in chips) 
Seat 4: DimaLesnoy ($21.17 in chips) 
Seat 5: Yearyeah ($4.69 in chips) 
DimaLesnoy: posts small blind $0.05
Yearyeah: posts big blind $0.10
larson090: sits out 
*** HOLE CARDS ***
darryn1973 leaves the table
b4udejas: raises $0.20 to $0.30
pudge.3096: folds 
pudge.3096 leaves the table
DimaLesnoy: folds 
Yearyeah: calls $0.20
*** FLOP *** [As 5d Ah]
Yearyeah: checks 
b4udejas: checks 
*** TURN *** [As 5d Ah] [6c]
RedClover101 joins the table at seat #3 
Yearyeah: bets $0.10
b4udejas: calls $0.10
*** RIVER *** [As 5d Ah 6c] [5h]
attilakorte joins the table at seat #6 
Yearyeah: bets $0.20
b4udejas: raises $0.80 to $1
Yearyeah: raises $0.80 to $1.80
b4udejas: folds 
Uncalled bet ($0.80) returned to Yearyeah
Yearyeah collected $2.72 from pot
Yearyeah: doesn't show hand 
*** SUMMARY ***
Total pot $2.85 | Rake $0.13 
Board [As 5d Ah 6c 5h]
Seat 2: b4udejas folded on the River
Seat 3: pudge.3096 (button) folded before Flop (didn't bet)
Seat 4: DimaLesnoy (small blind) folded before Flop
Seat 5: Yearyeah (big blind) collected ($2.72)



PokerStars Hand #222972463142:  Hold'em No Limit ($0.05/$0.10 USD) - 2021/01/23 16:32:33 ET
Table 'Bohlinia III' 6-max Seat #4 is the button
Seat 2: b4udejas ($3.13 in chips) 
Seat 3: RedClover101 ($10 in chips) 
Seat 4: DimaLesnoy ($21.12 in chips) 
Seat 5: Yearyeah ($6.01 in chips) 
Seat 6: attilakorte ($10 in chips) 
Yearyeah: posts small blind $0.05
attilakorte: posts big blind $0.10
larson090: sits out 
RedClover101: posts big blind $0.10
*** HOLE CARDS ***
b4udejas: raises $0.20 to $0.30
RedClover101: calls $0.20
DimaLesnoy: folds 
Yearyeah: calls $0.25
attilakorte: folds 
*** FLOP *** [Ks 7d 4s]
Yearyeah: bets $0.20
b4udejas: folds 
RedClover101: folds 
Uncalled bet ($0.20) returned to Yearyeah
Yearyeah collected $0.96 from pot
Yearyeah: doesn't show hand 
*** SUMMARY ***
Total pot $1 | Rake $0.04 
Board [Ks 7d 4s]
Seat 2: b4udejas folded on the Flop
Seat 3: RedClover101 folded on the Flop
Seat 4: DimaLesnoy (button) folded before Flop (didn't bet)
Seat 5: Yearyeah (small blind) collected ($0.96)
Seat 6: attilakorte (big blind) folded before Flop



PokerStars Hand #222972485137:  Hold'em No Limit ($0.05/$0.10 USD) - 2021/01/23 16:32:59 ET
Table 'Bohlinia III' 6-max Seat #5 is the button
Seat 1: larson090 ($10 in chips) 
Seat 2: b4udejas ($2.83 in chips) 
Seat 3: RedClover101 ($10 in chips) 
Seat 4: DimaLesnoy ($21.12 in chips) 
Seat 5: Yearyeah ($6.67 in chips) 
Seat 6: attilakorte ($10 in chips) 
attilakorte: posts small blind $0.05
larson090: posts big blind $0.10
*** HOLE CARDS ***
b4udejas: calls $0.10
RedClover101: folds 
DimaLesnoy: folds 
Yearyeah: calls $0.10
attilakorte: folds 
larson090: checks 
*** FLOP *** [3s Td Jd]
larson090: checks 
b4udejas: checks 
Yearyeah: bets $0.10
larson090: folds 
b4udejas: calls $0.10
*** TURN *** [3s Td Jd] [Jh]
b4udejas: checks 
Yearyeah: bets $0.10
b4udejas: calls $0.10
*** RIVER *** [3s Td Jd Jh] [8c]
b4udejas: checks 
Yearyeah: bets $0.10
b4udejas: calls $0.10
*** SHOW DOWN ***
Yearyeah: shows [8d Ac] (two pair, Jacks and Eights)
b4udejas: mucks hand 
Yearyeah collected $0.91 from pot
*** SUMMARY ***
Total pot $0.95 | Rake $0.04 
Board [3s Td Jd Jh 8c]
Seat 1: larson090 (big blind) folded on the Flop
Seat 2: b4udejas mucked
Seat 3: RedClover101 folded before Flop (didn't bet)
Seat 4: DimaLesnoy folded before Flop (didn't bet)
Seat 5: Yearyeah (button) showed [8d Ac] and won ($0.91) with two pair, Jacks and Eights
Seat 6: attilakorte (small blind) folded before Flop



PokerStars Hand #222972536815:  Hold'em No Limit ($0.05/$0.10 USD) - 2021/01/23 16:34:00 ET
Table 'Bohlinia III' 6-max Seat #6 is the button
Seat 1: larson090 ($10 in chips) 
Seat 2: b4udejas ($2.43 in chips) 
Seat 3: RedClover101 ($10 in chips) 
Seat 4: DimaLesnoy ($21.12 in chips) 
Seat 5: Yearyeah ($7.18 in chips) 
Seat 6: attilakorte ($10 in chips) 
larson090: posts small blind $0.05
b4udejas: posts big blind $0.10
*** HOLE CARDS ***
RedClover101: folds 
DimaLesnoy: folds 
Yearyeah: calls $0.10
attilakorte: folds 
larson090: calls $0.05
b4udejas: checks 
*** FLOP *** [6s 3d Tc]
larson090: bets $0.19
b4udejas is disconnected 
b4udejas has timed out while disconnected
b4udejas: folds 
Yearyeah: calls $0.19
*** TURN *** [6s 3d Tc] [8h]
larson090: checks 
Yearyeah: bets $0.10
larson090: calls $0.10
*** RIVER *** [6s 3d Tc 8h] [Kd]
larson090: checks 
Yearyeah: bets $0.30
larson090: folds 
Uncalled bet ($0.30) returned to Yearyeah
Yearyeah collected $0.84 from pot
Yearyeah: doesn't show hand 
*** SUMMARY ***
Total pot $0.88 | Rake $0.04 
Board [6s 3d Tc 8h Kd]
Seat 1: larson090 (small blind) folded on the River
Seat 2: b4udejas (big blind) folded on the Flop
Seat 3: RedClover101 folded before Flop (didn't bet)
Seat 4: DimaLesnoy folded before Flop (didn't bet)
Seat 5: Yearyeah collected ($0.84)
Seat 6: attilakorte (button) folded before Flop (didn't bet)



PokerStars Hand #222972605445:  Hold'em No Limit ($0.05/$0.10 USD) - 2021/01/23 16:35:22 ET
Table 'Bohlinia III' 6-max Seat #1 is the button
Seat 1: larson090 ($10 in chips) 
Seat 3: RedClover101 ($10 in chips) 
Seat 4: DimaLesnoy ($21.12 in chips) 
Seat 5: Yearyeah ($7.63 in chips) 
Seat 6: attilakorte ($10 in chips) 
RedClover101: posts small blind $0.05
DimaLesnoy: posts big blind $0.10
*** HOLE CARDS ***
Yearyeah: calls $0.10
attilakorte: folds 
larson090: folds 
RedClover101: folds 
DimaLesnoy: checks 
*** FLOP *** [5s 7s 9h]
DimaLesnoy: checks 
Yearyeah: bets $0.10
DimaLesnoy: raises $0.50 to $0.60
Yearyeah: calls $0.50
*** TURN *** [5s 7s 9h] [6c]
DimaLesnoy: checks 
Yearyeah: bets $0.10
DimaLesnoy: calls $0.10
*** RIVER *** [5s 7s 9h 6c] [5c]
DimaLesnoy: bets $20.32 and is all-in
Yearyeah: folds 
Uncalled bet ($20.32) returned to DimaLesnoy
DimaLesnoy collected $1.58 from pot
DimaLesnoy: doesn't show hand 
*** SUMMARY ***
Total pot $1.65 | Rake $0.07 
Board [5s 7s 9h 6c 5c]
Seat 1: larson090 (button) folded before Flop (didn't bet)
Seat 3: RedClover101 (small blind) folded before Flop
Seat 4: DimaLesnoy (big blind) collected ($1.58)
Seat 5: Yearyeah folded on the River
Seat 6: attilakorte folded before Flop (didn't bet)



PokerStars Hand #222972644780:  Hold'em No Limit ($0.05/$0.10 USD) - 2021/01/23 16:36:09 ET
Table 'Bohlinia III' 6-max Seat #3 is the button
Seat 1: larson090 ($10 in chips) 
Seat 2: b4udejas ($2.33 in chips) 
Seat 3: RedClover101 ($10 in chips) 
Seat 4: DimaLesnoy ($21.90 in chips) 
Seat 5: Yearyeah ($6.83 in chips) 
Seat 6: attilakorte ($10 in chips) 
DimaLesnoy: posts small blind $0.05
Yearyeah: posts big blind $0.10
b4udejas: posts small blind $0.05
*** HOLE CARDS ***
attilakorte: raises $0.12 to $0.22
larson090: folds 
b4udejas: calls $0.22
RedClover101: folds 
DimaLesnoy: folds 
Yearyeah: calls $0.12
*** FLOP *** [9h 4d 8d]
Yearyeah: bets $0.10
b4udejas is disconnected 
attilakorte: calls $0.10
b4udejas is connected 
b4udejas: calls $0.10
*** TURN *** [9h 4d 8d] [Jd]
Yearyeah: checks 
attilakorte: bets $0.53
b4udejas: folds 
Yearyeah: folds 
Uncalled bet ($0.53) returned to attilakorte
attilakorte collected $1.01 from pot
attilakorte: doesn't show hand 
*** SUMMARY ***
Total pot $1.06 | Rake $0.05 
Board [9h 4d 8d Jd]
Seat 1: larson090 folded before Flop (didn't bet)
Seat 2: b4udejas folded on the Turn
Seat 3: RedClover101 (button) folded before Flop (didn't bet)
Seat 4: DimaLesnoy (small blind) folded before Flop
Seat 5: Yearyeah (big blind) folded on the Turn
Seat 6: attilakorte collected ($1.01)



PokerStars Hand #222972694978:  Hold'em No Limit ($0.05/$0.10 USD) - 2021/01/23 16:37:09 ET
Table 'Bohlinia III' 6-max Seat #4 is the button
Seat 1: larson090 ($10 in chips) 
Seat 2: b4udejas ($1.96 in chips) 
Seat 3: RedClover101 ($10 in chips) 
Seat 4: DimaLesnoy ($21.85 in chips) 
Seat 5: Yearyeah ($6.51 in chips) 
Seat 6: attilakorte ($10.69 in chips) 
Yearyeah: posts small blind $0.05
attilakorte: posts big blind $0.10
*** HOLE CARDS ***
larson090: folds 
b4udejas: calls $0.10
RedClover101 has timed out
RedClover101: folds 
DimaLesnoy: folds 
Yearyeah is disconnected 
Yearyeah has timed out while disconnected
Yearyeah: folds 
attilakorte: checks 
*** FLOP *** [Kd 5c 2s]
attilakorte: checks 
b4udejas: checks 
*** TURN *** [Kd 5c 2s] [5s]
attilakorte: checks 
b4udejas: bets $0.10
attilakorte: calls $0.10
*** RIVER *** [Kd 5c 2s 5s] [Ac]
attilakorte: checks 
b4udejas: checks 
*** SHOW DOWN ***
attilakorte: shows [4c As] (two pair, Aces and Fives)
b4udejas: mucks hand 
attilakorte collected $0.43 from pot
*** SUMMARY ***
Total pot $0.45 | Rake $0.02 
Board [Kd 5c 2s 5s Ac]
Seat 1: larson090 folded before Flop (didn't bet)
Seat 2: b4udejas mucked
Seat 3: RedClover101 folded before Flop (didn't bet)
Seat 4: DimaLesnoy (button) folded before Flop (didn't bet)
Seat 5: Yearyeah (small blind) folded before Flop
Seat 6: attilakorte (big blind) showed [4c As] and won ($0.43) with two pair, Aces and Fives



PokerStars Hand #222972752251:  Hold'em No Limit ($0.05/$0.10 USD) - 2021/01/23 16:38:18 ET
Table 'Bohlinia III' 6-max Seat #5 is the button
Seat 1: larson090 ($10 in chips) 
Seat 2: b4udejas ($1.76 in chips) 
Seat 3: RedClover101 ($10 in chips) 
Seat 4: DimaLesnoy ($21.85 in chips) 
Seat 5: Yearyeah ($6.46 in chips) 
Seat 6: attilakorte ($10.92 in chips) 
attilakorte: posts small blind $0.05
larson090: posts big blind $0.10
*** HOLE CARDS ***
b4udejas: folds 
RedClover101: folds 
DimaLesnoy: folds 
Yearyeah: calls $0.10
attilakorte: folds 
larson090: checks 
*** FLOP *** [7c Js 5h]
larson090: checks 
Yearyeah: checks 
*** TURN *** [7c Js 5h] [6c]
larson090: checks 
Yearyeah: checks 
*** RIVER *** [7c Js 5h 6c] [8h]
larson090: bets $0.16
Yearyeah: calls $0.16
*** SHOW DOWN ***
larson090: shows [8c 5d] (two pair, Eights and Fives)
Yearyeah: shows [4c Th] (a straight, Four to Eight)
Yearyeah collected $0.54 from pot
*** SUMMARY ***
Total pot $0.57 | Rake $0.03 
Board [7c Js 5h 6c 8h]
Seat 1: larson090 (big blind) showed [8c 5d] and lost with two pair, Eights and Fives
Seat 2: b4udejas folded before Flop (didn't bet)
Seat 3: RedClover101 folded before Flop (didn't bet)
Seat 4: DimaLesnoy folded before Flop (didn't bet)
Seat 5: Yearyeah (button) showed [4c Th] and won ($0.54) with a straight, Four to Eight
Seat 6: attilakorte (small blind) folded before Flop



