PokerStars Hand #222943071958:  Hold'em No Limit ($0.05/$0.10 USD) - 2021/01/23 22:38:55 ET
Table 'Algieba III' 6-max Seat #5 is the button
Seat 1: Tyoma_Kovach ($11.29 in chips) 
Seat 2: johnysvk18 ($13.52 in chips) 
Seat 3: thedude696969 ($20.02 in chips) 
Seat 4: 0nix770 ($11.72 in chips) 
Seat 5: slipperyII ($10 in chips) 
Seat 6: Deniels7 ($8.85 in chips) 
Deniels7: posts small blind $0.05
Tyoma_Kovach: posts big blind $0.10
*** HOLE CARDS ***
johnysvk18: folds 
thedude696969: folds 
0nix770: raises $0.15 to $0.25
slipperyII: calls $0.25
Deniels7: calls $0.20
Tyoma_Kovach: calls $0.15
*** FLOP *** [3c 8s Qh]
Deniels7: checks 
Tyoma_Kovach: checks 
0nix770: checks 
slipperyII: checks 
*** TURN *** [3c 8s Qh] [2d]
Deniels7: checks 
Tyoma_Kovach: checks 
0nix770: checks 
slipperyII: checks 
*** RIVER *** [3c 8s Qh 2d] [2h]
Deniels7: checks 
Tyoma_Kovach: checks 
0nix770: checks 
slipperyII: checks 
*** SHOW DOWN ***
Deniels7: shows [Kc Js] (a pair of Deuces)
Tyoma_Kovach: shows [As Jc] (a pair of Deuces - Ace kicker)
0nix770: mucks hand 
slipperyII: shows [9c 8c] (two pair, Eights and Deuces)
slipperyII collected $0.96 from pot
*** SUMMARY ***
Total pot $1 | Rake $0.04 
Board [3c 8s Qh 2d 2h]
Seat 1: Tyoma_Kovach (big blind) showed [As Jc] and lost with a pair of Deuces
Seat 2: johnysvk18 folded before Flop (didn't bet)
Seat 3: thedude696969 folded before Flop (didn't bet)
Seat 4: 0nix770 mucked
Seat 5: slipperyII (button) showed [9c 8c] and won ($0.96) with two pair, Eights and Deuces
Seat 6: Deniels7 (small blind) showed [Kc Js] and lost with a pair of Deuces



PokerStars Hand #222943094114:  Hold'em No Limit ($0.05/$0.10 USD) - 2021/01/23 22:39:59 ET
Table 'Algieba III' 6-max Seat #6 is the button
Seat 1: Tyoma_Kovach ($11.04 in chips) 
Seat 2: johnysvk18 ($13.52 in chips) 
Seat 3: thedude696969 ($20.02 in chips) 
Seat 4: 0nix770 ($11.47 in chips) 
Seat 5: slipperyII ($10.71 in chips) 
Seat 6: Deniels7 ($8.60 in chips) 
Tyoma_Kovach: posts small blind $0.05
johnysvk18: posts big blind $0.10
*** HOLE CARDS ***
thedude696969: folds 
0nix770: folds 
slipperyII: folds 
Deniels7: raises $0.10 to $0.20
Tyoma_Kovach: folds 
johnysvk18: folds 
Uncalled bet ($0.10) returned to Deniels7
Deniels7 collected $0.25 from pot
Deniels7: doesn't show hand 
*** SUMMARY ***
Total pot $0.25 | Rake $0 
Seat 1: Tyoma_Kovach (small blind) folded before Flop
Seat 2: johnysvk18 (big blind) folded before Flop
Seat 3: thedude696969 folded before Flop (didn't bet)
Seat 4: 0nix770 folded before Flop (didn't bet)
Seat 5: slipperyII folded before Flop (didn't bet)
Seat 6: Deniels7 (button) collected ($0.25)



PokerStars Hand #222943100347:  Hold'em No Limit ($0.05/$0.10 USD) - 2021/01/23 22:40:17 ET
Table 'Algieba III' 6-max Seat #1 is the button
Seat 1: Tyoma_Kovach ($10.99 in chips) 
Seat 2: johnysvk18 ($13.42 in chips) 
Seat 3: thedude696969 ($20.02 in chips) 
Seat 4: 0nix770 ($11.47 in chips) 
Seat 5: slipperyII ($10.71 in chips) 
Seat 6: Deniels7 ($8.75 in chips) 
johnysvk18: posts small blind $0.05
thedude696969: posts big blind $0.10
*** HOLE CARDS ***
0nix770: folds 
slipperyII: folds 
Deniels7: calls $0.10
Tyoma_Kovach: raises $0.35 to $0.45
johnysvk18: folds 
thedude696969: folds 
Deniels7: calls $0.35
*** FLOP *** [2c 9d 2h]
Deniels7: checks 
Tyoma_Kovach: bets $0.33
Deniels7: folds 
Uncalled bet ($0.33) returned to Tyoma_Kovach
Tyoma_Kovach collected $1 from pot
Tyoma_Kovach: doesn't show hand 
*** SUMMARY ***
Total pot $1.05 | Rake $0.05 
Board [2c 9d 2h]
Seat 1: Tyoma_Kovach (button) collected ($1)
Seat 2: johnysvk18 (small blind) folded before Flop
Seat 3: thedude696969 (big blind) folded before Flop
Seat 4: 0nix770 folded before Flop (didn't bet)
Seat 5: slipperyII folded before Flop (didn't bet)
Seat 6: Deniels7 folded on the Flop



PokerStars Hand #222943108252:  Hold'em No Limit ($0.05/$0.10 USD) - 2021/01/23 22:40:40 ET
Table 'Algieba III' 6-max Seat #2 is the button
Seat 1: Tyoma_Kovach ($11.54 in chips) 
Seat 2: johnysvk18 ($13.37 in chips) 
Seat 3: thedude696969 ($19.92 in chips) 
Seat 4: 0nix770 ($11.47 in chips) 
Seat 5: slipperyII ($10.71 in chips) 
Seat 6: Deniels7 ($8.30 in chips) 
thedude696969: posts small blind $0.05
0nix770: posts big blind $0.10
*** HOLE CARDS ***
slipperyII: folds 
Deniels7: calls $0.10
Tyoma_Kovach: folds 
johnysvk18: raises $0.25 to $0.35
thedude696969: folds 
0nix770: folds 
Deniels7: calls $0.25
*** FLOP *** [Ks 5s 2d]
Deniels7: bets $0.20
johnysvk18: calls $0.20
*** TURN *** [Ks 5s 2d] [8s]
Deniels7: bets $0.20
johnysvk18: calls $0.20
*** RIVER *** [Ks 5s 2d 8s] [Js]
Deniels7: bets $0.50
johnysvk18: folds 
Uncalled bet ($0.50) returned to Deniels7
Deniels7 collected $1.58 from pot
Deniels7: doesn't show hand 
*** SUMMARY ***
Total pot $1.65 | Rake $0.07 
Board [Ks 5s 2d 8s Js]
Seat 1: Tyoma_Kovach folded before Flop (didn't bet)
Seat 2: johnysvk18 (button) folded on the River
Seat 3: thedude696969 (small blind) folded before Flop
Seat 4: 0nix770 (big blind) folded before Flop
Seat 5: slipperyII folded before Flop (didn't bet)
Seat 6: Deniels7 collected ($1.58)



PokerStars Hand #222943126049:  Hold'em No Limit ($0.05/$0.10 USD) - 2021/01/23 22:41:31 ET
Table 'Algieba III' 6-max Seat #3 is the button
Seat 1: Tyoma_Kovach ($11.54 in chips) 
Seat 2: johnysvk18 ($12.62 in chips) 
Seat 3: thedude696969 ($19.87 in chips) 
Seat 4: 0nix770 ($11.37 in chips) 
Seat 5: slipperyII ($10.71 in chips) 
Seat 6: Deniels7 ($9.13 in chips) 
0nix770: posts small blind $0.05
slipperyII: posts big blind $0.10
*** HOLE CARDS ***
Deniels7: folds 
Tyoma_Kovach: folds 
johnysvk18: folds 
thedude696969: folds 
0nix770: raises $0.20 to $0.30
slipperyII: folds 
Uncalled bet ($0.20) returned to 0nix770
0nix770 collected $0.20 from pot
0nix770: doesn't show hand 
*** SUMMARY ***
Total pot $0.20 | Rake $0 
Seat 1: Tyoma_Kovach folded before Flop (didn't bet)
Seat 2: johnysvk18 folded before Flop (didn't bet)
Seat 3: thedude696969 (button) folded before Flop (didn't bet)
Seat 4: 0nix770 (small blind) collected ($0.20)
Seat 5: slipperyII (big blind) folded before Flop
Seat 6: Deniels7 folded before Flop (didn't bet)



PokerStars Hand #222943130262:  Hold'em No Limit ($0.05/$0.10 USD) - 2021/01/23 22:41:43 ET
Table 'Algieba III' 6-max Seat #4 is the button
Seat 1: Tyoma_Kovach ($11.54 in chips) 
Seat 2: johnysvk18 ($12.62 in chips) 
Seat 3: thedude696969 ($19.87 in chips) 
Seat 4: 0nix770 ($11.47 in chips) 
Seat 5: slipperyII ($10.61 in chips) 
Seat 6: Deniels7 ($9.13 in chips) 
slipperyII: posts small blind $0.05
Deniels7: posts big blind $0.10
*** HOLE CARDS ***
Tyoma_Kovach: folds 
johnysvk18: folds 
thedude696969: folds 
0nix770: raises $0.13 to $0.23
slipperyII: folds 
Deniels7: calls $0.13
*** FLOP *** [9s 3d 6h]
slipperyII leaves the table
Deniels7: checks 
0nix770: bets $0.21
Deniels7: folds 
Uncalled bet ($0.21) returned to 0nix770
0nix770 collected $0.49 from pot
0nix770: doesn't show hand 
*** SUMMARY ***
Total pot $0.51 | Rake $0.02 
Board [9s 3d 6h]
Seat 1: Tyoma_Kovach folded before Flop (didn't bet)
Seat 2: johnysvk18 folded before Flop (didn't bet)
Seat 3: thedude696969 folded before Flop (didn't bet)
Seat 4: 0nix770 (button) collected ($0.49)
Seat 5: slipperyII (small blind) folded before Flop
Seat 6: Deniels7 (big blind) folded on the Flop



PokerStars Hand #222943144761:  Hold'em No Limit ($0.05/$0.10 USD) - 2021/01/23 22:42:25 ET
Table 'Algieba III' 6-max Seat #6 is the button
Seat 1: Tyoma_Kovach ($11.54 in chips) 
Seat 2: johnysvk18 ($12.62 in chips) 
Seat 3: thedude696969 ($19.87 in chips) 
Seat 4: 0nix770 ($11.73 in chips) 
Seat 6: Deniels7 ($8.90 in chips) 
Tyoma_Kovach: posts small blind $0.05
johnysvk18: posts big blind $0.10
*** HOLE CARDS ***
patboy73 joins the table at seat #5 
thedude696969: folds 
0nix770: folds 
Deniels7: folds 
Tyoma_Kovach: raises $0.20 to $0.30
johnysvk18: folds 
Uncalled bet ($0.20) returned to Tyoma_Kovach
Tyoma_Kovach collected $0.20 from pot
Tyoma_Kovach: doesn't show hand 
*** SUMMARY ***
Total pot $0.20 | Rake $0 
Seat 1: Tyoma_Kovach (small blind) collected ($0.20)
Seat 2: johnysvk18 (big blind) folded before Flop
Seat 3: thedude696969 folded before Flop (didn't bet)
Seat 4: 0nix770 folded before Flop (didn't bet)
Seat 6: Deniels7 (button) folded before Flop (didn't bet)



PokerStars Hand #222943152401:  Hold'em No Limit ($0.05/$0.10 USD) - 2021/01/23 22:42:41 ET
Table 'Algieba III' 6-max Seat #1 is the button
Seat 1: Tyoma_Kovach ($11.64 in chips) 
Seat 2: johnysvk18 ($12.52 in chips) 
Seat 3: thedude696969 ($19.87 in chips) 
Seat 4: 0nix770 ($11.73 in chips) 
Seat 5: patboy73 ($10 in chips) 
Seat 6: Deniels7 ($8.90 in chips) 
johnysvk18: posts small blind $0.05
thedude696969: posts big blind $0.10
patboy73: posts big blind $0.10
*** HOLE CARDS ***
0nix770: raises $0.30 to $0.40
patboy73: folds 
Deniels7: folds 
Tyoma_Kovach: folds 
johnysvk18: folds 
thedude696969: folds 
Uncalled bet ($0.30) returned to 0nix770
0nix770 collected $0.35 from pot
0nix770: doesn't show hand 
*** SUMMARY ***
Total pot $0.35 | Rake $0 
Seat 1: Tyoma_Kovach (button) folded before Flop (didn't bet)
Seat 2: johnysvk18 (small blind) folded before Flop
Seat 3: thedude696969 (big blind) folded before Flop
Seat 4: 0nix770 collected ($0.35)
Seat 5: patboy73 folded before Flop (didn't bet)
Seat 6: Deniels7 folded before Flop (didn't bet)



PokerStars Hand #222943156367:  Hold'em No Limit ($0.05/$0.10 USD) - 2021/01/23 22:42:53 ET
Table 'Algieba III' 6-max Seat #2 is the button
Seat 1: Tyoma_Kovach ($11.64 in chips) 
Seat 2: johnysvk18 ($12.47 in chips) 
Seat 3: thedude696969 ($19.77 in chips) 
Seat 4: 0nix770 ($11.98 in chips) 
Seat 5: patboy73 ($9.90 in chips) 
Seat 6: Deniels7 ($8.90 in chips) 
thedude696969: posts small blind $0.05
0nix770: posts big blind $0.10
*** HOLE CARDS ***
patboy73: calls $0.10
Deniels7: folds 
Tyoma_Kovach: folds 
johnysvk18: folds 
thedude696969: calls $0.05
0nix770: checks 
*** FLOP *** [Kh Td Jh]
thedude696969: checks 
0nix770: bets $0.19
patboy73: calls $0.19
thedude696969: folds 
*** TURN *** [Kh Td Jh] [Jd]
0nix770: checks 
patboy73: checks 
*** RIVER *** [Kh Td Jh Jd] [7d]
0nix770: bets $0.65
patboy73: calls $0.65
*** SHOW DOWN ***
0nix770: shows [9c Qc] (a straight, Nine to King)
patboy73: mucks hand 
0nix770 collected $1.89 from pot
*** SUMMARY ***
Total pot $1.98 | Rake $0.09 
Board [Kh Td Jh Jd 7d]
Seat 1: Tyoma_Kovach folded before Flop (didn't bet)
Seat 2: johnysvk18 (button) folded before Flop (didn't bet)
Seat 3: thedude696969 (small blind) folded on the Flop
Seat 4: 0nix770 (big blind) showed [9c Qc] and won ($1.89) with a straight, Nine to King
Seat 5: patboy73 mucked
Seat 6: Deniels7 folded before Flop (didn't bet)



PokerStars Hand #222943175018:  Hold'em No Limit ($0.05/$0.10 USD) - 2021/01/23 22:43:47 ET
Table 'Algieba III' 6-max Seat #3 is the button
Seat 1: Tyoma_Kovach ($11.64 in chips) 
Seat 2: johnysvk18 ($12.47 in chips) 
Seat 3: thedude696969 ($19.67 in chips) 
Seat 4: 0nix770 ($12.93 in chips) 
Seat 5: patboy73 ($8.96 in chips) 
Seat 6: Deniels7 ($8.90 in chips) 
0nix770: posts small blind $0.05
patboy73: posts big blind $0.10
*** HOLE CARDS ***
Deniels7: folds 
Tyoma_Kovach: folds 
johnysvk18: folds 
thedude696969: folds 
0nix770: folds 
Uncalled bet ($0.05) returned to patboy73
patboy73 collected $0.10 from pot
*** SUMMARY ***
Total pot $0.10 | Rake $0 
Seat 1: Tyoma_Kovach folded before Flop (didn't bet)
Seat 2: johnysvk18 folded before Flop (didn't bet)
Seat 3: thedude696969 (button) folded before Flop (didn't bet)
Seat 4: 0nix770 (small blind) folded before Flop
Seat 5: patboy73 (big blind) collected ($0.10)
Seat 6: Deniels7 folded before Flop (didn't bet)



PokerStars Hand #222943179353:  Hold'em No Limit ($0.05/$0.10 USD) - 2021/01/23 22:43:59 ET
Table 'Algieba III' 6-max Seat #4 is the button
Seat 1: Tyoma_Kovach ($11.64 in chips) 
Seat 2: johnysvk18 ($12.47 in chips) 
Seat 3: thedude696969 ($19.67 in chips) 
Seat 4: 0nix770 ($12.88 in chips) 
Seat 5: patboy73 ($9.01 in chips) 
Seat 6: Deniels7 ($8.90 in chips) 
patboy73: posts small blind $0.05
Deniels7: posts big blind $0.10
*** HOLE CARDS ***
Tyoma_Kovach: folds 
johnysvk18: folds 
thedude696969: folds 
0nix770: raises $0.13 to $0.23
patboy73: folds 
Deniels7: calls $0.13
*** FLOP *** [8s 5h 7d]
Deniels7: bets $0.20
0nix770: raises $0.50 to $0.70
Deniels7: calls $0.50
*** TURN *** [8s 5h 7d] [6h]
Deniels7: checks 
0nix770: checks 
*** RIVER *** [8s 5h 7d 6h] [As]
Deniels7: checks 
0nix770: bets $2.24
Deniels7: raises $2.24 to $4.48
0nix770: raises $7.47 to $11.95 and is all-in
Deniels7: calls $3.49 and is all-in
Uncalled bet ($3.98) returned to 0nix770
*** SHOW DOWN ***
0nix770: shows [Qc 9h] (a straight, Five to Nine)
Deniels7: shows [Ts 9c] (a straight, Six to Ten)
Deniels7 collected $17.05 from pot
*** SUMMARY ***
Total pot $17.85 | Rake $0.80 
Board [8s 5h 7d 6h As]
Seat 1: Tyoma_Kovach folded before Flop (didn't bet)
Seat 2: johnysvk18 folded before Flop (didn't bet)
Seat 3: thedude696969 folded before Flop (didn't bet)
Seat 4: 0nix770 (button) showed [Qc 9h] and lost with a straight, Five to Nine
Seat 5: patboy73 (small blind) folded before Flop
Seat 6: Deniels7 (big blind) showed [Ts 9c] and won ($17.05) with a straight, Six to Ten



PokerStars Hand #222943197765:  Hold'em No Limit ($0.05/$0.10 USD) - 2021/01/23 22:44:53 ET
Table 'Algieba III' 6-max Seat #5 is the button
Seat 1: Tyoma_Kovach ($11.64 in chips) 
Seat 2: johnysvk18 ($12.47 in chips) 
Seat 3: thedude696969 ($19.67 in chips) 
Seat 4: 0nix770 ($10 in chips) 
Seat 5: patboy73 ($8.96 in chips) 
Seat 6: Deniels7 ($17.05 in chips) 
Deniels7: posts small blind $0.05
Tyoma_Kovach: posts big blind $0.10
*** HOLE CARDS ***
johnysvk18: folds 
thedude696969: folds 
0nix770: folds 
patboy73: folds 
Deniels7: folds 
Uncalled bet ($0.05) returned to Tyoma_Kovach
Tyoma_Kovach collected $0.10 from pot
Tyoma_Kovach: doesn't show hand 
*** SUMMARY ***
Total pot $0.10 | Rake $0 
Seat 1: Tyoma_Kovach (big blind) collected ($0.10)
Seat 2: johnysvk18 folded before Flop (didn't bet)
Seat 3: thedude696969 folded before Flop (didn't bet)
Seat 4: 0nix770 folded before Flop (didn't bet)
Seat 5: patboy73 (button) folded before Flop (didn't bet)
Seat 6: Deniels7 (small blind) folded before Flop



PokerStars Hand #222943201996:  Hold'em No Limit ($0.05/$0.10 USD) - 2021/01/23 22:45:05 ET
Table 'Algieba III' 6-max Seat #6 is the button
Seat 1: Tyoma_Kovach ($11.69 in chips) 
Seat 2: johnysvk18 ($12.47 in chips) 
Seat 3: thedude696969 ($19.67 in chips) 
Seat 4: 0nix770 ($10 in chips) 
Seat 5: patboy73 ($8.96 in chips) 
Seat 6: Deniels7 ($17 in chips) 
Tyoma_Kovach: posts small blind $0.05
johnysvk18: posts big blind $0.10
*** HOLE CARDS ***
thedude696969: folds 
0nix770: folds 
patboy73: folds 
Deniels7: folds 
Tyoma_Kovach: raises $0.20 to $0.30
johnysvk18: folds 
Uncalled bet ($0.20) returned to Tyoma_Kovach
Tyoma_Kovach collected $0.20 from pot
Tyoma_Kovach: doesn't show hand 
*** SUMMARY ***
Total pot $0.20 | Rake $0 
Seat 1: Tyoma_Kovach (small blind) collected ($0.20)
Seat 2: johnysvk18 (big blind) folded before Flop
Seat 3: thedude696969 folded before Flop (didn't bet)
Seat 4: 0nix770 folded before Flop (didn't bet)
Seat 5: patboy73 folded before Flop (didn't bet)
Seat 6: Deniels7 (button) folded before Flop (didn't bet)



PokerStars Hand #222943208087:  Hold'em No Limit ($0.05/$0.10 USD) - 2021/01/23 22:45:23 ET
Table 'Algieba III' 6-max Seat #1 is the button
Seat 1: Tyoma_Kovach ($11.79 in chips) 
Seat 2: johnysvk18 ($12.37 in chips) 
Seat 3: thedude696969 ($19.67 in chips) 
Seat 4: 0nix770 ($10 in chips) 
Seat 5: patboy73 ($8.96 in chips) 
Seat 6: Deniels7 ($17 in chips) 
johnysvk18: posts small blind $0.05
thedude696969: posts big blind $0.10
*** HOLE CARDS ***
0nix770: folds 
patboy73: folds 
Deniels7: folds 
Tyoma_Kovach: folds 
johnysvk18: folds 
Uncalled bet ($0.05) returned to thedude696969
thedude696969 collected $0.10 from pot
thedude696969: doesn't show hand 
*** SUMMARY ***
Total pot $0.10 | Rake $0 
Seat 1: Tyoma_Kovach (button) folded before Flop (didn't bet)
Seat 2: johnysvk18 (small blind) folded before Flop
Seat 3: thedude696969 (big blind) collected ($0.10)
Seat 4: 0nix770 folded before Flop (didn't bet)
Seat 5: patboy73 folded before Flop (didn't bet)
Seat 6: Deniels7 folded before Flop (didn't bet)



PokerStars Hand #222943210604:  Hold'em No Limit ($0.05/$0.10 USD) - 2021/01/23 22:45:30 ET
Table 'Algieba III' 6-max Seat #2 is the button
Seat 1: Tyoma_Kovach ($11.79 in chips) 
Seat 2: johnysvk18 ($12.32 in chips) 
Seat 3: thedude696969 ($19.72 in chips) 
Seat 5: patboy73 ($8.96 in chips) 
Seat 6: Deniels7 ($17 in chips) 
thedude696969: posts small blind $0.05
0nix770: is sitting out 
patboy73: posts big blind $0.10
*** HOLE CARDS ***
Deniels7: folds 
Tyoma_Kovach: folds 
johnysvk18: folds 
thedude696969: raises $0.20 to $0.30
patboy73: folds 
Uncalled bet ($0.20) returned to thedude696969
thedude696969 collected $0.20 from pot
thedude696969: doesn't show hand 
*** SUMMARY ***
Total pot $0.20 | Rake $0 
Seat 1: Tyoma_Kovach folded before Flop (didn't bet)
Seat 2: johnysvk18 (button) folded before Flop (didn't bet)
Seat 3: thedude696969 (small blind) collected ($0.20)
Seat 5: patboy73 (big blind) folded before Flop
Seat 6: Deniels7 folded before Flop (didn't bet)



PokerStars Hand #222943216801:  Hold'em No Limit ($0.05/$0.10 USD) - 2021/01/23 22:45:49 ET
Table 'Algieba III' 6-max Seat #3 is the button
Seat 1: Tyoma_Kovach ($11.79 in chips) 
Seat 2: johnysvk18 ($12.32 in chips) 
Seat 3: thedude696969 ($19.82 in chips) 
Seat 5: patboy73 ($8.86 in chips) 
Seat 6: Deniels7 ($17 in chips) 
patboy73: posts small blind $0.05
Deniels7: posts big blind $0.10
*** HOLE CARDS ***
Tyoma_Kovach: folds 
johnysvk18: folds 
thedude696969: raises $0.20 to $0.30
patboy73: calls $0.25
Deniels7: folds 
*** FLOP *** [3s Qc As]
patboy73: checks 
thedude696969: checks 
*** TURN *** [3s Qc As] [Td]
patboy73: checks 
thedude696969: checks 
*** RIVER *** [3s Qc As Td] [9c]
patboy73: checks 
thedude696969: bets $0.42
patboy73: folds 
Uncalled bet ($0.42) returned to thedude696969
thedude696969 collected $0.67 from pot
thedude696969: doesn't show hand 
*** SUMMARY ***
Total pot $0.70 | Rake $0.03 
Board [3s Qc As Td 9c]
Seat 1: Tyoma_Kovach folded before Flop (didn't bet)
Seat 2: johnysvk18 folded before Flop (didn't bet)
Seat 3: thedude696969 (button) collected ($0.67)
Seat 5: patboy73 (small blind) folded on the River
Seat 6: Deniels7 (big blind) folded before Flop



PokerStars Hand #222943235800:  Hold'em No Limit ($0.05/$0.10 USD) - 2021/01/23 22:46:35 ET
Table 'Algieba III' 6-max Seat #5 is the button
Seat 1: Tyoma_Kovach ($11.79 in chips) 
Seat 2: johnysvk18 ($12.32 in chips) 
Seat 3: thedude696969 ($20.19 in chips) 
Seat 5: patboy73 ($8.56 in chips) 
Seat 6: Deniels7 ($16.90 in chips) 
Deniels7: posts small blind $0.05
Tyoma_Kovach: posts big blind $0.10
*** HOLE CARDS ***
johnysvk18: folds 
thedude696969: folds 
patboy73: calls $0.10
Deniels7: calls $0.05
Tyoma_Kovach: checks 
*** FLOP *** [Jh 7h 5s]
Deniels7: checks 
Tyoma_Kovach: checks 
patboy73: checks 
*** TURN *** [Jh 7h 5s] [5c]
Deniels7: bets $0.10
Tyoma_Kovach: calls $0.10
patboy73: folds 
*** RIVER *** [Jh 7h 5s 5c] [Qh]
Deniels7: checks 
Tyoma_Kovach: checks 
*** SHOW DOWN ***
Deniels7: shows [Qd 7s] (two pair, Queens and Sevens)
Tyoma_Kovach: mucks hand 
Deniels7 collected $0.48 from pot
*** SUMMARY ***
Total pot $0.50 | Rake $0.02 
Board [Jh 7h 5s 5c Qh]
Seat 1: Tyoma_Kovach (big blind) mucked
Seat 2: johnysvk18 folded before Flop (didn't bet)
Seat 3: thedude696969 folded before Flop (didn't bet)
Seat 5: patboy73 (button) folded on the Turn
Seat 6: Deniels7 (small blind) showed [Qd 7s] and won ($0.48) with two pair, Queens and Sevens



PokerStars Hand #222943248164:  Hold'em No Limit ($0.05/$0.10 USD) - 2021/01/23 22:47:11 ET
Table 'Algieba III' 6-max Seat #6 is the button
Seat 1: Tyoma_Kovach ($11.59 in chips) 
Seat 2: johnysvk18 ($12.32 in chips) 
Seat 3: thedude696969 ($20.19 in chips) 
Seat 5: patboy73 ($8.46 in chips) 
Seat 6: Deniels7 ($17.18 in chips) 
Tyoma_Kovach: posts small blind $0.05
johnysvk18: posts big blind $0.10
*** HOLE CARDS ***
thedude696969: calls $0.10
patboy73: folds 
Deniels7: calls $0.10
Tyoma_Kovach: raises $0.50 to $0.60
johnysvk18: folds 
thedude696969: folds 
Deniels7: calls $0.50
*** FLOP *** [2c 7c 9c]
Tyoma_Kovach: bets $0.44
Deniels7: calls $0.44
*** TURN *** [2c 7c 9c] [Qc]
Tyoma_Kovach: checks 
Deniels7: bets $1
Tyoma_Kovach: calls $1
*** RIVER *** [2c 7c 9c Qc] [3h]
Tyoma_Kovach: checks 
Deniels7: checks 
*** SHOW DOWN ***
Tyoma_Kovach: shows [8c 8h] (a flush, Queen high)
Deniels7: mucks hand 
Tyoma_Kovach collected $4.09 from pot
*** SUMMARY ***
Total pot $4.28 | Rake $0.19 
Board [2c 7c 9c Qc 3h]
Seat 1: Tyoma_Kovach (small blind) showed [8c 8h] and won ($4.09) with a flush, Queen high
Seat 2: johnysvk18 (big blind) folded before Flop
Seat 3: thedude696969 folded before Flop
Seat 5: patboy73 folded before Flop (didn't bet)
Seat 6: Deniels7 (button) mucked



PokerStars Hand #222943266480:  Hold'em No Limit ($0.05/$0.10 USD) - 2021/01/23 22:48:05 ET
Table 'Algieba III' 6-max Seat #1 is the button
Seat 1: Tyoma_Kovach ($13.64 in chips) 
Seat 2: johnysvk18 ($12.22 in chips) 
Seat 3: thedude696969 ($20.09 in chips) 
Seat 5: patboy73 ($8.46 in chips) 
Seat 6: Deniels7 ($15.14 in chips) 
johnysvk18: posts small blind $0.05
thedude696969: posts big blind $0.10
*** HOLE CARDS ***
patboy73: folds 
Deniels7: folds 
Tyoma_Kovach: raises $0.15 to $0.25
johnysvk18: folds 
thedude696969: calls $0.15
*** FLOP *** [Qh Qc 6s]
thedude696969: checks 
Tyoma_Kovach: checks 
*** TURN *** [Qh Qc 6s] [9s]
thedude696969: checks 
Tyoma_Kovach: bets $0.35
thedude696969: folds 
Uncalled bet ($0.35) returned to Tyoma_Kovach
Tyoma_Kovach collected $0.53 from pot
Tyoma_Kovach: doesn't show hand 
*** SUMMARY ***
Total pot $0.55 | Rake $0.02 
Board [Qh Qc 6s 9s]
Seat 1: Tyoma_Kovach (button) collected ($0.53)
Seat 2: johnysvk18 (small blind) folded before Flop
Seat 3: thedude696969 (big blind) folded on the Turn
Seat 5: patboy73 folded before Flop (didn't bet)
Seat 6: Deniels7 folded before Flop (didn't bet)



PokerStars Hand #222943276916:  Hold'em No Limit ($0.05/$0.10 USD) - 2021/01/23 22:48:35 ET
Table 'Algieba III' 6-max Seat #2 is the button
Seat 1: Tyoma_Kovach ($13.92 in chips) 
Seat 2: johnysvk18 ($12.17 in chips) 
Seat 3: thedude696969 ($19.84 in chips) 
Seat 5: patboy73 ($8.46 in chips) 
Seat 6: Deniels7 ($15.14 in chips) 
thedude696969: posts small blind $0.05
patboy73: posts big blind $0.10
*** HOLE CARDS ***
Deniels7: folds 
Tyoma_Kovach: folds 
johnysvk18: raises $0.15 to $0.25
thedude696969: folds 
patboy73: calls $0.15
*** FLOP *** [3s 5d As]
patboy73: checks 
johnysvk18: bets $0.20
patboy73: folds 
Uncalled bet ($0.20) returned to johnysvk18
johnysvk18 collected $0.53 from pot
johnysvk18: doesn't show hand 
*** SUMMARY ***
Total pot $0.55 | Rake $0.02 
Board [3s 5d As]
Seat 1: Tyoma_Kovach folded before Flop (didn't bet)
Seat 2: johnysvk18 (button) collected ($0.53)
Seat 3: thedude696969 (small blind) folded before Flop
Seat 5: patboy73 (big blind) folded on the Flop
Seat 6: Deniels7 folded before Flop (didn't bet)



PokerStars Hand #222943296504:  Hold'em No Limit ($0.05/$0.10 USD) - 2021/01/23 22:49:15 ET
Table 'Algieba III' 6-max Seat #3 is the button
Seat 1: Tyoma_Kovach ($13.92 in chips) 
Seat 2: johnysvk18 ($12.45 in chips) 
Seat 3: thedude696969 ($19.79 in chips) 
Seat 5: patboy73 ($8.21 in chips) 
Seat 6: Deniels7 ($15.14 in chips) 
patboy73: posts small blind $0.05
Deniels7: posts big blind $0.10
*** HOLE CARDS ***
Tyoma_Kovach: folds 
johnysvk18: folds 
thedude696969: folds 
patboy73: calls $0.05
Deniels7: raises $0.10 to $0.20
patboy73: calls $0.10
*** FLOP *** [Kh Kd 9s]
patboy73: checks 
Deniels7: checks 
*** TURN *** [Kh Kd 9s] [Qh]
patboy73: bets $0.10
Deniels7: calls $0.10
*** RIVER *** [Kh Kd 9s Qh] [Js]
patboy73: checks 
Deniels7: bets $0.60
patboy73: folds 
Uncalled bet ($0.60) returned to Deniels7
Deniels7 collected $0.57 from pot
Deniels7: doesn't show hand 
*** SUMMARY ***
Total pot $0.60 | Rake $0.03 
Board [Kh Kd 9s Qh Js]
Seat 1: Tyoma_Kovach folded before Flop (didn't bet)
Seat 2: johnysvk18 folded before Flop (didn't bet)
Seat 3: thedude696969 (button) folded before Flop (didn't bet)
Seat 5: patboy73 (small blind) folded on the River
Seat 6: Deniels7 (big blind) collected ($0.57)



PokerStars Hand #222943311939:  Hold'em No Limit ($0.05/$0.10 USD) - 2021/01/23 22:50:01 ET
Table 'Algieba III' 6-max Seat #5 is the button
Seat 1: Tyoma_Kovach ($13.92 in chips) 
Seat 2: johnysvk18 ($12.45 in chips) 
Seat 3: thedude696969 ($19.79 in chips) 
Seat 5: patboy73 ($7.91 in chips) 
Seat 6: Deniels7 ($15.41 in chips) 
Deniels7: posts small blind $0.05
Tyoma_Kovach: posts big blind $0.10
*** HOLE CARDS ***
johnysvk18: raises $0.15 to $0.25
thedude696969: folds 
patboy73: calls $0.25
Deniels7: folds 
Tyoma_Kovach: folds 
*** FLOP *** [4d 3h 5s]
johnysvk18: checks 
patboy73: checks 
*** TURN *** [4d 3h 5s] [Ah]
johnysvk18: bets $0.20
patboy73: raises $0.20 to $0.40
johnysvk18: calls $0.20
*** RIVER *** [4d 3h 5s Ah] [Kh]
johnysvk18: checks 
patboy73: checks 
*** SHOW DOWN ***
johnysvk18: shows [8s 7s] (high card Ace)
patboy73: shows [2d 2h] (a straight, Ace to Five)
patboy73 collected $1.38 from pot
*** SUMMARY ***
Total pot $1.45 | Rake $0.07 
Board [4d 3h 5s Ah Kh]
Seat 1: Tyoma_Kovach (big blind) folded before Flop
Seat 2: johnysvk18 showed [8s 7s] and lost with high card Ace
Seat 3: thedude696969 folded before Flop (didn't bet)
Seat 5: patboy73 (button) showed [2d 2h] and won ($1.38) with a straight, Ace to Five
Seat 6: Deniels7 (small blind) folded before Flop



PokerStars Hand #222943328227:  Hold'em No Limit ($0.05/$0.10 USD) - 2021/01/23 22:50:50 ET
Table 'Algieba III' 6-max Seat #6 is the button
Seat 1: Tyoma_Kovach ($13.82 in chips) 
Seat 2: johnysvk18 ($11.80 in chips) 
Seat 3: thedude696969 ($19.79 in chips) 
Seat 5: patboy73 ($8.64 in chips) 
Seat 6: Deniels7 ($15.36 in chips) 
Tyoma_Kovach: posts small blind $0.05
johnysvk18: posts big blind $0.10
*** HOLE CARDS ***
thedude696969: folds 
patboy73: folds 
Deniels7: folds 
Tyoma_Kovach: raises $0.20 to $0.30
johnysvk18: calls $0.20
*** FLOP *** [Kc Th Jc]
Tyoma_Kovach: bets $0.19
johnysvk18: folds 
Uncalled bet ($0.19) returned to Tyoma_Kovach
Tyoma_Kovach collected $0.57 from pot
Tyoma_Kovach: doesn't show hand 
*** SUMMARY ***
Total pot $0.60 | Rake $0.03 
Board [Kc Th Jc]
Seat 1: Tyoma_Kovach (small blind) collected ($0.57)
Seat 2: johnysvk18 (big blind) folded on the Flop
Seat 3: thedude696969 folded before Flop (didn't bet)
Seat 5: patboy73 folded before Flop (didn't bet)
Seat 6: Deniels7 (button) folded before Flop (didn't bet)



PokerStars Hand #222943340026:  Hold'em No Limit ($0.05/$0.10 USD) - 2021/01/23 22:51:25 ET
Table 'Algieba III' 6-max Seat #1 is the button
Seat 1: Tyoma_Kovach ($14.09 in chips) 
Seat 2: johnysvk18 ($11.50 in chips) 
Seat 3: thedude696969 ($19.79 in chips) 
Seat 5: patboy73 ($8.64 in chips) 
Seat 6: Deniels7 ($15.36 in chips) 
johnysvk18: posts small blind $0.05
thedude696969: posts big blind $0.10
*** HOLE CARDS ***
patboy73: folds 
Deniels7: folds 
Tyoma_Kovach: raises $0.15 to $0.25
johnysvk18: raises $0.70 to $0.95
thedude696969: folds 
Tyoma_Kovach: calls $0.70
*** FLOP *** [Th 4s Jc]
johnysvk18: checks 
Tyoma_Kovach: checks 
*** TURN *** [Th 4s Jc] [Qs]
johnysvk18: checks 
Tyoma_Kovach: checks 
*** RIVER *** [Th 4s Jc Qs] [2s]
johnysvk18: checks 
Tyoma_Kovach: checks 
*** SHOW DOWN ***
johnysvk18: shows [Ad Td] (a pair of Tens)
Tyoma_Kovach: mucks hand 
johnysvk18 collected $1.91 from pot
*** SUMMARY ***
Total pot $2 | Rake $0.09 
Board [Th 4s Jc Qs 2s]
Seat 1: Tyoma_Kovach (button) mucked
Seat 2: johnysvk18 (small blind) showed [Ad Td] and won ($1.91) with a pair of Tens
Seat 3: thedude696969 (big blind) folded before Flop
Seat 5: patboy73 folded before Flop (didn't bet)
Seat 6: Deniels7 folded before Flop (didn't bet)



PokerStars Hand #222943370896:  Hold'em No Limit ($0.05/$0.10 USD) - 2021/01/23 22:52:35 ET
Table 'Algieba III' 6-max Seat #2 is the button
Seat 1: Tyoma_Kovach ($13.14 in chips) 
Seat 2: johnysvk18 ($12.46 in chips) 
Seat 3: thedude696969 ($19.69 in chips) 
Seat 4: 0nix770 ($10 in chips) 
Seat 5: patboy73 ($8.64 in chips) 
Seat 6: Deniels7 ($15.36 in chips) 
thedude696969: posts small blind $0.05
0nix770: posts big blind $0.10
*** HOLE CARDS ***
patboy73: calls $0.10
Deniels7: calls $0.10
Tyoma_Kovach: raises $0.48 to $0.58
johnysvk18: folds 
thedude696969: folds 
0nix770: folds 
patboy73: calls $0.48
Deniels7: calls $0.48
*** FLOP *** [6c Jh Kh]
patboy73: checks 
Deniels7: checks 
Tyoma_Kovach: bets $1.35
patboy73: folds 
Deniels7: folds 
Uncalled bet ($1.35) returned to Tyoma_Kovach
Tyoma_Kovach collected $1.80 from pot
Tyoma_Kovach: doesn't show hand 
*** SUMMARY ***
Total pot $1.89 | Rake $0.09 
Board [6c Jh Kh]
Seat 1: Tyoma_Kovach collected ($1.80)
Seat 2: johnysvk18 (button) folded before Flop (didn't bet)
Seat 3: thedude696969 (small blind) folded before Flop
Seat 4: 0nix770 (big blind) folded before Flop
Seat 5: patboy73 folded on the Flop
Seat 6: Deniels7 folded on the Flop



PokerStars Hand #222943382245:  Hold'em No Limit ($0.05/$0.10 USD) - 2021/01/23 22:53:09 ET
Table 'Algieba III' 6-max Seat #3 is the button
Seat 1: Tyoma_Kovach ($14.36 in chips) 
Seat 2: johnysvk18 ($12.46 in chips) 
Seat 3: thedude696969 ($19.64 in chips) 
Seat 4: 0nix770 ($10 in chips) 
Seat 5: patboy73 ($8.06 in chips) 
Seat 6: Deniels7 ($14.78 in chips) 
0nix770: posts small blind $0.05
patboy73: posts big blind $0.10
*** HOLE CARDS ***
Deniels7: folds 
Tyoma_Kovach: raises $0.20 to $0.30
johnysvk18: folds 
thedude696969: folds 
0nix770: folds 
patboy73: calls $0.20
*** FLOP *** [Qs 6c 7h]
patboy73: checks 
Tyoma_Kovach: bets $0.20
patboy73: calls $0.20
*** TURN *** [Qs 6c 7h] [8d]
patboy73: checks 
Tyoma_Kovach: checks 
*** RIVER *** [Qs 6c 7h 8d] [6h]
patboy73: bets $0.50
Tyoma_Kovach: folds 
Uncalled bet ($0.50) returned to patboy73
patboy73 collected $1 from pot
*** SUMMARY ***
Total pot $1.05 | Rake $0.05 
Board [Qs 6c 7h 8d 6h]
Seat 1: Tyoma_Kovach folded on the River
Seat 2: johnysvk18 folded before Flop (didn't bet)
Seat 3: thedude696969 (button) folded before Flop (didn't bet)
Seat 4: 0nix770 (small blind) folded before Flop
Seat 5: patboy73 (big blind) collected ($1)
Seat 6: Deniels7 folded before Flop (didn't bet)



PokerStars Hand #222943394247:  Hold'em No Limit ($0.05/$0.10 USD) - 2021/01/23 22:53:45 ET
Table 'Algieba III' 6-max Seat #4 is the button
Seat 1: Tyoma_Kovach ($13.86 in chips) 
Seat 2: johnysvk18 ($12.46 in chips) 
Seat 3: thedude696969 ($19.64 in chips) 
Seat 4: 0nix770 ($10 in chips) 
Seat 5: patboy73 ($8.56 in chips) 
Seat 6: Deniels7 ($14.78 in chips) 
patboy73: posts small blind $0.05
Deniels7: posts big blind $0.10
*** HOLE CARDS ***
Tyoma_Kovach: folds 
johnysvk18: folds 
thedude696969: folds 
0nix770: folds 
patboy73: calls $0.05
Deniels7: checks 
*** FLOP *** [3s 9h 7s]
patboy73: checks 
Deniels7: checks 
*** TURN *** [3s 9h 7s] [Ad]
patboy73: checks 
Deniels7: checks 
*** RIVER *** [3s 9h 7s Ad] [Qd]
patboy73: checks 
Deniels7: checks 
*** SHOW DOWN ***
patboy73: shows [6h Th] (high card Ace)
Deniels7: mucks hand 
patboy73 collected $0.19 from pot
*** SUMMARY ***
Total pot $0.20 | Rake $0.01 
Board [3s 9h 7s Ad Qd]
Seat 1: Tyoma_Kovach folded before Flop (didn't bet)
Seat 2: johnysvk18 folded before Flop (didn't bet)
Seat 3: thedude696969 folded before Flop (didn't bet)
Seat 4: 0nix770 (button) folded before Flop (didn't bet)
Seat 5: patboy73 (small blind) showed [6h Th] and won ($0.19) with high card Ace
Seat 6: Deniels7 (big blind) mucked



PokerStars Hand #222943402866:  Hold'em No Limit ($0.05/$0.10 USD) - 2021/01/23 22:54:11 ET
Table 'Algieba III' 6-max Seat #5 is the button
Seat 1: Tyoma_Kovach ($13.86 in chips) 
Seat 2: johnysvk18 ($12.46 in chips) 
Seat 3: thedude696969 ($19.64 in chips) 
Seat 4: 0nix770 ($10 in chips) 
Seat 5: patboy73 ($8.65 in chips) 
Seat 6: Deniels7 ($14.68 in chips) 
Deniels7: posts small blind $0.05
Tyoma_Kovach: posts big blind $0.10
*** HOLE CARDS ***
johnysvk18: folds 
thedude696969: raises $0.14 to $0.24
0nix770: calls $0.24
patboy73: folds 
Deniels7: folds 
Tyoma_Kovach: folds 
*** FLOP *** [Td 6d Ks]
thedude696969: bets $0.30
0nix770: folds 
Uncalled bet ($0.30) returned to thedude696969
thedude696969 collected $0.60 from pot
thedude696969: doesn't show hand 
*** SUMMARY ***
Total pot $0.63 | Rake $0.03 
Board [Td 6d Ks]
Seat 1: Tyoma_Kovach (big blind) folded before Flop
Seat 2: johnysvk18 folded before Flop (didn't bet)
Seat 3: thedude696969 collected ($0.60)
Seat 4: 0nix770 folded on the Flop
Seat 5: patboy73 (button) folded before Flop (didn't bet)
Seat 6: Deniels7 (small blind) folded before Flop



PokerStars Hand #222943412145:  Hold'em No Limit ($0.05/$0.10 USD) - 2021/01/23 22:54:38 ET
Table 'Algieba III' 6-max Seat #6 is the button
Seat 1: Tyoma_Kovach ($13.76 in chips) 
Seat 2: johnysvk18 ($12.46 in chips) 
Seat 3: thedude696969 ($20 in chips) 
Seat 4: 0nix770 ($10 in chips) 
Seat 5: patboy73 ($8.65 in chips) 
Seat 6: Deniels7 ($14.63 in chips) 
Tyoma_Kovach: posts small blind $0.05
johnysvk18: posts big blind $0.10
*** HOLE CARDS ***
thedude696969: folds 
0nix770: folds 
patboy73: calls $0.10
Deniels7: folds 
Tyoma_Kovach: raises $0.40 to $0.50
johnysvk18: raises $1.10 to $1.60
patboy73: folds 
Tyoma_Kovach: raises $12.16 to $13.76 and is all-in
johnysvk18: calls $10.86 and is all-in
Uncalled bet ($1.30) returned to Tyoma_Kovach
*** FIRST FLOP *** [Td 9c 8c]
*** FIRST TURN *** [Td 9c 8c] [Ts]
*** FIRST RIVER *** [Td 9c 8c Ts] [2s]
*** SECOND FLOP *** [8s Qd 5c]
*** SECOND TURN *** [8s Qd 5c] [2d]
*** SECOND RIVER *** [8s Qd 5c 2d] [3h]
*** FIRST SHOW DOWN ***
Tyoma_Kovach: shows [Ks Ah] (a pair of Tens)
johnysvk18: shows [Qc Qh] (two pair, Queens and Tens)
johnysvk18 collected $11.95 from pot
*** SECOND SHOW DOWN ***
Tyoma_Kovach: shows [Ks Ah] (high card Ace)
johnysvk18: shows [Qc Qh] (three of a kind, Queens)
johnysvk18 collected $11.94 from pot
*** SUMMARY ***
Total pot $25.02 | Rake $1.13 
Hand was run twice
FIRST Board [Td 9c 8c Ts 2s]
SECOND Board [8s Qd 5c 2d 3h]
Seat 1: Tyoma_Kovach (small blind) showed [Ks Ah] and lost with a pair of Tens, and lost with high card Ace
Seat 2: johnysvk18 (big blind) showed [Qc Qh] and won ($11.95) with two pair, Queens and Tens, and won ($11.94) with three of a kind, Queens
Seat 3: thedude696969 folded before Flop (didn't bet)
Seat 4: 0nix770 folded before Flop (didn't bet)
Seat 5: patboy73 folded before Flop
Seat 6: Deniels7 (button) folded before Flop (didn't bet)



PokerStars Hand #222943427179:  Hold'em No Limit ($0.05/$0.10 USD) - 2021/01/23 22:55:29 ET
Table 'Algieba III' 6-max Seat #1 is the button
Seat 1: Tyoma_Kovach ($10 in chips) 
Seat 2: johnysvk18 ($23.89 in chips) 
Seat 3: thedude696969 ($20 in chips) 
Seat 4: 0nix770 ($10 in chips) 
Seat 5: patboy73 ($8.55 in chips) 
Seat 6: Deniels7 ($14.63 in chips) 
johnysvk18: posts small blind $0.05
thedude696969: posts big blind $0.10
*** HOLE CARDS ***
0nix770: raises $0.20 to $0.30
patboy73: folds 
Deniels7: calls $0.30
Tyoma_Kovach: calls $0.30
johnysvk18: calls $0.25
thedude696969: folds 
*** FLOP *** [6c 5c 6d]
johnysvk18: checks 
0nix770: bets $0.48
Deniels7: folds 
Tyoma_Kovach: folds 
johnysvk18: calls $0.48
*** TURN *** [6c 5c 6d] [4d]
johnysvk18: checks 
0nix770: checks 
*** RIVER *** [6c 5c 6d 4d] [9s]
johnysvk18: checks 
0nix770: bets $1.22
johnysvk18: calls $1.22
*** SHOW DOWN ***
0nix770: shows [Td Jh] (a pair of Sixes)
johnysvk18: shows [7c 7s] (two pair, Sevens and Sixes)
johnysvk18 collected $4.49 from pot
*** SUMMARY ***
Total pot $4.70 | Rake $0.21 
Board [6c 5c 6d 4d 9s]
Seat 1: Tyoma_Kovach (button) folded on the Flop
Seat 2: johnysvk18 (small blind) showed [7c 7s] and won ($4.49) with two pair, Sevens and Sixes
Seat 3: thedude696969 (big blind) folded before Flop
Seat 4: 0nix770 showed [Td Jh] and lost with a pair of Sixes
Seat 5: patboy73 folded before Flop (didn't bet)
Seat 6: Deniels7 folded on the Flop



PokerStars Hand #222943448400:  Hold'em No Limit ($0.05/$0.10 USD) - 2021/01/23 22:56:52 ET
Table 'Algieba III' 6-max Seat #2 is the button
Seat 1: Tyoma_Kovach ($10 in chips) 
Seat 2: johnysvk18 ($26.38 in chips) 
Seat 3: thedude696969 ($19.90 in chips) 
Seat 4: 0nix770 ($10 in chips) 
Seat 5: patboy73 ($8.55 in chips) 
Seat 6: Deniels7 ($14.33 in chips) 
thedude696969: posts small blind $0.05
0nix770: posts big blind $0.10
*** HOLE CARDS ***
patboy73: folds 
Deniels7: folds 
Tyoma_Kovach: folds 
johnysvk18: raises $0.15 to $0.25
thedude696969: folds 
0nix770: folds 
Uncalled bet ($0.15) returned to johnysvk18
johnysvk18 collected $0.25 from pot
johnysvk18: doesn't show hand 
*** SUMMARY ***
Total pot $0.25 | Rake $0 
Seat 1: Tyoma_Kovach folded before Flop (didn't bet)
Seat 2: johnysvk18 (button) collected ($0.25)
Seat 3: thedude696969 (small blind) folded before Flop
Seat 4: 0nix770 (big blind) folded before Flop
Seat 5: patboy73 folded before Flop (didn't bet)
Seat 6: Deniels7 folded before Flop (didn't bet)



PokerStars Hand #222943451797:  Hold'em No Limit ($0.05/$0.10 USD) - 2021/01/23 22:57:06 ET
Table 'Algieba III' 6-max Seat #3 is the button
Seat 1: Tyoma_Kovach ($10 in chips) 
Seat 2: johnysvk18 ($26.53 in chips) 
Seat 3: thedude696969 ($19.85 in chips) 
Seat 4: 0nix770 ($10 in chips) 
Seat 5: patboy73 ($8.55 in chips) 
Seat 6: Deniels7 ($14.33 in chips) 
0nix770: posts small blind $0.05
patboy73: posts big blind $0.10
*** HOLE CARDS ***
Deniels7: calls $0.10
Tyoma_Kovach: folds 
johnysvk18: folds 
thedude696969: folds 
0nix770: calls $0.05
patboy73: checks 
*** FLOP *** [5s 6h 2c]
0nix770: checks 
patboy73: checks 
Deniels7: bets $0.20
0nix770: folds 
patboy73: calls $0.20
*** TURN *** [5s 6h 2c] [5h]
patboy73: checks 
Deniels7: bets $0.20
patboy73: folds 
Uncalled bet ($0.20) returned to Deniels7
Deniels7 collected $0.67 from pot
Deniels7: doesn't show hand 
*** SUMMARY ***
Total pot $0.70 | Rake $0.03 
Board [5s 6h 2c 5h]
Seat 1: Tyoma_Kovach folded before Flop (didn't bet)
Seat 2: johnysvk18 folded before Flop (didn't bet)
Seat 3: thedude696969 (button) folded before Flop (didn't bet)
Seat 4: 0nix770 (small blind) folded on the Flop
Seat 5: patboy73 (big blind) folded on the Turn
Seat 6: Deniels7 collected ($0.67)



PokerStars Hand #222943460946:  Hold'em No Limit ($0.05/$0.10 USD) - 2021/01/23 22:57:42 ET
Table 'Algieba III' 6-max Seat #4 is the button
Seat 1: Tyoma_Kovach ($10 in chips) 
Seat 2: johnysvk18 ($26.53 in chips) 
Seat 3: thedude696969 ($19.85 in chips) 
Seat 4: 0nix770 ($10 in chips) 
Seat 5: patboy73 ($8.25 in chips) 
Seat 6: Deniels7 ($14.70 in chips) 
patboy73: posts small blind $0.05
Deniels7: posts big blind $0.10
*** HOLE CARDS ***
Tyoma_Kovach: folds 
johnysvk18: folds 
thedude696969: folds 
0nix770: raises $0.13 to $0.23
patboy73: calls $0.18
Deniels7: folds 
*** FLOP *** [8c Jh Ts]
patboy73: checks 
0nix770: checks 
*** TURN *** [8c Jh Ts] [7h]
patboy73: checks 
0nix770: bets $0.17
patboy73: raises $0.17 to $0.34
0nix770: folds 
Uncalled bet ($0.17) returned to patboy73
patboy73 collected $0.86 from pot
*** SUMMARY ***
Total pot $0.90 | Rake $0.04 
Board [8c Jh Ts 7h]
Seat 1: Tyoma_Kovach folded before Flop (didn't bet)
Seat 2: johnysvk18 folded before Flop (didn't bet)
Seat 3: thedude696969 folded before Flop (didn't bet)
Seat 4: 0nix770 (button) folded on the Turn
Seat 5: patboy73 (small blind) collected ($0.86)
Seat 6: Deniels7 (big blind) folded before Flop



PokerStars Hand #222943469243:  Hold'em No Limit ($0.05/$0.10 USD) - 2021/01/23 22:58:14 ET
Table 'Algieba III' 6-max Seat #5 is the button
Seat 1: Tyoma_Kovach ($10 in chips) 
Seat 2: johnysvk18 ($26.53 in chips) 
Seat 3: thedude696969 ($19.85 in chips) 
Seat 4: 0nix770 ($10 in chips) 
Seat 5: patboy73 ($8.71 in chips) 
Seat 6: Deniels7 ($14.60 in chips) 
Deniels7: posts small blind $0.05
Tyoma_Kovach: posts big blind $0.10
*** HOLE CARDS ***
johnysvk18: raises $0.15 to $0.25
thedude696969: folds 
0nix770: folds 
patboy73: folds 
Deniels7: calls $0.20
Tyoma_Kovach: folds 
*** FLOP *** [3c 4h Ts]
Deniels7: bets $0.20
johnysvk18: calls $0.20
*** TURN *** [3c 4h Ts] [6h]
Deniels7: bets $0.20
johnysvk18: calls $0.20
*** RIVER *** [3c 4h Ts 6h] [8s]
Deniels7: bets $0.50
johnysvk18: folds 
Uncalled bet ($0.50) returned to Deniels7
Deniels7 collected $1.34 from pot
Deniels7: doesn't show hand 
*** SUMMARY ***
Total pot $1.40 | Rake $0.06 
Board [3c 4h Ts 6h 8s]
Seat 1: Tyoma_Kovach (big blind) folded before Flop
Seat 2: johnysvk18 folded on the River
Seat 3: thedude696969 folded before Flop (didn't bet)
Seat 4: 0nix770 folded before Flop (didn't bet)
Seat 5: patboy73 (button) folded before Flop (didn't bet)
Seat 6: Deniels7 (small blind) collected ($1.34)



PokerStars Hand #222943479239:  Hold'em No Limit ($0.05/$0.10 USD) - 2021/01/23 22:58:53 ET
Table 'Algieba III' 6-max Seat #6 is the button
Seat 1: Tyoma_Kovach ($10 in chips) 
Seat 2: johnysvk18 ($25.88 in chips) 
Seat 3: thedude696969 ($19.85 in chips) 
Seat 4: 0nix770 ($10 in chips) 
Seat 5: patboy73 ($8.71 in chips) 
Seat 6: Deniels7 ($15.29 in chips) 
Tyoma_Kovach: posts small blind $0.05
johnysvk18: posts big blind $0.10
*** HOLE CARDS ***
thedude696969: folds 
0nix770: folds 
patboy73: calls $0.10
Deniels7: folds 
Tyoma_Kovach: calls $0.05
johnysvk18: checks 
*** FLOP *** [Qh 6s 3d]
Tyoma_Kovach: checks 
johnysvk18: checks 
patboy73: checks 
*** TURN *** [Qh 6s 3d] [9s]
Tyoma_Kovach: bets $0.22
johnysvk18: folds 
patboy73: folds 
Uncalled bet ($0.22) returned to Tyoma_Kovach
Tyoma_Kovach collected $0.29 from pot
Tyoma_Kovach: doesn't show hand 
*** SUMMARY ***
Total pot $0.30 | Rake $0.01 
Board [Qh 6s 3d 9s]
Seat 1: Tyoma_Kovach (small blind) collected ($0.29)
Seat 2: johnysvk18 (big blind) folded on the Turn
Seat 3: thedude696969 folded before Flop (didn't bet)
Seat 4: 0nix770 folded before Flop (didn't bet)
Seat 5: patboy73 folded on the Turn
Seat 6: Deniels7 (button) folded before Flop (didn't bet)



PokerStars Hand #222943489433:  Hold'em No Limit ($0.05/$0.10 USD) - 2021/01/23 22:59:33 ET
Table 'Algieba III' 6-max Seat #1 is the button
Seat 1: Tyoma_Kovach ($10.19 in chips) 
Seat 2: johnysvk18 ($25.78 in chips) 
Seat 3: thedude696969 ($19.85 in chips) 
Seat 4: 0nix770 ($10 in chips) 
Seat 5: patboy73 ($8.61 in chips) 
Seat 6: Deniels7 ($15.29 in chips) 
johnysvk18: posts small blind $0.05
thedude696969: posts big blind $0.10
*** HOLE CARDS ***
0nix770: folds 
patboy73: folds 
Deniels7: calls $0.10
Tyoma_Kovach: folds 
johnysvk18: folds 
thedude696969: checks 
*** FLOP *** [8d Qc 7h]
thedude696969: checks 
Deniels7: checks 
*** TURN *** [8d Qc 7h] [Ks]
thedude696969: checks 
Deniels7: checks 
*** RIVER *** [8d Qc 7h Ks] [3c]
thedude696969: checks 
Deniels7: checks 
*** SHOW DOWN ***
thedude696969: shows [5s Ac] (high card Ace)
Deniels7: mucks hand 
thedude696969 collected $0.24 from pot
*** SUMMARY ***
Total pot $0.25 | Rake $0.01 
Board [8d Qc 7h Ks 3c]
Seat 1: Tyoma_Kovach (button) folded before Flop (didn't bet)
Seat 2: johnysvk18 (small blind) folded before Flop
Seat 3: thedude696969 (big blind) showed [5s Ac] and won ($0.24) with high card Ace
Seat 4: 0nix770 folded before Flop (didn't bet)
Seat 5: patboy73 folded before Flop (didn't bet)
Seat 6: Deniels7 mucked



PokerStars Hand #222943496854:  Hold'em No Limit ($0.05/$0.10 USD) - 2021/01/23 23:00:01 ET
Table 'Algieba III' 6-max Seat #3 is the button
Seat 1: Tyoma_Kovach ($10.19 in chips) 
Seat 3: thedude696969 ($19.99 in chips) 
Seat 4: 0nix770 ($10 in chips) 
Seat 5: patboy73 ($8.61 in chips) 
Seat 6: Deniels7 ($15.19 in chips) 
0nix770: posts small blind $0.05
patboy73: posts big blind $0.10
*** HOLE CARDS ***
Deniels7: raises $0.25 to $0.35
Tyoma_Kovach: folds 
thedude696969: folds 
0nix770: folds 
patboy73: calls $0.25
*** FLOP *** [Qd 5d 9d]
patboy73: checks 
Deniels7: checks 
*** TURN *** [Qd 5d 9d] [5h]
patboy73: checks 
Deniels7: checks 
*** RIVER *** [Qd 5d 9d 5h] [7s]
patboy73: checks 
Deniels7: checks 
*** SHOW DOWN ***
patboy73: shows [7h Th] (two pair, Sevens and Fives)
Deniels7: mucks hand 
patboy73 collected $0.72 from pot
*** SUMMARY ***
Total pot $0.75 | Rake $0.03 
Board [Qd 5d 9d 5h 7s]
Seat 1: Tyoma_Kovach folded before Flop (didn't bet)
Seat 3: thedude696969 (button) folded before Flop (didn't bet)
Seat 4: 0nix770 (small blind) folded before Flop
Seat 5: patboy73 (big blind) showed [7h Th] and won ($0.72) with two pair, Sevens and Fives
Seat 6: Deniels7 mucked



PokerStars Hand #222943504183:  Hold'em No Limit ($0.05/$0.10 USD) - 2021/01/23 23:00:26 ET
Table 'Algieba III' 6-max Seat #4 is the button
Seat 1: Tyoma_Kovach ($10.19 in chips) 
Seat 3: thedude696969 ($19.99 in chips) 
Seat 4: 0nix770 ($10 in chips) 
Seat 5: patboy73 ($8.98 in chips) 
Seat 6: Deniels7 ($14.84 in chips) 
patboy73: posts small blind $0.05
Deniels7: posts big blind $0.10
*** HOLE CARDS ***
Tyoma_Kovach: folds 
thedude696969: raises $0.20 to $0.30
0nix770: calls $0.30
patboy73: folds 
Deniels7: folds 
*** FLOP *** [9s Qh 6c]
thedude696969: bets $0.40
0nix770: calls $0.40
*** TURN *** [9s Qh 6c] [Kd]
thedude696969: bets $0.90
0nix770: folds 
Uncalled bet ($0.90) returned to thedude696969
thedude696969 collected $1.48 from pot
thedude696969: doesn't show hand 
*** SUMMARY ***
Total pot $1.55 | Rake $0.07 
Board [9s Qh 6c Kd]
Seat 1: Tyoma_Kovach folded before Flop (didn't bet)
Seat 3: thedude696969 collected ($1.48)
Seat 4: 0nix770 (button) folded on the Turn
Seat 5: patboy73 (small blind) folded before Flop
Seat 6: Deniels7 (big blind) folded before Flop



PokerStars Hand #222943517571:  Hold'em No Limit ($0.05/$0.10 USD) - 2021/01/23 23:01:09 ET
Table 'Algieba III' 6-max Seat #5 is the button
Seat 1: Tyoma_Kovach ($10.19 in chips) 
Seat 3: thedude696969 ($20.77 in chips) 
Seat 4: 0nix770 ($10 in chips) 
Seat 5: patboy73 ($8.93 in chips) 
Seat 6: Deniels7 ($14.74 in chips) 
Deniels7: posts small blind $0.05
Tyoma_Kovach: posts big blind $0.10
*** HOLE CARDS ***
thedude696969: folds 
0nix770: folds 
patboy73 has timed out
patboy73: folds 
Deniels7: folds 
Uncalled bet ($0.05) returned to Tyoma_Kovach
Tyoma_Kovach collected $0.10 from pot
Tyoma_Kovach: doesn't show hand 
*** SUMMARY ***
Total pot $0.10 | Rake $0 
Seat 1: Tyoma_Kovach (big blind) collected ($0.10)
Seat 3: thedude696969 folded before Flop (didn't bet)
Seat 4: 0nix770 folded before Flop (didn't bet)
Seat 5: patboy73 (button) folded before Flop (didn't bet)
Seat 6: Deniels7 (small blind) folded before Flop



PokerStars Hand #222943523318:  Hold'em No Limit ($0.05/$0.10 USD) - 2021/01/23 23:01:27 ET
Table 'Algieba III' 6-max Seat #6 is the button
Seat 1: Tyoma_Kovach ($10.24 in chips) 
Seat 3: thedude696969 ($20.77 in chips) 
Seat 4: 0nix770 ($10 in chips) 
Seat 6: Deniels7 ($14.69 in chips) 
Tyoma_Kovach: posts small blind $0.05
thedude696969: posts big blind $0.10
*** HOLE CARDS ***
0nix770: folds 
Deniels7: raises $0.10 to $0.20
Tyoma_Kovach: folds 
thedude696969: calls $0.10
*** FLOP *** [3d 4h Ts]
thedude696969: checks 
Deniels7: bets $0.20
thedude696969: folds 
Uncalled bet ($0.20) returned to Deniels7
Deniels7 collected $0.43 from pot
Deniels7: doesn't show hand 
*** SUMMARY ***
Total pot $0.45 | Rake $0.02 
Board [3d 4h Ts]
Seat 1: Tyoma_Kovach (small blind) folded before Flop
Seat 3: thedude696969 (big blind) folded on the Flop
Seat 4: 0nix770 folded before Flop (didn't bet)
Seat 6: Deniels7 (button) collected ($0.43)



PokerStars Hand #222943531031:  Hold'em No Limit ($0.05/$0.10 USD) - 2021/01/23 23:01:51 ET
Table 'Algieba III' 6-max Seat #1 is the button
Seat 1: Tyoma_Kovach ($10.19 in chips) 
Seat 3: thedude696969 ($20.57 in chips) 
Seat 4: 0nix770 ($10 in chips) 
Seat 5: patboy73 ($8.93 in chips) 
Seat 6: Deniels7 ($14.92 in chips) 
thedude696969: posts small blind $0.05
0nix770: posts big blind $0.10
*** HOLE CARDS ***
patboy73: calls $0.10
Deniels7: calls $0.10
Tyoma_Kovach: folds 
thedude696969: calls $0.05
0nix770: checks 
*** FLOP *** [Qc 4s 3s]
thedude696969: checks 
0nix770: checks 
patboy73: checks 
Deniels7: bets $0.30
thedude696969: folds 
0nix770: folds 
patboy73: folds 
Uncalled bet ($0.30) returned to Deniels7
Deniels7 collected $0.38 from pot
Deniels7: doesn't show hand 
*** SUMMARY ***
Total pot $0.40 | Rake $0.02 
Board [Qc 4s 3s]
Seat 1: Tyoma_Kovach (button) folded before Flop (didn't bet)
Seat 3: thedude696969 (small blind) folded on the Flop
Seat 4: 0nix770 (big blind) folded on the Flop
Seat 5: patboy73 folded on the Flop
Seat 6: Deniels7 collected ($0.38)



PokerStars Hand #222943546031:  Hold'em No Limit ($0.05/$0.10 USD) - 2021/01/23 23:02:38 ET
Table 'Algieba III' 6-max Seat #3 is the button
Seat 1: Tyoma_Kovach ($10.19 in chips) 
Seat 3: thedude696969 ($20.47 in chips) 
Seat 4: 0nix770 ($10 in chips) 
Seat 5: patboy73 ($8.83 in chips) 
Seat 6: Deniels7 ($15.20 in chips) 
0nix770: posts small blind $0.05
patboy73: posts big blind $0.10
*** HOLE CARDS ***
Deniels7: folds 
Tyoma_Kovach: folds 
thedude696969: folds 
0nix770: raises $0.20 to $0.30
patboy73: folds 
Uncalled bet ($0.20) returned to 0nix770
0nix770 collected $0.20 from pot
0nix770: doesn't show hand 
*** SUMMARY ***
Total pot $0.20 | Rake $0 
Seat 1: Tyoma_Kovach folded before Flop (didn't bet)
Seat 3: thedude696969 (button) folded before Flop (didn't bet)
Seat 4: 0nix770 (small blind) collected ($0.20)
Seat 5: patboy73 (big blind) folded before Flop
Seat 6: Deniels7 folded before Flop (didn't bet)



PokerStars Hand #222943553315:  Hold'em No Limit ($0.05/$0.10 USD) - 2021/01/23 23:03:01 ET
Table 'Algieba III' 6-max Seat #4 is the button
Seat 1: Tyoma_Kovach ($10.19 in chips) 
Seat 3: thedude696969 ($20.47 in chips) 
Seat 4: 0nix770 ($10.10 in chips) 
Seat 5: patboy73 ($8.73 in chips) 
Seat 6: Deniels7 ($15.20 in chips) 
patboy73: posts small blind $0.05
Deniels7: posts big blind $0.10
*** HOLE CARDS ***
Tyoma_Kovach: folds 
thedude696969: raises $0.14 to $0.24
0nix770: folds 
patboy73: folds 
Deniels7: calls $0.14
*** FLOP *** [Ac Td Qc]
Deniels7: checks 
thedude696969: checks 
*** TURN *** [Ac Td Qc] [5h]
Deniels7: checks 
thedude696969: checks 
*** RIVER *** [Ac Td Qc 5h] [Ks]
Deniels7: checks 
thedude696969: bets $0.30
Deniels7: folds 
Uncalled bet ($0.30) returned to thedude696969
thedude696969 collected $0.51 from pot
thedude696969: doesn't show hand 
*** SUMMARY ***
Total pot $0.53 | Rake $0.02 
Board [Ac Td Qc 5h Ks]
Seat 1: Tyoma_Kovach folded before Flop (didn't bet)
Seat 3: thedude696969 collected ($0.51)
Seat 4: 0nix770 (button) folded before Flop (didn't bet)
Seat 5: patboy73 (small blind) folded before Flop
Seat 6: Deniels7 (big blind) folded on the River



PokerStars Hand #222943565987:  Hold'em No Limit ($0.05/$0.10 USD) - 2021/01/23 23:03:40 ET
Table 'Algieba III' 6-max Seat #5 is the button
Seat 1: Tyoma_Kovach ($10.19 in chips) 
Seat 3: thedude696969 ($20.74 in chips) 
Seat 4: 0nix770 ($10.10 in chips) 
Seat 5: patboy73 ($8.68 in chips) 
Seat 6: Deniels7 ($14.96 in chips) 
Deniels7: posts small blind $0.05
Tyoma_Kovach: posts big blind $0.10
*** HOLE CARDS ***
thedude696969: folds 
0nix770: folds 
patboy73: folds 
Deniels7: raises $0.10 to $0.20
Tyoma_Kovach: folds 
Uncalled bet ($0.10) returned to Deniels7
Deniels7 collected $0.20 from pot
Deniels7: doesn't show hand 
*** SUMMARY ***
Total pot $0.20 | Rake $0 
Seat 1: Tyoma_Kovach (big blind) folded before Flop
Seat 3: thedude696969 folded before Flop (didn't bet)
Seat 4: 0nix770 folded before Flop (didn't bet)
Seat 5: patboy73 (button) folded before Flop (didn't bet)
Seat 6: Deniels7 (small blind) collected ($0.20)



PokerStars Hand #222943570298:  Hold'em No Limit ($0.05/$0.10 USD) - 2021/01/23 23:03:53 ET
Table 'Algieba III' 6-max Seat #6 is the button
Seat 1: Tyoma_Kovach ($10.09 in chips) 
Seat 3: thedude696969 ($20.74 in chips) 
Seat 4: 0nix770 ($10.10 in chips) 
Seat 5: patboy73 ($8.68 in chips) 
Seat 6: Deniels7 ($15.06 in chips) 
Tyoma_Kovach: posts small blind $0.05
thedude696969: posts big blind $0.10
*** HOLE CARDS ***
0nix770: raises $0.20 to $0.30
patboy73: folds 
Deniels7: folds 
Tyoma_Kovach: raises $0.88 to $1.18
thedude696969: folds 
0nix770: calls $0.88
*** FLOP *** [8c 2h 7c]
Tyoma_Kovach: bets $1.57
0nix770: raises $2.35 to $3.92
Tyoma_Kovach: raises $4.99 to $8.91 and is all-in
0nix770: calls $4.99
*** FIRST TURN *** [8c 2h 7c] [Qc]
*** FIRST RIVER *** [8c 2h 7c Qc] [9c]
*** SECOND TURN *** [8c 2h 7c] [Qh]
*** SECOND RIVER *** [8c 2h 7c Qh] [8d]
*** FIRST SHOW DOWN ***
Tyoma_Kovach: shows [Js Jc] (a flush, Queen high)
0nix770: shows [Ac Kc] (a flush, Ace high)
0nix770 collected $9.69 from pot
*** SECOND SHOW DOWN ***
Tyoma_Kovach: shows [Js Jc] (two pair, Jacks and Eights)
0nix770: shows [Ac Kc] (a pair of Eights)
Tyoma_Kovach collected $9.68 from pot
*** SUMMARY ***
Total pot $20.28 | Rake $0.91 
Hand was run twice
FIRST Board [8c 2h 7c Qc 9c]
SECOND Board [8c 2h 7c Qh 8d]
Seat 1: Tyoma_Kovach (small blind) showed [Js Jc] and lost with a flush, Queen high, and won ($9.68) with two pair, Jacks and Eights
Seat 3: thedude696969 (big blind) folded before Flop
Seat 4: 0nix770 showed [Ac Kc] and won ($9.69) with a flush, Ace high, and lost with a pair of Eights
Seat 5: patboy73 folded before Flop (didn't bet)
Seat 6: Deniels7 (button) folded before Flop (didn't bet)



PokerStars Hand #222943582927:  Hold'em No Limit ($0.05/$0.10 USD) - 2021/01/23 23:04:32 ET
Table 'Algieba III' 6-max Seat #1 is the button
Seat 1: Tyoma_Kovach ($10 in chips) 
Seat 3: thedude696969 ($20.64 in chips) 
Seat 4: 0nix770 ($10 in chips) 
Seat 5: patboy73 ($8.68 in chips) 
Seat 6: Deniels7 ($15.06 in chips) 
thedude696969: posts small blind $0.05
0nix770: posts big blind $0.10
*** HOLE CARDS ***
patboy73: calls $0.10
Deniels7: folds 
Tyoma_Kovach: folds 
thedude696969: raises $0.20 to $0.30
0nix770: raises $0.80 to $1.10
patboy73: folds 
thedude696969: calls $0.80
*** FLOP *** [4d Ac Ts]
thedude696969: checks 
0nix770: bets $0.72
thedude696969: calls $0.72
*** TURN *** [4d Ac Ts] [6h]
thedude696969: checks 
0nix770: checks 
*** RIVER *** [4d Ac Ts 6h] [8h]
thedude696969: bets $2.23
0nix770: calls $2.23
*** SHOW DOWN ***
thedude696969: shows [Qd Jd] (high card Ace)
0nix770: shows [Js Jh] (a pair of Jacks)
0nix770 collected $7.83 from pot
*** SUMMARY ***
Total pot $8.20 | Rake $0.37 
Board [4d Ac Ts 6h 8h]
Seat 1: Tyoma_Kovach (button) folded before Flop (didn't bet)
Seat 3: thedude696969 (small blind) showed [Qd Jd] and lost with high card Ace
Seat 4: 0nix770 (big blind) showed [Js Jh] and won ($7.83) with a pair of Jacks
Seat 5: patboy73 folded before Flop
Seat 6: Deniels7 folded before Flop (didn't bet)



PokerStars Hand #222943607661:  Hold'em No Limit ($0.05/$0.10 USD) - 2021/01/23 23:05:39 ET
Table 'Algieba III' 6-max Seat #3 is the button
Seat 1: Tyoma_Kovach ($10 in chips) 
Seat 3: thedude696969 ($16.59 in chips) 
Seat 4: 0nix770 ($13.78 in chips) 
Seat 5: patboy73 ($8.58 in chips) 
Seat 6: Deniels7 ($15.06 in chips) 
0nix770: posts small blind $0.05
patboy73: posts big blind $0.10
johnysvk18: sits out 
*** HOLE CARDS ***
Deniels7: folds 
Tyoma_Kovach: folds 
thedude696969: folds 
0nix770: raises $0.20 to $0.30
patboy73: folds 
Uncalled bet ($0.20) returned to 0nix770
0nix770 collected $0.20 from pot
0nix770: doesn't show hand 
*** SUMMARY ***
Total pot $0.20 | Rake $0 
Seat 1: Tyoma_Kovach folded before Flop (didn't bet)
Seat 3: thedude696969 (button) folded before Flop (didn't bet)
Seat 4: 0nix770 (small blind) collected ($0.20)
Seat 5: patboy73 (big blind) folded before Flop
Seat 6: Deniels7 folded before Flop (didn't bet)



PokerStars Hand #222943610946:  Hold'em No Limit ($0.05/$0.10 USD) - 2021/01/23 23:05:49 ET
Table 'Algieba III' 6-max Seat #4 is the button
Seat 1: Tyoma_Kovach ($10 in chips) 
Seat 3: thedude696969 ($16.59 in chips) 
Seat 4: 0nix770 ($13.88 in chips) 
Seat 5: patboy73 ($8.48 in chips) 
Seat 6: Deniels7 ($15.06 in chips) 
patboy73: posts small blind $0.05
Deniels7: posts big blind $0.10
johnysvk18: sits out 
*** HOLE CARDS ***
Tyoma_Kovach: folds 
thedude696969: raises $0.20 to $0.30
0nix770: folds 
patboy73: folds 
Deniels7: calls $0.20
*** FLOP *** [Qs 4h Jd]
Deniels7: checks 
thedude696969: bets $0.40
Deniels7: folds 
Uncalled bet ($0.40) returned to thedude696969
thedude696969 collected $0.62 from pot
thedude696969: doesn't show hand 
*** SUMMARY ***
Total pot $0.65 | Rake $0.03 
Board [Qs 4h Jd]
Seat 1: Tyoma_Kovach folded before Flop (didn't bet)
Seat 3: thedude696969 collected ($0.62)
Seat 4: 0nix770 (button) folded before Flop (didn't bet)
Seat 5: patboy73 (small blind) folded before Flop
Seat 6: Deniels7 (big blind) folded on the Flop



PokerStars Hand #222943619709:  Hold'em No Limit ($0.05/$0.10 USD) - 2021/01/23 23:06:17 ET
Table 'Algieba III' 6-max Seat #5 is the button
Seat 1: Tyoma_Kovach ($10 in chips) 
Seat 3: thedude696969 ($16.91 in chips) 
Seat 4: 0nix770 ($13.88 in chips) 
Seat 5: patboy73 ($8.43 in chips) 
Seat 6: Deniels7 ($14.76 in chips) 
Deniels7: posts small blind $0.05
Tyoma_Kovach: posts big blind $0.10
johnysvk18: sits out 
*** HOLE CARDS ***
thedude696969: raises $0.20 to $0.30
0nix770: folds 
patboy73: folds 
Deniels7: folds 
Tyoma_Kovach: folds 
Uncalled bet ($0.20) returned to thedude696969
thedude696969 collected $0.25 from pot
thedude696969: doesn't show hand 
*** SUMMARY ***
Total pot $0.25 | Rake $0 
Seat 1: Tyoma_Kovach (big blind) folded before Flop
Seat 3: thedude696969 collected ($0.25)
Seat 4: 0nix770 folded before Flop (didn't bet)
Seat 5: patboy73 (button) folded before Flop (didn't bet)
Seat 6: Deniels7 (small blind) folded before Flop



PokerStars Hand #222943627643:  Hold'em No Limit ($0.05/$0.10 USD) - 2021/01/23 23:06:41 ET
Table 'Algieba III' 6-max Seat #6 is the button
Seat 1: Tyoma_Kovach ($10 in chips) 
Seat 2: johnysvk18 ($25.73 in chips) 
Seat 3: thedude696969 ($17.06 in chips) 
Seat 4: 0nix770 ($13.88 in chips) 
Seat 5: patboy73 ($8.43 in chips) 
Seat 6: Deniels7 ($14.71 in chips) 
Tyoma_Kovach: posts small blind $0.05
johnysvk18: posts big blind $0.10
*** HOLE CARDS ***
thedude696969: folds 
0nix770: raises $0.20 to $0.30
patboy73: folds 
Deniels7: calls $0.30
Tyoma_Kovach: folds 
johnysvk18: folds 
*** FLOP *** [6h 5s 3s]
0nix770: bets $0.46
Deniels7: calls $0.46
*** TURN *** [6h 5s 3s] [Ks]
0nix770: checks 
Deniels7: checks 
*** RIVER *** [6h 5s 3s Ks] [6s]
0nix770: bets $0.54
Deniels7: raises $3.06 to $3.60
0nix770: folds 
Uncalled bet ($3.06) returned to Deniels7
Deniels7 collected $2.63 from pot
Deniels7: doesn't show hand 
*** SUMMARY ***
Total pot $2.75 | Rake $0.12 
Board [6h 5s 3s Ks 6s]
Seat 1: Tyoma_Kovach (small blind) folded before Flop
Seat 2: johnysvk18 (big blind) folded before Flop
Seat 3: thedude696969 folded before Flop (didn't bet)
Seat 4: 0nix770 folded on the River
Seat 5: patboy73 folded before Flop (didn't bet)
Seat 6: Deniels7 (button) collected ($2.63)



PokerStars Hand #222943651016:  Hold'em No Limit ($0.05/$0.10 USD) - 2021/01/23 23:07:53 ET
Table 'Algieba III' 6-max Seat #1 is the button
Seat 1: Tyoma_Kovach ($10 in chips) 
Seat 2: johnysvk18 ($25.63 in chips) 
Seat 3: thedude696969 ($17.06 in chips) 
Seat 4: 0nix770 ($12.58 in chips) 
Seat 5: patboy73 ($8.43 in chips) 
Seat 6: Deniels7 ($16.04 in chips) 
johnysvk18: posts small blind $0.05
thedude696969: posts big blind $0.10
*** HOLE CARDS ***
0nix770: folds 
patboy73: folds 
Deniels7: calls $0.10
Tyoma_Kovach: raises $0.35 to $0.45
johnysvk18: folds 
thedude696969: calls $0.35
Deniels7: calls $0.35
*** FLOP *** [Jc Qs 9h]
thedude696969: checks 
Deniels7: checks 
Tyoma_Kovach: checks 
*** TURN *** [Jc Qs 9h] [Jd]
thedude696969: bets $0.90
Deniels7: folds 
Tyoma_Kovach: folds 
Uncalled bet ($0.90) returned to thedude696969
thedude696969 collected $1.34 from pot
thedude696969: doesn't show hand 
*** SUMMARY ***
Total pot $1.40 | Rake $0.06 
Board [Jc Qs 9h Jd]
Seat 1: Tyoma_Kovach (button) folded on the Turn
Seat 2: johnysvk18 (small blind) folded before Flop
Seat 3: thedude696969 (big blind) collected ($1.34)
Seat 4: 0nix770 folded before Flop (didn't bet)
Seat 5: patboy73 folded before Flop (didn't bet)
Seat 6: Deniels7 folded on the Turn



PokerStars Hand #222943667376:  Hold'em No Limit ($0.05/$0.10 USD) - 2021/01/23 23:08:44 ET
Table 'Algieba III' 6-max Seat #2 is the button
Seat 1: Tyoma_Kovach ($10 in chips) 
Seat 2: johnysvk18 ($25.58 in chips) 
Seat 3: thedude696969 ($17.95 in chips) 
Seat 4: 0nix770 ($12.58 in chips) 
Seat 5: patboy73 ($8.43 in chips) 
Seat 6: Deniels7 ($15.59 in chips) 
thedude696969: posts small blind $0.05
0nix770: posts big blind $0.10
*** HOLE CARDS ***
patboy73: folds 
Deniels7: folds 
Tyoma_Kovach: raises $0.18 to $0.28
johnysvk18: folds 
thedude696969: folds 
0nix770: folds 
Uncalled bet ($0.18) returned to Tyoma_Kovach
Tyoma_Kovach collected $0.25 from pot
Tyoma_Kovach: doesn't show hand 
*** SUMMARY ***
Total pot $0.25 | Rake $0 
Seat 1: Tyoma_Kovach collected ($0.25)
Seat 2: johnysvk18 (button) folded before Flop (didn't bet)
Seat 3: thedude696969 (small blind) folded before Flop
Seat 4: 0nix770 (big blind) folded before Flop
Seat 5: patboy73 folded before Flop (didn't bet)
Seat 6: Deniels7 folded before Flop (didn't bet)



PokerStars Hand #222943671358:  Hold'em No Limit ($0.05/$0.10 USD) - 2021/01/23 23:08:56 ET
Table 'Algieba III' 6-max Seat #3 is the button
Seat 1: Tyoma_Kovach ($10.15 in chips) 
Seat 2: johnysvk18 ($25.58 in chips) 
Seat 3: thedude696969 ($17.90 in chips) 
Seat 4: 0nix770 ($12.48 in chips) 
Seat 5: patboy73 ($8.43 in chips) 
Seat 6: Deniels7 ($15.59 in chips) 
0nix770: posts small blind $0.05
patboy73: posts big blind $0.10
*** HOLE CARDS ***
Deniels7: calls $0.10
Tyoma_Kovach: folds 
johnysvk18: folds 
thedude696969: raises $0.20 to $0.30
0nix770: calls $0.25
patboy73: folds 
Deniels7: calls $0.20
*** FLOP *** [3c 3d Ah]
0nix770: checks 
Deniels7: checks 
thedude696969: bets $0.54
0nix770: calls $0.54
Deniels7: folds 
*** TURN *** [3c 3d Ah] [Qc]
0nix770: checks 
thedude696969: bets $1.35
0nix770: calls $1.35
*** RIVER *** [3c 3d Ah Qc] [9d]
0nix770: checks 
thedude696969: bets $3
0nix770: calls $3
*** SHOW DOWN ***
thedude696969: shows [As 8s] (two pair, Aces and Threes)
0nix770: shows [2d Ad] (two pair, Aces and Threes)
0nix770 collected $5.15 from pot
thedude696969 collected $5.14 from pot
*** SUMMARY ***
Total pot $10.78 | Rake $0.49 
Board [3c 3d Ah Qc 9d]
Seat 1: Tyoma_Kovach folded before Flop (didn't bet)
Seat 2: johnysvk18 folded before Flop (didn't bet)
Seat 3: thedude696969 (button) showed [As 8s] and won ($5.14) with two pair, Aces and Threes
Seat 4: 0nix770 (small blind) showed [2d Ad] and won ($5.15) with two pair, Aces and Threes
Seat 5: patboy73 (big blind) folded before Flop
Seat 6: Deniels7 folded on the Flop



PokerStars Hand #222943697763:  Hold'em No Limit ($0.05/$0.10 USD) - 2021/01/23 23:10:18 ET
Table 'Algieba III' 6-max Seat #4 is the button
Seat 1: Tyoma_Kovach ($10.15 in chips) 
Seat 2: johnysvk18 ($25.58 in chips) 
Seat 3: thedude696969 ($17.85 in chips) 
Seat 4: 0nix770 ($12.44 in chips) 
Seat 5: patboy73 ($8.33 in chips) 
Seat 6: Deniels7 ($15.29 in chips) 
patboy73: posts small blind $0.05
Deniels7: posts big blind $0.10
*** HOLE CARDS ***
Tyoma_Kovach: raises $0.20 to $0.30
johnysvk18: folds 
thedude696969: calls $0.30
0nix770: folds 
patboy73: folds 
Deniels7: folds 
*** FLOP *** [3d 8d 5d]
Tyoma_Kovach: checks 
thedude696969: bets $0.40
Tyoma_Kovach: folds 
Uncalled bet ($0.40) returned to thedude696969
thedude696969 collected $0.72 from pot
thedude696969: doesn't show hand 
*** SUMMARY ***
Total pot $0.75 | Rake $0.03 
Board [3d 8d 5d]
Seat 1: Tyoma_Kovach folded on the Flop
Seat 2: johnysvk18 folded before Flop (didn't bet)
Seat 3: thedude696969 collected ($0.72)
Seat 4: 0nix770 (button) folded before Flop (didn't bet)
Seat 5: patboy73 (small blind) folded before Flop
Seat 6: Deniels7 (big blind) folded before Flop



PokerStars Hand #222943707035:  Hold'em No Limit ($0.05/$0.10 USD) - 2021/01/23 23:10:45 ET
Table 'Algieba III' 6-max Seat #5 is the button
Seat 1: Tyoma_Kovach ($10 in chips) 
Seat 2: johnysvk18 ($25.58 in chips) 
Seat 3: thedude696969 ($18.27 in chips) 
Seat 4: 0nix770 ($12.44 in chips) 
Seat 5: patboy73 ($8.28 in chips) 
Seat 6: Deniels7 ($15.19 in chips) 
Deniels7: posts small blind $0.05
Tyoma_Kovach: posts big blind $0.10
*** HOLE CARDS ***
johnysvk18: raises $0.15 to $0.25
thedude696969: folds 
0nix770: folds 
patboy73: folds 
Deniels7: calls $0.20
Tyoma_Kovach: folds 
*** FLOP *** [4d 5s 7h]
Deniels7: checks 
johnysvk18: bets $0.20
Deniels7: calls $0.20
*** TURN *** [4d 5s 7h] [Jd]
Deniels7: checks 
johnysvk18: checks 
*** RIVER *** [4d 5s 7h Jd] [8h]
Deniels7: checks 
johnysvk18: checks 
*** SHOW DOWN ***
Deniels7: shows [As 2d] (high card Ace)
johnysvk18: shows [Kc Ac] (high card Ace - King kicker)
johnysvk18 collected $0.96 from pot
*** SUMMARY ***
Total pot $1 | Rake $0.04 
Board [4d 5s 7h Jd 8h]
Seat 1: Tyoma_Kovach (big blind) folded before Flop
Seat 2: johnysvk18 showed [Kc Ac] and won ($0.96) with high card Ace
Seat 3: thedude696969 folded before Flop (didn't bet)
Seat 4: 0nix770 folded before Flop (didn't bet)
Seat 5: patboy73 (button) folded before Flop (didn't bet)
Seat 6: Deniels7 (small blind) showed [As 2d] and lost with high card Ace



PokerStars Hand #222943717438:  Hold'em No Limit ($0.05/$0.10 USD) - 2021/01/23 23:11:17 ET
Table 'Algieba III' 6-max Seat #6 is the button
Seat 1: Tyoma_Kovach ($10 in chips) 
Seat 2: johnysvk18 ($26.09 in chips) 
Seat 3: thedude696969 ($18.27 in chips) 
Seat 4: 0nix770 ($12.44 in chips) 
Seat 5: patboy73 ($8.28 in chips) 
Seat 6: Deniels7 ($14.74 in chips) 
Tyoma_Kovach: posts small blind $0.05
johnysvk18: posts big blind $0.10
*** HOLE CARDS ***
thedude696969: folds 
0nix770: folds 
patboy73: folds 
Deniels7: calls $0.10
Tyoma_Kovach: calls $0.05
johnysvk18: checks 
*** FLOP *** [5c 3d Kc]
Tyoma_Kovach: checks 
johnysvk18: bets $0.20
Deniels7: calls $0.20
Tyoma_Kovach: calls $0.20
*** TURN *** [5c 3d Kc] [4s]
Tyoma_Kovach: checks 
johnysvk18: bets $0.50
Deniels7: calls $0.50
Tyoma_Kovach: calls $0.50
*** RIVER *** [5c 3d Kc 4s] [Kh]
Tyoma_Kovach: checks 
johnysvk18: bets $1.50
Deniels7: folds 
Tyoma_Kovach: calls $1.50
*** SHOW DOWN ***
johnysvk18: shows [Ac 8c] (a pair of Kings)
Tyoma_Kovach: shows [Kd 7d] (three of a kind, Kings)
Tyoma_Kovach collected $5.16 from pot
*** SUMMARY ***
Total pot $5.40 | Rake $0.24 
Board [5c 3d Kc 4s Kh]
Seat 1: Tyoma_Kovach (small blind) showed [Kd 7d] and won ($5.16) with three of a kind, Kings
Seat 2: johnysvk18 (big blind) showed [Ac 8c] and lost with a pair of Kings
Seat 3: thedude696969 folded before Flop (didn't bet)
Seat 4: 0nix770 folded before Flop (didn't bet)
Seat 5: patboy73 folded before Flop (didn't bet)
Seat 6: Deniels7 (button) folded on the River



PokerStars Hand #222943741380:  Hold'em No Limit ($0.05/$0.10 USD) - 2021/01/23 23:12:20 ET
Table 'Algieba III' 6-max Seat #1 is the button
Seat 1: Tyoma_Kovach ($12.86 in chips) 
Seat 2: johnysvk18 ($23.79 in chips) 
Seat 3: thedude696969 ($18.27 in chips) 
Seat 4: 0nix770 ($12.44 in chips) 
Seat 5: patboy73 ($8.28 in chips) 
Seat 6: Deniels7 ($13.94 in chips) 
johnysvk18: posts small blind $0.05
thedude696969: posts big blind $0.10
*** HOLE CARDS ***
0nix770: raises $0.20 to $0.30
patboy73: folds 
Deniels7: folds 
Tyoma_Kovach: folds 
johnysvk18: folds 
thedude696969: folds 
Uncalled bet ($0.20) returned to 0nix770
0nix770 collected $0.25 from pot
0nix770: doesn't show hand 
*** SUMMARY ***
Total pot $0.25 | Rake $0 
Seat 1: Tyoma_Kovach (button) folded before Flop (didn't bet)
Seat 2: johnysvk18 (small blind) folded before Flop
Seat 3: thedude696969 (big blind) folded before Flop
Seat 4: 0nix770 collected ($0.25)
Seat 5: patboy73 folded before Flop (didn't bet)
Seat 6: Deniels7 folded before Flop (didn't bet)



PokerStars Hand #222943744994:  Hold'em No Limit ($0.05/$0.10 USD) - 2021/01/23 23:12:31 ET
Table 'Algieba III' 6-max Seat #2 is the button
Seat 1: Tyoma_Kovach ($12.86 in chips) 
Seat 2: johnysvk18 ($23.74 in chips) 
Seat 3: thedude696969 ($18.17 in chips) 
Seat 4: 0nix770 ($12.59 in chips) 
Seat 5: patboy73 ($8.28 in chips) 
Seat 6: Deniels7 ($13.94 in chips) 
thedude696969: posts small blind $0.05
0nix770: posts big blind $0.10
*** HOLE CARDS ***
patboy73: folds 
Deniels7: calls $0.10
Tyoma_Kovach: folds 
johnysvk18: folds 
thedude696969: raises $0.30 to $0.40
0nix770: folds 
Deniels7: calls $0.30
*** FLOP *** [7h 7c 4d]
thedude696969: bets $0.50
Deniels7: folds 
Uncalled bet ($0.50) returned to thedude696969
thedude696969 collected $0.86 from pot
thedude696969: doesn't show hand 
*** SUMMARY ***
Total pot $0.90 | Rake $0.04 
Board [7h 7c 4d]
Seat 1: Tyoma_Kovach folded before Flop (didn't bet)
Seat 2: johnysvk18 (button) folded before Flop (didn't bet)
Seat 3: thedude696969 (small blind) collected ($0.86)
Seat 4: 0nix770 (big blind) folded before Flop
Seat 5: patboy73 folded before Flop (didn't bet)
Seat 6: Deniels7 folded on the Flop



PokerStars Hand #222943753455:  Hold'em No Limit ($0.05/$0.10 USD) - 2021/01/23 23:12:58 ET
Table 'Algieba III' 6-max Seat #3 is the button
Seat 1: Tyoma_Kovach ($12.86 in chips) 
Seat 2: johnysvk18 ($23.74 in chips) 
Seat 3: thedude696969 ($18.63 in chips) 
Seat 4: 0nix770 ($12.49 in chips) 
Seat 5: patboy73 ($8.28 in chips) 
Seat 6: Deniels7 ($13.54 in chips) 
0nix770: posts small blind $0.05
patboy73: posts big blind $0.10
*** HOLE CARDS ***
Deniels7: folds 
Tyoma_Kovach: folds 
johnysvk18: raises $0.15 to $0.25
thedude696969: raises $0.75 to $1
0nix770: folds 
patboy73: folds 
johnysvk18: folds 
Uncalled bet ($0.75) returned to thedude696969
thedude696969 collected $0.65 from pot
thedude696969: doesn't show hand 
*** SUMMARY ***
Total pot $0.65 | Rake $0 
Seat 1: Tyoma_Kovach folded before Flop (didn't bet)
Seat 2: johnysvk18 folded before Flop
Seat 3: thedude696969 (button) collected ($0.65)
Seat 4: 0nix770 (small blind) folded before Flop
Seat 5: patboy73 (big blind) folded before Flop
Seat 6: Deniels7 folded before Flop (didn't bet)



PokerStars Hand #222943761130:  Hold'em No Limit ($0.05/$0.10 USD) - 2021/01/23 23:13:22 ET
Table 'Algieba III' 6-max Seat #4 is the button
Seat 1: Tyoma_Kovach ($12.86 in chips) 
Seat 2: johnysvk18 ($23.49 in chips) 
Seat 3: thedude696969 ($19.03 in chips) 
Seat 4: 0nix770 ($12.44 in chips) 
Seat 5: patboy73 ($8.18 in chips) 
Seat 6: Deniels7 ($13.54 in chips) 
patboy73: posts small blind $0.05
Deniels7: posts big blind $0.10
*** HOLE CARDS ***
Tyoma_Kovach: folds 
johnysvk18: folds 
thedude696969 has timed out
thedude696969: folds 
0nix770: raises $0.13 to $0.23
patboy73: calls $0.18
Deniels7: calls $0.13
*** FLOP *** [Qd Ah Tc]
patboy73: checks 
Deniels7: checks 
0nix770: bets $0.28
patboy73: folds 
Deniels7: calls $0.28
*** TURN *** [Qd Ah Tc] [6c]
Deniels7: checks 
0nix770: bets $0.37
Deniels7: folds 
Uncalled bet ($0.37) returned to 0nix770
0nix770 collected $1.19 from pot
0nix770: doesn't show hand 
*** SUMMARY ***
Total pot $1.25 | Rake $0.06 
Board [Qd Ah Tc 6c]
Seat 1: Tyoma_Kovach folded before Flop (didn't bet)
Seat 2: johnysvk18 folded before Flop (didn't bet)
Seat 3: thedude696969 folded before Flop (didn't bet)
Seat 4: 0nix770 (button) collected ($1.19)
Seat 5: patboy73 (small blind) folded on the Flop
Seat 6: Deniels7 (big blind) folded on the Turn



PokerStars Hand #222943775295:  Hold'em No Limit ($0.05/$0.10 USD) - 2021/01/23 23:14:06 ET
Table 'Algieba III' 6-max Seat #5 is the button
Seat 1: Tyoma_Kovach ($12.86 in chips) 
Seat 2: johnysvk18 ($23.49 in chips) 
Seat 3: thedude696969 ($19.03 in chips) 
Seat 4: 0nix770 ($13.12 in chips) 
Seat 5: patboy73 ($7.95 in chips) 
Seat 6: Deniels7 ($13.03 in chips) 
Deniels7: posts small blind $0.05
Tyoma_Kovach: posts big blind $0.10
*** HOLE CARDS ***
johnysvk18: folds 
thedude696969: raises $0.14 to $0.24
0nix770: calls $0.24
patboy73: folds 
Deniels7: folds 
Tyoma_Kovach: calls $0.14
*** FLOP *** [Ah Qh 4h]
Tyoma_Kovach: checks 
thedude696969: bets $0.40
0nix770: folds 
Tyoma_Kovach: folds 
Uncalled bet ($0.40) returned to thedude696969
thedude696969 collected $0.74 from pot
thedude696969: doesn't show hand 
*** SUMMARY ***
Total pot $0.77 | Rake $0.03 
Board [Ah Qh 4h]
Seat 1: Tyoma_Kovach (big blind) folded on the Flop
Seat 2: johnysvk18 folded before Flop (didn't bet)
Seat 3: thedude696969 collected ($0.74)
Seat 4: 0nix770 folded on the Flop
Seat 5: patboy73 (button) folded before Flop (didn't bet)
Seat 6: Deniels7 (small blind) folded before Flop



PokerStars Hand #222943784665:  Hold'em No Limit ($0.05/$0.10 USD) - 2021/01/23 23:14:35 ET
Table 'Algieba III' 6-max Seat #6 is the button
Seat 1: Tyoma_Kovach ($12.62 in chips) 
Seat 2: johnysvk18 ($23.49 in chips) 
Seat 3: thedude696969 ($19.53 in chips) 
Seat 4: 0nix770 ($12.88 in chips) 
Seat 5: patboy73 ($7.95 in chips) 
Seat 6: Deniels7 ($12.98 in chips) 
Tyoma_Kovach: posts small blind $0.05
johnysvk18: posts big blind $0.10
*** HOLE CARDS ***
thedude696969: raises $0.20 to $0.30
0nix770: folds 
patboy73: calls $0.30
Deniels7: folds 
Tyoma_Kovach: folds 
johnysvk18: folds 
*** FLOP *** [Jd 5h 3h]
thedude696969: bets $0.40
patboy73: calls $0.40
*** TURN *** [Jd 5h 3h] [4c]
thedude696969: bets $0.82
patboy73: folds 
Uncalled bet ($0.82) returned to thedude696969
thedude696969 collected $1.48 from pot
thedude696969: doesn't show hand 
*** SUMMARY ***
Total pot $1.55 | Rake $0.07 
Board [Jd 5h 3h 4c]
Seat 1: Tyoma_Kovach (small blind) folded before Flop
Seat 2: johnysvk18 (big blind) folded before Flop
Seat 3: thedude696969 collected ($1.48)
Seat 4: 0nix770 folded before Flop (didn't bet)
Seat 5: patboy73 folded on the Turn
Seat 6: Deniels7 (button) folded before Flop (didn't bet)



PokerStars Hand #222943801367:  Hold'em No Limit ($0.05/$0.10 USD) - 2021/01/23 23:15:27 ET
Table 'Algieba III' 6-max Seat #1 is the button
Seat 1: Tyoma_Kovach ($12.57 in chips) 
Seat 2: johnysvk18 ($23.39 in chips) 
Seat 3: thedude696969 ($20.31 in chips) 
Seat 4: 0nix770 ($12.88 in chips) 
Seat 5: patboy73 ($7.25 in chips) 
Seat 6: Deniels7 ($12.98 in chips) 
johnysvk18: posts small blind $0.05
thedude696969: posts big blind $0.10
*** HOLE CARDS ***
0nix770: folds 
patboy73: folds 
Deniels7: folds 
Tyoma_Kovach: folds 
johnysvk18: folds 
Uncalled bet ($0.05) returned to thedude696969
thedude696969 collected $0.10 from pot
thedude696969: doesn't show hand 
*** SUMMARY ***
Total pot $0.10 | Rake $0 
Seat 1: Tyoma_Kovach (button) folded before Flop (didn't bet)
Seat 2: johnysvk18 (small blind) folded before Flop
Seat 3: thedude696969 (big blind) collected ($0.10)
Seat 4: 0nix770 folded before Flop (didn't bet)
Seat 5: patboy73 folded before Flop (didn't bet)
Seat 6: Deniels7 folded before Flop (didn't bet)



PokerStars Hand #222943804598:  Hold'em No Limit ($0.05/$0.10 USD) - 2021/01/23 23:15:37 ET
Table 'Algieba III' 6-max Seat #2 is the button
Seat 1: Tyoma_Kovach ($12.57 in chips) 
Seat 2: johnysvk18 ($23.34 in chips) 
Seat 3: thedude696969 ($20.36 in chips) 
Seat 4: 0nix770 ($12.88 in chips) 
Seat 5: patboy73 ($7.25 in chips) 
Seat 6: Deniels7 ($12.98 in chips) 
thedude696969: posts small blind $0.05
0nix770: posts big blind $0.10
*** HOLE CARDS ***
patboy73 has timed out
patboy73: folds 
Deniels7: folds 
Tyoma_Kovach: folds 
johnysvk18: folds 
thedude696969: raises $0.30 to $0.40
0nix770: folds 
Uncalled bet ($0.30) returned to thedude696969
thedude696969 collected $0.20 from pot
thedude696969: doesn't show hand 
*** SUMMARY ***
Total pot $0.20 | Rake $0 
Seat 1: Tyoma_Kovach folded before Flop (didn't bet)
Seat 2: johnysvk18 (button) folded before Flop (didn't bet)
Seat 3: thedude696969 (small blind) collected ($0.20)
Seat 4: 0nix770 (big blind) folded before Flop
Seat 5: patboy73 folded before Flop (didn't bet)
Seat 6: Deniels7 folded before Flop (didn't bet)



PokerStars Hand #222943811709:  Hold'em No Limit ($0.05/$0.10 USD) - 2021/01/23 23:15:59 ET
Table 'Algieba III' 6-max Seat #3 is the button
Seat 1: Tyoma_Kovach ($12.57 in chips) 
Seat 2: johnysvk18 ($23.34 in chips) 
Seat 3: thedude696969 ($20.46 in chips) 
Seat 4: 0nix770 ($12.78 in chips) 
Seat 5: patboy73 ($7.25 in chips) 
Seat 6: Deniels7 ($12.98 in chips) 
0nix770: posts small blind $0.05
patboy73: posts big blind $0.10
*** HOLE CARDS ***
Deniels7: folds 
Tyoma_Kovach: folds 
johnysvk18: folds 
thedude696969: raises $0.20 to $0.30
0nix770: folds 
patboy73: folds 
Uncalled bet ($0.20) returned to thedude696969
thedude696969 collected $0.25 from pot
thedude696969: doesn't show hand 
*** SUMMARY ***
Total pot $0.25 | Rake $0 
Seat 1: Tyoma_Kovach folded before Flop (didn't bet)
Seat 2: johnysvk18 folded before Flop (didn't bet)
Seat 3: thedude696969 (button) collected ($0.25)
Seat 4: 0nix770 (small blind) folded before Flop
Seat 5: patboy73 (big blind) folded before Flop
Seat 6: Deniels7 folded before Flop (didn't bet)



PokerStars Hand #222943816107:  Hold'em No Limit ($0.05/$0.10 USD) - 2021/01/23 23:16:13 ET
Table 'Algieba III' 6-max Seat #4 is the button
Seat 1: Tyoma_Kovach ($12.57 in chips) 
Seat 2: johnysvk18 ($23.34 in chips) 
Seat 3: thedude696969 ($20.61 in chips) 
Seat 4: 0nix770 ($12.73 in chips) 
Seat 5: patboy73 ($7.15 in chips) 
Seat 6: Deniels7 ($12.98 in chips) 
patboy73: posts small blind $0.05
Deniels7: posts big blind $0.10
*** HOLE CARDS ***
Tyoma_Kovach: folds 
johnysvk18: folds 
thedude696969: folds 
0nix770: folds 
patboy73: folds 
Uncalled bet ($0.05) returned to Deniels7
Deniels7 collected $0.10 from pot
Deniels7: doesn't show hand 
*** SUMMARY ***
Total pot $0.10 | Rake $0 
Seat 1: Tyoma_Kovach folded before Flop (didn't bet)
Seat 2: johnysvk18 folded before Flop (didn't bet)
Seat 3: thedude696969 folded before Flop (didn't bet)
Seat 4: 0nix770 (button) folded before Flop (didn't bet)
Seat 5: patboy73 (small blind) folded before Flop
Seat 6: Deniels7 (big blind) collected ($0.10)



PokerStars Hand #222943818476:  Hold'em No Limit ($0.05/$0.10 USD) - 2021/01/23 23:16:20 ET
Table 'Algieba III' 6-max Seat #5 is the button
Seat 1: Tyoma_Kovach ($12.57 in chips) 
Seat 2: johnysvk18 ($23.34 in chips) 
Seat 3: thedude696969 ($20.61 in chips) 
Seat 4: 0nix770 ($12.73 in chips) 
Seat 5: patboy73 ($7.10 in chips) 
Seat 6: Deniels7 ($13.03 in chips) 
Deniels7: posts small blind $0.05
Tyoma_Kovach: posts big blind $0.10
*** HOLE CARDS ***
johnysvk18: folds 
johnysvk18 leaves the table
thedude696969: folds 
0nix770: folds 
patboy73: folds 
Deniels7: folds 
Uncalled bet ($0.05) returned to Tyoma_Kovach
Tyoma_Kovach collected $0.10 from pot
Tyoma_Kovach: doesn't show hand 
*** SUMMARY ***
Total pot $0.10 | Rake $0 
Seat 1: Tyoma_Kovach (big blind) collected ($0.10)
Seat 2: johnysvk18 folded before Flop (didn't bet)
Seat 3: thedude696969 folded before Flop (didn't bet)
Seat 4: 0nix770 folded before Flop (didn't bet)
Seat 5: patboy73 (button) folded before Flop (didn't bet)
Seat 6: Deniels7 (small blind) folded before Flop



PokerStars Hand #222943822289:  Hold'em No Limit ($0.05/$0.10 USD) - 2021/01/23 23:16:32 ET
Table 'Algieba III' 6-max Seat #6 is the button
Seat 1: Tyoma_Kovach ($12.62 in chips) 
Seat 3: thedude696969 ($20.61 in chips) 
Seat 4: 0nix770 ($12.73 in chips) 
Seat 5: patboy73 ($7.10 in chips) 
Seat 6: Deniels7 ($12.98 in chips) 
Tyoma_Kovach: posts small blind $0.05
thedude696969: posts big blind $0.10
*** HOLE CARDS ***
0nix770: folds 
patboy73: calls $0.10
Deniels7: folds 
Tyoma_Kovach: folds 
thedude696969: checks 
*** FLOP *** [5s Ad 6h]
Palen030 joins the table at seat #2 
thedude696969: checks 
patboy73: checks 
*** TURN *** [5s Ad 6h] [3d]
thedude696969: checks 
patboy73: bets $0.10
thedude696969: folds 
Uncalled bet ($0.10) returned to patboy73
patboy73 collected $0.24 from pot
*** SUMMARY ***
Total pot $0.25 | Rake $0.01 
Board [5s Ad 6h 3d]
Seat 1: Tyoma_Kovach (small blind) folded before Flop
Seat 3: thedude696969 (big blind) folded on the Turn
Seat 4: 0nix770 folded before Flop (didn't bet)
Seat 5: patboy73 collected ($0.24)
Seat 6: Deniels7 (button) folded before Flop (didn't bet)



PokerStars Hand #222943842965:  Hold'em No Limit ($0.05/$0.10 USD) - 2021/01/23 23:17:10 ET
Table 'Algieba III' 6-max Seat #1 is the button
Seat 1: Tyoma_Kovach ($12.57 in chips) 
Seat 3: thedude696969 ($20.51 in chips) 
Seat 4: 0nix770 ($12.73 in chips) 
Seat 5: patboy73 ($7.24 in chips) 
Seat 6: Deniels7 ($12.98 in chips) 
thedude696969: posts small blind $0.05
0nix770: posts big blind $0.10
*** HOLE CARDS ***
patboy73: calls $0.10
Deniels7: folds 
Tyoma_Kovach: raises $0.35 to $0.45
thedude696969: folds 
0nix770: raises $1 to $1.45
patboy73: folds 
Tyoma_Kovach: calls $1
*** FLOP *** [Td Qs Ah]
0nix770: bets $0.99
Tyoma_Kovach: folds 
Uncalled bet ($0.99) returned to 0nix770
0nix770 collected $2.91 from pot
0nix770: doesn't show hand 
*** SUMMARY ***
Total pot $3.05 | Rake $0.14 
Board [Td Qs Ah]
Seat 1: Tyoma_Kovach (button) folded on the Flop
Seat 3: thedude696969 (small blind) folded before Flop
Seat 4: 0nix770 (big blind) collected ($2.91)
Seat 5: patboy73 folded before Flop
Seat 6: Deniels7 folded before Flop (didn't bet)



PokerStars Hand #222943852790:  Hold'em No Limit ($0.05/$0.10 USD) - 2021/01/23 23:17:40 ET
Table 'Algieba III' 6-max Seat #3 is the button
Seat 1: Tyoma_Kovach ($11.12 in chips) 
Seat 2: Palen030 ($4 in chips) 
Seat 3: thedude696969 ($20.46 in chips) 
Seat 4: 0nix770 ($14.19 in chips) 
Seat 5: patboy73 ($7.14 in chips) 
Seat 6: Deniels7 ($12.98 in chips) 
0nix770: posts small blind $0.05
patboy73: posts big blind $0.10
Palen030: posts big blind $0.10
*** HOLE CARDS ***
Deniels7: folds 
Tyoma_Kovach: folds 
Palen030: checks 
thedude696969: folds 
0nix770: folds 
patboy73: checks 
*** FLOP *** [Ac 7s 7c]
patboy73: checks 
Palen030: checks 
*** TURN *** [Ac 7s 7c] [3h]
patboy73: checks 
Palen030: checks 
*** RIVER *** [Ac 7s 7c 3h] [Tc]
patboy73: checks 
Palen030: checks 
*** SHOW DOWN ***
patboy73: shows [Jh 9d] (a pair of Sevens)
Palen030: shows [8d Ts] (two pair, Tens and Sevens)
Palen030 collected $0.24 from pot
*** SUMMARY ***
Total pot $0.25 | Rake $0.01 
Board [Ac 7s 7c 3h Tc]
Seat 1: Tyoma_Kovach folded before Flop (didn't bet)
Seat 2: Palen030 showed [8d Ts] and won ($0.24) with two pair, Tens and Sevens
Seat 3: thedude696969 (button) folded before Flop (didn't bet)
Seat 4: 0nix770 (small blind) folded before Flop
Seat 5: patboy73 (big blind) showed [Jh 9d] and lost with a pair of Sevens
Seat 6: Deniels7 folded before Flop (didn't bet)



PokerStars Hand #222943861163:  Hold'em No Limit ($0.05/$0.10 USD) - 2021/01/23 23:18:06 ET
Table 'Algieba III' 6-max Seat #4 is the button
Seat 1: Tyoma_Kovach ($11.12 in chips) 
Seat 2: Palen030 ($4.14 in chips) 
Seat 3: thedude696969 ($20.46 in chips) 
Seat 4: 0nix770 ($14.14 in chips) 
Seat 5: patboy73 ($7.04 in chips) 
Seat 6: Deniels7 ($12.98 in chips) 
patboy73: posts small blind $0.05
Deniels7: posts big blind $0.10
*** HOLE CARDS ***
Tyoma_Kovach: folds 
Palen030: calls $0.10
thedude696969: folds 
0nix770: raises $0.30 to $0.40
patboy73: folds 
Deniels7: calls $0.30
Palen030: calls $0.30
*** FLOP *** [3s Qh Ts]
Deniels7: checks 
Palen030: checks 
0nix770: checks 
*** TURN *** [3s Qh Ts] [Ad]
Deniels7: checks 
Palen030: checks 
0nix770: bets $0.64
Deniels7: calls $0.64
Palen030: folds 
*** RIVER *** [3s Qh Ts Ad] [4h]
Deniels7: checks 
0nix770: bets $1.84
Deniels7: raises $1.84 to $3.68
0nix770: calls $1.84
*** SHOW DOWN ***
Deniels7: shows [Ah 4s] (two pair, Aces and Fours)
0nix770: shows [As 4c] (two pair, Aces and Fours)
Deniels7 collected $4.72 from pot
0nix770 collected $4.72 from pot
*** SUMMARY ***
Total pot $9.89 | Rake $0.45 
Board [3s Qh Ts Ad 4h]
Seat 1: Tyoma_Kovach folded before Flop (didn't bet)
Seat 2: Palen030 folded on the Turn
Seat 3: thedude696969 folded before Flop (didn't bet)
Seat 4: 0nix770 (button) showed [As 4c] and won ($4.72) with two pair, Aces and Fours
Seat 5: patboy73 (small blind) folded before Flop
Seat 6: Deniels7 (big blind) showed [Ah 4s] and won ($4.72) with two pair, Aces and Fours



PokerStars Hand #222943882094:  Hold'em No Limit ($0.05/$0.10 USD) - 2021/01/23 23:18:49 ET
Table 'Algieba III' 6-max Seat #5 is the button
Seat 1: Tyoma_Kovach ($11.12 in chips) 
Seat 2: Palen030 ($3.74 in chips) 
Seat 3: thedude696969 ($20.46 in chips) 
Seat 4: 0nix770 ($14.14 in chips) 
Seat 5: patboy73 ($6.99 in chips) 
Seat 6: Deniels7 ($12.98 in chips) 
Deniels7: posts small blind $0.05
Tyoma_Kovach: posts big blind $0.10
*** HOLE CARDS ***
Palen030: folds 
thedude696969: folds 
0nix770: raises $0.15 to $0.25
patboy73: folds 
Deniels7: folds 
Tyoma_Kovach: calls $0.15
*** FLOP *** [Qh Kh Tc]
Tyoma_Kovach: checks 
0nix770: bets $0.27
Tyoma_Kovach: folds 
Uncalled bet ($0.27) returned to 0nix770
0nix770 collected $0.53 from pot
0nix770: doesn't show hand 
*** SUMMARY ***
Total pot $0.55 | Rake $0.02 
Board [Qh Kh Tc]
Seat 1: Tyoma_Kovach (big blind) folded on the Flop
Seat 2: Palen030 folded before Flop (didn't bet)
Seat 3: thedude696969 folded before Flop (didn't bet)
Seat 4: 0nix770 collected ($0.53)
Seat 5: patboy73 (button) folded before Flop (didn't bet)
Seat 6: Deniels7 (small blind) folded before Flop



PokerStars Hand #222943888497:  Hold'em No Limit ($0.05/$0.10 USD) - 2021/01/23 23:19:09 ET
Table 'Algieba III' 6-max Seat #6 is the button
Seat 1: Tyoma_Kovach ($10.87 in chips) 
Seat 2: Palen030 ($3.74 in chips) 
Seat 3: thedude696969 ($20.46 in chips) 
Seat 4: 0nix770 ($14.42 in chips) 
Seat 5: patboy73 ($6.99 in chips) 
Seat 6: Deniels7 ($12.93 in chips) 
Tyoma_Kovach: posts small blind $0.05
Palen030: posts big blind $0.10
*** HOLE CARDS ***
thedude696969: folds 
0nix770: folds 
patboy73: calls $0.10
Deniels7: calls $0.10
Tyoma_Kovach: calls $0.05
Palen030: checks 
*** FLOP *** [4s 9s Jc]
Tyoma_Kovach: checks 
Palen030: checks 
patboy73: checks 
Deniels7: bets $0.20
Tyoma_Kovach: folds 
Palen030: calls $0.20
patboy73: calls $0.20
*** TURN *** [4s 9s Jc] [6s]
Palen030: bets $0.48
patboy73: folds 
Deniels7: folds 
Uncalled bet ($0.48) returned to Palen030
Palen030 collected $0.96 from pot
Palen030: doesn't show hand 
*** SUMMARY ***
Total pot $1 | Rake $0.04 
Board [4s 9s Jc 6s]
Seat 1: Tyoma_Kovach (small blind) folded on the Flop
Seat 2: Palen030 (big blind) collected ($0.96)
Seat 3: thedude696969 folded before Flop (didn't bet)
Seat 4: 0nix770 folded before Flop (didn't bet)
Seat 5: patboy73 folded on the Turn
Seat 6: Deniels7 (button) folded on the Turn



PokerStars Hand #222943902317:  Hold'em No Limit ($0.05/$0.10 USD) - 2021/01/23 23:19:53 ET
Table 'Algieba III' 6-max Seat #1 is the button
Seat 1: Tyoma_Kovach ($10.77 in chips) 
Seat 2: Palen030 ($4.40 in chips) 
Seat 3: thedude696969 ($20.46 in chips) 
Seat 4: 0nix770 ($14.42 in chips) 
Seat 5: patboy73 ($6.69 in chips) 
Seat 6: Deniels7 ($12.63 in chips) 
Palen030: posts small blind $0.05
thedude696969: posts big blind $0.10
*** HOLE CARDS ***
0nix770: folds 
patboy73: folds 
Deniels7: folds 
Tyoma_Kovach: raises $0.15 to $0.25
Palen030: calls $0.20
thedude696969: folds 
*** FLOP *** [8c Tc 4h]
Palen030: checks 
Tyoma_Kovach: bets $0.19
Palen030: folds 
Uncalled bet ($0.19) returned to Tyoma_Kovach
Tyoma_Kovach collected $0.57 from pot
Tyoma_Kovach: doesn't show hand 
*** SUMMARY ***
Total pot $0.60 | Rake $0.03 
Board [8c Tc 4h]
Seat 1: Tyoma_Kovach (button) collected ($0.57)
Seat 2: Palen030 (small blind) folded on the Flop
Seat 3: thedude696969 (big blind) folded before Flop
Seat 4: 0nix770 folded before Flop (didn't bet)
Seat 5: patboy73 folded before Flop (didn't bet)
Seat 6: Deniels7 folded before Flop (didn't bet)



PokerStars Hand #222943910284:  Hold'em No Limit ($0.05/$0.10 USD) - 2021/01/23 23:20:18 ET
Table 'Algieba III' 6-max Seat #2 is the button
Seat 1: Tyoma_Kovach ($11.09 in chips) 
Seat 2: Palen030 ($4.15 in chips) 
Seat 3: thedude696969 ($20.36 in chips) 
Seat 4: 0nix770 ($14.42 in chips) 
Seat 5: patboy73 ($6.69 in chips) 
Seat 6: Deniels7 ($12.63 in chips) 
thedude696969: posts small blind $0.05
0nix770: posts big blind $0.10
*** HOLE CARDS ***
patboy73 has timed out
patboy73: folds 
Deniels7: calls $0.10
Tyoma_Kovach: raises $0.35 to $0.45
Palen030: folds 
thedude696969: calls $0.40
0nix770: folds 
Deniels7: calls $0.35
*** FLOP *** [3h 8c 9c]
thedude696969: checks 
Deniels7: bets $0.50
Tyoma_Kovach: calls $0.50
thedude696969: folds 
*** TURN *** [3h 8c 9c] [4h]
Deniels7: bets $1.30
Tyoma_Kovach: calls $1.30
*** RIVER *** [3h 8c 9c 4h] [7d]
Deniels7: bets $2.10
Tyoma_Kovach: folds 
Uncalled bet ($2.10) returned to Deniels7
Deniels7 collected $4.82 from pot
Deniels7: doesn't show hand 
*** SUMMARY ***
Total pot $5.05 | Rake $0.23 
Board [3h 8c 9c 4h 7d]
Seat 1: Tyoma_Kovach folded on the River
Seat 2: Palen030 (button) folded before Flop (didn't bet)
Seat 3: thedude696969 (small blind) folded on the Flop
Seat 4: 0nix770 (big blind) folded before Flop
Seat 5: patboy73 folded before Flop (didn't bet)
Seat 6: Deniels7 collected ($4.82)



PokerStars Hand #222943937567:  Hold'em No Limit ($0.05/$0.10 USD) - 2021/01/23 23:21:44 ET
Table 'Algieba III' 6-max Seat #3 is the button
Seat 1: Tyoma_Kovach ($10 in chips) 
Seat 2: Palen030 ($4.15 in chips) 
Seat 3: thedude696969 ($19.91 in chips) 
Seat 4: 0nix770 ($14.32 in chips) 
Seat 5: patboy73 ($6.69 in chips) 
Seat 6: Deniels7 ($15.20 in chips) 
0nix770: posts small blind $0.05
patboy73: posts big blind $0.10
*** HOLE CARDS ***
Deniels7: folds 
Tyoma_Kovach: folds 
Palen030: folds 
thedude696969: folds 
0nix770: raises $0.20 to $0.30
patboy73: calls $0.20
*** FLOP *** [6c Ad 4h]
0nix770: bets $0.24
patboy73: calls $0.24
*** TURN *** [6c Ad 4h] [Jc]
0nix770: bets $0.53
patboy73: folds 
Uncalled bet ($0.53) returned to 0nix770
0nix770 collected $1.03 from pot
0nix770: doesn't show hand 
*** SUMMARY ***
Total pot $1.08 | Rake $0.05 
Board [6c Ad 4h Jc]
Seat 1: Tyoma_Kovach folded before Flop (didn't bet)
Seat 2: Palen030 folded before Flop (didn't bet)
Seat 3: thedude696969 (button) folded before Flop (didn't bet)
Seat 4: 0nix770 (small blind) collected ($1.03)
Seat 5: patboy73 (big blind) folded on the Turn
Seat 6: Deniels7 folded before Flop (didn't bet)



PokerStars Hand #222943951148:  Hold'em No Limit ($0.05/$0.10 USD) - 2021/01/23 23:22:26 ET
Table 'Algieba III' 6-max Seat #4 is the button
Seat 1: Tyoma_Kovach ($10 in chips) 
Seat 2: Palen030 ($4.15 in chips) 
Seat 3: thedude696969 ($19.91 in chips) 
Seat 4: 0nix770 ($14.81 in chips) 
Seat 5: patboy73 ($6.15 in chips) 
Seat 6: Deniels7 ($15.20 in chips) 
patboy73: posts small blind $0.05
Deniels7: posts big blind $0.10
*** HOLE CARDS ***
Tyoma_Kovach: folds 
Palen030: folds 
thedude696969: raises $0.20 to $0.30
0nix770: folds 
patboy73: calls $0.25
Deniels7: calls $0.20
*** FLOP *** [8h Ah As]
patboy73: checks 
Deniels7: checks 
thedude696969: bets $0.34
patboy73: raises $1.54 to $1.88
Deniels7: calls $1.88
thedude696969: folds 
*** TURN *** [8h Ah As] [9d]
patboy73: bets $3.97 and is all-in
Deniels7: calls $3.97
*** RIVER *** [8h Ah As 9d] [3c]
*** SHOW DOWN ***
patboy73: shows [Ad Kc] (three of a kind, Aces)
Deniels7: shows [Ac 2d] (three of a kind, Aces - lower kicker)
patboy73 collected $12.36 from pot
Deniels7 cashed out the hand for $1.66 | Cash Out Fee $0.02
*** SUMMARY ***
Total pot $12.94 | Rake $0.58 
Board [8h Ah As 9d 3c]
Seat 1: Tyoma_Kovach folded before Flop (didn't bet)
Seat 2: Palen030 folded before Flop (didn't bet)
Seat 3: thedude696969 folded on the Flop
Seat 4: 0nix770 (button) folded before Flop (didn't bet)
Seat 5: patboy73 (small blind) showed [Ad Kc] and won ($12.36) with three of a kind, Aces
Seat 6: Deniels7 (big blind) showed [Ac 2d] and lost with three of a kind, Aces (cashed out).



PokerStars Hand #222943964598:  Hold'em No Limit ($0.05/$0.10 USD) - 2021/01/23 23:23:09 ET
Table 'Algieba III' 6-max Seat #5 is the button
Seat 1: Tyoma_Kovach ($10 in chips) 
Seat 2: Palen030 ($4.15 in chips) 
Seat 3: thedude696969 ($19.27 in chips) 
Seat 4: 0nix770 ($14.81 in chips) 
Seat 5: patboy73 ($12.36 in chips) 
Seat 6: Deniels7 ($10.71 in chips) 
Deniels7: posts small blind $0.05
Tyoma_Kovach: posts big blind $0.10
*** HOLE CARDS ***
Palen030: folds 
thedude696969: folds 
0nix770: folds 
patboy73: calls $0.10
Deniels7: calls $0.05
Tyoma_Kovach: checks 
*** FLOP *** [9s Qc 4c]
Deniels7: checks 
Tyoma_Kovach: checks 
patboy73: checks 
*** TURN *** [9s Qc 4c] [2c]
Deniels7: checks 
Tyoma_Kovach: checks 
patboy73: checks 
*** RIVER *** [9s Qc 4c 2c] [Kc]
Deniels7: checks 
Tyoma_Kovach: checks 
patboy73: bets $0.10
Deniels7: folds 
Tyoma_Kovach: folds 
Uncalled bet ($0.10) returned to patboy73
patboy73 collected $0.29 from pot
*** SUMMARY ***
Total pot $0.30 | Rake $0.01 
Board [9s Qc 4c 2c Kc]
Seat 1: Tyoma_Kovach (big blind) folded on the River
Seat 2: Palen030 folded before Flop (didn't bet)
Seat 3: thedude696969 folded before Flop (didn't bet)
Seat 4: 0nix770 folded before Flop (didn't bet)
Seat 5: patboy73 (button) collected ($0.29)
Seat 6: Deniels7 (small blind) folded on the River



PokerStars Hand #222943977069:  Hold'em No Limit ($0.05/$0.10 USD) - 2021/01/23 23:23:48 ET
Table 'Algieba III' 6-max Seat #6 is the button
Seat 1: Tyoma_Kovach ($10 in chips) 
Seat 2: Palen030 ($4.15 in chips) 
Seat 3: thedude696969 ($19.27 in chips) 
Seat 4: 0nix770 ($14.81 in chips) 
Seat 5: patboy73 ($12.55 in chips) 
Seat 6: Deniels7 ($10.61 in chips) 
Tyoma_Kovach: posts small blind $0.05
Palen030: posts big blind $0.10
*** HOLE CARDS ***
thedude696969: folds 
0nix770: folds 
patboy73: calls $0.10
Deniels7: folds 
Tyoma_Kovach: folds 
Palen030: checks 
*** FLOP *** [8c 3d Js]
Palen030: checks 
patboy73: checks 
*** TURN *** [8c 3d Js] [5s]
Palen030: bets $0.10
patboy73: folds 
Uncalled bet ($0.10) returned to Palen030
Palen030 collected $0.24 from pot
Palen030: doesn't show hand 
*** SUMMARY ***
Total pot $0.25 | Rake $0.01 
Board [8c 3d Js 5s]
Seat 1: Tyoma_Kovach (small blind) folded before Flop
Seat 2: Palen030 (big blind) collected ($0.24)
Seat 3: thedude696969 folded before Flop (didn't bet)
Seat 4: 0nix770 folded before Flop (didn't bet)
Seat 5: patboy73 folded on the Turn
Seat 6: Deniels7 (button) folded before Flop (didn't bet)



PokerStars Hand #222943988191:  Hold'em No Limit ($0.05/$0.10 USD) - 2021/01/23 23:24:23 ET
Table 'Algieba III' 6-max Seat #1 is the button
Seat 1: Tyoma_Kovach ($10 in chips) 
Seat 2: Palen030 ($4.29 in chips) 
Seat 3: thedude696969 ($19.27 in chips) 
Seat 4: 0nix770 ($14.81 in chips) 
Seat 5: patboy73 ($12.45 in chips) 
Seat 6: Deniels7 ($10.61 in chips) 
Palen030: posts small blind $0.05
thedude696969: posts big blind $0.10
*** HOLE CARDS ***
0nix770: folds 
patboy73: calls $0.10
Deniels7: folds 
Tyoma_Kovach: folds 
Palen030: calls $0.05
thedude696969: checks 
*** FLOP *** [Jh 2h 4s]
Palen030: checks 
thedude696969: checks 
patboy73: checks 
*** TURN *** [Jh 2h 4s] [Kh]
Palen030: checks 
thedude696969: checks 
patboy73: checks 
*** RIVER *** [Jh 2h 4s Kh] [5s]
Palen030: bets $0.10
thedude696969: calls $0.10
patboy73: folds 
*** SHOW DOWN ***
Palen030: shows [8h 8d] (a pair of Eights)
thedude696969: mucks hand 
Palen030 collected $0.48 from pot
*** SUMMARY ***
Total pot $0.50 | Rake $0.02 
Board [Jh 2h 4s Kh 5s]
Seat 1: Tyoma_Kovach (button) folded before Flop (didn't bet)
Seat 2: Palen030 (small blind) showed [8h 8d] and won ($0.48) with a pair of Eights
Seat 3: thedude696969 (big blind) mucked
Seat 4: 0nix770 folded before Flop (didn't bet)
Seat 5: patboy73 folded on the River
Seat 6: Deniels7 folded before Flop (didn't bet)



PokerStars Hand #222943998304:  Hold'em No Limit ($0.05/$0.10 USD) - 2021/01/23 23:24:55 ET
Table 'Algieba III' 6-max Seat #2 is the button
Seat 1: Tyoma_Kovach ($10 in chips) 
Seat 2: Palen030 ($4.57 in chips) 
Seat 3: thedude696969 ($19.07 in chips) 
Seat 4: 0nix770 ($14.81 in chips) 
Seat 5: patboy73 ($12.35 in chips) 
Seat 6: Deniels7 ($10.61 in chips) 
thedude696969: posts small blind $0.05
0nix770: posts big blind $0.10
*** HOLE CARDS ***
patboy73: folds 
Deniels7: raises $0.10 to $0.20
Tyoma_Kovach: folds 
Palen030: folds 
thedude696969: calls $0.15
0nix770: folds 
*** FLOP *** [5s Qs 2c]
thedude696969: checks 
Deniels7: checks 
*** TURN *** [5s Qs 2c] [5h]
thedude696969: checks 
Deniels7: bets $0.20
thedude696969: raises $0.20 to $0.40
Deniels7: calls $0.20
*** RIVER *** [5s Qs 2c 5h] [6h]
thedude696969: checks 
Deniels7: checks 
*** SHOW DOWN ***
thedude696969: shows [2h 2d] (a full house, Deuces full of Fives)
Deniels7: mucks hand 
thedude696969 collected $1.24 from pot
*** SUMMARY ***
Total pot $1.30 | Rake $0.06 
Board [5s Qs 2c 5h 6h]
Seat 1: Tyoma_Kovach folded before Flop (didn't bet)
Seat 2: Palen030 (button) folded before Flop (didn't bet)
Seat 3: thedude696969 (small blind) showed [2h 2d] and won ($1.24) with a full house, Deuces full of Fives
Seat 4: 0nix770 (big blind) folded before Flop
Seat 5: patboy73 folded before Flop (didn't bet)
Seat 6: Deniels7 mucked



PokerStars Hand #222944015505:  Hold'em No Limit ($0.05/$0.10 USD) - 2021/01/23 23:25:49 ET
Table 'Algieba III' 6-max Seat #3 is the button
Seat 1: Tyoma_Kovach ($10 in chips) 
Seat 2: Palen030 ($4.57 in chips) 
Seat 3: thedude696969 ($19.71 in chips) 
Seat 4: 0nix770 ($14.71 in chips) 
Seat 5: patboy73 ($12.35 in chips) 
Seat 6: Deniels7 ($10.01 in chips) 
0nix770: posts small blind $0.05
patboy73: posts big blind $0.10
*** HOLE CARDS ***
Deniels7: folds 
Tyoma_Kovach: raises $0.20 to $0.30
Palen030: folds 
thedude696969: raises $0.90 to $1.20
0nix770: folds 
patboy73: folds 
Tyoma_Kovach: folds 
Uncalled bet ($0.90) returned to thedude696969
thedude696969 collected $0.75 from pot
thedude696969: doesn't show hand 
*** SUMMARY ***
Total pot $0.75 | Rake $0 
Seat 1: Tyoma_Kovach folded before Flop
Seat 2: Palen030 folded before Flop (didn't bet)
Seat 3: thedude696969 (button) collected ($0.75)
Seat 4: 0nix770 (small blind) folded before Flop
Seat 5: patboy73 (big blind) folded before Flop
Seat 6: Deniels7 folded before Flop (didn't bet)



PokerStars Hand #222944021011:  Hold'em No Limit ($0.05/$0.10 USD) - 2021/01/23 23:26:06 ET
Table 'Algieba III' 6-max Seat #4 is the button
Seat 1: Tyoma_Kovach ($10 in chips) 
Seat 2: Palen030 ($4.57 in chips) 
Seat 3: thedude696969 ($20.16 in chips) 
Seat 4: 0nix770 ($14.66 in chips) 
Seat 5: patboy73 ($12.25 in chips) 
Seat 6: Deniels7 ($10.01 in chips) 
patboy73: posts small blind $0.05
Deniels7: posts big blind $0.10
*** HOLE CARDS ***
Tyoma_Kovach: folds 
Palen030: calls $0.10
thedude696969: raises $0.20 to $0.30
0nix770: folds 
patboy73: calls $0.25
Deniels7: calls $0.20
Palen030: calls $0.20
*** FLOP *** [9c Qd As]
patboy73: checks 
Deniels7: checks 
Palen030: checks 
thedude696969: checks 
*** TURN *** [9c Qd As] [4c]
patboy73: bets $1.15
Deniels7: folds 
Palen030: folds 
thedude696969: folds 
Uncalled bet ($1.15) returned to patboy73
patboy73 collected $1.15 from pot
*** SUMMARY ***
Total pot $1.20 | Rake $0.05 
Board [9c Qd As 4c]
Seat 1: Tyoma_Kovach folded before Flop (didn't bet)
Seat 2: Palen030 folded on the Turn
Seat 3: thedude696969 folded on the Turn
Seat 4: 0nix770 (button) folded before Flop (didn't bet)
Seat 5: patboy73 (small blind) collected ($1.15)
Seat 6: Deniels7 (big blind) folded on the Turn



PokerStars Hand #222944035351:  Hold'em No Limit ($0.05/$0.10 USD) - 2021/01/23 23:26:52 ET
Table 'Algieba III' 6-max Seat #5 is the button
Seat 1: Tyoma_Kovach ($10 in chips) 
Seat 2: Palen030 ($4.27 in chips) 
Seat 3: thedude696969 ($19.86 in chips) 
Seat 4: 0nix770 ($14.66 in chips) 
Seat 5: patboy73 ($13.10 in chips) 
Seat 6: Deniels7 ($9.71 in chips) 
Deniels7: posts small blind $0.05
Tyoma_Kovach: posts big blind $0.10
*** HOLE CARDS ***
Palen030: calls $0.10
thedude696969: raises $0.14 to $0.24
0nix770: raises $0.86 to $1.10
patboy73: folds 
Deniels7: folds 
Tyoma_Kovach: folds 
Palen030: folds 
thedude696969: folds 
Uncalled bet ($0.86) returned to 0nix770
0nix770 collected $0.73 from pot
0nix770: doesn't show hand 
*** SUMMARY ***
Total pot $0.73 | Rake $0 
Seat 1: Tyoma_Kovach (big blind) folded before Flop
Seat 2: Palen030 folded before Flop
Seat 3: thedude696969 folded before Flop
Seat 4: 0nix770 collected ($0.73)
Seat 5: patboy73 (button) folded before Flop (didn't bet)
Seat 6: Deniels7 (small blind) folded before Flop



PokerStars Hand #222944043761:  Hold'em No Limit ($0.05/$0.10 USD) - 2021/01/23 23:27:18 ET
Table 'Algieba III' 6-max Seat #6 is the button
Seat 1: Tyoma_Kovach ($10 in chips) 
Seat 2: Palen030 ($4.17 in chips) 
Seat 3: thedude696969 ($19.62 in chips) 
Seat 4: 0nix770 ($15.15 in chips) 
Seat 5: patboy73 ($13.10 in chips) 
Seat 6: Deniels7 ($9.66 in chips) 
Tyoma_Kovach: posts small blind $0.05
Palen030: posts big blind $0.10
*** HOLE CARDS ***
thedude696969: folds 
0nix770: folds 
patboy73 has timed out
patboy73: folds 
Deniels7: folds 
Tyoma_Kovach: folds 
Uncalled bet ($0.05) returned to Palen030
Palen030 collected $0.10 from pot
Palen030: doesn't show hand 
*** SUMMARY ***
Total pot $0.10 | Rake $0 
Seat 1: Tyoma_Kovach (small blind) folded before Flop
Seat 2: Palen030 (big blind) collected ($0.10)
Seat 3: thedude696969 folded before Flop (didn't bet)
Seat 4: 0nix770 folded before Flop (didn't bet)
Seat 5: patboy73 folded before Flop (didn't bet)
Seat 6: Deniels7 (button) folded before Flop (didn't bet)



PokerStars Hand #222944049922:  Hold'em No Limit ($0.05/$0.10 USD) - 2021/01/23 23:27:39 ET
Table 'Algieba III' 6-max Seat #1 is the button
Seat 1: Tyoma_Kovach ($10 in chips) 
Seat 2: Palen030 ($4.22 in chips) 
Seat 3: thedude696969 ($19.62 in chips) 
Seat 4: 0nix770 ($15.15 in chips) 
Seat 6: Deniels7 ($9.66 in chips) 
Palen030: posts small blind $0.05
thedude696969: posts big blind $0.10
*** HOLE CARDS ***
0nix770: folds 
Deniels7: folds 
Tyoma_Kovach: folds 
Palen030: calls $0.05
thedude696969: checks 
*** FLOP *** [Ah 8c 6h]
Palen030: bets $0.10
thedude696969: folds 
Uncalled bet ($0.10) returned to Palen030
Palen030 collected $0.19 from pot
Palen030: doesn't show hand 
*** SUMMARY ***
Total pot $0.20 | Rake $0.01 
Board [Ah 8c 6h]
Seat 1: Tyoma_Kovach (button) folded before Flop (didn't bet)
Seat 2: Palen030 (small blind) collected ($0.19)
Seat 3: thedude696969 (big blind) folded on the Flop
Seat 4: 0nix770 folded before Flop (didn't bet)
Seat 6: Deniels7 folded before Flop (didn't bet)



PokerStars Hand #222944055293:  Hold'em No Limit ($0.05/$0.10 USD) - 2021/01/23 23:27:56 ET
Table 'Algieba III' 6-max Seat #2 is the button
Seat 1: Tyoma_Kovach ($10 in chips) 
Seat 2: Palen030 ($4.31 in chips) 
Seat 3: thedude696969 ($19.52 in chips) 
Seat 4: 0nix770 ($15.15 in chips) 
Seat 5: patboy73 ($13.10 in chips) 
Seat 6: Deniels7 ($9.66 in chips) 
thedude696969: posts small blind $0.05
0nix770: posts big blind $0.10
*** HOLE CARDS ***
patboy73 has timed out
patboy73: folds 
Deniels7: raises $0.10 to $0.20
Tyoma_Kovach: folds 
Palen030: calls $0.20
thedude696969: folds 
0nix770: folds 
*** FLOP *** [3h Jd 5s]
Deniels7: checks 
Palen030: bets $4.11 and is all-in
Deniels7: folds 
Uncalled bet ($4.11) returned to Palen030
Palen030 collected $0.53 from pot
Palen030: doesn't show hand 
*** SUMMARY ***
Total pot $0.55 | Rake $0.02 
Board [3h Jd 5s]
Seat 1: Tyoma_Kovach folded before Flop (didn't bet)
Seat 2: Palen030 (button) collected ($0.53)
Seat 3: thedude696969 (small blind) folded before Flop
Seat 4: 0nix770 (big blind) folded before Flop
Seat 5: patboy73 folded before Flop (didn't bet)
Seat 6: Deniels7 folded on the Flop



PokerStars Hand #222944063751:  Hold'em No Limit ($0.05/$0.10 USD) - 2021/01/23 23:28:23 ET
Table 'Algieba III' 6-max Seat #3 is the button
Seat 1: Tyoma_Kovach ($10 in chips) 
Seat 2: Palen030 ($4.64 in chips) 
Seat 3: thedude696969 ($19.47 in chips) 
Seat 4: 0nix770 ($15.05 in chips) 
Seat 5: patboy73 ($13.10 in chips) 
Seat 6: Deniels7 ($9.46 in chips) 
0nix770: posts small blind $0.05
patboy73: posts big blind $0.10
*** HOLE CARDS ***
Deniels7: folds 
Tyoma_Kovach: folds 
Palen030: folds 
thedude696969: raises $0.14 to $0.24
0nix770: folds 
patboy73: folds 
Uncalled bet ($0.14) returned to thedude696969
thedude696969 collected $0.25 from pot
thedude696969: doesn't show hand 
*** SUMMARY ***
Total pot $0.25 | Rake $0 
Seat 1: Tyoma_Kovach folded before Flop (didn't bet)
Seat 2: Palen030 folded before Flop (didn't bet)
Seat 3: thedude696969 (button) collected ($0.25)
Seat 4: 0nix770 (small blind) folded before Flop
Seat 5: patboy73 (big blind) folded before Flop
Seat 6: Deniels7 folded before Flop (didn't bet)



PokerStars Hand #222944071229:  Hold'em No Limit ($0.05/$0.10 USD) - 2021/01/23 23:28:47 ET
Table 'Algieba III' 6-max Seat #4 is the button
Seat 1: Tyoma_Kovach ($10 in chips) 
Seat 2: Palen030 ($4.64 in chips) 
Seat 3: thedude696969 ($19.62 in chips) 
Seat 4: 0nix770 ($15 in chips) 
Seat 5: patboy73 ($13 in chips) 
Seat 6: Deniels7 ($9.46 in chips) 
patboy73: posts small blind $0.05
Deniels7: posts big blind $0.10
*** HOLE CARDS ***
Tyoma_Kovach: folds 
Palen030: folds 
thedude696969: folds 
0nix770: raises $0.13 to $0.23
patboy73: folds 
Deniels7: calls $0.13
*** FLOP *** [9d Ts Qh]
Deniels7: checks 
0nix770: checks 
*** TURN *** [9d Ts Qh] [7c]
Deniels7: checks 
0nix770: checks 
*** RIVER *** [9d Ts Qh 7c] [8c]
Deniels7: bets $0.20
0nix770: folds 
Uncalled bet ($0.20) returned to Deniels7
Deniels7 collected $0.49 from pot
Deniels7: doesn't show hand 
*** SUMMARY ***
Total pot $0.51 | Rake $0.02 
Board [9d Ts Qh 7c 8c]
Seat 1: Tyoma_Kovach folded before Flop (didn't bet)
Seat 2: Palen030 folded before Flop (didn't bet)
Seat 3: thedude696969 folded before Flop (didn't bet)
Seat 4: 0nix770 (button) folded on the River
Seat 5: patboy73 (small blind) folded before Flop
Seat 6: Deniels7 (big blind) collected ($0.49)



PokerStars Hand #222944087413:  Hold'em No Limit ($0.05/$0.10 USD) - 2021/01/23 23:29:40 ET
Table 'Algieba III' 6-max Seat #5 is the button
Seat 1: Tyoma_Kovach ($10 in chips) 
Seat 2: Palen030 ($4.64 in chips) 
Seat 3: thedude696969 ($19.62 in chips) 
Seat 4: 0nix770 ($14.77 in chips) 
Seat 5: patboy73 ($12.95 in chips) 
Seat 6: Deniels7 ($9.72 in chips) 
Deniels7: posts small blind $0.05
Tyoma_Kovach: posts big blind $0.10
*** HOLE CARDS ***
Palen030: raises $0.10 to $0.20
thedude696969: folds 
0nix770: folds 
patboy73: calls $0.20
Deniels7: calls $0.15
Tyoma_Kovach: folds 
*** FLOP *** [7h 6h 9c]
Deniels7: checks 
Palen030: bets $0.10
patboy73: calls $0.10
Deniels7: calls $0.10
*** TURN *** [7h 6h 9c] [9s]
Deniels7: checks 
Palen030: bets $0.10
patboy73: calls $0.10
Deniels7: calls $0.10
*** RIVER *** [7h 6h 9c 9s] [3h]
Deniels7: checks 
Palen030: bets $0.20
patboy73: folds 
Deniels7: raises $0.50 to $0.70
Palen030: folds 
Uncalled bet ($0.50) returned to Deniels7
Deniels7 collected $1.62 from pot
Deniels7: doesn't show hand 
*** SUMMARY ***
Total pot $1.70 | Rake $0.08 
Board [7h 6h 9c 9s 3h]
Seat 1: Tyoma_Kovach (big blind) folded before Flop
Seat 2: Palen030 folded on the River
Seat 3: thedude696969 folded before Flop (didn't bet)
Seat 4: 0nix770 folded before Flop (didn't bet)
Seat 5: patboy73 (button) folded on the River
Seat 6: Deniels7 (small blind) collected ($1.62)



PokerStars Hand #222944112584:  Hold'em No Limit ($0.05/$0.10 USD) - 2021/01/23 23:30:53 ET
Table 'Algieba III' 6-max Seat #6 is the button
Seat 1: Tyoma_Kovach ($10 in chips) 
Seat 2: Palen030 ($4.04 in chips) 
Seat 3: thedude696969 ($19.62 in chips) 
Seat 4: 0nix770 ($14.77 in chips) 
Seat 5: patboy73 ($12.55 in chips) 
Seat 6: Deniels7 ($10.74 in chips) 
Tyoma_Kovach: posts small blind $0.05
Palen030: posts big blind $0.10
*** HOLE CARDS ***
thedude696969: folds 
0nix770: folds 
patboy73: folds 
Deniels7: raises $0.10 to $0.20
Tyoma_Kovach: raises $0.80 to $1
Palen030: folds 
Deniels7: calls $0.80
*** FLOP *** [Kh Qs Qc]
Tyoma_Kovach: bets $0.66
Deniels7: calls $0.66
*** TURN *** [Kh Qs Qc] [2d]
Tyoma_Kovach: bets $1.08
Deniels7: calls $1.08
*** RIVER *** [Kh Qs Qc 2d] [5c]
Tyoma_Kovach: bets $1.76
Deniels7: raises $2.64 to $4.40
Tyoma_Kovach: raises $2.86 to $7.26 and is all-in
Deniels7: calls $2.86
*** SHOW DOWN ***
Tyoma_Kovach: shows [Kc Ks] (a full house, Kings full of Queens)
Deniels7: shows [Th Qh] (three of a kind, Queens)
Tyoma_Kovach collected $19.20 from pot
*** SUMMARY ***
Total pot $20.10 | Rake $0.90 
Board [Kh Qs Qc 2d 5c]
Seat 1: Tyoma_Kovach (small blind) showed [Kc Ks] and won ($19.20) with a full house, Kings full of Queens
Seat 2: Palen030 (big blind) folded before Flop
Seat 3: thedude696969 folded before Flop (didn't bet)
Seat 4: 0nix770 folded before Flop (didn't bet)
Seat 5: patboy73 folded before Flop (didn't bet)
Seat 6: Deniels7 (button) showed [Th Qh] and lost with three of a kind, Queens



PokerStars Hand #222944131901:  Hold'em No Limit ($0.05/$0.10 USD) - 2021/01/23 23:31:56 ET
Table 'Algieba III' 6-max Seat #1 is the button
Seat 1: Tyoma_Kovach ($19.20 in chips) 
Seat 2: Palen030 ($3.94 in chips) 
Seat 3: thedude696969 ($19.62 in chips) 
Seat 4: 0nix770 ($14.77 in chips) 
Seat 5: patboy73 ($12.55 in chips) 
Seat 6: Deniels7 ($0.74 in chips) 
Palen030: posts small blind $0.05
thedude696969: posts big blind $0.10
*** HOLE CARDS ***
0nix770: folds 
patboy73: folds 
Deniels7: folds 
Tyoma_Kovach: raises $0.15 to $0.25
Palen030: calls $0.20
thedude696969: calls $0.15
*** FLOP *** [8d Js 4d]
Palen030: checks 
thedude696969: checks 
Tyoma_Kovach: checks 
*** TURN *** [8d Js 4d] [5c]
Palen030: checks 
thedude696969: checks 
Tyoma_Kovach: checks 
*** RIVER *** [8d Js 4d 5c] [6h]
Palen030: bets $0.72
thedude696969: folds 
Tyoma_Kovach: folds 
Uncalled bet ($0.72) returned to Palen030
Palen030 collected $0.72 from pot
Palen030: doesn't show hand 
*** SUMMARY ***
Total pot $0.75 | Rake $0.03 
Board [8d Js 4d 5c 6h]
Seat 1: Tyoma_Kovach (button) folded on the River
Seat 2: Palen030 (small blind) collected ($0.72)
Seat 3: thedude696969 (big blind) folded on the River
Seat 4: 0nix770 folded before Flop (didn't bet)
Seat 5: patboy73 folded before Flop (didn't bet)
Seat 6: Deniels7 folded before Flop (didn't bet)



PokerStars Hand #222944145905:  Hold'em No Limit ($0.05/$0.10 USD) - 2021/01/23 23:32:42 ET
Table 'Algieba III' 6-max Seat #2 is the button
Seat 1: Tyoma_Kovach ($18.95 in chips) 
Seat 2: Palen030 ($4.41 in chips) 
Seat 3: thedude696969 ($19.37 in chips) 
Seat 4: 0nix770 ($14.77 in chips) 
Seat 5: patboy73 ($12.55 in chips) 
Seat 6: Deniels7 ($10 in chips) 
thedude696969: posts small blind $0.05
0nix770: posts big blind $0.10
*** HOLE CARDS ***
patboy73: folds 
Deniels7: raises $0.20 to $0.30
Tyoma_Kovach: folds 
Palen030: calls $0.30
thedude696969: folds 
0nix770: folds 
*** FLOP *** [3h Ac As]
Deniels7: checks 
Palen030: checks 
*** TURN *** [3h Ac As] [Qs]
Deniels7: bets $0.10
Palen030: calls $0.10
*** RIVER *** [3h Ac As Qs] [9d]
Deniels7: bets $0.50
Palen030: folds 
Uncalled bet ($0.50) returned to Deniels7
Deniels7 collected $0.91 from pot
Deniels7: doesn't show hand 
*** SUMMARY ***
Total pot $0.95 | Rake $0.04 
Board [3h Ac As Qs 9d]
Seat 1: Tyoma_Kovach folded before Flop (didn't bet)
Seat 2: Palen030 (button) folded on the River
Seat 3: thedude696969 (small blind) folded before Flop
Seat 4: 0nix770 (big blind) folded before Flop
Seat 5: patboy73 folded before Flop (didn't bet)
Seat 6: Deniels7 collected ($0.91)



PokerStars Hand #222944155479:  Hold'em No Limit ($0.05/$0.10 USD) - 2021/01/23 23:33:13 ET
Table 'Algieba III' 6-max Seat #3 is the button
Seat 1: Tyoma_Kovach ($18.95 in chips) 
Seat 2: Palen030 ($4.01 in chips) 
Seat 3: thedude696969 ($19.32 in chips) 
Seat 4: 0nix770 ($14.67 in chips) 
Seat 5: patboy73 ($12.55 in chips) 
Seat 6: Deniels7 ($10.51 in chips) 
0nix770: posts small blind $0.05
patboy73: posts big blind $0.10
*** HOLE CARDS ***
Deniels7: raises $0.25 to $0.35
Tyoma_Kovach: folds 
Palen030: folds 
thedude696969: folds 
0nix770: folds 
patboy73: calls $0.25
*** FLOP *** [5s Qh 2c]
patboy73: checks 
Deniels7: bets $0.20
patboy73: folds 
Uncalled bet ($0.20) returned to Deniels7
Deniels7 collected $0.72 from pot
Deniels7: doesn't show hand 
*** SUMMARY ***
Total pot $0.75 | Rake $0.03 
Board [5s Qh 2c]
Seat 1: Tyoma_Kovach folded before Flop (didn't bet)
Seat 2: Palen030 folded before Flop (didn't bet)
Seat 3: thedude696969 (button) folded before Flop (didn't bet)
Seat 4: 0nix770 (small blind) folded before Flop
Seat 5: patboy73 (big blind) folded on the Flop
Seat 6: Deniels7 collected ($0.72)



PokerStars Hand #222944161582:  Hold'em No Limit ($0.05/$0.10 USD) - 2021/01/23 23:33:33 ET
Table 'Algieba III' 6-max Seat #4 is the button
Seat 1: Tyoma_Kovach ($18.95 in chips) 
Seat 2: Palen030 ($4.01 in chips) 
Seat 3: thedude696969 ($19.32 in chips) 
Seat 4: 0nix770 ($14.62 in chips) 
Seat 5: patboy73 ($12.20 in chips) 
Seat 6: Deniels7 ($10.88 in chips) 
patboy73: posts small blind $0.05
Deniels7: posts big blind $0.10
*** HOLE CARDS ***
Tyoma_Kovach: folds 
Palen030: folds 
thedude696969: folds 
0nix770: raises $0.13 to $0.23
patboy73: folds 
Deniels7: raises $0.13 to $0.36
0nix770: calls $0.13
*** FLOP *** [Kc 9d 2d]
Deniels7: checks 
0nix770: checks 
*** TURN *** [Kc 9d 2d] [Js]
Deniels7: checks 
0nix770: bets $0.41
Deniels7: folds 
Uncalled bet ($0.41) returned to 0nix770
0nix770 collected $0.74 from pot
0nix770: doesn't show hand 
*** SUMMARY ***
Total pot $0.77 | Rake $0.03 
Board [Kc 9d 2d Js]
Seat 1: Tyoma_Kovach folded before Flop (didn't bet)
Seat 2: Palen030 folded before Flop (didn't bet)
Seat 3: thedude696969 folded before Flop (didn't bet)
Seat 4: 0nix770 (button) collected ($0.74)
Seat 5: patboy73 (small blind) folded before Flop
Seat 6: Deniels7 (big blind) folded on the Turn



PokerStars Hand #222944170971:  Hold'em No Limit ($0.05/$0.10 USD) - 2021/01/23 23:34:04 ET
Table 'Algieba III' 6-max Seat #5 is the button
Seat 1: Tyoma_Kovach ($18.95 in chips) 
Seat 2: Palen030 ($4.01 in chips) 
Seat 3: thedude696969 ($19.32 in chips) 
Seat 4: 0nix770 ($15 in chips) 
Seat 5: patboy73 ($12.15 in chips) 
Seat 6: Deniels7 ($10.52 in chips) 
Deniels7: posts small blind $0.05
Tyoma_Kovach: posts big blind $0.10
*** HOLE CARDS ***
Palen030: folds 
thedude696969: folds 
0nix770: folds 
patboy73: folds 
Deniels7: raises $0.10 to $0.20
Tyoma_Kovach: raises $0.60 to $0.80
Deniels7: calls $0.60
*** FLOP *** [4c Jh 5h]
Deniels7: bets $1.60
Tyoma_Kovach: folds 
Uncalled bet ($1.60) returned to Deniels7
Deniels7 collected $1.53 from pot
Deniels7: doesn't show hand 
*** SUMMARY ***
Total pot $1.60 | Rake $0.07 
Board [4c Jh 5h]
Seat 1: Tyoma_Kovach (big blind) folded on the Flop
Seat 2: Palen030 folded before Flop (didn't bet)
Seat 3: thedude696969 folded before Flop (didn't bet)
Seat 4: 0nix770 folded before Flop (didn't bet)
Seat 5: patboy73 (button) folded before Flop (didn't bet)
Seat 6: Deniels7 (small blind) collected ($1.53)



PokerStars Hand #222944178898:  Hold'em No Limit ($0.05/$0.10 USD) - 2021/01/23 23:34:30 ET
Table 'Algieba III' 6-max Seat #6 is the button
Seat 1: Tyoma_Kovach ($18.15 in chips) 
Seat 2: Palen030 ($4.01 in chips) 
Seat 3: thedude696969 ($19.32 in chips) 
Seat 4: 0nix770 ($15 in chips) 
Seat 6: Deniels7 ($11.25 in chips) 
Tyoma_Kovach: posts small blind $0.05
Palen030: posts big blind $0.10
*** HOLE CARDS ***
thedude696969: folds 
0nix770: folds 
Deniels7: calls $0.10
Tyoma_Kovach: folds 
Palen030: checks 
*** FLOP *** [9d 5h 9s]
Palen030: checks 
Deniels7: checks 
*** TURN *** [9d 5h 9s] [4s]
Palen030: bets $0.10
Deniels7: folds 
Uncalled bet ($0.10) returned to Palen030
Palen030 collected $0.24 from pot
Palen030: doesn't show hand 
*** SUMMARY ***
Total pot $0.25 | Rake $0.01 
Board [9d 5h 9s 4s]
Seat 1: Tyoma_Kovach (small blind) folded before Flop
Seat 2: Palen030 (big blind) collected ($0.24)
Seat 3: thedude696969 folded before Flop (didn't bet)
Seat 4: 0nix770 folded before Flop (didn't bet)
Seat 6: Deniels7 (button) folded on the Turn



PokerStars Hand #222944184981:  Hold'em No Limit ($0.05/$0.10 USD) - 2021/01/23 23:34:50 ET
Table 'Algieba III' 6-max Seat #1 is the button
Seat 1: Tyoma_Kovach ($18.10 in chips) 
Seat 2: Palen030 ($4.15 in chips) 
Seat 3: thedude696969 ($19.32 in chips) 
Seat 4: 0nix770 ($15 in chips) 
Seat 6: Deniels7 ($11.15 in chips) 
Palen030: posts small blind $0.05
thedude696969: posts big blind $0.10
*** HOLE CARDS ***
0nix770: folds 
Deniels7: folds 
Tyoma_Kovach: folds 
Palen030: folds 
Uncalled bet ($0.05) returned to thedude696969
thedude696969 collected $0.10 from pot
thedude696969: doesn't show hand 
*** SUMMARY ***
Total pot $0.10 | Rake $0 
Seat 1: Tyoma_Kovach (button) folded before Flop (didn't bet)
Seat 2: Palen030 (small blind) folded before Flop
Seat 3: thedude696969 (big blind) collected ($0.10)
Seat 4: 0nix770 folded before Flop (didn't bet)
Seat 6: Deniels7 folded before Flop (didn't bet)



PokerStars Hand #222944191047:  Hold'em No Limit ($0.05/$0.10 USD) - 2021/01/23 23:35:00 ET
Table 'Algieba III' 6-max Seat #2 is the button
Seat 1: Tyoma_Kovach ($18.10 in chips) 
Seat 2: Palen030 ($4.10 in chips) 
Seat 3: thedude696969 ($19.37 in chips) 
Seat 4: 0nix770 ($15 in chips) 
Seat 6: Deniels7 ($11.15 in chips) 
thedude696969: posts small blind $0.05
0nix770: posts big blind $0.10
*** HOLE CARDS ***
Deniels7: folds 
Tyoma_Kovach: folds 
Palen030: folds 
thedude696969: folds 
Uncalled bet ($0.05) returned to 0nix770
0nix770 collected $0.10 from pot
0nix770: doesn't show hand 
*** SUMMARY ***
Total pot $0.10 | Rake $0 
Seat 1: Tyoma_Kovach folded before Flop (didn't bet)
Seat 2: Palen030 (button) folded before Flop (didn't bet)
Seat 3: thedude696969 (small blind) folded before Flop
Seat 4: 0nix770 (big blind) collected ($0.10)
Seat 6: Deniels7 folded before Flop (didn't bet)



PokerStars Hand #222944194896:  Hold'em No Limit ($0.05/$0.10 USD) - 2021/01/23 23:35:12 ET
Table 'Algieba III' 6-max Seat #3 is the button
Seat 1: Tyoma_Kovach ($18.10 in chips) 
Seat 2: Palen030 ($4.10 in chips) 
Seat 3: thedude696969 ($19.32 in chips) 
Seat 4: 0nix770 ($15.05 in chips) 
Seat 6: Deniels7 ($11.15 in chips) 
0nix770: posts small blind $0.05
Deniels7: posts big blind $0.10
*** HOLE CARDS ***
Tyoma_Kovach: folds 
Palen030: calls $0.10
thedude696969: raises $0.20 to $0.30
0nix770: calls $0.25
Deniels7: raises $0.20 to $0.50
Palen030: folds 
thedude696969: calls $0.20
0nix770: calls $0.20
*** FLOP *** [8c 6d Jh]
0nix770: checks 
Deniels7: bets $1.53
thedude696969: folds 
0nix770: folds 
Uncalled bet ($1.53) returned to Deniels7
Deniels7 collected $1.53 from pot
Deniels7: doesn't show hand 
*** SUMMARY ***
Total pot $1.60 | Rake $0.07 
Board [8c 6d Jh]
Seat 1: Tyoma_Kovach folded before Flop (didn't bet)
Seat 2: Palen030 folded before Flop
Seat 3: thedude696969 (button) folded on the Flop
Seat 4: 0nix770 (small blind) folded on the Flop
Seat 6: Deniels7 (big blind) collected ($1.53)



PokerStars Hand #222944203764:  Hold'em No Limit ($0.05/$0.10 USD) - 2021/01/23 23:35:42 ET
Table 'Algieba III' 6-max Seat #4 is the button
Seat 1: Tyoma_Kovach ($18.10 in chips) 
Seat 2: Palen030 ($4 in chips) 
Seat 3: thedude696969 ($18.82 in chips) 
Seat 4: 0nix770 ($14.55 in chips) 
Seat 6: Deniels7 ($12.18 in chips) 
Deniels7: posts small blind $0.05
Tyoma_Kovach: posts big blind $0.10
*** HOLE CARDS ***
Palen030: folds 
thedude696969: folds 
0nix770: folds 
Deniels7: raises $0.10 to $0.20
Tyoma_Kovach: calls $0.10
*** FLOP *** [7d Ah 6s]
Deniels7: checks 
Tyoma_Kovach: bets $0.13
Deniels7: calls $0.13
*** TURN *** [7d Ah 6s] [2c]
Deniels7: checks 
Tyoma_Kovach: bets $0.47
Deniels7: calls $0.47
*** RIVER *** [7d Ah 6s 2c] [Tc]
Deniels7: checks 
Tyoma_Kovach: bets $0.77
Deniels7: calls $0.77
*** SHOW DOWN ***
Tyoma_Kovach: shows [9d As] (a pair of Aces)
Deniels7: mucks hand 
Tyoma_Kovach collected $3 from pot
*** SUMMARY ***
Total pot $3.14 | Rake $0.14 
Board [7d Ah 6s 2c Tc]
Seat 1: Tyoma_Kovach (big blind) showed [9d As] and won ($3) with a pair of Aces
Seat 2: Palen030 folded before Flop (didn't bet)
Seat 3: thedude696969 folded before Flop (didn't bet)
Seat 4: 0nix770 (button) folded before Flop (didn't bet)
Seat 6: Deniels7 (small blind) mucked



PokerStars Hand #222944219463:  Hold'em No Limit ($0.05/$0.10 USD) - 2021/01/23 23:36:34 ET
Table 'Algieba III' 6-max Seat #6 is the button
Seat 1: Tyoma_Kovach ($19.53 in chips) 
Seat 2: Palen030 ($4 in chips) 
Seat 3: thedude696969 ($18.82 in chips) 
Seat 4: 0nix770 ($14.55 in chips) 
Seat 6: Deniels7 ($10.61 in chips) 
Tyoma_Kovach: posts small blind $0.05
Palen030: posts big blind $0.10
*** HOLE CARDS ***
thedude696969: folds 
0nix770: folds 
Deniels7: calls $0.10
Tyoma_Kovach: folds 
Palen030: checks 
*** FLOP *** [4c 7h 7c]
Palen030: checks 
Deniels7: checks 
*** TURN *** [4c 7h 7c] [5c]
Palen030: checks 
Deniels7: checks 
*** RIVER *** [4c 7h 7c 5c] [3h]
Palen030: checks 
Deniels7: checks 
*** SHOW DOWN ***
Palen030: shows [9s 2c] (a pair of Sevens)
Deniels7: shows [Kd 5d] (two pair, Sevens and Fives)
Deniels7 collected $0.24 from pot
*** SUMMARY ***
Total pot $0.25 | Rake $0.01 
Board [4c 7h 7c 5c 3h]
Seat 1: Tyoma_Kovach (small blind) folded before Flop
Seat 2: Palen030 (big blind) showed [9s 2c] and lost with a pair of Sevens
Seat 3: thedude696969 folded before Flop (didn't bet)
Seat 4: 0nix770 folded before Flop (didn't bet)
Seat 6: Deniels7 (button) showed [Kd 5d] and won ($0.24) with two pair, Sevens and Fives



PokerStars Hand #222944231135:  Hold'em No Limit ($0.05/$0.10 USD) - 2021/01/23 23:37:13 ET
Table 'Algieba III' 6-max Seat #1 is the button
Seat 1: Tyoma_Kovach ($19.48 in chips) 
Seat 2: Palen030 ($3.90 in chips) 
Seat 3: thedude696969 ($18.82 in chips) 
Seat 4: 0nix770 ($14.55 in chips) 
Seat 6: Deniels7 ($10.75 in chips) 
Palen030: posts small blind $0.05
thedude696969: posts big blind $0.10
*** HOLE CARDS ***
0nix770: folds 
Deniels7: folds 
Tyoma_Kovach: raises $0.15 to $0.25
Palen030: calls $0.20
thedude696969: folds 
*** FLOP *** [5s 3d Jc]
Palen030: checks 
Tyoma_Kovach: bets $0.19
Palen030: folds 
Uncalled bet ($0.19) returned to Tyoma_Kovach
Tyoma_Kovach collected $0.57 from pot
Tyoma_Kovach: doesn't show hand 
*** SUMMARY ***
Total pot $0.60 | Rake $0.03 
Board [5s 3d Jc]
Seat 1: Tyoma_Kovach (button) collected ($0.57)
Seat 2: Palen030 (small blind) folded on the Flop
Seat 3: thedude696969 (big blind) folded before Flop
Seat 4: 0nix770 folded before Flop (didn't bet)
Seat 6: Deniels7 folded before Flop (didn't bet)



PokerStars Hand #222944236923:  Hold'em No Limit ($0.05/$0.10 USD) - 2021/01/23 23:37:32 ET
Table 'Algieba III' 6-max Seat #2 is the button
Seat 1: Tyoma_Kovach ($19.80 in chips) 
Seat 2: Palen030 ($3.65 in chips) 
Seat 3: thedude696969 ($18.72 in chips) 
Seat 4: 0nix770 ($14.55 in chips) 
Seat 5: patboy73 ($12.15 in chips) 
Seat 6: Deniels7 ($10.75 in chips) 
thedude696969: posts small blind $0.05
0nix770: posts big blind $0.10
patboy73: posts small & big blinds $0.15
*** HOLE CARDS ***
patboy73: checks 
Deniels7: folds 
Tyoma_Kovach: folds 
Palen030: folds 
thedude696969: folds 
0nix770: raises $0.40 to $0.50
patboy73: folds 
Uncalled bet ($0.40) returned to 0nix770
0nix770 collected $0.30 from pot
0nix770: doesn't show hand 
*** SUMMARY ***
Total pot $0.30 | Rake $0 
Seat 1: Tyoma_Kovach folded before Flop (didn't bet)
Seat 2: Palen030 (button) folded before Flop (didn't bet)
Seat 3: thedude696969 (small blind) folded before Flop
Seat 4: 0nix770 (big blind) collected ($0.30)
Seat 5: patboy73 folded before Flop (didn't bet)
Seat 6: Deniels7 folded before Flop (didn't bet)



PokerStars Hand #222944242910:  Hold'em No Limit ($0.05/$0.10 USD) - 2021/01/23 23:37:52 ET
Table 'Algieba III' 6-max Seat #3 is the button
Seat 1: Tyoma_Kovach ($19.80 in chips) 
Seat 2: Palen030 ($3.65 in chips) 
Seat 3: thedude696969 ($18.67 in chips) 
Seat 4: 0nix770 ($14.75 in chips) 
Seat 5: patboy73 ($12 in chips) 
Seat 6: Deniels7 ($10.75 in chips) 
0nix770: posts small blind $0.05
patboy73: posts big blind $0.10
*** HOLE CARDS ***
Deniels7: folds 
Tyoma_Kovach: folds 
Palen030: folds 
thedude696969: folds 
0nix770: folds 
Uncalled bet ($0.05) returned to patboy73
patboy73 collected $0.10 from pot
*** SUMMARY ***
Total pot $0.10 | Rake $0 
Seat 1: Tyoma_Kovach folded before Flop (didn't bet)
Seat 2: Palen030 folded before Flop (didn't bet)
Seat 3: thedude696969 (button) folded before Flop (didn't bet)
Seat 4: 0nix770 (small blind) folded before Flop
Seat 5: patboy73 (big blind) collected ($0.10)
Seat 6: Deniels7 folded before Flop (didn't bet)



PokerStars Hand #222944245127:  Hold'em No Limit ($0.05/$0.10 USD) - 2021/01/23 23:37:59 ET
Table 'Algieba III' 6-max Seat #4 is the button
Seat 1: Tyoma_Kovach ($19.80 in chips) 
Seat 2: Palen030 ($3.65 in chips) 
Seat 3: thedude696969 ($18.67 in chips) 
Seat 4: 0nix770 ($14.70 in chips) 
Seat 5: patboy73 ($12.05 in chips) 
Seat 6: Deniels7 ($10.75 in chips) 
patboy73: posts small blind $0.05
Deniels7: posts big blind $0.10
*** HOLE CARDS ***
Tyoma_Kovach: raises $0.20 to $0.30
Palen030: folds 
thedude696969: folds 
0nix770: folds 
patboy73: calls $0.25
Deniels7: calls $0.20
*** FLOP *** [Ad Jd Kc]
patboy73: checks 
Deniels7: checks 
Tyoma_Kovach: bets $0.28
patboy73: calls $0.28
Deniels7: folds 
*** TURN *** [Ad Jd Kc] [Td]
patboy73: checks 
Tyoma_Kovach: checks 
*** RIVER *** [Ad Jd Kc Td] [8h]
patboy73: checks 
Tyoma_Kovach: bets $0.46
patboy73: calls $0.46
*** SHOW DOWN ***
Tyoma_Kovach: shows [As 8s] (two pair, Aces and Eights)
patboy73: shows [Qh Jc] (a straight, Ten to Ace)
patboy73 collected $2.27 from pot
*** SUMMARY ***
Total pot $2.38 | Rake $0.11 
Board [Ad Jd Kc Td 8h]
Seat 1: Tyoma_Kovach showed [As 8s] and lost with two pair, Aces and Eights
Seat 2: Palen030 folded before Flop (didn't bet)
Seat 3: thedude696969 folded before Flop (didn't bet)
Seat 4: 0nix770 (button) folded before Flop (didn't bet)
Seat 5: patboy73 (small blind) showed [Qh Jc] and won ($2.27) with a straight, Ten to Ace
Seat 6: Deniels7 (big blind) folded on the Flop



PokerStars Hand #222944257279:  Hold'em No Limit ($0.05/$0.10 USD) - 2021/01/23 23:38:39 ET
Table 'Algieba III' 6-max Seat #5 is the button
Seat 1: Tyoma_Kovach ($18.76 in chips) 
Seat 2: Palen030 ($3.65 in chips) 
Seat 3: thedude696969 ($18.67 in chips) 
Seat 4: 0nix770 ($14.70 in chips) 
Seat 5: patboy73 ($13.28 in chips) 
Seat 6: Deniels7 ($10.45 in chips) 
Deniels7: posts small blind $0.05
Tyoma_Kovach: posts big blind $0.10
*** HOLE CARDS ***
Palen030: folds 
thedude696969: folds 
0nix770: folds 
patboy73: calls $0.10
Deniels7: calls $0.05
Tyoma_Kovach: checks 
*** FLOP *** [Qs 3h 2s]
Deniels7: checks 
Tyoma_Kovach: checks 
patboy73: checks 
*** TURN *** [Qs 3h 2s] [5c]
Deniels7: bets $0.10
Tyoma_Kovach: calls $0.10
patboy73: calls $0.10
*** RIVER *** [Qs 3h 2s 5c] [2d]
Deniels7: bets $0.20
Tyoma_Kovach: folds 
patboy73: calls $0.20
*** SHOW DOWN ***
Deniels7: shows [Ks 3d] (two pair, Threes and Deuces)
patboy73: shows [9h Qd] (two pair, Queens and Deuces)
patboy73 collected $0.96 from pot
*** SUMMARY ***
Total pot $1 | Rake $0.04 
Board [Qs 3h 2s 5c 2d]
Seat 1: Tyoma_Kovach (big blind) folded on the River
Seat 2: Palen030 folded before Flop (didn't bet)
Seat 3: thedude696969 folded before Flop (didn't bet)
Seat 4: 0nix770 folded before Flop (didn't bet)
Seat 5: patboy73 (button) showed [9h Qd] and won ($0.96) with two pair, Queens and Deuces
Seat 6: Deniels7 (small blind) showed [Ks 3d] and lost with two pair, Threes and Deuces



PokerStars Hand #222944273729:  Hold'em No Limit ($0.05/$0.10 USD) - 2021/01/23 23:39:34 ET
Table 'Algieba III' 6-max Seat #6 is the button
Seat 1: Tyoma_Kovach ($18.56 in chips) 
Seat 2: Palen030 ($3.65 in chips) 
Seat 3: thedude696969 ($18.67 in chips) 
Seat 4: 0nix770 ($14.70 in chips) 
Seat 5: patboy73 ($13.84 in chips) 
Seat 6: Deniels7 ($10.05 in chips) 
Tyoma_Kovach: posts small blind $0.05
Palen030: posts big blind $0.10
*** HOLE CARDS ***
thedude696969: folds 
0nix770: folds 
patboy73: calls $0.10
Deniels7: calls $0.10
Tyoma_Kovach: folds 
Palen030: checks 
*** FLOP *** [Ad Qd 2h]
Palen030: checks 
patboy73: checks 
Deniels7: checks 
*** TURN *** [Ad Qd 2h] [8d]
Palen030: bets $0.17
patboy73: calls $0.17
Deniels7: folds 
*** RIVER *** [Ad Qd 2h 8d] [5s]
Palen030: bets $0.66
patboy73: folds 
Uncalled bet ($0.66) returned to Palen030
Palen030 collected $0.66 from pot
Palen030: doesn't show hand 
*** SUMMARY ***
Total pot $0.69 | Rake $0.03 
Board [Ad Qd 2h 8d 5s]
Seat 1: Tyoma_Kovach (small blind) folded before Flop
Seat 2: Palen030 (big blind) collected ($0.66)
Seat 3: thedude696969 folded before Flop (didn't bet)
Seat 4: 0nix770 folded before Flop (didn't bet)
Seat 5: patboy73 folded on the River
Seat 6: Deniels7 (button) folded on the Turn



PokerStars Hand #222944283884:  Hold'em No Limit ($0.05/$0.10 USD) - 2021/01/23 23:40:07 ET
Table 'Algieba III' 6-max Seat #1 is the button
Seat 1: Tyoma_Kovach ($18.51 in chips) 
Seat 2: Palen030 ($4.04 in chips) 
Seat 3: thedude696969 ($18.67 in chips) 
Seat 4: 0nix770 ($14.70 in chips) 
Seat 5: patboy73 ($13.57 in chips) 
Seat 6: Deniels7 ($9.95 in chips) 
Palen030: posts small blind $0.05
thedude696969: posts big blind $0.10
*** HOLE CARDS ***
0nix770: raises $0.20 to $0.30
patboy73: calls $0.30
Deniels7: folds 
Tyoma_Kovach: folds 
Palen030: calls $0.25
thedude696969: calls $0.20
*** FLOP *** [Jh Kc 6d]
Palen030: checks 
thedude696969: checks 
0nix770: bets $0.63
patboy73: folds 
Palen030: folds 
thedude696969: folds 
Uncalled bet ($0.63) returned to 0nix770
0nix770 collected $1.15 from pot
0nix770: doesn't show hand 
*** SUMMARY ***
Total pot $1.20 | Rake $0.05 
Board [Jh Kc 6d]
Seat 1: Tyoma_Kovach (button) folded before Flop (didn't bet)
Seat 2: Palen030 (small blind) folded on the Flop
Seat 3: thedude696969 (big blind) folded on the Flop
Seat 4: 0nix770 collected ($1.15)
Seat 5: patboy73 folded on the Flop
Seat 6: Deniels7 folded before Flop (didn't bet)



PokerStars Hand #222944292036:  Hold'em No Limit ($0.05/$0.10 USD) - 2021/01/23 23:40:34 ET
Table 'Algieba III' 6-max Seat #2 is the button
Seat 1: Tyoma_Kovach ($18.51 in chips) 
Seat 2: Palen030 ($3.74 in chips) 
Seat 3: thedude696969 ($18.37 in chips) 
Seat 4: 0nix770 ($15.55 in chips) 
Seat 5: patboy73 ($13.27 in chips) 
Seat 6: Deniels7 ($9.95 in chips) 
thedude696969: posts small blind $0.05
0nix770: posts big blind $0.10
*** HOLE CARDS ***
patboy73: folds 
Deniels7: folds 
Tyoma_Kovach: folds 
Palen030: folds 
patboy73 leaves the table
thedude696969: raises $0.20 to $0.30
0nix770: folds 
Uncalled bet ($0.20) returned to thedude696969
thedude696969 collected $0.20 from pot
thedude696969: doesn't show hand 
*** SUMMARY ***
Total pot $0.20 | Rake $0 
Seat 1: Tyoma_Kovach folded before Flop (didn't bet)
Seat 2: Palen030 (button) folded before Flop (didn't bet)
Seat 3: thedude696969 (small blind) collected ($0.20)
Seat 4: 0nix770 (big blind) folded before Flop
Seat 5: patboy73 folded before Flop (didn't bet)
Seat 6: Deniels7 folded before Flop (didn't bet)



PokerStars Hand #222944302237:  Hold'em No Limit ($0.05/$0.10 USD) - 2021/01/23 23:40:46 ET
Table 'Algieba III' 6-max Seat #3 is the button
Seat 1: Tyoma_Kovach ($18.51 in chips) 
Seat 2: Palen030 ($3.74 in chips) 
Seat 3: thedude696969 ($18.47 in chips) 
Seat 4: 0nix770 ($15.45 in chips) 
Seat 6: Deniels7 ($9.95 in chips) 
0nix770: posts small blind $0.05
Deniels7: posts big blind $0.10
*** HOLE CARDS ***
Tyoma_Kovach: folds 
Palen030: folds 
thedude696969: folds 
0nix770: raises $0.20 to $0.30
Deniels7: calls $0.20
*** FLOP *** [8s 6c Ad]
0nix770: bets $0.22
Deniels7: folds 
Uncalled bet ($0.22) returned to 0nix770
0nix770 collected $0.57 from pot
0nix770: doesn't show hand 
*** SUMMARY ***
Total pot $0.60 | Rake $0.03 
Board [8s 6c Ad]
Seat 1: Tyoma_Kovach folded before Flop (didn't bet)
Seat 2: Palen030 folded before Flop (didn't bet)
Seat 3: thedude696969 (button) folded before Flop (didn't bet)
Seat 4: 0nix770 (small blind) collected ($0.57)
Seat 6: Deniels7 (big blind) folded on the Flop



PokerStars Hand #222944307451:  Hold'em No Limit ($0.05/$0.10 USD) - 2021/01/23 23:41:04 ET
Table 'Algieba III' 6-max Seat #4 is the button
Seat 1: Tyoma_Kovach ($18.51 in chips) 
Seat 2: Palen030 ($3.74 in chips) 
Seat 3: thedude696969 ($18.47 in chips) 
Seat 4: 0nix770 ($15.72 in chips) 
Seat 6: Deniels7 ($9.65 in chips) 
Deniels7: posts small blind $0.05
Tyoma_Kovach: posts big blind $0.10
*** HOLE CARDS ***
Palen030: folds 
thedude696969: raises $0.20 to $0.30
0nix770: folds 
Deniels7: calls $0.25
Tyoma_Kovach: folds 
*** FLOP *** [2h Jc Td]
Deniels7: checks 
thedude696969: bets $0.40
Deniels7: folds 
Uncalled bet ($0.40) returned to thedude696969
thedude696969 collected $0.67 from pot
thedude696969: doesn't show hand 
*** SUMMARY ***
Total pot $0.70 | Rake $0.03 
Board [2h Jc Td]
Seat 1: Tyoma_Kovach (big blind) folded before Flop
Seat 2: Palen030 folded before Flop (didn't bet)
Seat 3: thedude696969 collected ($0.67)
Seat 4: 0nix770 (button) folded before Flop (didn't bet)
Seat 6: Deniels7 (small blind) folded on the Flop



PokerStars Hand #222944314137:  Hold'em No Limit ($0.05/$0.10 USD) - 2021/01/23 23:41:26 ET
Table 'Algieba III' 6-max Seat #6 is the button
Seat 1: Tyoma_Kovach ($18.41 in chips) 
Seat 2: Palen030 ($3.74 in chips) 
Seat 3: thedude696969 ($18.84 in chips) 
Seat 4: 0nix770 ($15.72 in chips) 
Seat 6: Deniels7 ($9.35 in chips) 
Tyoma_Kovach: posts small blind $0.05
Palen030: posts big blind $0.10
*** HOLE CARDS ***
johnnytrue joins the table at seat #5 
thedude696969: folds 
0nix770: raises $0.15 to $0.25
Deniels7: folds 
Tyoma_Kovach: folds 
Palen030: folds 
Uncalled bet ($0.15) returned to 0nix770
0nix770 collected $0.25 from pot
0nix770: doesn't show hand 
*** SUMMARY ***
Total pot $0.25 | Rake $0 
Seat 1: Tyoma_Kovach (small blind) folded before Flop
Seat 2: Palen030 (big blind) folded before Flop
Seat 3: thedude696969 folded before Flop (didn't bet)
Seat 4: 0nix770 collected ($0.25)
Seat 6: Deniels7 (button) folded before Flop (didn't bet)



PokerStars Hand #222944316444:  Hold'em No Limit ($0.05/$0.10 USD) - 2021/01/23 23:41:34 ET
Table 'Algieba III' 6-max Seat #1 is the button
Seat 1: Tyoma_Kovach ($18.36 in chips) 
Seat 2: Palen030 ($3.64 in chips) 
Seat 3: thedude696969 ($18.84 in chips) 
Seat 4: 0nix770 ($15.87 in chips) 
Seat 6: Deniels7 ($9.35 in chips) 
Palen030: posts small blind $0.05
thedude696969: posts big blind $0.10
johnnytrue: sits out 
*** HOLE CARDS ***
0nix770: folds 
Deniels7: folds 
Tyoma_Kovach: raises $0.15 to $0.25
Palen030: folds 
thedude696969: folds 
Uncalled bet ($0.15) returned to Tyoma_Kovach
Tyoma_Kovach collected $0.25 from pot
Tyoma_Kovach: doesn't show hand 
*** SUMMARY ***
Total pot $0.25 | Rake $0 
Seat 1: Tyoma_Kovach (button) collected ($0.25)
Seat 2: Palen030 (small blind) folded before Flop
Seat 3: thedude696969 (big blind) folded before Flop
Seat 4: 0nix770 folded before Flop (didn't bet)
Seat 6: Deniels7 folded before Flop (didn't bet)



PokerStars Hand #222944319727:  Hold'em No Limit ($0.05/$0.10 USD) - 2021/01/23 23:41:45 ET
Table 'Algieba III' 6-max Seat #2 is the button
Seat 1: Tyoma_Kovach ($18.51 in chips) 
Seat 2: Palen030 ($3.59 in chips) 
Seat 3: thedude696969 ($18.74 in chips) 
Seat 4: 0nix770 ($15.87 in chips) 
Seat 6: Deniels7 ($9.35 in chips) 
thedude696969: posts small blind $0.05
0nix770: posts big blind $0.10
johnnytrue: sits out 
*** HOLE CARDS ***
Deniels7: folds 
Tyoma_Kovach: folds 
Palen030: folds 
thedude696969: folds 
Uncalled bet ($0.05) returned to 0nix770
0nix770 collected $0.10 from pot
0nix770: doesn't show hand 
*** SUMMARY ***
Total pot $0.10 | Rake $0 
Seat 1: Tyoma_Kovach folded before Flop (didn't bet)
Seat 2: Palen030 (button) folded before Flop (didn't bet)
Seat 3: thedude696969 (small blind) folded before Flop
Seat 4: 0nix770 (big blind) collected ($0.10)
Seat 6: Deniels7 folded before Flop (didn't bet)



PokerStars Hand #222944322118:  Hold'em No Limit ($0.05/$0.10 USD) - 2021/01/23 23:41:53 ET
Table 'Algieba III' 6-max Seat #3 is the button
Seat 1: Tyoma_Kovach ($18.51 in chips) 
Seat 2: Palen030 ($3.59 in chips) 
Seat 3: thedude696969 ($18.69 in chips) 
Seat 4: 0nix770 ($15.92 in chips) 
Seat 5: johnnytrue ($10 in chips) 
Seat 6: Deniels7 ($9.35 in chips) 
0nix770: posts small blind $0.05
johnnytrue: posts big blind $0.10
*** HOLE CARDS ***
Deniels7: calls $0.10
Tyoma_Kovach: folds 
Palen030: folds 
thedude696969: raises $0.14 to $0.24
0nix770: folds 
johnnytrue: calls $0.14
Deniels7: calls $0.14
*** FLOP *** [9s 4h 7h]
johnnytrue: checks 
Deniels7: bets $0.30
thedude696969: raises $0.90 to $1.20
johnnytrue: folds 
Deniels7: folds 
Uncalled bet ($0.90) returned to thedude696969
thedude696969 collected $1.31 from pot
thedude696969: doesn't show hand 
*** SUMMARY ***
Total pot $1.37 | Rake $0.06 
Board [9s 4h 7h]
Seat 1: Tyoma_Kovach folded before Flop (didn't bet)
Seat 2: Palen030 folded before Flop (didn't bet)
Seat 3: thedude696969 (button) collected ($1.31)
Seat 4: 0nix770 (small blind) folded before Flop
Seat 5: johnnytrue (big blind) folded on the Flop
Seat 6: Deniels7 folded on the Flop



PokerStars Hand #222944338726:  Hold'em No Limit ($0.05/$0.10 USD) - 2021/01/23 23:42:48 ET
Table 'Algieba III' 6-max Seat #4 is the button
Seat 1: Tyoma_Kovach ($18.51 in chips) 
Seat 2: Palen030 ($3.59 in chips) 
Seat 3: thedude696969 ($19.46 in chips) 
Seat 4: 0nix770 ($15.87 in chips) 
Seat 5: johnnytrue ($9.76 in chips) 
Seat 6: Deniels7 ($8.81 in chips) 
johnnytrue: posts small blind $0.05
Deniels7: posts big blind $0.10
*** HOLE CARDS ***
Tyoma_Kovach: folds 
Palen030: folds 
thedude696969: folds 
0nix770: folds 
johnnytrue: folds 
Uncalled bet ($0.05) returned to Deniels7
Deniels7 collected $0.10 from pot
Deniels7: doesn't show hand 
*** SUMMARY ***
Total pot $0.10 | Rake $0 
Seat 1: Tyoma_Kovach folded before Flop (didn't bet)
Seat 2: Palen030 folded before Flop (didn't bet)
Seat 3: thedude696969 folded before Flop (didn't bet)
Seat 4: 0nix770 (button) folded before Flop (didn't bet)
Seat 5: johnnytrue (small blind) folded before Flop
Seat 6: Deniels7 (big blind) collected ($0.10)



PokerStars Hand #222944342254:  Hold'em No Limit ($0.05/$0.10 USD) - 2021/01/23 23:42:59 ET
Table 'Algieba III' 6-max Seat #5 is the button
Seat 1: Tyoma_Kovach ($18.51 in chips) 
Seat 2: Palen030 ($3.59 in chips) 
Seat 3: thedude696969 ($19.46 in chips) 
Seat 4: 0nix770 ($15.87 in chips) 
Seat 5: johnnytrue ($9.71 in chips) 
Seat 6: Deniels7 ($8.86 in chips) 
Deniels7: posts small blind $0.05
Tyoma_Kovach: posts big blind $0.10
*** HOLE CARDS ***
Palen030: folds 
thedude696969: folds 
0nix770: folds 
johnnytrue: folds 
Deniels7: calls $0.05
Tyoma_Kovach: raises $0.25 to $0.35
Deniels7: calls $0.25
*** FLOP *** [6d 7c 9c]
Deniels7: bets $0.30
Tyoma_Kovach: calls $0.30
*** TURN *** [6d 7c 9c] [Qh]
Deniels7: bets $0.20
Tyoma_Kovach: calls $0.20
*** RIVER *** [6d 7c 9c Qh] [9h]
Deniels7: checks 
Tyoma_Kovach: checks 
*** SHOW DOWN ***
Deniels7: shows [8c Jc] (a pair of Nines)
Tyoma_Kovach: shows [7h Ad] (two pair, Nines and Sevens)
Tyoma_Kovach collected $1.62 from pot
*** SUMMARY ***
Total pot $1.70 | Rake $0.08 
Board [6d 7c 9c Qh 9h]
Seat 1: Tyoma_Kovach (big blind) showed [7h Ad] and won ($1.62) with two pair, Nines and Sevens
Seat 2: Palen030 folded before Flop (didn't bet)
Seat 3: thedude696969 folded before Flop (didn't bet)
Seat 4: 0nix770 folded before Flop (didn't bet)
Seat 5: johnnytrue (button) folded before Flop (didn't bet)
Seat 6: Deniels7 (small blind) showed [8c Jc] and lost with a pair of Nines



PokerStars Hand #222944356546:  Hold'em No Limit ($0.05/$0.10 USD) - 2021/01/23 23:43:47 ET
Table 'Algieba III' 6-max Seat #6 is the button
Seat 1: Tyoma_Kovach ($19.28 in chips) 
Seat 2: Palen030 ($3.59 in chips) 
Seat 3: thedude696969 ($19.46 in chips) 
Seat 4: 0nix770 ($15.87 in chips) 
Seat 5: johnnytrue ($9.71 in chips) 
Seat 6: Deniels7 ($8.01 in chips) 
Tyoma_Kovach: posts small blind $0.05
Palen030: posts big blind $0.10
*** HOLE CARDS ***
thedude696969: folds 
0nix770: folds 
johnnytrue: calls $0.10
Deniels7: folds 
Tyoma_Kovach: calls $0.05
Palen030: checks 
*** FLOP *** [3d 5d 6c]
Tyoma_Kovach: checks 
Palen030: checks 
johnnytrue: checks 
*** TURN *** [3d 5d 6c] [7c]
Tyoma_Kovach: checks 
Palen030: checks 
johnnytrue: checks 
*** RIVER *** [3d 5d 6c 7c] [3c]
Tyoma_Kovach: checks 
Palen030: checks 
johnnytrue: checks 
*** SHOW DOWN ***
Tyoma_Kovach: shows [Ah 2h] (a pair of Threes)
Palen030: mucks hand 
johnnytrue: mucks hand 
Tyoma_Kovach collected $0.29 from pot
*** SUMMARY ***
Total pot $0.30 | Rake $0.01 
Board [3d 5d 6c 7c 3c]
Seat 1: Tyoma_Kovach (small blind) showed [Ah 2h] and won ($0.29) with a pair of Threes
Seat 2: Palen030 (big blind) mucked
Seat 3: thedude696969 folded before Flop (didn't bet)
Seat 4: 0nix770 folded before Flop (didn't bet)
Seat 5: johnnytrue mucked
Seat 6: Deniels7 (button) folded before Flop (didn't bet)



PokerStars Hand #222944371856:  Hold'em No Limit ($0.05/$0.10 USD) - 2021/01/23 23:44:39 ET
Table 'Algieba III' 6-max Seat #1 is the button
Seat 1: Tyoma_Kovach ($19.47 in chips) 
Seat 2: Palen030 ($3.49 in chips) 
Seat 3: thedude696969 ($19.46 in chips) 
Seat 4: 0nix770 ($15.87 in chips) 
Seat 5: johnnytrue ($9.61 in chips) 
Seat 6: Deniels7 ($8.01 in chips) 
Palen030: posts small blind $0.05
thedude696969: posts big blind $0.10
*** HOLE CARDS ***
0nix770: folds 
johnnytrue: folds 
Deniels7: folds 
Tyoma_Kovach: folds 
Palen030: calls $0.05
thedude696969: checks 
*** FLOP *** [8h 3d Ad]
Palen030: bets $0.10
thedude696969: raises $0.30 to $0.40
Palen030: raises $2.99 to $3.39 and is all-in
thedude696969: folds 
Uncalled bet ($2.99) returned to Palen030
Palen030 collected $0.96 from pot
Palen030: doesn't show hand 
*** SUMMARY ***
Total pot $1 | Rake $0.04 
Board [8h 3d Ad]
Seat 1: Tyoma_Kovach (button) folded before Flop (didn't bet)
Seat 2: Palen030 (small blind) collected ($0.96)
Seat 3: thedude696969 (big blind) folded on the Flop
Seat 4: 0nix770 folded before Flop (didn't bet)
Seat 5: johnnytrue folded before Flop (didn't bet)
Seat 6: Deniels7 folded before Flop (didn't bet)



PokerStars Hand #222944379735:  Hold'em No Limit ($0.05/$0.10 USD) - 2021/01/23 23:45:05 ET
Table 'Algieba III' 6-max Seat #2 is the button
Seat 1: Tyoma_Kovach ($19.47 in chips) 
Seat 2: Palen030 ($3.95 in chips) 
Seat 3: thedude696969 ($18.96 in chips) 
Seat 4: 0nix770 ($15.87 in chips) 
Seat 5: johnnytrue ($9.61 in chips) 
Seat 6: Deniels7 ($8.01 in chips) 
thedude696969: posts small blind $0.05
0nix770: posts big blind $0.10
*** HOLE CARDS ***
johnnytrue: folds 
Deniels7: folds 
Tyoma_Kovach: folds 
Palen030: folds 
thedude696969: raises $0.20 to $0.30
0nix770: folds 
Uncalled bet ($0.20) returned to thedude696969
thedude696969 collected $0.20 from pot
thedude696969: doesn't show hand 
*** SUMMARY ***
Total pot $0.20 | Rake $0 
Seat 1: Tyoma_Kovach folded before Flop (didn't bet)
Seat 2: Palen030 (button) folded before Flop (didn't bet)
Seat 3: thedude696969 (small blind) collected ($0.20)
Seat 4: 0nix770 (big blind) folded before Flop
Seat 5: johnnytrue folded before Flop (didn't bet)
Seat 6: Deniels7 folded before Flop (didn't bet)



PokerStars Hand #222944382993:  Hold'em No Limit ($0.05/$0.10 USD) - 2021/01/23 23:45:16 ET
Table 'Algieba III' 6-max Seat #3 is the button
Seat 1: Tyoma_Kovach ($19.47 in chips) 
Seat 2: Palen030 ($3.95 in chips) 
Seat 3: thedude696969 ($19.06 in chips) 
Seat 4: 0nix770 ($15.77 in chips) 
Seat 5: johnnytrue ($9.61 in chips) 
Seat 6: Deniels7 ($8.01 in chips) 
0nix770: posts small blind $0.05
johnnytrue: posts big blind $0.10
*** HOLE CARDS ***
Deniels7: folds 
Tyoma_Kovach: folds 
Palen030: folds 
thedude696969: raises $0.20 to $0.30
0nix770: folds 
johnnytrue: calls $0.20
*** FLOP *** [3s 5d 8h]
johnnytrue: checks 
thedude696969: bets $0.42
johnnytrue: calls $0.42
*** TURN *** [3s 5d 8h] [6s]
johnnytrue: checks 
thedude696969: bets $1
johnnytrue: calls $1
*** RIVER *** [3s 5d 8h 6s] [4d]
johnnytrue: checks 
thedude696969: bets $2.40
johnnytrue: folds 
Uncalled bet ($2.40) returned to thedude696969
thedude696969 collected $3.33 from pot
thedude696969: doesn't show hand 
*** SUMMARY ***
Total pot $3.49 | Rake $0.16 
Board [3s 5d 8h 6s 4d]
Seat 1: Tyoma_Kovach folded before Flop (didn't bet)
Seat 2: Palen030 folded before Flop (didn't bet)
Seat 3: thedude696969 (button) collected ($3.33)
Seat 4: 0nix770 (small blind) folded before Flop
Seat 5: johnnytrue (big blind) folded on the River
Seat 6: Deniels7 folded before Flop (didn't bet)



PokerStars Hand #222944404989:  Hold'em No Limit ($0.05/$0.10 USD) - 2021/01/23 23:46:30 ET
Table 'Algieba III' 6-max Seat #4 is the button
Seat 1: Tyoma_Kovach ($19.47 in chips) 
Seat 2: Palen030 ($3.95 in chips) 
Seat 3: thedude696969 ($20.67 in chips) 
Seat 4: 0nix770 ($15.72 in chips) 
Seat 5: johnnytrue ($10 in chips) 
Seat 6: Deniels7 ($8.01 in chips) 
johnnytrue: posts small blind $0.05
Deniels7: posts big blind $0.10
*** HOLE CARDS ***
Tyoma_Kovach: raises $0.20 to $0.30
Palen030: folds 
thedude696969: calls $0.30
0nix770: folds 
johnnytrue: raises $0.20 to $0.50
Deniels7: calls $0.40
Tyoma_Kovach: calls $0.20
thedude696969: calls $0.20
*** FLOP *** [Kd Qd 9c]
johnnytrue: checks 
Deniels7: checks 
Tyoma_Kovach: checks 
thedude696969: bets $1.10
johnnytrue: folds 
Deniels7: folds 
Tyoma_Kovach: folds 
Uncalled bet ($1.10) returned to thedude696969
thedude696969 collected $1.91 from pot
thedude696969: doesn't show hand 
*** SUMMARY ***
Total pot $2 | Rake $0.09 
Board [Kd Qd 9c]
Seat 1: Tyoma_Kovach folded on the Flop
Seat 2: Palen030 folded before Flop (didn't bet)
Seat 3: thedude696969 collected ($1.91)
Seat 4: 0nix770 (button) folded before Flop (didn't bet)
Seat 5: johnnytrue (small blind) folded on the Flop
Seat 6: Deniels7 (big blind) folded on the Flop



PokerStars Hand #222944418476:  Hold'em No Limit ($0.05/$0.10 USD) - 2021/01/23 23:47:16 ET
Table 'Algieba III' 6-max Seat #5 is the button
Seat 1: Tyoma_Kovach ($18.97 in chips) 
Seat 2: Palen030 ($3.95 in chips) 
Seat 3: thedude696969 ($22.08 in chips) 
Seat 4: 0nix770 ($15.72 in chips) 
Seat 5: johnnytrue ($9.50 in chips) 
Seat 6: Deniels7 ($10 in chips) 
Deniels7: posts small blind $0.05
Tyoma_Kovach: posts big blind $0.10
*** HOLE CARDS ***
Palen030: folds 
thedude696969: folds 
0nix770: raises $0.15 to $0.25
johnnytrue: calls $0.25
Deniels7: calls $0.20
Tyoma_Kovach: folds 
*** FLOP *** [9c 5d 7c]
Deniels7: checks 
0nix770: checks 
johnnytrue: checks 
*** TURN *** [9c 5d 7c] [9s]
Deniels7: checks 
0nix770: checks 
johnnytrue: checks 
*** RIVER *** [9c 5d 7c 9s] [4s]
Deniels7: checks 
0nix770: checks 
johnnytrue: checks 
*** SHOW DOWN ***
Deniels7: shows [Ks Td] (a pair of Nines)
0nix770: mucks hand 
johnnytrue: shows [Js 5s] (two pair, Nines and Fives)
johnnytrue collected $0.81 from pot
*** SUMMARY ***
Total pot $0.85 | Rake $0.04 
Board [9c 5d 7c 9s 4s]
Seat 1: Tyoma_Kovach (big blind) folded before Flop
Seat 2: Palen030 folded before Flop (didn't bet)
Seat 3: thedude696969 folded before Flop (didn't bet)
Seat 4: 0nix770 mucked
Seat 5: johnnytrue (button) showed [Js 5s] and won ($0.81) with two pair, Nines and Fives
Seat 6: Deniels7 (small blind) showed [Ks Td] and lost with a pair of Nines



PokerStars Hand #222944435221:  Hold'em No Limit ($0.05/$0.10 USD) - 2021/01/23 23:48:12 ET
Table 'Algieba III' 6-max Seat #6 is the button
Seat 1: Tyoma_Kovach ($18.87 in chips) 
Seat 2: Palen030 ($3.95 in chips) 
Seat 3: thedude696969 ($22.08 in chips) 
Seat 4: 0nix770 ($15.47 in chips) 
Seat 5: johnnytrue ($10.06 in chips) 
Seat 6: Deniels7 ($10 in chips) 
Tyoma_Kovach: posts small blind $0.05
Palen030: posts big blind $0.10
*** HOLE CARDS ***
thedude696969: folds 
0nix770: folds 
johnnytrue: folds 
Deniels7: calls $0.10
Tyoma_Kovach: folds 
Palen030: checks 
*** FLOP *** [Kc Qh Ac]
Palen030: checks 
Deniels7: checks 
*** TURN *** [Kc Qh Ac] [7s]
Palen030: checks 
Deniels7: checks 
*** RIVER *** [Kc Qh Ac 7s] [4h]
Palen030: checks 
Deniels7: checks 
*** SHOW DOWN ***
Palen030: shows [9d 3s] (high card Ace)
Deniels7: shows [7h 6h] (a pair of Sevens)
Deniels7 collected $0.24 from pot
*** SUMMARY ***
Total pot $0.25 | Rake $0.01 
Board [Kc Qh Ac 7s 4h]
Seat 1: Tyoma_Kovach (small blind) folded before Flop
Seat 2: Palen030 (big blind) showed [9d 3s] and lost with high card Ace
Seat 3: thedude696969 folded before Flop (didn't bet)
Seat 4: 0nix770 folded before Flop (didn't bet)
Seat 5: johnnytrue folded before Flop (didn't bet)
Seat 6: Deniels7 (button) showed [7h 6h] and won ($0.24) with a pair of Sevens



PokerStars Hand #222944443237:  Hold'em No Limit ($0.05/$0.10 USD) - 2021/01/23 23:48:39 ET
Table 'Algieba III' 6-max Seat #1 is the button
Seat 1: Tyoma_Kovach ($18.82 in chips) 
Seat 2: Palen030 ($3.85 in chips) 
Seat 3: thedude696969 ($22.08 in chips) 
Seat 4: 0nix770 ($15.47 in chips) 
Seat 5: johnnytrue ($10.06 in chips) 
Seat 6: Deniels7 ($10.14 in chips) 
Palen030: posts small blind $0.05
thedude696969: posts big blind $0.10
*** HOLE CARDS ***
0nix770: folds 
johnnytrue: folds 
Deniels7: raises $0.10 to $0.20
Tyoma_Kovach: folds 
Palen030: folds 
thedude696969: folds 
Uncalled bet ($0.10) returned to Deniels7
Deniels7 collected $0.25 from pot
Deniels7: doesn't show hand 
*** SUMMARY ***
Total pot $0.25 | Rake $0 
Seat 1: Tyoma_Kovach (button) folded before Flop (didn't bet)
Seat 2: Palen030 (small blind) folded before Flop
Seat 3: thedude696969 (big blind) folded before Flop
Seat 4: 0nix770 folded before Flop (didn't bet)
Seat 5: johnnytrue folded before Flop (didn't bet)
Seat 6: Deniels7 collected ($0.25)



PokerStars Hand #222944447113:  Hold'em No Limit ($0.05/$0.10 USD) - 2021/01/23 23:48:52 ET
Table 'Algieba III' 6-max Seat #2 is the button
Seat 1: Tyoma_Kovach ($18.82 in chips) 
Seat 2: Palen030 ($3.80 in chips) 
Seat 3: thedude696969 ($21.98 in chips) 
Seat 4: 0nix770 ($15.47 in chips) 
Seat 5: johnnytrue ($10.06 in chips) 
Seat 6: Deniels7 ($10.29 in chips) 
thedude696969: posts small blind $0.05
0nix770: posts big blind $0.10
*** HOLE CARDS ***
johnnytrue: calls $0.10
Deniels7: raises $0.10 to $0.20
Tyoma_Kovach: folds 
Palen030: folds 
thedude696969: calls $0.15
0nix770: calls $0.10
johnnytrue: calls $0.10
*** FLOP *** [5h 7c 9c]
thedude696969: bets $0.23
0nix770: folds 
johnnytrue: calls $0.23
Deniels7: calls $0.23
*** TURN *** [5h 7c 9c] [Kc]
thedude696969: checks 
johnnytrue: checks 
Deniels7: checks 
*** RIVER *** [5h 7c 9c Kc] [4h]
thedude696969: bets $0.74
johnnytrue: folds 
Deniels7: folds 
Uncalled bet ($0.74) returned to thedude696969
thedude696969 collected $1.42 from pot
thedude696969: doesn't show hand 
*** SUMMARY ***
Total pot $1.49 | Rake $0.07 
Board [5h 7c 9c Kc 4h]
Seat 1: Tyoma_Kovach folded before Flop (didn't bet)
Seat 2: Palen030 (button) folded before Flop (didn't bet)
Seat 3: thedude696969 (small blind) collected ($1.42)
Seat 4: 0nix770 (big blind) folded on the Flop
Seat 5: johnnytrue folded on the River
Seat 6: Deniels7 folded on the River



PokerStars Hand #222944463904:  Hold'em No Limit ($0.05/$0.10 USD) - 2021/01/23 23:49:49 ET
Table 'Algieba III' 6-max Seat #3 is the button
Seat 1: Tyoma_Kovach ($18.82 in chips) 
Seat 2: Palen030 ($3.80 in chips) 
Seat 3: thedude696969 ($22.97 in chips) 
Seat 4: 0nix770 ($15.27 in chips) 
Seat 5: johnnytrue ($9.63 in chips) 
Seat 6: Deniels7 ($9.86 in chips) 
0nix770: posts small blind $0.05
johnnytrue: posts big blind $0.10
*** HOLE CARDS ***
Deniels7: folds 
Tyoma_Kovach: folds 
Palen030: folds 
thedude696969: folds 
0nix770: folds 
Uncalled bet ($0.05) returned to johnnytrue
johnnytrue collected $0.10 from pot
*** SUMMARY ***
Total pot $0.10 | Rake $0 
Seat 1: Tyoma_Kovach folded before Flop (didn't bet)
Seat 2: Palen030 folded before Flop (didn't bet)
Seat 3: thedude696969 (button) folded before Flop (didn't bet)
Seat 4: 0nix770 (small blind) folded before Flop
Seat 5: johnnytrue (big blind) collected ($0.10)
Seat 6: Deniels7 folded before Flop (didn't bet)



PokerStars Hand #222944466954:  Hold'em No Limit ($0.05/$0.10 USD) - 2021/01/23 23:50:00 ET
Table 'Algieba III' 6-max Seat #4 is the button
Seat 1: Tyoma_Kovach ($18.82 in chips) 
Seat 2: Palen030 ($3.80 in chips) 
Seat 3: thedude696969 ($22.97 in chips) 
Seat 4: 0nix770 ($15.22 in chips) 
Seat 5: johnnytrue ($9.68 in chips) 
Seat 6: Deniels7 ($9.86 in chips) 
johnnytrue: posts small blind $0.05
Deniels7: posts big blind $0.10
*** HOLE CARDS ***
Tyoma_Kovach: folds 
Palen030: folds 
thedude696969: folds 
0nix770: folds 
johnnytrue: folds 
Uncalled bet ($0.05) returned to Deniels7
Deniels7 collected $0.10 from pot
Deniels7: doesn't show hand 
*** SUMMARY ***
Total pot $0.10 | Rake $0 
Seat 1: Tyoma_Kovach folded before Flop (didn't bet)
Seat 2: Palen030 folded before Flop (didn't bet)
Seat 3: thedude696969 folded before Flop (didn't bet)
Seat 4: 0nix770 (button) folded before Flop (didn't bet)
Seat 5: johnnytrue (small blind) folded before Flop
Seat 6: Deniels7 (big blind) collected ($0.10)



PokerStars Hand #222944471050:  Hold'em No Limit ($0.05/$0.10 USD) - 2021/01/23 23:50:14 ET
Table 'Algieba III' 6-max Seat #5 is the button
Seat 1: Tyoma_Kovach ($18.82 in chips) 
Seat 2: Palen030 ($3.80 in chips) 
Seat 3: thedude696969 ($22.97 in chips) 
Seat 4: 0nix770 ($15.22 in chips) 
Seat 5: johnnytrue ($9.63 in chips) 
Seat 6: Deniels7 ($10 in chips) 
Deniels7: posts small blind $0.05
Tyoma_Kovach: posts big blind $0.10
*** HOLE CARDS ***
Palen030: folds 
thedude696969: folds 
0nix770: raises $0.15 to $0.25
johnnytrue: folds 
Deniels7: folds 
Tyoma_Kovach: folds 
Uncalled bet ($0.15) returned to 0nix770
0nix770 collected $0.25 from pot
0nix770: doesn't show hand 
*** SUMMARY ***
Total pot $0.25 | Rake $0 
Seat 1: Tyoma_Kovach (big blind) folded before Flop
Seat 2: Palen030 folded before Flop (didn't bet)
Seat 3: thedude696969 folded before Flop (didn't bet)
Seat 4: 0nix770 collected ($0.25)
Seat 5: johnnytrue (button) folded before Flop (didn't bet)
Seat 6: Deniels7 (small blind) folded before Flop



PokerStars Hand #222944476844:  Hold'em No Limit ($0.05/$0.10 USD) - 2021/01/23 23:50:34 ET
Table 'Algieba III' 6-max Seat #6 is the button
Seat 1: Tyoma_Kovach ($18.72 in chips) 
Seat 2: Palen030 ($3.80 in chips) 
Seat 3: thedude696969 ($22.97 in chips) 
Seat 4: 0nix770 ($15.37 in chips) 
Seat 5: johnnytrue ($9.63 in chips) 
Seat 6: Deniels7 ($9.95 in chips) 
Tyoma_Kovach: posts small blind $0.05
Palen030: posts big blind $0.10
*** HOLE CARDS ***
thedude696969: raises $0.14 to $0.24
0nix770: folds 
johnnytrue: folds 
Deniels7: calls $0.24
Tyoma_Kovach: folds 
Palen030: folds 
*** FLOP *** [Jc 5d 4c]
thedude696969: bets $0.32
Deniels7: folds 
Uncalled bet ($0.32) returned to thedude696969
thedude696969 collected $0.60 from pot
thedude696969: doesn't show hand 
*** SUMMARY ***
Total pot $0.63 | Rake $0.03 
Board [Jc 5d 4c]
Seat 1: Tyoma_Kovach (small blind) folded before Flop
Seat 2: Palen030 (big blind) folded before Flop
Seat 3: thedude696969 collected ($0.60)
Seat 4: 0nix770 folded before Flop (didn't bet)
Seat 5: johnnytrue folded before Flop (didn't bet)
Seat 6: Deniels7 (button) folded on the Flop



PokerStars Hand #222944484058:  Hold'em No Limit ($0.05/$0.10 USD) - 2021/01/23 23:50:58 ET
Table 'Algieba III' 6-max Seat #1 is the button
Seat 1: Tyoma_Kovach ($18.67 in chips) 
Seat 2: Palen030 ($3.70 in chips) 
Seat 3: thedude696969 ($23.33 in chips) 
Seat 4: 0nix770 ($15.37 in chips) 
Seat 5: johnnytrue ($9.63 in chips) 
Seat 6: Deniels7 ($9.71 in chips) 
Palen030: posts small blind $0.05
thedude696969: posts big blind $0.10
*** HOLE CARDS ***
0nix770: folds 
johnnytrue: folds 
Deniels7: raises $0.10 to $0.20
Tyoma_Kovach: raises $0.60 to $0.80
Palen030: folds 
thedude696969: folds 
Deniels7: calls $0.60
*** FLOP *** [Th 7h Ks]
Deniels7: checks 
Tyoma_Kovach: bets $1.25
Deniels7: calls $1.25
*** TURN *** [Th 7h Ks] [2d]
Deniels7: checks 
Tyoma_Kovach: bets $2.71
Deniels7: raises $4.95 to $7.66 and is all-in
Tyoma_Kovach: calls $4.95
*** RIVER *** [Th 7h Ks 2d] [3s]
*** SHOW DOWN ***
Deniels7: shows [7d 7s] (three of a kind, Sevens)
Tyoma_Kovach: shows [Ad Ac] (a pair of Aces)
Deniels7 collected $18.69 from pot
*** SUMMARY ***
Total pot $19.57 | Rake $0.88 
Board [Th 7h Ks 2d 3s]
Seat 1: Tyoma_Kovach (button) showed [Ad Ac] and lost with a pair of Aces
Seat 2: Palen030 (small blind) folded before Flop
Seat 3: thedude696969 (big blind) folded before Flop
Seat 4: 0nix770 folded before Flop (didn't bet)
Seat 5: johnnytrue folded before Flop (didn't bet)
Seat 6: Deniels7 showed [7d 7s] and won ($18.69) with three of a kind, Sevens



PokerStars Hand #222944499834:  Hold'em No Limit ($0.05/$0.10 USD) - 2021/01/23 23:51:53 ET
Table 'Algieba III' 6-max Seat #2 is the button
Seat 1: Tyoma_Kovach ($10 in chips) 
Seat 2: Palen030 ($3.65 in chips) 
Seat 3: thedude696969 ($23.23 in chips) 
Seat 4: 0nix770 ($15.37 in chips) 
Seat 5: johnnytrue ($9.63 in chips) 
Seat 6: Deniels7 ($18.69 in chips) 
thedude696969: posts small blind $0.05
0nix770: posts big blind $0.10
*** HOLE CARDS ***
johnnytrue: folds 
Deniels7: raises $0.10 to $0.20
Tyoma_Kovach: folds 
Palen030: calls $0.20
thedude696969: folds 
0nix770: calls $0.10
*** FLOP *** [7h 3d 6d]
0nix770: checks 
Deniels7: bets $0.40
Palen030: folds 
0nix770: calls $0.40
*** TURN *** [7h 3d 6d] [Jh]
0nix770: checks 
Deniels7: bets $0.40
0nix770: raises $1.20 to $1.60
Deniels7: folds 
Uncalled bet ($1.20) returned to 0nix770
0nix770 collected $2.15 from pot
0nix770: doesn't show hand 
*** SUMMARY ***
Total pot $2.25 | Rake $0.10 
Board [7h 3d 6d Jh]
Seat 1: Tyoma_Kovach folded before Flop (didn't bet)
Seat 2: Palen030 (button) folded on the Flop
Seat 3: thedude696969 (small blind) folded before Flop
Seat 4: 0nix770 (big blind) collected ($2.15)
Seat 5: johnnytrue folded before Flop (didn't bet)
Seat 6: Deniels7 folded on the Turn



PokerStars Hand #222944513996:  Hold'em No Limit ($0.05/$0.10 USD) - 2021/01/23 23:52:41 ET
Table 'Algieba III' 6-max Seat #3 is the button
Seat 1: Tyoma_Kovach ($10 in chips) 
Seat 2: Palen030 ($3.45 in chips) 
Seat 3: thedude696969 ($23.18 in chips) 
Seat 4: 0nix770 ($16.52 in chips) 
Seat 5: johnnytrue ($9.63 in chips) 
Seat 6: Deniels7 ($17.69 in chips) 
0nix770: posts small blind $0.05
johnnytrue: posts big blind $0.10
*** HOLE CARDS ***
Deniels7: folds 
Tyoma_Kovach: folds 
Palen030: folds 
thedude696969: folds 
0nix770: folds 
Uncalled bet ($0.05) returned to johnnytrue
johnnytrue collected $0.10 from pot
*** SUMMARY ***
Total pot $0.10 | Rake $0 
Seat 1: Tyoma_Kovach folded before Flop (didn't bet)
Seat 2: Palen030 folded before Flop (didn't bet)
Seat 3: thedude696969 (button) folded before Flop (didn't bet)
Seat 4: 0nix770 (small blind) folded before Flop
Seat 5: johnnytrue (big blind) collected ($0.10)
Seat 6: Deniels7 folded before Flop (didn't bet)



PokerStars Hand #222944516584:  Hold'em No Limit ($0.05/$0.10 USD) - 2021/01/23 23:52:50 ET
Table 'Algieba III' 6-max Seat #4 is the button
Seat 1: Tyoma_Kovach ($10 in chips) 
Seat 2: Palen030 ($3.45 in chips) 
Seat 3: thedude696969 ($23.18 in chips) 
Seat 4: 0nix770 ($16.47 in chips) 
Seat 5: johnnytrue ($9.68 in chips) 
Seat 6: Deniels7 ($17.69 in chips) 
johnnytrue: posts small blind $0.05
Deniels7: posts big blind $0.10
*** HOLE CARDS ***
Tyoma_Kovach: folds 
Palen030: folds 
thedude696969: folds 
0nix770: folds 
johnnytrue: calls $0.05
Deniels7: checks 
*** FLOP *** [9h Jh Kc]
johnnytrue: checks 
Deniels7: checks 
*** TURN *** [9h Jh Kc] [6c]
johnnytrue: bets $0.10
Deniels7: calls $0.10
*** RIVER *** [9h Jh Kc 6c] [Th]
johnnytrue: checks 
Deniels7: bets $0.30
johnnytrue: calls $0.30
*** SHOW DOWN ***
Deniels7: shows [Qc 3c] (a straight, Nine to King)
johnnytrue: shows [Jc Qd] (a straight, Nine to King)
johnnytrue collected $0.48 from pot
Deniels7 collected $0.48 from pot
*** SUMMARY ***
Total pot $1 | Rake $0.04 
Board [9h Jh Kc 6c Th]
Seat 1: Tyoma_Kovach folded before Flop (didn't bet)
Seat 2: Palen030 folded before Flop (didn't bet)
Seat 3: thedude696969 folded before Flop (didn't bet)
Seat 4: 0nix770 (button) folded before Flop (didn't bet)
Seat 5: johnnytrue (small blind) showed [Jc Qd] and won ($0.48) with a straight, Nine to King
Seat 6: Deniels7 (big blind) showed [Qc 3c] and won ($0.48) with a straight, Nine to King



PokerStars Hand #222944528791:  Hold'em No Limit ($0.05/$0.10 USD) - 2021/01/23 23:53:32 ET
Table 'Algieba III' 6-max Seat #5 is the button
Seat 1: Tyoma_Kovach ($10 in chips) 
Seat 2: Palen030 ($3.45 in chips) 
Seat 3: thedude696969 ($23.18 in chips) 
Seat 4: 0nix770 ($16.47 in chips) 
Seat 5: johnnytrue ($9.66 in chips) 
Seat 6: Deniels7 ($17.67 in chips) 
Deniels7: posts small blind $0.05
Tyoma_Kovach: posts big blind $0.10
*** HOLE CARDS ***
Palen030: folds 
thedude696969: folds 
0nix770: raises $0.15 to $0.25
johnnytrue: folds 
Deniels7: folds 
Tyoma_Kovach: folds 
Uncalled bet ($0.15) returned to 0nix770
0nix770 collected $0.25 from pot
0nix770: doesn't show hand 
*** SUMMARY ***
Total pot $0.25 | Rake $0 
Seat 1: Tyoma_Kovach (big blind) folded before Flop
Seat 2: Palen030 folded before Flop (didn't bet)
Seat 3: thedude696969 folded before Flop (didn't bet)
Seat 4: 0nix770 collected ($0.25)
Seat 5: johnnytrue (button) folded before Flop (didn't bet)
Seat 6: Deniels7 (small blind) folded before Flop



PokerStars Hand #222944532293:  Hold'em No Limit ($0.05/$0.10 USD) - 2021/01/23 23:53:44 ET
Table 'Algieba III' 6-max Seat #6 is the button
Seat 1: Tyoma_Kovach ($10 in chips) 
Seat 2: Palen030 ($3.45 in chips) 
Seat 3: thedude696969 ($23.18 in chips) 
Seat 4: 0nix770 ($16.62 in chips) 
Seat 5: johnnytrue ($9.66 in chips) 
Seat 6: Deniels7 ($17.62 in chips) 
Tyoma_Kovach: posts small blind $0.05
Palen030: posts big blind $0.10
*** HOLE CARDS ***
thedude696969: folds 
0nix770: raises $0.20 to $0.30
johnnytrue: folds 
Deniels7: folds 
Tyoma_Kovach: folds 
Palen030: folds 
Uncalled bet ($0.20) returned to 0nix770
0nix770 collected $0.25 from pot
0nix770: doesn't show hand 
*** SUMMARY ***
Total pot $0.25 | Rake $0 
Seat 1: Tyoma_Kovach (small blind) folded before Flop
Seat 2: Palen030 (big blind) folded before Flop
Seat 3: thedude696969 folded before Flop (didn't bet)
Seat 4: 0nix770 collected ($0.25)
Seat 5: johnnytrue folded before Flop (didn't bet)
Seat 6: Deniels7 (button) folded before Flop (didn't bet)



PokerStars Hand #222944536331:  Hold'em No Limit ($0.05/$0.10 USD) - 2021/01/23 23:53:58 ET
Table 'Algieba III' 6-max Seat #1 is the button
Seat 1: Tyoma_Kovach ($10 in chips) 
Seat 2: Palen030 ($3.35 in chips) 
Seat 3: thedude696969 ($23.18 in chips) 
Seat 4: 0nix770 ($16.77 in chips) 
Seat 5: johnnytrue ($9.66 in chips) 
Seat 6: Deniels7 ($17.62 in chips) 
Palen030: posts small blind $0.05
thedude696969: posts big blind $0.10
*** HOLE CARDS ***
0nix770: folds 
johnnytrue: folds 
Deniels7: folds 
Tyoma_Kovach: raises $0.15 to $0.25
Palen030: folds 
thedude696969: calls $0.15
*** FLOP *** [9h 3s 4s]
thedude696969: checks 
Tyoma_Kovach: bets $0.35
thedude696969: folds 
Uncalled bet ($0.35) returned to Tyoma_Kovach
Tyoma_Kovach collected $0.53 from pot
Tyoma_Kovach: doesn't show hand 
*** SUMMARY ***
Total pot $0.55 | Rake $0.02 
Board [9h 3s 4s]
Seat 1: Tyoma_Kovach (button) collected ($0.53)
Seat 2: Palen030 (small blind) folded before Flop
Seat 3: thedude696969 (big blind) folded on the Flop
Seat 4: 0nix770 folded before Flop (didn't bet)
Seat 5: johnnytrue folded before Flop (didn't bet)
Seat 6: Deniels7 folded before Flop (didn't bet)



PokerStars Hand #222944544763:  Hold'em No Limit ($0.05/$0.10 USD) - 2021/01/23 23:54:28 ET
Table 'Algieba III' 6-max Seat #2 is the button
Seat 1: Tyoma_Kovach ($10.28 in chips) 
Seat 2: Palen030 ($3.30 in chips) 
Seat 3: thedude696969 ($22.93 in chips) 
Seat 4: 0nix770 ($16.77 in chips) 
Seat 5: johnnytrue ($9.66 in chips) 
Seat 6: Deniels7 ($17.62 in chips) 
thedude696969: posts small blind $0.05
0nix770: posts big blind $0.10
*** HOLE CARDS ***
johnnytrue: folds 
Deniels7: raises $0.10 to $0.20
Tyoma_Kovach: folds 
Palen030: folds 
thedude696969: calls $0.15
0nix770: folds 
*** FLOP *** [Th Kd 3c]
thedude696969: checks 
Deniels7: checks 
*** TURN *** [Th Kd 3c] [Kc]
thedude696969: bets $0.30
Deniels7: calls $0.30
*** RIVER *** [Th Kd 3c Kc] [4s]
thedude696969: bets $0.83
Deniels7: folds 
Uncalled bet ($0.83) returned to thedude696969
thedude696969 collected $1.05 from pot
thedude696969: doesn't show hand 
*** SUMMARY ***
Total pot $1.10 | Rake $0.05 
Board [Th Kd 3c Kc 4s]
Seat 1: Tyoma_Kovach folded before Flop (didn't bet)
Seat 2: Palen030 (button) folded before Flop (didn't bet)
Seat 3: thedude696969 (small blind) collected ($1.05)
Seat 4: 0nix770 (big blind) folded before Flop
Seat 5: johnnytrue folded before Flop (didn't bet)
Seat 6: Deniels7 folded on the River



PokerStars Hand #222944559394:  Hold'em No Limit ($0.05/$0.10 USD) - 2021/01/23 23:55:06 ET
Table 'Algieba III' 6-max Seat #3 is the button
Seat 1: Tyoma_Kovach ($10.28 in chips) 
Seat 2: Palen030 ($3.30 in chips) 
Seat 3: thedude696969 ($23.48 in chips) 
Seat 4: 0nix770 ($16.67 in chips) 
Seat 5: johnnytrue ($9.66 in chips) 
Seat 6: Deniels7 ($17.12 in chips) 
0nix770: posts small blind $0.05
johnnytrue: posts big blind $0.10
*** HOLE CARDS ***
Deniels7: folds 
Tyoma_Kovach: raises $0.20 to $0.30
Palen030: calls $0.30
thedude696969: folds 
0nix770: folds 
johnnytrue: folds 
*** FLOP *** [6d Th 9s]
Tyoma_Kovach: checks 
Palen030: bets $0.10
Tyoma_Kovach: calls $0.10
*** TURN *** [6d Th 9s] [Ks]
Tyoma_Kovach: checks 
Palen030: bets $0.10
Tyoma_Kovach: calls $0.10
*** RIVER *** [6d Th 9s Ks] [8d]
Tyoma_Kovach: checks 
Palen030: checks 
*** SHOW DOWN ***
Tyoma_Kovach: shows [6h 5h] (a pair of Sixes)
Palen030: shows [Jc Js] (a pair of Jacks)
Palen030 collected $1.10 from pot
*** SUMMARY ***
Total pot $1.15 | Rake $0.05 
Board [6d Th 9s Ks 8d]
Seat 1: Tyoma_Kovach showed [6h 5h] and lost with a pair of Sixes
Seat 2: Palen030 showed [Jc Js] and won ($1.10) with a pair of Jacks
Seat 3: thedude696969 (button) folded before Flop (didn't bet)
Seat 4: 0nix770 (small blind) folded before Flop
Seat 5: johnnytrue (big blind) folded before Flop
Seat 6: Deniels7 folded before Flop (didn't bet)



PokerStars Hand #222944566545:  Hold'em No Limit ($0.05/$0.10 USD) - 2021/01/23 23:55:39 ET
Table 'Algieba III' 6-max Seat #4 is the button
Seat 1: Tyoma_Kovach ($10 in chips) 
Seat 2: Palen030 ($3.90 in chips) 
Seat 3: thedude696969 ($23.48 in chips) 
Seat 4: 0nix770 ($16.62 in chips) 
Seat 5: johnnytrue ($9.56 in chips) 
Seat 6: Deniels7 ($17.12 in chips) 
johnnytrue: posts small blind $0.05
Deniels7: posts big blind $0.10
*** HOLE CARDS ***
Tyoma_Kovach: folds 
Palen030: folds 
thedude696969: folds 
0nix770: folds 
johnnytrue: folds 
Uncalled bet ($0.05) returned to Deniels7
Deniels7 collected $0.10 from pot
Deniels7: doesn't show hand 
*** SUMMARY ***
Total pot $0.10 | Rake $0 
Seat 1: Tyoma_Kovach folded before Flop (didn't bet)
Seat 2: Palen030 folded before Flop (didn't bet)
Seat 3: thedude696969 folded before Flop (didn't bet)
Seat 4: 0nix770 (button) folded before Flop (didn't bet)
Seat 5: johnnytrue (small blind) folded before Flop
Seat 6: Deniels7 (big blind) collected ($0.10)



PokerStars Hand #222944568867:  Hold'em No Limit ($0.05/$0.10 USD) - 2021/01/23 23:55:49 ET
Table 'Algieba III' 6-max Seat #5 is the button
Seat 1: Tyoma_Kovach ($10 in chips) 
Seat 2: Palen030 ($3.90 in chips) 
Seat 3: thedude696969 ($23.48 in chips) 
Seat 4: 0nix770 ($16.62 in chips) 
Seat 5: johnnytrue ($9.51 in chips) 
Seat 6: Deniels7 ($17.17 in chips) 
Deniels7: posts small blind $0.05
Tyoma_Kovach: posts big blind $0.10
*** HOLE CARDS ***
Palen030: folds 
thedude696969: folds 
0nix770: folds 
johnnytrue: calls $0.10
Deniels7: calls $0.05
Tyoma_Kovach: checks 
*** FLOP *** [4h 3h Ad]
Deniels7: checks 
Tyoma_Kovach: bets $0.22
johnnytrue: calls $0.22
Deniels7: folds 
*** TURN *** [4h 3h Ad] [4s]
Tyoma_Kovach: checks 
johnnytrue: checks 
*** RIVER *** [4h 3h Ad 4s] [7h]
Tyoma_Kovach: bets $0.23
johnnytrue: calls $0.23
*** SHOW DOWN ***
Tyoma_Kovach: shows [As 3c] (two pair, Aces and Fours)
johnnytrue: shows [Ah Ts] (two pair, Aces and Fours - Ten kicker)
johnnytrue collected $1.15 from pot
*** SUMMARY ***
Total pot $1.20 | Rake $0.05 
Board [4h 3h Ad 4s 7h]
Seat 1: Tyoma_Kovach (big blind) showed [As 3c] and lost with two pair, Aces and Fours
Seat 2: Palen030 folded before Flop (didn't bet)
Seat 3: thedude696969 folded before Flop (didn't bet)
Seat 4: 0nix770 folded before Flop (didn't bet)
Seat 5: johnnytrue (button) showed [Ah Ts] and won ($1.15) with two pair, Aces and Fours
Seat 6: Deniels7 (small blind) folded on the Flop



PokerStars Hand #222944580993:  Hold'em No Limit ($0.05/$0.10 USD) - 2021/01/23 23:56:45 ET
Table 'Algieba III' 6-max Seat #6 is the button
Seat 1: Tyoma_Kovach ($10 in chips) 
Seat 2: Palen030 ($3.90 in chips) 
Seat 3: thedude696969 ($23.48 in chips) 
Seat 4: 0nix770 ($16.62 in chips) 
Seat 5: johnnytrue ($10.11 in chips) 
Seat 6: Deniels7 ($17.07 in chips) 
Tyoma_Kovach: posts small blind $0.05
Palen030: posts big blind $0.10
*** HOLE CARDS ***
thedude696969: folds 
0nix770: folds 
johnnytrue: folds 
Deniels7: calls $0.10
Tyoma_Kovach: folds 
Palen030: checks 
*** FLOP *** [7c As 8c]
Palen030: checks 
Deniels7: checks 
*** TURN *** [7c As 8c] [8s]
Palen030: checks 
Deniels7: checks 
*** RIVER *** [7c As 8c 8s] [Ac]
Palen030: checks 
Deniels7: checks 
*** SHOW DOWN ***
Palen030: shows [Kh 5h] (two pair, Aces and Eights)
Deniels7: mucks hand 
Palen030 collected $0.24 from pot
*** SUMMARY ***
Total pot $0.25 | Rake $0.01 
Board [7c As 8c 8s Ac]
Seat 1: Tyoma_Kovach (small blind) folded before Flop
Seat 2: Palen030 (big blind) showed [Kh 5h] and won ($0.24) with two pair, Aces and Eights
Seat 3: thedude696969 folded before Flop (didn't bet)
Seat 4: 0nix770 folded before Flop (didn't bet)
Seat 5: johnnytrue folded before Flop (didn't bet)
Seat 6: Deniels7 (button) mucked



PokerStars Hand #222944586115:  Hold'em No Limit ($0.05/$0.10 USD) - 2021/01/23 23:57:09 ET
Table 'Algieba III' 6-max Seat #1 is the button
Seat 1: Tyoma_Kovach ($10 in chips) 
Seat 2: Palen030 ($4.04 in chips) 
Seat 3: thedude696969 ($23.48 in chips) 
Seat 4: 0nix770 ($16.62 in chips) 
Seat 5: johnnytrue ($10.11 in chips) 
Seat 6: Deniels7 ($16.97 in chips) 
Palen030: posts small blind $0.05
thedude696969: posts big blind $0.10
*** HOLE CARDS ***
0nix770: raises $0.20 to $0.30
johnnytrue: folds 
Deniels7: folds 
Tyoma_Kovach: calls $0.30
Palen030: folds 
thedude696969: calls $0.20
*** FLOP *** [Td 4d 7d]
thedude696969: checks 
0nix770: checks 
Tyoma_Kovach: bets $0.30
thedude696969: folds 
0nix770: folds 
Uncalled bet ($0.30) returned to Tyoma_Kovach
Tyoma_Kovach collected $0.91 from pot
Tyoma_Kovach: doesn't show hand 
*** SUMMARY ***
Total pot $0.95 | Rake $0.04 
Board [Td 4d 7d]
Seat 1: Tyoma_Kovach (button) collected ($0.91)
Seat 2: Palen030 (small blind) folded before Flop
Seat 3: thedude696969 (big blind) folded on the Flop
Seat 4: 0nix770 folded on the Flop
Seat 5: johnnytrue folded before Flop (didn't bet)
Seat 6: Deniels7 folded before Flop (didn't bet)



PokerStars Hand #222944596658:  Hold'em No Limit ($0.05/$0.10 USD) - 2021/01/23 23:57:57 ET
Table 'Algieba III' 6-max Seat #2 is the button
Seat 1: Tyoma_Kovach ($10.61 in chips) 
Seat 2: Palen030 ($3.99 in chips) 
Seat 3: thedude696969 ($23.18 in chips) 
Seat 4: 0nix770 ($16.32 in chips) 
Seat 5: johnnytrue ($10.11 in chips) 
Seat 6: Deniels7 ($16.97 in chips) 
thedude696969: posts small blind $0.05
0nix770: posts big blind $0.10
*** HOLE CARDS ***
johnnytrue: folds 
Deniels7: raises $0.10 to $0.20
Tyoma_Kovach: folds 
Palen030: folds 
thedude696969: calls $0.15
0nix770: folds 
*** FLOP *** [2d 3d 6c]
thedude696969: checks 
Deniels7: checks 
*** TURN *** [2d 3d 6c] [7h]
thedude696969: checks 
Deniels7: checks 
*** RIVER *** [2d 3d 6c 7h] [Js]
thedude696969: bets $0.24
Deniels7: folds 
Uncalled bet ($0.24) returned to thedude696969
thedude696969 collected $0.48 from pot
thedude696969: doesn't show hand 
*** SUMMARY ***
Total pot $0.50 | Rake $0.02 
Board [2d 3d 6c 7h Js]
Seat 1: Tyoma_Kovach folded before Flop (didn't bet)
Seat 2: Palen030 (button) folded before Flop (didn't bet)
Seat 3: thedude696969 (small blind) collected ($0.48)
Seat 4: 0nix770 (big blind) folded before Flop
Seat 5: johnnytrue folded before Flop (didn't bet)
Seat 6: Deniels7 folded on the River



PokerStars Hand #222944604235:  Hold'em No Limit ($0.05/$0.10 USD) - 2021/01/23 23:58:32 ET
Table 'Algieba III' 6-max Seat #3 is the button
Seat 1: Tyoma_Kovach ($10.61 in chips) 
Seat 2: Palen030 ($3.99 in chips) 
Seat 3: thedude696969 ($23.46 in chips) 
Seat 4: 0nix770 ($16.22 in chips) 
Seat 5: johnnytrue ($10.11 in chips) 
Seat 6: Deniels7 ($16.77 in chips) 
0nix770: posts small blind $0.05
johnnytrue: posts big blind $0.10
*** HOLE CARDS ***
Deniels7: calls $0.10
Tyoma_Kovach: folds 
Palen030: folds 
thedude696969: raises $0.20 to $0.30
0nix770: folds 
johnnytrue: folds 
Deniels7: calls $0.20
*** FLOP *** [Ac Ts Ah]
Deniels7: checks 
thedude696969: bets $0.40
Deniels7: folds 
Uncalled bet ($0.40) returned to thedude696969
thedude696969 collected $0.72 from pot
thedude696969: doesn't show hand 
*** SUMMARY ***
Total pot $0.75 | Rake $0.03 
Board [Ac Ts Ah]
Seat 1: Tyoma_Kovach folded before Flop (didn't bet)
Seat 2: Palen030 folded before Flop (didn't bet)
Seat 3: thedude696969 (button) collected ($0.72)
Seat 4: 0nix770 (small blind) folded before Flop
Seat 5: johnnytrue (big blind) folded before Flop
Seat 6: Deniels7 folded on the Flop



PokerStars Hand #222944611682:  Hold'em No Limit ($0.05/$0.10 USD) - 2021/01/23 23:59:06 ET
Table 'Algieba III' 6-max Seat #4 is the button
Seat 1: Tyoma_Kovach ($10.61 in chips) 
Seat 2: Palen030 ($3.99 in chips) 
Seat 3: thedude696969 ($23.88 in chips) 
Seat 4: 0nix770 ($16.17 in chips) 
Seat 5: johnnytrue ($10.01 in chips) 
Seat 6: Deniels7 ($16.47 in chips) 
johnnytrue: posts small blind $0.05
Deniels7: posts big blind $0.10
*** HOLE CARDS ***
Tyoma_Kovach: folds 
Palen030: folds 
thedude696969: folds 
0nix770: raises $0.13 to $0.23
johnnytrue: folds 
Deniels7: calls $0.13
*** FLOP *** [Kd 7c 9d]
Deniels7: checks 
0nix770: bets $0.27
Deniels7: calls $0.27
*** TURN *** [Kd 7c 9d] [7d]
Deniels7: checks 
0nix770: bets $0.55
Deniels7: folds 
Uncalled bet ($0.55) returned to 0nix770
0nix770 collected $1 from pot
0nix770: doesn't show hand 
*** SUMMARY ***
Total pot $1.05 | Rake $0.05 
Board [Kd 7c 9d 7d]
Seat 1: Tyoma_Kovach folded before Flop (didn't bet)
Seat 2: Palen030 folded before Flop (didn't bet)
Seat 3: thedude696969 folded before Flop (didn't bet)
Seat 4: 0nix770 (button) collected ($1)
Seat 5: johnnytrue (small blind) folded before Flop
Seat 6: Deniels7 (big blind) folded on the Turn



PokerStars Hand #222944620218:  Hold'em No Limit ($0.05/$0.10 USD) - 2021/01/23 23:59:46 ET
Table 'Algieba III' 6-max Seat #5 is the button
Seat 1: Tyoma_Kovach ($10.61 in chips) 
Seat 2: Palen030 ($3.99 in chips) 
Seat 3: thedude696969 ($23.88 in chips) 
Seat 4: 0nix770 ($16.67 in chips) 
Seat 5: johnnytrue ($9.96 in chips) 
Seat 6: Deniels7 ($15.97 in chips) 
Deniels7: posts small blind $0.05
Tyoma_Kovach: posts big blind $0.10
*** HOLE CARDS ***
Palen030: folds 
thedude696969: folds 
0nix770: raises $0.15 to $0.25
johnnytrue: folds 
Deniels7: folds 
Tyoma_Kovach: folds 
Uncalled bet ($0.15) returned to 0nix770
0nix770 collected $0.25 from pot
0nix770: doesn't show hand 
*** SUMMARY ***
Total pot $0.25 | Rake $0 
Seat 1: Tyoma_Kovach (big blind) folded before Flop
Seat 2: Palen030 folded before Flop (didn't bet)
Seat 3: thedude696969 folded before Flop (didn't bet)
Seat 4: 0nix770 collected ($0.25)
Seat 5: johnnytrue (button) folded before Flop (didn't bet)
Seat 6: Deniels7 (small blind) folded before Flop



PokerStars Hand #222944622979:  Hold'em No Limit ($0.05/$0.10 USD) - 2021/01/23 23:59:59 ET
Table 'Algieba III' 6-max Seat #6 is the button
Seat 1: Tyoma_Kovach ($10.51 in chips) 
Seat 2: Palen030 ($3.99 in chips) 
Seat 3: thedude696969 ($23.88 in chips) 
Seat 4: 0nix770 ($16.82 in chips) 
Seat 5: johnnytrue ($9.96 in chips) 
Seat 6: Deniels7 ($15.92 in chips) 
Tyoma_Kovach: posts small blind $0.05
Palen030: posts big blind $0.10
*** HOLE CARDS ***
thedude696969: folds 
0nix770: folds 
johnnytrue: calls $0.10
Deniels7: folds 
Tyoma_Kovach: raises $0.40 to $0.50
Palen030: folds 
johnnytrue: calls $0.40
*** FLOP *** [Ad 2s Qc]
Tyoma_Kovach: bets $0.35
johnnytrue: folds 
Uncalled bet ($0.35) returned to Tyoma_Kovach
Tyoma_Kovach collected $1.05 from pot
Tyoma_Kovach: doesn't show hand 
*** SUMMARY ***
Total pot $1.10 | Rake $0.05 
Board [Ad 2s Qc]
Seat 1: Tyoma_Kovach (small blind) collected ($1.05)
Seat 2: Palen030 (big blind) folded before Flop
Seat 3: thedude696969 folded before Flop (didn't bet)
Seat 4: 0nix770 folded before Flop (didn't bet)
Seat 5: johnnytrue folded on the Flop
Seat 6: Deniels7 (button) folded before Flop (didn't bet)



PokerStars Hand #222945561715:  Hold'em No Limit ($0.05/$0.10 USD) - 2021/01/23 0:55:51 ET
Table 'Algieba III' 6-max Seat #3 is the button
Seat 1: Tyoma_Kovach ($10.43 in chips) 
Seat 2: sixcoins ($13.93 in chips) 
Seat 3: thedude696969 ($31.52 in chips) 
Seat 4: fish72o ($12.34 in chips) 
Seat 5: johnnytrue ($13.69 in chips) 
Seat 6: Notatur ($10.54 in chips) 
fish72o: posts small blind $0.05
johnnytrue: posts big blind $0.10
*** HOLE CARDS ***
Notatur: folds 
Tyoma_Kovach: raises $0.20 to $0.30
sixcoins: calls $0.30
thedude696969: calls $0.30
fish72o: folds 
johnnytrue: folds 
*** FLOP *** [4d 2c Jc]
Tyoma_Kovach: checks 
sixcoins: checks 
thedude696969: bets $0.63
Tyoma_Kovach: folds 
sixcoins: folds 
Uncalled bet ($0.63) returned to thedude696969
thedude696969 collected $1 from pot
thedude696969: doesn't show hand 
*** SUMMARY ***
Total pot $1.05 | Rake $0.05 
Board [4d 2c Jc]
Seat 1: Tyoma_Kovach folded on the Flop
Seat 2: sixcoins folded on the Flop
Seat 3: thedude696969 (button) collected ($1)
Seat 4: fish72o (small blind) folded before Flop
Seat 5: johnnytrue (big blind) folded before Flop
Seat 6: Notatur folded before Flop (didn't bet)



PokerStars Hand #222946323191:  Hold'em No Limit ($0.05/$0.10 USD) - 2021/01/23 1:47:39 ET
Table 'Algieba III' 6-max Seat #1 is the button
Seat 1: Tyoma_Kovach ($13.41 in chips) 
Seat 2: zebaztravez ($11.40 in chips) 
Seat 3: loehc ($11.10 in chips) 
Seat 4: fish72o ($10 in chips) 
Seat 5: 19_Ips_87 ($9.53 in chips) 
Seat 6: Notatur ($10.60 in chips) 
zebaztravez: posts small blind $0.05
loehc: posts big blind $0.10
*** HOLE CARDS ***
fish72o: folds 
19_Ips_87: raises $0.20 to $0.30
Notatur: folds 
Tyoma_Kovach: calls $0.30
zebaztravez: folds 
loehc: calls $0.20
*** FLOP *** [5d As Jh]
loehc: checks 
19_Ips_87: checks 
Tyoma_Kovach: checks 
*** TURN *** [5d As Jh] [4h]
loehc: checks 
19_Ips_87: bets $0.70
Tyoma_Kovach: folds 
loehc: folds 
Uncalled bet ($0.70) returned to 19_Ips_87
19_Ips_87 collected $0.91 from pot
19_Ips_87: doesn't show hand 
*** SUMMARY ***
Total pot $0.95 | Rake $0.04 
Board [5d As Jh 4h]
Seat 1: Tyoma_Kovach (button) folded on the Turn
Seat 2: zebaztravez (small blind) folded before Flop
Seat 3: loehc (big blind) folded on the Turn
Seat 4: fish72o folded before Flop (didn't bet)
Seat 5: 19_Ips_87 collected ($0.91)
Seat 6: Notatur folded before Flop (didn't bet)



PokerStars Hand #222946334892:  Hold'em No Limit ($0.05/$0.10 USD) - 2021/01/23 1:48:29 ET
Table 'Algieba III' 6-max Seat #2 is the button
Seat 1: Tyoma_Kovach ($13.11 in chips) 
Seat 2: zebaztravez ($11.35 in chips) 
Seat 3: loehc ($10.80 in chips) 
Seat 4: fish72o ($10 in chips) 
Seat 5: 19_Ips_87 ($10.14 in chips) 
Seat 6: Notatur ($10.60 in chips) 
loehc: posts small blind $0.05
fish72o: posts big blind $0.10
*** HOLE CARDS ***
19_Ips_87: folds 
Notatur: raises $0.15 to $0.25
Tyoma_Kovach: folds 
zebaztravez: folds 
loehc: folds 
fish72o: calls $0.15
*** FLOP *** [Qs 5h Th]
fish72o: bets $0.17
Notatur: folds 
Uncalled bet ($0.17) returned to fish72o
fish72o collected $0.53 from pot
fish72o: doesn't show hand 
*** SUMMARY ***
Total pot $0.55 | Rake $0.02 
Board [Qs 5h Th]
Seat 1: Tyoma_Kovach folded before Flop (didn't bet)
Seat 2: zebaztravez (button) folded before Flop (didn't bet)
Seat 3: loehc (small blind) folded before Flop
Seat 4: fish72o (big blind) collected ($0.53)
Seat 5: 19_Ips_87 folded before Flop (didn't bet)
Seat 6: Notatur folded on the Flop



PokerStars Hand #222946343863:  Hold'em No Limit ($0.05/$0.10 USD) - 2021/01/23 1:49:07 ET
Table 'Algieba III' 6-max Seat #3 is the button
Seat 1: Tyoma_Kovach ($13.11 in chips) 
Seat 2: zebaztravez ($11.35 in chips) 
Seat 3: loehc ($10.75 in chips) 
Seat 4: fish72o ($10.28 in chips) 
Seat 5: 19_Ips_87 ($10.14 in chips) 
Seat 6: Notatur ($10.35 in chips) 
fish72o: posts small blind $0.05
19_Ips_87: posts big blind $0.10
*** HOLE CARDS ***
Notatur: folds 
Tyoma_Kovach: folds 
zebaztravez: folds 
loehc: folds 
fish72o: folds 
Uncalled bet ($0.05) returned to 19_Ips_87
19_Ips_87 collected $0.10 from pot
19_Ips_87: doesn't show hand 
*** SUMMARY ***
Total pot $0.10 | Rake $0 
Seat 1: Tyoma_Kovach folded before Flop (didn't bet)
Seat 2: zebaztravez folded before Flop (didn't bet)
Seat 3: loehc (button) folded before Flop (didn't bet)
Seat 4: fish72o (small blind) folded before Flop
Seat 5: 19_Ips_87 (big blind) collected ($0.10)
Seat 6: Notatur folded before Flop (didn't bet)



PokerStars Hand #222946346668:  Hold'em No Limit ($0.05/$0.10 USD) - 2021/01/23 1:49:19 ET
Table 'Algieba III' 6-max Seat #4 is the button
Seat 1: Tyoma_Kovach ($13.11 in chips) 
Seat 2: zebaztravez ($11.35 in chips) 
Seat 3: loehc ($10.75 in chips) 
Seat 4: fish72o ($10.23 in chips) 
Seat 5: 19_Ips_87 ($10.19 in chips) 
Seat 6: Notatur ($10.35 in chips) 
19_Ips_87: posts small blind $0.05
Notatur: posts big blind $0.10
*** HOLE CARDS ***
Tyoma_Kovach: folds 
zebaztravez: folds 
loehc: folds 
fish72o: folds 
19_Ips_87: folds 
Uncalled bet ($0.05) returned to Notatur
Notatur collected $0.10 from pot
Notatur: doesn't show hand 
*** SUMMARY ***
Total pot $0.10 | Rake $0 
Seat 1: Tyoma_Kovach folded before Flop (didn't bet)
Seat 2: zebaztravez folded before Flop (didn't bet)
Seat 3: loehc folded before Flop (didn't bet)
Seat 4: fish72o (button) folded before Flop (didn't bet)
Seat 5: 19_Ips_87 (small blind) folded before Flop
Seat 6: Notatur (big blind) collected ($0.10)



PokerStars Hand #222946350513:  Hold'em No Limit ($0.05/$0.10 USD) - 2021/01/23 1:49:33 ET
Table 'Algieba III' 6-max Seat #5 is the button
Seat 1: Tyoma_Kovach ($13.11 in chips) 
Seat 2: zebaztravez ($11.35 in chips) 
Seat 3: loehc ($10.75 in chips) 
Seat 4: fish72o ($10.23 in chips) 
Seat 5: 19_Ips_87 ($10.14 in chips) 
Seat 6: Notatur ($10.40 in chips) 
Notatur: posts small blind $0.05
Tyoma_Kovach: posts big blind $0.10
*** HOLE CARDS ***
zebaztravez: raises $0.20 to $0.30
loehc: raises $0.75 to $1.05
fish72o: folds 
19_Ips_87: folds 
Notatur: folds 
Tyoma_Kovach: folds 
zebaztravez: folds 
Uncalled bet ($0.75) returned to loehc
loehc collected $0.75 from pot
loehc: doesn't show hand 
*** SUMMARY ***
Total pot $0.75 | Rake $0 
Seat 1: Tyoma_Kovach (big blind) folded before Flop
Seat 2: zebaztravez folded before Flop
Seat 3: loehc collected ($0.75)
Seat 4: fish72o folded before Flop (didn't bet)
Seat 5: 19_Ips_87 (button) folded before Flop (didn't bet)
Seat 6: Notatur (small blind) folded before Flop



PokerStars Hand #222946354947:  Hold'em No Limit ($0.05/$0.10 USD) - 2021/01/23 1:49:52 ET
Table 'Algieba III' 6-max Seat #6 is the button
Seat 1: Tyoma_Kovach ($13.01 in chips) 
Seat 2: zebaztravez ($11.05 in chips) 
Seat 3: loehc ($11.20 in chips) 
Seat 4: fish72o ($10.23 in chips) 
Seat 5: 19_Ips_87 ($10.14 in chips) 
Seat 6: Notatur ($10.35 in chips) 
Tyoma_Kovach: posts small blind $0.05
zebaztravez: posts big blind $0.10
*** HOLE CARDS ***
loehc: folds 
fish72o: folds 
19_Ips_87: raises $0.10 to $0.20
Notatur: folds 
Tyoma_Kovach: raises $0.80 to $1
zebaztravez: folds 
19_Ips_87: folds 
Uncalled bet ($0.80) returned to Tyoma_Kovach
Tyoma_Kovach collected $0.50 from pot
Tyoma_Kovach: doesn't show hand 
*** SUMMARY ***
Total pot $0.50 | Rake $0 
Seat 1: Tyoma_Kovach (small blind) collected ($0.50)
Seat 2: zebaztravez (big blind) folded before Flop
Seat 3: loehc folded before Flop (didn't bet)
Seat 4: fish72o folded before Flop (didn't bet)
Seat 5: 19_Ips_87 folded before Flop
Seat 6: Notatur (button) folded before Flop (didn't bet)



PokerStars Hand #222946359767:  Hold'em No Limit ($0.05/$0.10 USD) - 2021/01/23 1:50:12 ET
Table 'Algieba III' 6-max Seat #1 is the button
Seat 1: Tyoma_Kovach ($13.31 in chips) 
Seat 2: zebaztravez ($10.95 in chips) 
Seat 3: loehc ($11.20 in chips) 
Seat 4: fish72o ($10.23 in chips) 
Seat 5: 19_Ips_87 ($9.94 in chips) 
Seat 6: Notatur ($10.35 in chips) 
zebaztravez: posts small blind $0.05
loehc: posts big blind $0.10
*** HOLE CARDS ***
fish72o: folds 
19_Ips_87: folds 
Notatur: folds 
Tyoma_Kovach: folds 
zebaztravez: folds 
Uncalled bet ($0.05) returned to loehc
loehc collected $0.10 from pot
loehc: doesn't show hand 
*** SUMMARY ***
Total pot $0.10 | Rake $0 
Seat 1: Tyoma_Kovach (button) folded before Flop (didn't bet)
Seat 2: zebaztravez (small blind) folded before Flop
Seat 3: loehc (big blind) collected ($0.10)
Seat 4: fish72o folded before Flop (didn't bet)
Seat 5: 19_Ips_87 folded before Flop (didn't bet)
Seat 6: Notatur folded before Flop (didn't bet)



PokerStars Hand #222946362384:  Hold'em No Limit ($0.05/$0.10 USD) - 2021/01/23 1:50:24 ET
Table 'Algieba III' 6-max Seat #2 is the button
Seat 1: Tyoma_Kovach ($13.31 in chips) 
Seat 2: zebaztravez ($10.90 in chips) 
Seat 3: loehc ($11.25 in chips) 
Seat 4: fish72o ($10.23 in chips) 
Seat 5: 19_Ips_87 ($9.94 in chips) 
Seat 6: Notatur ($10.35 in chips) 
loehc: posts small blind $0.05
fish72o: posts big blind $0.10
*** HOLE CARDS ***
19_Ips_87: folds 
Notatur: folds 
Tyoma_Kovach: raises $0.18 to $0.28
zebaztravez: folds 
loehc: folds 
fish72o: folds 
Uncalled bet ($0.18) returned to Tyoma_Kovach
Tyoma_Kovach collected $0.25 from pot
Tyoma_Kovach: doesn't show hand 
*** SUMMARY ***
Total pot $0.25 | Rake $0 
Seat 1: Tyoma_Kovach collected ($0.25)
Seat 2: zebaztravez (button) folded before Flop (didn't bet)
Seat 3: loehc (small blind) folded before Flop
Seat 4: fish72o (big blind) folded before Flop
Seat 5: 19_Ips_87 folded before Flop (didn't bet)
Seat 6: Notatur folded before Flop (didn't bet)



PokerStars Hand #222946365972:  Hold'em No Limit ($0.05/$0.10 USD) - 2021/01/23 1:50:39 ET
Table 'Algieba III' 6-max Seat #3 is the button
Seat 1: Tyoma_Kovach ($13.46 in chips) 
Seat 2: zebaztravez ($10.90 in chips) 
Seat 3: loehc ($11.20 in chips) 
Seat 4: fish72o ($10.13 in chips) 
Seat 5: 19_Ips_87 ($9.94 in chips) 
Seat 6: Notatur ($10.35 in chips) 
fish72o: posts small blind $0.05
19_Ips_87: posts big blind $0.10
*** HOLE CARDS ***
Notatur: folds 
Tyoma_Kovach: folds 
zebaztravez: raises $0.20 to $0.30
loehc: folds 
fish72o: folds 
19_Ips_87: calls $0.20
*** FLOP *** [4s Qs 4h]
19_Ips_87: checks 
zebaztravez: bets $0.31
19_Ips_87: calls $0.31
*** TURN *** [4s Qs 4h] [Jh]
19_Ips_87: checks 
zebaztravez: bets $0.91
19_Ips_87: folds 
Uncalled bet ($0.91) returned to zebaztravez
zebaztravez collected $1.21 from pot
zebaztravez: doesn't show hand 
*** SUMMARY ***
Total pot $1.27 | Rake $0.06 
Board [4s Qs 4h Jh]
Seat 1: Tyoma_Kovach folded before Flop (didn't bet)
Seat 2: zebaztravez collected ($1.21)
Seat 3: loehc (button) folded before Flop (didn't bet)
Seat 4: fish72o (small blind) folded before Flop
Seat 5: 19_Ips_87 (big blind) folded on the Turn
Seat 6: Notatur folded before Flop (didn't bet)



PokerStars Hand #222946374797:  Hold'em No Limit ($0.05/$0.10 USD) - 2021/01/23 1:51:18 ET
Table 'Algieba III' 6-max Seat #4 is the button
Seat 1: Tyoma_Kovach ($13.46 in chips) 
Seat 2: zebaztravez ($11.50 in chips) 
Seat 3: loehc ($11.20 in chips) 
Seat 4: fish72o ($10.08 in chips) 
Seat 5: 19_Ips_87 ($9.33 in chips) 
Seat 6: Notatur ($10.35 in chips) 
19_Ips_87: posts small blind $0.05
Notatur: posts big blind $0.10
*** HOLE CARDS ***
Tyoma_Kovach: folds 
zebaztravez: folds 
loehc: folds 
fish72o: raises $0.15 to $0.25
19_Ips_87: folds 
Notatur: raises $0.75 to $1
fish72o: calls $0.75
*** FLOP *** [3h 5d Th]
Notatur: checks 
fish72o: bets $0.65
Notatur: calls $0.65
*** TURN *** [3h 5d Th] [Qd]
Notatur: checks 
fish72o: checks 
*** RIVER *** [3h 5d Th Qd] [6s]
Notatur: checks 
fish72o: bets $0.64
Notatur: calls $0.64
*** SHOW DOWN ***
fish72o: shows [Qs Js] (a pair of Queens)
Notatur: mucks hand 
fish72o collected $4.42 from pot
*** SUMMARY ***
Total pot $4.63 | Rake $0.21 
Board [3h 5d Th Qd 6s]
Seat 1: Tyoma_Kovach folded before Flop (didn't bet)
Seat 2: zebaztravez folded before Flop (didn't bet)
Seat 3: loehc folded before Flop (didn't bet)
Seat 4: fish72o (button) showed [Qs Js] and won ($4.42) with a pair of Queens
Seat 5: 19_Ips_87 (small blind) folded before Flop
Seat 6: Notatur (big blind) mucked



PokerStars Hand #222946386464:  Hold'em No Limit ($0.05/$0.10 USD) - 2021/01/23 1:52:08 ET
Table 'Algieba III' 6-max Seat #5 is the button
Seat 1: Tyoma_Kovach ($13.46 in chips) 
Seat 2: zebaztravez ($11.50 in chips) 
Seat 3: loehc ($11.20 in chips) 
Seat 4: fish72o ($12.21 in chips) 
Seat 5: 19_Ips_87 ($9.28 in chips) 
Seat 6: Notatur ($10 in chips) 
Notatur: posts small blind $0.05
Tyoma_Kovach: posts big blind $0.10
*** HOLE CARDS ***
zebaztravez: folds 
loehc: folds 
fish72o: folds 
19_Ips_87: folds 
Notatur: folds 
Uncalled bet ($0.05) returned to Tyoma_Kovach
Tyoma_Kovach collected $0.10 from pot
Tyoma_Kovach: doesn't show hand 
*** SUMMARY ***
Total pot $0.10 | Rake $0 
Seat 1: Tyoma_Kovach (big blind) collected ($0.10)
Seat 2: zebaztravez folded before Flop (didn't bet)
Seat 3: loehc folded before Flop (didn't bet)
Seat 4: fish72o folded before Flop (didn't bet)
Seat 5: 19_Ips_87 (button) folded before Flop (didn't bet)
Seat 6: Notatur (small blind) folded before Flop



PokerStars Hand #222946389530:  Hold'em No Limit ($0.05/$0.10 USD) - 2021/01/23 1:52:22 ET
Table 'Algieba III' 6-max Seat #6 is the button
Seat 1: Tyoma_Kovach ($13.51 in chips) 
Seat 2: zebaztravez ($11.50 in chips) 
Seat 3: loehc ($11.20 in chips) 
Seat 4: fish72o ($12.21 in chips) 
Seat 5: 19_Ips_87 ($9.28 in chips) 
Seat 6: Notatur ($10 in chips) 
Tyoma_Kovach: posts small blind $0.05
zebaztravez: posts big blind $0.10
*** HOLE CARDS ***
loehc: folds 
fish72o: folds 
19_Ips_87: folds 
Notatur: raises $0.15 to $0.25
Tyoma_Kovach: folds 
zebaztravez: folds 
Uncalled bet ($0.15) returned to Notatur
Notatur collected $0.25 from pot
Notatur: doesn't show hand 
*** SUMMARY ***
Total pot $0.25 | Rake $0 
Seat 1: Tyoma_Kovach (small blind) folded before Flop
Seat 2: zebaztravez (big blind) folded before Flop
Seat 3: loehc folded before Flop (didn't bet)
Seat 4: fish72o folded before Flop (didn't bet)
Seat 5: 19_Ips_87 folded before Flop (didn't bet)
Seat 6: Notatur (button) collected ($0.25)



PokerStars Hand #222946394429:  Hold'em No Limit ($0.05/$0.10 USD) - 2021/01/23 1:52:43 ET
Table 'Algieba III' 6-max Seat #1 is the button
Seat 1: Tyoma_Kovach ($13.46 in chips) 
Seat 2: zebaztravez ($11.40 in chips) 
Seat 3: loehc ($11.20 in chips) 
Seat 4: fish72o ($12.21 in chips) 
Seat 5: 19_Ips_87 ($9.28 in chips) 
Seat 6: Notatur ($10.15 in chips) 
zebaztravez: posts small blind $0.05
loehc: posts big blind $0.10
*** HOLE CARDS ***
fish72o: folds 
19_Ips_87: folds 
Notatur: raises $0.15 to $0.25
Tyoma_Kovach: folds 
zebaztravez: folds 
loehc: folds 
Uncalled bet ($0.15) returned to Notatur
Notatur collected $0.25 from pot
Notatur: doesn't show hand 
*** SUMMARY ***
Total pot $0.25 | Rake $0 
Seat 1: Tyoma_Kovach (button) folded before Flop (didn't bet)
Seat 2: zebaztravez (small blind) folded before Flop
Seat 3: loehc (big blind) folded before Flop
Seat 4: fish72o folded before Flop (didn't bet)
Seat 5: 19_Ips_87 folded before Flop (didn't bet)
Seat 6: Notatur collected ($0.25)



PokerStars Hand #222946400423:  Hold'em No Limit ($0.05/$0.10 USD) - 2021/01/23 1:52:59 ET
Table 'Algieba III' 6-max Seat #2 is the button
Seat 1: Tyoma_Kovach ($13.46 in chips) 
Seat 2: zebaztravez ($11.35 in chips) 
Seat 3: loehc ($11.10 in chips) 
Seat 4: fish72o ($12.21 in chips) 
Seat 5: 19_Ips_87 ($9.28 in chips) 
Seat 6: Notatur ($10.30 in chips) 
loehc: posts small blind $0.05
fish72o: posts big blind $0.10
*** HOLE CARDS ***
19_Ips_87: folds 
Notatur: folds 
Tyoma_Kovach: raises $0.18 to $0.28
zebaztravez: folds 
loehc: folds 
fish72o: raises $0.72 to $1
Tyoma_Kovach: folds 
Uncalled bet ($0.72) returned to fish72o
fish72o collected $0.61 from pot
fish72o: doesn't show hand 
*** SUMMARY ***
Total pot $0.61 | Rake $0 
Seat 1: Tyoma_Kovach folded before Flop
Seat 2: zebaztravez (button) folded before Flop (didn't bet)
Seat 3: loehc (small blind) folded before Flop
Seat 4: fish72o (big blind) collected ($0.61)
Seat 5: 19_Ips_87 folded before Flop (didn't bet)
Seat 6: Notatur folded before Flop (didn't bet)



PokerStars Hand #222946404405:  Hold'em No Limit ($0.05/$0.10 USD) - 2021/01/23 1:53:17 ET
Table 'Algieba III' 6-max Seat #3 is the button
Seat 1: Tyoma_Kovach ($13.18 in chips) 
Seat 2: zebaztravez ($11.35 in chips) 
Seat 3: loehc ($11.05 in chips) 
Seat 4: fish72o ($12.54 in chips) 
Seat 5: 19_Ips_87 ($9.28 in chips) 
Seat 6: Notatur ($10.30 in chips) 
fish72o: posts small blind $0.05
19_Ips_87: posts big blind $0.10
*** HOLE CARDS ***
Notatur: folds 
Tyoma_Kovach: folds 
zebaztravez: folds 
loehc: folds 
fish72o: folds 
Uncalled bet ($0.05) returned to 19_Ips_87
19_Ips_87 collected $0.10 from pot
19_Ips_87: doesn't show hand 
*** SUMMARY ***
Total pot $0.10 | Rake $0 
Seat 1: Tyoma_Kovach folded before Flop (didn't bet)
Seat 2: zebaztravez folded before Flop (didn't bet)
Seat 3: loehc (button) folded before Flop (didn't bet)
Seat 4: fish72o (small blind) folded before Flop
Seat 5: 19_Ips_87 (big blind) collected ($0.10)
Seat 6: Notatur folded before Flop (didn't bet)



PokerStars Hand #222946406460:  Hold'em No Limit ($0.05/$0.10 USD) - 2021/01/23 1:53:25 ET
Table 'Algieba III' 6-max Seat #4 is the button
Seat 1: Tyoma_Kovach ($13.18 in chips) 
Seat 2: zebaztravez ($11.35 in chips) 
Seat 3: loehc ($11.05 in chips) 
Seat 4: fish72o ($12.49 in chips) 
Seat 5: 19_Ips_87 ($9.33 in chips) 
19_Ips_87: posts small blind $0.05
Notatur: is sitting out 
Tyoma_Kovach: posts big blind $0.10
*** HOLE CARDS ***
zebaztravez: folds 
loehc: folds 
fish72o: folds 
Notatur leaves the table
19_Ips_87: folds 
Uncalled bet ($0.05) returned to Tyoma_Kovach
Tyoma_Kovach collected $0.10 from pot
Tyoma_Kovach: doesn't show hand 
*** SUMMARY ***
Total pot $0.10 | Rake $0 
Seat 1: Tyoma_Kovach (big blind) collected ($0.10)
Seat 2: zebaztravez folded before Flop (didn't bet)
Seat 3: loehc folded before Flop (didn't bet)
Seat 4: fish72o (button) folded before Flop (didn't bet)
Seat 5: 19_Ips_87 (small blind) folded before Flop



PokerStars Hand #222946408604:  Hold'em No Limit ($0.05/$0.10 USD) - 2021/01/23 1:53:35 ET
Table 'Algieba III' 6-max Seat #5 is the button
Seat 1: Tyoma_Kovach ($13.23 in chips) 
Seat 2: zebaztravez ($11.35 in chips) 
Seat 3: loehc ($11.05 in chips) 
Seat 4: fish72o ($12.49 in chips) 
Seat 5: 19_Ips_87 ($9.28 in chips) 
Tyoma_Kovach: posts small blind $0.05
zebaztravez: posts big blind $0.10
*** HOLE CARDS ***
loehc: folds 
fish72o: folds 
19_Ips_87: raises $0.10 to $0.20
Tyoma_Kovach: folds 
beastboy3690 joins the table at seat #6 
zebaztravez: calls $0.10
*** FLOP *** [7c Ac 5s]
zebaztravez: checks 
19_Ips_87: bets $0.22
zebaztravez: folds 
Uncalled bet ($0.22) returned to 19_Ips_87
19_Ips_87 collected $0.43 from pot
19_Ips_87: doesn't show hand 
*** SUMMARY ***
Total pot $0.45 | Rake $0.02 
Board [7c Ac 5s]
Seat 1: Tyoma_Kovach (small blind) folded before Flop
Seat 2: zebaztravez (big blind) folded on the Flop
Seat 3: loehc folded before Flop (didn't bet)
Seat 4: fish72o folded before Flop (didn't bet)
Seat 5: 19_Ips_87 (button) collected ($0.43)



PokerStars Hand #222946417338:  Hold'em No Limit ($0.05/$0.10 USD) - 2021/01/23 1:54:12 ET
Table 'Algieba III' 6-max Seat #1 is the button
Seat 1: Tyoma_Kovach ($13.18 in chips) 
Seat 2: zebaztravez ($11.15 in chips) 
Seat 3: loehc ($11.05 in chips) 
Seat 4: fish72o ($12.49 in chips) 
Seat 5: 19_Ips_87 ($9.51 in chips) 
zebaztravez: posts small blind $0.05
loehc: posts big blind $0.10
beastboy3690: sits out 
*** HOLE CARDS ***
fish72o: folds 
19_Ips_87: raises $0.20 to $0.30
Tyoma_Kovach: folds 
zebaztravez: folds 
loehc: folds 
Uncalled bet ($0.20) returned to 19_Ips_87
19_Ips_87 collected $0.25 from pot
19_Ips_87: doesn't show hand 
*** SUMMARY ***
Total pot $0.25 | Rake $0 
Seat 1: Tyoma_Kovach (button) folded before Flop (didn't bet)
Seat 2: zebaztravez (small blind) folded before Flop
Seat 3: loehc (big blind) folded before Flop
Seat 4: fish72o folded before Flop (didn't bet)
Seat 5: 19_Ips_87 collected ($0.25)



PokerStars Hand #222946421275:  Hold'em No Limit ($0.05/$0.10 USD) - 2021/01/23 1:54:29 ET
Table 'Algieba III' 6-max Seat #2 is the button
Seat 1: Tyoma_Kovach ($13.18 in chips) 
Seat 2: zebaztravez ($11.10 in chips) 
Seat 3: loehc ($10.95 in chips) 
Seat 4: fish72o ($12.49 in chips) 
Seat 5: 19_Ips_87 ($9.66 in chips) 
loehc: posts small blind $0.05
fish72o: posts big blind $0.10
beastboy3690: sits out 
*** HOLE CARDS ***
19_Ips_87: folds 
Tyoma_Kovach: folds 
zebaztravez: raises $0.16 to $0.26
loehc: folds 
fish72o: folds 
Uncalled bet ($0.16) returned to zebaztravez
zebaztravez collected $0.25 from pot
zebaztravez: doesn't show hand 
*** SUMMARY ***
Total pot $0.25 | Rake $0 
Seat 1: Tyoma_Kovach folded before Flop (didn't bet)
Seat 2: zebaztravez (button) collected ($0.25)
Seat 3: loehc (small blind) folded before Flop
Seat 4: fish72o (big blind) folded before Flop
Seat 5: 19_Ips_87 folded before Flop (didn't bet)



PokerStars Hand #222946427124:  Hold'em No Limit ($0.05/$0.10 USD) - 2021/01/23 1:54:55 ET
Table 'Algieba III' 6-max Seat #3 is the button
Seat 1: Tyoma_Kovach ($13.18 in chips) 
Seat 2: zebaztravez ($11.25 in chips) 
Seat 3: loehc ($10.90 in chips) 
Seat 4: fish72o ($12.39 in chips) 
Seat 5: 19_Ips_87 ($9.66 in chips) 
fish72o: posts small blind $0.05
19_Ips_87: posts big blind $0.10
beastboy3690: sits out 
*** HOLE CARDS ***
Tyoma_Kovach: folds 
zebaztravez: raises $0.20 to $0.30
loehc: calls $0.30
fish72o: folds 
19_Ips_87: calls $0.20
*** FLOP *** [3h 8s 4h]
19_Ips_87: checks 
zebaztravez: checks 
loehc: bets $0.60
19_Ips_87: calls $0.60
zebaztravez: folds 
*** TURN *** [3h 8s 4h] [Jc]
19_Ips_87: checks 
loehc: checks 
*** RIVER *** [3h 8s 4h Jc] [7c]
19_Ips_87: bets $1.50
loehc: folds 
Uncalled bet ($1.50) returned to 19_Ips_87
19_Ips_87 collected $2.05 from pot
19_Ips_87: doesn't show hand 
*** SUMMARY ***
Total pot $2.15 | Rake $0.10 
Board [3h 8s 4h Jc 7c]
Seat 1: Tyoma_Kovach folded before Flop (didn't bet)
Seat 2: zebaztravez folded on the Flop
Seat 3: loehc (button) folded on the River
Seat 4: fish72o (small blind) folded before Flop
Seat 5: 19_Ips_87 (big blind) collected ($2.05)



PokerStars Hand #222946450191:  Hold'em No Limit ($0.05/$0.10 USD) - 2021/01/23 1:56:51 ET
Table 'Algieba III' 6-max Seat #4 is the button
Seat 1: Tyoma_Kovach ($13.18 in chips) 
Seat 2: zebaztravez ($10.95 in chips) 
Seat 3: loehc ($10 in chips) 
Seat 4: fish72o ($12.34 in chips) 
Tyoma_Kovach: posts small blind $0.05
zebaztravez: posts big blind $0.10
*** HOLE CARDS ***
loehc: folds 
19_Ips_87 is disconnected 
fish72o: raises $0.15 to $0.25
Tyoma_Kovach: folds 
zebaztravez: folds 
Uncalled bet ($0.15) returned to fish72o
fish72o collected $0.25 from pot
fish72o: doesn't show hand 
*** SUMMARY ***
Total pot $0.25 | Rake $0 
Seat 1: Tyoma_Kovach (small blind) folded before Flop
Seat 2: zebaztravez (big blind) folded before Flop
Seat 3: loehc folded before Flop (didn't bet)
Seat 4: fish72o (button) collected ($0.25)



PokerStars Hand #222946453651:  Hold'em No Limit ($0.05/$0.10 USD) - 2021/01/23 1:57:09 ET
Table 'Algieba III' 6-max Seat #1 is the button
Seat 1: Tyoma_Kovach ($13.13 in chips) 
Seat 2: zebaztravez ($10.85 in chips) 
Seat 3: loehc ($10 in chips) 
Seat 4: fish72o ($12.49 in chips) 
zebaztravez: posts small blind $0.05
loehc: posts big blind $0.10
beastboy3690: sits out 
*** HOLE CARDS ***
fish72o: folds 
Tyoma_Kovach: raises $0.15 to $0.25
zebaztravez: folds 
loehc: folds 
Uncalled bet ($0.15) returned to Tyoma_Kovach
Tyoma_Kovach collected $0.25 from pot
Tyoma_Kovach: doesn't show hand 
*** SUMMARY ***
Total pot $0.25 | Rake $0 
Seat 1: Tyoma_Kovach (button) collected ($0.25)
Seat 2: zebaztravez (small blind) folded before Flop
Seat 3: loehc (big blind) folded before Flop
Seat 4: fish72o folded before Flop (didn't bet)



PokerStars Hand #222946456687:  Hold'em No Limit ($0.05/$0.10 USD) - 2021/01/23 1:57:25 ET
Table 'Algieba III' 6-max Seat #2 is the button
Seat 1: Tyoma_Kovach ($13.28 in chips) 
Seat 2: zebaztravez ($10.80 in chips) 
Seat 3: loehc ($9.90 in chips) 
Seat 4: fish72o ($12.49 in chips) 
loehc: posts small blind $0.05
fish72o: posts big blind $0.10
beastboy3690: sits out 
*** HOLE CARDS ***
Tyoma_Kovach: folds 
zebaztravez: raises $0.16 to $0.26
loehc: folds 
fish72o: folds 
Uncalled bet ($0.16) returned to zebaztravez
zebaztravez collected $0.25 from pot
zebaztravez: doesn't show hand 
*** SUMMARY ***
Total pot $0.25 | Rake $0 
Seat 1: Tyoma_Kovach folded before Flop (didn't bet)
Seat 2: zebaztravez (button) collected ($0.25)
Seat 3: loehc (small blind) folded before Flop
Seat 4: fish72o (big blind) folded before Flop



PokerStars Hand #222946462586:  Hold'em No Limit ($0.05/$0.10 USD) - 2021/01/23 1:57:55 ET
Table 'Algieba III' 6-max Seat #3 is the button
Seat 1: Tyoma_Kovach ($13.28 in chips) 
Seat 2: zebaztravez ($10.95 in chips) 
Seat 3: loehc ($9.85 in chips) 
Seat 4: fish72o ($12.39 in chips) 
Seat 6: beastboy3690 ($10 in chips) 
fish72o: posts small blind $0.05
beastboy3690: posts big blind $0.10
*** HOLE CARDS ***
Tyoma_Kovach: folds 
zebaztravez: folds 
loehc: folds 
fish72o: raises $0.15 to $0.25
beastboy3690: folds 
Uncalled bet ($0.15) returned to fish72o
fish72o collected $0.20 from pot
fish72o: doesn't show hand 
*** SUMMARY ***
Total pot $0.20 | Rake $0 
Seat 1: Tyoma_Kovach folded before Flop (didn't bet)
Seat 2: zebaztravez folded before Flop (didn't bet)
Seat 3: loehc (button) folded before Flop (didn't bet)
Seat 4: fish72o (small blind) collected ($0.20)
Seat 6: beastboy3690 (big blind) folded before Flop



PokerStars Hand #222946468422:  Hold'em No Limit ($0.05/$0.10 USD) - 2021/01/23 1:58:26 ET
Table 'Algieba III' 6-max Seat #4 is the button
Seat 1: Tyoma_Kovach ($13.28 in chips) 
Seat 2: zebaztravez ($10.95 in chips) 
Seat 3: loehc ($9.85 in chips) 
Seat 4: fish72o ($12.49 in chips) 
Seat 6: beastboy3690 ($10 in chips) 
beastboy3690: posts small blind $0.05
Tyoma_Kovach: posts big blind $0.10
*** HOLE CARDS ***
zebaztravez: folds 
loehc: folds 
fish72o: folds 
beastboy3690: folds 
Uncalled bet ($0.05) returned to Tyoma_Kovach
Tyoma_Kovach collected $0.10 from pot
Tyoma_Kovach: doesn't show hand 
*** SUMMARY ***
Total pot $0.10 | Rake $0 
Seat 1: Tyoma_Kovach (big blind) collected ($0.10)
Seat 2: zebaztravez folded before Flop (didn't bet)
Seat 3: loehc folded before Flop (didn't bet)
Seat 4: fish72o (button) folded before Flop (didn't bet)
Seat 6: beastboy3690 (small blind) folded before Flop



PokerStars Hand #222946470371:  Hold'em No Limit ($0.05/$0.10 USD) - 2021/01/23 1:58:36 ET
Table 'Algieba III' 6-max Seat #6 is the button
Seat 1: Tyoma_Kovach ($13.33 in chips) 
Seat 2: zebaztravez ($10.95 in chips) 
Seat 3: loehc ($9.85 in chips) 
Seat 4: fish72o ($12.49 in chips) 
Seat 6: beastboy3690 ($10 in chips) 
Tyoma_Kovach: posts small blind $0.05
zebaztravez: posts big blind $0.10
*** HOLE CARDS ***
loehc: raises $0.17 to $0.27
fish72o: folds 
beastboy3690: folds 
Tyoma_Kovach: folds 
zebaztravez: folds 
Uncalled bet ($0.17) returned to loehc
loehc collected $0.25 from pot
loehc: doesn't show hand 
*** SUMMARY ***
Total pot $0.25 | Rake $0 
Seat 1: Tyoma_Kovach (small blind) folded before Flop
Seat 2: zebaztravez (big blind) folded before Flop
Seat 3: loehc collected ($0.25)
Seat 4: fish72o folded before Flop (didn't bet)
Seat 6: beastboy3690 (button) folded before Flop (didn't bet)



PokerStars Hand #222946476960:  Hold'em No Limit ($0.05/$0.10 USD) - 2021/01/23 1:59:10 ET
Table 'Algieba III' 6-max Seat #1 is the button
Seat 1: Tyoma_Kovach ($13.28 in chips) 
Seat 2: zebaztravez ($10.85 in chips) 
Seat 3: loehc ($10 in chips) 
Seat 4: fish72o ($12.49 in chips) 
Seat 6: beastboy3690 ($10 in chips) 
zebaztravez: posts small blind $0.05
loehc: posts big blind $0.10
*** HOLE CARDS ***
fish72o: raises $0.15 to $0.25
beastboy3690: folds 
Tyoma_Kovach: folds 
zebaztravez: folds 
loehc: raises $0.15 to $0.40
fish72o: calls $0.15
*** FLOP *** [8h 6h 6s]
loehc: bets $0.40
fish72o: calls $0.40
*** TURN *** [8h 6h 6s] [9s]
loehc: bets $1.06
fish72o: folds 
Uncalled bet ($1.06) returned to loehc
loehc collected $1.58 from pot
loehc: doesn't show hand 
*** SUMMARY ***
Total pot $1.65 | Rake $0.07 
Board [8h 6h 6s 9s]
Seat 1: Tyoma_Kovach (button) folded before Flop (didn't bet)
Seat 2: zebaztravez (small blind) folded before Flop
Seat 3: loehc (big blind) collected ($1.58)
Seat 4: fish72o folded on the Turn
Seat 6: beastboy3690 folded before Flop (didn't bet)



PokerStars Hand #222946484381:  Hold'em No Limit ($0.05/$0.10 USD) - 2021/01/23 1:59:48 ET
Table 'Algieba III' 6-max Seat #2 is the button
Seat 1: Tyoma_Kovach ($13.28 in chips) 
Seat 2: zebaztravez ($10.80 in chips) 
Seat 3: loehc ($10.78 in chips) 
Seat 6: beastboy3690 ($10 in chips) 
loehc: posts small blind $0.05
fish72o: is sitting out 
beastboy3690: posts big blind $0.10
*** HOLE CARDS ***
fish72o leaves the table
Tyoma_Kovach: folds 
zebaztravez: folds 
loehc: raises $0.10 to $0.20
beastboy3690: folds 
Uncalled bet ($0.10) returned to loehc
loehc collected $0.20 from pot
loehc: doesn't show hand 
*** SUMMARY ***
Total pot $0.20 | Rake $0 
Seat 1: Tyoma_Kovach folded before Flop (didn't bet)
Seat 2: zebaztravez (button) folded before Flop (didn't bet)
Seat 3: loehc (small blind) collected ($0.20)
Seat 6: beastboy3690 (big blind) folded before Flop



PokerStars Hand #222946487310:  Hold'em No Limit ($0.05/$0.10 USD) - 2021/01/23 2:00:03 ET
Table 'Algieba III' 6-max Seat #3 is the button
Seat 1: Tyoma_Kovach ($13.28 in chips) 
Seat 2: zebaztravez ($10.80 in chips) 
Seat 3: loehc ($10.88 in chips) 
Seat 6: beastboy3690 ($10 in chips) 
beastboy3690: posts small blind $0.05
Tyoma_Kovach: posts big blind $0.10
*** HOLE CARDS ***
zebaztravez: folds 
loehc: folds 
beastboy3690: raises $0.20 to $0.30
Tyoma_Kovach: folds 
Uncalled bet ($0.20) returned to beastboy3690
beastboy3690 collected $0.20 from pot
beastboy3690: doesn't show hand 
*** SUMMARY ***
Total pot $0.20 | Rake $0 
Seat 1: Tyoma_Kovach (big blind) folded before Flop
Seat 2: zebaztravez folded before Flop (didn't bet)
Seat 3: loehc (button) folded before Flop (didn't bet)
Seat 6: beastboy3690 (small blind) collected ($0.20)



PokerStars Hand #222946490201:  Hold'em No Limit ($0.05/$0.10 USD) - 2021/01/23 2:00:17 ET
Table 'Algieba III' 6-max Seat #6 is the button
Seat 1: Tyoma_Kovach ($13.18 in chips) 
Seat 2: zebaztravez ($10.80 in chips) 
Seat 3: loehc ($10.88 in chips) 
Seat 6: beastboy3690 ($10.10 in chips) 
Tyoma_Kovach: posts small blind $0.05
zebaztravez: posts big blind $0.10
*** HOLE CARDS ***
loehc: raises $0.13 to $0.23
beastboy3690: folds 
Tyoma_Kovach: folds 
zebaztravez: folds 
Uncalled bet ($0.13) returned to loehc
loehc collected $0.25 from pot
loehc: doesn't show hand 
*** SUMMARY ***
Total pot $0.25 | Rake $0 
Seat 1: Tyoma_Kovach (small blind) folded before Flop
Seat 2: zebaztravez (big blind) folded before Flop
Seat 3: loehc collected ($0.25)
Seat 6: beastboy3690 (button) folded before Flop (didn't bet)



PokerStars Hand #222946493893:  Hold'em No Limit ($0.05/$0.10 USD) - 2021/01/23 2:00:34 ET
Table 'Algieba III' 6-max Seat #1 is the button
Seat 1: Tyoma_Kovach ($13.13 in chips) 
Seat 2: zebaztravez ($10.70 in chips) 
Seat 3: loehc ($11.03 in chips) 
Seat 6: beastboy3690 ($10.10 in chips) 
zebaztravez: posts small blind $0.05
loehc: posts big blind $0.10
*** HOLE CARDS ***
beastboy3690: raises $0.20 to $0.30
Tyoma_Kovach: raises $0.67 to $0.97
zebaztravez: folds 
loehc: folds 
beastboy3690: folds 
Uncalled bet ($0.67) returned to Tyoma_Kovach
Tyoma_Kovach collected $0.75 from pot
Tyoma_Kovach: doesn't show hand 
*** SUMMARY ***
Total pot $0.75 | Rake $0 
Seat 1: Tyoma_Kovach (button) collected ($0.75)
Seat 2: zebaztravez (small blind) folded before Flop
Seat 3: loehc (big blind) folded before Flop
Seat 6: beastboy3690 folded before Flop



PokerStars Hand #222946498179:  Hold'em No Limit ($0.05/$0.10 USD) - 2021/01/23 2:00:53 ET
Table 'Algieba III' 6-max Seat #2 is the button
Seat 1: Tyoma_Kovach ($13.58 in chips) 
Seat 2: zebaztravez ($10.65 in chips) 
Seat 3: loehc ($10.93 in chips) 
loehc: posts small blind $0.05
beastboy3690: is sitting out 
Tyoma_Kovach: posts big blind $0.10
*** HOLE CARDS ***
zebaztravez: raises $0.16 to $0.26
beastboy3690 leaves the table
loehc: folds 
Tyoma_Kovach: folds 
Uncalled bet ($0.16) returned to zebaztravez
zebaztravez collected $0.25 from pot
19_Ips_87 was removed from the table for failing to post
19_Ips_87 leaves the table
zebaztravez: doesn't show hand 
*** SUMMARY ***
Total pot $0.25 | Rake $0 
Seat 1: Tyoma_Kovach (big blind) folded before Flop
Seat 2: zebaztravez (button) collected ($0.25)
Seat 3: loehc (small blind) folded before Flop



PokerStars Hand #222946500262:  Hold'em No Limit ($0.05/$0.10 USD) - 2021/01/23 2:01:02 ET
Table 'Algieba III' 6-max Seat #3 is the button
Seat 1: Tyoma_Kovach ($13.48 in chips) 
Seat 2: zebaztravez ($10.80 in chips) 
Seat 3: loehc ($10.88 in chips) 
Tyoma_Kovach: posts small blind $0.05
zebaztravez: posts big blind $0.10
*** HOLE CARDS ***
loehc: folds 
Tyoma_Kovach: folds 
Uncalled bet ($0.05) returned to zebaztravez
zebaztravez collected $0.10 from pot
zebaztravez: doesn't show hand 
*** SUMMARY ***
Total pot $0.10 | Rake $0 
Seat 1: Tyoma_Kovach (small blind) folded before Flop
Seat 2: zebaztravez (big blind) collected ($0.10)
Seat 3: loehc (button) folded before Flop (didn't bet)



PokerStars Hand #222946502961:  Hold'em No Limit ($0.05/$0.10 USD) - 2021/01/23 2:01:14 ET
Table 'Algieba III' 6-max Seat #1 is the button
Seat 1: Tyoma_Kovach ($13.43 in chips) 
Seat 2: zebaztravez ($10.85 in chips) 
Seat 3: loehc ($10.88 in chips) 
zebaztravez: posts small blind $0.05
loehc: posts big blind $0.10
*** HOLE CARDS ***
Tyoma_Kovach: raises $0.15 to $0.25
zebaztravez: folds 
loehc: calls $0.15
*** FLOP *** [2s 7h 6d]
loehc: bets $0.17
Tyoma_Kovach: raises $0.44 to $0.61
loehc: folds 
Uncalled bet ($0.44) returned to Tyoma_Kovach
Tyoma_Kovach collected $0.85 from pot
Tyoma_Kovach: doesn't show hand 
*** SUMMARY ***
Total pot $0.89 | Rake $0.04 
Board [2s 7h 6d]
Seat 1: Tyoma_Kovach (button) collected ($0.85)
Seat 2: zebaztravez (small blind) folded before Flop
Seat 3: loehc (big blind) folded on the Flop



PokerStars Hand #222946512295:  Hold'em No Limit ($0.05/$0.10 USD) - 2021/01/23 2:01:55 ET
Table 'Algieba III' 6-max Seat #2 is the button
Seat 1: Tyoma_Kovach ($13.86 in chips) 
Seat 2: zebaztravez ($10.80 in chips) 
Seat 3: loehc ($10.46 in chips) 
loehc: posts small blind $0.05
Tyoma_Kovach: posts big blind $0.10
*** HOLE CARDS ***
zebaztravez: raises $0.15 to $0.25
loehc: folds 
Tyoma_Kovach: folds 
Uncalled bet ($0.15) returned to zebaztravez
zebaztravez collected $0.25 from pot
zebaztravez: doesn't show hand 
*** SUMMARY ***
Total pot $0.25 | Rake $0 
Seat 1: Tyoma_Kovach (big blind) folded before Flop
Seat 2: zebaztravez (button) collected ($0.25)
Seat 3: loehc (small blind) folded before Flop



PokerStars Hand #222946514254:  Hold'em No Limit ($0.05/$0.10 USD) - 2021/01/23 2:02:03 ET
Table 'Algieba III' 6-max Seat #3 is the button
Seat 1: Tyoma_Kovach ($13.76 in chips) 
Seat 2: zebaztravez ($10.95 in chips) 
Seat 3: loehc ($10.41 in chips) 
Tyoma_Kovach: posts small blind $0.05
zebaztravez: posts big blind $0.10
*** HOLE CARDS ***
loehc: raises $0.10 to $0.20
Tyoma_Kovach: folds 
zebaztravez: folds 
Uncalled bet ($0.10) returned to loehc
loehc collected $0.25 from pot
loehc: doesn't show hand 
*** SUMMARY ***
Total pot $0.25 | Rake $0 
Seat 1: Tyoma_Kovach (small blind) folded before Flop
Seat 2: zebaztravez (big blind) folded before Flop
Seat 3: loehc (button) collected ($0.25)



PokerStars Hand #222946516092:  Hold'em No Limit ($0.05/$0.10 USD) - 2021/01/23 2:02:11 ET
Table 'Algieba III' 6-max Seat #1 is the button
Seat 1: Tyoma_Kovach ($13.71 in chips) 
Seat 2: zebaztravez ($10.85 in chips) 
Seat 3: loehc ($10.56 in chips) 
zebaztravez: posts small blind $0.05
loehc: posts big blind $0.10
*** HOLE CARDS ***
Tyoma_Kovach: folds 
zebaztravez: raises $0.20 to $0.30
loehc: calls $0.20
*** FLOP *** [Th 5h Td]
zebaztravez: bets $0.30
loehc: raises $0.30 to $0.60
zebaztravez: folds 
Uncalled bet ($0.30) returned to loehc
loehc collected $1.15 from pot
loehc: doesn't show hand 
*** SUMMARY ***
Total pot $1.20 | Rake $0.05 
Board [Th 5h Td]
Seat 1: Tyoma_Kovach (button) folded before Flop (didn't bet)
Seat 2: zebaztravez (small blind) folded on the Flop
Seat 3: loehc (big blind) collected ($1.15)



PokerStars Hand #222946522092:  Hold'em No Limit ($0.05/$0.10 USD) - 2021/01/23 2:02:37 ET
Table 'Algieba III' 6-max Seat #3 is the button
Seat 1: Tyoma_Kovach ($13.71 in chips) 
Seat 3: loehc ($11.11 in chips) 
loehc: posts small blind $0.05
Tyoma_Kovach: posts big blind $0.10
*** HOLE CARDS ***
loehc: calls $0.05
zebaztravez leaves the table
Tyoma_Kovach: checks 
*** FLOP *** [8s 2c Ts]
Tyoma_Kovach: checks 
loehc: bets $0.10
Tyoma_Kovach: folds 
Uncalled bet ($0.10) returned to loehc
loehc collected $0.19 from pot
loehc: doesn't show hand 
*** SUMMARY ***
Total pot $0.20 | Rake $0.01 
Board [8s 2c Ts]
Seat 1: Tyoma_Kovach (big blind) folded on the Flop
Seat 3: loehc (button) (small blind) collected ($0.19)



PokerStars Hand #222945432226:  Hold'em No Limit ($0.05/$0.10 USD) - 2021/01/23 0:47:38 ET
Table 'Algieba III' 6-max Seat #5 is the button
Seat 1: Tyoma_Kovach ($10.42 in chips) 
Seat 2: sixcoins ($14.16 in chips) 
Seat 3: thedude696969 ($31.09 in chips) 
Seat 4: fish72o ($12.01 in chips) 
Seat 5: johnnytrue ($13.64 in chips) 
Seat 6: Notatur ($10 in chips) 
Notatur: posts small blind $0.05
Tyoma_Kovach: posts big blind $0.10
*** HOLE CARDS ***
sixcoins: folds 
thedude696969: raises $0.16 to $0.26
fish72o: folds 
johnnytrue: folds 
Notatur: folds 
Tyoma_Kovach: calls $0.16
*** FLOP *** [2s 7s Kd]
Tyoma_Kovach: checks 
thedude696969: bets $0.34
Tyoma_Kovach: folds 
Uncalled bet ($0.34) returned to thedude696969
thedude696969 collected $0.54 from pot
thedude696969: doesn't show hand 
*** SUMMARY ***
Total pot $0.57 | Rake $0.03 
Board [2s 7s Kd]
Seat 1: Tyoma_Kovach (big blind) folded on the Flop
Seat 2: sixcoins folded before Flop (didn't bet)
Seat 3: thedude696969 collected ($0.54)
Seat 4: fish72o folded before Flop (didn't bet)
Seat 5: johnnytrue (button) folded before Flop (didn't bet)
Seat 6: Notatur (small blind) folded before Flop



PokerStars Hand #222945441478:  Hold'em No Limit ($0.05/$0.10 USD) - 2021/01/23 0:48:15 ET
Table 'Algieba III' 6-max Seat #6 is the button
Seat 1: Tyoma_Kovach ($10.16 in chips) 
Seat 2: sixcoins ($14.16 in chips) 
Seat 3: thedude696969 ($31.37 in chips) 
Seat 4: fish72o ($12.01 in chips) 
Seat 5: johnnytrue ($13.64 in chips) 
Seat 6: Notatur ($10 in chips) 
Tyoma_Kovach: posts small blind $0.05
sixcoins: posts big blind $0.10
*** HOLE CARDS ***
thedude696969: raises $0.13 to $0.23
fish72o: folds 
johnnytrue: folds 
Notatur: folds 
Tyoma_Kovach: folds 
sixcoins: folds 
Uncalled bet ($0.13) returned to thedude696969
thedude696969 collected $0.25 from pot
thedude696969: doesn't show hand 
*** SUMMARY ***
Total pot $0.25 | Rake $0 
Seat 1: Tyoma_Kovach (small blind) folded before Flop
Seat 2: sixcoins (big blind) folded before Flop
Seat 3: thedude696969 collected ($0.25)
Seat 4: fish72o folded before Flop (didn't bet)
Seat 5: johnnytrue folded before Flop (didn't bet)
Seat 6: Notatur (button) folded before Flop (didn't bet)



PokerStars Hand #222945445407:  Hold'em No Limit ($0.05/$0.10 USD) - 2021/01/23 0:48:30 ET
Table 'Algieba III' 6-max Seat #1 is the button
Seat 1: Tyoma_Kovach ($10.11 in chips) 
Seat 2: sixcoins ($14.06 in chips) 
Seat 3: thedude696969 ($31.52 in chips) 
Seat 4: fish72o ($12.01 in chips) 
Seat 5: johnnytrue ($13.64 in chips) 
Seat 6: Notatur ($10 in chips) 
sixcoins: posts small blind $0.05
thedude696969: posts big blind $0.10
*** HOLE CARDS ***
fish72o: folds 
johnnytrue: folds 
Notatur has timed out
Notatur: folds 
Tyoma_Kovach: folds 
sixcoins: folds 
Uncalled bet ($0.05) returned to thedude696969
thedude696969 collected $0.10 from pot
thedude696969: doesn't show hand 
*** SUMMARY ***
Total pot $0.10 | Rake $0 
Seat 1: Tyoma_Kovach (button) folded before Flop (didn't bet)
Seat 2: sixcoins (small blind) folded before Flop
Seat 3: thedude696969 (big blind) collected ($0.10)
Seat 4: fish72o folded before Flop (didn't bet)
Seat 5: johnnytrue folded before Flop (didn't bet)
Seat 6: Notatur folded before Flop (didn't bet)



PokerStars Hand #222945450599:  Hold'em No Limit ($0.05/$0.10 USD) - 2021/01/23 0:48:50 ET
Table 'Algieba III' 6-max Seat #2 is the button
Seat 1: Tyoma_Kovach ($10.11 in chips) 
Seat 2: sixcoins ($14.01 in chips) 
Seat 3: thedude696969 ($31.57 in chips) 
Seat 4: fish72o ($12.01 in chips) 
Seat 5: johnnytrue ($13.64 in chips) 
Seat 6: Notatur ($10 in chips) 
thedude696969: posts small blind $0.05
fish72o: posts big blind $0.10
*** HOLE CARDS ***
johnnytrue: folds 
Notatur: folds 
Tyoma_Kovach: folds 
sixcoins: folds 
thedude696969: raises $0.20 to $0.30
fish72o: folds 
Uncalled bet ($0.20) returned to thedude696969
thedude696969 collected $0.20 from pot
thedude696969: doesn't show hand 
*** SUMMARY ***
Total pot $0.20 | Rake $0 
Seat 1: Tyoma_Kovach folded before Flop (didn't bet)
Seat 2: sixcoins (button) folded before Flop (didn't bet)
Seat 3: thedude696969 (small blind) collected ($0.20)
Seat 4: fish72o (big blind) folded before Flop
Seat 5: johnnytrue folded before Flop (didn't bet)
Seat 6: Notatur folded before Flop (didn't bet)



PokerStars Hand #222945455197:  Hold'em No Limit ($0.05/$0.10 USD) - 2021/01/23 0:49:08 ET
Table 'Algieba III' 6-max Seat #3 is the button
Seat 1: Tyoma_Kovach ($10.11 in chips) 
Seat 2: sixcoins ($14.01 in chips) 
Seat 3: thedude696969 ($31.67 in chips) 
Seat 4: fish72o ($11.91 in chips) 
Seat 5: johnnytrue ($13.64 in chips) 
Seat 6: Notatur ($10 in chips) 
fish72o: posts small blind $0.05
johnnytrue: posts big blind $0.10
*** HOLE CARDS ***
Notatur: raises $0.15 to $0.25
Tyoma_Kovach: folds 
sixcoins: folds 
thedude696969: folds 
fish72o: folds 
johnnytrue: calls $0.15
*** FLOP *** [3h Kh Ts]
johnnytrue: checks 
Notatur: checks 
*** TURN *** [3h Kh Ts] [4d]
johnnytrue: bets $0.10
Notatur: calls $0.10
*** RIVER *** [3h Kh Ts 4d] [9c]
johnnytrue: checks 
Notatur: checks 
*** SHOW DOWN ***
johnnytrue: shows [Kc 8c] (a pair of Kings)
Notatur: mucks hand 
johnnytrue collected $0.72 from pot
*** SUMMARY ***
Total pot $0.75 | Rake $0.03 
Board [3h Kh Ts 4d 9c]
Seat 1: Tyoma_Kovach folded before Flop (didn't bet)
Seat 2: sixcoins folded before Flop (didn't bet)
Seat 3: thedude696969 (button) folded before Flop (didn't bet)
Seat 4: fish72o (small blind) folded before Flop
Seat 5: johnnytrue (big blind) showed [Kc 8c] and won ($0.72) with a pair of Kings
Seat 6: Notatur mucked



PokerStars Hand #222945467085:  Hold'em No Limit ($0.05/$0.10 USD) - 2021/01/23 0:49:55 ET
Table 'Algieba III' 6-max Seat #4 is the button
Seat 1: Tyoma_Kovach ($10.11 in chips) 
Seat 2: sixcoins ($14.01 in chips) 
Seat 3: thedude696969 ($31.67 in chips) 
Seat 4: fish72o ($11.86 in chips) 
Seat 5: johnnytrue ($14.01 in chips) 
Seat 6: Notatur ($10 in chips) 
johnnytrue: posts small blind $0.05
Notatur: posts big blind $0.10
*** HOLE CARDS ***
Tyoma_Kovach: folds 
sixcoins: folds 
thedude696969: folds 
fish72o: folds 
johnnytrue: calls $0.05
Notatur: checks 
*** FLOP *** [2s Kc 5c]
johnnytrue: checks 
Notatur: checks 
*** TURN *** [2s Kc 5c] [Ts]
johnnytrue: checks 
Notatur: checks 
*** RIVER *** [2s Kc 5c Ts] [Kh]
johnnytrue: checks 
Notatur: checks 
*** SHOW DOWN ***
johnnytrue: shows [8s 5d] (two pair, Kings and Fives)
Notatur: mucks hand 
johnnytrue collected $0.19 from pot
*** SUMMARY ***
Total pot $0.20 | Rake $0.01 
Board [2s Kc 5c Ts Kh]
Seat 1: Tyoma_Kovach folded before Flop (didn't bet)
Seat 2: sixcoins folded before Flop (didn't bet)
Seat 3: thedude696969 folded before Flop (didn't bet)
Seat 4: fish72o (button) folded before Flop (didn't bet)
Seat 5: johnnytrue (small blind) showed [8s 5d] and won ($0.19) with two pair, Kings and Fives
Seat 6: Notatur (big blind) mucked



PokerStars Hand #222945479433:  Hold'em No Limit ($0.05/$0.10 USD) - 2021/01/23 0:50:43 ET
Table 'Algieba III' 6-max Seat #5 is the button
Seat 1: Tyoma_Kovach ($10.11 in chips) 
Seat 2: sixcoins ($14.01 in chips) 
Seat 3: thedude696969 ($31.67 in chips) 
Seat 4: fish72o ($11.86 in chips) 
Seat 5: johnnytrue ($14.10 in chips) 
Seat 6: Notatur ($10 in chips) 
Notatur: posts small blind $0.05
Tyoma_Kovach: posts big blind $0.10
*** HOLE CARDS ***
sixcoins: folds 
thedude696969: raises $0.20 to $0.30
fish72o: folds 
johnnytrue: folds 
Notatur: folds 
Tyoma_Kovach: folds 
Uncalled bet ($0.20) returned to thedude696969
thedude696969 collected $0.25 from pot
thedude696969: doesn't show hand 
*** SUMMARY ***
Total pot $0.25 | Rake $0 
Seat 1: Tyoma_Kovach (big blind) folded before Flop
Seat 2: sixcoins folded before Flop (didn't bet)
Seat 3: thedude696969 collected ($0.25)
Seat 4: fish72o folded before Flop (didn't bet)
Seat 5: johnnytrue (button) folded before Flop (didn't bet)
Seat 6: Notatur (small blind) folded before Flop



PokerStars Hand #222945483637:  Hold'em No Limit ($0.05/$0.10 USD) - 2021/01/23 0:51:00 ET
Table 'Algieba III' 6-max Seat #6 is the button
Seat 1: Tyoma_Kovach ($10.01 in chips) 
Seat 2: sixcoins ($14.01 in chips) 
Seat 3: thedude696969 ($31.82 in chips) 
Seat 4: fish72o ($11.86 in chips) 
Seat 5: johnnytrue ($14.10 in chips) 
Seat 6: Notatur ($10 in chips) 
Tyoma_Kovach: posts small blind $0.05
sixcoins: posts big blind $0.10
*** HOLE CARDS ***
thedude696969: folds 
fish72o: folds 
johnnytrue: folds 
Notatur: folds 
Tyoma_Kovach: folds 
Uncalled bet ($0.05) returned to sixcoins
sixcoins collected $0.10 from pot
sixcoins: doesn't show hand 
*** SUMMARY ***
Total pot $0.10 | Rake $0 
Seat 1: Tyoma_Kovach (small blind) folded before Flop
Seat 2: sixcoins (big blind) collected ($0.10)
Seat 3: thedude696969 folded before Flop (didn't bet)
Seat 4: fish72o folded before Flop (didn't bet)
Seat 5: johnnytrue folded before Flop (didn't bet)
Seat 6: Notatur (button) folded before Flop (didn't bet)



PokerStars Hand #222945487056:  Hold'em No Limit ($0.05/$0.10 USD) - 2021/01/23 0:51:14 ET
Table 'Algieba III' 6-max Seat #1 is the button
Seat 1: Tyoma_Kovach ($10 in chips) 
Seat 2: sixcoins ($14.06 in chips) 
Seat 3: thedude696969 ($31.82 in chips) 
Seat 4: fish72o ($11.86 in chips) 
Seat 5: johnnytrue ($14.10 in chips) 
Seat 6: Notatur ($10 in chips) 
sixcoins: posts small blind $0.05
thedude696969: posts big blind $0.10
*** HOLE CARDS ***
fish72o: folds 
johnnytrue: calls $0.10
Notatur: folds 
Tyoma_Kovach: folds 
sixcoins: raises $0.20 to $0.30
thedude696969: folds 
johnnytrue: calls $0.20
*** FLOP *** [Td Tc 8d]
sixcoins: checks 
johnnytrue: checks 
*** TURN *** [Td Tc 8d] [8c]
sixcoins: bets $0.10
johnnytrue: calls $0.10
*** RIVER *** [Td Tc 8d 8c] [Jh]
sixcoins: bets $0.43
johnnytrue: folds 
Uncalled bet ($0.43) returned to sixcoins
sixcoins collected $0.86 from pot
sixcoins: doesn't show hand 
*** SUMMARY ***
Total pot $0.90 | Rake $0.04 
Board [Td Tc 8d 8c Jh]
Seat 1: Tyoma_Kovach (button) folded before Flop (didn't bet)
Seat 2: sixcoins (small blind) collected ($0.86)
Seat 3: thedude696969 (big blind) folded before Flop
Seat 4: fish72o folded before Flop (didn't bet)
Seat 5: johnnytrue folded on the River
Seat 6: Notatur folded before Flop (didn't bet)



PokerStars Hand #222945502490:  Hold'em No Limit ($0.05/$0.10 USD) - 2021/01/23 0:52:15 ET
Table 'Algieba III' 6-max Seat #2 is the button
Seat 1: Tyoma_Kovach ($10 in chips) 
Seat 2: sixcoins ($14.52 in chips) 
Seat 3: thedude696969 ($31.72 in chips) 
Seat 4: fish72o ($11.86 in chips) 
Seat 5: johnnytrue ($13.70 in chips) 
Seat 6: Notatur ($10 in chips) 
thedude696969: posts small blind $0.05
fish72o: posts big blind $0.10
*** HOLE CARDS ***
johnnytrue: folds 
Notatur: folds 
Tyoma_Kovach: raises $0.18 to $0.28
sixcoins: folds 
thedude696969: folds 
fish72o: calls $0.18
*** FLOP *** [Ts Ad 5h]
fish72o: checks 
Tyoma_Kovach: bets $0.19
fish72o: calls $0.19
*** TURN *** [Ts Ad 5h] [7c]
fish72o: checks 
Tyoma_Kovach: checks 
*** RIVER *** [Ts Ad 5h 7c] [Js]
fish72o: checks 
Tyoma_Kovach: checks 
*** SHOW DOWN ***
fish72o: shows [As 8s] (a pair of Aces)
Tyoma_Kovach: mucks hand 
fish72o collected $0.95 from pot
*** SUMMARY ***
Total pot $0.99 | Rake $0.04 
Board [Ts Ad 5h 7c Js]
Seat 1: Tyoma_Kovach mucked
Seat 2: sixcoins (button) folded before Flop (didn't bet)
Seat 3: thedude696969 (small blind) folded before Flop
Seat 4: fish72o (big blind) showed [As 8s] and won ($0.95) with a pair of Aces
Seat 5: johnnytrue folded before Flop (didn't bet)
Seat 6: Notatur folded before Flop (didn't bet)



PokerStars Hand #222945512523:  Hold'em No Limit ($0.05/$0.10 USD) - 2021/01/23 0:52:54 ET
Table 'Algieba III' 6-max Seat #3 is the button
Seat 1: Tyoma_Kovach ($10 in chips) 
Seat 2: sixcoins ($14.52 in chips) 
Seat 3: thedude696969 ($31.67 in chips) 
Seat 4: fish72o ($12.34 in chips) 
Seat 5: johnnytrue ($13.70 in chips) 
Seat 6: Notatur ($10 in chips) 
fish72o: posts small blind $0.05
johnnytrue: posts big blind $0.10
*** HOLE CARDS ***
Notatur: folds 
Tyoma_Kovach: folds 
sixcoins: folds 
thedude696969: raises $0.20 to $0.30
fish72o: folds 
johnnytrue: folds 
Uncalled bet ($0.20) returned to thedude696969
thedude696969 collected $0.25 from pot
thedude696969: doesn't show hand 
*** SUMMARY ***
Total pot $0.25 | Rake $0 
Seat 1: Tyoma_Kovach folded before Flop (didn't bet)
Seat 2: sixcoins folded before Flop (didn't bet)
Seat 3: thedude696969 (button) collected ($0.25)
Seat 4: fish72o (small blind) folded before Flop
Seat 5: johnnytrue (big blind) folded before Flop
Seat 6: Notatur folded before Flop (didn't bet)



PokerStars Hand #222945524657:  Hold'em No Limit ($0.05/$0.10 USD) - 2021/01/23 0:53:14 ET
Table 'Algieba III' 6-max Seat #4 is the button
Seat 1: Tyoma_Kovach ($10 in chips) 
Seat 2: sixcoins ($14.52 in chips) 
Seat 3: thedude696969 ($31.82 in chips) 
Seat 4: fish72o ($12.29 in chips) 
Seat 5: johnnytrue ($13.60 in chips) 
Seat 6: Notatur ($10 in chips) 
johnnytrue: posts small blind $0.05
Notatur: posts big blind $0.10
*** HOLE CARDS ***
Tyoma_Kovach: folds 
sixcoins: folds 
thedude696969: folds 
fish72o: raises $0.15 to $0.25
johnnytrue: folds 
Notatur: folds 
Uncalled bet ($0.15) returned to fish72o
fish72o collected $0.25 from pot
fish72o: doesn't show hand 
*** SUMMARY ***
Total pot $0.25 | Rake $0 
Seat 1: Tyoma_Kovach folded before Flop (didn't bet)
Seat 2: sixcoins folded before Flop (didn't bet)
Seat 3: thedude696969 folded before Flop (didn't bet)
Seat 4: fish72o (button) collected ($0.25)
Seat 5: johnnytrue (small blind) folded before Flop
Seat 6: Notatur (big blind) folded before Flop



PokerStars Hand #222945528038:  Hold'em No Limit ($0.05/$0.10 USD) - 2021/01/23 0:53:27 ET
Table 'Algieba III' 6-max Seat #5 is the button
Seat 1: Tyoma_Kovach ($10 in chips) 
Seat 2: sixcoins ($14.52 in chips) 
Seat 3: thedude696969 ($31.82 in chips) 
Seat 4: fish72o ($12.44 in chips) 
Seat 5: johnnytrue ($13.55 in chips) 
Seat 6: Notatur ($10 in chips) 
Notatur: posts small blind $0.05
Tyoma_Kovach: posts big blind $0.10
*** HOLE CARDS ***
sixcoins: folds 
thedude696969: folds 
fish72o: folds 
johnnytrue: calls $0.10
Notatur: folds 
Tyoma_Kovach: checks 
*** FLOP *** [Kh 8c 6s]
Tyoma_Kovach: checks 
johnnytrue: bets $0.24
Tyoma_Kovach: folds 
Uncalled bet ($0.24) returned to johnnytrue
johnnytrue collected $0.24 from pot
*** SUMMARY ***
Total pot $0.25 | Rake $0.01 
Board [Kh 8c 6s]
Seat 1: Tyoma_Kovach (big blind) folded on the Flop
Seat 2: sixcoins folded before Flop (didn't bet)
Seat 3: thedude696969 folded before Flop (didn't bet)
Seat 4: fish72o folded before Flop (didn't bet)
Seat 5: johnnytrue (button) collected ($0.24)
Seat 6: Notatur (small blind) folded before Flop



PokerStars Hand #222945535545:  Hold'em No Limit ($0.05/$0.10 USD) - 2021/01/23 0:53:57 ET
Table 'Algieba III' 6-max Seat #6 is the button
Seat 1: Tyoma_Kovach ($10 in chips) 
Seat 2: sixcoins ($14.52 in chips) 
Seat 3: thedude696969 ($31.82 in chips) 
Seat 4: fish72o ($12.44 in chips) 
Seat 5: johnnytrue ($13.69 in chips) 
Seat 6: Notatur ($10 in chips) 
Tyoma_Kovach: posts small blind $0.05
sixcoins: posts big blind $0.10
*** HOLE CARDS ***
thedude696969: folds 
fish72o: folds 
johnnytrue: folds 
Notatur: raises $0.15 to $0.25
Tyoma_Kovach: folds 
sixcoins: calls $0.15
*** FLOP *** [7h 5d 3h]
sixcoins: checks 
Notatur: checks 
*** TURN *** [7h 5d 3h] [2s]
sixcoins: checks 
Notatur: checks 
*** RIVER *** [7h 5d 3h 2s] [Jc]
sixcoins: checks 
Notatur: bets $0.29
sixcoins: calls $0.29
*** SHOW DOWN ***
Notatur: shows [Jh Qd] (a pair of Jacks)
sixcoins: mucks hand 
Notatur collected $1.08 from pot
*** SUMMARY ***
Total pot $1.13 | Rake $0.05 
Board [7h 5d 3h 2s Jc]
Seat 1: Tyoma_Kovach (small blind) folded before Flop
Seat 2: sixcoins (big blind) mucked
Seat 3: thedude696969 folded before Flop (didn't bet)
Seat 4: fish72o folded before Flop (didn't bet)
Seat 5: johnnytrue folded before Flop (didn't bet)
Seat 6: Notatur (button) showed [Jh Qd] and won ($1.08) with a pair of Jacks



PokerStars Hand #222945550216:  Hold'em No Limit ($0.05/$0.10 USD) - 2021/01/23 0:54:56 ET
Table 'Algieba III' 6-max Seat #1 is the button
Seat 1: Tyoma_Kovach ($10 in chips) 
Seat 2: sixcoins ($13.98 in chips) 
Seat 3: thedude696969 ($31.82 in chips) 
Seat 4: fish72o ($12.44 in chips) 
Seat 5: johnnytrue ($13.69 in chips) 
Seat 6: Notatur ($10.54 in chips) 
sixcoins: posts small blind $0.05
thedude696969: posts big blind $0.10
*** HOLE CARDS ***
fish72o: folds 
johnnytrue: folds 
Notatur: folds 
Tyoma_Kovach: raises $0.15 to $0.25
sixcoins: folds 
thedude696969: calls $0.15
*** FLOP *** [3s Ts 5d]
thedude696969: checks 
Tyoma_Kovach: bets $0.40
thedude696969: folds 
Uncalled bet ($0.40) returned to Tyoma_Kovach
Tyoma_Kovach collected $0.53 from pot
Tyoma_Kovach: doesn't show hand 
*** SUMMARY ***
Total pot $0.55 | Rake $0.02 
Board [3s Ts 5d]
Seat 1: Tyoma_Kovach (button) collected ($0.53)
Seat 2: sixcoins (small blind) folded before Flop
Seat 3: thedude696969 (big blind) folded on the Flop
Seat 4: fish72o folded before Flop (didn't bet)
Seat 5: johnnytrue folded before Flop (didn't bet)
Seat 6: Notatur folded before Flop (didn't bet)



PokerStars Hand #222945557952:  Hold'em No Limit ($0.05/$0.10 USD) - 2021/01/23 0:55:32 ET
Table 'Algieba III' 6-max Seat #2 is the button
Seat 1: Tyoma_Kovach ($10.28 in chips) 
Seat 2: sixcoins ($13.93 in chips) 
Seat 3: thedude696969 ($31.57 in chips) 
Seat 4: fish72o ($12.44 in chips) 
Seat 5: johnnytrue ($13.69 in chips) 
Seat 6: Notatur ($10.54 in chips) 
thedude696969: posts small blind $0.05
fish72o: posts big blind $0.10
*** HOLE CARDS ***
johnnytrue: folds 
Notatur: folds 
Tyoma_Kovach: raises $0.18 to $0.28
sixcoins: folds 
thedude696969: folds 
fish72o: folds 
Uncalled bet ($0.18) returned to Tyoma_Kovach
Tyoma_Kovach collected $0.25 from pot
Tyoma_Kovach: doesn't show hand 
*** SUMMARY ***
Total pot $0.25 | Rake $0 
Seat 1: Tyoma_Kovach collected ($0.25)
Seat 2: sixcoins (button) folded before Flop (didn't bet)
Seat 3: thedude696969 (small blind) folded before Flop
Seat 4: fish72o (big blind) folded before Flop
Seat 5: johnnytrue folded before Flop (didn't bet)
Seat 6: Notatur folded before Flop (didn't bet)



PokerStars Hand #222945568729:  Hold'em No Limit ($0.05/$0.10 USD) - 2021/01/23 0:56:26 ET
Table 'Algieba III' 6-max Seat #4 is the button
Seat 1: Tyoma_Kovach ($10.13 in chips) 
Seat 2: sixcoins ($13.63 in chips) 
Seat 3: thedude696969 ($32.22 in chips) 
Seat 4: fish72o ($12.29 in chips) 
Seat 5: johnnytrue ($13.59 in chips) 
Seat 6: Notatur ($10.54 in chips) 
johnnytrue: posts small blind $0.05
Notatur: posts big blind $0.10
*** HOLE CARDS ***
Tyoma_Kovach: folds 
sixcoins: folds 
thedude696969: folds 
fish72o: raises $0.15 to $0.25
johnnytrue: calls $0.20
Notatur: calls $0.15
*** FLOP *** [Jd 8s 2c]
johnnytrue: checks 
Notatur: checks 
fish72o: bets $0.24
johnnytrue: folds 
Notatur: folds 
Uncalled bet ($0.24) returned to fish72o
fish72o collected $0.72 from pot
fish72o: doesn't show hand 
*** SUMMARY ***
Total pot $0.75 | Rake $0.03 
Board [Jd 8s 2c]
Seat 1: Tyoma_Kovach folded before Flop (didn't bet)
Seat 2: sixcoins folded before Flop (didn't bet)
Seat 3: thedude696969 folded before Flop (didn't bet)
Seat 4: fish72o (button) collected ($0.72)
Seat 5: johnnytrue (small blind) folded on the Flop
Seat 6: Notatur (big blind) folded on the Flop



PokerStars Hand #222945577272:  Hold'em No Limit ($0.05/$0.10 USD) - 2021/01/23 0:57:09 ET
Table 'Algieba III' 6-max Seat #5 is the button
Seat 1: Tyoma_Kovach ($10.13 in chips) 
Seat 2: sixcoins ($13.63 in chips) 
Seat 3: thedude696969 ($32.22 in chips) 
Seat 4: fish72o ($12.76 in chips) 
Seat 5: johnnytrue ($13.34 in chips) 
Seat 6: Notatur ($10.29 in chips) 
Notatur: posts small blind $0.05
Tyoma_Kovach: posts big blind $0.10
*** HOLE CARDS ***
sixcoins: folds 
thedude696969: raises $0.20 to $0.30
fish72o: folds 
johnnytrue: folds 
Notatur: folds 
Tyoma_Kovach: folds 
Uncalled bet ($0.20) returned to thedude696969
thedude696969 collected $0.25 from pot
thedude696969: doesn't show hand 
*** SUMMARY ***
Total pot $0.25 | Rake $0 
Seat 1: Tyoma_Kovach (big blind) folded before Flop
Seat 2: sixcoins folded before Flop (didn't bet)
Seat 3: thedude696969 collected ($0.25)
Seat 4: fish72o folded before Flop (didn't bet)
Seat 5: johnnytrue (button) folded before Flop (didn't bet)
Seat 6: Notatur (small blind) folded before Flop



PokerStars Hand #222945580396:  Hold'em No Limit ($0.05/$0.10 USD) - 2021/01/23 0:57:24 ET
Table 'Algieba III' 6-max Seat #6 is the button
Seat 1: Tyoma_Kovach ($10.03 in chips) 
Seat 2: sixcoins ($13.63 in chips) 
Seat 3: thedude696969 ($32.37 in chips) 
Seat 4: fish72o ($12.76 in chips) 
Seat 5: johnnytrue ($13.34 in chips) 
Seat 6: Notatur ($10.24 in chips) 
Tyoma_Kovach: posts small blind $0.05
sixcoins: posts big blind $0.10
*** HOLE CARDS ***
thedude696969: folds 
fish72o: folds 
johnnytrue: folds 
Notatur: raises $0.15 to $0.25
Tyoma_Kovach: raises $0.75 to $1
sixcoins: folds 
Notatur: folds 
Uncalled bet ($0.75) returned to Tyoma_Kovach
Tyoma_Kovach collected $0.60 from pot
Tyoma_Kovach: doesn't show hand 
*** SUMMARY ***
Total pot $0.60 | Rake $0 
Seat 1: Tyoma_Kovach (small blind) collected ($0.60)
Seat 2: sixcoins (big blind) folded before Flop
Seat 3: thedude696969 folded before Flop (didn't bet)
Seat 4: fish72o folded before Flop (didn't bet)
Seat 5: johnnytrue folded before Flop (didn't bet)
Seat 6: Notatur (button) folded before Flop



PokerStars Hand #222945585613:  Hold'em No Limit ($0.05/$0.10 USD) - 2021/01/23 0:57:50 ET
Table 'Algieba III' 6-max Seat #1 is the button
Seat 1: Tyoma_Kovach ($10.38 in chips) 
Seat 2: sixcoins ($13.53 in chips) 
Seat 3: thedude696969 ($32.37 in chips) 
Seat 4: fish72o ($12.76 in chips) 
Seat 5: johnnytrue ($13.34 in chips) 
Seat 6: Notatur ($10 in chips) 
sixcoins: posts small blind $0.05
thedude696969: posts big blind $0.10
*** HOLE CARDS ***
fish72o: folds 
johnnytrue: folds 
Notatur: folds 
Tyoma_Kovach: folds 
sixcoins: raises $0.20 to $0.30
thedude696969: raises $1 to $1.30
sixcoins: calls $1
*** FLOP *** [Kd 6c 2s]
sixcoins: checks 
thedude696969: bets $1.60
sixcoins: folds 
Uncalled bet ($1.60) returned to thedude696969
thedude696969 collected $2.48 from pot
thedude696969: doesn't show hand 
*** SUMMARY ***
Total pot $2.60 | Rake $0.12 
Board [Kd 6c 2s]
Seat 1: Tyoma_Kovach (button) folded before Flop (didn't bet)
Seat 2: sixcoins (small blind) folded on the Flop
Seat 3: thedude696969 (big blind) collected ($2.48)
Seat 4: fish72o folded before Flop (didn't bet)
Seat 5: johnnytrue folded before Flop (didn't bet)
Seat 6: Notatur folded before Flop (didn't bet)



PokerStars Hand #222945594122:  Hold'em No Limit ($0.05/$0.10 USD) - 2021/01/23 0:58:33 ET
Table 'Algieba III' 6-max Seat #2 is the button
Seat 1: Tyoma_Kovach ($10.38 in chips) 
Seat 2: sixcoins ($12.23 in chips) 
Seat 3: thedude696969 ($33.55 in chips) 
Seat 4: fish72o ($12.76 in chips) 
Seat 5: johnnytrue ($13.34 in chips) 
Seat 6: Notatur ($10 in chips) 
thedude696969: posts small blind $0.05
fish72o: posts big blind $0.10
*** HOLE CARDS ***
johnnytrue: folds 
Notatur: folds 
Tyoma_Kovach: folds 
sixcoins: raises $0.20 to $0.30
thedude696969: folds 
fish72o: folds 
Uncalled bet ($0.20) returned to sixcoins
sixcoins collected $0.25 from pot
sixcoins: doesn't show hand 
*** SUMMARY ***
Total pot $0.25 | Rake $0 
Seat 1: Tyoma_Kovach folded before Flop (didn't bet)
Seat 2: sixcoins (button) collected ($0.25)
Seat 3: thedude696969 (small blind) folded before Flop
Seat 4: fish72o (big blind) folded before Flop
Seat 5: johnnytrue folded before Flop (didn't bet)
Seat 6: Notatur folded before Flop (didn't bet)



PokerStars Hand #222945598482:  Hold'em No Limit ($0.05/$0.10 USD) - 2021/01/23 0:58:55 ET
Table 'Algieba III' 6-max Seat #3 is the button
Seat 1: Tyoma_Kovach ($10.38 in chips) 
Seat 2: sixcoins ($12.38 in chips) 
Seat 3: thedude696969 ($33.50 in chips) 
Seat 4: fish72o ($12.66 in chips) 
Seat 5: johnnytrue ($13.34 in chips) 
Seat 6: Notatur ($10 in chips) 
fish72o: posts small blind $0.05
johnnytrue: posts big blind $0.10
*** HOLE CARDS ***
Notatur: raises $0.15 to $0.25
Tyoma_Kovach: folds 
sixcoins: folds 
thedude696969: calls $0.25
fish72o: calls $0.20
johnnytrue: folds 
*** FLOP *** [8c Qs Ad]
fish72o: checks 
Notatur: bets $0.27
thedude696969: raises $1.13 to $1.40
fish72o: folds 
Notatur: calls $1.13
*** TURN *** [8c Qs Ad] [Qd]
Notatur: checks 
thedude696969: bets $2.35
Notatur: folds 
Uncalled bet ($2.35) returned to thedude696969
thedude696969 collected $3.49 from pot
thedude696969: doesn't show hand 
*** SUMMARY ***
Total pot $3.65 | Rake $0.16 
Board [8c Qs Ad Qd]
Seat 1: Tyoma_Kovach folded before Flop (didn't bet)
Seat 2: sixcoins folded before Flop (didn't bet)
Seat 3: thedude696969 (button) collected ($3.49)
Seat 4: fish72o (small blind) folded on the Flop
Seat 5: johnnytrue (big blind) folded before Flop
Seat 6: Notatur folded on the Turn



PokerStars Hand #222945613441:  Hold'em No Limit ($0.05/$0.10 USD) - 2021/01/23 1:00:09 ET
Table 'Algieba III' 6-max Seat #4 is the button
Seat 1: Tyoma_Kovach ($10.38 in chips) 
Seat 2: sixcoins ($12.38 in chips) 
Seat 3: thedude696969 ($35.34 in chips) 
Seat 4: fish72o ($12.41 in chips) 
Seat 5: johnnytrue ($13.24 in chips) 
Seat 6: Notatur ($10 in chips) 
johnnytrue: posts small blind $0.05
Notatur: posts big blind $0.10
*** HOLE CARDS ***
Tyoma_Kovach: folds 
sixcoins: folds 
thedude696969: folds 
fish72o: raises $0.15 to $0.25
johnnytrue: folds 
Notatur: folds 
Uncalled bet ($0.15) returned to fish72o
fish72o collected $0.25 from pot
fish72o: doesn't show hand 
*** SUMMARY ***
Total pot $0.25 | Rake $0 
Seat 1: Tyoma_Kovach folded before Flop (didn't bet)
Seat 2: sixcoins folded before Flop (didn't bet)
Seat 3: thedude696969 folded before Flop (didn't bet)
Seat 4: fish72o (button) collected ($0.25)
Seat 5: johnnytrue (small blind) folded before Flop
Seat 6: Notatur (big blind) folded before Flop



PokerStars Hand #222945619154:  Hold'em No Limit ($0.05/$0.10 USD) - 2021/01/23 1:00:33 ET
Table 'Algieba III' 6-max Seat #5 is the button
Seat 1: Tyoma_Kovach ($10.38 in chips) 
Seat 2: sixcoins ($12.38 in chips) 
Seat 3: thedude696969 ($35.34 in chips) 
Seat 4: fish72o ($12.56 in chips) 
Seat 5: johnnytrue ($13.19 in chips) 
Seat 6: Notatur ($10 in chips) 
Notatur: posts small blind $0.05
Tyoma_Kovach: posts big blind $0.10
*** HOLE CARDS ***
sixcoins: folds 
thedude696969: folds 
fish72o: folds 
johnnytrue: calls $0.10
Notatur: folds 
Tyoma_Kovach: raises $0.36 to $0.46
johnnytrue: folds 
Uncalled bet ($0.36) returned to Tyoma_Kovach
Tyoma_Kovach collected $0.25 from pot
Tyoma_Kovach: doesn't show hand 
*** SUMMARY ***
Total pot $0.25 | Rake $0 
Seat 1: Tyoma_Kovach (big blind) collected ($0.25)
Seat 2: sixcoins folded before Flop (didn't bet)
Seat 3: thedude696969 folded before Flop (didn't bet)
Seat 4: fish72o folded before Flop (didn't bet)
Seat 5: johnnytrue (button) folded before Flop
Seat 6: Notatur (small blind) folded before Flop



PokerStars Hand #222945623470:  Hold'em No Limit ($0.05/$0.10 USD) - 2021/01/23 1:00:52 ET
Table 'Algieba III' 6-max Seat #6 is the button
Seat 1: Tyoma_Kovach ($10.53 in chips) 
Seat 2: sixcoins ($12.38 in chips) 
Seat 3: thedude696969 ($35.34 in chips) 
Seat 4: fish72o ($12.56 in chips) 
Seat 5: johnnytrue ($13.09 in chips) 
Seat 6: Notatur ($10 in chips) 
Tyoma_Kovach: posts small blind $0.05
sixcoins: posts big blind $0.10
*** HOLE CARDS ***
thedude696969: raises $0.20 to $0.30
fish72o: folds 
johnnytrue: folds 
Notatur: folds 
Tyoma_Kovach: folds 
sixcoins: folds 
Uncalled bet ($0.20) returned to thedude696969
thedude696969 collected $0.25 from pot
thedude696969: doesn't show hand 
*** SUMMARY ***
Total pot $0.25 | Rake $0 
Seat 1: Tyoma_Kovach (small blind) folded before Flop
Seat 2: sixcoins (big blind) folded before Flop
Seat 3: thedude696969 collected ($0.25)
Seat 4: fish72o folded before Flop (didn't bet)
Seat 5: johnnytrue folded before Flop (didn't bet)
Seat 6: Notatur (button) folded before Flop (didn't bet)



PokerStars Hand #222945626659:  Hold'em No Limit ($0.05/$0.10 USD) - 2021/01/23 1:01:05 ET
Table 'Algieba III' 6-max Seat #1 is the button
Seat 1: Tyoma_Kovach ($10.48 in chips) 
Seat 2: sixcoins ($12.28 in chips) 
Seat 3: thedude696969 ($35.49 in chips) 
Seat 4: fish72o ($12.56 in chips) 
Seat 5: johnnytrue ($13.09 in chips) 
Seat 6: Notatur ($10 in chips) 
sixcoins: posts small blind $0.05
thedude696969: posts big blind $0.10
*** HOLE CARDS ***
fish72o: folds 
johnnytrue: calls $0.10
Notatur: folds 
Tyoma_Kovach: raises $0.35 to $0.45
sixcoins: folds 
thedude696969: folds 
johnnytrue: folds 
Uncalled bet ($0.35) returned to Tyoma_Kovach
Tyoma_Kovach collected $0.35 from pot
Tyoma_Kovach: doesn't show hand 
*** SUMMARY ***
Total pot $0.35 | Rake $0 
Seat 1: Tyoma_Kovach (button) collected ($0.35)
Seat 2: sixcoins (small blind) folded before Flop
Seat 3: thedude696969 (big blind) folded before Flop
Seat 4: fish72o folded before Flop (didn't bet)
Seat 5: johnnytrue folded before Flop
Seat 6: Notatur folded before Flop (didn't bet)



PokerStars Hand #222945631229:  Hold'em No Limit ($0.05/$0.10 USD) - 2021/01/23 1:01:25 ET
Table 'Algieba III' 6-max Seat #2 is the button
Seat 1: Tyoma_Kovach ($10.73 in chips) 
Seat 2: sixcoins ($12.23 in chips) 
Seat 3: thedude696969 ($35.39 in chips) 
Seat 4: fish72o ($12.56 in chips) 
Seat 5: johnnytrue ($12.99 in chips) 
Seat 6: Notatur ($10 in chips) 
thedude696969: posts small blind $0.05
fish72o: posts big blind $0.10
*** HOLE CARDS ***
johnnytrue: folds 
Notatur: folds 
Tyoma_Kovach: raises $0.18 to $0.28
sixcoins: folds 
thedude696969: raises $0.92 to $1.20
fish72o: folds 
Tyoma_Kovach: calls $0.92
*** FLOP *** [As Ac Jd]
thedude696969: checks 
Tyoma_Kovach: checks 
*** TURN *** [As Ac Jd] [2c]
thedude696969: checks 
Tyoma_Kovach: checks 
*** RIVER *** [As Ac Jd 2c] [7s]
thedude696969: bets $2
Tyoma_Kovach: folds 
Uncalled bet ($2) returned to thedude696969
thedude696969 collected $2.39 from pot
thedude696969: doesn't show hand 
*** SUMMARY ***
Total pot $2.50 | Rake $0.11 
Board [As Ac Jd 2c 7s]
Seat 1: Tyoma_Kovach folded on the River
Seat 2: sixcoins (button) folded before Flop (didn't bet)
Seat 3: thedude696969 (small blind) collected ($2.39)
Seat 4: fish72o (big blind) folded before Flop
Seat 5: johnnytrue folded before Flop (didn't bet)
Seat 6: Notatur folded before Flop (didn't bet)



PokerStars Hand #222945641908:  Hold'em No Limit ($0.05/$0.10 USD) - 2021/01/23 1:02:09 ET
Table 'Algieba III' 6-max Seat #3 is the button
Seat 1: Tyoma_Kovach ($10 in chips) 
Seat 2: sixcoins ($12.23 in chips) 
Seat 3: thedude696969 ($36.58 in chips) 
Seat 4: fish72o ($12.46 in chips) 
Seat 5: johnnytrue ($12.99 in chips) 
Seat 6: Notatur ($10 in chips) 
fish72o: posts small blind $0.05
johnnytrue: posts big blind $0.10
*** HOLE CARDS ***
Notatur: folds 
Tyoma_Kovach: folds 
sixcoins: raises $0.20 to $0.30
thedude696969: folds 
fish72o: folds 
johnnytrue: calls $0.20
*** FLOP *** [5c 5d 2h]
johnnytrue: checks 
sixcoins: bets $0.10
johnnytrue: calls $0.10
*** TURN *** [5c 5d 2h] [6s]
johnnytrue: checks 
sixcoins: bets $0.10
johnnytrue: calls $0.10
*** RIVER *** [5c 5d 2h 6s] [9h]
johnnytrue: checks 
sixcoins: bets $0.50
johnnytrue: folds 
Uncalled bet ($0.50) returned to sixcoins
sixcoins collected $1 from pot
sixcoins: doesn't show hand 
*** SUMMARY ***
Total pot $1.05 | Rake $0.05 
Board [5c 5d 2h 6s 9h]
Seat 1: Tyoma_Kovach folded before Flop (didn't bet)
Seat 2: sixcoins collected ($1)
Seat 3: thedude696969 (button) folded before Flop (didn't bet)
Seat 4: fish72o (small blind) folded before Flop
Seat 5: johnnytrue (big blind) folded on the River
Seat 6: Notatur folded before Flop (didn't bet)



PokerStars Hand #222945657502:  Hold'em No Limit ($0.05/$0.10 USD) - 2021/01/23 1:03:12 ET
Table 'Algieba III' 6-max Seat #4 is the button
Seat 1: Tyoma_Kovach ($10 in chips) 
Seat 2: sixcoins ($12.73 in chips) 
Seat 3: thedude696969 ($36.58 in chips) 
Seat 4: fish72o ($12.41 in chips) 
Seat 5: johnnytrue ($12.49 in chips) 
Seat 6: Notatur ($10 in chips) 
johnnytrue: posts small blind $0.05
Notatur: posts big blind $0.10
*** HOLE CARDS ***
Tyoma_Kovach: folds 
sixcoins: folds 
thedude696969: folds 
fish72o: folds 
johnnytrue: calls $0.05
Notatur: checks 
*** FLOP *** [Qh 5h 6h]
johnnytrue: checks 
Notatur: checks 
*** TURN *** [Qh 5h 6h] [3h]
johnnytrue: checks 
Notatur: checks 
*** RIVER *** [Qh 5h 6h 3h] [6c]
johnnytrue: checks 
Notatur: checks 
*** SHOW DOWN ***
johnnytrue: shows [6s Ad] (three of a kind, Sixes)
Notatur: mucks hand 
johnnytrue collected $0.19 from pot
*** SUMMARY ***
Total pot $0.20 | Rake $0.01 
Board [Qh 5h 6h 3h 6c]
Seat 1: Tyoma_Kovach folded before Flop (didn't bet)
Seat 2: sixcoins folded before Flop (didn't bet)
Seat 3: thedude696969 folded before Flop (didn't bet)
Seat 4: fish72o (button) folded before Flop (didn't bet)
Seat 5: johnnytrue (small blind) showed [6s Ad] and won ($0.19) with three of a kind, Sixes
Seat 6: Notatur (big blind) mucked



PokerStars Hand #222945669997:  Hold'em No Limit ($0.05/$0.10 USD) - 2021/01/23 1:04:03 ET
Table 'Algieba III' 6-max Seat #5 is the button
Seat 1: Tyoma_Kovach ($10 in chips) 
Seat 2: sixcoins ($12.73 in chips) 
Seat 3: thedude696969 ($36.58 in chips) 
Seat 4: fish72o ($12.41 in chips) 
Seat 5: johnnytrue ($12.58 in chips) 
Seat 6: Notatur ($10 in chips) 
Notatur: posts small blind $0.05
Tyoma_Kovach: posts big blind $0.10
*** HOLE CARDS ***
sixcoins: folds 
thedude696969: folds 
sixcoins leaves the table
fish72o: raises $0.15 to $0.25
johnnytrue: calls $0.25
Notatur: folds 
Tyoma_Kovach: folds 
*** FLOP *** [7c Ad 3c]
fish72o: bets $0.20
johnnytrue: calls $0.20
*** TURN *** [7c Ad 3c] [Tc]
negritos81 joins the table at seat #2 
fish72o: checks 
johnnytrue: bets $0.50
fish72o: folds 
Uncalled bet ($0.50) returned to johnnytrue
johnnytrue collected $1 from pot
*** SUMMARY ***
Total pot $1.05 | Rake $0.05 
Board [7c Ad 3c Tc]
Seat 1: Tyoma_Kovach (big blind) folded before Flop
Seat 2: sixcoins folded before Flop (didn't bet)
Seat 3: thedude696969 folded before Flop (didn't bet)
Seat 4: fish72o folded on the Turn
Seat 5: johnnytrue (button) collected ($1)
Seat 6: Notatur (small blind) folded before Flop



PokerStars Hand #222945678351:  Hold'em No Limit ($0.05/$0.10 USD) - 2021/01/23 1:04:37 ET
Table 'Algieba III' 6-max Seat #6 is the button
Seat 1: Tyoma_Kovach ($10 in chips) 
Seat 2: negritos81 ($10 in chips) 
Seat 3: thedude696969 ($36.58 in chips) 
Seat 4: fish72o ($11.96 in chips) 
Seat 5: johnnytrue ($13.13 in chips) 
Seat 6: Notatur ($10 in chips) 
Tyoma_Kovach: posts small blind $0.05
negritos81: posts big blind $0.10
*** HOLE CARDS ***
thedude696969: folds 
fish72o: folds 
johnnytrue: folds 
Notatur: folds 
Tyoma_Kovach: raises $0.20 to $0.30
negritos81: calls $0.20
*** FLOP *** [4s 3s 2c]
Tyoma_Kovach: bets $0.43
negritos81: folds 
Uncalled bet ($0.43) returned to Tyoma_Kovach
Tyoma_Kovach collected $0.57 from pot
Tyoma_Kovach: doesn't show hand 
*** SUMMARY ***
Total pot $0.60 | Rake $0.03 
Board [4s 3s 2c]
Seat 1: Tyoma_Kovach (small blind) collected ($0.57)
Seat 2: negritos81 (big blind) folded on the Flop
Seat 3: thedude696969 folded before Flop (didn't bet)
Seat 4: fish72o folded before Flop (didn't bet)
Seat 5: johnnytrue folded before Flop (didn't bet)
Seat 6: Notatur (button) folded before Flop (didn't bet)



PokerStars Hand #222945686764:  Hold'em No Limit ($0.05/$0.10 USD) - 2021/01/23 1:05:10 ET
Table 'Algieba III' 6-max Seat #1 is the button
Seat 1: Tyoma_Kovach ($10.27 in chips) 
Seat 2: negritos81 ($10 in chips) 
Seat 3: thedude696969 ($36.58 in chips) 
Seat 4: fish72o ($11.96 in chips) 
Seat 5: johnnytrue ($13.13 in chips) 
Seat 6: Notatur ($10 in chips) 
negritos81: posts small blind $0.05
thedude696969: posts big blind $0.10
*** HOLE CARDS ***
fish72o: folds 
johnnytrue: folds 
Notatur: folds 
Tyoma_Kovach: folds 
negritos81: folds 
Uncalled bet ($0.05) returned to thedude696969
thedude696969 collected $0.10 from pot
thedude696969: doesn't show hand 
*** SUMMARY ***
Total pot $0.10 | Rake $0 
Seat 1: Tyoma_Kovach (button) folded before Flop (didn't bet)
Seat 2: negritos81 (small blind) folded before Flop
Seat 3: thedude696969 (big blind) collected ($0.10)
Seat 4: fish72o folded before Flop (didn't bet)
Seat 5: johnnytrue folded before Flop (didn't bet)
Seat 6: Notatur folded before Flop (didn't bet)



PokerStars Hand #222945693010:  Hold'em No Limit ($0.05/$0.10 USD) - 2021/01/23 1:05:35 ET
Table 'Algieba III' 6-max Seat #2 is the button
Seat 1: Tyoma_Kovach ($10.27 in chips) 
Seat 2: negritos81 ($10 in chips) 
Seat 3: thedude696969 ($36.63 in chips) 
Seat 4: fish72o ($11.96 in chips) 
Seat 6: Notatur ($10 in chips) 
thedude696969: posts small blind $0.05
fish72o: posts big blind $0.10
*** HOLE CARDS ***
Notatur: folds 
Tyoma_Kovach: folds 
negritos81: folds 
thedude696969: folds 
Uncalled bet ($0.05) returned to fish72o
fish72o collected $0.10 from pot
fish72o: doesn't show hand 
*** SUMMARY ***
Total pot $0.10 | Rake $0 
Seat 1: Tyoma_Kovach folded before Flop (didn't bet)
Seat 2: negritos81 (button) folded before Flop (didn't bet)
Seat 3: thedude696969 (small blind) folded before Flop
Seat 4: fish72o (big blind) collected ($0.10)
Seat 6: Notatur folded before Flop (didn't bet)



PokerStars Hand #222945696546:  Hold'em No Limit ($0.05/$0.10 USD) - 2021/01/23 1:05:49 ET
Table 'Algieba III' 6-max Seat #3 is the button
Seat 1: Tyoma_Kovach ($10.27 in chips) 
Seat 2: negritos81 ($10 in chips) 
Seat 3: thedude696969 ($36.58 in chips) 
Seat 4: fish72o ($12.01 in chips) 
Seat 6: Notatur ($10 in chips) 
fish72o: posts small blind $0.05
Notatur: posts big blind $0.10
*** HOLE CARDS ***
Tyoma_Kovach: raises $0.20 to $0.30
negritos81: folds 
thedude696969: folds 
fish72o: folds 
Notatur: calls $0.20
*** FLOP *** [Kc 2s 7s]
Notatur: checks 
Tyoma_Kovach: bets $0.41
Notatur: folds 
Uncalled bet ($0.41) returned to Tyoma_Kovach
Tyoma_Kovach collected $0.62 from pot
Tyoma_Kovach: doesn't show hand 
*** SUMMARY ***
Total pot $0.65 | Rake $0.03 
Board [Kc 2s 7s]
Seat 1: Tyoma_Kovach collected ($0.62)
Seat 2: negritos81 folded before Flop (didn't bet)
Seat 3: thedude696969 (button) folded before Flop (didn't bet)
Seat 4: fish72o (small blind) folded before Flop
Seat 6: Notatur (big blind) folded on the Flop



PokerStars Hand #222945702176:  Hold'em No Limit ($0.05/$0.10 USD) - 2021/01/23 1:06:11 ET
Table 'Algieba III' 6-max Seat #4 is the button
Seat 1: Tyoma_Kovach ($10.59 in chips) 
Seat 2: negritos81 ($10 in chips) 
Seat 3: thedude696969 ($36.58 in chips) 
Seat 4: fish72o ($11.96 in chips) 
Seat 6: Notatur ($10 in chips) 
Notatur: posts small blind $0.05
Tyoma_Kovach: posts big blind $0.10
*** HOLE CARDS ***
negritos81: folds 
thedude696969: folds 
fish72o: folds 
Notatur: folds 
Uncalled bet ($0.05) returned to Tyoma_Kovach
Tyoma_Kovach collected $0.10 from pot
Tyoma_Kovach: doesn't show hand 
*** SUMMARY ***
Total pot $0.10 | Rake $0 
Seat 1: Tyoma_Kovach (big blind) collected ($0.10)
Seat 2: negritos81 folded before Flop (didn't bet)
Seat 3: thedude696969 folded before Flop (didn't bet)
Seat 4: fish72o (button) folded before Flop (didn't bet)
Seat 6: Notatur (small blind) folded before Flop



PokerStars Hand #222945706348:  Hold'em No Limit ($0.05/$0.10 USD) - 2021/01/23 1:06:28 ET
Table 'Algieba III' 6-max Seat #6 is the button
Seat 1: Tyoma_Kovach ($10.64 in chips) 
Seat 2: negritos81 ($10 in chips) 
Seat 3: thedude696969 ($36.58 in chips) 
Seat 4: fish72o ($11.96 in chips) 
Seat 6: Notatur ($10 in chips) 
Tyoma_Kovach: posts small blind $0.05
negritos81: posts big blind $0.10
*** HOLE CARDS ***
thedude696969: raises $0.20 to $0.30
fish72o: folds 
Notatur: folds 
Tyoma_Kovach: folds 
negritos81: folds 
Uncalled bet ($0.20) returned to thedude696969
thedude696969 collected $0.25 from pot
thedude696969: doesn't show hand 
*** SUMMARY ***
Total pot $0.25 | Rake $0 
Seat 1: Tyoma_Kovach (small blind) folded before Flop
Seat 2: negritos81 (big blind) folded before Flop
Seat 3: thedude696969 collected ($0.25)
Seat 4: fish72o folded before Flop (didn't bet)
Seat 6: Notatur (button) folded before Flop (didn't bet)



PokerStars Hand #222945710350:  Hold'em No Limit ($0.05/$0.10 USD) - 2021/01/23 1:06:44 ET
Table 'Algieba III' 6-max Seat #1 is the button
Seat 1: Tyoma_Kovach ($10.59 in chips) 
Seat 2: negritos81 ($10 in chips) 
Seat 3: thedude696969 ($36.73 in chips) 
Seat 4: fish72o ($11.96 in chips) 
Seat 6: Notatur ($10 in chips) 
negritos81: posts small blind $0.05
thedude696969: posts big blind $0.10
*** HOLE CARDS ***
fish72o: folds 
Notatur: folds 
Tyoma_Kovach: folds 
negritos81: raises $0.20 to $0.30
thedude696969: raises $0.80 to $1.10
negritos81: calls $0.80
*** FLOP *** [3h Jh 3s]
negritos81: checks 
thedude696969: bets $1.32
negritos81: calls $1.32
*** TURN *** [3h Jh 3s] [3c]
negritos81: checks 
thedude696969: bets $2.87
johnnytrue leaves the table
negritos81 has timed out
negritos81: folds 
Uncalled bet ($2.87) returned to thedude696969
thedude696969 collected $4.62 from pot
thedude696969: doesn't show hand 
*** SUMMARY ***
Total pot $4.84 | Rake $0.22 
Board [3h Jh 3s 3c]
Seat 1: Tyoma_Kovach (button) folded before Flop (didn't bet)
Seat 2: negritos81 (small blind) folded on the Turn
Seat 3: thedude696969 (big blind) collected ($4.62)
Seat 4: fish72o folded before Flop (didn't bet)
Seat 6: Notatur folded before Flop (didn't bet)



PokerStars Hand #222945737831:  Hold'em No Limit ($0.05/$0.10 USD) - 2021/01/23 1:08:34 ET
Table 'Algieba III' 6-max Seat #3 is the button
Seat 1: Tyoma_Kovach ($10.59 in chips) 
Seat 3: thedude696969 ($38.93 in chips) 
Seat 4: fish72o ($11.96 in chips) 
Seat 6: Notatur ($10 in chips) 
fish72o: posts small blind $0.05
Notatur: posts big blind $0.10
*** HOLE CARDS ***
Tyoma_Kovach: raises $0.18 to $0.28
thedude696969: folds 
fish72o: folds 
Notatur: folds 
Uncalled bet ($0.18) returned to Tyoma_Kovach
Tyoma_Kovach collected $0.25 from pot
Tyoma_Kovach: doesn't show hand 
*** SUMMARY ***
Total pot $0.25 | Rake $0 
Seat 1: Tyoma_Kovach collected ($0.25)
Seat 3: thedude696969 (button) folded before Flop (didn't bet)
Seat 4: fish72o (small blind) folded before Flop
Seat 6: Notatur (big blind) folded before Flop



PokerStars Hand #222945741758:  Hold'em No Limit ($0.05/$0.10 USD) - 2021/01/23 1:08:49 ET
Table 'Algieba III' 6-max Seat #4 is the button
Seat 1: Tyoma_Kovach ($10.74 in chips) 
Seat 2: negritos81 ($10 in chips) 
Seat 3: thedude696969 ($38.93 in chips) 
Seat 4: fish72o ($11.91 in chips) 
Seat 6: Notatur ($10 in chips) 
Notatur: posts small blind $0.05
Tyoma_Kovach: posts big blind $0.10
*** HOLE CARDS ***
t_m_y_n joins the table at seat #5 
negritos81: folds 
thedude696969: raises $0.20 to $0.30
fish72o: folds 
Notatur: raises $0.90 to $1.20
Tyoma_Kovach: folds 
thedude696969: folds 
Uncalled bet ($0.90) returned to Notatur
Notatur collected $0.70 from pot
Notatur: doesn't show hand 
*** SUMMARY ***
Total pot $0.70 | Rake $0 
Seat 1: Tyoma_Kovach (big blind) folded before Flop
Seat 2: negritos81 folded before Flop (didn't bet)
Seat 3: thedude696969 folded before Flop
Seat 4: fish72o (button) folded before Flop (didn't bet)
Seat 6: Notatur (small blind) collected ($0.70)



PokerStars Hand #222945751374:  Hold'em No Limit ($0.05/$0.10 USD) - 2021/01/23 1:09:29 ET
Table 'Algieba III' 6-max Seat #6 is the button
Seat 1: Tyoma_Kovach ($10.64 in chips) 
Seat 2: negritos81 ($10 in chips) 
Seat 3: thedude696969 ($38.63 in chips) 
Seat 4: fish72o ($11.91 in chips) 
Seat 5: t_m_y_n ($4 in chips) 
Seat 6: Notatur ($10.40 in chips) 
Tyoma_Kovach: posts small blind $0.05
negritos81: posts big blind $0.10
t_m_y_n: posts big blind $0.10
*** HOLE CARDS ***
thedude696969: raises $0.20 to $0.30
fish72o: folds 
t_m_y_n: calls $0.20
Notatur: folds 
Tyoma_Kovach: raises $1.18 to $1.48
negritos81: folds 
thedude696969: calls $1.18
t_m_y_n: folds 
*** FLOP *** [Tc 7c 9d]
Tyoma_Kovach: checks 
thedude696969: bets $1.90
Tyoma_Kovach: folds 
Uncalled bet ($1.90) returned to thedude696969
thedude696969 collected $3.21 from pot
thedude696969: doesn't show hand 
*** SUMMARY ***
Total pot $3.36 | Rake $0.15 
Board [Tc 7c 9d]
Seat 1: Tyoma_Kovach (small blind) folded on the Flop
Seat 2: negritos81 (big blind) folded before Flop
Seat 3: thedude696969 collected ($3.21)
Seat 4: fish72o folded before Flop (didn't bet)
Seat 5: t_m_y_n folded before Flop
Seat 6: Notatur (button) folded before Flop (didn't bet)



PokerStars Hand #222945761912:  Hold'em No Limit ($0.05/$0.10 USD) - 2021/01/23 1:10:11 ET
Table 'Algieba III' 6-max Seat #1 is the button
Seat 1: Tyoma_Kovach ($10 in chips) 
Seat 2: negritos81 ($10 in chips) 
Seat 3: thedude696969 ($40.36 in chips) 
Seat 4: fish72o ($11.91 in chips) 
Seat 5: t_m_y_n ($3.70 in chips) 
Seat 6: Notatur ($10.40 in chips) 
negritos81: posts small blind $0.05
thedude696969: posts big blind $0.10
*** HOLE CARDS ***
fish72o: folds 
t_m_y_n: folds 
Notatur: folds 
Tyoma_Kovach: folds 
negritos81: folds 
Uncalled bet ($0.05) returned to thedude696969
thedude696969 collected $0.10 from pot
thedude696969: doesn't show hand 
*** SUMMARY ***
Total pot $0.10 | Rake $0 
Seat 1: Tyoma_Kovach (button) folded before Flop (didn't bet)
Seat 2: negritos81 (small blind) folded before Flop
Seat 3: thedude696969 (big blind) collected ($0.10)
Seat 4: fish72o folded before Flop (didn't bet)
Seat 5: t_m_y_n folded before Flop (didn't bet)
Seat 6: Notatur folded before Flop (didn't bet)



PokerStars Hand #222945767263:  Hold'em No Limit ($0.05/$0.10 USD) - 2021/01/23 1:10:32 ET
Table 'Algieba III' 6-max Seat #2 is the button
Seat 1: Tyoma_Kovach ($10 in chips) 
Seat 2: negritos81 ($10 in chips) 
Seat 3: thedude696969 ($40.41 in chips) 
Seat 4: fish72o ($11.91 in chips) 
Seat 5: t_m_y_n ($3.70 in chips) 
Seat 6: Notatur ($10.40 in chips) 
thedude696969: posts small blind $0.05
fish72o: posts big blind $0.10
*** HOLE CARDS ***
t_m_y_n: folds 
Notatur: folds 
Tyoma_Kovach: folds 
negritos81: folds 
thedude696969: folds 
Uncalled bet ($0.05) returned to fish72o
fish72o collected $0.10 from pot
fish72o: doesn't show hand 
*** SUMMARY ***
Total pot $0.10 | Rake $0 
Seat 1: Tyoma_Kovach folded before Flop (didn't bet)
Seat 2: negritos81 (button) folded before Flop (didn't bet)
Seat 3: thedude696969 (small blind) folded before Flop
Seat 4: fish72o (big blind) collected ($0.10)
Seat 5: t_m_y_n folded before Flop (didn't bet)
Seat 6: Notatur folded before Flop (didn't bet)



PokerStars Hand #222945770090:  Hold'em No Limit ($0.05/$0.10 USD) - 2021/01/23 1:10:44 ET
Table 'Algieba III' 6-max Seat #3 is the button
Seat 1: Tyoma_Kovach ($10 in chips) 
Seat 2: negritos81 ($10 in chips) 
Seat 3: thedude696969 ($40.36 in chips) 
Seat 4: fish72o ($11.96 in chips) 
Seat 5: t_m_y_n ($3.70 in chips) 
Seat 6: Notatur ($10.40 in chips) 
fish72o: posts small blind $0.05
t_m_y_n: posts big blind $0.10
*** HOLE CARDS ***
Notatur: folds 
Tyoma_Kovach: folds 
negritos81: folds 
thedude696969: raises $0.20 to $0.30
fish72o: folds 
t_m_y_n: calls $0.20
*** FLOP *** [Jd 5s Kc]
t_m_y_n: checks 
thedude696969: bets $0.50
t_m_y_n: calls $0.50
*** TURN *** [Jd 5s Kc] [Tc]
t_m_y_n: checks 
thedude696969: bets $1.30
t_m_y_n: raises $1.60 to $2.90 and is all-in
thedude696969: calls $1.60
*** RIVER *** [Jd 5s Kc Tc] [7s]
*** SHOW DOWN ***
t_m_y_n: shows [Td Th] (three of a kind, Tens)
thedude696969: shows [Js Ah] (a pair of Jacks)
t_m_y_n collected $7.11 from pot
*** SUMMARY ***
Total pot $7.45 | Rake $0.34 
Board [Jd 5s Kc Tc 7s]
Seat 1: Tyoma_Kovach folded before Flop (didn't bet)
Seat 2: negritos81 folded before Flop (didn't bet)
Seat 3: thedude696969 (button) showed [Js Ah] and lost with a pair of Jacks
Seat 4: fish72o (small blind) folded before Flop
Seat 5: t_m_y_n (big blind) showed [Td Th] and won ($7.11) with three of a kind, Tens
Seat 6: Notatur folded before Flop (didn't bet)



PokerStars Hand #222945792285:  Hold'em No Limit ($0.05/$0.10 USD) - 2021/01/23 1:11:33 ET
Table 'Algieba III' 6-max Seat #4 is the button
Seat 1: Tyoma_Kovach ($10 in chips) 
Seat 2: negritos81 ($10 in chips) 
Seat 3: thedude696969 ($36.66 in chips) 
Seat 4: fish72o ($11.91 in chips) 
Seat 5: t_m_y_n ($7.11 in chips) 
Seat 6: Notatur ($10.40 in chips) 
t_m_y_n: posts small blind $0.05
Notatur: posts big blind $0.10
*** HOLE CARDS ***
Tyoma_Kovach: folds 
negritos81: folds 
thedude696969: calls $0.10
fish72o: raises $0.35 to $0.45
t_m_y_n: folds 
Notatur: folds 
thedude696969: calls $0.35
*** FLOP *** [2d 5h Jh]
thedude696969: checks 
fish72o: bets $0.33
thedude696969: calls $0.33
*** TURN *** [2d 5h Jh] [Js]
thedude696969: checks 
fish72o: checks 
*** RIVER *** [2d 5h Jh Js] [As]
thedude696969: bets $1.80
fish72o: calls $1.80
*** SHOW DOWN ***
thedude696969: shows [2h 2c] (a full house, Deuces full of Jacks)
fish72o: mucks hand 
thedude696969 collected $5.07 from pot
*** SUMMARY ***
Total pot $5.31 | Rake $0.24 
Board [2d 5h Jh Js As]
Seat 1: Tyoma_Kovach folded before Flop (didn't bet)
Seat 2: negritos81 folded before Flop (didn't bet)
Seat 3: thedude696969 showed [2h 2c] and won ($5.07) with a full house, Deuces full of Jacks
Seat 4: fish72o (button) mucked
Seat 5: t_m_y_n (small blind) folded before Flop
Seat 6: Notatur (big blind) folded before Flop



PokerStars Hand #222945802964:  Hold'em No Limit ($0.05/$0.10 USD) - 2021/01/23 1:12:16 ET
Table 'Algieba III' 6-max Seat #5 is the button
Seat 1: Tyoma_Kovach ($10 in chips) 
Seat 2: negritos81 ($10 in chips) 
Seat 3: thedude696969 ($39.15 in chips) 
Seat 4: fish72o ($10 in chips) 
Seat 5: t_m_y_n ($7.06 in chips) 
Seat 6: Notatur ($10.30 in chips) 
Notatur: posts small blind $0.05
Tyoma_Kovach: posts big blind $0.10
*** HOLE CARDS ***
negritos81: folds 
thedude696969: folds 
fish72o: folds 
t_m_y_n: raises $0.10 to $0.20
Notatur: folds 
Tyoma_Kovach: raises $0.80 to $1
t_m_y_n: folds 
Uncalled bet ($0.80) returned to Tyoma_Kovach
Tyoma_Kovach collected $0.45 from pot
Tyoma_Kovach: doesn't show hand 
*** SUMMARY ***
Total pot $0.45 | Rake $0 
Seat 1: Tyoma_Kovach (big blind) collected ($0.45)
Seat 2: negritos81 folded before Flop (didn't bet)
Seat 3: thedude696969 folded before Flop (didn't bet)
Seat 4: fish72o folded before Flop (didn't bet)
Seat 5: t_m_y_n (button) folded before Flop
Seat 6: Notatur (small blind) folded before Flop



PokerStars Hand #222945809805:  Hold'em No Limit ($0.05/$0.10 USD) - 2021/01/23 1:12:44 ET
Table 'Algieba III' 6-max Seat #6 is the button
Seat 1: Tyoma_Kovach ($10.25 in chips) 
Seat 2: negritos81 ($10 in chips) 
Seat 3: thedude696969 ($39.15 in chips) 
Seat 4: fish72o ($10 in chips) 
Seat 5: t_m_y_n ($6.86 in chips) 
Seat 6: Notatur ($10.25 in chips) 
Tyoma_Kovach: posts small blind $0.05
negritos81: posts big blind $0.10
*** HOLE CARDS ***
thedude696969: folds 
fish72o: folds 
t_m_y_n: raises $0.10 to $0.20
Notatur: folds 
Tyoma_Kovach: folds 
negritos81: folds 
Uncalled bet ($0.10) returned to t_m_y_n
t_m_y_n collected $0.25 from pot
t_m_y_n: doesn't show hand 
*** SUMMARY ***
Total pot $0.25 | Rake $0 
Seat 1: Tyoma_Kovach (small blind) folded before Flop
Seat 2: negritos81 (big blind) folded before Flop
Seat 3: thedude696969 folded before Flop (didn't bet)
Seat 4: fish72o folded before Flop (didn't bet)
Seat 5: t_m_y_n collected ($0.25)
Seat 6: Notatur (button) folded before Flop (didn't bet)



PokerStars Hand #222945814224:  Hold'em No Limit ($0.05/$0.10 USD) - 2021/01/23 1:13:02 ET
Table 'Algieba III' 6-max Seat #1 is the button
Seat 1: Tyoma_Kovach ($10.20 in chips) 
Seat 2: negritos81 ($10 in chips) 
Seat 3: thedude696969 ($39.15 in chips) 
Seat 4: fish72o ($10 in chips) 
Seat 5: t_m_y_n ($7.01 in chips) 
Seat 6: Notatur ($10.25 in chips) 
negritos81: posts small blind $0.05
thedude696969: posts big blind $0.10
*** HOLE CARDS ***
fish72o: folds 
t_m_y_n: folds 
Notatur: folds 
Tyoma_Kovach: raises $0.15 to $0.25
negritos81: raises $0.85 to $1.10
thedude696969: raises $4.20 to $5.30
Tyoma_Kovach: folds 
negritos81: raises $4.70 to $10 and is all-in
thedude696969: calls $4.70
*** FLOP *** [Ah 7c 5h]
*** TURN *** [Ah 7c 5h] [9s]
*** RIVER *** [Ah 7c 5h 9s] [5c]
*** SHOW DOWN ***
negritos81: shows [Ac Ks] (two pair, Aces and Fives)
thedude696969: shows [Qc Qd] (two pair, Queens and Fives)
negritos81 collected $19.34 from pot
*** SUMMARY ***
Total pot $20.25 | Rake $0.91 
Board [Ah 7c 5h 9s 5c]
Seat 1: Tyoma_Kovach (button) folded before Flop
Seat 2: negritos81 (small blind) showed [Ac Ks] and won ($19.34) with two pair, Aces and Fives
Seat 3: thedude696969 (big blind) showed [Qc Qd] and lost with two pair, Queens and Fives
Seat 4: fish72o folded before Flop (didn't bet)
Seat 5: t_m_y_n folded before Flop (didn't bet)
Seat 6: Notatur folded before Flop (didn't bet)



PokerStars Hand #222945827126:  Hold'em No Limit ($0.05/$0.10 USD) - 2021/01/23 1:13:55 ET
Table 'Algieba III' 6-max Seat #2 is the button
Seat 1: Tyoma_Kovach ($10 in chips) 
Seat 2: negritos81 ($19.34 in chips) 
Seat 3: thedude696969 ($29.15 in chips) 
Seat 4: fish72o ($10 in chips) 
Seat 5: t_m_y_n ($7.01 in chips) 
Seat 6: Notatur ($10.25 in chips) 
thedude696969: posts small blind $0.05
fish72o: posts big blind $0.10
*** HOLE CARDS ***
t_m_y_n: raises $0.10 to $0.20
Notatur: folds 
Tyoma_Kovach: folds 
negritos81: folds 
thedude696969: raises $0.80 to $1
fish72o: folds 
t_m_y_n: folds 
Uncalled bet ($0.80) returned to thedude696969
thedude696969 collected $0.50 from pot
thedude696969: doesn't show hand 
*** SUMMARY ***
Total pot $0.50 | Rake $0 
Seat 1: Tyoma_Kovach folded before Flop (didn't bet)
Seat 2: negritos81 (button) folded before Flop (didn't bet)
Seat 3: thedude696969 (small blind) collected ($0.50)
Seat 4: fish72o (big blind) folded before Flop
Seat 5: t_m_y_n folded before Flop
Seat 6: Notatur folded before Flop (didn't bet)



PokerStars Hand #222945832975:  Hold'em No Limit ($0.05/$0.10 USD) - 2021/01/23 1:14:19 ET
Table 'Algieba III' 6-max Seat #3 is the button
Seat 1: Tyoma_Kovach ($10 in chips) 
Seat 2: negritos81 ($19.34 in chips) 
Seat 3: thedude696969 ($29.45 in chips) 
Seat 4: fish72o ($10 in chips) 
Seat 5: t_m_y_n ($6.81 in chips) 
Seat 6: Notatur ($10.25 in chips) 
fish72o: posts small blind $0.05
t_m_y_n: posts big blind $0.10
*** HOLE CARDS ***
Notatur: folds 
Tyoma_Kovach: folds 
negritos81: folds 
thedude696969: raises $0.20 to $0.30
fish72o: folds 
t_m_y_n: calls $0.20
*** FLOP *** [Tc 5h Js]
t_m_y_n: checks 
thedude696969: bets $0.50
t_m_y_n: calls $0.50
*** TURN *** [Tc 5h Js] [4d]
t_m_y_n: checks 
thedude696969: bets $0.84
t_m_y_n: calls $0.84
*** RIVER *** [Tc 5h Js 4d] [8h]
t_m_y_n: checks 
thedude696969: checks 
*** SHOW DOWN ***
t_m_y_n: shows [Jc 8s] (two pair, Jacks and Eights)
thedude696969: mucks hand 
t_m_y_n collected $3.18 from pot
*** SUMMARY ***
Total pot $3.33 | Rake $0.15 
Board [Tc 5h Js 4d 8h]
Seat 1: Tyoma_Kovach folded before Flop (didn't bet)
Seat 2: negritos81 folded before Flop (didn't bet)
Seat 3: thedude696969 (button) mucked
Seat 4: fish72o (small blind) folded before Flop
Seat 5: t_m_y_n (big blind) showed [Jc 8s] and won ($3.18) with two pair, Jacks and Eights
Seat 6: Notatur folded before Flop (didn't bet)



PokerStars Hand #222945844215:  Hold'em No Limit ($0.05/$0.10 USD) - 2021/01/23 1:15:04 ET
Table 'Algieba III' 6-max Seat #4 is the button
Seat 1: Tyoma_Kovach ($10 in chips) 
Seat 2: negritos81 ($19.34 in chips) 
Seat 3: thedude696969 ($27.81 in chips) 
Seat 4: fish72o ($10 in chips) 
Seat 5: t_m_y_n ($8.35 in chips) 
Seat 6: Notatur ($10.25 in chips) 
t_m_y_n: posts small blind $0.05
Notatur: posts big blind $0.10
*** HOLE CARDS ***
Tyoma_Kovach: folds 
negritos81: folds 
thedude696969: folds 
fish72o: folds 
t_m_y_n: calls $0.05
Notatur: checks 
*** FLOP *** [Jh Td 5c]
t_m_y_n: bets $0.10
Notatur: folds 
Uncalled bet ($0.10) returned to t_m_y_n
t_m_y_n collected $0.19 from pot
t_m_y_n: doesn't show hand 
*** SUMMARY ***
Total pot $0.20 | Rake $0.01 
Board [Jh Td 5c]
Seat 1: Tyoma_Kovach folded before Flop (didn't bet)
Seat 2: negritos81 folded before Flop (didn't bet)
Seat 3: thedude696969 folded before Flop (didn't bet)
Seat 4: fish72o (button) folded before Flop (didn't bet)
Seat 5: t_m_y_n (small blind) collected ($0.19)
Seat 6: Notatur (big blind) folded on the Flop



PokerStars Hand #222945849365:  Hold'em No Limit ($0.05/$0.10 USD) - 2021/01/23 1:15:24 ET
Table 'Algieba III' 6-max Seat #5 is the button
Seat 1: Tyoma_Kovach ($10 in chips) 
Seat 2: negritos81 ($19.34 in chips) 
Seat 3: thedude696969 ($27.81 in chips) 
Seat 4: fish72o ($10 in chips) 
Seat 5: t_m_y_n ($8.44 in chips) 
Seat 6: Notatur ($10.15 in chips) 
Notatur: posts small blind $0.05
Tyoma_Kovach: posts big blind $0.10
*** HOLE CARDS ***
negritos81: folds 
thedude696969: folds 
fish72o: folds 
t_m_y_n: folds 
Notatur: folds 
Uncalled bet ($0.05) returned to Tyoma_Kovach
Tyoma_Kovach collected $0.10 from pot
Tyoma_Kovach: doesn't show hand 
*** SUMMARY ***
Total pot $0.10 | Rake $0 
Seat 1: Tyoma_Kovach (big blind) collected ($0.10)
Seat 2: negritos81 folded before Flop (didn't bet)
Seat 3: thedude696969 folded before Flop (didn't bet)
Seat 4: fish72o folded before Flop (didn't bet)
Seat 5: t_m_y_n (button) folded before Flop (didn't bet)
Seat 6: Notatur (small blind) folded before Flop



PokerStars Hand #222945853035:  Hold'em No Limit ($0.05/$0.10 USD) - 2021/01/23 1:15:39 ET
Table 'Algieba III' 6-max Seat #6 is the button
Seat 1: Tyoma_Kovach ($10.05 in chips) 
Seat 2: negritos81 ($19.34 in chips) 
Seat 3: thedude696969 ($27.81 in chips) 
Seat 4: fish72o ($10 in chips) 
Seat 5: t_m_y_n ($8.44 in chips) 
Seat 6: Notatur ($10.10 in chips) 
Tyoma_Kovach: posts small blind $0.05
negritos81: posts big blind $0.10
*** HOLE CARDS ***
thedude696969: folds 
fish72o: folds 
t_m_y_n: raises $0.10 to $0.20
Notatur: folds 
Tyoma_Kovach: folds 
negritos81: calls $0.10
*** FLOP *** [5d 7c 2s]
negritos81: checks 
t_m_y_n: bets $0.21
negritos81: folds 
Uncalled bet ($0.21) returned to t_m_y_n
t_m_y_n collected $0.43 from pot
t_m_y_n: doesn't show hand 
*** SUMMARY ***
Total pot $0.45 | Rake $0.02 
Board [5d 7c 2s]
Seat 1: Tyoma_Kovach (small blind) folded before Flop
Seat 2: negritos81 (big blind) folded on the Flop
Seat 3: thedude696969 folded before Flop (didn't bet)
Seat 4: fish72o folded before Flop (didn't bet)
Seat 5: t_m_y_n collected ($0.43)
Seat 6: Notatur (button) folded before Flop (didn't bet)



PokerStars Hand #222945861785:  Hold'em No Limit ($0.05/$0.10 USD) - 2021/01/23 1:16:15 ET
Table 'Algieba III' 6-max Seat #1 is the button
Seat 1: Tyoma_Kovach ($10 in chips) 
Seat 2: negritos81 ($19.14 in chips) 
Seat 3: thedude696969 ($27.81 in chips) 
Seat 4: fish72o ($10 in chips) 
Seat 5: t_m_y_n ($8.67 in chips) 
Seat 6: Notatur ($10.10 in chips) 
negritos81: posts small blind $0.05
thedude696969: posts big blind $0.10
*** HOLE CARDS ***
fish72o: folds 
t_m_y_n: raises $0.10 to $0.20
Notatur: raises $0.50 to $0.70
Tyoma_Kovach: folds 
negritos81: folds 
thedude696969: folds 
t_m_y_n: calls $0.50
*** FLOP *** [Td Ad Qh]
t_m_y_n: bets $0.54
Notatur: raises $0.84 to $1.38
t_m_y_n: folds 
Uncalled bet ($0.84) returned to Notatur
Notatur collected $2.51 from pot
Notatur: doesn't show hand 
*** SUMMARY ***
Total pot $2.63 | Rake $0.12 
Board [Td Ad Qh]
Seat 1: Tyoma_Kovach (button) folded before Flop (didn't bet)
Seat 2: negritos81 (small blind) folded before Flop
Seat 3: thedude696969 (big blind) folded before Flop
Seat 4: fish72o folded before Flop (didn't bet)
Seat 5: t_m_y_n folded on the Flop
Seat 6: Notatur collected ($2.51)



PokerStars Hand #222945871538:  Hold'em No Limit ($0.05/$0.10 USD) - 2021/01/23 1:16:54 ET
Table 'Algieba III' 6-max Seat #2 is the button
Seat 1: Tyoma_Kovach ($10 in chips) 
Seat 2: negritos81 ($19.09 in chips) 
Seat 3: thedude696969 ($27.71 in chips) 
Seat 4: fish72o ($10 in chips) 
Seat 5: t_m_y_n ($7.43 in chips) 
Seat 6: Notatur ($11.37 in chips) 
thedude696969: posts small blind $0.05
fish72o: posts big blind $0.10
*** HOLE CARDS ***
t_m_y_n: folds 
Notatur has timed out
Notatur: folds 
Tyoma_Kovach: folds 
negritos81: raises $0.20 to $0.30
thedude696969: raises $0.90 to $1.20
fish72o: folds 
negritos81: folds 
Uncalled bet ($0.90) returned to thedude696969
thedude696969 collected $0.70 from pot
thedude696969: doesn't show hand 
*** SUMMARY ***
Total pot $0.70 | Rake $0 
Seat 1: Tyoma_Kovach folded before Flop (didn't bet)
Seat 2: negritos81 (button) folded before Flop
Seat 3: thedude696969 (small blind) collected ($0.70)
Seat 4: fish72o (big blind) folded before Flop
Seat 5: t_m_y_n folded before Flop (didn't bet)
Seat 6: Notatur folded before Flop (didn't bet)



PokerStars Hand #222945887779:  Hold'em No Limit ($0.05/$0.10 USD) - 2021/01/23 1:17:27 ET
Table 'Algieba III' 6-max Seat #3 is the button
Seat 1: Tyoma_Kovach ($10 in chips) 
Seat 2: negritos81 ($18.79 in chips) 
Seat 3: thedude696969 ($28.11 in chips) 
Seat 4: fish72o ($10 in chips) 
Seat 5: t_m_y_n ($7.43 in chips) 
Seat 6: Notatur ($11.37 in chips) 
fish72o: posts small blind $0.05
t_m_y_n: posts big blind $0.10
*** HOLE CARDS ***
Notatur: folds 
Tyoma_Kovach: folds 
negritos81: folds 
thedude696969: folds 
fish72o: raises $0.15 to $0.25
t_m_y_n: calls $0.15
*** FLOP *** [2c 8d 2d]
fish72o: bets $0.32
t_m_y_n: raises $0.46 to $0.78
fish72o: calls $0.46
*** TURN *** [2c 8d 2d] [4s]
fish72o: checks 
t_m_y_n: checks 
*** RIVER *** [2c 8d 2d 4s] [As]
fish72o: checks 
t_m_y_n: checks 
*** SHOW DOWN ***
fish72o: shows [8s Jh] (two pair, Eights and Deuces)
t_m_y_n: mucks hand 
fish72o collected $1.97 from pot
*** SUMMARY ***
Total pot $2.06 | Rake $0.09 
Board [2c 8d 2d 4s As]
Seat 1: Tyoma_Kovach folded before Flop (didn't bet)
Seat 2: negritos81 folded before Flop (didn't bet)
Seat 3: thedude696969 (button) folded before Flop (didn't bet)
Seat 4: fish72o (small blind) showed [8s Jh] and won ($1.97) with two pair, Eights and Deuces
Seat 5: t_m_y_n (big blind) mucked
Seat 6: Notatur folded before Flop (didn't bet)



PokerStars Hand #222945903128:  Hold'em No Limit ($0.05/$0.10 USD) - 2021/01/23 1:18:30 ET
Table 'Algieba III' 6-max Seat #4 is the button
Seat 1: Tyoma_Kovach ($10 in chips) 
Seat 2: negritos81 ($18.79 in chips) 
Seat 3: thedude696969 ($28.11 in chips) 
Seat 4: fish72o ($10.94 in chips) 
Seat 5: t_m_y_n ($6.40 in chips) 
Seat 6: Notatur ($11.37 in chips) 
t_m_y_n: posts small blind $0.05
Notatur: posts big blind $0.10
*** HOLE CARDS ***
Tyoma_Kovach: folds 
negritos81: folds 
thedude696969: folds 
fish72o: raises $0.15 to $0.25
t_m_y_n: calls $0.20
Notatur: folds 
*** FLOP *** [Kc 4s 4h]
t_m_y_n: checks 
fish72o: bets $0.19
t_m_y_n: raises $0.19 to $0.38
fish72o: folds 
Uncalled bet ($0.19) returned to t_m_y_n
t_m_y_n collected $0.94 from pot
t_m_y_n: doesn't show hand 
*** SUMMARY ***
Total pot $0.98 | Rake $0.04 
Board [Kc 4s 4h]
Seat 1: Tyoma_Kovach folded before Flop (didn't bet)
Seat 2: negritos81 folded before Flop (didn't bet)
Seat 3: thedude696969 folded before Flop (didn't bet)
Seat 4: fish72o (button) folded on the Flop
Seat 5: t_m_y_n (small blind) collected ($0.94)
Seat 6: Notatur (big blind) folded before Flop



PokerStars Hand #222945910908:  Hold'em No Limit ($0.05/$0.10 USD) - 2021/01/23 1:19:02 ET
Table 'Algieba III' 6-max Seat #5 is the button
Seat 1: Tyoma_Kovach ($10 in chips) 
Seat 2: negritos81 ($18.79 in chips) 
Seat 3: thedude696969 ($28.11 in chips) 
Seat 4: fish72o ($10.50 in chips) 
Seat 5: t_m_y_n ($6.90 in chips) 
Seat 6: Notatur ($11.27 in chips) 
Notatur: posts small blind $0.05
Tyoma_Kovach: posts big blind $0.10
*** HOLE CARDS ***
negritos81: folds 
thedude696969: folds 
fish72o: folds 
t_m_y_n: folds 
Notatur: raises $0.15 to $0.25
Tyoma_Kovach: calls $0.15
*** FLOP *** [8c Ks 4d]
Notatur: bets $0.20
Tyoma_Kovach: folds 
Uncalled bet ($0.20) returned to Notatur
Notatur collected $0.48 from pot
Notatur: doesn't show hand 
*** SUMMARY ***
Total pot $0.50 | Rake $0.02 
Board [8c Ks 4d]
Seat 1: Tyoma_Kovach (big blind) folded on the Flop
Seat 2: negritos81 folded before Flop (didn't bet)
Seat 3: thedude696969 folded before Flop (didn't bet)
Seat 4: fish72o folded before Flop (didn't bet)
Seat 5: t_m_y_n (button) folded before Flop (didn't bet)
Seat 6: Notatur (small blind) collected ($0.48)



PokerStars Hand #222945916924:  Hold'em No Limit ($0.05/$0.10 USD) - 2021/01/23 1:19:26 ET
Table 'Algieba III' 6-max Seat #6 is the button
Seat 1: Tyoma_Kovach ($10 in chips) 
Seat 2: negritos81 ($18.79 in chips) 
Seat 3: thedude696969 ($28.11 in chips) 
Seat 4: fish72o ($10.50 in chips) 
Seat 5: t_m_y_n ($6.90 in chips) 
Seat 6: Notatur ($11.50 in chips) 
Tyoma_Kovach: posts small blind $0.05
negritos81: posts big blind $0.10
*** HOLE CARDS ***
thedude696969: folds 
fish72o: folds 
t_m_y_n: raises $0.10 to $0.20
Notatur: folds 
Tyoma_Kovach: folds 
negritos81: raises $0.90 to $1.10
t_m_y_n: folds 
Uncalled bet ($0.90) returned to negritos81
negritos81 collected $0.45 from pot
negritos81: doesn't show hand 
*** SUMMARY ***
Total pot $0.45 | Rake $0 
Seat 1: Tyoma_Kovach (small blind) folded before Flop
Seat 2: negritos81 (big blind) collected ($0.45)
Seat 3: thedude696969 folded before Flop (didn't bet)
Seat 4: fish72o folded before Flop (didn't bet)
Seat 5: t_m_y_n folded before Flop
Seat 6: Notatur (button) folded before Flop (didn't bet)



PokerStars Hand #222945923344:  Hold'em No Limit ($0.05/$0.10 USD) - 2021/01/23 1:19:53 ET
Table 'Algieba III' 6-max Seat #1 is the button
Seat 1: Tyoma_Kovach ($10 in chips) 
Seat 2: negritos81 ($19.04 in chips) 
Seat 3: thedude696969 ($28.11 in chips) 
Seat 4: fish72o ($10.50 in chips) 
Seat 5: t_m_y_n ($6.70 in chips) 
Seat 6: Notatur ($11.50 in chips) 
negritos81: posts small blind $0.05
thedude696969: posts big blind $0.10
*** HOLE CARDS ***
fish72o: folds 
t_m_y_n: folds 
Notatur: folds 
Tyoma_Kovach: folds 
negritos81: folds 
Uncalled bet ($0.05) returned to thedude696969
thedude696969 collected $0.10 from pot
thedude696969: doesn't show hand 
*** SUMMARY ***
Total pot $0.10 | Rake $0 
Seat 1: Tyoma_Kovach (button) folded before Flop (didn't bet)
Seat 2: negritos81 (small blind) folded before Flop
Seat 3: thedude696969 (big blind) collected ($0.10)
Seat 4: fish72o folded before Flop (didn't bet)
Seat 5: t_m_y_n folded before Flop (didn't bet)
Seat 6: Notatur folded before Flop (didn't bet)



PokerStars Hand #222945926099:  Hold'em No Limit ($0.05/$0.10 USD) - 2021/01/23 1:20:04 ET
Table 'Algieba III' 6-max Seat #2 is the button
Seat 1: Tyoma_Kovach ($10 in chips) 
Seat 2: negritos81 ($18.99 in chips) 
Seat 3: thedude696969 ($28.16 in chips) 
Seat 4: fish72o ($10.50 in chips) 
Seat 5: t_m_y_n ($6.70 in chips) 
Seat 6: Notatur ($11.50 in chips) 
thedude696969: posts small blind $0.05
fish72o: posts big blind $0.10
*** HOLE CARDS ***
t_m_y_n: folds 
Notatur: folds 
Tyoma_Kovach: folds 
negritos81: folds 
thedude696969: raises $0.20 to $0.30
fish72o: folds 
Uncalled bet ($0.20) returned to thedude696969
thedude696969 collected $0.20 from pot
thedude696969: doesn't show hand 
*** SUMMARY ***
Total pot $0.20 | Rake $0 
Seat 1: Tyoma_Kovach folded before Flop (didn't bet)
Seat 2: negritos81 (button) folded before Flop (didn't bet)
Seat 3: thedude696969 (small blind) collected ($0.20)
Seat 4: fish72o (big blind) folded before Flop
Seat 5: t_m_y_n folded before Flop (didn't bet)
Seat 6: Notatur folded before Flop (didn't bet)



PokerStars Hand #222945930350:  Hold'em No Limit ($0.05/$0.10 USD) - 2021/01/23 1:20:21 ET
Table 'Algieba III' 6-max Seat #3 is the button
Seat 1: Tyoma_Kovach ($10 in chips) 
Seat 2: negritos81 ($18.99 in chips) 
Seat 3: thedude696969 ($28.26 in chips) 
Seat 4: fish72o ($10.40 in chips) 
Seat 5: t_m_y_n ($6.70 in chips) 
Seat 6: Notatur ($11.50 in chips) 
fish72o: posts small blind $0.05
t_m_y_n: posts big blind $0.10
*** HOLE CARDS ***
Notatur: folds 
Tyoma_Kovach: folds 
negritos81: folds 
thedude696969: raises $0.20 to $0.30
fish72o: folds 
t_m_y_n: calls $0.20
*** FLOP *** [8s 2h Ts]
t_m_y_n: checks 
thedude696969: checks 
*** TURN *** [8s 2h Ts] [Ad]
t_m_y_n: bets $0.21
thedude696969: calls $0.21
*** RIVER *** [8s 2h Ts Ad] [2s]
t_m_y_n: checks 
thedude696969: bets $0.70
t_m_y_n: folds 
Uncalled bet ($0.70) returned to thedude696969
thedude696969 collected $1.02 from pot
thedude696969: doesn't show hand 
*** SUMMARY ***
Total pot $1.07 | Rake $0.05 
Board [8s 2h Ts Ad 2s]
Seat 1: Tyoma_Kovach folded before Flop (didn't bet)
Seat 2: negritos81 folded before Flop (didn't bet)
Seat 3: thedude696969 (button) collected ($1.02)
Seat 4: fish72o (small blind) folded before Flop
Seat 5: t_m_y_n (big blind) folded on the River
Seat 6: Notatur folded before Flop (didn't bet)



PokerStars Hand #222945944188:  Hold'em No Limit ($0.05/$0.10 USD) - 2021/01/23 1:21:18 ET
Table 'Algieba III' 6-max Seat #4 is the button
Seat 1: Tyoma_Kovach ($10 in chips) 
Seat 2: negritos81 ($18.99 in chips) 
Seat 3: thedude696969 ($28.77 in chips) 
Seat 4: fish72o ($10.35 in chips) 
Seat 5: t_m_y_n ($6.19 in chips) 
Seat 6: Notatur ($11.50 in chips) 
t_m_y_n: posts small blind $0.05
Notatur: posts big blind $0.10
*** HOLE CARDS ***
Tyoma_Kovach: folds 
negritos81 has timed out
negritos81: folds 
thedude696969: folds 
fish72o: raises $0.15 to $0.25
t_m_y_n: folds 
Notatur: folds 
Uncalled bet ($0.15) returned to fish72o
fish72o collected $0.25 from pot
fish72o: doesn't show hand 
*** SUMMARY ***
Total pot $0.25 | Rake $0 
Seat 1: Tyoma_Kovach folded before Flop (didn't bet)
Seat 2: negritos81 folded before Flop (didn't bet)
Seat 3: thedude696969 folded before Flop (didn't bet)
Seat 4: fish72o (button) collected ($0.25)
Seat 5: t_m_y_n (small blind) folded before Flop
Seat 6: Notatur (big blind) folded before Flop



PokerStars Hand #222945950031:  Hold'em No Limit ($0.05/$0.10 USD) - 2021/01/23 1:21:42 ET
Table 'Algieba III' 6-max Seat #5 is the button
Seat 1: Tyoma_Kovach ($10 in chips) 
Seat 2: negritos81 ($18.99 in chips) 
Seat 3: thedude696969 ($28.77 in chips) 
Seat 4: fish72o ($10.50 in chips) 
Seat 5: t_m_y_n ($6.14 in chips) 
Seat 6: Notatur ($11.40 in chips) 
Notatur: posts small blind $0.05
Tyoma_Kovach: posts big blind $0.10
*** HOLE CARDS ***
negritos81: folds 
thedude696969: folds 
fish72o: folds 
t_m_y_n: raises $0.10 to $0.20
Notatur: folds 
Tyoma_Kovach: folds 
Uncalled bet ($0.10) returned to t_m_y_n
t_m_y_n collected $0.25 from pot
t_m_y_n: doesn't show hand 
*** SUMMARY ***
Total pot $0.25 | Rake $0 
Seat 1: Tyoma_Kovach (big blind) folded before Flop
Seat 2: negritos81 folded before Flop (didn't bet)
Seat 3: thedude696969 folded before Flop (didn't bet)
Seat 4: fish72o folded before Flop (didn't bet)
Seat 5: t_m_y_n (button) collected ($0.25)
Seat 6: Notatur (small blind) folded before Flop



PokerStars Hand #222945956129:  Hold'em No Limit ($0.05/$0.10 USD) - 2021/01/23 1:22:08 ET
Table 'Algieba III' 6-max Seat #6 is the button
Seat 1: Tyoma_Kovach ($10 in chips) 
Seat 3: thedude696969 ($28.77 in chips) 
Seat 4: fish72o ($10.50 in chips) 
Seat 5: t_m_y_n ($6.29 in chips) 
Seat 6: Notatur ($11.35 in chips) 
Tyoma_Kovach: posts small blind $0.05
thedude696969: posts big blind $0.10
*** HOLE CARDS ***
fish72o: folds 
t_m_y_n: folds 
negritos81 leaves the table
Notatur: raises $0.15 to $0.25
Tyoma_Kovach: folds 
thedude696969: folds 
Uncalled bet ($0.15) returned to Notatur
Notatur collected $0.25 from pot
Notatur: doesn't show hand 
Gutik535 joins the table at seat #2 
*** SUMMARY ***
Total pot $0.25 | Rake $0 
Seat 1: Tyoma_Kovach (small blind) folded before Flop
Seat 3: thedude696969 (big blind) folded before Flop
Seat 4: fish72o folded before Flop (didn't bet)
Seat 5: t_m_y_n folded before Flop (didn't bet)
Seat 6: Notatur (button) collected ($0.25)



PokerStars Hand #222945960437:  Hold'em No Limit ($0.05/$0.10 USD) - 2021/01/23 1:22:25 ET
Table 'Algieba III' 6-max Seat #1 is the button
Seat 1: Tyoma_Kovach ($10 in chips) 
Seat 3: thedude696969 ($28.67 in chips) 
Seat 4: fish72o ($10.50 in chips) 
Seat 5: t_m_y_n ($6.29 in chips) 
Seat 6: Notatur ($11.50 in chips) 
thedude696969: posts small blind $0.05
fish72o: posts big blind $0.10
*** HOLE CARDS ***
t_m_y_n: folds 
Notatur: folds 
Tyoma_Kovach: folds 
thedude696969: folds 
Uncalled bet ($0.05) returned to fish72o
fish72o collected $0.10 from pot
fish72o: doesn't show hand 
*** SUMMARY ***
Total pot $0.10 | Rake $0 
Seat 1: Tyoma_Kovach (button) folded before Flop (didn't bet)
Seat 3: thedude696969 (small blind) folded before Flop
Seat 4: fish72o (big blind) collected ($0.10)
Seat 5: t_m_y_n folded before Flop (didn't bet)
Seat 6: Notatur folded before Flop (didn't bet)



PokerStars Hand #222945962830:  Hold'em No Limit ($0.05/$0.10 USD) - 2021/01/23 1:22:35 ET
Table 'Algieba III' 6-max Seat #3 is the button
Seat 1: Tyoma_Kovach ($10 in chips) 
Seat 3: thedude696969 ($28.62 in chips) 
Seat 4: fish72o ($10.55 in chips) 
Seat 5: t_m_y_n ($6.29 in chips) 
Seat 6: Notatur ($11.50 in chips) 
fish72o: posts small blind $0.05
t_m_y_n: posts big blind $0.10
Gutik535: sits out 
*** HOLE CARDS ***
Notatur: folds 
Tyoma_Kovach: raises $0.18 to $0.28
thedude696969: raises $0.82 to $1.10
fish72o: folds 
t_m_y_n: folds 
Tyoma_Kovach: calls $0.82
*** FLOP *** [2c 7s 8s]
Tyoma_Kovach: checks 
thedude696969: bets $1.12
Tyoma_Kovach: folds 
Uncalled bet ($1.12) returned to thedude696969
thedude696969 collected $2.24 from pot
thedude696969: doesn't show hand 
*** SUMMARY ***
Total pot $2.35 | Rake $0.11 
Board [2c 7s 8s]
Seat 1: Tyoma_Kovach folded on the Flop
Seat 3: thedude696969 (button) collected ($2.24)
Seat 4: fish72o (small blind) folded before Flop
Seat 5: t_m_y_n (big blind) folded before Flop
Seat 6: Notatur folded before Flop (didn't bet)



PokerStars Hand #222945971685:  Hold'em No Limit ($0.05/$0.10 USD) - 2021/01/23 1:23:12 ET
Table 'Algieba III' 6-max Seat #4 is the button
Seat 1: Tyoma_Kovach ($10 in chips) 
Seat 3: thedude696969 ($29.76 in chips) 
Seat 4: fish72o ($10.50 in chips) 
Seat 5: t_m_y_n ($6.19 in chips) 
Seat 6: Notatur ($11.50 in chips) 
t_m_y_n: posts small blind $0.05
Notatur: posts big blind $0.10
Gutik535: sits out 
*** HOLE CARDS ***
Tyoma_Kovach: raises $0.20 to $0.30
thedude696969: folds 
fish72o: folds 
t_m_y_n: calls $0.25
Notatur: folds 
*** FLOP *** [9h Ad Jc]
t_m_y_n: checks 
Tyoma_Kovach: bets $0.22
t_m_y_n: calls $0.22
*** TURN *** [9h Ad Jc] [9c]
t_m_y_n: checks 
Tyoma_Kovach: checks 
*** RIVER *** [9h Ad Jc 9c] [Td]
t_m_y_n: bets $0.54
Tyoma_Kovach: raises $1.19 to $1.73
t_m_y_n: raises $3.94 to $5.67 and is all-in
Tyoma_Kovach: calls $3.94
*** SHOW DOWN ***
t_m_y_n: shows [Ts Th] (a full house, Tens full of Nines)
Tyoma_Kovach: shows [Kd Qc] (a straight, Ten to Ace)
t_m_y_n collected $11.92 from pot
*** SUMMARY ***
Total pot $12.48 | Rake $0.56 
Board [9h Ad Jc 9c Td]
Seat 1: Tyoma_Kovach showed [Kd Qc] and lost with a straight, Ten to Ace
Seat 3: thedude696969 folded before Flop (didn't bet)
Seat 4: fish72o (button) folded before Flop (didn't bet)
Seat 5: t_m_y_n (small blind) showed [Ts Th] and won ($11.92) with a full house, Tens full of Nines
Seat 6: Notatur (big blind) folded before Flop



PokerStars Hand #222945982563:  Hold'em No Limit ($0.05/$0.10 USD) - 2021/01/23 1:23:56 ET
Table 'Algieba III' 6-max Seat #5 is the button
Seat 1: Tyoma_Kovach ($10 in chips) 
Seat 3: thedude696969 ($29.76 in chips) 
Seat 4: fish72o ($10.50 in chips) 
Seat 5: t_m_y_n ($11.92 in chips) 
Seat 6: Notatur ($11.40 in chips) 
Notatur: posts small blind $0.05
Tyoma_Kovach: posts big blind $0.10
Gutik535: sits out 
*** HOLE CARDS ***
thedude696969: raises $0.20 to $0.30
fish72o: folds 
t_m_y_n: folds 
Notatur: folds 
Tyoma_Kovach: raises $0.88 to $1.18
thedude696969: calls $0.88
*** FLOP *** [8h 8c 9s]
Tyoma_Kovach: checks 
thedude696969: bets $1.30
Tyoma_Kovach: raises $7.52 to $8.82 and is all-in
thedude696969: calls $7.52
*** TURN *** [8h 8c 9s] [As]
*** RIVER *** [8h 8c 9s As] [5s]
*** SHOW DOWN ***
Tyoma_Kovach: shows [Th Td] (two pair, Tens and Eights)
thedude696969: shows [9c 5c] (two pair, Nines and Eights)
Tyoma_Kovach collected $19.15 from pot
*** SUMMARY ***
Total pot $20.05 | Rake $0.90 
Board [8h 8c 9s As 5s]
Seat 1: Tyoma_Kovach (big blind) showed [Th Td] and won ($19.15) with two pair, Tens and Eights
Seat 3: thedude696969 showed [9c 5c] and lost with two pair, Nines and Eights
Seat 4: fish72o folded before Flop (didn't bet)
Seat 5: t_m_y_n (button) folded before Flop (didn't bet)
Seat 6: Notatur (small blind) folded before Flop



PokerStars Hand #222945993204:  Hold'em No Limit ($0.05/$0.10 USD) - 2021/01/23 1:24:40 ET
Table 'Algieba III' 6-max Seat #6 is the button
Seat 1: Tyoma_Kovach ($19.15 in chips) 
Seat 2: Gutik535 ($10 in chips) 
Seat 3: thedude696969 ($19.76 in chips) 
Seat 4: fish72o ($10.50 in chips) 
Seat 5: t_m_y_n ($11.92 in chips) 
Seat 6: Notatur ($11.35 in chips) 
Tyoma_Kovach: posts small blind $0.05
Gutik535: posts big blind $0.10
*** HOLE CARDS ***
thedude696969: raises $0.20 to $0.30
fish72o: folds 
t_m_y_n: folds 
Notatur: folds 
Tyoma_Kovach: folds 
Gutik535: folds 
Uncalled bet ($0.20) returned to thedude696969
thedude696969 collected $0.25 from pot
thedude696969: doesn't show hand 
*** SUMMARY ***
Total pot $0.25 | Rake $0 
Seat 1: Tyoma_Kovach (small blind) folded before Flop
Seat 2: Gutik535 (big blind) folded before Flop
Seat 3: thedude696969 collected ($0.25)
Seat 4: fish72o folded before Flop (didn't bet)
Seat 5: t_m_y_n folded before Flop (didn't bet)
Seat 6: Notatur (button) folded before Flop (didn't bet)



PokerStars Hand #222945997148:  Hold'em No Limit ($0.05/$0.10 USD) - 2021/01/23 1:24:56 ET
Table 'Algieba III' 6-max Seat #1 is the button
Seat 1: Tyoma_Kovach ($19.10 in chips) 
Seat 2: Gutik535 ($10 in chips) 
Seat 4: fish72o ($10.50 in chips) 
Seat 5: t_m_y_n ($11.92 in chips) 
Seat 6: Notatur ($11.35 in chips) 
Gutik535: posts small blind $0.05
thedude696969: is sitting out 
fish72o: posts big blind $0.10
*** HOLE CARDS ***
t_m_y_n: raises $0.20 to $0.30
Notatur: folds 
Tyoma_Kovach: raises $0.67 to $0.97
Gutik535: folds 
fish72o: folds 
t_m_y_n: calls $0.67
*** FLOP *** [9h Kh Qs]
t_m_y_n: bets $1
Tyoma_Kovach: folds 
Uncalled bet ($1) returned to t_m_y_n
t_m_y_n collected $2 from pot
t_m_y_n: doesn't show hand 
*** SUMMARY ***
Total pot $2.09 | Rake $0.09 
Board [9h Kh Qs]
Seat 1: Tyoma_Kovach (button) folded on the Flop
Seat 2: Gutik535 (small blind) folded before Flop
Seat 4: fish72o (big blind) folded before Flop
Seat 5: t_m_y_n collected ($2)
Seat 6: Notatur folded before Flop (didn't bet)



PokerStars Hand #222946005171:  Hold'em No Limit ($0.05/$0.10 USD) - 2021/01/23 1:25:30 ET
Table 'Algieba III' 6-max Seat #2 is the button
Seat 1: Tyoma_Kovach ($18.13 in chips) 
Seat 2: Gutik535 ($10 in chips) 
Seat 4: fish72o ($10.40 in chips) 
Seat 5: t_m_y_n ($12.95 in chips) 
Seat 6: Notatur ($11.35 in chips) 
fish72o: posts small blind $0.05
t_m_y_n: posts big blind $0.10
*** HOLE CARDS ***
Notatur: folds 
Tyoma_Kovach: folds 
Gutik535: folds 
fish72o: folds 
Uncalled bet ($0.05) returned to t_m_y_n
t_m_y_n collected $0.10 from pot
t_m_y_n: doesn't show hand 
*** SUMMARY ***
Total pot $0.10 | Rake $0 
Seat 1: Tyoma_Kovach folded before Flop (didn't bet)
Seat 2: Gutik535 (button) folded before Flop (didn't bet)
Seat 4: fish72o (small blind) folded before Flop
Seat 5: t_m_y_n (big blind) collected ($0.10)
Seat 6: Notatur folded before Flop (didn't bet)



PokerStars Hand #222946008722:  Hold'em No Limit ($0.05/$0.10 USD) - 2021/01/23 1:25:44 ET
Table 'Algieba III' 6-max Seat #4 is the button
Seat 1: Tyoma_Kovach ($18.13 in chips) 
Seat 2: Gutik535 ($10 in chips) 
Seat 3: thedude696969 ($19.91 in chips) 
Seat 4: fish72o ($10.35 in chips) 
Seat 5: t_m_y_n ($13 in chips) 
Seat 6: Notatur ($11.35 in chips) 
t_m_y_n: posts small blind $0.05
Notatur: posts big blind $0.10
thedude696969: posts small & big blinds $0.15
*** HOLE CARDS ***
Tyoma_Kovach: folds 
Gutik535: raises $0.30 to $0.40
thedude696969: folds 
fish72o: folds 
t_m_y_n: calls $0.35
Notatur: calls $0.30
*** FLOP *** [3c 2h 5s]
t_m_y_n: checks 
Notatur: checks 
Gutik535: checks 
*** TURN *** [3c 2h 5s] [6c]
t_m_y_n: bets $0.44
Notatur: folds 
Gutik535: calls $0.44
*** RIVER *** [3c 2h 5s 6c] [8h]
t_m_y_n: bets $0.66
Gutik535: calls $0.66
*** SHOW DOWN ***
t_m_y_n: shows [8c 9c] (a pair of Eights)
Gutik535: mucks hand 
t_m_y_n collected $3.39 from pot
*** SUMMARY ***
Total pot $3.55 | Rake $0.16 
Board [3c 2h 5s 6c 8h]
Seat 1: Tyoma_Kovach folded before Flop (didn't bet)
Seat 2: Gutik535 mucked
Seat 3: thedude696969 folded before Flop (didn't bet)
Seat 4: fish72o (button) folded before Flop (didn't bet)
Seat 5: t_m_y_n (small blind) showed [8c 9c] and won ($3.39) with a pair of Eights
Seat 6: Notatur (big blind) folded on the Turn



PokerStars Hand #222946023512:  Hold'em No Limit ($0.05/$0.10 USD) - 2021/01/23 1:26:46 ET
Table 'Algieba III' 6-max Seat #5 is the button
Seat 1: Tyoma_Kovach ($18.13 in chips) 
Seat 2: Gutik535 ($10 in chips) 
Seat 3: thedude696969 ($19.76 in chips) 
Seat 4: fish72o ($10.35 in chips) 
Seat 5: t_m_y_n ($14.89 in chips) 
Seat 6: Notatur ($10.95 in chips) 
Notatur: posts small blind $0.05
Tyoma_Kovach: posts big blind $0.10
*** HOLE CARDS ***
Gutik535: folds 
thedude696969: folds 
fish72o: folds 
t_m_y_n: raises $0.10 to $0.20
Notatur: raises $0.65 to $0.85
Tyoma_Kovach: folds 
t_m_y_n: folds 
Uncalled bet ($0.65) returned to Notatur
Notatur collected $0.50 from pot
Notatur: doesn't show hand 
*** SUMMARY ***
Total pot $0.50 | Rake $0 
Seat 1: Tyoma_Kovach (big blind) folded before Flop
Seat 2: Gutik535 folded before Flop (didn't bet)
Seat 3: thedude696969 folded before Flop (didn't bet)
Seat 4: fish72o folded before Flop (didn't bet)
Seat 5: t_m_y_n (button) folded before Flop
Seat 6: Notatur (small blind) collected ($0.50)



PokerStars Hand #222946028721:  Hold'em No Limit ($0.05/$0.10 USD) - 2021/01/23 1:27:08 ET
Table 'Algieba III' 6-max Seat #6 is the button
Seat 1: Tyoma_Kovach ($18.03 in chips) 
Seat 2: Gutik535 ($10 in chips) 
Seat 3: thedude696969 ($19.76 in chips) 
Seat 4: fish72o ($10.35 in chips) 
Seat 5: t_m_y_n ($14.69 in chips) 
Seat 6: Notatur ($11.25 in chips) 
Tyoma_Kovach: posts small blind $0.05
Gutik535: posts big blind $0.10
*** HOLE CARDS ***
thedude696969: folds 
fish72o: folds 
t_m_y_n: folds 
Notatur: raises $0.15 to $0.25
Tyoma_Kovach: folds 
Gutik535: folds 
Uncalled bet ($0.15) returned to Notatur
Notatur collected $0.25 from pot
Notatur: doesn't show hand 
*** SUMMARY ***
Total pot $0.25 | Rake $0 
Seat 1: Tyoma_Kovach (small blind) folded before Flop
Seat 2: Gutik535 (big blind) folded before Flop
Seat 3: thedude696969 folded before Flop (didn't bet)
Seat 4: fish72o folded before Flop (didn't bet)
Seat 5: t_m_y_n folded before Flop (didn't bet)
Seat 6: Notatur (button) collected ($0.25)



PokerStars Hand #222946033707:  Hold'em No Limit ($0.05/$0.10 USD) - 2021/01/23 1:27:29 ET
Table 'Algieba III' 6-max Seat #1 is the button
Seat 1: Tyoma_Kovach ($17.98 in chips) 
Seat 2: Gutik535 ($10 in chips) 
Seat 3: thedude696969 ($19.76 in chips) 
Seat 4: fish72o ($10.35 in chips) 
Seat 5: t_m_y_n ($14.69 in chips) 
Seat 6: Notatur ($11.40 in chips) 
Gutik535: posts small blind $0.05
thedude696969: posts big blind $0.10
*** HOLE CARDS ***
fish72o: folds 
t_m_y_n: folds 
Notatur: folds 
Tyoma_Kovach: folds 
Gutik535: folds 
Uncalled bet ($0.05) returned to thedude696969
thedude696969 collected $0.10 from pot
thedude696969: doesn't show hand 
*** SUMMARY ***
Total pot $0.10 | Rake $0 
Seat 1: Tyoma_Kovach (button) folded before Flop (didn't bet)
Seat 2: Gutik535 (small blind) folded before Flop
Seat 3: thedude696969 (big blind) collected ($0.10)
Seat 4: fish72o folded before Flop (didn't bet)
Seat 5: t_m_y_n folded before Flop (didn't bet)
Seat 6: Notatur folded before Flop (didn't bet)



PokerStars Hand #222946036408:  Hold'em No Limit ($0.05/$0.10 USD) - 2021/01/23 1:27:40 ET
Table 'Algieba III' 6-max Seat #2 is the button
Seat 1: Tyoma_Kovach ($17.98 in chips) 
Seat 2: Gutik535 ($10 in chips) 
Seat 3: thedude696969 ($19.81 in chips) 
Seat 4: fish72o ($10.35 in chips) 
Seat 5: t_m_y_n ($14.69 in chips) 
Seat 6: Notatur ($11.40 in chips) 
thedude696969: posts small blind $0.05
fish72o: posts big blind $0.10
*** HOLE CARDS ***
t_m_y_n: raises $0.10 to $0.20
Notatur: folds 
Tyoma_Kovach: folds 
Gutik535: folds 
thedude696969: raises $0.60 to $0.80
fish72o: folds 
t_m_y_n: calls $0.60
*** FLOP *** [8h 7d 5s]
thedude696969: bets $1
t_m_y_n: folds 
Uncalled bet ($1) returned to thedude696969
thedude696969 collected $1.62 from pot
thedude696969: doesn't show hand 
*** SUMMARY ***
Total pot $1.70 | Rake $0.08 
Board [8h 7d 5s]
Seat 1: Tyoma_Kovach folded before Flop (didn't bet)
Seat 2: Gutik535 (button) folded before Flop (didn't bet)
Seat 3: thedude696969 (small blind) collected ($1.62)
Seat 4: fish72o (big blind) folded before Flop
Seat 5: t_m_y_n folded on the Flop
Seat 6: Notatur folded before Flop (didn't bet)



PokerStars Hand #222946042663:  Hold'em No Limit ($0.05/$0.10 USD) - 2021/01/23 1:28:06 ET
Table 'Algieba III' 6-max Seat #3 is the button
Seat 1: Tyoma_Kovach ($17.98 in chips) 
Seat 2: Gutik535 ($10 in chips) 
Seat 3: thedude696969 ($20.63 in chips) 
Seat 4: fish72o ($10.25 in chips) 
Seat 5: t_m_y_n ($13.89 in chips) 
Seat 6: Notatur ($11.40 in chips) 
fish72o: posts small blind $0.05
t_m_y_n: posts big blind $0.10
*** HOLE CARDS ***
Notatur: folds 
Tyoma_Kovach: folds 
Gutik535: folds 
thedude696969: folds 
fish72o: raises $0.15 to $0.25
t_m_y_n: calls $0.15
*** FLOP *** [2s 7s 3d]
fish72o: bets $0.32
t_m_y_n: calls $0.32
*** TURN *** [2s 7s 3d] [2c]
fish72o: bets $0.73
t_m_y_n: calls $0.73
*** RIVER *** [2s 7s 3d 2c] [Ts]
fish72o: checks 
t_m_y_n: bets $1.24
fish72o: calls $1.24
*** SHOW DOWN ***
t_m_y_n: shows [Jh 2h] (three of a kind, Deuces)
fish72o: mucks hand 
t_m_y_n collected $4.85 from pot
*** SUMMARY ***
Total pot $5.08 | Rake $0.23 
Board [2s 7s 3d 2c Ts]
Seat 1: Tyoma_Kovach folded before Flop (didn't bet)
Seat 2: Gutik535 folded before Flop (didn't bet)
Seat 3: thedude696969 (button) folded before Flop (didn't bet)
Seat 4: fish72o (small blind) mucked
Seat 5: t_m_y_n (big blind) showed [Jh 2h] and won ($4.85) with three of a kind, Deuces
Seat 6: Notatur folded before Flop (didn't bet)



PokerStars Hand #222946054766:  Hold'em No Limit ($0.05/$0.10 USD) - 2021/01/23 1:28:56 ET
Table 'Algieba III' 6-max Seat #4 is the button
Seat 1: Tyoma_Kovach ($17.98 in chips) 
Seat 2: Gutik535 ($10 in chips) 
Seat 3: thedude696969 ($20.63 in chips) 
Seat 4: fish72o ($10 in chips) 
Seat 5: t_m_y_n ($16.20 in chips) 
Seat 6: Notatur ($11.40 in chips) 
t_m_y_n: posts small blind $0.05
Notatur: posts big blind $0.10
*** HOLE CARDS ***
Tyoma_Kovach: folds 
Gutik535: folds 
thedude696969: folds 
fish72o: folds 
t_m_y_n: raises $0.10 to $0.20
Notatur: calls $0.10
*** FLOP *** [Ac 3h 3d]
t_m_y_n: bets $0.20
Notatur: folds 
Uncalled bet ($0.20) returned to t_m_y_n
t_m_y_n collected $0.38 from pot
t_m_y_n: doesn't show hand 
*** SUMMARY ***
Total pot $0.40 | Rake $0.02 
Board [Ac 3h 3d]
Seat 1: Tyoma_Kovach folded before Flop (didn't bet)
Seat 2: Gutik535 folded before Flop (didn't bet)
Seat 3: thedude696969 folded before Flop (didn't bet)
Seat 4: fish72o (button) folded before Flop (didn't bet)
Seat 5: t_m_y_n (small blind) collected ($0.38)
Seat 6: Notatur (big blind) folded on the Flop



PokerStars Hand #222946060785:  Hold'em No Limit ($0.05/$0.10 USD) - 2021/01/23 1:29:21 ET
Table 'Algieba III' 6-max Seat #5 is the button
Seat 1: Tyoma_Kovach ($17.98 in chips) 
Seat 2: Gutik535 ($10 in chips) 
Seat 3: thedude696969 ($20.63 in chips) 
Seat 4: fish72o ($10 in chips) 
Seat 5: t_m_y_n ($16.38 in chips) 
Seat 6: Notatur ($11.20 in chips) 
Notatur: posts small blind $0.05
Tyoma_Kovach: posts big blind $0.10
*** HOLE CARDS ***
Gutik535: raises $0.15 to $0.25
thedude696969: folds 
fish72o: folds 
t_m_y_n: folds 
Notatur: folds 
Tyoma_Kovach: folds 
Uncalled bet ($0.15) returned to Gutik535
Gutik535 collected $0.25 from pot
Gutik535: doesn't show hand 
*** SUMMARY ***
Total pot $0.25 | Rake $0 
Seat 1: Tyoma_Kovach (big blind) folded before Flop
Seat 2: Gutik535 collected ($0.25)
Seat 3: thedude696969 folded before Flop (didn't bet)
Seat 4: fish72o folded before Flop (didn't bet)
Seat 5: t_m_y_n (button) folded before Flop (didn't bet)
Seat 6: Notatur (small blind) folded before Flop



PokerStars Hand #222946064121:  Hold'em No Limit ($0.05/$0.10 USD) - 2021/01/23 1:29:34 ET
Table 'Algieba III' 6-max Seat #6 is the button
Seat 1: Tyoma_Kovach ($17.88 in chips) 
Seat 2: Gutik535 ($10.15 in chips) 
Seat 3: thedude696969 ($20.63 in chips) 
Seat 4: fish72o ($10 in chips) 
Seat 5: t_m_y_n ($16.38 in chips) 
Seat 6: Notatur ($11.15 in chips) 
Tyoma_Kovach: posts small blind $0.05
Gutik535: posts big blind $0.10
*** HOLE CARDS ***
thedude696969: folds 
fish72o: folds 
t_m_y_n: folds 
Notatur: folds 
Tyoma_Kovach: folds 
Uncalled bet ($0.05) returned to Gutik535
Gutik535 collected $0.10 from pot
Gutik535: doesn't show hand 
*** SUMMARY ***
Total pot $0.10 | Rake $0 
Seat 1: Tyoma_Kovach (small blind) folded before Flop
Seat 2: Gutik535 (big blind) collected ($0.10)
Seat 3: thedude696969 folded before Flop (didn't bet)
Seat 4: fish72o folded before Flop (didn't bet)
Seat 5: t_m_y_n folded before Flop (didn't bet)
Seat 6: Notatur (button) folded before Flop (didn't bet)



PokerStars Hand #222944642112:  Hold'em No Limit ($0.05/$0.10 USD) - 2021/01/23 0:00:37 ET
Table 'Algieba III' 6-max Seat #1 is the button
Seat 1: Tyoma_Kovach ($11.06 in chips) 
Seat 2: Palen030 ($3.89 in chips) 
Seat 3: thedude696969 ($23.88 in chips) 
Seat 4: 0nix770 ($16.82 in chips) 
Seat 5: johnnytrue ($9.46 in chips) 
Seat 6: Deniels7 ($15.92 in chips) 
Palen030: posts small blind $0.05
thedude696969: posts big blind $0.10
*** HOLE CARDS ***
0nix770: folds 
0nix770 leaves the table
johnnytrue: folds 
Deniels7: folds 
Tyoma_Kovach: folds 
Palen030: calls $0.05
fish72o joins the table at seat #4 
thedude696969: checks 
*** FLOP *** [5c Th 2s]
Palen030: checks 
thedude696969: bets $0.20
Palen030: folds 
Uncalled bet ($0.20) returned to thedude696969
thedude696969 collected $0.19 from pot
thedude696969: doesn't show hand 
*** SUMMARY ***
Total pot $0.20 | Rake $0.01 
Board [5c Th 2s]
Seat 1: Tyoma_Kovach (button) folded before Flop (didn't bet)
Seat 2: Palen030 (small blind) folded on the Flop
Seat 3: thedude696969 (big blind) collected ($0.19)
Seat 4: 0nix770 folded before Flop (didn't bet)
Seat 5: johnnytrue folded before Flop (didn't bet)
Seat 6: Deniels7 folded before Flop (didn't bet)



PokerStars Hand #222944648708:  Hold'em No Limit ($0.05/$0.10 USD) - 2021/01/23 0:01:02 ET
Table 'Algieba III' 6-max Seat #2 is the button
Seat 1: Tyoma_Kovach ($11.06 in chips) 
Seat 2: Palen030 ($3.79 in chips) 
Seat 3: thedude696969 ($23.97 in chips) 
Seat 4: fish72o ($10 in chips) 
Seat 5: johnnytrue ($9.46 in chips) 
Seat 6: Deniels7 ($15.92 in chips) 
thedude696969: posts small blind $0.05
fish72o: posts big blind $0.10
*** HOLE CARDS ***
johnnytrue: folds 
Deniels7: calls $0.10
Tyoma_Kovach: folds 
Palen030: folds 
thedude696969: calls $0.05
fish72o: checks 
*** FLOP *** [Th Ts Kh]
thedude696969: checks 
fish72o: checks 
Deniels7: checks 
*** TURN *** [Th Ts Kh] [Jc]
thedude696969: checks 
fish72o: checks 
Deniels7: checks 
*** RIVER *** [Th Ts Kh Jc] [Kd]
thedude696969: bets $0.20
fish72o: folds 
Deniels7: folds 
Uncalled bet ($0.20) returned to thedude696969
thedude696969 collected $0.29 from pot
thedude696969: doesn't show hand 
*** SUMMARY ***
Total pot $0.30 | Rake $0.01 
Board [Th Ts Kh Jc Kd]
Seat 1: Tyoma_Kovach folded before Flop (didn't bet)
Seat 2: Palen030 (button) folded before Flop (didn't bet)
Seat 3: thedude696969 (small blind) collected ($0.29)
Seat 4: fish72o (big blind) folded on the River
Seat 5: johnnytrue folded before Flop (didn't bet)
Seat 6: Deniels7 folded on the River



PokerStars Hand #222944662090:  Hold'em No Limit ($0.05/$0.10 USD) - 2021/01/23 0:01:51 ET
Table 'Algieba III' 6-max Seat #3 is the button
Seat 1: Tyoma_Kovach ($11.06 in chips) 
Seat 2: Palen030 ($3.79 in chips) 
Seat 3: thedude696969 ($24.16 in chips) 
Seat 4: fish72o ($10 in chips) 
Seat 5: johnnytrue ($9.46 in chips) 
Seat 6: Deniels7 ($15.82 in chips) 
fish72o: posts small blind $0.05
johnnytrue: posts big blind $0.10
*** HOLE CARDS ***
Deniels7: folds 
Tyoma_Kovach: folds 
Palen030: calls $0.10
thedude696969: raises $0.20 to $0.30
fish72o: folds 
johnnytrue: folds 
Palen030: calls $0.20
*** FLOP *** [Ts 7h 5c]
Palen030: checks 
thedude696969: checks 
*** TURN *** [Ts 7h 5c] [6c]
Palen030: checks 
thedude696969: checks 
*** RIVER *** [Ts 7h 5c 6c] [9c]
Palen030: checks 
thedude696969: checks 
*** SHOW DOWN ***
Palen030: shows [Ah Qs] (high card Ace)
thedude696969: shows [6d Qd] (a pair of Sixes)
thedude696969 collected $0.72 from pot
*** SUMMARY ***
Total pot $0.75 | Rake $0.03 
Board [Ts 7h 5c 6c 9c]
Seat 1: Tyoma_Kovach folded before Flop (didn't bet)
Seat 2: Palen030 showed [Ah Qs] and lost with high card Ace
Seat 3: thedude696969 (button) showed [6d Qd] and won ($0.72) with a pair of Sixes
Seat 4: fish72o (small blind) folded before Flop
Seat 5: johnnytrue (big blind) folded before Flop
Seat 6: Deniels7 folded before Flop (didn't bet)



PokerStars Hand #222944675156:  Hold'em No Limit ($0.05/$0.10 USD) - 2021/01/23 0:02:37 ET
Table 'Algieba III' 6-max Seat #4 is the button
Seat 1: Tyoma_Kovach ($11.06 in chips) 
Seat 2: Palen030 ($3.49 in chips) 
Seat 3: thedude696969 ($24.58 in chips) 
Seat 4: fish72o ($10 in chips) 
Seat 5: johnnytrue ($10 in chips) 
Seat 6: Deniels7 ($15.82 in chips) 
johnnytrue: posts small blind $0.05
Deniels7: posts big blind $0.10
*** HOLE CARDS ***
Tyoma_Kovach: folds 
Palen030: folds 
thedude696969: folds 
fish72o: folds 
johnnytrue: folds 
Uncalled bet ($0.05) returned to Deniels7
Deniels7 collected $0.10 from pot
Deniels7: doesn't show hand 
*** SUMMARY ***
Total pot $0.10 | Rake $0 
Seat 1: Tyoma_Kovach folded before Flop (didn't bet)
Seat 2: Palen030 folded before Flop (didn't bet)
Seat 3: thedude696969 folded before Flop (didn't bet)
Seat 4: fish72o (button) folded before Flop (didn't bet)
Seat 5: johnnytrue (small blind) folded before Flop
Seat 6: Deniels7 (big blind) collected ($0.10)



PokerStars Hand #222944677674:  Hold'em No Limit ($0.05/$0.10 USD) - 2021/01/23 0:02:46 ET
Table 'Algieba III' 6-max Seat #5 is the button
Seat 1: Tyoma_Kovach ($11.06 in chips) 
Seat 2: Palen030 ($3.49 in chips) 
Seat 3: thedude696969 ($24.58 in chips) 
Seat 4: fish72o ($10 in chips) 
Seat 5: johnnytrue ($9.95 in chips) 
Seat 6: Deniels7 ($15.87 in chips) 
Deniels7: posts small blind $0.05
Tyoma_Kovach: posts big blind $0.10
*** HOLE CARDS ***
Palen030: folds 
thedude696969: raises $0.20 to $0.30
fish72o: folds 
johnnytrue: calls $0.30
Deniels7: folds 
Tyoma_Kovach: folds 
*** FLOP *** [2h Qh 4h]
thedude696969: bets $0.50
johnnytrue: folds 
Uncalled bet ($0.50) returned to thedude696969
thedude696969 collected $0.72 from pot
thedude696969: doesn't show hand 
*** SUMMARY ***
Total pot $0.75 | Rake $0.03 
Board [2h Qh 4h]
Seat 1: Tyoma_Kovach (big blind) folded before Flop
Seat 2: Palen030 folded before Flop (didn't bet)
Seat 3: thedude696969 collected ($0.72)
Seat 4: fish72o folded before Flop (didn't bet)
Seat 5: johnnytrue (button) folded on the Flop
Seat 6: Deniels7 (small blind) folded before Flop



PokerStars Hand #222944688435:  Hold'em No Limit ($0.05/$0.10 USD) - 2021/01/23 0:03:25 ET
Table 'Algieba III' 6-max Seat #6 is the button
Seat 1: Tyoma_Kovach ($10.96 in chips) 
Seat 2: Palen030 ($3.49 in chips) 
Seat 3: thedude696969 ($25 in chips) 
Seat 4: fish72o ($10 in chips) 
Seat 5: johnnytrue ($9.65 in chips) 
Seat 6: Deniels7 ($15.82 in chips) 
Tyoma_Kovach: posts small blind $0.05
Palen030: posts big blind $0.10
*** HOLE CARDS ***
thedude696969: folds 
fish72o: folds 
johnnytrue: folds 
Deniels7: raises $0.10 to $0.20
Tyoma_Kovach: calls $0.15
Palen030: folds 
*** FLOP *** [8c 9c Tc]
Tyoma_Kovach: checks 
Deniels7: checks 
*** TURN *** [8c 9c Tc] [3h]
Tyoma_Kovach: bets $0.48
Deniels7: folds 
Uncalled bet ($0.48) returned to Tyoma_Kovach
Tyoma_Kovach collected $0.48 from pot
Tyoma_Kovach: doesn't show hand 
*** SUMMARY ***
Total pot $0.50 | Rake $0.02 
Board [8c 9c Tc 3h]
Seat 1: Tyoma_Kovach (small blind) collected ($0.48)
Seat 2: Palen030 (big blind) folded before Flop
Seat 3: thedude696969 folded before Flop (didn't bet)
Seat 4: fish72o folded before Flop (didn't bet)
Seat 5: johnnytrue folded before Flop (didn't bet)
Seat 6: Deniels7 (button) folded on the Turn



PokerStars Hand #222944709107:  Hold'em No Limit ($0.05/$0.10 USD) - 2021/01/23 0:04:02 ET
Table 'Algieba III' 6-max Seat #1 is the button
Seat 1: Tyoma_Kovach ($11.24 in chips) 
Seat 2: Palen030 ($3.39 in chips) 
Seat 3: thedude696969 ($25 in chips) 
Seat 4: fish72o ($10 in chips) 
Seat 5: johnnytrue ($9.65 in chips) 
Seat 6: Deniels7 ($15.62 in chips) 
Palen030: posts small blind $0.05
thedude696969: posts big blind $0.10
*** HOLE CARDS ***
fish72o: folds 
johnnytrue: calls $0.10
Deniels7: calls $0.10
Tyoma_Kovach: folds 
Palen030: folds 
thedude696969: checks 
*** FLOP *** [9s Ad 3s]
thedude696969: checks 
johnnytrue: checks 
Deniels7: checks 
*** TURN *** [9s Ad 3s] [6c]
thedude696969: checks 
johnnytrue: bets $0.33
Deniels7: folds 
thedude696969: folds 
Uncalled bet ($0.33) returned to johnnytrue
johnnytrue collected $0.33 from pot
*** SUMMARY ***
Total pot $0.35 | Rake $0.02 
Board [9s Ad 3s 6c]
Seat 1: Tyoma_Kovach (button) folded before Flop (didn't bet)
Seat 2: Palen030 (small blind) folded before Flop
Seat 3: thedude696969 (big blind) folded on the Turn
Seat 4: fish72o folded before Flop (didn't bet)
Seat 5: johnnytrue collected ($0.33)
Seat 6: Deniels7 folded on the Turn



PokerStars Hand #222944721627:  Hold'em No Limit ($0.05/$0.10 USD) - 2021/01/23 0:04:47 ET
Table 'Algieba III' 6-max Seat #2 is the button
Seat 1: Tyoma_Kovach ($11.24 in chips) 
Seat 2: Palen030 ($3.34 in chips) 
Seat 3: thedude696969 ($24.90 in chips) 
Seat 4: fish72o ($10 in chips) 
Seat 5: johnnytrue ($9.88 in chips) 
Seat 6: Deniels7 ($15.52 in chips) 
thedude696969: posts small blind $0.05
fish72o: posts big blind $0.10
*** HOLE CARDS ***
johnnytrue: folds 
Deniels7: raises $0.10 to $0.20
Tyoma_Kovach: folds 
Palen030: calls $0.20
thedude696969: folds 
fish72o: calls $0.10
*** FLOP *** [4h 4s Kh]
fish72o: checks 
Deniels7: checks 
Palen030: checks 
*** TURN *** [4h 4s Kh] [As]
fish72o: checks 
Deniels7: checks 
Palen030: checks 
*** RIVER *** [4h 4s Kh As] [7d]
fish72o: bets $0.20
Deniels7: calls $0.20
Palen030: folds 
*** SHOW DOWN ***
fish72o: shows [Th Ad] (two pair, Aces and Fours)
Deniels7: shows [Ah 5d] (two pair, Aces and Fours)
fish72o collected $0.50 from pot
Deniels7 collected $0.50 from pot
*** SUMMARY ***
Total pot $1.05 | Rake $0.05 
Board [4h 4s Kh As 7d]
Seat 1: Tyoma_Kovach folded before Flop (didn't bet)
Seat 2: Palen030 (button) folded on the River
Seat 3: thedude696969 (small blind) folded before Flop
Seat 4: fish72o (big blind) showed [Th Ad] and won ($0.50) with two pair, Aces and Fours
Seat 5: johnnytrue folded before Flop (didn't bet)
Seat 6: Deniels7 showed [Ah 5d] and won ($0.50) with two pair, Aces and Fours



PokerStars Hand #222944731460:  Hold'em No Limit ($0.05/$0.10 USD) - 2021/01/23 0:05:21 ET
Table 'Algieba III' 6-max Seat #3 is the button
Seat 1: Tyoma_Kovach ($11.24 in chips) 
Seat 2: Palen030 ($3.14 in chips) 
Seat 3: thedude696969 ($24.85 in chips) 
Seat 4: fish72o ($10.10 in chips) 
Seat 5: johnnytrue ($9.88 in chips) 
Seat 6: Deniels7 ($15.62 in chips) 
fish72o: posts small blind $0.05
johnnytrue: posts big blind $0.10
*** HOLE CARDS ***
Deniels7: calls $0.10
Tyoma_Kovach: folds 
Palen030: folds 
thedude696969: folds 
fish72o: folds 
johnnytrue: checks 
*** FLOP *** [8s 9c 4h]
johnnytrue: checks 
Deniels7: bets $0.10
johnnytrue: calls $0.10
*** TURN *** [8s 9c 4h] [6h]
johnnytrue: checks 
Deniels7: checks 
*** RIVER *** [8s 9c 4h 6h] [2s]
johnnytrue: bets $0.10
Deniels7: raises $0.63 to $0.73
johnnytrue: folds 
Uncalled bet ($0.63) returned to Deniels7
Deniels7 collected $0.62 from pot
Deniels7: doesn't show hand 
*** SUMMARY ***
Total pot $0.65 | Rake $0.03 
Board [8s 9c 4h 6h 2s]
Seat 1: Tyoma_Kovach folded before Flop (didn't bet)
Seat 2: Palen030 folded before Flop (didn't bet)
Seat 3: thedude696969 (button) folded before Flop (didn't bet)
Seat 4: fish72o (small blind) folded before Flop
Seat 5: johnnytrue (big blind) folded on the River
Seat 6: Deniels7 collected ($0.62)



PokerStars Hand #222944747342:  Hold'em No Limit ($0.05/$0.10 USD) - 2021/01/23 0:06:17 ET
Table 'Algieba III' 6-max Seat #4 is the button
Seat 1: Tyoma_Kovach ($11.24 in chips) 
Seat 2: Palen030 ($3.14 in chips) 
Seat 3: thedude696969 ($24.85 in chips) 
Seat 4: fish72o ($10.05 in chips) 
Seat 5: johnnytrue ($9.58 in chips) 
Seat 6: Deniels7 ($15.94 in chips) 
johnnytrue: posts small blind $0.05
Deniels7: posts big blind $0.10
*** HOLE CARDS ***
Tyoma_Kovach: folds 
Palen030: folds 
thedude696969: raises $0.13 to $0.23
fish72o: folds 
johnnytrue: folds 
Deniels7: calls $0.13
*** FLOP *** [7d Kc 5s]
Deniels7: checks 
thedude696969: bets $0.30
Deniels7: folds 
Uncalled bet ($0.30) returned to thedude696969
thedude696969 collected $0.49 from pot
thedude696969: doesn't show hand 
*** SUMMARY ***
Total pot $0.51 | Rake $0.02 
Board [7d Kc 5s]
Seat 1: Tyoma_Kovach folded before Flop (didn't bet)
Seat 2: Palen030 folded before Flop (didn't bet)
Seat 3: thedude696969 collected ($0.49)
Seat 4: fish72o (button) folded before Flop (didn't bet)
Seat 5: johnnytrue (small blind) folded before Flop
Seat 6: Deniels7 (big blind) folded on the Flop



PokerStars Hand #222944755915:  Hold'em No Limit ($0.05/$0.10 USD) - 2021/01/23 0:06:47 ET
Table 'Algieba III' 6-max Seat #5 is the button
Seat 1: Tyoma_Kovach ($11.24 in chips) 
Seat 2: Palen030 ($3.14 in chips) 
Seat 3: thedude696969 ($25.11 in chips) 
Seat 4: fish72o ($10.05 in chips) 
Seat 5: johnnytrue ($9.53 in chips) 
Seat 6: Deniels7 ($15.71 in chips) 
Deniels7: posts small blind $0.05
Tyoma_Kovach: posts big blind $0.10
*** HOLE CARDS ***
Palen030: folds 
thedude696969: folds 
fish72o: folds 
johnnytrue: calls $0.10
Deniels7: calls $0.05
Tyoma_Kovach: checks 
*** FLOP *** [4h Kc Qs]
Deniels7: checks 
Tyoma_Kovach: checks 
johnnytrue: checks 
*** TURN *** [4h Kc Qs] [2d]
Deniels7: checks 
Tyoma_Kovach: bets $0.22
johnnytrue: folds 
Deniels7: calls $0.22
*** RIVER *** [4h Kc Qs 2d] [Jc]
Deniels7: checks 
Tyoma_Kovach: bets $0.53
Deniels7: raises $0.53 to $1.06
Tyoma_Kovach: folds 
Uncalled bet ($0.53) returned to Deniels7
Deniels7 collected $1.72 from pot
Deniels7: doesn't show hand 
*** SUMMARY ***
Total pot $1.80 | Rake $0.08 
Board [4h Kc Qs 2d Jc]
Seat 1: Tyoma_Kovach (big blind) folded on the River
Seat 2: Palen030 folded before Flop (didn't bet)
Seat 3: thedude696969 folded before Flop (didn't bet)
Seat 4: fish72o folded before Flop (didn't bet)
Seat 5: johnnytrue (button) folded on the Turn
Seat 6: Deniels7 (small blind) collected ($1.72)



PokerStars Hand #222944770420:  Hold'em No Limit ($0.05/$0.10 USD) - 2021/01/23 0:07:37 ET
Table 'Algieba III' 6-max Seat #6 is the button
Seat 1: Tyoma_Kovach ($10.39 in chips) 
Seat 2: Palen030 ($3.14 in chips) 
Seat 3: thedude696969 ($25.11 in chips) 
Seat 4: fish72o ($10.05 in chips) 
Seat 5: johnnytrue ($9.43 in chips) 
Seat 6: Deniels7 ($16.58 in chips) 
Tyoma_Kovach: posts small blind $0.05
Palen030: posts big blind $0.10
*** HOLE CARDS ***
thedude696969: raises $0.13 to $0.23
fish72o: folds 
johnnytrue: folds 
Deniels7: folds 
Tyoma_Kovach: raises $0.77 to $1
Palen030: folds 
thedude696969: calls $0.77
*** FLOP *** [Jc 9c 4s]
Tyoma_Kovach: bets $0.66
thedude696969: folds 
Uncalled bet ($0.66) returned to Tyoma_Kovach
Tyoma_Kovach collected $2.01 from pot
Tyoma_Kovach: doesn't show hand 
*** SUMMARY ***
Total pot $2.10 | Rake $0.09 
Board [Jc 9c 4s]
Seat 1: Tyoma_Kovach (small blind) collected ($2.01)
Seat 2: Palen030 (big blind) folded before Flop
Seat 3: thedude696969 folded on the Flop
Seat 4: fish72o folded before Flop (didn't bet)
Seat 5: johnnytrue folded before Flop (didn't bet)
Seat 6: Deniels7 (button) folded before Flop (didn't bet)



PokerStars Hand #222944785154:  Hold'em No Limit ($0.05/$0.10 USD) - 2021/01/23 0:08:29 ET
Table 'Algieba III' 6-max Seat #1 is the button
Seat 1: Tyoma_Kovach ($11.40 in chips) 
Seat 2: Palen030 ($3.04 in chips) 
Seat 3: thedude696969 ($24.11 in chips) 
Seat 4: fish72o ($10.05 in chips) 
Seat 5: johnnytrue ($9.43 in chips) 
Seat 6: Deniels7 ($16.58 in chips) 
Palen030: posts small blind $0.05
thedude696969: posts big blind $0.10
*** HOLE CARDS ***
fish72o: folds 
johnnytrue: folds 
Deniels7: folds 
Tyoma_Kovach: folds 
Palen030: calls $0.05
thedude696969: raises $0.20 to $0.30
Palen030: calls $0.20
*** FLOP *** [Kc 8c Kh]
Palen030: checks 
thedude696969: bets $0.30
Palen030: calls $0.30
*** TURN *** [Kc 8c Kh] [Ts]
Palen030: checks 
thedude696969: bets $0.82
Palen030: folds 
Uncalled bet ($0.82) returned to thedude696969
thedude696969 collected $1.15 from pot
thedude696969: doesn't show hand 
*** SUMMARY ***
Total pot $1.20 | Rake $0.05 
Board [Kc 8c Kh Ts]
Seat 1: Tyoma_Kovach (button) folded before Flop (didn't bet)
Seat 2: Palen030 (small blind) folded on the Turn
Seat 3: thedude696969 (big blind) collected ($1.15)
Seat 4: fish72o folded before Flop (didn't bet)
Seat 5: johnnytrue folded before Flop (didn't bet)
Seat 6: Deniels7 folded before Flop (didn't bet)



PokerStars Hand #222944795154:  Hold'em No Limit ($0.05/$0.10 USD) - 2021/01/23 0:09:04 ET
Table 'Algieba III' 6-max Seat #2 is the button
Seat 1: Tyoma_Kovach ($11.40 in chips) 
Seat 2: Palen030 ($2.44 in chips) 
Seat 3: thedude696969 ($24.66 in chips) 
Seat 4: fish72o ($10.05 in chips) 
Seat 5: johnnytrue ($9.43 in chips) 
Seat 6: Deniels7 ($16.58 in chips) 
thedude696969: posts small blind $0.05
fish72o: posts big blind $0.10
*** HOLE CARDS ***
johnnytrue: folds 
Deniels7: raises $0.20 to $0.30
Tyoma_Kovach: calls $0.30
Palen030: folds 
thedude696969: folds 
fish72o: calls $0.20
*** FLOP *** [5d 5s 2d]
fish72o: checks 
Deniels7: bets $0.20
Tyoma_Kovach: raises $0.98 to $1.18
fish72o: folds 
Deniels7: folds 
Uncalled bet ($0.98) returned to Tyoma_Kovach
Tyoma_Kovach collected $1.29 from pot
Tyoma_Kovach: doesn't show hand 
*** SUMMARY ***
Total pot $1.35 | Rake $0.06 
Board [5d 5s 2d]
Seat 1: Tyoma_Kovach collected ($1.29)
Seat 2: Palen030 (button) folded before Flop (didn't bet)
Seat 3: thedude696969 (small blind) folded before Flop
Seat 4: fish72o (big blind) folded on the Flop
Seat 5: johnnytrue folded before Flop (didn't bet)
Seat 6: Deniels7 folded on the Flop



PokerStars Hand #222944802879:  Hold'em No Limit ($0.05/$0.10 USD) - 2021/01/23 0:09:32 ET
Table 'Algieba III' 6-max Seat #3 is the button
Seat 1: Tyoma_Kovach ($12.19 in chips) 
Seat 2: Palen030 ($2.44 in chips) 
Seat 3: thedude696969 ($24.61 in chips) 
Seat 4: fish72o ($10 in chips) 
Seat 5: johnnytrue ($9.43 in chips) 
Seat 6: Deniels7 ($16.08 in chips) 
fish72o: posts small blind $0.05
johnnytrue: posts big blind $0.10
*** HOLE CARDS ***
Deniels7: folds 
Tyoma_Kovach: folds 
Palen030: folds 
thedude696969: folds 
fish72o: folds 
Uncalled bet ($0.05) returned to johnnytrue
johnnytrue collected $0.10 from pot
*** SUMMARY ***
Total pot $0.10 | Rake $0 
Seat 1: Tyoma_Kovach folded before Flop (didn't bet)
Seat 2: Palen030 folded before Flop (didn't bet)
Seat 3: thedude696969 (button) folded before Flop (didn't bet)
Seat 4: fish72o (small blind) folded before Flop
Seat 5: johnnytrue (big blind) collected ($0.10)
Seat 6: Deniels7 folded before Flop (didn't bet)



PokerStars Hand #222944806628:  Hold'em No Limit ($0.05/$0.10 USD) - 2021/01/23 0:09:45 ET
Table 'Algieba III' 6-max Seat #4 is the button
Seat 1: Tyoma_Kovach ($12.19 in chips) 
Seat 2: Palen030 ($2.44 in chips) 
Seat 3: thedude696969 ($24.61 in chips) 
Seat 4: fish72o ($10 in chips) 
Seat 5: johnnytrue ($9.48 in chips) 
Seat 6: Deniels7 ($16.08 in chips) 
johnnytrue: posts small blind $0.05
Deniels7: posts big blind $0.10
*** HOLE CARDS ***
Tyoma_Kovach: raises $0.20 to $0.30
Palen030: folds 
thedude696969: folds 
fish72o: folds 
johnnytrue: folds 
Deniels7: calls $0.20
*** FLOP *** [5d 7s Th]
Deniels7: checks 
Tyoma_Kovach: bets $0.47
Deniels7: folds 
Uncalled bet ($0.47) returned to Tyoma_Kovach
Tyoma_Kovach collected $0.62 from pot
Tyoma_Kovach: doesn't show hand 
*** SUMMARY ***
Total pot $0.65 | Rake $0.03 
Board [5d 7s Th]
Seat 1: Tyoma_Kovach collected ($0.62)
Seat 2: Palen030 folded before Flop (didn't bet)
Seat 3: thedude696969 folded before Flop (didn't bet)
Seat 4: fish72o (button) folded before Flop (didn't bet)
Seat 5: johnnytrue (small blind) folded before Flop
Seat 6: Deniels7 (big blind) folded on the Flop



PokerStars Hand #222944816068:  Hold'em No Limit ($0.05/$0.10 USD) - 2021/01/23 0:10:19 ET
Table 'Algieba III' 6-max Seat #5 is the button
Seat 1: Tyoma_Kovach ($12.51 in chips) 
Seat 2: Palen030 ($2.44 in chips) 
Seat 3: thedude696969 ($24.61 in chips) 
Seat 4: fish72o ($10 in chips) 
Seat 5: johnnytrue ($9.43 in chips) 
Seat 6: Deniels7 ($15.78 in chips) 
Deniels7: posts small blind $0.05
Tyoma_Kovach: posts big blind $0.10
*** HOLE CARDS ***
Palen030: folds 
thedude696969: calls $0.10
fish72o: folds 
johnnytrue: folds 
Deniels7: calls $0.05
Tyoma_Kovach: checks 
*** FLOP *** [6c Ks 7c]
Deniels7: checks 
Tyoma_Kovach: checks 
thedude696969: checks 
*** TURN *** [6c Ks 7c] [Kd]
Deniels7: bets $0.20
Tyoma_Kovach: folds 
thedude696969: calls $0.20
*** RIVER *** [6c Ks 7c Kd] [Td]
Deniels7: bets $0.30
thedude696969: raises $1.20 to $1.50
Deniels7: calls $1.20
*** SHOW DOWN ***
thedude696969: shows [3c 3s] (two pair, Kings and Threes)
Deniels7: mucks hand 
thedude696969 collected $3.53 from pot
*** SUMMARY ***
Total pot $3.70 | Rake $0.17 
Board [6c Ks 7c Kd Td]
Seat 1: Tyoma_Kovach (big blind) folded on the Turn
Seat 2: Palen030 folded before Flop (didn't bet)
Seat 3: thedude696969 showed [3c 3s] and won ($3.53) with two pair, Kings and Threes
Seat 4: fish72o folded before Flop (didn't bet)
Seat 5: johnnytrue (button) folded before Flop (didn't bet)
Seat 6: Deniels7 (small blind) mucked



PokerStars Hand #222944833221:  Hold'em No Limit ($0.05/$0.10 USD) - 2021/01/23 0:11:20 ET
Table 'Algieba III' 6-max Seat #6 is the button
Seat 1: Tyoma_Kovach ($12.41 in chips) 
Seat 2: Palen030 ($2.44 in chips) 
Seat 3: thedude696969 ($26.34 in chips) 
Seat 4: fish72o ($10 in chips) 
Seat 5: johnnytrue ($9.43 in chips) 
Seat 6: Deniels7 ($13.98 in chips) 
Tyoma_Kovach: posts small blind $0.05
Palen030: posts big blind $0.10
*** HOLE CARDS ***
thedude696969: folds 
fish72o: folds 
johnnytrue: folds 
Deniels7: folds 
Tyoma_Kovach: calls $0.05
Palen030: checks 
*** FLOP *** [Td 2h 2s]
Tyoma_Kovach: bets $0.10
Palen030: calls $0.10
*** TURN *** [Td 2h 2s] [Qh]
Tyoma_Kovach: checks 
Palen030: checks 
*** RIVER *** [Td 2h 2s Qh] [Jh]
Tyoma_Kovach: checks 
Palen030: checks 
*** SHOW DOWN ***
Tyoma_Kovach: shows [6d 3d] (a pair of Deuces)
Palen030: shows [Th 3s] (two pair, Tens and Deuces)
Palen030 collected $0.38 from pot
*** SUMMARY ***
Total pot $0.40 | Rake $0.02 
Board [Td 2h 2s Qh Jh]
Seat 1: Tyoma_Kovach (small blind) showed [6d 3d] and lost with a pair of Deuces
Seat 2: Palen030 (big blind) showed [Th 3s] and won ($0.38) with two pair, Tens and Deuces
Seat 3: thedude696969 folded before Flop (didn't bet)
Seat 4: fish72o folded before Flop (didn't bet)
Seat 5: johnnytrue folded before Flop (didn't bet)
Seat 6: Deniels7 (button) folded before Flop (didn't bet)



PokerStars Hand #222944840144:  Hold'em No Limit ($0.05/$0.10 USD) - 2021/01/23 0:11:44 ET
Table 'Algieba III' 6-max Seat #1 is the button
Seat 1: Tyoma_Kovach ($12.21 in chips) 
Seat 2: Palen030 ($2.62 in chips) 
Seat 3: thedude696969 ($26.34 in chips) 
Seat 4: fish72o ($10 in chips) 
Seat 5: johnnytrue ($9.43 in chips) 
Seat 6: Deniels7 ($13.98 in chips) 
Palen030: posts small blind $0.05
thedude696969: posts big blind $0.10
*** HOLE CARDS ***
fish72o: folds 
johnnytrue: folds 
Deniels7: folds 
Tyoma_Kovach: folds 
Palen030: folds 
Uncalled bet ($0.05) returned to thedude696969
thedude696969 collected $0.10 from pot
thedude696969: doesn't show hand 
*** SUMMARY ***
Total pot $0.10 | Rake $0 
Seat 1: Tyoma_Kovach (button) folded before Flop (didn't bet)
Seat 2: Palen030 (small blind) folded before Flop
Seat 3: thedude696969 (big blind) collected ($0.10)
Seat 4: fish72o folded before Flop (didn't bet)
Seat 5: johnnytrue folded before Flop (didn't bet)
Seat 6: Deniels7 folded before Flop (didn't bet)



PokerStars Hand #222944841973:  Hold'em No Limit ($0.05/$0.10 USD) - 2021/01/23 0:11:51 ET
Table 'Algieba III' 6-max Seat #2 is the button
Seat 1: Tyoma_Kovach ($12.21 in chips) 
Seat 2: Palen030 ($2.57 in chips) 
Seat 3: thedude696969 ($26.39 in chips) 
Seat 4: fish72o ($10 in chips) 
Seat 5: johnnytrue ($9.43 in chips) 
Seat 6: Deniels7 ($13.98 in chips) 
thedude696969: posts small blind $0.05
fish72o: posts big blind $0.10
*** HOLE CARDS ***
johnnytrue: folds 
Deniels7: folds 
Tyoma_Kovach: folds 
Palen030: folds 
thedude696969: raises $0.20 to $0.30
fish72o: calls $0.20
*** FLOP *** [Th Jh 9c]
thedude696969: bets $0.29
fish72o: calls $0.29
*** TURN *** [Th Jh 9c] [Ac]
thedude696969: checks 
fish72o: checks 
*** RIVER *** [Th Jh 9c Ac] [2d]
thedude696969: bets $0.73
fish72o: calls $0.73
*** SHOW DOWN ***
thedude696969: shows [5s Ts] (a pair of Tens)
fish72o: shows [Tc Qh] (a pair of Tens - Ace+Queen kicker)
fish72o collected $2.52 from pot
*** SUMMARY ***
Total pot $2.64 | Rake $0.12 
Board [Th Jh 9c Ac 2d]
Seat 1: Tyoma_Kovach folded before Flop (didn't bet)
Seat 2: Palen030 (button) folded before Flop (didn't bet)
Seat 3: thedude696969 (small blind) showed [5s Ts] and lost with a pair of Tens
Seat 4: fish72o (big blind) showed [Tc Qh] and won ($2.52) with a pair of Tens
Seat 5: johnnytrue folded before Flop (didn't bet)
Seat 6: Deniels7 folded before Flop (didn't bet)



PokerStars Hand #222944854569:  Hold'em No Limit ($0.05/$0.10 USD) - 2021/01/23 0:12:36 ET
Table 'Algieba III' 6-max Seat #3 is the button
Seat 1: Tyoma_Kovach ($12.21 in chips) 
Seat 2: Palen030 ($2.57 in chips) 
Seat 3: thedude696969 ($25.07 in chips) 
Seat 4: fish72o ($11.20 in chips) 
Seat 5: johnnytrue ($9.43 in chips) 
Seat 6: Deniels7 ($13.98 in chips) 
fish72o: posts small blind $0.05
johnnytrue: posts big blind $0.10
*** HOLE CARDS ***
Deniels7: raises $0.20 to $0.30
Tyoma_Kovach: folds 
Palen030: folds 
thedude696969: folds 
fish72o: folds 
johnnytrue: calls $0.20
*** FLOP *** [9c Ts 2d]
johnnytrue: checks 
Deniels7: bets $0.50
johnnytrue: calls $0.50
*** TURN *** [9c Ts 2d] [Qc]
johnnytrue: checks 
Deniels7: checks 
*** RIVER *** [9c Ts 2d Qc] [9h]
johnnytrue: bets $0.79
Deniels7: calls $0.79
*** SHOW DOWN ***
johnnytrue: shows [9d As] (three of a kind, Nines)
Deniels7: mucks hand 
johnnytrue collected $3.08 from pot
*** SUMMARY ***
Total pot $3.23 | Rake $0.15 
Board [9c Ts 2d Qc 9h]
Seat 1: Tyoma_Kovach folded before Flop (didn't bet)
Seat 2: Palen030 folded before Flop (didn't bet)
Seat 3: thedude696969 (button) folded before Flop (didn't bet)
Seat 4: fish72o (small blind) folded before Flop
Seat 5: johnnytrue (big blind) showed [9d As] and won ($3.08) with three of a kind, Nines
Seat 6: Deniels7 mucked



PokerStars Hand #222944869847:  Hold'em No Limit ($0.05/$0.10 USD) - 2021/01/23 0:13:30 ET
Table 'Algieba III' 6-max Seat #4 is the button
Seat 1: Tyoma_Kovach ($12.21 in chips) 
Seat 2: Palen030 ($2.57 in chips) 
Seat 3: thedude696969 ($25.07 in chips) 
Seat 4: fish72o ($11.15 in chips) 
Seat 5: johnnytrue ($10.92 in chips) 
Seat 6: Deniels7 ($12.39 in chips) 
johnnytrue: posts small blind $0.05
Deniels7: posts big blind $0.10
*** HOLE CARDS ***
Tyoma_Kovach: folds 
Palen030: folds 
thedude696969: folds 
fish72o: folds 
johnnytrue: calls $0.05
Deniels7: raises $0.20 to $0.30
johnnytrue: calls $0.20
*** FLOP *** [5h 6c 8s]
johnnytrue: checks 
Deniels7: checks 
*** TURN *** [5h 6c 8s] [2s]
johnnytrue: checks 
Deniels7: checks 
*** RIVER *** [5h 6c 8s 2s] [6s]
johnnytrue: checks 
Deniels7: checks 
*** SHOW DOWN ***
johnnytrue: shows [Qs 8d] (two pair, Eights and Sixes)
Deniels7: mucks hand 
johnnytrue collected $0.57 from pot
*** SUMMARY ***
Total pot $0.60 | Rake $0.03 
Board [5h 6c 8s 2s 6s]
Seat 1: Tyoma_Kovach folded before Flop (didn't bet)
Seat 2: Palen030 folded before Flop (didn't bet)
Seat 3: thedude696969 folded before Flop (didn't bet)
Seat 4: fish72o (button) folded before Flop (didn't bet)
Seat 5: johnnytrue (small blind) showed [Qs 8d] and won ($0.57) with two pair, Eights and Sixes
Seat 6: Deniels7 (big blind) mucked



PokerStars Hand #222944880648:  Hold'em No Limit ($0.05/$0.10 USD) - 2021/01/23 0:14:08 ET
Table 'Algieba III' 6-max Seat #5 is the button
Seat 1: Tyoma_Kovach ($12.21 in chips) 
Seat 2: Palen030 ($2.57 in chips) 
Seat 3: thedude696969 ($25.07 in chips) 
Seat 4: fish72o ($11.15 in chips) 
Seat 5: johnnytrue ($11.19 in chips) 
Seat 6: Deniels7 ($12.09 in chips) 
Deniels7: posts small blind $0.05
Tyoma_Kovach: posts big blind $0.10
*** HOLE CARDS ***
Palen030: folds 
thedude696969: folds 
fish72o: folds 
johnnytrue: calls $0.10
Deniels7: raises $0.30 to $0.40
Tyoma_Kovach: folds 
johnnytrue: calls $0.30
*** FLOP *** [8h 3s Ad]
Deniels7: checks 
johnnytrue: checks 
*** TURN *** [8h 3s Ad] [5h]
Deniels7: bets $0.10
johnnytrue: folds 
Uncalled bet ($0.10) returned to Deniels7
Deniels7 collected $0.86 from pot
Deniels7: doesn't show hand 
*** SUMMARY ***
Total pot $0.90 | Rake $0.04 
Board [8h 3s Ad 5h]
Seat 1: Tyoma_Kovach (big blind) folded before Flop
Seat 2: Palen030 folded before Flop (didn't bet)
Seat 3: thedude696969 folded before Flop (didn't bet)
Seat 4: fish72o folded before Flop (didn't bet)
Seat 5: johnnytrue (button) folded on the Turn
Seat 6: Deniels7 (small blind) collected ($0.86)



PokerStars Hand #222944891314:  Hold'em No Limit ($0.05/$0.10 USD) - 2021/01/23 0:14:46 ET
Table 'Algieba III' 6-max Seat #6 is the button
Seat 1: Tyoma_Kovach ($12.11 in chips) 
Seat 2: Palen030 ($2.57 in chips) 
Seat 3: thedude696969 ($25.07 in chips) 
Seat 4: fish72o ($11.15 in chips) 
Seat 5: johnnytrue ($10.79 in chips) 
Seat 6: Deniels7 ($12.55 in chips) 
Tyoma_Kovach: posts small blind $0.05
Palen030: posts big blind $0.10
*** HOLE CARDS ***
thedude696969: raises $0.20 to $0.30
fish72o: folds 
johnnytrue: folds 
Deniels7: raises $0.20 to $0.50
Tyoma_Kovach: folds 
Palen030: folds 
thedude696969: calls $0.20
*** FLOP *** [Jc Ac 9h]
thedude696969: checks 
Deniels7: bets $0.20
thedude696969: calls $0.20
*** TURN *** [Jc Ac 9h] [4s]
thedude696969: checks 
Deniels7: bets $0.20
thedude696969: calls $0.20
*** RIVER *** [Jc Ac 9h 4s] [Qc]
thedude696969: bets $1.20
Deniels7: raises $1.90 to $3.10
thedude696969: folds 
Uncalled bet ($1.90) returned to Deniels7
Deniels7 collected $4.15 from pot
Deniels7: doesn't show hand 
*** SUMMARY ***
Total pot $4.35 | Rake $0.20 
Board [Jc Ac 9h 4s Qc]
Seat 1: Tyoma_Kovach (small blind) folded before Flop
Seat 2: Palen030 (big blind) folded before Flop
Seat 3: thedude696969 folded on the River
Seat 4: fish72o folded before Flop (didn't bet)
Seat 5: johnnytrue folded before Flop (didn't bet)
Seat 6: Deniels7 (button) collected ($4.15)



PokerStars Hand #222944910803:  Hold'em No Limit ($0.05/$0.10 USD) - 2021/01/23 0:15:56 ET
Table 'Algieba III' 6-max Seat #1 is the button
Seat 1: Tyoma_Kovach ($12.06 in chips) 
Seat 2: Palen030 ($2.47 in chips) 
Seat 3: thedude696969 ($22.97 in chips) 
Seat 4: fish72o ($11.15 in chips) 
Seat 5: johnnytrue ($10.79 in chips) 
Seat 6: Deniels7 ($14.60 in chips) 
Palen030: posts small blind $0.05
thedude696969: posts big blind $0.10
*** HOLE CARDS ***
fish72o: folds 
johnnytrue: calls $0.10
Deniels7: raises $0.20 to $0.30
Tyoma_Kovach: folds 
Palen030: folds 
thedude696969: folds 
johnnytrue: calls $0.20
*** FLOP *** [2c Qs 3c]
johnnytrue: checks 
Deniels7: bets $0.30
johnnytrue: folds 
Uncalled bet ($0.30) returned to Deniels7
Deniels7 collected $0.72 from pot
Deniels7: doesn't show hand 
*** SUMMARY ***
Total pot $0.75 | Rake $0.03 
Board [2c Qs 3c]
Seat 1: Tyoma_Kovach (button) folded before Flop (didn't bet)
Seat 2: Palen030 (small blind) folded before Flop
Seat 3: thedude696969 (big blind) folded before Flop
Seat 4: fish72o folded before Flop (didn't bet)
Seat 5: johnnytrue folded on the Flop
Seat 6: Deniels7 collected ($0.72)



PokerStars Hand #222944919433:  Hold'em No Limit ($0.05/$0.10 USD) - 2021/01/23 0:16:28 ET
Table 'Algieba III' 6-max Seat #2 is the button
Seat 1: Tyoma_Kovach ($12.06 in chips) 
Seat 2: Palen030 ($2.42 in chips) 
Seat 3: thedude696969 ($22.87 in chips) 
Seat 4: fish72o ($11.15 in chips) 
Seat 5: johnnytrue ($10.49 in chips) 
Seat 6: Deniels7 ($15.02 in chips) 
thedude696969: posts small blind $0.05
fish72o: posts big blind $0.10
*** HOLE CARDS ***
johnnytrue: folds 
Deniels7: folds 
Tyoma_Kovach: raises $0.18 to $0.28
Palen030: calls $0.28
thedude696969: folds 
fish72o: folds 
*** FLOP *** [9s 9c Tc]
Tyoma_Kovach: checks 
Palen030: checks 
*** TURN *** [9s 9c Tc] [Kh]
Tyoma_Kovach: bets $0.51
Palen030: calls $0.51
*** RIVER *** [9s 9c Tc Kh] [7d]
Tyoma_Kovach: bets $2.19
Palen030: folds 
Uncalled bet ($2.19) returned to Tyoma_Kovach
Tyoma_Kovach collected $1.65 from pot
Tyoma_Kovach: doesn't show hand 
*** SUMMARY ***
Total pot $1.73 | Rake $0.08 
Board [9s 9c Tc Kh 7d]
Seat 1: Tyoma_Kovach collected ($1.65)
Seat 2: Palen030 (button) folded on the River
Seat 3: thedude696969 (small blind) folded before Flop
Seat 4: fish72o (big blind) folded before Flop
Seat 5: johnnytrue folded before Flop (didn't bet)
Seat 6: Deniels7 folded before Flop (didn't bet)



PokerStars Hand #222944930308:  Hold'em No Limit ($0.05/$0.10 USD) - 2021/01/23 0:17:07 ET
Table 'Algieba III' 6-max Seat #3 is the button
Seat 1: Tyoma_Kovach ($12.92 in chips) 
Seat 2: Palen030 ($1.63 in chips) 
Seat 3: thedude696969 ($22.82 in chips) 
Seat 4: fish72o ($11.05 in chips) 
Seat 5: johnnytrue ($10.49 in chips) 
Seat 6: Deniels7 ($15.02 in chips) 
fish72o: posts small blind $0.05
johnnytrue: posts big blind $0.10
*** HOLE CARDS ***
Deniels7: folds 
Tyoma_Kovach: raises $0.20 to $0.30
Palen030: folds 
thedude696969: raises $0.90 to $1.20
fish72o: folds 
johnnytrue: folds 
Tyoma_Kovach: calls $0.90
*** FLOP *** [Qc Kh 8d]
Tyoma_Kovach: checks 
thedude696969: bets $1.43
Tyoma_Kovach: calls $1.43
*** TURN *** [Qc Kh 8d] [2h]
Tyoma_Kovach: checks 
thedude696969: bets $2.20
Tyoma_Kovach: calls $2.20
*** RIVER *** [Qc Kh 8d 2h] [7s]
Tyoma_Kovach: checks 
thedude696969: bets $17.99 and is all-in
Tyoma_Kovach: folds 
Uncalled bet ($17.99) returned to thedude696969
thedude696969 collected $9.37 from pot
thedude696969: doesn't show hand 
*** SUMMARY ***
Total pot $9.81 | Rake $0.44 
Board [Qc Kh 8d 2h 7s]
Seat 1: Tyoma_Kovach folded on the River
Seat 2: Palen030 folded before Flop (didn't bet)
Seat 3: thedude696969 (button) collected ($9.37)
Seat 4: fish72o (small blind) folded before Flop
Seat 5: johnnytrue (big blind) folded before Flop
Seat 6: Deniels7 folded before Flop (didn't bet)



PokerStars Hand #222944948610:  Hold'em No Limit ($0.05/$0.10 USD) - 2021/01/23 0:18:12 ET
Table 'Algieba III' 6-max Seat #4 is the button
Seat 1: Tyoma_Kovach ($10 in chips) 
Seat 2: Palen030 ($1.63 in chips) 
Seat 3: thedude696969 ($27.36 in chips) 
Seat 4: fish72o ($11 in chips) 
Seat 5: johnnytrue ($10.39 in chips) 
Seat 6: Deniels7 ($15.02 in chips) 
johnnytrue: posts small blind $0.05
Deniels7: posts big blind $0.10
*** HOLE CARDS ***
Tyoma_Kovach: folds 
Palen030: folds 
thedude696969: folds 
fish72o: raises $0.15 to $0.25
johnnytrue: folds 
Deniels7: calls $0.15
*** FLOP *** [2s 2d 8s]
Deniels7: checks 
fish72o: bets $0.17
Deniels7: folds 
Uncalled bet ($0.17) returned to fish72o
fish72o collected $0.53 from pot
fish72o: doesn't show hand 
*** SUMMARY ***
Total pot $0.55 | Rake $0.02 
Board [2s 2d 8s]
Seat 1: Tyoma_Kovach folded before Flop (didn't bet)
Seat 2: Palen030 folded before Flop (didn't bet)
Seat 3: thedude696969 folded before Flop (didn't bet)
Seat 4: fish72o (button) collected ($0.53)
Seat 5: johnnytrue (small blind) folded before Flop
Seat 6: Deniels7 (big blind) folded on the Flop



PokerStars Hand #222944956044:  Hold'em No Limit ($0.05/$0.10 USD) - 2021/01/23 0:18:39 ET
Table 'Algieba III' 6-max Seat #5 is the button
Seat 1: Tyoma_Kovach ($10 in chips) 
Seat 2: Palen030 ($1.63 in chips) 
Seat 3: thedude696969 ($27.36 in chips) 
Seat 4: fish72o ($11.28 in chips) 
Seat 5: johnnytrue ($10.34 in chips) 
Seat 6: Deniels7 ($14.77 in chips) 
Deniels7: posts small blind $0.05
Tyoma_Kovach: posts big blind $0.10
*** HOLE CARDS ***
Palen030: folds 
thedude696969: folds 
fish72o: folds 
johnnytrue: folds 
Deniels7: raises $0.10 to $0.20
Tyoma_Kovach: calls $0.10
*** FLOP *** [7c 8s 6c]
Deniels7: bets $0.20
Tyoma_Kovach: folds 
Uncalled bet ($0.20) returned to Deniels7
Deniels7 collected $0.38 from pot
Deniels7: doesn't show hand 
*** SUMMARY ***
Total pot $0.40 | Rake $0.02 
Board [7c 8s 6c]
Seat 1: Tyoma_Kovach (big blind) folded on the Flop
Seat 2: Palen030 folded before Flop (didn't bet)
Seat 3: thedude696969 folded before Flop (didn't bet)
Seat 4: fish72o folded before Flop (didn't bet)
Seat 5: johnnytrue (button) folded before Flop (didn't bet)
Seat 6: Deniels7 (small blind) collected ($0.38)



PokerStars Hand #222944962123:  Hold'em No Limit ($0.05/$0.10 USD) - 2021/01/23 0:19:00 ET
Table 'Algieba III' 6-max Seat #6 is the button
Seat 1: Tyoma_Kovach ($10 in chips) 
Seat 2: Palen030 ($1.63 in chips) 
Seat 3: thedude696969 ($27.36 in chips) 
Seat 4: fish72o ($11.28 in chips) 
Seat 5: johnnytrue ($10.34 in chips) 
Seat 6: Deniels7 ($14.95 in chips) 
Tyoma_Kovach: posts small blind $0.05
Palen030: posts big blind $0.10
*** HOLE CARDS ***
thedude696969: raises $0.20 to $0.30
fish72o: folds 
johnnytrue: folds 
Deniels7: raises $0.20 to $0.50
Tyoma_Kovach: folds 
Palen030: folds 
thedude696969: calls $0.20
*** FLOP *** [Jh 6h 3c]
thedude696969: checks 
Deniels7: bets $0.40
thedude696969: calls $0.40
*** TURN *** [Jh 6h 3c] [2s]
thedude696969: checks 
Deniels7: checks 
*** RIVER *** [Jh 6h 3c 2s] [3d]
thedude696969: bets $1.10
Deniels7: calls $1.10
*** SHOW DOWN ***
thedude696969: shows [As Kc] (a pair of Threes)
Deniels7: mucks hand 
thedude696969 collected $3.96 from pot
*** SUMMARY ***
Total pot $4.15 | Rake $0.19 
Board [Jh 6h 3c 2s 3d]
Seat 1: Tyoma_Kovach (small blind) folded before Flop
Seat 2: Palen030 (big blind) folded before Flop
Seat 3: thedude696969 showed [As Kc] and won ($3.96) with a pair of Threes
Seat 4: fish72o folded before Flop (didn't bet)
Seat 5: johnnytrue folded before Flop (didn't bet)
Seat 6: Deniels7 (button) mucked



PokerStars Hand #222944973643:  Hold'em No Limit ($0.05/$0.10 USD) - 2021/01/23 0:19:42 ET
Table 'Algieba III' 6-max Seat #1 is the button
Seat 1: Tyoma_Kovach ($10 in chips) 
Seat 2: Palen030 ($1.53 in chips) 
Seat 3: thedude696969 ($29.32 in chips) 
Seat 4: fish72o ($11.28 in chips) 
Seat 5: johnnytrue ($10.34 in chips) 
Seat 6: Deniels7 ($12.95 in chips) 
Palen030: posts small blind $0.05
thedude696969: posts big blind $0.10
*** HOLE CARDS ***
fish72o: folds 
johnnytrue: folds 
Deniels7: raises $0.20 to $0.30
Tyoma_Kovach: raises $0.67 to $0.97
Palen030: folds 
thedude696969: folds 
Deniels7: calls $0.67
*** FLOP *** [Kc 8h Ah]
Deniels7: checks 
Tyoma_Kovach: checks 
*** TURN *** [Kc 8h Ah] [5c]
Deniels7: checks 
Tyoma_Kovach: bets $0.66
Deniels7: calls $0.66
*** RIVER *** [Kc 8h Ah 5c] [2h]
Deniels7: checks 
Tyoma_Kovach: checks 
*** SHOW DOWN ***
Deniels7: shows [Kh Qs] (a pair of Kings)
Tyoma_Kovach: mucks hand 
Deniels7 collected $3.26 from pot
*** SUMMARY ***
Total pot $3.41 | Rake $0.15 
Board [Kc 8h Ah 5c 2h]
Seat 1: Tyoma_Kovach (button) mucked
Seat 2: Palen030 (small blind) folded before Flop
Seat 3: thedude696969 (big blind) folded before Flop
Seat 4: fish72o folded before Flop (didn't bet)
Seat 5: johnnytrue folded before Flop (didn't bet)
Seat 6: Deniels7 showed [Kh Qs] and won ($3.26) with a pair of Kings



PokerStars Hand #222944986187:  Hold'em No Limit ($0.05/$0.10 USD) - 2021/01/23 0:20:26 ET
Table 'Algieba III' 6-max Seat #2 is the button
Seat 1: Tyoma_Kovach ($10 in chips) 
Seat 2: Palen030 ($1.48 in chips) 
Seat 3: thedude696969 ($29.22 in chips) 
Seat 4: fish72o ($11.28 in chips) 
Seat 5: johnnytrue ($10.34 in chips) 
Seat 6: Deniels7 ($14.58 in chips) 
thedude696969: posts small blind $0.05
fish72o: posts big blind $0.10
*** HOLE CARDS ***
johnnytrue: folds 
Deniels7: folds 
Tyoma_Kovach: folds 
Palen030: folds 
thedude696969: raises $0.20 to $0.30
fish72o: folds 
Uncalled bet ($0.20) returned to thedude696969
thedude696969 collected $0.20 from pot
thedude696969: doesn't show hand 
*** SUMMARY ***
Total pot $0.20 | Rake $0 
Seat 1: Tyoma_Kovach folded before Flop (didn't bet)
Seat 2: Palen030 (button) folded before Flop (didn't bet)
Seat 3: thedude696969 (small blind) collected ($0.20)
Seat 4: fish72o (big blind) folded before Flop
Seat 5: johnnytrue folded before Flop (didn't bet)
Seat 6: Deniels7 folded before Flop (didn't bet)



PokerStars Hand #222944990603:  Hold'em No Limit ($0.05/$0.10 USD) - 2021/01/23 0:20:42 ET
Table 'Algieba III' 6-max Seat #3 is the button
Seat 1: Tyoma_Kovach ($10 in chips) 
Seat 2: Palen030 ($1.48 in chips) 
Seat 3: thedude696969 ($29.32 in chips) 
Seat 4: fish72o ($11.18 in chips) 
Seat 5: johnnytrue ($10.34 in chips) 
Seat 6: Deniels7 ($14.58 in chips) 
fish72o: posts small blind $0.05
johnnytrue: posts big blind $0.10
*** HOLE CARDS ***
Deniels7: folds 
Tyoma_Kovach: folds 
Palen030: folds 
thedude696969: raises $0.20 to $0.30
fish72o: folds 
johnnytrue: folds 
Uncalled bet ($0.20) returned to thedude696969
thedude696969 collected $0.25 from pot
thedude696969: doesn't show hand 
*** SUMMARY ***
Total pot $0.25 | Rake $0 
Seat 1: Tyoma_Kovach folded before Flop (didn't bet)
Seat 2: Palen030 folded before Flop (didn't bet)
Seat 3: thedude696969 (button) collected ($0.25)
Seat 4: fish72o (small blind) folded before Flop
Seat 5: johnnytrue (big blind) folded before Flop
Seat 6: Deniels7 folded before Flop (didn't bet)



PokerStars Hand #222944995480:  Hold'em No Limit ($0.05/$0.10 USD) - 2021/01/23 0:20:59 ET
Table 'Algieba III' 6-max Seat #4 is the button
Seat 1: Tyoma_Kovach ($10 in chips) 
Seat 2: Palen030 ($1.48 in chips) 
Seat 3: thedude696969 ($29.47 in chips) 
Seat 4: fish72o ($11.13 in chips) 
Seat 5: johnnytrue ($10.24 in chips) 
Seat 6: Deniels7 ($14.58 in chips) 
johnnytrue: posts small blind $0.05
Deniels7: posts big blind $0.10
*** HOLE CARDS ***
Tyoma_Kovach: folds 
Palen030: folds 
thedude696969: raises $0.20 to $0.30
fish72o: folds 
johnnytrue: calls $0.25
Deniels7: folds 
*** FLOP *** [4c Kh Kd]
johnnytrue: checks 
thedude696969: bets $0.40
johnnytrue: calls $0.40
*** TURN *** [4c Kh Kd] [5c]
johnnytrue: bets $1.43
thedude696969: folds 
Uncalled bet ($1.43) returned to johnnytrue
johnnytrue collected $1.43 from pot
*** SUMMARY ***
Total pot $1.50 | Rake $0.07 
Board [4c Kh Kd 5c]
Seat 1: Tyoma_Kovach folded before Flop (didn't bet)
Seat 2: Palen030 folded before Flop (didn't bet)
Seat 3: thedude696969 folded on the Turn
Seat 4: fish72o (button) folded before Flop (didn't bet)
Seat 5: johnnytrue (small blind) collected ($1.43)
Seat 6: Deniels7 (big blind) folded before Flop



PokerStars Hand #222945006996:  Hold'em No Limit ($0.05/$0.10 USD) - 2021/01/23 0:21:41 ET
Table 'Algieba III' 6-max Seat #5 is the button
Seat 1: Tyoma_Kovach ($10 in chips) 
Seat 2: Palen030 ($1.48 in chips) 
Seat 3: thedude696969 ($28.77 in chips) 
Seat 4: fish72o ($11.13 in chips) 
Seat 5: johnnytrue ($10.97 in chips) 
Seat 6: Deniels7 ($14.48 in chips) 
Deniels7: posts small blind $0.05
Tyoma_Kovach: posts big blind $0.10
*** HOLE CARDS ***
Palen030: folds 
thedude696969: folds 
fish72o: folds 
johnnytrue: calls $0.10
Deniels7: raises $0.20 to $0.30
Tyoma_Kovach: folds 
johnnytrue: calls $0.20
*** FLOP *** [9s 7c Th]
Deniels7: checks 
johnnytrue: checks 
*** TURN *** [9s 7c Th] [6c]
Deniels7: bets $0.20
johnnytrue: folds 
Uncalled bet ($0.20) returned to Deniels7
Deniels7 collected $0.67 from pot
Deniels7: doesn't show hand 
*** SUMMARY ***
Total pot $0.70 | Rake $0.03 
Board [9s 7c Th 6c]
Seat 1: Tyoma_Kovach (big blind) folded before Flop
Seat 2: Palen030 folded before Flop (didn't bet)
Seat 3: thedude696969 folded before Flop (didn't bet)
Seat 4: fish72o folded before Flop (didn't bet)
Seat 5: johnnytrue (button) folded on the Turn
Seat 6: Deniels7 (small blind) collected ($0.67)



PokerStars Hand #222945019812:  Hold'em No Limit ($0.05/$0.10 USD) - 2021/01/23 0:22:29 ET
Table 'Algieba III' 6-max Seat #6 is the button
Seat 1: Tyoma_Kovach ($10 in chips) 
Seat 2: Palen030 ($1.48 in chips) 
Seat 3: thedude696969 ($28.77 in chips) 
Seat 4: fish72o ($11.13 in chips) 
Seat 5: johnnytrue ($10.67 in chips) 
Seat 6: Deniels7 ($14.85 in chips) 
Tyoma_Kovach: posts small blind $0.05
Palen030: posts big blind $0.10
*** HOLE CARDS ***
thedude696969: folds 
fish72o: raises $0.15 to $0.25
johnnytrue: folds 
Deniels7: raises $0.15 to $0.40
Tyoma_Kovach: calls $0.35
Palen030: folds 
fish72o: calls $0.15
*** FLOP *** [Jh 2h Th]
Tyoma_Kovach: checks 
fish72o: checks 
Deniels7: bets $1
Tyoma_Kovach: folds 
fish72o: folds 
Uncalled bet ($1) returned to Deniels7
Deniels7 collected $1.24 from pot
Deniels7: doesn't show hand 
*** SUMMARY ***
Total pot $1.30 | Rake $0.06 
Board [Jh 2h Th]
Seat 1: Tyoma_Kovach (small blind) folded on the Flop
Seat 2: Palen030 (big blind) folded before Flop
Seat 3: thedude696969 folded before Flop (didn't bet)
Seat 4: fish72o folded on the Flop
Seat 5: johnnytrue folded before Flop (didn't bet)
Seat 6: Deniels7 (button) collected ($1.24)



PokerStars Hand #222945031615:  Hold'em No Limit ($0.05/$0.10 USD) - 2021/01/23 0:23:11 ET
Table 'Algieba III' 6-max Seat #1 is the button
Seat 1: Tyoma_Kovach ($10 in chips) 
Seat 2: Palen030 ($1.38 in chips) 
Seat 3: thedude696969 ($28.77 in chips) 
Seat 4: fish72o ($10.73 in chips) 
Seat 5: johnnytrue ($10.67 in chips) 
Seat 6: Deniels7 ($15.69 in chips) 
Palen030: posts small blind $0.05
thedude696969: posts big blind $0.10
*** HOLE CARDS ***
fish72o: folds 
johnnytrue: calls $0.10
Deniels7: calls $0.10
Tyoma_Kovach: folds 
Palen030: calls $0.05
thedude696969: checks 
*** FLOP *** [5s 9h Ks]
Palen030: checks 
thedude696969: bets $0.20
johnnytrue: calls $0.20
Deniels7: folds 
Palen030: calls $0.20
*** TURN *** [5s 9h Ks] [2h]
Palen030: checks 
thedude696969: bets $0.62
johnnytrue: folds 
Palen030: folds 
Uncalled bet ($0.62) returned to thedude696969
thedude696969 collected $0.96 from pot
thedude696969: doesn't show hand 
*** SUMMARY ***
Total pot $1 | Rake $0.04 
Board [5s 9h Ks 2h]
Seat 1: Tyoma_Kovach (button) folded before Flop (didn't bet)
Seat 2: Palen030 (small blind) folded on the Turn
Seat 3: thedude696969 (big blind) collected ($0.96)
Seat 4: fish72o folded before Flop (didn't bet)
Seat 5: johnnytrue folded on the Turn
Seat 6: Deniels7 folded on the Flop



PokerStars Hand #222945042984:  Hold'em No Limit ($0.05/$0.10 USD) - 2021/01/23 0:23:53 ET
Table 'Algieba III' 6-max Seat #2 is the button
Seat 1: Tyoma_Kovach ($10 in chips) 
Seat 2: Palen030 ($1.08 in chips) 
Seat 3: thedude696969 ($29.43 in chips) 
Seat 4: fish72o ($10.73 in chips) 
Seat 5: johnnytrue ($10.37 in chips) 
Seat 6: Deniels7 ($15.59 in chips) 
thedude696969: posts small blind $0.05
fish72o: posts big blind $0.10
*** HOLE CARDS ***
johnnytrue: folds 
Deniels7: calls $0.10
Tyoma_Kovach: raises $0.35 to $0.45
Palen030: folds 
thedude696969: folds 
fish72o: folds 
Deniels7: calls $0.35
*** FLOP *** [Tc 7s 4c]
Deniels7: checks 
Tyoma_Kovach: bets $0.75
Deniels7: folds 
Uncalled bet ($0.75) returned to Tyoma_Kovach
Tyoma_Kovach collected $1 from pot
Tyoma_Kovach: doesn't show hand 
*** SUMMARY ***
Total pot $1.05 | Rake $0.05 
Board [Tc 7s 4c]
Seat 1: Tyoma_Kovach collected ($1)
Seat 2: Palen030 (button) folded before Flop (didn't bet)
Seat 3: thedude696969 (small blind) folded before Flop
Seat 4: fish72o (big blind) folded before Flop
Seat 5: johnnytrue folded before Flop (didn't bet)
Seat 6: Deniels7 folded on the Flop



PokerStars Hand #222945054829:  Hold'em No Limit ($0.05/$0.10 USD) - 2021/01/23 0:24:35 ET
Table 'Algieba III' 6-max Seat #3 is the button
Seat 1: Tyoma_Kovach ($10.55 in chips) 
Seat 2: Palen030 ($1.08 in chips) 
Seat 3: thedude696969 ($29.38 in chips) 
Seat 4: fish72o ($10.63 in chips) 
Seat 5: johnnytrue ($10.37 in chips) 
Seat 6: Deniels7 ($15.14 in chips) 
fish72o: posts small blind $0.05
johnnytrue: posts big blind $0.10
*** HOLE CARDS ***
Deniels7: raises $0.20 to $0.30
Tyoma_Kovach: folds 
Palen030: folds 
thedude696969: folds 
fish72o: folds 
johnnytrue: calls $0.20
*** FLOP *** [2c 4s Qd]
johnnytrue: checks 
Deniels7: checks 
*** TURN *** [2c 4s Qd] [6d]
johnnytrue: checks 
Deniels7: checks 
*** RIVER *** [2c 4s Qd 6d] [Ac]
johnnytrue: checks 
Deniels7: bets $0.40
johnnytrue: folds 
Uncalled bet ($0.40) returned to Deniels7
Deniels7 collected $0.62 from pot
Deniels7: doesn't show hand 
*** SUMMARY ***
Total pot $0.65 | Rake $0.03 
Board [2c 4s Qd 6d Ac]
Seat 1: Tyoma_Kovach folded before Flop (didn't bet)
Seat 2: Palen030 folded before Flop (didn't bet)
Seat 3: thedude696969 (button) folded before Flop (didn't bet)
Seat 4: fish72o (small blind) folded before Flop
Seat 5: johnnytrue (big blind) folded on the River
Seat 6: Deniels7 collected ($0.62)



PokerStars Hand #222945067467:  Hold'em No Limit ($0.05/$0.10 USD) - 2021/01/23 0:25:22 ET
Table 'Algieba III' 6-max Seat #4 is the button
Seat 1: Tyoma_Kovach ($10.55 in chips) 
Seat 2: Palen030 ($1.08 in chips) 
Seat 3: thedude696969 ($29.38 in chips) 
Seat 4: fish72o ($10.58 in chips) 
Seat 5: johnnytrue ($10.07 in chips) 
Seat 6: Deniels7 ($15.46 in chips) 
johnnytrue: posts small blind $0.05
Deniels7: posts big blind $0.10
*** HOLE CARDS ***
Tyoma_Kovach: raises $0.20 to $0.30
Palen030: raises $0.78 to $1.08 and is all-in
thedude696969: folds 
fish72o: folds 
johnnytrue: folds 
Deniels7: calls $0.98
Tyoma_Kovach: calls $0.78
*** FLOP *** [4h Th 7s]
Deniels7: checks 
Tyoma_Kovach: bets $1.04
Deniels7: calls $1.04
*** TURN *** [4h Th 7s] [9c]
Deniels7: checks 
Tyoma_Kovach: checks 
*** RIVER *** [4h Th 7s 9c] [6h]
Deniels7: checks 
Tyoma_Kovach: checks 
*** SHOW DOWN ***
Deniels7: shows [Qh Jd] (high card Queen)
Tyoma_Kovach: shows [5c 5d] (a pair of Fives)
Tyoma_Kovach collected $1.99 from side pot
Palen030: mucks hand 
Tyoma_Kovach collected $3.14 from main pot
*** SUMMARY ***
Total pot $5.37 Main pot $3.14. Side pot $1.99. | Rake $0.24 
Board [4h Th 7s 9c 6h]
Seat 1: Tyoma_Kovach showed [5c 5d] and won ($5.13) with a pair of Fives
Seat 2: Palen030 mucked
Seat 3: thedude696969 folded before Flop (didn't bet)
Seat 4: fish72o (button) folded before Flop (didn't bet)
Seat 5: johnnytrue (small blind) folded before Flop
Seat 6: Deniels7 (big blind) showed [Qh Jd] and lost with high card Queen



PokerStars Hand #222945081101:  Hold'em No Limit ($0.05/$0.10 USD) - 2021/01/23 0:26:11 ET
Table 'Algieba III' 6-max Seat #5 is the button
Seat 1: Tyoma_Kovach ($13.56 in chips) 
Seat 3: thedude696969 ($29.38 in chips) 
Seat 4: fish72o ($10.58 in chips) 
Seat 5: johnnytrue ($10.02 in chips) 
Seat 6: Deniels7 ($13.34 in chips) 
Deniels7: posts small blind $0.05
Tyoma_Kovach: posts big blind $0.10
*** HOLE CARDS ***
thedude696969: folds 
Palen030 leaves the table
fish72o: raises $0.15 to $0.25
johnnytrue: folds 
Deniels7: folds 
Tyoma_Kovach: folds 
Uncalled bet ($0.15) returned to fish72o
fish72o collected $0.25 from pot
fish72o: doesn't show hand 
*** SUMMARY ***
Total pot $0.25 | Rake $0 
Seat 1: Tyoma_Kovach (big blind) folded before Flop
Seat 3: thedude696969 folded before Flop (didn't bet)
Seat 4: fish72o collected ($0.25)
Seat 5: johnnytrue (button) folded before Flop (didn't bet)
Seat 6: Deniels7 (small blind) folded before Flop



PokerStars Hand #222945086642:  Hold'em No Limit ($0.05/$0.10 USD) - 2021/01/23 0:26:31 ET
Table 'Algieba III' 6-max Seat #6 is the button
Seat 1: Tyoma_Kovach ($13.46 in chips) 
Seat 3: thedude696969 ($29.38 in chips) 
Seat 4: fish72o ($10.73 in chips) 
Seat 5: johnnytrue ($10.02 in chips) 
Seat 6: Deniels7 ($13.29 in chips) 
Tyoma_Kovach: posts small blind $0.05
thedude696969: posts big blind $0.10
*** HOLE CARDS ***
fish72o: folds 
johnnytrue: folds 
sixcoins joins the table at seat #2 
Deniels7: calls $0.10
Tyoma_Kovach: raises $0.40 to $0.50
thedude696969: folds 
Deniels7: calls $0.40
*** FLOP *** [6d 8d 5c]
Tyoma_Kovach: checks 
Deniels7: checks 
*** TURN *** [6d 8d 5c] [9c]
Tyoma_Kovach: checks 
Deniels7: bets $0.60
Tyoma_Kovach: calls $0.60
*** RIVER *** [6d 8d 5c 9c] [Qd]
Tyoma_Kovach: checks 
Deniels7: checks 
*** SHOW DOWN ***
Tyoma_Kovach: shows [Kd Ah] (high card Ace)
Deniels7: shows [Kc 8h] (a pair of Eights)
Deniels7 collected $2.20 from pot
*** SUMMARY ***
Total pot $2.30 | Rake $0.10 
Board [6d 8d 5c 9c Qd]
Seat 1: Tyoma_Kovach (small blind) showed [Kd Ah] and lost with high card Ace
Seat 3: thedude696969 (big blind) folded before Flop
Seat 4: fish72o folded before Flop (didn't bet)
Seat 5: johnnytrue folded before Flop (didn't bet)
Seat 6: Deniels7 (button) showed [Kc 8h] and won ($2.20) with a pair of Eights



PokerStars Hand #222945097435:  Hold'em No Limit ($0.05/$0.10 USD) - 2021/01/23 0:27:11 ET
Table 'Algieba III' 6-max Seat #1 is the button
Seat 1: Tyoma_Kovach ($12.36 in chips) 
Seat 3: thedude696969 ($29.28 in chips) 
Seat 4: fish72o ($10.73 in chips) 
Seat 5: johnnytrue ($10.02 in chips) 
Seat 6: Deniels7 ($14.39 in chips) 
thedude696969: posts small blind $0.05
fish72o: posts big blind $0.10
*** HOLE CARDS ***
johnnytrue: calls $0.10
Deniels7: folds 
Tyoma_Kovach: raises $0.35 to $0.45
thedude696969: folds 
fish72o: folds 
johnnytrue: folds 
Uncalled bet ($0.35) returned to Tyoma_Kovach
Tyoma_Kovach collected $0.35 from pot
Tyoma_Kovach: doesn't show hand 
*** SUMMARY ***
Total pot $0.35 | Rake $0 
Seat 1: Tyoma_Kovach (button) collected ($0.35)
Seat 3: thedude696969 (small blind) folded before Flop
Seat 4: fish72o (big blind) folded before Flop
Seat 5: johnnytrue folded before Flop
Seat 6: Deniels7 folded before Flop (didn't bet)



PokerStars Hand #222945101612:  Hold'em No Limit ($0.05/$0.10 USD) - 2021/01/23 0:27:26 ET
Table 'Algieba III' 6-max Seat #3 is the button
Seat 1: Tyoma_Kovach ($12.61 in chips) 
Seat 3: thedude696969 ($29.23 in chips) 
Seat 4: fish72o ($10.63 in chips) 
Seat 5: johnnytrue ($9.92 in chips) 
Seat 6: Deniels7 ($14.39 in chips) 
fish72o: posts small blind $0.05
johnnytrue: posts big blind $0.10
sixcoins: sits out 
*** HOLE CARDS ***
Deniels7: folds 
Tyoma_Kovach: folds 
thedude696969: folds 
fish72o: folds 
Uncalled bet ($0.05) returned to johnnytrue
johnnytrue collected $0.10 from pot
*** SUMMARY ***
Total pot $0.10 | Rake $0 
Seat 1: Tyoma_Kovach folded before Flop (didn't bet)
Seat 3: thedude696969 (button) folded before Flop (didn't bet)
Seat 4: fish72o (small blind) folded before Flop
Seat 5: johnnytrue (big blind) collected ($0.10)
Seat 6: Deniels7 folded before Flop (didn't bet)



PokerStars Hand #222945104236:  Hold'em No Limit ($0.05/$0.10 USD) - 2021/01/23 0:27:36 ET
Table 'Algieba III' 6-max Seat #4 is the button
Seat 1: Tyoma_Kovach ($12.61 in chips) 
Seat 3: thedude696969 ($29.23 in chips) 
Seat 4: fish72o ($10.58 in chips) 
Seat 5: johnnytrue ($9.97 in chips) 
Seat 6: Deniels7 ($14.39 in chips) 
johnnytrue: posts small blind $0.05
Deniels7: posts big blind $0.10
sixcoins: sits out 
*** HOLE CARDS ***
Tyoma_Kovach: folds 
thedude696969: folds 
fish72o: folds 
johnnytrue: calls $0.05
Deniels7: checks 
*** FLOP *** [Qc Kc Td]
johnnytrue: checks 
Deniels7: checks 
*** TURN *** [Qc Kc Td] [3s]
johnnytrue: bets $0.19
Deniels7: calls $0.19
*** RIVER *** [Qc Kc Td 3s] [6d]
johnnytrue: bets $0.90
Deniels7: folds 
Uncalled bet ($0.90) returned to johnnytrue
johnnytrue collected $0.55 from pot
*** SUMMARY ***
Total pot $0.58 | Rake $0.03 
Board [Qc Kc Td 3s 6d]
Seat 1: Tyoma_Kovach folded before Flop (didn't bet)
Seat 3: thedude696969 folded before Flop (didn't bet)
Seat 4: fish72o (button) folded before Flop (didn't bet)
Seat 5: johnnytrue (small blind) collected ($0.55)
Seat 6: Deniels7 (big blind) folded on the River



PokerStars Hand #222945114187:  Hold'em No Limit ($0.05/$0.10 USD) - 2021/01/23 0:28:12 ET
Table 'Algieba III' 6-max Seat #5 is the button
Seat 1: Tyoma_Kovach ($12.61 in chips) 
Seat 3: thedude696969 ($29.23 in chips) 
Seat 4: fish72o ($10.58 in chips) 
Seat 5: johnnytrue ($10.23 in chips) 
Seat 6: Deniels7 ($14.10 in chips) 
Deniels7: posts small blind $0.05
Tyoma_Kovach: posts big blind $0.10
sixcoins: sits out 
*** HOLE CARDS ***
thedude696969: folds 
fish72o: raises $0.15 to $0.25
johnnytrue: folds 
Deniels7: folds 
Tyoma_Kovach: folds 
Uncalled bet ($0.15) returned to fish72o
fish72o collected $0.25 from pot
fish72o: doesn't show hand 
*** SUMMARY ***
Total pot $0.25 | Rake $0 
Seat 1: Tyoma_Kovach (big blind) folded before Flop
Seat 3: thedude696969 folded before Flop (didn't bet)
Seat 4: fish72o collected ($0.25)
Seat 5: johnnytrue (button) folded before Flop (didn't bet)
Seat 6: Deniels7 (small blind) folded before Flop



PokerStars Hand #222945118763:  Hold'em No Limit ($0.05/$0.10 USD) - 2021/01/23 0:28:29 ET
Table 'Algieba III' 6-max Seat #6 is the button
Seat 1: Tyoma_Kovach ($12.51 in chips) 
Seat 2: sixcoins ($8 in chips) 
Seat 3: thedude696969 ($29.23 in chips) 
Seat 4: fish72o ($10.73 in chips) 
Seat 5: johnnytrue ($10.23 in chips) 
Seat 6: Deniels7 ($14.05 in chips) 
Tyoma_Kovach: posts small blind $0.05
sixcoins: posts big blind $0.10
*** HOLE CARDS ***
thedude696969: folds 
fish72o: folds 
johnnytrue: folds 
Deniels7: raises $0.10 to $0.20
Tyoma_Kovach: folds 
sixcoins: folds 
Uncalled bet ($0.10) returned to Deniels7
Deniels7 collected $0.25 from pot
Deniels7: doesn't show hand 
*** SUMMARY ***
Total pot $0.25 | Rake $0 
Seat 1: Tyoma_Kovach (small blind) folded before Flop
Seat 2: sixcoins (big blind) folded before Flop
Seat 3: thedude696969 folded before Flop (didn't bet)
Seat 4: fish72o folded before Flop (didn't bet)
Seat 5: johnnytrue folded before Flop (didn't bet)
Seat 6: Deniels7 (button) collected ($0.25)



PokerStars Hand #222945122553:  Hold'em No Limit ($0.05/$0.10 USD) - 2021/01/23 0:28:43 ET
Table 'Algieba III' 6-max Seat #1 is the button
Seat 1: Tyoma_Kovach ($12.46 in chips) 
Seat 2: sixcoins ($7.90 in chips) 
Seat 3: thedude696969 ($29.23 in chips) 
Seat 4: fish72o ($10.73 in chips) 
Seat 5: johnnytrue ($10.23 in chips) 
Seat 6: Deniels7 ($14.20 in chips) 
sixcoins: posts small blind $0.05
thedude696969: posts big blind $0.10
*** HOLE CARDS ***
fish72o: folds 
johnnytrue: calls $0.10
Deniels7: folds 
Tyoma_Kovach: folds 
sixcoins: calls $0.05
thedude696969: checks 
*** FLOP *** [Kh 3d 4d]
sixcoins: checks 
thedude696969: checks 
johnnytrue: checks 
*** TURN *** [Kh 3d 4d] [As]
sixcoins: checks 
thedude696969: checks 
johnnytrue: checks 
*** RIVER *** [Kh 3d 4d As] [4c]
sixcoins: checks 
thedude696969: checks 
johnnytrue: checks 
*** SHOW DOWN ***
sixcoins: shows [2s 2c] (two pair, Fours and Deuces)
thedude696969: mucks hand 
johnnytrue: shows [Qh Qd] (two pair, Queens and Fours)
johnnytrue collected $0.29 from pot
*** SUMMARY ***
Total pot $0.30 | Rake $0.01 
Board [Kh 3d 4d As 4c]
Seat 1: Tyoma_Kovach (button) folded before Flop (didn't bet)
Seat 2: sixcoins (small blind) showed [2s 2c] and lost with two pair, Fours and Deuces
Seat 3: thedude696969 (big blind) mucked
Seat 4: fish72o folded before Flop (didn't bet)
Seat 5: johnnytrue showed [Qh Qd] and won ($0.29) with two pair, Queens and Fours
Seat 6: Deniels7 folded before Flop (didn't bet)



PokerStars Hand #222945137915:  Hold'em No Limit ($0.05/$0.10 USD) - 2021/01/23 0:29:19 ET
Table 'Algieba III' 6-max Seat #2 is the button
Seat 1: Tyoma_Kovach ($12.46 in chips) 
Seat 2: sixcoins ($7.80 in chips) 
Seat 3: thedude696969 ($29.13 in chips) 
Seat 4: fish72o ($10.73 in chips) 
Seat 5: johnnytrue ($10.42 in chips) 
Seat 6: Deniels7 ($14.20 in chips) 
thedude696969: posts small blind $0.05
fish72o: posts big blind $0.10
*** HOLE CARDS ***
johnnytrue: folds 
Deniels7: calls $0.10
Tyoma_Kovach: folds 
sixcoins: folds 
thedude696969: raises $0.20 to $0.30
fish72o: folds 
Deniels7: calls $0.20
*** FLOP *** [7d 8s 4d]
thedude696969: checks 
Deniels7: checks 
*** TURN *** [7d 8s 4d] [6d]
thedude696969: bets $0.40
Deniels7: calls $0.40
*** RIVER *** [7d 8s 4d 6d] [8h]
thedude696969: bets $1.50
Deniels7: folds 
Uncalled bet ($1.50) returned to thedude696969
thedude696969 collected $1.43 from pot
thedude696969: doesn't show hand 
*** SUMMARY ***
Total pot $1.50 | Rake $0.07 
Board [7d 8s 4d 6d 8h]
Seat 1: Tyoma_Kovach folded before Flop (didn't bet)
Seat 2: sixcoins (button) folded before Flop (didn't bet)
Seat 3: thedude696969 (small blind) collected ($1.43)
Seat 4: fish72o (big blind) folded before Flop
Seat 5: johnnytrue folded before Flop (didn't bet)
Seat 6: Deniels7 folded on the River



PokerStars Hand #222945148151:  Hold'em No Limit ($0.05/$0.10 USD) - 2021/01/23 0:29:57 ET
Table 'Algieba III' 6-max Seat #3 is the button
Seat 1: Tyoma_Kovach ($12.46 in chips) 
Seat 2: sixcoins ($7.80 in chips) 
Seat 3: thedude696969 ($29.86 in chips) 
Seat 4: fish72o ($10.63 in chips) 
Seat 5: johnnytrue ($10.42 in chips) 
Seat 6: Deniels7 ($13.50 in chips) 
fish72o: posts small blind $0.05
johnnytrue: posts big blind $0.10
*** HOLE CARDS ***
Deniels7: folds 
Tyoma_Kovach: folds 
sixcoins: folds 
thedude696969: raises $0.30 to $0.40
fish72o: calls $0.35
johnnytrue: calls $0.30
*** FLOP *** [Ts Ah 8h]
fish72o: checks 
johnnytrue: checks 
thedude696969: bets $0.80
fish72o: folds 
johnnytrue: folds 
Uncalled bet ($0.80) returned to thedude696969
thedude696969 collected $1.15 from pot
thedude696969: doesn't show hand 
*** SUMMARY ***
Total pot $1.20 | Rake $0.05 
Board [Ts Ah 8h]
Seat 1: Tyoma_Kovach folded before Flop (didn't bet)
Seat 2: sixcoins folded before Flop (didn't bet)
Seat 3: thedude696969 (button) collected ($1.15)
Seat 4: fish72o (small blind) folded on the Flop
Seat 5: johnnytrue (big blind) folded on the Flop
Seat 6: Deniels7 folded before Flop (didn't bet)



PokerStars Hand #222945165262:  Hold'em No Limit ($0.05/$0.10 USD) - 2021/01/23 0:30:59 ET
Table 'Algieba III' 6-max Seat #4 is the button
Seat 1: Tyoma_Kovach ($12.46 in chips) 
Seat 2: sixcoins ($7.80 in chips) 
Seat 3: thedude696969 ($30.61 in chips) 
Seat 4: fish72o ($10.23 in chips) 
Seat 5: johnnytrue ($10.02 in chips) 
Seat 6: Deniels7 ($13.50 in chips) 
johnnytrue: posts small blind $0.05
Deniels7: posts big blind $0.10
*** HOLE CARDS ***
Tyoma_Kovach: folds 
sixcoins: folds 
thedude696969: folds 
fish72o: raises $0.10 to $0.20
johnnytrue: folds 
Deniels7: calls $0.10
*** FLOP *** [Kh 6d 9c]
Deniels7: checks 
fish72o: bets $0.29
Deniels7: calls $0.29
*** TURN *** [Kh 6d 9c] [2s]
Deniels7: checks 
fish72o: checks 
*** RIVER *** [Kh 6d 9c 2s] [9s]
Deniels7: checks 
fish72o: checks 
*** SHOW DOWN ***
Deniels7: shows [7d 9d] (three of a kind, Nines)
fish72o: mucks hand 
Deniels7 collected $0.98 from pot
*** SUMMARY ***
Total pot $1.03 | Rake $0.05 
Board [Kh 6d 9c 2s 9s]
Seat 1: Tyoma_Kovach folded before Flop (didn't bet)
Seat 2: sixcoins folded before Flop (didn't bet)
Seat 3: thedude696969 folded before Flop (didn't bet)
Seat 4: fish72o (button) mucked
Seat 5: johnnytrue (small blind) folded before Flop
Seat 6: Deniels7 (big blind) showed [7d 9d] and won ($0.98) with three of a kind, Nines



PokerStars Hand #222945175721:  Hold'em No Limit ($0.05/$0.10 USD) - 2021/01/23 0:31:38 ET
Table 'Algieba III' 6-max Seat #5 is the button
Seat 1: Tyoma_Kovach ($12.46 in chips) 
Seat 2: sixcoins ($7.80 in chips) 
Seat 3: thedude696969 ($30.61 in chips) 
Seat 4: fish72o ($10 in chips) 
Seat 5: johnnytrue ($9.97 in chips) 
Seat 6: Deniels7 ($13.99 in chips) 
Deniels7: posts small blind $0.05
Tyoma_Kovach: posts big blind $0.10
*** HOLE CARDS ***
sixcoins: folds 
thedude696969: folds 
fish72o: raises $0.15 to $0.25
johnnytrue: folds 
Deniels7: raises $0.15 to $0.40
Tyoma_Kovach: folds 
fish72o: calls $0.15
*** FLOP *** [9c 5d 7s]
Deniels7: bets $0.40
fish72o: folds 
Uncalled bet ($0.40) returned to Deniels7
Deniels7 collected $0.86 from pot
Deniels7: doesn't show hand 
*** SUMMARY ***
Total pot $0.90 | Rake $0.04 
Board [9c 5d 7s]
Seat 1: Tyoma_Kovach (big blind) folded before Flop
Seat 2: sixcoins folded before Flop (didn't bet)
Seat 3: thedude696969 folded before Flop (didn't bet)
Seat 4: fish72o folded on the Flop
Seat 5: johnnytrue (button) folded before Flop (didn't bet)
Seat 6: Deniels7 (small blind) collected ($0.86)



PokerStars Hand #222945183679:  Hold'em No Limit ($0.05/$0.10 USD) - 2021/01/23 0:32:07 ET
Table 'Algieba III' 6-max Seat #6 is the button
Seat 1: Tyoma_Kovach ($12.36 in chips) 
Seat 2: sixcoins ($7.80 in chips) 
Seat 3: thedude696969 ($30.61 in chips) 
Seat 4: fish72o ($10 in chips) 
Seat 5: johnnytrue ($9.97 in chips) 
Seat 6: Deniels7 ($14.45 in chips) 
Tyoma_Kovach: posts small blind $0.05
sixcoins: posts big blind $0.10
*** HOLE CARDS ***
thedude696969: folds 
fish72o: raises $0.15 to $0.25
johnnytrue: folds 
Deniels7: folds 
Tyoma_Kovach: folds 
sixcoins: folds 
Uncalled bet ($0.15) returned to fish72o
fish72o collected $0.25 from pot
fish72o: doesn't show hand 
*** SUMMARY ***
Total pot $0.25 | Rake $0 
Seat 1: Tyoma_Kovach (small blind) folded before Flop
Seat 2: sixcoins (big blind) folded before Flop
Seat 3: thedude696969 folded before Flop (didn't bet)
Seat 4: fish72o collected ($0.25)
Seat 5: johnnytrue folded before Flop (didn't bet)
Seat 6: Deniels7 (button) folded before Flop (didn't bet)



PokerStars Hand #222945186715:  Hold'em No Limit ($0.05/$0.10 USD) - 2021/01/23 0:32:19 ET
Table 'Algieba III' 6-max Seat #1 is the button
Seat 1: Tyoma_Kovach ($12.31 in chips) 
Seat 2: sixcoins ($7.70 in chips) 
Seat 3: thedude696969 ($30.61 in chips) 
Seat 4: fish72o ($10.15 in chips) 
Seat 5: johnnytrue ($9.97 in chips) 
Seat 6: Deniels7 ($14.45 in chips) 
sixcoins: posts small blind $0.05
thedude696969: posts big blind $0.10
*** HOLE CARDS ***
fish72o: folds 
johnnytrue: calls $0.10
Deniels7: calls $0.10
Tyoma_Kovach: folds 
sixcoins: folds 
thedude696969: checks 
*** FLOP *** [5d Qs 4c]
thedude696969: checks 
johnnytrue: checks 
Deniels7: checks 
*** TURN *** [5d Qs 4c] [Kh]
thedude696969: checks 
johnnytrue: checks 
Deniels7: checks 
*** RIVER *** [5d Qs 4c Kh] [2d]
thedude696969: bets $0.20
johnnytrue: folds 
Deniels7: calls $0.20
*** SHOW DOWN ***
thedude696969: shows [8d 6c] (high card King)
Deniels7: shows [6h Qh] (a pair of Queens)
Deniels7 collected $0.72 from pot
*** SUMMARY ***
Total pot $0.75 | Rake $0.03 
Board [5d Qs 4c Kh 2d]
Seat 1: Tyoma_Kovach (button) folded before Flop (didn't bet)
Seat 2: sixcoins (small blind) folded before Flop
Seat 3: thedude696969 (big blind) showed [8d 6c] and lost with high card King
Seat 4: fish72o folded before Flop (didn't bet)
Seat 5: johnnytrue folded on the River
Seat 6: Deniels7 showed [6h Qh] and won ($0.72) with a pair of Queens



PokerStars Hand #222945196781:  Hold'em No Limit ($0.05/$0.10 USD) - 2021/01/23 0:32:56 ET
Table 'Algieba III' 6-max Seat #2 is the button
Seat 1: Tyoma_Kovach ($12.31 in chips) 
Seat 2: sixcoins ($7.65 in chips) 
Seat 3: thedude696969 ($30.31 in chips) 
Seat 4: fish72o ($10.15 in chips) 
Seat 5: johnnytrue ($9.87 in chips) 
Seat 6: Deniels7 ($14.87 in chips) 
thedude696969: posts small blind $0.05
fish72o: posts big blind $0.10
*** HOLE CARDS ***
johnnytrue: folds 
Deniels7: folds 
Tyoma_Kovach: raises $0.18 to $0.28
sixcoins: folds 
thedude696969: folds 
fish72o: folds 
Uncalled bet ($0.18) returned to Tyoma_Kovach
Tyoma_Kovach collected $0.25 from pot
Tyoma_Kovach: doesn't show hand 
*** SUMMARY ***
Total pot $0.25 | Rake $0 
Seat 1: Tyoma_Kovach collected ($0.25)
Seat 2: sixcoins (button) folded before Flop (didn't bet)
Seat 3: thedude696969 (small blind) folded before Flop
Seat 4: fish72o (big blind) folded before Flop
Seat 5: johnnytrue folded before Flop (didn't bet)
Seat 6: Deniels7 folded before Flop (didn't bet)



PokerStars Hand #222945200196:  Hold'em No Limit ($0.05/$0.10 USD) - 2021/01/23 0:33:08 ET
Table 'Algieba III' 6-max Seat #3 is the button
Seat 1: Tyoma_Kovach ($12.46 in chips) 
Seat 2: sixcoins ($7.65 in chips) 
Seat 3: thedude696969 ($30.26 in chips) 
Seat 4: fish72o ($10.05 in chips) 
Seat 5: johnnytrue ($9.87 in chips) 
Seat 6: Deniels7 ($14.87 in chips) 
fish72o: posts small blind $0.05
johnnytrue: posts big blind $0.10
*** HOLE CARDS ***
Deniels7: folds 
Tyoma_Kovach: raises $0.20 to $0.30
sixcoins: folds 
thedude696969: raises $0.90 to $1.20
fish72o: folds 
johnnytrue: folds 
Tyoma_Kovach: folds 
Uncalled bet ($0.90) returned to thedude696969
thedude696969 collected $0.75 from pot
thedude696969: doesn't show hand 
*** SUMMARY ***
Total pot $0.75 | Rake $0 
Seat 1: Tyoma_Kovach folded before Flop
Seat 2: sixcoins folded before Flop (didn't bet)
Seat 3: thedude696969 (button) collected ($0.75)
Seat 4: fish72o (small blind) folded before Flop
Seat 5: johnnytrue (big blind) folded before Flop
Seat 6: Deniels7 folded before Flop (didn't bet)



PokerStars Hand #222945206234:  Hold'em No Limit ($0.05/$0.10 USD) - 2021/01/23 0:33:31 ET
Table 'Algieba III' 6-max Seat #4 is the button
Seat 1: Tyoma_Kovach ($12.16 in chips) 
Seat 2: sixcoins ($7.65 in chips) 
Seat 3: thedude696969 ($30.71 in chips) 
Seat 4: fish72o ($10 in chips) 
Seat 5: johnnytrue ($9.77 in chips) 
Seat 6: Deniels7 ($14.87 in chips) 
johnnytrue: posts small blind $0.05
Deniels7: posts big blind $0.10
*** HOLE CARDS ***
Tyoma_Kovach: folds 
sixcoins: folds 
thedude696969: folds 
fish72o: raises $0.15 to $0.25
johnnytrue: calls $0.20
Deniels7: calls $0.15
*** FLOP *** [6s 6d Kh]
johnnytrue: checks 
Deniels7: checks 
fish72o: checks 
*** TURN *** [6s 6d Kh] [4d]
johnnytrue: checks 
Deniels7: checks 
fish72o: checks 
*** RIVER *** [6s 6d Kh 4d] [Qs]
johnnytrue: checks 
Deniels7: checks 
fish72o: bets $0.24
johnnytrue: folds 
Deniels7: calls $0.24
*** SHOW DOWN ***
fish72o: shows [Ts Qc] (two pair, Queens and Sixes)
Deniels7: shows [3d Qh] (two pair, Queens and Sixes)
Deniels7 collected $0.59 from pot
fish72o collected $0.58 from pot
*** SUMMARY ***
Total pot $1.23 | Rake $0.06 
Board [6s 6d Kh 4d Qs]
Seat 1: Tyoma_Kovach folded before Flop (didn't bet)
Seat 2: sixcoins folded before Flop (didn't bet)
Seat 3: thedude696969 folded before Flop (didn't bet)
Seat 4: fish72o (button) showed [Ts Qc] and won ($0.58) with two pair, Queens and Sixes
Seat 5: johnnytrue (small blind) folded on the River
Seat 6: Deniels7 (big blind) showed [3d Qh] and won ($0.59) with two pair, Queens and Sixes



PokerStars Hand #222945221432:  Hold'em No Limit ($0.05/$0.10 USD) - 2021/01/23 0:34:27 ET
Table 'Algieba III' 6-max Seat #5 is the button
Seat 1: Tyoma_Kovach ($12.16 in chips) 
Seat 2: sixcoins ($7.65 in chips) 
Seat 3: thedude696969 ($30.71 in chips) 
Seat 4: fish72o ($10.09 in chips) 
Seat 5: johnnytrue ($9.52 in chips) 
Seat 6: Deniels7 ($14.97 in chips) 
Deniels7: posts small blind $0.05
Tyoma_Kovach: posts big blind $0.10
*** HOLE CARDS ***
sixcoins: folds 
thedude696969: folds 
fish72o: raises $0.15 to $0.25
johnnytrue: folds 
Deniels7: calls $0.20
Tyoma_Kovach: calls $0.15
*** FLOP *** [5s Jh 7d]
Deniels7: checks 
Tyoma_Kovach: checks 
fish72o: bets $0.24
Deniels7: folds 
Tyoma_Kovach: calls $0.24
*** TURN *** [5s Jh 7d] [5h]
Tyoma_Kovach: checks 
fish72o: checks 
*** RIVER *** [5s Jh 7d 5h] [2c]
Tyoma_Kovach: checks 
fish72o: checks 
*** SHOW DOWN ***
Tyoma_Kovach: shows [6s 4s] (a pair of Fives)
fish72o: shows [Ts Qd] (a pair of Fives - Queen kicker)
fish72o collected $1.17 from pot
*** SUMMARY ***
Total pot $1.23 | Rake $0.06 
Board [5s Jh 7d 5h 2c]
Seat 1: Tyoma_Kovach (big blind) showed [6s 4s] and lost with a pair of Fives
Seat 2: sixcoins folded before Flop (didn't bet)
Seat 3: thedude696969 folded before Flop (didn't bet)
Seat 4: fish72o showed [Ts Qd] and won ($1.17) with a pair of Fives
Seat 5: johnnytrue (button) folded before Flop (didn't bet)
Seat 6: Deniels7 (small blind) folded on the Flop



PokerStars Hand #222945234448:  Hold'em No Limit ($0.05/$0.10 USD) - 2021/01/23 0:35:17 ET
Table 'Algieba III' 6-max Seat #6 is the button
Seat 1: Tyoma_Kovach ($11.67 in chips) 
Seat 2: sixcoins ($7.65 in chips) 
Seat 3: thedude696969 ($30.71 in chips) 
Seat 4: fish72o ($10.77 in chips) 
Seat 5: johnnytrue ($9.52 in chips) 
Seat 6: Deniels7 ($14.72 in chips) 
Tyoma_Kovach: posts small blind $0.05
sixcoins: posts big blind $0.10
*** HOLE CARDS ***
thedude696969: raises $0.14 to $0.24
fish72o: folds 
johnnytrue: folds 
Deniels7: calls $0.24
Tyoma_Kovach: folds 
sixcoins: folds 
*** FLOP *** [7s 4c 6d]
thedude696969: checks 
Deniels7: checks 
*** TURN *** [7s 4c 6d] [Th]
thedude696969: checks 
Deniels7: bets $0.10
thedude696969: calls $0.10
*** RIVER *** [7s 4c 6d Th] [3d]
thedude696969: checks 
Deniels7: bets $0.40
thedude696969: folds 
Uncalled bet ($0.40) returned to Deniels7
Deniels7 collected $0.79 from pot
Deniels7: doesn't show hand 
*** SUMMARY ***
Total pot $0.83 | Rake $0.04 
Board [7s 4c 6d Th 3d]
Seat 1: Tyoma_Kovach (small blind) folded before Flop
Seat 2: sixcoins (big blind) folded before Flop
Seat 3: thedude696969 folded on the River
Seat 4: fish72o folded before Flop (didn't bet)
Seat 5: johnnytrue folded before Flop (didn't bet)
Seat 6: Deniels7 (button) collected ($0.79)



PokerStars Hand #222945249513:  Hold'em No Limit ($0.05/$0.10 USD) - 2021/01/23 0:36:13 ET
Table 'Algieba III' 6-max Seat #1 is the button
Seat 1: Tyoma_Kovach ($11.62 in chips) 
Seat 2: sixcoins ($7.55 in chips) 
Seat 3: thedude696969 ($30.37 in chips) 
Seat 4: fish72o ($10.77 in chips) 
Seat 5: johnnytrue ($9.52 in chips) 
Seat 6: Deniels7 ($15.17 in chips) 
sixcoins: posts small blind $0.05
thedude696969: posts big blind $0.10
*** HOLE CARDS ***
fish72o: folds 
johnnytrue: folds 
Deniels7: calls $0.10
Tyoma_Kovach: folds 
sixcoins: calls $0.05
thedude696969: checks 
*** FLOP *** [9c 6d Jd]
sixcoins: checks 
thedude696969: bets $0.20
Deniels7: calls $0.20
sixcoins: folds 
*** TURN *** [9c 6d Jd] [5h]
thedude696969: bets $0.50
Deniels7: calls $0.50
*** RIVER *** [9c 6d Jd 5h] [2h]
thedude696969: bets $1.80
Deniels7: folds 
Uncalled bet ($1.80) returned to thedude696969
thedude696969 collected $1.62 from pot
thedude696969: doesn't show hand 
*** SUMMARY ***
Total pot $1.70 | Rake $0.08 
Board [9c 6d Jd 5h 2h]
Seat 1: Tyoma_Kovach (button) folded before Flop (didn't bet)
Seat 2: sixcoins (small blind) folded on the Flop
Seat 3: thedude696969 (big blind) collected ($1.62)
Seat 4: fish72o folded before Flop (didn't bet)
Seat 5: johnnytrue folded before Flop (didn't bet)
Seat 6: Deniels7 folded on the River



PokerStars Hand #222945262248:  Hold'em No Limit ($0.05/$0.10 USD) - 2021/01/23 0:37:01 ET
Table 'Algieba III' 6-max Seat #2 is the button
Seat 1: Tyoma_Kovach ($11.62 in chips) 
Seat 2: sixcoins ($7.45 in chips) 
Seat 3: thedude696969 ($31.19 in chips) 
Seat 4: fish72o ($10.77 in chips) 
Seat 5: johnnytrue ($9.52 in chips) 
Seat 6: Deniels7 ($14.37 in chips) 
thedude696969: posts small blind $0.05
fish72o: posts big blind $0.10
*** HOLE CARDS ***
johnnytrue: folds 
Deniels7: folds 
Tyoma_Kovach: folds 
sixcoins: raises $0.20 to $0.30
thedude696969: folds 
fish72o: calls $0.20
*** FLOP *** [Kh 8d Jd]
fish72o: checks 
sixcoins: bets $0.31
fish72o: calls $0.31
*** TURN *** [Kh 8d Jd] [Ks]
fish72o: checks 
sixcoins: checks 
*** RIVER *** [Kh 8d Jd Ks] [2c]
fish72o: bets $0.40
sixcoins: folds 
Uncalled bet ($0.40) returned to fish72o
fish72o collected $1.21 from pot
fish72o: doesn't show hand 
*** SUMMARY ***
Total pot $1.27 | Rake $0.06 
Board [Kh 8d Jd Ks 2c]
Seat 1: Tyoma_Kovach folded before Flop (didn't bet)
Seat 2: sixcoins (button) folded on the River
Seat 3: thedude696969 (small blind) folded before Flop
Seat 4: fish72o (big blind) collected ($1.21)
Seat 5: johnnytrue folded before Flop (didn't bet)
Seat 6: Deniels7 folded before Flop (didn't bet)



PokerStars Hand #222945273607:  Hold'em No Limit ($0.05/$0.10 USD) - 2021/01/23 0:37:44 ET
Table 'Algieba III' 6-max Seat #3 is the button
Seat 1: Tyoma_Kovach ($11.62 in chips) 
Seat 2: sixcoins ($6.84 in chips) 
Seat 3: thedude696969 ($31.14 in chips) 
Seat 4: fish72o ($11.37 in chips) 
Seat 5: johnnytrue ($9.52 in chips) 
Seat 6: Deniels7 ($14.37 in chips) 
fish72o: posts small blind $0.05
johnnytrue: posts big blind $0.10
*** HOLE CARDS ***
Deniels7: folds 
Tyoma_Kovach: folds 
sixcoins: folds 
thedude696969: raises $0.20 to $0.30
fish72o: raises $0.90 to $1.20
johnnytrue: folds 
thedude696969: calls $0.90
*** FLOP *** [Jd Ks 8s]
fish72o: bets $0.79
thedude696969: folds 
Uncalled bet ($0.79) returned to fish72o
fish72o collected $2.39 from pot
fish72o: doesn't show hand 
*** SUMMARY ***
Total pot $2.50 | Rake $0.11 
Board [Jd Ks 8s]
Seat 1: Tyoma_Kovach folded before Flop (didn't bet)
Seat 2: sixcoins folded before Flop (didn't bet)
Seat 3: thedude696969 (button) folded on the Flop
Seat 4: fish72o (small blind) collected ($2.39)
Seat 5: johnnytrue (big blind) folded before Flop
Seat 6: Deniels7 folded before Flop (didn't bet)



PokerStars Hand #222945280803:  Hold'em No Limit ($0.05/$0.10 USD) - 2021/01/23 0:38:11 ET
Table 'Algieba III' 6-max Seat #4 is the button
Seat 1: Tyoma_Kovach ($11.62 in chips) 
Seat 2: sixcoins ($6.84 in chips) 
Seat 3: thedude696969 ($29.94 in chips) 
Seat 4: fish72o ($12.56 in chips) 
Seat 5: johnnytrue ($9.42 in chips) 
Seat 6: Deniels7 ($14.37 in chips) 
johnnytrue: posts small blind $0.05
Deniels7: posts big blind $0.10
*** HOLE CARDS ***
Tyoma_Kovach: folds 
sixcoins: folds 
thedude696969: raises $0.16 to $0.26
fish72o: folds 
johnnytrue: calls $0.21
Deniels7: calls $0.16
*** FLOP *** [Js Jh Td]
johnnytrue: checks 
Deniels7: checks 
thedude696969: bets $0.47
johnnytrue: calls $0.47
Deniels7: calls $0.47
*** TURN *** [Js Jh Td] [8s]
johnnytrue: checks 
Deniels7: checks 
thedude696969: bets $1.34
johnnytrue: calls $1.34
Deniels7: folds 
*** RIVER *** [Js Jh Td 8s] [3s]
johnnytrue: checks 
thedude696969: bets $3
johnnytrue: calls $3
*** SHOW DOWN ***
thedude696969: shows [4h 5h] (a pair of Jacks)
johnnytrue: shows [Jc Qc] (three of a kind, Jacks)
johnnytrue collected $10.38 from pot
*** SUMMARY ***
Total pot $10.87 | Rake $0.49 
Board [Js Jh Td 8s 3s]
Seat 1: Tyoma_Kovach folded before Flop (didn't bet)
Seat 2: sixcoins folded before Flop (didn't bet)
Seat 3: thedude696969 showed [4h 5h] and lost with a pair of Jacks
Seat 4: fish72o (button) folded before Flop (didn't bet)
Seat 5: johnnytrue (small blind) showed [Jc Qc] and won ($10.38) with three of a kind, Jacks
Seat 6: Deniels7 (big blind) folded on the Turn



PokerStars Hand #222946068055:  Hold'em No Limit ($0.05/$0.10 USD) - 2021/01/23 1:29:50 ET
Table 'Algieba III' 6-max Seat #1 is the button
Seat 1: Tyoma_Kovach ($17.83 in chips) 
Seat 2: Gutik535 ($10.20 in chips) 
Seat 3: thedude696969 ($20.63 in chips) 
Seat 4: fish72o ($10 in chips) 
Seat 5: t_m_y_n ($16.38 in chips) 
Seat 6: Notatur ($11.15 in chips) 
Gutik535: posts small blind $0.05
thedude696969: posts big blind $0.10
*** HOLE CARDS ***
fish72o: folds 
t_m_y_n: raises $0.10 to $0.20
Notatur: folds 
Tyoma_Kovach: folds 
Gutik535: folds 
thedude696969: calls $0.10
*** FLOP *** [7d 9c Ts]
thedude696969: checks 
t_m_y_n: bets $0.20
thedude696969: folds 
Uncalled bet ($0.20) returned to t_m_y_n
t_m_y_n collected $0.43 from pot
t_m_y_n: doesn't show hand 
*** SUMMARY ***
Total pot $0.45 | Rake $0.02 
Board [7d 9c Ts]
Seat 1: Tyoma_Kovach (button) folded before Flop (didn't bet)
Seat 2: Gutik535 (small blind) folded before Flop
Seat 3: thedude696969 (big blind) folded on the Flop
Seat 4: fish72o folded before Flop (didn't bet)
Seat 5: t_m_y_n collected ($0.43)
Seat 6: Notatur folded before Flop (didn't bet)



PokerStars Hand #222946074228:  Hold'em No Limit ($0.05/$0.10 USD) - 2021/01/23 1:30:15 ET
Table 'Algieba III' 6-max Seat #2 is the button
Seat 1: Tyoma_Kovach ($17.83 in chips) 
Seat 2: Gutik535 ($10.15 in chips) 
Seat 3: thedude696969 ($20.43 in chips) 
Seat 4: fish72o ($10 in chips) 
Seat 5: t_m_y_n ($16.61 in chips) 
Seat 6: Notatur ($11.15 in chips) 
thedude696969: posts small blind $0.05
fish72o: posts big blind $0.10
*** HOLE CARDS ***
t_m_y_n: raises $0.10 to $0.20
Notatur: folds 
Tyoma_Kovach: folds 
Gutik535: raises $0.50 to $0.70
thedude696969: folds 
fish72o: folds 
t_m_y_n: calls $0.50
*** FLOP *** [Js 5h 3s]
t_m_y_n: checks 
Gutik535: bets $0.74
t_m_y_n: folds 
Uncalled bet ($0.74) returned to Gutik535
Gutik535 collected $1.48 from pot
Gutik535: doesn't show hand 
*** SUMMARY ***
Total pot $1.55 | Rake $0.07 
Board [Js 5h 3s]
Seat 1: Tyoma_Kovach folded before Flop (didn't bet)
Seat 2: Gutik535 (button) collected ($1.48)
Seat 3: thedude696969 (small blind) folded before Flop
Seat 4: fish72o (big blind) folded before Flop
Seat 5: t_m_y_n folded on the Flop
Seat 6: Notatur folded before Flop (didn't bet)



PokerStars Hand #222946083816:  Hold'em No Limit ($0.05/$0.10 USD) - 2021/01/23 1:30:55 ET
Table 'Algieba III' 6-max Seat #3 is the button
Seat 1: Tyoma_Kovach ($17.83 in chips) 
Seat 2: Gutik535 ($10.93 in chips) 
Seat 3: thedude696969 ($20.38 in chips) 
Seat 4: fish72o ($10 in chips) 
Seat 5: t_m_y_n ($15.91 in chips) 
Seat 6: Notatur ($11.15 in chips) 
fish72o: posts small blind $0.05
t_m_y_n: posts big blind $0.10
*** HOLE CARDS ***
Notatur: folds 
Tyoma_Kovach: raises $0.20 to $0.30
Gutik535: folds 
thedude696969: calls $0.30
fish72o: folds 
t_m_y_n: calls $0.20
*** FLOP *** [8d Jh 4s]
t_m_y_n: checks 
Tyoma_Kovach: checks 
thedude696969: checks 
*** TURN *** [8d Jh 4s] [Kh]
t_m_y_n: bets $0.25
Tyoma_Kovach: folds 
thedude696969: raises $1.05 to $1.30
t_m_y_n: folds 
Uncalled bet ($1.05) returned to thedude696969
thedude696969 collected $1.38 from pot
thedude696969: doesn't show hand 
*** SUMMARY ***
Total pot $1.45 | Rake $0.07 
Board [8d Jh 4s Kh]
Seat 1: Tyoma_Kovach folded on the Turn
Seat 2: Gutik535 folded before Flop (didn't bet)
Seat 3: thedude696969 (button) collected ($1.38)
Seat 4: fish72o (small blind) folded before Flop
Seat 5: t_m_y_n (big blind) folded on the Turn
Seat 6: Notatur folded before Flop (didn't bet)



PokerStars Hand #222946094085:  Hold'em No Limit ($0.05/$0.10 USD) - 2021/01/23 1:31:37 ET
Table 'Algieba III' 6-max Seat #4 is the button
Seat 1: Tyoma_Kovach ($17.53 in chips) 
Seat 2: Gutik535 ($10.93 in chips) 
Seat 3: thedude696969 ($21.21 in chips) 
Seat 4: fish72o ($10 in chips) 
Seat 5: t_m_y_n ($15.36 in chips) 
Seat 6: Notatur ($11.15 in chips) 
t_m_y_n: posts small blind $0.05
Notatur: posts big blind $0.10
*** HOLE CARDS ***
Tyoma_Kovach: raises $0.20 to $0.30
Gutik535: folds 
thedude696969: raises $1 to $1.30
fish72o: folds 
t_m_y_n: calls $1.25
Notatur: folds 
Tyoma_Kovach: calls $1
*** FLOP *** [8h 7s Ts]
t_m_y_n: checks 
Tyoma_Kovach: checks 
thedude696969: bets $1.60
t_m_y_n: calls $1.60
Tyoma_Kovach: folds 
*** TURN *** [8h 7s Ts] [4d]
t_m_y_n: checks 
thedude696969: checks 
*** RIVER *** [8h 7s Ts 4d] [6s]
t_m_y_n: bets $3.44
thedude696969: folds 
Uncalled bet ($3.44) returned to t_m_y_n
t_m_y_n collected $6.88 from pot
t_m_y_n: doesn't show hand 
*** SUMMARY ***
Total pot $7.20 | Rake $0.32 
Board [8h 7s Ts 4d 6s]
Seat 1: Tyoma_Kovach folded on the Flop
Seat 2: Gutik535 folded before Flop (didn't bet)
Seat 3: thedude696969 folded on the River
Seat 4: fish72o (button) folded before Flop (didn't bet)
Seat 5: t_m_y_n (small blind) collected ($6.88)
Seat 6: Notatur (big blind) folded before Flop



PokerStars Hand #222946107652:  Hold'em No Limit ($0.05/$0.10 USD) - 2021/01/23 1:32:33 ET
Table 'Algieba III' 6-max Seat #5 is the button
Seat 1: Tyoma_Kovach ($16.23 in chips) 
Seat 2: Gutik535 ($10.93 in chips) 
Seat 3: thedude696969 ($18.31 in chips) 
Seat 4: fish72o ($10 in chips) 
Seat 5: t_m_y_n ($19.34 in chips) 
Seat 6: Notatur ($11.05 in chips) 
Notatur: posts small blind $0.05
Tyoma_Kovach: posts big blind $0.10
*** HOLE CARDS ***
Gutik535: folds 
thedude696969: folds 
fish72o: folds 
t_m_y_n: folds 
Notatur: raises $0.15 to $0.25
Tyoma_Kovach: folds 
Uncalled bet ($0.15) returned to Notatur
Notatur collected $0.20 from pot
Notatur: doesn't show hand 
*** SUMMARY ***
Total pot $0.20 | Rake $0 
Seat 1: Tyoma_Kovach (big blind) folded before Flop
Seat 2: Gutik535 folded before Flop (didn't bet)
Seat 3: thedude696969 folded before Flop (didn't bet)
Seat 4: fish72o folded before Flop (didn't bet)
Seat 5: t_m_y_n (button) folded before Flop (didn't bet)
Seat 6: Notatur (small blind) collected ($0.20)



PokerStars Hand #222946110872:  Hold'em No Limit ($0.05/$0.10 USD) - 2021/01/23 1:32:46 ET
Table 'Algieba III' 6-max Seat #6 is the button
Seat 1: Tyoma_Kovach ($16.13 in chips) 
Seat 3: thedude696969 ($18.31 in chips) 
Seat 4: fish72o ($10 in chips) 
Seat 5: t_m_y_n ($19.34 in chips) 
Seat 6: Notatur ($11.15 in chips) 
Tyoma_Kovach: posts small blind $0.05
Gutik535: is sitting out 
thedude696969: posts big blind $0.10
*** HOLE CARDS ***
Gutik535 leaves the table
fish72o: folds 
t_m_y_n: raises $0.10 to $0.20
Notatur: folds 
Tyoma_Kovach: folds 
zebaztravez joins the table at seat #2 
thedude696969: raises $0.60 to $0.80
t_m_y_n: calls $0.60
*** FLOP *** [Js 6h 7d]
thedude696969: bets $0.90
t_m_y_n: raises $0.90 to $1.80
thedude696969: calls $0.90
*** TURN *** [Js 6h 7d] [As]
thedude696969: checks 
t_m_y_n: bets $1.20
thedude696969: calls $1.20
*** RIVER *** [Js 6h 7d As] [Ks]
thedude696969: checks 
t_m_y_n: checks 
*** SHOW DOWN ***
thedude696969: shows [8c 7c] (a pair of Sevens)
t_m_y_n: shows [8s Ac] (a pair of Aces)
t_m_y_n collected $7.31 from pot
*** SUMMARY ***
Total pot $7.65 | Rake $0.34 
Board [Js 6h 7d As Ks]
Seat 1: Tyoma_Kovach (small blind) folded before Flop
Seat 3: thedude696969 (big blind) showed [8c 7c] and lost with a pair of Sevens
Seat 4: fish72o folded before Flop (didn't bet)
Seat 5: t_m_y_n showed [8s Ac] and won ($7.31) with a pair of Aces
Seat 6: Notatur (button) folded before Flop (didn't bet)



PokerStars Hand #222946123456:  Hold'em No Limit ($0.05/$0.10 USD) - 2021/01/23 1:33:38 ET
Table 'Algieba III' 6-max Seat #1 is the button
Seat 1: Tyoma_Kovach ($16.08 in chips) 
Seat 3: thedude696969 ($14.51 in chips) 
Seat 4: fish72o ($10 in chips) 
Seat 5: t_m_y_n ($22.85 in chips) 
Seat 6: Notatur ($11.15 in chips) 
thedude696969: posts small blind $0.05
fish72o: posts big blind $0.10
*** HOLE CARDS ***
t_m_y_n: folds 
Notatur: folds 
Tyoma_Kovach: folds 
thedude696969: raises $0.20 to $0.30
fish72o: folds 
Uncalled bet ($0.20) returned to thedude696969
thedude696969 collected $0.20 from pot
thedude696969: doesn't show hand 
*** SUMMARY ***
Total pot $0.20 | Rake $0 
Seat 1: Tyoma_Kovach (button) folded before Flop (didn't bet)
Seat 3: thedude696969 (small blind) collected ($0.20)
Seat 4: fish72o (big blind) folded before Flop
Seat 5: t_m_y_n folded before Flop (didn't bet)
Seat 6: Notatur folded before Flop (didn't bet)



PokerStars Hand #222946126646:  Hold'em No Limit ($0.05/$0.10 USD) - 2021/01/23 1:33:51 ET
Table 'Algieba III' 6-max Seat #3 is the button
Seat 1: Tyoma_Kovach ($16.08 in chips) 
Seat 3: thedude696969 ($14.61 in chips) 
Seat 4: fish72o ($10 in chips) 
Seat 5: t_m_y_n ($22.85 in chips) 
Seat 6: Notatur ($11.15 in chips) 
fish72o: posts small blind $0.05
t_m_y_n: posts big blind $0.10
zebaztravez: sits out 
*** HOLE CARDS ***
Notatur: folds 
Tyoma_Kovach: raises $0.18 to $0.28
thedude696969: raises $0.82 to $1.10
fish72o: folds 
t_m_y_n: folds 
Tyoma_Kovach: calls $0.82
*** FLOP *** [9d Kh 3s]
Tyoma_Kovach: checks 
thedude696969: bets $1.30
Tyoma_Kovach: folds 
Uncalled bet ($1.30) returned to thedude696969
thedude696969 collected $2.24 from pot
thedude696969: doesn't show hand 
*** SUMMARY ***
Total pot $2.35 | Rake $0.11 
Board [9d Kh 3s]
Seat 1: Tyoma_Kovach folded on the Flop
Seat 3: thedude696969 (button) collected ($2.24)
Seat 4: fish72o (small blind) folded before Flop
Seat 5: t_m_y_n (big blind) folded before Flop
Seat 6: Notatur folded before Flop (didn't bet)



PokerStars Hand #222946133988:  Hold'em No Limit ($0.05/$0.10 USD) - 2021/01/23 1:34:22 ET
Table 'Algieba III' 6-max Seat #4 is the button
Seat 1: Tyoma_Kovach ($14.98 in chips) 
Seat 3: thedude696969 ($15.75 in chips) 
Seat 4: fish72o ($10 in chips) 
Seat 5: t_m_y_n ($22.75 in chips) 
t_m_y_n: posts small blind $0.05
Notatur: is sitting out 
Tyoma_Kovach: posts big blind $0.10
zebaztravez: sits out 
*** HOLE CARDS ***
thedude696969: folds 
fish72o: folds 
t_m_y_n: raises $0.10 to $0.20
Tyoma_Kovach: folds 
Uncalled bet ($0.10) returned to t_m_y_n
t_m_y_n collected $0.20 from pot
t_m_y_n: doesn't show hand 
*** SUMMARY ***
Total pot $0.20 | Rake $0 
Seat 1: Tyoma_Kovach (big blind) folded before Flop
Seat 3: thedude696969 folded before Flop (didn't bet)
Seat 4: fish72o (button) folded before Flop (didn't bet)
Seat 5: t_m_y_n (small blind) collected ($0.20)



PokerStars Hand #222946137055:  Hold'em No Limit ($0.05/$0.10 USD) - 2021/01/23 1:34:34 ET
Table 'Algieba III' 6-max Seat #5 is the button
Seat 1: Tyoma_Kovach ($14.88 in chips) 
Seat 2: zebaztravez ($10 in chips) 
Seat 3: thedude696969 ($15.75 in chips) 
Seat 4: fish72o ($10 in chips) 
Seat 5: t_m_y_n ($22.85 in chips) 
Tyoma_Kovach: posts small blind $0.05
zebaztravez: posts big blind $0.10
*** HOLE CARDS ***
thedude696969: folds 
fish72o: folds 
t_m_y_n: folds 
Tyoma_Kovach: folds 
Uncalled bet ($0.05) returned to zebaztravez
zebaztravez collected $0.10 from pot
zebaztravez: doesn't show hand 
*** SUMMARY ***
Total pot $0.10 | Rake $0 
Seat 1: Tyoma_Kovach (small blind) folded before Flop
Seat 2: zebaztravez (big blind) collected ($0.10)
Seat 3: thedude696969 folded before Flop (didn't bet)
Seat 4: fish72o folded before Flop (didn't bet)
Seat 5: t_m_y_n (button) folded before Flop (didn't bet)



PokerStars Hand #222946139219:  Hold'em No Limit ($0.05/$0.10 USD) - 2021/01/23 1:34:43 ET
Table 'Algieba III' 6-max Seat #1 is the button
Seat 1: Tyoma_Kovach ($14.83 in chips) 
Seat 2: zebaztravez ($10.05 in chips) 
Seat 3: thedude696969 ($15.75 in chips) 
Seat 4: fish72o ($10 in chips) 
Seat 5: t_m_y_n ($22.85 in chips) 
zebaztravez: posts small blind $0.05
thedude696969: posts big blind $0.10
*** HOLE CARDS ***
fish72o: folds 
t_m_y_n: folds 
Tyoma_Kovach: folds 
zebaztravez: raises $0.20 to $0.30
thedude696969: folds 
Uncalled bet ($0.20) returned to zebaztravez
zebaztravez collected $0.20 from pot
zebaztravez: doesn't show hand 
*** SUMMARY ***
Total pot $0.20 | Rake $0 
Seat 1: Tyoma_Kovach (button) folded before Flop (didn't bet)
Seat 2: zebaztravez (small blind) collected ($0.20)
Seat 3: thedude696969 (big blind) folded before Flop
Seat 4: fish72o folded before Flop (didn't bet)
Seat 5: t_m_y_n folded before Flop (didn't bet)



PokerStars Hand #222946145041:  Hold'em No Limit ($0.05/$0.10 USD) - 2021/01/23 1:35:08 ET
Table 'Algieba III' 6-max Seat #2 is the button
Seat 1: Tyoma_Kovach ($14.83 in chips) 
Seat 2: zebaztravez ($10.15 in chips) 
Seat 3: thedude696969 ($15.65 in chips) 
Seat 4: fish72o ($10 in chips) 
Seat 5: t_m_y_n ($22.85 in chips) 
thedude696969: posts small blind $0.05
fish72o: posts big blind $0.10
*** HOLE CARDS ***
t_m_y_n: raises $0.10 to $0.20
Tyoma_Kovach: folds 
zebaztravez: folds 
thedude696969: raises $0.60 to $0.80
fish72o: folds 
t_m_y_n: calls $0.60
*** FLOP *** [4s Qs 6h]
thedude696969: bets $1
t_m_y_n: calls $1
*** TURN *** [4s Qs 6h] [4d]
thedude696969: checks 
t_m_y_n: bets $1.26
thedude696969: raises $2.74 to $4
t_m_y_n: calls $2.74
*** RIVER *** [4s Qs 6h 4d] [Th]
thedude696969: checks 
t_m_y_n: checks 
*** SHOW DOWN ***
thedude696969: shows [7d 9d] (a pair of Fours)
t_m_y_n: shows [Kd Qd] (two pair, Queens and Fours)
t_m_y_n collected $11.17 from pot
*** SUMMARY ***
Total pot $11.70 | Rake $0.53 
Board [4s Qs 6h 4d Th]
Seat 1: Tyoma_Kovach folded before Flop (didn't bet)
Seat 2: zebaztravez (button) folded before Flop (didn't bet)
Seat 3: thedude696969 (small blind) showed [7d 9d] and lost with a pair of Fours
Seat 4: fish72o (big blind) folded before Flop
Seat 5: t_m_y_n showed [Kd Qd] and won ($11.17) with two pair, Queens and Fours



PokerStars Hand #222946160573:  Hold'em No Limit ($0.05/$0.10 USD) - 2021/01/23 1:36:13 ET
Table 'Algieba III' 6-max Seat #3 is the button
Seat 1: Tyoma_Kovach ($14.83 in chips) 
Seat 2: zebaztravez ($10.15 in chips) 
Seat 3: thedude696969 ($9.85 in chips) 
Seat 4: fish72o ($10 in chips) 
Seat 5: t_m_y_n ($28.22 in chips) 
fish72o: posts small blind $0.05
t_m_y_n: posts big blind $0.10
*** HOLE CARDS ***
Tyoma_Kovach: folds 
zebaztravez: raises $0.20 to $0.30
thedude696969: raises $0.75 to $1.05
fish72o: folds 
t_m_y_n: calls $0.95
zebaztravez: folds 
*** FLOP *** [2s 4h Tc]
t_m_y_n: bets $1.17
thedude696969: raises $7.63 to $8.80 and is all-in
t_m_y_n: calls $7.63
*** TURN *** [2s 4h Tc] [3s]
*** RIVER *** [2s 4h Tc 3s] [5h]
*** SHOW DOWN ***
t_m_y_n: shows [Td As] (a straight, Ace to Five)
thedude696969: shows [4s 9s] (a pair of Fours)
t_m_y_n collected $19.15 from pot
*** SUMMARY ***
Total pot $20.05 | Rake $0.90 
Board [2s 4h Tc 3s 5h]
Seat 1: Tyoma_Kovach folded before Flop (didn't bet)
Seat 2: zebaztravez folded before Flop
Seat 3: thedude696969 (button) showed [4s 9s] and lost with a pair of Fours
Seat 4: fish72o (small blind) folded before Flop
Seat 5: t_m_y_n (big blind) showed [Td As] and won ($19.15) with a straight, Ace to Five



PokerStars Hand #222946170847:  Hold'em No Limit ($0.05/$0.10 USD) - 2021/01/23 1:36:56 ET
Table 'Algieba III' 6-max Seat #4 is the button
Seat 1: Tyoma_Kovach ($14.83 in chips) 
Seat 2: zebaztravez ($10 in chips) 
Seat 4: fish72o ($10 in chips) 
Seat 5: t_m_y_n ($37.52 in chips) 
t_m_y_n: posts small blind $0.05
Tyoma_Kovach: posts big blind $0.10
*** HOLE CARDS ***
zebaztravez: folds 
fish72o: folds 
t_m_y_n: raises $0.10 to $0.20
Tyoma_Kovach: calls $0.10
*** FLOP *** [3h 8d 9s]
thedude696969 leaves the table
t_m_y_n: bets $0.19
Tyoma_Kovach: folds 
Uncalled bet ($0.19) returned to t_m_y_n
t_m_y_n collected $0.38 from pot
t_m_y_n: doesn't show hand 
*** SUMMARY ***
Total pot $0.40 | Rake $0.02 
Board [3h 8d 9s]
Seat 1: Tyoma_Kovach (big blind) folded on the Flop
Seat 2: zebaztravez folded before Flop (didn't bet)
Seat 4: fish72o (button) folded before Flop (didn't bet)
Seat 5: t_m_y_n (small blind) collected ($0.38)



PokerStars Hand #222946175155:  Hold'em No Limit ($0.05/$0.10 USD) - 2021/01/23 1:37:14 ET
Table 'Algieba III' 6-max Seat #5 is the button
Seat 1: Tyoma_Kovach ($14.63 in chips) 
Seat 2: zebaztravez ($10 in chips) 
Seat 4: fish72o ($10 in chips) 
Seat 5: t_m_y_n ($37.70 in chips) 
Tyoma_Kovach: posts small blind $0.05
zebaztravez: posts big blind $0.10
*** HOLE CARDS ***
fish72o: folds 
t_m_y_n: folds 
Tyoma_Kovach: raises $0.20 to $0.30
zebaztravez: calls $0.20
*** FLOP *** [4s Qh 7c]
Tyoma_Kovach: checks 
t_m_y_n leaves the table
zebaztravez: checks 
*** TURN *** [4s Qh 7c] [5d]
Tyoma_Kovach: checks 
zebaztravez: bets $0.30
Tyoma_Kovach: calls $0.30
*** RIVER *** [4s Qh 7c 5d] [9c]
Tyoma_Kovach: checks 
zebaztravez: checks 
*** SHOW DOWN ***
Tyoma_Kovach: shows [3d Ad] (high card Ace)
zebaztravez: shows [8d As] (high card Ace - Queen+Nine+Eight kicker)
zebaztravez collected $1.15 from pot
*** SUMMARY ***
Total pot $1.20 | Rake $0.05 
Board [4s Qh 7c 5d 9c]
Seat 1: Tyoma_Kovach (small blind) showed [3d Ad] and lost with high card Ace
Seat 2: zebaztravez (big blind) showed [8d As] and won ($1.15) with high card Ace
Seat 4: fish72o folded before Flop (didn't bet)
Seat 5: t_m_y_n (button) folded before Flop (didn't bet)



PokerStars Hand #222946187967:  Hold'em No Limit ($0.05/$0.10 USD) - 2021/01/23 1:38:08 ET
Table 'Algieba III' 6-max Seat #1 is the button
Seat 1: Tyoma_Kovach ($14.03 in chips) 
Seat 2: zebaztravez ($10.55 in chips) 
Seat 4: fish72o ($10 in chips) 
zebaztravez: posts small blind $0.05
fish72o: posts big blind $0.10
*** HOLE CARDS ***
Tyoma_Kovach: folds 
19_Ips_87 joins the table at seat #5 
loehc joins the table at seat #3 
zebaztravez: raises $0.20 to $0.30
fish72o: folds 
Uncalled bet ($0.20) returned to zebaztravez
zebaztravez collected $0.20 from pot
zebaztravez: doesn't show hand 
*** SUMMARY ***
Total pot $0.20 | Rake $0 
Seat 1: Tyoma_Kovach (button) folded before Flop (didn't bet)
Seat 2: zebaztravez (small blind) collected ($0.20)
Seat 4: fish72o (big blind) folded before Flop



PokerStars Hand #222946194344:  Hold'em No Limit ($0.05/$0.10 USD) - 2021/01/23 1:38:34 ET
Table 'Algieba III' 6-max Seat #2 is the button
Seat 1: Tyoma_Kovach ($14.03 in chips) 
Seat 2: zebaztravez ($10.65 in chips) 
Seat 4: fish72o ($10 in chips) 
Seat 5: 19_Ips_87 ($10 in chips) 
fish72o: posts small blind $0.05
19_Ips_87: posts big blind $0.10
*** HOLE CARDS ***
Tyoma_Kovach: raises $0.18 to $0.28
zebaztravez: folds 
fish72o: folds 
19_Ips_87: calls $0.18
*** FLOP *** [As Qs 4d]
19_Ips_87: checks 
Tyoma_Kovach: bets $0.19
19_Ips_87: calls $0.19
*** TURN *** [As Qs 4d] [5d]
19_Ips_87: checks 
Tyoma_Kovach: checks 
*** RIVER *** [As Qs 4d 5d] [5s]
19_Ips_87: bets $0.60
Tyoma_Kovach: folds 
Uncalled bet ($0.60) returned to 19_Ips_87
19_Ips_87 collected $0.95 from pot
19_Ips_87: doesn't show hand 
*** SUMMARY ***
Total pot $0.99 | Rake $0.04 
Board [As Qs 4d 5d 5s]
Seat 1: Tyoma_Kovach folded on the River
Seat 2: zebaztravez (button) folded before Flop (didn't bet)
Seat 4: fish72o (small blind) folded before Flop
Seat 5: 19_Ips_87 (big blind) collected ($0.95)



PokerStars Hand #222946205938:  Hold'em No Limit ($0.05/$0.10 USD) - 2021/01/23 1:39:23 ET
Table 'Algieba III' 6-max Seat #4 is the button
Seat 1: Tyoma_Kovach ($13.56 in chips) 
Seat 2: zebaztravez ($10.65 in chips) 
Seat 4: fish72o ($10 in chips) 
Seat 5: 19_Ips_87 ($10.48 in chips) 
19_Ips_87: posts small blind $0.05
Tyoma_Kovach: posts big blind $0.10
loehc: sits out 
*** HOLE CARDS ***
zebaztravez: raises $0.20 to $0.30
fish72o: folds 
19_Ips_87: folds 
Tyoma_Kovach: folds 
Uncalled bet ($0.20) returned to zebaztravez
zebaztravez collected $0.25 from pot
zebaztravez: doesn't show hand 
*** SUMMARY ***
Total pot $0.25 | Rake $0 
Seat 1: Tyoma_Kovach (big blind) folded before Flop
Seat 2: zebaztravez collected ($0.25)
Seat 4: fish72o (button) folded before Flop (didn't bet)
Seat 5: 19_Ips_87 (small blind) folded before Flop



PokerStars Hand #222946209146:  Hold'em No Limit ($0.05/$0.10 USD) - 2021/01/23 1:39:36 ET
Table 'Algieba III' 6-max Seat #5 is the button
Seat 1: Tyoma_Kovach ($13.46 in chips) 
Seat 2: zebaztravez ($10.80 in chips) 
Seat 4: fish72o ($10 in chips) 
Seat 5: 19_Ips_87 ($10.43 in chips) 
Tyoma_Kovach: posts small blind $0.05
zebaztravez: posts big blind $0.10
loehc: sits out 
*** HOLE CARDS ***
fish72o: folds 
19_Ips_87: folds 
Tyoma_Kovach: raises $0.20 to $0.30
zebaztravez: calls $0.20
*** FLOP *** [4h 3d Th]
Tyoma_Kovach: checks 
zebaztravez: checks 
*** TURN *** [4h 3d Th] [Ts]
Tyoma_Kovach: checks 
zebaztravez: checks 
*** RIVER *** [4h 3d Th Ts] [5d]
Tyoma_Kovach: checks 
zebaztravez: bets $0.43
Tyoma_Kovach: folds 
Uncalled bet ($0.43) returned to zebaztravez
zebaztravez collected $0.57 from pot
zebaztravez: doesn't show hand 
*** SUMMARY ***
Total pot $0.60 | Rake $0.03 
Board [4h 3d Th Ts 5d]
Seat 1: Tyoma_Kovach (small blind) folded on the River
Seat 2: zebaztravez (big blind) collected ($0.57)
Seat 4: fish72o folded before Flop (didn't bet)
Seat 5: 19_Ips_87 (button) folded before Flop (didn't bet)



PokerStars Hand #222946219959:  Hold'em No Limit ($0.05/$0.10 USD) - 2021/01/23 1:40:22 ET
Table 'Algieba III' 6-max Seat #1 is the button
Seat 1: Tyoma_Kovach ($13.16 in chips) 
Seat 2: zebaztravez ($11.07 in chips) 
Seat 3: loehc ($10 in chips) 
Seat 4: fish72o ($10 in chips) 
Seat 5: 19_Ips_87 ($10.43 in chips) 
zebaztravez: posts small blind $0.05
loehc: posts big blind $0.10
Notatur: sits out 
*** HOLE CARDS ***
fish72o: folds 
19_Ips_87: raises $0.20 to $0.30
Tyoma_Kovach: folds 
zebaztravez: calls $0.25
loehc: calls $0.20
*** FLOP *** [9d 6h 5c]
zebaztravez: checks 
loehc: checks 
19_Ips_87: checks 
*** TURN *** [9d 6h 5c] [3s]
zebaztravez: bets $0.65
loehc: folds 
19_Ips_87: folds 
Uncalled bet ($0.65) returned to zebaztravez
zebaztravez collected $0.86 from pot
zebaztravez: doesn't show hand 
*** SUMMARY ***
Total pot $0.90 | Rake $0.04 
Board [9d 6h 5c 3s]
Seat 1: Tyoma_Kovach (button) folded before Flop (didn't bet)
Seat 2: zebaztravez (small blind) collected ($0.86)
Seat 3: loehc (big blind) folded on the Turn
Seat 4: fish72o folded before Flop (didn't bet)
Seat 5: 19_Ips_87 folded on the Turn



PokerStars Hand #222946231214:  Hold'em No Limit ($0.05/$0.10 USD) - 2021/01/23 1:41:09 ET
Table 'Algieba III' 6-max Seat #2 is the button
Seat 1: Tyoma_Kovach ($13.16 in chips) 
Seat 2: zebaztravez ($11.63 in chips) 
Seat 3: loehc ($9.70 in chips) 
Seat 4: fish72o ($10 in chips) 
Seat 5: 19_Ips_87 ($10.13 in chips) 
loehc: posts small blind $0.05
fish72o: posts big blind $0.10
Notatur: sits out 
*** HOLE CARDS ***
19_Ips_87: folds 
Tyoma_Kovach: folds 
zebaztravez: raises $0.16 to $0.26
loehc: folds 
fish72o: calls $0.16
*** FLOP *** [Td Jd 9s]
fish72o: checks 
zebaztravez: bets $0.20
fish72o: folds 
Uncalled bet ($0.20) returned to zebaztravez
zebaztravez collected $0.54 from pot
zebaztravez: doesn't show hand 
*** SUMMARY ***
Total pot $0.57 | Rake $0.03 
Board [Td Jd 9s]
Seat 1: Tyoma_Kovach folded before Flop (didn't bet)
Seat 2: zebaztravez (button) collected ($0.54)
Seat 3: loehc (small blind) folded before Flop
Seat 4: fish72o (big blind) folded on the Flop
Seat 5: 19_Ips_87 folded before Flop (didn't bet)



PokerStars Hand #222946240669:  Hold'em No Limit ($0.05/$0.10 USD) - 2021/01/23 1:41:49 ET
Table 'Algieba III' 6-max Seat #3 is the button
Seat 1: Tyoma_Kovach ($13.16 in chips) 
Seat 2: zebaztravez ($11.91 in chips) 
Seat 3: loehc ($9.65 in chips) 
Seat 4: fish72o ($10 in chips) 
Seat 5: 19_Ips_87 ($10.13 in chips) 
fish72o: posts small blind $0.05
19_Ips_87: posts big blind $0.10
Notatur: sits out 
*** HOLE CARDS ***
Tyoma_Kovach: folds 
zebaztravez: raises $0.20 to $0.30
loehc: folds 
fish72o: folds 
19_Ips_87: folds 
Uncalled bet ($0.20) returned to zebaztravez
zebaztravez collected $0.25 from pot
zebaztravez: doesn't show hand 
*** SUMMARY ***
Total pot $0.25 | Rake $0 
Seat 1: Tyoma_Kovach folded before Flop (didn't bet)
Seat 2: zebaztravez collected ($0.25)
Seat 3: loehc (button) folded before Flop (didn't bet)
Seat 4: fish72o (small blind) folded before Flop
Seat 5: 19_Ips_87 (big blind) folded before Flop



PokerStars Hand #222946243420:  Hold'em No Limit ($0.05/$0.10 USD) - 2021/01/23 1:42:00 ET
Table 'Algieba III' 6-max Seat #4 is the button
Seat 1: Tyoma_Kovach ($13.16 in chips) 
Seat 2: zebaztravez ($12.06 in chips) 
Seat 3: loehc ($9.65 in chips) 
Seat 4: fish72o ($10 in chips) 
Seat 5: 19_Ips_87 ($10.03 in chips) 
Seat 6: Notatur ($11.15 in chips) 
19_Ips_87: posts small blind $0.05
Notatur: posts big blind $0.10
*** HOLE CARDS ***
Tyoma_Kovach: folds 
zebaztravez: folds 
loehc: folds 
fish72o: raises $0.15 to $0.25
19_Ips_87: folds 
Notatur: folds 
Uncalled bet ($0.15) returned to fish72o
fish72o collected $0.25 from pot
fish72o: doesn't show hand 
*** SUMMARY ***
Total pot $0.25 | Rake $0 
Seat 1: Tyoma_Kovach folded before Flop (didn't bet)
Seat 2: zebaztravez folded before Flop (didn't bet)
Seat 3: loehc folded before Flop (didn't bet)
Seat 4: fish72o (button) collected ($0.25)
Seat 5: 19_Ips_87 (small blind) folded before Flop
Seat 6: Notatur (big blind) folded before Flop



PokerStars Hand #222946248039:  Hold'em No Limit ($0.05/$0.10 USD) - 2021/01/23 1:42:20 ET
Table 'Algieba III' 6-max Seat #5 is the button
Seat 1: Tyoma_Kovach ($13.16 in chips) 
Seat 2: zebaztravez ($12.06 in chips) 
Seat 3: loehc ($9.65 in chips) 
Seat 4: fish72o ($10.15 in chips) 
Seat 5: 19_Ips_87 ($9.98 in chips) 
Seat 6: Notatur ($11.05 in chips) 
Notatur: posts small blind $0.05
Tyoma_Kovach: posts big blind $0.10
*** HOLE CARDS ***
zebaztravez: folds 
loehc: folds 
fish72o: folds 
19_Ips_87: folds 
Notatur: folds 
Uncalled bet ($0.05) returned to Tyoma_Kovach
Tyoma_Kovach collected $0.10 from pot
Tyoma_Kovach: doesn't show hand 
*** SUMMARY ***
Total pot $0.10 | Rake $0 
Seat 1: Tyoma_Kovach (big blind) collected ($0.10)
Seat 2: zebaztravez folded before Flop (didn't bet)
Seat 3: loehc folded before Flop (didn't bet)
Seat 4: fish72o folded before Flop (didn't bet)
Seat 5: 19_Ips_87 (button) folded before Flop (didn't bet)
Seat 6: Notatur (small blind) folded before Flop



PokerStars Hand #222946250186:  Hold'em No Limit ($0.05/$0.10 USD) - 2021/01/23 1:42:29 ET
Table 'Algieba III' 6-max Seat #6 is the button
Seat 1: Tyoma_Kovach ($13.21 in chips) 
Seat 2: zebaztravez ($12.06 in chips) 
Seat 3: loehc ($9.65 in chips) 
Seat 4: fish72o ($10.15 in chips) 
Seat 6: Notatur ($11 in chips) 
Tyoma_Kovach: posts small blind $0.05
zebaztravez: posts big blind $0.10
*** HOLE CARDS ***
loehc: folds 
fish72o: raises $0.15 to $0.25
Notatur: folds 
Tyoma_Kovach: folds 
zebaztravez: calls $0.15
*** FLOP *** [9c Jc 6h]
19_Ips_87 is disconnected 
zebaztravez: checks 
fish72o: bets $0.17
zebaztravez: folds 
Uncalled bet ($0.17) returned to fish72o
fish72o collected $0.53 from pot
fish72o: doesn't show hand 
*** SUMMARY ***
Total pot $0.55 | Rake $0.02 
Board [9c Jc 6h]
Seat 1: Tyoma_Kovach (small blind) folded before Flop
Seat 2: zebaztravez (big blind) folded on the Flop
Seat 3: loehc folded before Flop (didn't bet)
Seat 4: fish72o collected ($0.53)
Seat 6: Notatur (button) folded before Flop (didn't bet)



PokerStars Hand #222946261060:  Hold'em No Limit ($0.05/$0.10 USD) - 2021/01/23 1:43:15 ET
Table 'Algieba III' 6-max Seat #1 is the button
Seat 1: Tyoma_Kovach ($13.16 in chips) 
Seat 2: zebaztravez ($11.81 in chips) 
Seat 3: loehc ($9.65 in chips) 
Seat 4: fish72o ($10.43 in chips) 
Seat 6: Notatur ($11 in chips) 
zebaztravez: posts small blind $0.05
loehc: posts big blind $0.10
*** HOLE CARDS ***
fish72o: folds 
Notatur: raises $0.15 to $0.25
Tyoma_Kovach: folds 
zebaztravez: folds 
loehc: folds 
Uncalled bet ($0.15) returned to Notatur
Notatur collected $0.25 from pot
Notatur: doesn't show hand 
*** SUMMARY ***
Total pot $0.25 | Rake $0 
Seat 1: Tyoma_Kovach (button) folded before Flop (didn't bet)
Seat 2: zebaztravez (small blind) folded before Flop
Seat 3: loehc (big blind) folded before Flop
Seat 4: fish72o folded before Flop (didn't bet)
Seat 6: Notatur collected ($0.25)



PokerStars Hand #222946263655:  Hold'em No Limit ($0.05/$0.10 USD) - 2021/01/23 1:43:26 ET
Table 'Algieba III' 6-max Seat #2 is the button
Seat 1: Tyoma_Kovach ($13.16 in chips) 
Seat 2: zebaztravez ($11.76 in chips) 
Seat 3: loehc ($9.55 in chips) 
Seat 4: fish72o ($10.43 in chips) 
Seat 6: Notatur ($11.15 in chips) 
loehc: posts small blind $0.05
fish72o: posts big blind $0.10
*** HOLE CARDS ***
Notatur: folds 
Tyoma_Kovach: folds 
zebaztravez: folds 
loehc: raises $0.17 to $0.27
fish72o: folds 
Uncalled bet ($0.17) returned to loehc
loehc collected $0.20 from pot
loehc: doesn't show hand 
*** SUMMARY ***
Total pot $0.20 | Rake $0 
Seat 1: Tyoma_Kovach folded before Flop (didn't bet)
Seat 2: zebaztravez (button) folded before Flop (didn't bet)
Seat 3: loehc (small blind) collected ($0.20)
Seat 4: fish72o (big blind) folded before Flop
Seat 6: Notatur folded before Flop (didn't bet)



PokerStars Hand #222946267136:  Hold'em No Limit ($0.05/$0.10 USD) - 2021/01/23 1:43:40 ET
Table 'Algieba III' 6-max Seat #3 is the button
Seat 1: Tyoma_Kovach ($13.16 in chips) 
Seat 2: zebaztravez ($11.76 in chips) 
Seat 3: loehc ($9.65 in chips) 
Seat 4: fish72o ($10.33 in chips) 
Seat 6: Notatur ($11.15 in chips) 
fish72o: posts small blind $0.05
Notatur: posts big blind $0.10
*** HOLE CARDS ***
Tyoma_Kovach: folds 
zebaztravez: folds 
loehc: raises $0.13 to $0.23
fish72o: folds 
Notatur: folds 
Uncalled bet ($0.13) returned to loehc
loehc collected $0.25 from pot
loehc: doesn't show hand 
*** SUMMARY ***
Total pot $0.25 | Rake $0 
Seat 1: Tyoma_Kovach folded before Flop (didn't bet)
Seat 2: zebaztravez folded before Flop (didn't bet)
Seat 3: loehc (button) collected ($0.25)
Seat 4: fish72o (small blind) folded before Flop
Seat 6: Notatur (big blind) folded before Flop



PokerStars Hand #222946272643:  Hold'em No Limit ($0.05/$0.10 USD) - 2021/01/23 1:44:04 ET
Table 'Algieba III' 6-max Seat #4 is the button
Seat 1: Tyoma_Kovach ($13.16 in chips) 
Seat 2: zebaztravez ($11.76 in chips) 
Seat 3: loehc ($9.80 in chips) 
Seat 4: fish72o ($10.28 in chips) 
Seat 6: Notatur ($11.05 in chips) 
Notatur: posts small blind $0.05
Tyoma_Kovach: posts big blind $0.10
*** HOLE CARDS ***
zebaztravez: folds 
loehc: folds 
fish72o: folds 
Notatur: folds 
Uncalled bet ($0.05) returned to Tyoma_Kovach
Tyoma_Kovach collected $0.10 from pot
Tyoma_Kovach: doesn't show hand 
*** SUMMARY ***
Total pot $0.10 | Rake $0 
Seat 1: Tyoma_Kovach (big blind) collected ($0.10)
Seat 2: zebaztravez folded before Flop (didn't bet)
Seat 3: loehc folded before Flop (didn't bet)
Seat 4: fish72o (button) folded before Flop (didn't bet)
Seat 6: Notatur (small blind) folded before Flop



PokerStars Hand #222946275101:  Hold'em No Limit ($0.05/$0.10 USD) - 2021/01/23 1:44:14 ET
Table 'Algieba III' 6-max Seat #6 is the button
Seat 1: Tyoma_Kovach ($13.21 in chips) 
Seat 2: zebaztravez ($11.76 in chips) 
Seat 3: loehc ($9.80 in chips) 
Seat 4: fish72o ($10.28 in chips) 
Seat 6: Notatur ($11 in chips) 
Tyoma_Kovach: posts small blind $0.05
zebaztravez: posts big blind $0.10
19_Ips_87: sits out 
*** HOLE CARDS ***
loehc: folds 
fish72o: folds 
Notatur: raises $0.15 to $0.25
Tyoma_Kovach: raises $0.75 to $1
zebaztravez: folds 
Notatur: folds 
Uncalled bet ($0.75) returned to Tyoma_Kovach
Tyoma_Kovach collected $0.60 from pot
Tyoma_Kovach: doesn't show hand 
*** SUMMARY ***
Total pot $0.60 | Rake $0 
Seat 1: Tyoma_Kovach (small blind) collected ($0.60)
Seat 2: zebaztravez (big blind) folded before Flop
Seat 3: loehc folded before Flop (didn't bet)
Seat 4: fish72o folded before Flop (didn't bet)
Seat 6: Notatur (button) folded before Flop



PokerStars Hand #222946282412:  Hold'em No Limit ($0.05/$0.10 USD) - 2021/01/23 1:44:45 ET
Table 'Algieba III' 6-max Seat #1 is the button
Seat 1: Tyoma_Kovach ($13.56 in chips) 
Seat 2: zebaztravez ($11.66 in chips) 
Seat 3: loehc ($9.80 in chips) 
Seat 4: fish72o ($10.28 in chips) 
Seat 5: 19_Ips_87 ($10 in chips) 
Seat 6: Notatur ($10.75 in chips) 
zebaztravez: posts small blind $0.05
loehc: posts big blind $0.10
19_Ips_87: posts small & big blinds $0.15
*** HOLE CARDS ***
fish72o: folds 
19_Ips_87: checks 
Notatur: folds 
Tyoma_Kovach: folds 
zebaztravez: folds 
loehc: checks 
*** FLOP *** [5d Kh 7d]
loehc: bets $0.10
19_Ips_87: folds 
Uncalled bet ($0.10) returned to loehc
loehc collected $0.29 from pot
loehc: doesn't show hand 
*** SUMMARY ***
Total pot $0.30 | Rake $0.01 
Board [5d Kh 7d]
Seat 1: Tyoma_Kovach (button) folded before Flop (didn't bet)
Seat 2: zebaztravez (small blind) folded before Flop
Seat 3: loehc (big blind) collected ($0.29)
Seat 4: fish72o folded before Flop (didn't bet)
Seat 5: 19_Ips_87 folded on the Flop (didn't bet)
Seat 6: Notatur folded before Flop (didn't bet)



PokerStars Hand #222946290950:  Hold'em No Limit ($0.05/$0.10 USD) - 2021/01/23 1:45:21 ET
Table 'Algieba III' 6-max Seat #2 is the button
Seat 1: Tyoma_Kovach ($13.56 in chips) 
Seat 2: zebaztravez ($11.61 in chips) 
Seat 3: loehc ($9.99 in chips) 
Seat 4: fish72o ($10.28 in chips) 
Seat 5: 19_Ips_87 ($9.85 in chips) 
Seat 6: Notatur ($10.75 in chips) 
loehc: posts small blind $0.05
fish72o: posts big blind $0.10
*** HOLE CARDS ***
19_Ips_87: folds 
Notatur: folds 
Tyoma_Kovach: folds 
zebaztravez: raises $0.16 to $0.26
loehc: calls $0.21
fish72o: folds 
*** FLOP *** [2s Ks Ac]
loehc: bets $0.19
zebaztravez: folds 
Uncalled bet ($0.19) returned to loehc
loehc collected $0.59 from pot
loehc: doesn't show hand 
*** SUMMARY ***
Total pot $0.62 | Rake $0.03 
Board [2s Ks Ac]
Seat 1: Tyoma_Kovach folded before Flop (didn't bet)
Seat 2: zebaztravez (button) folded on the Flop
Seat 3: loehc (small blind) collected ($0.59)
Seat 4: fish72o (big blind) folded before Flop
Seat 5: 19_Ips_87 folded before Flop (didn't bet)
Seat 6: Notatur folded before Flop (didn't bet)



PokerStars Hand #222946296010:  Hold'em No Limit ($0.05/$0.10 USD) - 2021/01/23 1:45:43 ET
Table 'Algieba III' 6-max Seat #3 is the button
Seat 1: Tyoma_Kovach ($13.56 in chips) 
Seat 2: zebaztravez ($11.35 in chips) 
Seat 3: loehc ($10.32 in chips) 
Seat 4: fish72o ($10.18 in chips) 
Seat 5: 19_Ips_87 ($9.85 in chips) 
Seat 6: Notatur ($10.75 in chips) 
fish72o: posts small blind $0.05
19_Ips_87: posts big blind $0.10
*** HOLE CARDS ***
Notatur: folds 
Tyoma_Kovach: folds 
zebaztravez: folds 
loehc: raises $0.13 to $0.23
fish72o: folds 
19_Ips_87: folds 
Uncalled bet ($0.13) returned to loehc
loehc collected $0.25 from pot
loehc: doesn't show hand 
*** SUMMARY ***
Total pot $0.25 | Rake $0 
Seat 1: Tyoma_Kovach folded before Flop (didn't bet)
Seat 2: zebaztravez folded before Flop (didn't bet)
Seat 3: loehc (button) collected ($0.25)
Seat 4: fish72o (small blind) folded before Flop
Seat 5: 19_Ips_87 (big blind) folded before Flop
Seat 6: Notatur folded before Flop (didn't bet)



PokerStars Hand #222946299842:  Hold'em No Limit ($0.05/$0.10 USD) - 2021/01/23 1:45:59 ET
Table 'Algieba III' 6-max Seat #4 is the button
Seat 1: Tyoma_Kovach ($13.56 in chips) 
Seat 2: zebaztravez ($11.35 in chips) 
Seat 3: loehc ($10.47 in chips) 
Seat 4: fish72o ($10.13 in chips) 
Seat 5: 19_Ips_87 ($9.75 in chips) 
Seat 6: Notatur ($10.75 in chips) 
19_Ips_87: posts small blind $0.05
Notatur: posts big blind $0.10
*** HOLE CARDS ***
Tyoma_Kovach: folds 
zebaztravez: folds 
loehc: folds 
fish72o: raises $0.15 to $0.25
19_Ips_87: calls $0.20
Notatur: folds 
*** FLOP *** [7s Jd Th]
19_Ips_87: checks 
fish72o: checks 
*** TURN *** [7s Jd Th] [7c]
19_Ips_87: checks 
fish72o: checks 
*** RIVER *** [7s Jd Th 7c] [9c]
19_Ips_87: bets $0.29
fish72o: folds 
Uncalled bet ($0.29) returned to 19_Ips_87
19_Ips_87 collected $0.57 from pot
19_Ips_87: doesn't show hand 
*** SUMMARY ***
Total pot $0.60 | Rake $0.03 
Board [7s Jd Th 7c 9c]
Seat 1: Tyoma_Kovach folded before Flop (didn't bet)
Seat 2: zebaztravez folded before Flop (didn't bet)
Seat 3: loehc folded before Flop (didn't bet)
Seat 4: fish72o (button) folded on the River
Seat 5: 19_Ips_87 (small blind) collected ($0.57)
Seat 6: Notatur (big blind) folded before Flop



PokerStars Hand #222946310068:  Hold'em No Limit ($0.05/$0.10 USD) - 2021/01/23 1:46:43 ET
Table 'Algieba III' 6-max Seat #5 is the button
Seat 1: Tyoma_Kovach ($13.56 in chips) 
Seat 2: zebaztravez ($11.35 in chips) 
Seat 3: loehc ($10.47 in chips) 
Seat 4: fish72o ($10 in chips) 
Seat 5: 19_Ips_87 ($10.07 in chips) 
Seat 6: Notatur ($10.65 in chips) 
Notatur: posts small blind $0.05
Tyoma_Kovach: posts big blind $0.10
*** HOLE CARDS ***
zebaztravez: raises $0.20 to $0.30
loehc: folds 
fish72o: folds 
19_Ips_87: folds 
Notatur: folds 
Tyoma_Kovach: folds 
Uncalled bet ($0.20) returned to zebaztravez
zebaztravez collected $0.25 from pot
zebaztravez: doesn't show hand 
*** SUMMARY ***
Total pot $0.25 | Rake $0 
Seat 1: Tyoma_Kovach (big blind) folded before Flop
Seat 2: zebaztravez collected ($0.25)
Seat 3: loehc folded before Flop (didn't bet)
Seat 4: fish72o folded before Flop (didn't bet)
Seat 5: 19_Ips_87 (button) folded before Flop (didn't bet)
Seat 6: Notatur (small blind) folded before Flop



PokerStars Hand #222946314373:  Hold'em No Limit ($0.05/$0.10 USD) - 2021/01/23 1:47:01 ET
Table 'Algieba III' 6-max Seat #6 is the button
Seat 1: Tyoma_Kovach ($13.46 in chips) 
Seat 2: zebaztravez ($11.50 in chips) 
Seat 3: loehc ($10.47 in chips) 
Seat 4: fish72o ($10 in chips) 
Seat 5: 19_Ips_87 ($10.07 in chips) 
Seat 6: Notatur ($10.60 in chips) 
Tyoma_Kovach: posts small blind $0.05
zebaztravez: posts big blind $0.10
*** HOLE CARDS ***
loehc: raises $0.20 to $0.30
fish72o: folds 
19_Ips_87: calls $0.30
Notatur: folds 
Tyoma_Kovach: folds 
zebaztravez: folds 
*** FLOP *** [8h Tc 2s]
loehc: bets $0.24
19_Ips_87: calls $0.24
*** TURN *** [8h Tc 2s] [Ac]
loehc: bets $0.39
19_Ips_87: folds 
Uncalled bet ($0.39) returned to loehc
loehc collected $1.17 from pot
loehc: doesn't show hand 
*** SUMMARY ***
Total pot $1.23 | Rake $0.06 
Board [8h Tc 2s Ac]
Seat 1: Tyoma_Kovach (small blind) folded before Flop
Seat 2: zebaztravez (big blind) folded before Flop
Seat 3: loehc collected ($1.17)
Seat 4: fish72o folded before Flop (didn't bet)
Seat 5: 19_Ips_87 folded on the Turn
Seat 6: Notatur (button) folded before Flop (didn't bet)



PokerStars Hand #222945301700:  Hold'em No Limit ($0.05/$0.10 USD) - 2021/01/23 0:39:30 ET
Table 'Algieba III' 6-max Seat #5 is the button
Seat 1: Tyoma_Kovach ($11.62 in chips) 
Seat 2: sixcoins ($6.84 in chips) 
Seat 3: thedude696969 ($24.87 in chips) 
Seat 4: fish72o ($12.56 in chips) 
Seat 5: johnnytrue ($14.73 in chips) 
Seat 6: Deniels7 ($13.64 in chips) 
Deniels7: posts small blind $0.05
Tyoma_Kovach: posts big blind $0.10
*** HOLE CARDS ***
sixcoins: folds 
thedude696969: raises $0.20 to $0.30
fish72o: folds 
johnnytrue: calls $0.30
Deniels7: raises $0.30 to $0.60
Tyoma_Kovach: folds 
thedude696969: calls $0.30
johnnytrue: calls $0.30
*** FLOP *** [7s 3h 4d]
Deniels7: bets $0.50
thedude696969: raises $0.90 to $1.40
johnnytrue: folds 
Deniels7: calls $0.90
*** TURN *** [7s 3h 4d] [7h]
Deniels7: checks 
thedude696969: bets $2.60
Deniels7: calls $2.60
*** RIVER *** [7s 3h 4d 7h] [4c]
Deniels7: checks 
thedude696969: bets $5.40
Deniels7: calls $5.40
*** SHOW DOWN ***
thedude696969: shows [Ah 8h] (two pair, Sevens and Fours)
Deniels7: shows [Ac Jc] (two pair, Sevens and Fours)
Deniels7 collected $9.89 from pot
thedude696969 collected $9.88 from pot
*** SUMMARY ***
Total pot $20.70 | Rake $0.93 
Board [7s 3h 4d 7h 4c]
Seat 1: Tyoma_Kovach (big blind) folded before Flop
Seat 2: sixcoins folded before Flop (didn't bet)
Seat 3: thedude696969 showed [Ah 8h] and won ($9.88) with two pair, Sevens and Fours
Seat 4: fish72o folded before Flop (didn't bet)
Seat 5: johnnytrue (button) folded on the Flop
Seat 6: Deniels7 (small blind) showed [Ac Jc] and won ($9.89) with two pair, Sevens and Fours



PokerStars Hand #222945325198:  Hold'em No Limit ($0.05/$0.10 USD) - 2021/01/23 0:40:59 ET
Table 'Algieba III' 6-max Seat #6 is the button
Seat 1: Tyoma_Kovach ($11.52 in chips) 
Seat 2: sixcoins ($6.84 in chips) 
Seat 3: thedude696969 ($24.75 in chips) 
Seat 4: fish72o ($12.56 in chips) 
Seat 5: johnnytrue ($14.13 in chips) 
Seat 6: Deniels7 ($13.53 in chips) 
Tyoma_Kovach: posts small blind $0.05
sixcoins: posts big blind $0.10
*** HOLE CARDS ***
thedude696969: folds 
fish72o: folds 
johnnytrue: folds 
Deniels7: calls $0.10
Tyoma_Kovach: raises $0.40 to $0.50
sixcoins: folds 
Deniels7: calls $0.40
*** FLOP *** [Qd 4d Qc]
Tyoma_Kovach: checks 
Deniels7: bets $0.50
Tyoma_Kovach: calls $0.50
*** TURN *** [Qd 4d Qc] [9s]
Tyoma_Kovach: checks 
Deniels7: bets $1.10
Tyoma_Kovach: folds 
Uncalled bet ($1.10) returned to Deniels7
Deniels7 collected $2.01 from pot
Deniels7: doesn't show hand 
*** SUMMARY ***
Total pot $2.10 | Rake $0.09 
Board [Qd 4d Qc 9s]
Seat 1: Tyoma_Kovach (small blind) folded on the Turn
Seat 2: sixcoins (big blind) folded before Flop
Seat 3: thedude696969 folded before Flop (didn't bet)
Seat 4: fish72o folded before Flop (didn't bet)
Seat 5: johnnytrue folded before Flop (didn't bet)
Seat 6: Deniels7 (button) collected ($2.01)



PokerStars Hand #222945336544:  Hold'em No Limit ($0.05/$0.10 USD) - 2021/01/23 0:41:42 ET
Table 'Algieba III' 6-max Seat #1 is the button
Seat 1: Tyoma_Kovach ($10.52 in chips) 
Seat 2: sixcoins ($6.74 in chips) 
Seat 3: thedude696969 ($24.75 in chips) 
Seat 4: fish72o ($12.56 in chips) 
Seat 5: johnnytrue ($14.13 in chips) 
Seat 6: Deniels7 ($14.54 in chips) 
sixcoins: posts small blind $0.05
thedude696969: posts big blind $0.10
*** HOLE CARDS ***
fish72o: folds 
johnnytrue: folds 
Deniels7: calls $0.10
Tyoma_Kovach: folds 
sixcoins: calls $0.05
thedude696969: checks 
*** FLOP *** [2h 9c Ad]
sixcoins: checks 
thedude696969: checks 
Deniels7: checks 
*** TURN *** [2h 9c Ad] [3h]
sixcoins: checks 
thedude696969: checks 
Deniels7: checks 
*** RIVER *** [2h 9c Ad 3h] [Jc]
sixcoins: checks 
thedude696969: bets $0.17
Deniels7: folds 
sixcoins: folds 
Uncalled bet ($0.17) returned to thedude696969
thedude696969 collected $0.29 from pot
thedude696969: doesn't show hand 
*** SUMMARY ***
Total pot $0.30 | Rake $0.01 
Board [2h 9c Ad 3h Jc]
Seat 1: Tyoma_Kovach (button) folded before Flop (didn't bet)
Seat 2: sixcoins (small blind) folded on the River
Seat 3: thedude696969 (big blind) collected ($0.29)
Seat 4: fish72o folded before Flop (didn't bet)
Seat 5: johnnytrue folded before Flop (didn't bet)
Seat 6: Deniels7 folded on the River



PokerStars Hand #222945348430:  Hold'em No Limit ($0.05/$0.10 USD) - 2021/01/23 0:42:27 ET
Table 'Algieba III' 6-max Seat #2 is the button
Seat 1: Tyoma_Kovach ($10.52 in chips) 
Seat 2: sixcoins ($6.64 in chips) 
Seat 3: thedude696969 ($24.94 in chips) 
Seat 4: fish72o ($12.56 in chips) 
Seat 5: johnnytrue ($14.13 in chips) 
Seat 6: Deniels7 ($14.44 in chips) 
thedude696969: posts small blind $0.05
fish72o: posts big blind $0.10
*** HOLE CARDS ***
johnnytrue: folds 
Deniels7: raises $0.20 to $0.30
Tyoma_Kovach: folds 
sixcoins: folds 
thedude696969: raises $1.10 to $1.40
fish72o: folds 
Deniels7: calls $1.10
*** FLOP *** [Tc Ts 6s]
thedude696969: bets $1.70
Deniels7: calls $1.70
*** TURN *** [Tc Ts 6s] [5s]
thedude696969: bets $5.90
Deniels7: raises $5.44 to $11.34 and is all-in
thedude696969: calls $5.44
*** RIVER *** [Tc Ts 6s 5s] [As]
*** SHOW DOWN ***
thedude696969: shows [Jc Js] (a flush, Ace high)
Deniels7: shows [Ah 5h] (two pair, Aces and Tens)
thedude696969 collected $27.68 from pot
*** SUMMARY ***
Total pot $28.98 | Rake $1.30 
Board [Tc Ts 6s 5s As]
Seat 1: Tyoma_Kovach folded before Flop (didn't bet)
Seat 2: sixcoins (button) folded before Flop (didn't bet)
Seat 3: thedude696969 (small blind) showed [Jc Js] and won ($27.68) with a flush, Ace high
Seat 4: fish72o (big blind) folded before Flop
Seat 5: johnnytrue folded before Flop (didn't bet)
Seat 6: Deniels7 showed [Ah 5h] and lost with two pair, Aces and Tens



PokerStars Hand #222945363948:  Hold'em No Limit ($0.05/$0.10 USD) - 2021/01/23 0:43:13 ET
Table 'Algieba III' 6-max Seat #3 is the button
Seat 1: Tyoma_Kovach ($10.52 in chips) 
Seat 2: sixcoins ($6.64 in chips) 
Seat 3: thedude696969 ($38.18 in chips) 
Seat 4: fish72o ($12.46 in chips) 
Seat 5: johnnytrue ($14.13 in chips) 
fish72o: posts small blind $0.05
johnnytrue: posts big blind $0.10
*** HOLE CARDS ***
Tyoma_Kovach: folds 
sixcoins: raises $0.20 to $0.30
thedude696969: folds 
fish72o: folds 
johnnytrue: folds 
Uncalled bet ($0.20) returned to sixcoins
sixcoins collected $0.25 from pot
sixcoins: doesn't show hand 
*** SUMMARY ***
Total pot $0.25 | Rake $0 
Seat 1: Tyoma_Kovach folded before Flop (didn't bet)
Seat 2: sixcoins collected ($0.25)
Seat 3: thedude696969 (button) folded before Flop (didn't bet)
Seat 4: fish72o (small blind) folded before Flop
Seat 5: johnnytrue (big blind) folded before Flop



PokerStars Hand #222945368176:  Hold'em No Limit ($0.05/$0.10 USD) - 2021/01/23 0:43:29 ET
Table 'Algieba III' 6-max Seat #4 is the button
Seat 1: Tyoma_Kovach ($10.52 in chips) 
Seat 2: sixcoins ($6.79 in chips) 
Seat 3: thedude696969 ($38.18 in chips) 
Seat 4: fish72o ($12.41 in chips) 
Seat 5: johnnytrue ($14.03 in chips) 
johnnytrue: posts small blind $0.05
Tyoma_Kovach: posts big blind $0.10
*** HOLE CARDS ***
sixcoins: folds 
thedude696969: calls $0.10
fish72o: folds 
johnnytrue: folds 
Tyoma_Kovach: raises $0.36 to $0.46
thedude696969: calls $0.36
*** FLOP *** [2d 3c 7h]
Tyoma_Kovach: bets $0.70
thedude696969: folds 
Uncalled bet ($0.70) returned to Tyoma_Kovach
Tyoma_Kovach collected $0.93 from pot
Tyoma_Kovach: doesn't show hand 
*** SUMMARY ***
Total pot $0.97 | Rake $0.04 
Board [2d 3c 7h]
Seat 1: Tyoma_Kovach (big blind) collected ($0.93)
Seat 2: sixcoins folded before Flop (didn't bet)
Seat 3: thedude696969 folded on the Flop
Seat 4: fish72o (button) folded before Flop (didn't bet)
Seat 5: johnnytrue (small blind) folded before Flop



PokerStars Hand #222945376441:  Hold'em No Limit ($0.05/$0.10 USD) - 2021/01/23 0:44:01 ET
Table 'Algieba III' 6-max Seat #5 is the button
Seat 1: Tyoma_Kovach ($10.99 in chips) 
Seat 2: sixcoins ($6.79 in chips) 
Seat 3: thedude696969 ($37.72 in chips) 
Seat 4: fish72o ($12.41 in chips) 
Seat 5: johnnytrue ($13.98 in chips) 
Tyoma_Kovach: posts small blind $0.05
sixcoins: posts big blind $0.10
*** HOLE CARDS ***
thedude696969: folds 
fish72o: folds 
johnnytrue: calls $0.10
Tyoma_Kovach: calls $0.05
sixcoins: checks 
*** FLOP *** [2h 8d 7d]
Tyoma_Kovach: bets $0.22
Deniels7 leaves the table
Notatur joins the table at seat #6 
sixcoins: calls $0.22
johnnytrue: calls $0.22
*** TURN *** [2h 8d 7d] [Tc]
Tyoma_Kovach: checks 
sixcoins: checks 
johnnytrue: checks 
*** RIVER *** [2h 8d 7d Tc] [Jc]
Tyoma_Kovach: checks 
sixcoins: bets $0.46
johnnytrue: folds 
Tyoma_Kovach: folds 
Uncalled bet ($0.46) returned to sixcoins
sixcoins collected $0.92 from pot
sixcoins: doesn't show hand 
*** SUMMARY ***
Total pot $0.96 | Rake $0.04 
Board [2h 8d 7d Tc Jc]
Seat 1: Tyoma_Kovach (small blind) folded on the River
Seat 2: sixcoins (big blind) collected ($0.92)
Seat 3: thedude696969 folded before Flop (didn't bet)
Seat 4: fish72o folded before Flop (didn't bet)
Seat 5: johnnytrue (button) folded on the River



PokerStars Hand #222945392035:  Hold'em No Limit ($0.05/$0.10 USD) - 2021/01/23 0:45:01 ET
Table 'Algieba III' 6-max Seat #1 is the button
Seat 1: Tyoma_Kovach ($10.67 in chips) 
Seat 2: sixcoins ($7.39 in chips) 
Seat 3: thedude696969 ($37.72 in chips) 
Seat 4: fish72o ($12.41 in chips) 
Seat 5: johnnytrue ($13.66 in chips) 
sixcoins: posts small blind $0.05
thedude696969: posts big blind $0.10
Notatur: sits out 
*** HOLE CARDS ***
fish72o: raises $0.15 to $0.25
johnnytrue: folds 
Tyoma_Kovach: calls $0.25
sixcoins: folds 
thedude696969: calls $0.15
*** FLOP *** [4c 7d 3h]
thedude696969: bets $0.50
fish72o: folds 
Tyoma_Kovach: folds 
Uncalled bet ($0.50) returned to thedude696969
thedude696969 collected $0.76 from pot
thedude696969: doesn't show hand 
*** SUMMARY ***
Total pot $0.80 | Rake $0.04 
Board [4c 7d 3h]
Seat 1: Tyoma_Kovach (button) folded on the Flop
Seat 2: sixcoins (small blind) folded before Flop
Seat 3: thedude696969 (big blind) collected ($0.76)
Seat 4: fish72o folded on the Flop
Seat 5: johnnytrue folded before Flop (didn't bet)



PokerStars Hand #222945400868:  Hold'em No Limit ($0.05/$0.10 USD) - 2021/01/23 0:45:36 ET
Table 'Algieba III' 6-max Seat #2 is the button
Seat 1: Tyoma_Kovach ($10.42 in chips) 
Seat 2: sixcoins ($7.34 in chips) 
Seat 3: thedude696969 ($38.23 in chips) 
Seat 4: fish72o ($12.16 in chips) 
Seat 5: johnnytrue ($13.66 in chips) 
thedude696969: posts small blind $0.05
fish72o: posts big blind $0.10
Notatur: sits out 
*** HOLE CARDS ***
johnnytrue: calls $0.10
Tyoma_Kovach: folds 
sixcoins: folds 
thedude696969: raises $0.50 to $0.60
fish72o: folds 
johnnytrue: folds 
Uncalled bet ($0.50) returned to thedude696969
thedude696969 collected $0.30 from pot
thedude696969: doesn't show hand 
*** SUMMARY ***
Total pot $0.30 | Rake $0 
Seat 1: Tyoma_Kovach folded before Flop (didn't bet)
Seat 2: sixcoins (button) folded before Flop (didn't bet)
Seat 3: thedude696969 (small blind) collected ($0.30)
Seat 4: fish72o (big blind) folded before Flop
Seat 5: johnnytrue folded before Flop



PokerStars Hand #222945407329:  Hold'em No Limit ($0.05/$0.10 USD) - 2021/01/23 0:46:01 ET
Table 'Algieba III' 6-max Seat #3 is the button
Seat 1: Tyoma_Kovach ($10.42 in chips) 
Seat 2: sixcoins ($7.34 in chips) 
Seat 3: thedude696969 ($38.43 in chips) 
Seat 4: fish72o ($12.06 in chips) 
Seat 5: johnnytrue ($13.56 in chips) 
fish72o: posts small blind $0.05
johnnytrue: posts big blind $0.10
Notatur: sits out 
*** HOLE CARDS ***
Tyoma_Kovach: folds 
sixcoins: raises $0.20 to $0.30
thedude696969: raises $1 to $1.30
fish72o: folds 
johnnytrue: folds 
sixcoins: calls $1
*** FLOP *** [6h 9c Qd]
sixcoins: checks 
thedude696969: bets $2.40
sixcoins: calls $2.40
*** TURN *** [6h 9c Qd] [2d]
sixcoins: checks 
thedude696969: bets $3.64
sixcoins: calls $3.64 and is all-in
*** RIVER *** [6h 9c Qd 2d] [5d]
*** SHOW DOWN ***
sixcoins: shows [Ah As] (a pair of Aces)
thedude696969: shows [8d 8s] (a pair of Eights)
sixcoins collected $14.16 from pot
*** SUMMARY ***
Total pot $14.83 | Rake $0.67 
Board [6h 9c Qd 2d 5d]
Seat 1: Tyoma_Kovach folded before Flop (didn't bet)
Seat 2: sixcoins showed [Ah As] and won ($14.16) with a pair of Aces
Seat 3: thedude696969 (button) showed [8d 8s] and lost with a pair of Eights
Seat 4: fish72o (small blind) folded before Flop
Seat 5: johnnytrue (big blind) folded before Flop



PokerStars Hand #222945424404:  Hold'em No Limit ($0.05/$0.10 USD) - 2021/01/23 0:47:08 ET
Table 'Algieba III' 6-max Seat #4 is the button
Seat 1: Tyoma_Kovach ($10.42 in chips) 
Seat 2: sixcoins ($14.16 in chips) 
Seat 3: thedude696969 ($31.09 in chips) 
Seat 4: fish72o ($12.01 in chips) 
Seat 5: johnnytrue ($13.46 in chips) 
Seat 6: Notatur ($10 in chips) 
johnnytrue: posts small blind $0.05
Notatur: posts big blind $0.10
*** HOLE CARDS ***
Tyoma_Kovach: folds 
sixcoins: folds 
thedude696969: folds 
fish72o: folds 
johnnytrue: calls $0.05
Notatur: checks 
*** FLOP *** [Kh 3h 2s]
johnnytrue: checks 
Notatur: checks 
*** TURN *** [Kh 3h 2s] [4c]
johnnytrue: bets $0.10
Notatur: calls $0.10
*** RIVER *** [Kh 3h 2s 4c] [7h]
johnnytrue: bets $0.38
Notatur: folds 
Uncalled bet ($0.38) returned to johnnytrue
johnnytrue collected $0.38 from pot
*** SUMMARY ***
Total pot $0.40 | Rake $0.02 
Board [Kh 3h 2s 4c 7h]
Seat 1: Tyoma_Kovach folded before Flop (didn't bet)
Seat 2: sixcoins folded before Flop (didn't bet)
Seat 3: thedude696969 folded before Flop (didn't bet)
Seat 4: fish72o (button) folded before Flop (didn't bet)
Seat 5: johnnytrue (small blind) collected ($0.38)
Seat 6: Notatur (big blind) folded on the River



