PokerStars Hand #222968180798:  Hold'em No Limit ($0.05/$0.10 USD) - 2021/01/23 15:07:10 ET
Table 'Jihlava III' 6-max Seat #2 is the button
Seat 1: FreshMcClean ($10.73 in chips) 
Seat 2: vlfrm ($10 in chips) 
Seat 3: Boolik414 ($15.26 in chips) 
Seat 4: zizou_11 ($9.79 in chips) 
Seat 5: Lumbojack ($11.98 in chips) 
Seat 6: droog318 ($10.77 in chips) 
Boolik414: posts small blind $0.05
zizou_11: posts big blind $0.10
*** HOLE CARDS ***
Lumbojack: folds 
droog318: folds 
FreshMcClean: folds 
vlfrm: folds 
Boolik414: folds 
Uncalled bet ($0.05) returned to zizou_11
zizou_11 collected $0.10 from pot
zizou_11: doesn't show hand 
*** SUMMARY ***
Total pot $0.10 | Rake $0 
Seat 1: FreshMcClean folded before Flop (didn't bet)
Seat 2: vlfrm (button) folded before Flop (didn't bet)
Seat 3: Boolik414 (small blind) folded before Flop
Seat 4: zizou_11 (big blind) collected ($0.10)
Seat 5: Lumbojack folded before Flop (didn't bet)
Seat 6: droog318 folded before Flop (didn't bet)



PokerStars Hand #222968196758:  Hold'em No Limit ($0.05/$0.10 USD) - 2021/01/23 15:07:29 ET
Table 'Jihlava III' 6-max Seat #3 is the button
Seat 1: FreshMcClean ($10.73 in chips) 
Seat 2: vlfrm ($10 in chips) 
Seat 3: Boolik414 ($15.21 in chips) 
Seat 4: zizou_11 ($9.84 in chips) 
Seat 5: Lumbojack ($11.98 in chips) 
Seat 6: droog318 ($10.77 in chips) 
zizou_11: posts small blind $0.05
Lumbojack: posts big blind $0.10
*** HOLE CARDS ***
droog318: folds 
FreshMcClean: folds 
vlfrm: raises $0.15 to $0.25
Boolik414: folds 
zizou_11: calls $0.20
Lumbojack: folds 
*** FLOP *** [Ah 5c 9s]
zizou_11: checks 
vlfrm: bets $0.19
zizou_11: folds 
Uncalled bet ($0.19) returned to vlfrm
vlfrm collected $0.57 from pot
vlfrm: doesn't show hand 
*** SUMMARY ***
Total pot $0.60 | Rake $0.03 
Board [Ah 5c 9s]
Seat 1: FreshMcClean folded before Flop (didn't bet)
Seat 2: vlfrm collected ($0.57)
Seat 3: Boolik414 (button) folded before Flop (didn't bet)
Seat 4: zizou_11 (small blind) folded on the Flop
Seat 5: Lumbojack (big blind) folded before Flop
Seat 6: droog318 folded before Flop (didn't bet)



PokerStars Hand #222968214182:  Hold'em No Limit ($0.05/$0.10 USD) - 2021/01/23 15:07:50 ET
Table 'Jihlava III' 6-max Seat #4 is the button
Seat 1: FreshMcClean ($10.73 in chips) 
Seat 2: vlfrm ($10.32 in chips) 
Seat 3: Boolik414 ($15.21 in chips) 
Seat 4: zizou_11 ($9.59 in chips) 
Seat 5: Lumbojack ($11.88 in chips) 
Seat 6: droog318 ($10.77 in chips) 
Lumbojack: posts small blind $0.05
droog318: posts big blind $0.10
*** HOLE CARDS ***
FreshMcClean: folds 
vlfrm: folds 
Boolik414: folds 
zizou_11: folds 
Lumbojack: raises $0.20 to $0.30
droog318: folds 
Uncalled bet ($0.20) returned to Lumbojack
Lumbojack collected $0.20 from pot
Lumbojack: doesn't show hand 
*** SUMMARY ***
Total pot $0.20 | Rake $0 
Seat 1: FreshMcClean folded before Flop (didn't bet)
Seat 2: vlfrm folded before Flop (didn't bet)
Seat 3: Boolik414 folded before Flop (didn't bet)
Seat 4: zizou_11 (button) folded before Flop (didn't bet)
Seat 5: Lumbojack (small blind) collected ($0.20)
Seat 6: droog318 (big blind) folded before Flop



PokerStars Hand #222968223574:  Hold'em No Limit ($0.05/$0.10 USD) - 2021/01/23 15:08:01 ET
Table 'Jihlava III' 6-max Seat #5 is the button
Seat 1: FreshMcClean ($10.73 in chips) 
Seat 2: vlfrm ($10.32 in chips) 
Seat 3: Boolik414 ($15.21 in chips) 
Seat 4: zizou_11 ($9.59 in chips) 
Seat 5: Lumbojack ($11.98 in chips) 
Seat 6: droog318 ($10.67 in chips) 
droog318: posts small blind $0.05
FreshMcClean: posts big blind $0.10
*** HOLE CARDS ***
vlfrm: folds 
Boolik414: folds 
zizou_11: raises $0.15 to $0.25
Lumbojack: folds 
droog318: raises $0.60 to $0.85
FreshMcClean: folds 
zizou_11: calls $0.60
*** FLOP *** [6d Qc Qs]
droog318: bets $0.80
zizou_11: calls $0.80
*** TURN *** [6d Qc Qs] [9h]
droog318: bets $1.90
zizou_11: folds 
Uncalled bet ($1.90) returned to droog318
droog318 collected $3.25 from pot
droog318: doesn't show hand 
*** SUMMARY ***
Total pot $3.40 | Rake $0.15 
Board [6d Qc Qs 9h]
Seat 1: FreshMcClean (big blind) folded before Flop
Seat 2: vlfrm folded before Flop (didn't bet)
Seat 3: Boolik414 folded before Flop (didn't bet)
Seat 4: zizou_11 folded on the Turn
Seat 5: Lumbojack (button) folded before Flop (didn't bet)
Seat 6: droog318 (small blind) collected ($3.25)



PokerStars Hand #222968268344:  Hold'em No Limit ($0.05/$0.10 USD) - 2021/01/23 15:08:54 ET
Table 'Jihlava III' 6-max Seat #6 is the button
Seat 1: FreshMcClean ($10.63 in chips) 
Seat 2: vlfrm ($10.32 in chips) 
Seat 3: Boolik414 ($15.21 in chips) 
Seat 4: zizou_11 ($10 in chips) 
Seat 5: Lumbojack ($11.98 in chips) 
Seat 6: droog318 ($12.27 in chips) 
FreshMcClean: posts small blind $0.05
vlfrm: posts big blind $0.10
*** HOLE CARDS ***
Boolik414: raises $0.15 to $0.25
zizou_11: folds 
Lumbojack: folds 
droog318: folds 
FreshMcClean: folds 
vlfrm: folds 
Uncalled bet ($0.15) returned to Boolik414
Boolik414 collected $0.25 from pot
Boolik414: doesn't show hand 
*** SUMMARY ***
Total pot $0.25 | Rake $0 
Seat 1: FreshMcClean (small blind) folded before Flop
Seat 2: vlfrm (big blind) folded before Flop
Seat 3: Boolik414 collected ($0.25)
Seat 4: zizou_11 folded before Flop (didn't bet)
Seat 5: Lumbojack folded before Flop (didn't bet)
Seat 6: droog318 (button) folded before Flop (didn't bet)



PokerStars Hand #222968282777:  Hold'em No Limit ($0.05/$0.10 USD) - 2021/01/23 15:09:12 ET
Table 'Jihlava III' 6-max Seat #1 is the button
Seat 1: FreshMcClean ($10.58 in chips) 
Seat 2: vlfrm ($10.22 in chips) 
Seat 3: Boolik414 ($15.36 in chips) 
Seat 4: zizou_11 ($10 in chips) 
Seat 5: Lumbojack ($11.98 in chips) 
Seat 6: droog318 ($12.27 in chips) 
vlfrm: posts small blind $0.05
Boolik414: posts big blind $0.10
*** HOLE CARDS ***
zizou_11: folds 
Lumbojack: folds 
droog318: folds 
FreshMcClean: raises $0.20 to $0.30
vlfrm: folds 
Boolik414: calls $0.20
*** FLOP *** [Td Ac Ah]
Boolik414: checks 
FreshMcClean: bets $0.20
Boolik414: calls $0.20
*** TURN *** [Td Ac Ah] [8c]
Boolik414: checks 
FreshMcClean: bets $1
Boolik414: folds 
Uncalled bet ($1) returned to FreshMcClean
FreshMcClean collected $1 from pot
*** SUMMARY ***
Total pot $1.05 | Rake $0.05 
Board [Td Ac Ah 8c]
Seat 1: FreshMcClean (button) collected ($1)
Seat 2: vlfrm (small blind) folded before Flop
Seat 3: Boolik414 (big blind) folded on the Turn
Seat 4: zizou_11 folded before Flop (didn't bet)
Seat 5: Lumbojack folded before Flop (didn't bet)
Seat 6: droog318 folded before Flop (didn't bet)



PokerStars Hand #222968358066:  Hold'em No Limit ($0.05/$0.10 USD) - 2021/01/23 15:10:41 ET
Table 'Jihlava III' 6-max Seat #2 is the button
Seat 1: FreshMcClean ($11.08 in chips) 
Seat 2: vlfrm ($10.17 in chips) 
Seat 3: Boolik414 ($14.86 in chips) 
Seat 4: zizou_11 ($10 in chips) 
Seat 5: Lumbojack ($11.98 in chips) 
Seat 6: droog318 ($12.27 in chips) 
Boolik414: posts small blind $0.05
zizou_11: posts big blind $0.10
*** HOLE CARDS ***
Lumbojack: raises $0.15 to $0.25
droog318: folds 
FreshMcClean: folds 
vlfrm: folds 
Boolik414: folds 
zizou_11: folds 
Uncalled bet ($0.15) returned to Lumbojack
Lumbojack collected $0.25 from pot
Lumbojack: doesn't show hand 
*** SUMMARY ***
Total pot $0.25 | Rake $0 
Seat 1: FreshMcClean folded before Flop (didn't bet)
Seat 2: vlfrm (button) folded before Flop (didn't bet)
Seat 3: Boolik414 (small blind) folded before Flop
Seat 4: zizou_11 (big blind) folded before Flop
Seat 5: Lumbojack collected ($0.25)
Seat 6: droog318 folded before Flop (didn't bet)



PokerStars Hand #222968368271:  Hold'em No Limit ($0.05/$0.10 USD) - 2021/01/23 15:10:53 ET
Table 'Jihlava III' 6-max Seat #3 is the button
Seat 1: FreshMcClean ($11.08 in chips) 
Seat 2: vlfrm ($10.17 in chips) 
Seat 3: Boolik414 ($14.81 in chips) 
Seat 4: zizou_11 ($9.90 in chips) 
Seat 5: Lumbojack ($12.13 in chips) 
Seat 6: droog318 ($12.27 in chips) 
zizou_11: posts small blind $0.05
Lumbojack: posts big blind $0.10
*** HOLE CARDS ***
droog318: folds 
FreshMcClean: folds 
vlfrm: folds 
Boolik414: raises $0.25 to $0.35
zizou_11: folds 
Lumbojack: folds 
Uncalled bet ($0.25) returned to Boolik414
Boolik414 collected $0.25 from pot
Boolik414: doesn't show hand 
*** SUMMARY ***
Total pot $0.25 | Rake $0 
Seat 1: FreshMcClean folded before Flop (didn't bet)
Seat 2: vlfrm folded before Flop (didn't bet)
Seat 3: Boolik414 (button) collected ($0.25)
Seat 4: zizou_11 (small blind) folded before Flop
Seat 5: Lumbojack (big blind) folded before Flop
Seat 6: droog318 folded before Flop (didn't bet)



PokerStars Hand #222968387535:  Hold'em No Limit ($0.05/$0.10 USD) - 2021/01/23 15:11:16 ET
Table 'Jihlava III' 6-max Seat #4 is the button
Seat 1: FreshMcClean ($11.08 in chips) 
Seat 2: vlfrm ($10.17 in chips) 
Seat 3: Boolik414 ($14.96 in chips) 
Seat 4: zizou_11 ($9.85 in chips) 
Seat 5: Lumbojack ($12.03 in chips) 
Seat 6: droog318 ($12.27 in chips) 
Lumbojack: posts small blind $0.05
droog318: posts big blind $0.10
*** HOLE CARDS ***
FreshMcClean: folds 
vlfrm: folds 
Boolik414: folds 
zizou_11: folds 
Lumbojack: raises $0.20 to $0.30
droog318: folds 
Uncalled bet ($0.20) returned to Lumbojack
Lumbojack collected $0.20 from pot
Lumbojack: doesn't show hand 
*** SUMMARY ***
Total pot $0.20 | Rake $0 
Seat 1: FreshMcClean folded before Flop (didn't bet)
Seat 2: vlfrm folded before Flop (didn't bet)
Seat 3: Boolik414 folded before Flop (didn't bet)
Seat 4: zizou_11 (button) folded before Flop (didn't bet)
Seat 5: Lumbojack (small blind) collected ($0.20)
Seat 6: droog318 (big blind) folded before Flop



PokerStars Hand #222968397722:  Hold'em No Limit ($0.05/$0.10 USD) - 2021/01/23 15:11:28 ET
Table 'Jihlava III' 6-max Seat #5 is the button
Seat 1: FreshMcClean ($11.08 in chips) 
Seat 2: vlfrm ($10.17 in chips) 
Seat 3: Boolik414 ($14.96 in chips) 
Seat 4: zizou_11 ($9.85 in chips) 
Seat 5: Lumbojack ($12.13 in chips) 
Seat 6: droog318 ($12.17 in chips) 
droog318: posts small blind $0.05
FreshMcClean: posts big blind $0.10
*** HOLE CARDS ***
vlfrm: folds 
Boolik414: raises $0.15 to $0.25
zizou_11: calls $0.25
Lumbojack: folds 
droog318: folds 
FreshMcClean: folds 
*** FLOP *** [2s 2h 8c]
Boolik414: bets $0.47
zizou_11: calls $0.47
*** TURN *** [2s 2h 8c] [7s]
Boolik414: bets $0.46
zizou_11: calls $0.46
*** RIVER *** [2s 2h 8c 7s] [Ts]
Boolik414: bets $0.72
zizou_11: calls $0.72
*** SHOW DOWN ***
Boolik414: shows [8d 9d] (two pair, Eights and Deuces)
zizou_11: mucks hand 
Boolik414 collected $3.77 from pot
*** SUMMARY ***
Total pot $3.95 | Rake $0.18 
Board [2s 2h 8c 7s Ts]
Seat 1: FreshMcClean (big blind) folded before Flop
Seat 2: vlfrm folded before Flop (didn't bet)
Seat 3: Boolik414 showed [8d 9d] and won ($3.77) with two pair, Eights and Deuces
Seat 4: zizou_11 mucked
Seat 5: Lumbojack (button) folded before Flop (didn't bet)
Seat 6: droog318 (small blind) folded before Flop



PokerStars Hand #222968462213:  Hold'em No Limit ($0.05/$0.10 USD) - 2021/01/23 15:12:37 ET
Table 'Jihlava III' 6-max Seat #6 is the button
Seat 1: FreshMcClean ($10.98 in chips) 
Seat 2: vlfrm ($10.17 in chips) 
Seat 3: Boolik414 ($16.83 in chips) 
Seat 4: zizou_11 ($10 in chips) 
Seat 5: Lumbojack ($12.13 in chips) 
Seat 6: droog318 ($12.12 in chips) 
FreshMcClean: posts small blind $0.05
vlfrm: posts big blind $0.10
*** HOLE CARDS ***
Boolik414: folds 
zizou_11: raises $0.25 to $0.35
Lumbojack: folds 
droog318: folds 
FreshMcClean: folds 
vlfrm: calls $0.25
*** FLOP *** [8d Jh 3c]
vlfrm: checks 
zizou_11: bets $0.50
vlfrm: folds 
Uncalled bet ($0.50) returned to zizou_11
zizou_11 collected $0.72 from pot
zizou_11: doesn't show hand 
*** SUMMARY ***
Total pot $0.75 | Rake $0.03 
Board [8d Jh 3c]
Seat 1: FreshMcClean (small blind) folded before Flop
Seat 2: vlfrm (big blind) folded on the Flop
Seat 3: Boolik414 folded before Flop (didn't bet)
Seat 4: zizou_11 collected ($0.72)
Seat 5: Lumbojack folded before Flop (didn't bet)
Seat 6: droog318 (button) folded before Flop (didn't bet)



PokerStars Hand #222968503780:  Hold'em No Limit ($0.05/$0.10 USD) - 2021/01/23 15:13:27 ET
Table 'Jihlava III' 6-max Seat #1 is the button
Seat 1: FreshMcClean ($10.93 in chips) 
Seat 2: vlfrm ($10 in chips) 
Seat 3: Boolik414 ($16.83 in chips) 
Seat 4: zizou_11 ($10.37 in chips) 
Seat 5: Lumbojack ($12.13 in chips) 
Seat 6: droog318 ($12.12 in chips) 
vlfrm: posts small blind $0.05
Boolik414: posts big blind $0.10
*** HOLE CARDS ***
zizou_11: folds 
Lumbojack: folds 
droog318: raises $0.20 to $0.30
FreshMcClean: folds 
vlfrm: folds 
Boolik414: calls $0.20
*** FLOP *** [As Kd Js]
Boolik414: checks 
droog318: bets $0.40
Boolik414: folds 
Uncalled bet ($0.40) returned to droog318
droog318 collected $0.62 from pot
droog318: doesn't show hand 
*** SUMMARY ***
Total pot $0.65 | Rake $0.03 
Board [As Kd Js]
Seat 1: FreshMcClean (button) folded before Flop (didn't bet)
Seat 2: vlfrm (small blind) folded before Flop
Seat 3: Boolik414 (big blind) folded on the Flop
Seat 4: zizou_11 folded before Flop (didn't bet)
Seat 5: Lumbojack folded before Flop (didn't bet)
Seat 6: droog318 collected ($0.62)



PokerStars Hand #222968534888:  Hold'em No Limit ($0.05/$0.10 USD) - 2021/01/23 15:14:04 ET
Table 'Jihlava III' 6-max Seat #2 is the button
Seat 1: FreshMcClean ($10.93 in chips) 
Seat 2: vlfrm ($10 in chips) 
Seat 3: Boolik414 ($16.53 in chips) 
Seat 4: zizou_11 ($10.37 in chips) 
Seat 5: Lumbojack ($12.13 in chips) 
Seat 6: droog318 ($12.44 in chips) 
Boolik414: posts small blind $0.05
zizou_11: posts big blind $0.10
*** HOLE CARDS ***
Lumbojack: raises $0.15 to $0.25
droog318: folds 
FreshMcClean: raises $0.50 to $0.75
vlfrm: folds 
Boolik414: folds 
zizou_11: folds 
Lumbojack: folds 
Uncalled bet ($0.50) returned to FreshMcClean
FreshMcClean collected $0.65 from pot
*** SUMMARY ***
Total pot $0.65 | Rake $0 
Seat 1: FreshMcClean collected ($0.65)
Seat 2: vlfrm (button) folded before Flop (didn't bet)
Seat 3: Boolik414 (small blind) folded before Flop
Seat 4: zizou_11 (big blind) folded before Flop
Seat 5: Lumbojack folded before Flop
Seat 6: droog318 folded before Flop (didn't bet)



PokerStars Hand #222968564371:  Hold'em No Limit ($0.05/$0.10 USD) - 2021/01/23 15:14:39 ET
Table 'Jihlava III' 6-max Seat #3 is the button
Seat 1: FreshMcClean ($11.33 in chips) 
Seat 2: vlfrm ($10 in chips) 
Seat 3: Boolik414 ($16.48 in chips) 
Seat 4: zizou_11 ($10.27 in chips) 
Seat 5: Lumbojack ($11.88 in chips) 
Seat 6: droog318 ($12.44 in chips) 
zizou_11: posts small blind $0.05
Lumbojack: posts big blind $0.10
*** HOLE CARDS ***
droog318: folds 
FreshMcClean: folds 
vlfrm: folds 
Boolik414: folds 
zizou_11: folds 
Uncalled bet ($0.05) returned to Lumbojack
Lumbojack collected $0.10 from pot
Lumbojack: doesn't show hand 
*** SUMMARY ***
Total pot $0.10 | Rake $0 
Seat 1: FreshMcClean folded before Flop (didn't bet)
Seat 2: vlfrm folded before Flop (didn't bet)
Seat 3: Boolik414 (button) folded before Flop (didn't bet)
Seat 4: zizou_11 (small blind) folded before Flop
Seat 5: Lumbojack (big blind) collected ($0.10)
Seat 6: droog318 folded before Flop (didn't bet)



PokerStars Hand #222968571850:  Hold'em No Limit ($0.05/$0.10 USD) - 2021/01/23 15:14:48 ET
Table 'Jihlava III' 6-max Seat #4 is the button
Seat 1: FreshMcClean ($11.33 in chips) 
Seat 2: vlfrm ($10 in chips) 
Seat 3: Boolik414 ($16.48 in chips) 
Seat 4: zizou_11 ($10.22 in chips) 
Seat 5: Lumbojack ($11.93 in chips) 
Seat 6: droog318 ($12.44 in chips) 
Lumbojack: posts small blind $0.05
droog318: posts big blind $0.10
*** HOLE CARDS ***
FreshMcClean: raises $0.20 to $0.30
vlfrm: folds 
Boolik414: calls $0.30
zizou_11: folds 
Lumbojack: folds 
droog318: folds 
*** FLOP *** [6s 8s Qh]
FreshMcClean: checks 
Boolik414: checks 
*** TURN *** [6s 8s Qh] [7s]
FreshMcClean: checks 
Boolik414: checks 
*** RIVER *** [6s 8s Qh 7s] [5c]
FreshMcClean: checks 
Boolik414: checks 
*** SHOW DOWN ***
FreshMcClean: shows [Kd As] (high card Ace)
Boolik414: mucks hand 
FreshMcClean collected $0.72 from pot
*** SUMMARY ***
Total pot $0.75 | Rake $0.03 
Board [6s 8s Qh 7s 5c]
Seat 1: FreshMcClean showed [Kd As] and won ($0.72) with high card Ace
Seat 2: vlfrm folded before Flop (didn't bet)
Seat 3: Boolik414 mucked
Seat 4: zizou_11 (button) folded before Flop (didn't bet)
Seat 5: Lumbojack (small blind) folded before Flop
Seat 6: droog318 (big blind) folded before Flop



PokerStars Hand #222968638731:  Hold'em No Limit ($0.05/$0.10 USD) - 2021/01/23 15:16:06 ET
Table 'Jihlava III' 6-max Seat #5 is the button
Seat 1: FreshMcClean ($11.75 in chips) 
Seat 2: vlfrm ($10 in chips) 
Seat 3: Boolik414 ($16.18 in chips) 
Seat 4: zizou_11 ($10.22 in chips) 
Seat 5: Lumbojack ($11.88 in chips) 
Seat 6: droog318 ($12.34 in chips) 
droog318: posts small blind $0.05
FreshMcClean: posts big blind $0.10
*** HOLE CARDS ***
vlfrm: folds 
Boolik414: folds 
zizou_11: folds 
Lumbojack: folds 
droog318: folds 
Uncalled bet ($0.05) returned to FreshMcClean
FreshMcClean collected $0.10 from pot
*** SUMMARY ***
Total pot $0.10 | Rake $0 
Seat 1: FreshMcClean (big blind) collected ($0.10)
Seat 2: vlfrm folded before Flop (didn't bet)
Seat 3: Boolik414 folded before Flop (didn't bet)
Seat 4: zizou_11 folded before Flop (didn't bet)
Seat 5: Lumbojack (button) folded before Flop (didn't bet)
Seat 6: droog318 (small blind) folded before Flop



PokerStars Hand #222968649918:  Hold'em No Limit ($0.05/$0.10 USD) - 2021/01/23 15:16:19 ET
Table 'Jihlava III' 6-max Seat #6 is the button
Seat 1: FreshMcClean ($11.80 in chips) 
Seat 2: vlfrm ($10 in chips) 
Seat 3: Boolik414 ($16.18 in chips) 
Seat 4: zizou_11 ($10.22 in chips) 
Seat 5: Lumbojack ($11.88 in chips) 
Seat 6: droog318 ($12.29 in chips) 
FreshMcClean: posts small blind $0.05
vlfrm: posts big blind $0.10
*** HOLE CARDS ***
Boolik414: raises $0.15 to $0.25
zizou_11: folds 
Lumbojack has timed out
Lumbojack: folds 
droog318: folds 
FreshMcClean: folds 
vlfrm: calls $0.15
*** FLOP *** [4d 7h As]
vlfrm: checks 
Boolik414: bets $0.40
vlfrm: calls $0.40
*** TURN *** [4d 7h As] [Jc]
vlfrm: checks 
Boolik414: bets $0.39
vlfrm: raises $0.78 to $1.17
Boolik414: calls $0.78
*** RIVER *** [4d 7h As Jc] [6s]
vlfrm: checks 
Boolik414: checks 
*** SHOW DOWN ***
vlfrm: shows [Td Tc] (a pair of Tens)
Boolik414: shows [Ah Kh] (a pair of Aces)
Boolik414 collected $3.52 from pot
*** SUMMARY ***
Total pot $3.69 | Rake $0.17 
Board [4d 7h As Jc 6s]
Seat 1: FreshMcClean (small blind) folded before Flop
Seat 2: vlfrm (big blind) showed [Td Tc] and lost with a pair of Tens
Seat 3: Boolik414 showed [Ah Kh] and won ($3.52) with a pair of Aces
Seat 4: zizou_11 folded before Flop (didn't bet)
Seat 5: Lumbojack folded before Flop (didn't bet)
Seat 6: droog318 (button) folded before Flop (didn't bet)



PokerStars Hand #222968746325:  Hold'em No Limit ($0.05/$0.10 USD) - 2021/01/23 15:18:12 ET
Table 'Jihlava III' 6-max Seat #1 is the button
Seat 1: FreshMcClean ($11.75 in chips) 
Seat 2: vlfrm ($10 in chips) 
Seat 3: Boolik414 ($17.88 in chips) 
Seat 4: zizou_11 ($10.22 in chips) 
Seat 5: Lumbojack ($11.88 in chips) 
Seat 6: droog318 ($12.29 in chips) 
vlfrm: posts small blind $0.05
Boolik414: posts big blind $0.10
*** HOLE CARDS ***
zizou_11: raises $0.15 to $0.25
Lumbojack: folds 
droog318: calls $0.25
FreshMcClean: folds 
vlfrm: folds 
Boolik414: folds 
*** FLOP *** [Ah Qs 2h]
zizou_11: checks 
droog318: bets $0.31
zizou_11: calls $0.31
*** TURN *** [Ah Qs 2h] [7c]
zizou_11: checks 
droog318: bets $0.90
zizou_11: folds 
Uncalled bet ($0.90) returned to droog318
droog318 collected $1.21 from pot
droog318: doesn't show hand 
*** SUMMARY ***
Total pot $1.27 | Rake $0.06 
Board [Ah Qs 2h 7c]
Seat 1: FreshMcClean (button) folded before Flop (didn't bet)
Seat 2: vlfrm (small blind) folded before Flop
Seat 3: Boolik414 (big blind) folded before Flop
Seat 4: zizou_11 folded on the Turn
Seat 5: Lumbojack folded before Flop (didn't bet)
Seat 6: droog318 collected ($1.21)



PokerStars Hand #222968776009:  Hold'em No Limit ($0.05/$0.10 USD) - 2021/01/23 15:18:47 ET
Table 'Jihlava III' 6-max Seat #2 is the button
Seat 1: FreshMcClean ($11.75 in chips) 
Seat 2: vlfrm ($10 in chips) 
Seat 3: Boolik414 ($17.78 in chips) 
Seat 4: zizou_11 ($9.66 in chips) 
Seat 5: Lumbojack ($11.88 in chips) 
Seat 6: droog318 ($12.94 in chips) 
Boolik414: posts small blind $0.05
zizou_11: posts big blind $0.10
*** HOLE CARDS ***
Lumbojack: folds 
droog318: folds 
FreshMcClean: folds 
vlfrm: folds 
Boolik414: folds 
Uncalled bet ($0.05) returned to zizou_11
zizou_11 collected $0.10 from pot
zizou_11: doesn't show hand 
*** SUMMARY ***
Total pot $0.10 | Rake $0 
Seat 1: FreshMcClean folded before Flop (didn't bet)
Seat 2: vlfrm (button) folded before Flop (didn't bet)
Seat 3: Boolik414 (small blind) folded before Flop
Seat 4: zizou_11 (big blind) collected ($0.10)
Seat 5: Lumbojack folded before Flop (didn't bet)
Seat 6: droog318 folded before Flop (didn't bet)



PokerStars Hand #222968786407:  Hold'em No Limit ($0.05/$0.10 USD) - 2021/01/23 15:18:59 ET
Table 'Jihlava III' 6-max Seat #3 is the button
Seat 1: FreshMcClean ($11.75 in chips) 
Seat 2: vlfrm ($10 in chips) 
Seat 3: Boolik414 ($17.73 in chips) 
Seat 4: zizou_11 ($9.71 in chips) 
Seat 5: Lumbojack ($11.88 in chips) 
Seat 6: droog318 ($12.94 in chips) 
zizou_11: posts small blind $0.05
Lumbojack: posts big blind $0.10
*** HOLE CARDS ***
droog318: folds 
FreshMcClean: folds 
vlfrm: folds 
Boolik414: folds 
zizou_11: raises $0.20 to $0.30
Lumbojack: raises $0.60 to $0.90
zizou_11: raises $0.60 to $1.50
Lumbojack: calls $0.60
*** FLOP *** [7s 8c 3h]
zizou_11: bets $1.70
Lumbojack: calls $1.70
*** TURN *** [7s 8c 3h] [Ac]
zizou_11: checks 
Lumbojack: checks 
*** RIVER *** [7s 8c 3h Ac] [2d]
zizou_11: bets $1.50
Lumbojack: calls $1.50
*** SHOW DOWN ***
zizou_11: shows [Ah Ad] (three of a kind, Aces)
Lumbojack: mucks hand 
zizou_11 collected $8.98 from pot
*** SUMMARY ***
Total pot $9.40 | Rake $0.42 
Board [7s 8c 3h Ac 2d]
Seat 1: FreshMcClean folded before Flop (didn't bet)
Seat 2: vlfrm folded before Flop (didn't bet)
Seat 3: Boolik414 (button) folded before Flop (didn't bet)
Seat 4: zizou_11 (small blind) showed [Ah Ad] and won ($8.98) with three of a kind, Aces
Seat 5: Lumbojack (big blind) mucked
Seat 6: droog318 folded before Flop (didn't bet)



PokerStars Hand #222968858906:  Hold'em No Limit ($0.05/$0.10 USD) - 2021/01/23 15:20:24 ET
Table 'Jihlava III' 6-max Seat #4 is the button
Seat 1: FreshMcClean ($11.75 in chips) 
Seat 2: vlfrm ($10 in chips) 
Seat 3: Boolik414 ($17.73 in chips) 
Seat 4: zizou_11 ($13.99 in chips) 
Seat 5: Lumbojack ($10 in chips) 
Seat 6: droog318 ($12.94 in chips) 
Lumbojack: posts small blind $0.05
droog318: posts big blind $0.10
*** HOLE CARDS ***
FreshMcClean: raises $0.20 to $0.30
vlfrm: calls $0.30
Boolik414: calls $0.30
zizou_11: folds 
Lumbojack: folds 
droog318: calls $0.20
*** FLOP *** [As 5h Ad]
droog318: checks 
FreshMcClean: bets $0.60
vlfrm: folds 
Boolik414: calls $0.60
droog318: folds 
*** TURN *** [As 5h Ad] [4h]
FreshMcClean: bets $1.17
Boolik414: calls $1.17
*** RIVER *** [As 5h Ad 4h] [2c]
FreshMcClean: bets $2.29
Boolik414: calls $2.29
*** SHOW DOWN ***
FreshMcClean: shows [Qc Ac] (three of a kind, Aces)
Boolik414: shows [Qs Ah] (three of a kind, Aces)
FreshMcClean collected $4.48 from pot
Boolik414 collected $4.47 from pot
*** SUMMARY ***
Total pot $9.37 | Rake $0.42 
Board [As 5h Ad 4h 2c]
Seat 1: FreshMcClean showed [Qc Ac] and won ($4.48) with three of a kind, Aces
Seat 2: vlfrm folded on the Flop
Seat 3: Boolik414 showed [Qs Ah] and won ($4.47) with three of a kind, Aces
Seat 4: zizou_11 (button) folded before Flop (didn't bet)
Seat 5: Lumbojack (small blind) folded before Flop
Seat 6: droog318 (big blind) folded on the Flop



PokerStars Hand #222968974757:  Hold'em No Limit ($0.05/$0.10 USD) - 2021/01/23 15:22:38 ET
Table 'Jihlava III' 6-max Seat #5 is the button
Seat 1: FreshMcClean ($11.87 in chips) 
Seat 2: vlfrm ($10 in chips) 
Seat 3: Boolik414 ($17.84 in chips) 
Seat 4: zizou_11 ($13.99 in chips) 
Seat 5: Lumbojack ($9.95 in chips) 
Seat 6: droog318 ($12.64 in chips) 
droog318: posts small blind $0.05
FreshMcClean: posts big blind $0.10
*** HOLE CARDS ***
vlfrm: folds 
Boolik414: folds 
zizou_11: folds 
Lumbojack: folds 
droog318: raises $0.20 to $0.30
FreshMcClean: calls $0.20
*** FLOP *** [6d 3s 2d]
droog318: bets $0.40
FreshMcClean: folds 
Uncalled bet ($0.40) returned to droog318
droog318 collected $0.57 from pot
droog318: doesn't show hand 
*** SUMMARY ***
Total pot $0.60 | Rake $0.03 
Board [6d 3s 2d]
Seat 1: FreshMcClean (big blind) folded on the Flop
Seat 2: vlfrm folded before Flop (didn't bet)
Seat 3: Boolik414 folded before Flop (didn't bet)
Seat 4: zizou_11 folded before Flop (didn't bet)
Seat 5: Lumbojack (button) folded before Flop (didn't bet)
Seat 6: droog318 (small blind) collected ($0.57)



PokerStars Hand #222968996514:  Hold'em No Limit ($0.05/$0.10 USD) - 2021/01/23 15:23:03 ET
Table 'Jihlava III' 6-max Seat #6 is the button
Seat 1: FreshMcClean ($11.57 in chips) 
Seat 2: vlfrm ($10 in chips) 
Seat 3: Boolik414 ($17.84 in chips) 
Seat 4: zizou_11 ($13.99 in chips) 
Seat 5: Lumbojack ($9.95 in chips) 
Seat 6: droog318 ($12.91 in chips) 
FreshMcClean: posts small blind $0.05
vlfrm: posts big blind $0.10
*** HOLE CARDS ***
Boolik414: folds 
zizou_11: raises $0.15 to $0.25
Lumbojack: folds 
droog318: folds 
FreshMcClean: calls $0.20
vlfrm: calls $0.15
*** FLOP *** [9d Ac 7d]
FreshMcClean: checks 
vlfrm: checks 
zizou_11: checks 
*** TURN *** [9d Ac 7d] [Ks]
FreshMcClean: checks 
vlfrm: checks 
zizou_11: checks 
*** RIVER *** [9d Ac 7d Ks] [7c]
FreshMcClean: bets $0.72
vlfrm: calls $0.72
zizou_11: folds 
*** SHOW DOWN ***
FreshMcClean: shows [Th 7h] (three of a kind, Sevens)
vlfrm: mucks hand 
FreshMcClean collected $2.09 from pot
*** SUMMARY ***
Total pot $2.19 | Rake $0.10 
Board [9d Ac 7d Ks 7c]
Seat 1: FreshMcClean (small blind) showed [Th 7h] and won ($2.09) with three of a kind, Sevens
Seat 2: vlfrm (big blind) mucked
Seat 3: Boolik414 folded before Flop (didn't bet)
Seat 4: zizou_11 folded on the River
Seat 5: Lumbojack folded before Flop (didn't bet)
Seat 6: droog318 (button) folded before Flop (didn't bet)



PokerStars Hand #222969040490:  Hold'em No Limit ($0.05/$0.10 USD) - 2021/01/23 15:23:54 ET
Table 'Jihlava III' 6-max Seat #1 is the button
Seat 1: FreshMcClean ($12.69 in chips) 
Seat 2: vlfrm ($10 in chips) 
Seat 3: Boolik414 ($17.84 in chips) 
Seat 4: zizou_11 ($13.74 in chips) 
Seat 5: Lumbojack ($9.95 in chips) 
Seat 6: droog318 ($12.91 in chips) 
vlfrm: posts small blind $0.05
Boolik414: posts big blind $0.10
*** HOLE CARDS ***
zizou_11: folds 
Lumbojack: folds 
droog318: folds 
FreshMcClean: folds 
vlfrm: folds 
Uncalled bet ($0.05) returned to Boolik414
Boolik414 collected $0.10 from pot
Boolik414: doesn't show hand 
*** SUMMARY ***
Total pot $0.10 | Rake $0 
Seat 1: FreshMcClean (button) folded before Flop (didn't bet)
Seat 2: vlfrm (small blind) folded before Flop
Seat 3: Boolik414 (big blind) collected ($0.10)
Seat 4: zizou_11 folded before Flop (didn't bet)
Seat 5: Lumbojack folded before Flop (didn't bet)
Seat 6: droog318 folded before Flop (didn't bet)



PokerStars Hand #222969050623:  Hold'em No Limit ($0.05/$0.10 USD) - 2021/01/23 15:24:06 ET
Table 'Jihlava III' 6-max Seat #2 is the button
Seat 1: FreshMcClean ($12.69 in chips) 
Seat 2: vlfrm ($10 in chips) 
Seat 3: Boolik414 ($17.89 in chips) 
Seat 4: zizou_11 ($13.74 in chips) 
Seat 5: Lumbojack ($9.95 in chips) 
Seat 6: droog318 ($12.91 in chips) 
Boolik414: posts small blind $0.05
zizou_11: posts big blind $0.10
*** HOLE CARDS ***
Lumbojack: folds 
droog318: folds 
FreshMcClean: folds 
vlfrm: folds 
Boolik414: folds 
Uncalled bet ($0.05) returned to zizou_11
zizou_11 collected $0.10 from pot
zizou_11: doesn't show hand 
*** SUMMARY ***
Total pot $0.10 | Rake $0 
Seat 1: FreshMcClean folded before Flop (didn't bet)
Seat 2: vlfrm (button) folded before Flop (didn't bet)
Seat 3: Boolik414 (small blind) folded before Flop
Seat 4: zizou_11 (big blind) collected ($0.10)
Seat 5: Lumbojack folded before Flop (didn't bet)
Seat 6: droog318 folded before Flop (didn't bet)



PokerStars Hand #222969057707:  Hold'em No Limit ($0.05/$0.10 USD) - 2021/01/23 15:24:14 ET
Table 'Jihlava III' 6-max Seat #3 is the button
Seat 1: FreshMcClean ($12.69 in chips) 
Seat 2: vlfrm ($10 in chips) 
Seat 3: Boolik414 ($17.84 in chips) 
Seat 4: zizou_11 ($13.79 in chips) 
Seat 5: Lumbojack ($9.95 in chips) 
Seat 6: droog318 ($12.91 in chips) 
zizou_11: posts small blind $0.05
Lumbojack: posts big blind $0.10
*** HOLE CARDS ***
droog318: raises $0.20 to $0.30
FreshMcClean: calls $0.30
vlfrm: folds 
Boolik414: folds 
zizou_11: folds 
Lumbojack: folds 
*** FLOP *** [2d 6h 6s]
droog318: bets $0.40
FreshMcClean: raises $0.80 to $1.20
droog318: folds 
Uncalled bet ($0.80) returned to FreshMcClean
FreshMcClean collected $1.48 from pot
*** SUMMARY ***
Total pot $1.55 | Rake $0.07 
Board [2d 6h 6s]
Seat 1: FreshMcClean collected ($1.48)
Seat 2: vlfrm folded before Flop (didn't bet)
Seat 3: Boolik414 (button) folded before Flop (didn't bet)
Seat 4: zizou_11 (small blind) folded before Flop
Seat 5: Lumbojack (big blind) folded before Flop
Seat 6: droog318 folded on the Flop



PokerStars Hand #222969083865:  Hold'em No Limit ($0.05/$0.10 USD) - 2021/01/23 15:24:45 ET
Table 'Jihlava III' 6-max Seat #4 is the button
Seat 1: FreshMcClean ($13.47 in chips) 
Seat 2: vlfrm ($10 in chips) 
Seat 3: Boolik414 ($17.84 in chips) 
Seat 4: zizou_11 ($13.74 in chips) 
Seat 5: Lumbojack ($9.85 in chips) 
Seat 6: droog318 ($12.21 in chips) 
Lumbojack: posts small blind $0.05
droog318: posts big blind $0.10
*** HOLE CARDS ***
FreshMcClean: folds 
vlfrm: folds 
Boolik414: folds 
zizou_11: folds 
Lumbojack: folds 
Uncalled bet ($0.05) returned to droog318
droog318 collected $0.10 from pot
droog318: doesn't show hand 
*** SUMMARY ***
Total pot $0.10 | Rake $0 
Seat 1: FreshMcClean folded before Flop (didn't bet)
Seat 2: vlfrm folded before Flop (didn't bet)
Seat 3: Boolik414 folded before Flop (didn't bet)
Seat 4: zizou_11 (button) folded before Flop (didn't bet)
Seat 5: Lumbojack (small blind) folded before Flop
Seat 6: droog318 (big blind) collected ($0.10)



PokerStars Hand #222969091114:  Hold'em No Limit ($0.05/$0.10 USD) - 2021/01/23 15:24:53 ET
Table 'Jihlava III' 6-max Seat #5 is the button
Seat 1: FreshMcClean ($13.47 in chips) 
Seat 2: vlfrm ($10 in chips) 
Seat 3: Boolik414 ($17.84 in chips) 
Seat 4: zizou_11 ($13.74 in chips) 
Seat 5: Lumbojack ($9.80 in chips) 
Seat 6: droog318 ($12.26 in chips) 
droog318: posts small blind $0.05
FreshMcClean: posts big blind $0.10
*** HOLE CARDS ***
vlfrm: folds 
Boolik414: folds 
zizou_11: folds 
Lumbojack: folds 
droog318: raises $0.20 to $0.30
FreshMcClean: calls $0.20
*** FLOP *** [4c Kh 3s]
droog318: bets $0.29
FreshMcClean: calls $0.29
*** TURN *** [4c Kh 3s] [2s]
droog318: bets $0.60
FreshMcClean: raises $1.17 to $1.77
droog318: folds 
Uncalled bet ($1.17) returned to FreshMcClean
FreshMcClean collected $2.27 from pot
*** SUMMARY ***
Total pot $2.38 | Rake $0.11 
Board [4c Kh 3s 2s]
Seat 1: FreshMcClean (big blind) collected ($2.27)
Seat 2: vlfrm folded before Flop (didn't bet)
Seat 3: Boolik414 folded before Flop (didn't bet)
Seat 4: zizou_11 folded before Flop (didn't bet)
Seat 5: Lumbojack (button) folded before Flop (didn't bet)
Seat 6: droog318 (small blind) folded on the Turn



PokerStars Hand #222969145120:  Hold'em No Limit ($0.05/$0.10 USD) - 2021/01/23 15:25:56 ET
Table 'Jihlava III' 6-max Seat #6 is the button
Seat 1: FreshMcClean ($14.55 in chips) 
Seat 2: vlfrm ($10 in chips) 
Seat 3: Boolik414 ($17.84 in chips) 
Seat 4: zizou_11 ($13.74 in chips) 
Seat 5: Lumbojack ($9.80 in chips) 
Seat 6: droog318 ($11.07 in chips) 
FreshMcClean: posts small blind $0.05
vlfrm: posts big blind $0.10
*** HOLE CARDS ***
Boolik414: raises $0.15 to $0.25
zizou_11: calls $0.25
Lumbojack: folds 
droog318: folds 
FreshMcClean: folds 
vlfrm: calls $0.15
*** FLOP *** [Kh 7d Jd]
vlfrm: checks 
Boolik414: bets $0.38
zizou_11: folds 
vlfrm: folds 
Uncalled bet ($0.38) returned to Boolik414
Boolik414 collected $0.76 from pot
Boolik414: doesn't show hand 
*** SUMMARY ***
Total pot $0.80 | Rake $0.04 
Board [Kh 7d Jd]
Seat 1: FreshMcClean (small blind) folded before Flop
Seat 2: vlfrm (big blind) folded on the Flop
Seat 3: Boolik414 collected ($0.76)
Seat 4: zizou_11 folded on the Flop
Seat 5: Lumbojack folded before Flop (didn't bet)
Seat 6: droog318 (button) folded before Flop (didn't bet)



PokerStars Hand #222969191169:  Hold'em No Limit ($0.05/$0.10 USD) - 2021/01/23 15:26:50 ET
Table 'Jihlava III' 6-max Seat #1 is the button
Seat 1: FreshMcClean ($14.50 in chips) 
Seat 2: vlfrm ($10 in chips) 
Seat 3: Boolik414 ($18.35 in chips) 
Seat 4: zizou_11 ($13.49 in chips) 
Seat 6: droog318 ($11.07 in chips) 
vlfrm: posts small blind $0.05
Boolik414: posts big blind $0.10
*** HOLE CARDS ***
zizou_11: folds 
droog318: folds 
FreshMcClean: folds 
vlfrm: raises $0.15 to $0.25
Boolik414: folds 
Uncalled bet ($0.15) returned to vlfrm
vlfrm collected $0.20 from pot
vlfrm: doesn't show hand 
*** SUMMARY ***
Total pot $0.20 | Rake $0 
Seat 1: FreshMcClean (button) folded before Flop (didn't bet)
Seat 2: vlfrm (small blind) collected ($0.20)
Seat 3: Boolik414 (big blind) folded before Flop
Seat 4: zizou_11 folded before Flop (didn't bet)
Seat 6: droog318 folded before Flop (didn't bet)



PokerStars Hand #222969208727:  Hold'em No Limit ($0.05/$0.10 USD) - 2021/01/23 15:27:11 ET
Table 'Jihlava III' 6-max Seat #2 is the button
Seat 1: FreshMcClean ($14.50 in chips) 
Seat 2: vlfrm ($10.10 in chips) 
Seat 3: Boolik414 ($18.25 in chips) 
Seat 4: zizou_11 ($13.49 in chips) 
Seat 6: droog318 ($11.07 in chips) 
Boolik414: posts small blind $0.05
zizou_11: posts big blind $0.10
*** HOLE CARDS ***
droog318: folds 
FreshMcClean: folds 
vlfrm: raises $0.15 to $0.25
Boolik414: folds 
zizou_11: folds 
Uncalled bet ($0.15) returned to vlfrm
vlfrm collected $0.25 from pot
vlfrm: doesn't show hand 
*** SUMMARY ***
Total pot $0.25 | Rake $0 
Seat 1: FreshMcClean folded before Flop (didn't bet)
Seat 2: vlfrm (button) collected ($0.25)
Seat 3: Boolik414 (small blind) folded before Flop
Seat 4: zizou_11 (big blind) folded before Flop
Seat 6: droog318 folded before Flop (didn't bet)



PokerStars Hand #222969236093:  Hold'em No Limit ($0.05/$0.10 USD) - 2021/01/23 15:27:43 ET
Table 'Jihlava III' 6-max Seat #3 is the button
Seat 1: FreshMcClean ($14.50 in chips) 
Seat 2: vlfrm ($10.25 in chips) 
Seat 3: Boolik414 ($18.20 in chips) 
Seat 4: zizou_11 ($13.39 in chips) 
Seat 6: droog318 ($11.07 in chips) 
zizou_11: posts small blind $0.05
droog318: posts big blind $0.10
*** HOLE CARDS ***
FreshMcClean: raises $0.20 to $0.30
vlfrm: folds 
Boolik414: raises $0.20 to $0.50
zizou_11: calls $0.45
droog318: folds 
FreshMcClean: calls $0.20
*** FLOP *** [Jh 4h Qd]
zizou_11: checks 
FreshMcClean: checks 
Boolik414: bets $0.77
zizou_11: folds 
FreshMcClean: folds 
Uncalled bet ($0.77) returned to Boolik414
Boolik414 collected $1.53 from pot
Boolik414: doesn't show hand 
*** SUMMARY ***
Total pot $1.60 | Rake $0.07 
Board [Jh 4h Qd]
Seat 1: FreshMcClean folded on the Flop
Seat 2: vlfrm folded before Flop (didn't bet)
Seat 3: Boolik414 (button) collected ($1.53)
Seat 4: zizou_11 (small blind) folded on the Flop
Seat 6: droog318 (big blind) folded before Flop



PokerStars Hand #222969302577:  Hold'em No Limit ($0.05/$0.10 USD) - 2021/01/23 15:29:00 ET
Table 'Jihlava III' 6-max Seat #4 is the button
Seat 1: FreshMcClean ($14 in chips) 
Seat 2: vlfrm ($10.25 in chips) 
Seat 3: Boolik414 ($19.23 in chips) 
Seat 4: zizou_11 ($12.89 in chips) 
Seat 6: droog318 ($10.97 in chips) 
droog318: posts small blind $0.05
FreshMcClean: posts big blind $0.10
*** HOLE CARDS ***
vlfrm: folds 
Boolik414: folds 
zizou_11: folds 
droog318: folds 
Uncalled bet ($0.05) returned to FreshMcClean
FreshMcClean collected $0.10 from pot
*** SUMMARY ***
Total pot $0.10 | Rake $0 
Seat 1: FreshMcClean (big blind) collected ($0.10)
Seat 2: vlfrm folded before Flop (didn't bet)
Seat 3: Boolik414 folded before Flop (didn't bet)
Seat 4: zizou_11 (button) folded before Flop (didn't bet)
Seat 6: droog318 (small blind) folded before Flop



PokerStars Hand #222969309008:  Hold'em No Limit ($0.05/$0.10 USD) - 2021/01/23 15:29:07 ET
Table 'Jihlava III' 6-max Seat #6 is the button
Seat 2: vlfrm ($10.25 in chips) 
Seat 3: Boolik414 ($19.23 in chips) 
Seat 4: zizou_11 ($12.89 in chips) 
Seat 6: droog318 ($10.92 in chips) 
vlfrm: posts small blind $0.05
Boolik414: posts big blind $0.10
Lumbojack: sits out 
*** HOLE CARDS ***
zizou_11: raises $0.15 to $0.25
FreshMcClean leaves the table
droog318: folds 
vlfrm: folds 
Boolik414: folds 
Uncalled bet ($0.15) returned to zizou_11
zizou_11 collected $0.25 from pot
zizou_11: doesn't show hand 
*** SUMMARY ***
Total pot $0.25 | Rake $0 
Seat 2: vlfrm (small blind) folded before Flop
Seat 3: Boolik414 (big blind) folded before Flop
Seat 4: zizou_11 collected ($0.25)
Seat 6: droog318 (button) folded before Flop (didn't bet)



PokerStars Hand #222969317253:  Hold'em No Limit ($0.05/$0.10 USD) - 2021/01/23 15:29:17 ET
Table 'Jihlava III' 6-max Seat #2 is the button
Seat 2: vlfrm ($10.20 in chips) 
Seat 3: Boolik414 ($19.13 in chips) 
Seat 4: zizou_11 ($13.04 in chips) 
Seat 6: droog318 ($10.92 in chips) 
Boolik414: posts small blind $0.05
zizou_11: posts big blind $0.10
Lumbojack: sits out 
*** HOLE CARDS ***
droog318: folds 
vlfrm: folds 
Boolik414: folds 
Uncalled bet ($0.05) returned to zizou_11
zizou_11 collected $0.10 from pot
zizou_11: doesn't show hand 
*** SUMMARY ***
Total pot $0.10 | Rake $0 
Seat 2: vlfrm (button) folded before Flop (didn't bet)
Seat 3: Boolik414 (small blind) folded before Flop
Seat 4: zizou_11 (big blind) collected ($0.10)
Seat 6: droog318 folded before Flop (didn't bet)



PokerStars Hand #222969321973:  Hold'em No Limit ($0.05/$0.10 USD) - 2021/01/23 15:29:23 ET
Table 'Jihlava III' 6-max Seat #3 is the button
Seat 2: vlfrm ($10.20 in chips) 
Seat 3: Boolik414 ($19.08 in chips) 
Seat 4: zizou_11 ($13.09 in chips) 
Seat 5: Lumbojack ($9.80 in chips) 
Seat 6: droog318 ($10.92 in chips) 
zizou_11: posts small blind $0.05
Lumbojack: posts big blind $0.10
*** HOLE CARDS ***
droog318: folds 
vlfrm: folds 
Boolik414: raises $0.25 to $0.35
zizou_11: folds 
Lumbojack: folds 
Uncalled bet ($0.25) returned to Boolik414
Boolik414 collected $0.25 from pot
Boolik414: doesn't show hand 
*** SUMMARY ***
Total pot $0.25 | Rake $0 
Seat 2: vlfrm folded before Flop (didn't bet)
Seat 3: Boolik414 (button) collected ($0.25)
Seat 4: zizou_11 (small blind) folded before Flop
Seat 5: Lumbojack (big blind) folded before Flop
Seat 6: droog318 folded before Flop (didn't bet)



PokerStars Hand #222969340048:  Hold'em No Limit ($0.05/$0.10 USD) - 2021/01/23 15:29:44 ET
Table 'Jihlava III' 6-max Seat #4 is the button
Seat 2: vlfrm ($10.20 in chips) 
Seat 3: Boolik414 ($19.23 in chips) 
Seat 4: zizou_11 ($13.04 in chips) 
Seat 5: Lumbojack ($9.70 in chips) 
Seat 6: droog318 ($10.92 in chips) 
Lumbojack: posts small blind $0.05
droog318: posts big blind $0.10
*** HOLE CARDS ***
vlfrm: raises $0.15 to $0.25
Boolik414: folds 
zizou_11: folds 
Lumbojack: folds 
droog318: raises $0.55 to $0.80
vlfrm: calls $0.55
*** FLOP *** [Qc 7c Jd]
droog318: bets $0.80
vlfrm: folds 
Uncalled bet ($0.80) returned to droog318
droog318 collected $1.58 from pot
droog318: doesn't show hand 
*** SUMMARY ***
Total pot $1.65 | Rake $0.07 
Board [Qc 7c Jd]
Seat 2: vlfrm folded on the Flop
Seat 3: Boolik414 folded before Flop (didn't bet)
Seat 4: zizou_11 (button) folded before Flop (didn't bet)
Seat 5: Lumbojack (small blind) folded before Flop
Seat 6: droog318 (big blind) collected ($1.58)



PokerStars Hand #222969370728:  Hold'em No Limit ($0.05/$0.10 USD) - 2021/01/23 15:30:19 ET
Table 'Jihlava III' 6-max Seat #5 is the button
Seat 2: vlfrm ($10 in chips) 
Seat 3: Boolik414 ($19.23 in chips) 
Seat 4: zizou_11 ($13.04 in chips) 
Seat 5: Lumbojack ($9.65 in chips) 
Seat 6: droog318 ($11.70 in chips) 
droog318: posts small blind $0.05
vlfrm: posts big blind $0.10
*** HOLE CARDS ***
ccmf123 joins the table at seat #1 
Boolik414: folds 
zizou_11: raises $0.15 to $0.25
Lumbojack: folds 
droog318: folds 
vlfrm: folds 
Uncalled bet ($0.15) returned to zizou_11
zizou_11 collected $0.25 from pot
zizou_11: doesn't show hand 
*** SUMMARY ***
Total pot $0.25 | Rake $0 
Seat 2: vlfrm (big blind) folded before Flop
Seat 3: Boolik414 folded before Flop (didn't bet)
Seat 4: zizou_11 collected ($0.25)
Seat 5: Lumbojack (button) folded before Flop (didn't bet)
Seat 6: droog318 (small blind) folded before Flop



PokerStars Hand #222969386911:  Hold'em No Limit ($0.05/$0.10 USD) - 2021/01/23 15:30:38 ET
Table 'Jihlava III' 6-max Seat #6 is the button
Seat 2: vlfrm ($10 in chips) 
Seat 3: Boolik414 ($19.23 in chips) 
Seat 4: zizou_11 ($13.19 in chips) 
Seat 5: Lumbojack ($9.65 in chips) 
Seat 6: droog318 ($11.65 in chips) 
vlfrm: posts small blind $0.05
Boolik414: posts big blind $0.10
*** HOLE CARDS ***
zizou_11: folds 
Lumbojack: folds 
droog318: folds 
vlfrm: folds 
Uncalled bet ($0.05) returned to Boolik414
Boolik414 collected $0.10 from pot
Boolik414: doesn't show hand 
*** SUMMARY ***
Total pot $0.10 | Rake $0 
Seat 2: vlfrm (small blind) folded before Flop
Seat 3: Boolik414 (big blind) collected ($0.10)
Seat 4: zizou_11 folded before Flop (didn't bet)
Seat 5: Lumbojack folded before Flop (didn't bet)
Seat 6: droog318 (button) folded before Flop (didn't bet)



PokerStars Hand #222969399150:  Hold'em No Limit ($0.05/$0.10 USD) - 2021/01/23 15:30:52 ET
Table 'Jihlava III' 6-max Seat #2 is the button
Seat 1: ccmf123 ($4.12 in chips) 
Seat 2: vlfrm ($10 in chips) 
Seat 3: Boolik414 ($19.28 in chips) 
Seat 4: zizou_11 ($13.19 in chips) 
Seat 5: Lumbojack ($9.65 in chips) 
Seat 6: droog318 ($11.65 in chips) 
Boolik414: posts small blind $0.05
zizou_11: posts big blind $0.10
ccmf123: posts big blind $0.10
*** HOLE CARDS ***
Lumbojack: folds 
droog318: folds 
ccmf123: checks 
vlfrm: raises $0.30 to $0.40
Boolik414: folds 
zizou_11: folds 
ccmf123: folds 
Uncalled bet ($0.30) returned to vlfrm
vlfrm collected $0.35 from pot
vlfrm: doesn't show hand 
*** SUMMARY ***
Total pot $0.35 | Rake $0 
Seat 1: ccmf123 folded before Flop (didn't bet)
Seat 2: vlfrm (button) collected ($0.35)
Seat 3: Boolik414 (small blind) folded before Flop
Seat 4: zizou_11 (big blind) folded before Flop
Seat 5: Lumbojack folded before Flop (didn't bet)
Seat 6: droog318 folded before Flop (didn't bet)



PokerStars Hand #222969421514:  Hold'em No Limit ($0.05/$0.10 USD) - 2021/01/23 15:31:06 ET
Table 'Jihlava III' 6-max Seat #3 is the button
Seat 1: ccmf123 ($4.02 in chips) 
Seat 2: vlfrm ($10.25 in chips) 
Seat 3: Boolik414 ($19.23 in chips) 
Seat 4: zizou_11 ($13.09 in chips) 
Seat 5: Lumbojack ($9.65 in chips) 
Seat 6: droog318 ($11.65 in chips) 
zizou_11: posts small blind $0.05
Lumbojack: posts big blind $0.10
*** HOLE CARDS ***
droog318: folds 
ccmf123: folds 
vlfrm: folds 
Boolik414: folds 
zizou_11: folds 
Uncalled bet ($0.05) returned to Lumbojack
Lumbojack collected $0.10 from pot
Lumbojack: doesn't show hand 
*** SUMMARY ***
Total pot $0.10 | Rake $0 
Seat 1: ccmf123 folded before Flop (didn't bet)
Seat 2: vlfrm folded before Flop (didn't bet)
Seat 3: Boolik414 (button) folded before Flop (didn't bet)
Seat 4: zizou_11 (small blind) folded before Flop
Seat 5: Lumbojack (big blind) collected ($0.10)
Seat 6: droog318 folded before Flop (didn't bet)



PokerStars Hand #222969434957:  Hold'em No Limit ($0.05/$0.10 USD) - 2021/01/23 15:31:20 ET
Table 'Jihlava III' 6-max Seat #4 is the button
Seat 1: ccmf123 ($4.02 in chips) 
Seat 2: vlfrm ($10.25 in chips) 
Seat 3: Boolik414 ($19.23 in chips) 
Seat 4: zizou_11 ($13.04 in chips) 
Seat 5: Lumbojack ($9.70 in chips) 
Seat 6: droog318 ($11.65 in chips) 
Lumbojack: posts small blind $0.05
droog318: posts big blind $0.10
*** HOLE CARDS ***
ccmf123: folds 
vlfrm: folds 
Boolik414: folds 
zizou_11: folds 
Lumbojack: raises $0.20 to $0.30
droog318: calls $0.20
*** FLOP *** [5d 5s 9h]
Lumbojack: checks 
droog318: bets $0.30
Lumbojack: calls $0.30
*** TURN *** [5d 5s 9h] [5h]
Lumbojack: checks 
droog318: bets $0.70
Lumbojack: calls $0.70
*** RIVER *** [5d 5s 9h 5h] [2d]
Lumbojack: checks 
droog318: bets $1.70
Lumbojack: calls $1.70
*** SHOW DOWN ***
droog318: shows [9s 8s] (a full house, Fives full of Nines)
Lumbojack: shows [9c Tc] (a full house, Fives full of Nines)
Lumbojack collected $2.87 from pot
droog318 collected $2.86 from pot
*** SUMMARY ***
Total pot $6 | Rake $0.27 
Board [5d 5s 9h 5h 2d]
Seat 1: ccmf123 folded before Flop (didn't bet)
Seat 2: vlfrm folded before Flop (didn't bet)
Seat 3: Boolik414 folded before Flop (didn't bet)
Seat 4: zizou_11 (button) folded before Flop (didn't bet)
Seat 5: Lumbojack (small blind) showed [9c Tc] and won ($2.87) with a full house, Fives full of Nines
Seat 6: droog318 (big blind) showed [9s 8s] and won ($2.86) with a full house, Fives full of Nines



PokerStars Hand #222969478694:  Hold'em No Limit ($0.05/$0.10 USD) - 2021/01/23 15:32:11 ET
Table 'Jihlava III' 6-max Seat #5 is the button
Seat 1: ccmf123 ($4.02 in chips) 
Seat 2: vlfrm ($10.25 in chips) 
Seat 3: Boolik414 ($19.23 in chips) 
Seat 4: zizou_11 ($13.04 in chips) 
Seat 5: Lumbojack ($9.57 in chips) 
Seat 6: droog318 ($11.51 in chips) 
droog318: posts small blind $0.05
ccmf123: posts big blind $0.10
*** HOLE CARDS ***
vlfrm: folds 
Boolik414: raises $0.15 to $0.25
zizou_11: folds 
Lumbojack: calls $0.25
droog318: calls $0.20
ccmf123: folds 
*** FLOP *** [4c 6s 8s]
droog318: checks 
Boolik414: bets $0.61
Lumbojack: raises $1.79 to $2.40
droog318: folds 
Boolik414: calls $1.79
*** TURN *** [4c 6s 8s] [Ah]
Boolik414: bets $4.05
Lumbojack: folds 
Uncalled bet ($4.05) returned to Boolik414
Boolik414 collected $5.40 from pot
Boolik414: doesn't show hand 
*** SUMMARY ***
Total pot $5.65 | Rake $0.25 
Board [4c 6s 8s Ah]
Seat 1: ccmf123 (big blind) folded before Flop
Seat 2: vlfrm folded before Flop (didn't bet)
Seat 3: Boolik414 collected ($5.40)
Seat 4: zizou_11 folded before Flop (didn't bet)
Seat 5: Lumbojack (button) folded on the Turn
Seat 6: droog318 (small blind) folded on the Flop



PokerStars Hand #222969568909:  Hold'em No Limit ($0.05/$0.10 USD) - 2021/01/23 15:33:56 ET
Table 'Jihlava III' 6-max Seat #6 is the button
Seat 1: ccmf123 ($3.92 in chips) 
Seat 2: vlfrm ($10.25 in chips) 
Seat 3: Boolik414 ($21.98 in chips) 
Seat 4: zizou_11 ($13.04 in chips) 
Seat 5: Lumbojack ($10 in chips) 
Seat 6: droog318 ($11.26 in chips) 
ccmf123: posts small blind $0.05
vlfrm: posts big blind $0.10
*** HOLE CARDS ***
Boolik414: raises $0.15 to $0.25
zizou_11: folds 
Lumbojack: folds 
droog318: raises $0.65 to $0.90
ccmf123: calls $0.85
vlfrm: folds 
Boolik414: calls $0.65
*** FLOP *** [3d Jd 5d]
ccmf123: checks 
Boolik414: bets $2
droog318: calls $2
ccmf123: folds 
*** TURN *** [3d Jd 5d] [8h]
Boolik414: bets $3.25
droog318: raises $5.11 to $8.36 and is all-in
Boolik414: calls $5.11
*** RIVER *** [3d Jd 5d 8h] [4h]
*** SHOW DOWN ***
Boolik414: shows [5h 5s] (three of a kind, Fives)
droog318: shows [Jh Kd] (a pair of Jacks)
Boolik414 collected $22.46 from pot
*** SUMMARY ***
Total pot $23.52 | Rake $1.06 
Board [3d Jd 5d 8h 4h]
Seat 1: ccmf123 (small blind) folded on the Flop
Seat 2: vlfrm (big blind) folded before Flop
Seat 3: Boolik414 showed [5h 5s] and won ($22.46) with three of a kind, Fives
Seat 4: zizou_11 folded before Flop (didn't bet)
Seat 5: Lumbojack folded before Flop (didn't bet)
Seat 6: droog318 (button) showed [Jh Kd] and lost with a pair of Jacks



PokerStars Hand #222969692884:  Hold'em No Limit ($0.05/$0.10 USD) - 2021/01/23 15:36:19 ET
Table 'Jihlava III' 6-max Seat #1 is the button
Seat 1: ccmf123 ($3.02 in chips) 
Seat 2: vlfrm ($10.15 in chips) 
Seat 3: Boolik414 ($33.18 in chips) 
Seat 4: zizou_11 ($13.04 in chips) 
Seat 5: Lumbojack ($10 in chips) 
Seat 6: droog318 ($10 in chips) 
vlfrm: posts small blind $0.05
Boolik414: posts big blind $0.10
*** HOLE CARDS ***
zizou_11: folds 
Lumbojack: folds 
droog318: folds 
ccmf123: folds 
vlfrm: folds 
Uncalled bet ($0.05) returned to Boolik414
Boolik414 collected $0.10 from pot
Boolik414: doesn't show hand 
*** SUMMARY ***
Total pot $0.10 | Rake $0 
Seat 1: ccmf123 (button) folded before Flop (didn't bet)
Seat 2: vlfrm (small blind) folded before Flop
Seat 3: Boolik414 (big blind) collected ($0.10)
Seat 4: zizou_11 folded before Flop (didn't bet)
Seat 5: Lumbojack folded before Flop (didn't bet)
Seat 6: droog318 folded before Flop (didn't bet)



PokerStars Hand #222969706583:  Hold'em No Limit ($0.05/$0.10 USD) - 2021/01/23 15:36:35 ET
Table 'Jihlava III' 6-max Seat #2 is the button
Seat 1: ccmf123 ($3.02 in chips) 
Seat 2: vlfrm ($10.10 in chips) 
Seat 3: Boolik414 ($33.23 in chips) 
Seat 4: zizou_11 ($13.04 in chips) 
Seat 5: Lumbojack ($10 in chips) 
Seat 6: droog318 ($10 in chips) 
Boolik414: posts small blind $0.05
zizou_11: posts big blind $0.10
*** HOLE CARDS ***
Lumbojack: folds 
droog318: folds 
ccmf123: calls $0.10
vlfrm: folds 
Boolik414: raises $0.25 to $0.35
zizou_11: folds 
ccmf123: folds 
Uncalled bet ($0.25) returned to Boolik414
Boolik414 collected $0.30 from pot
Boolik414: doesn't show hand 
*** SUMMARY ***
Total pot $0.30 | Rake $0 
Seat 1: ccmf123 folded before Flop
Seat 2: vlfrm (button) folded before Flop (didn't bet)
Seat 3: Boolik414 (small blind) collected ($0.30)
Seat 4: zizou_11 (big blind) folded before Flop
Seat 5: Lumbojack folded before Flop (didn't bet)
Seat 6: droog318 folded before Flop (didn't bet)



PokerStars Hand #222969736496:  Hold'em No Limit ($0.05/$0.10 USD) - 2021/01/23 15:37:10 ET
Table 'Jihlava III' 6-max Seat #3 is the button
Seat 1: ccmf123 ($2.92 in chips) 
Seat 2: vlfrm ($10.10 in chips) 
Seat 3: Boolik414 ($33.43 in chips) 
Seat 4: zizou_11 ($12.94 in chips) 
Seat 5: Lumbojack ($10 in chips) 
Seat 6: droog318 ($10 in chips) 
zizou_11: posts small blind $0.05
Lumbojack: posts big blind $0.10
*** HOLE CARDS ***
droog318: raises $0.20 to $0.30
ccmf123: calls $0.30
vlfrm: folds 
Boolik414: calls $0.30
zizou_11: folds 
Lumbojack: folds 
*** FLOP *** [Ah 4c 6h]
droog318: bets $0.60
ccmf123: folds 
Boolik414: calls $0.60
*** TURN *** [Ah 4c 6h] [Kh]
droog318: bets $1.40
Boolik414: folds 
Uncalled bet ($1.40) returned to droog318
droog318 collected $2.15 from pot
droog318: doesn't show hand 
*** SUMMARY ***
Total pot $2.25 | Rake $0.10 
Board [Ah 4c 6h Kh]
Seat 1: ccmf123 folded on the Flop
Seat 2: vlfrm folded before Flop (didn't bet)
Seat 3: Boolik414 (button) folded on the Turn
Seat 4: zizou_11 (small blind) folded before Flop
Seat 5: Lumbojack (big blind) folded before Flop
Seat 6: droog318 collected ($2.15)



PokerStars Hand #222969800739:  Hold'em No Limit ($0.05/$0.10 USD) - 2021/01/23 15:38:25 ET
Table 'Jihlava III' 6-max Seat #4 is the button
Seat 1: ccmf123 ($2.62 in chips) 
Seat 2: vlfrm ($10.10 in chips) 
Seat 3: Boolik414 ($32.53 in chips) 
Seat 4: zizou_11 ($12.89 in chips) 
Seat 5: Lumbojack ($9.90 in chips) 
Seat 6: droog318 ($11.25 in chips) 
Lumbojack: posts small blind $0.05
droog318: posts big blind $0.10
*** HOLE CARDS ***
ccmf123: folds 
vlfrm: folds 
Boolik414: folds 
zizou_11: folds 
Lumbojack: folds 
Uncalled bet ($0.05) returned to droog318
droog318 collected $0.10 from pot
droog318: doesn't show hand 
*** SUMMARY ***
Total pot $0.10 | Rake $0 
Seat 1: ccmf123 folded before Flop (didn't bet)
Seat 2: vlfrm folded before Flop (didn't bet)
Seat 3: Boolik414 folded before Flop (didn't bet)
Seat 4: zizou_11 (button) folded before Flop (didn't bet)
Seat 5: Lumbojack (small blind) folded before Flop
Seat 6: droog318 (big blind) collected ($0.10)



PokerStars Hand #222969823330:  Hold'em No Limit ($0.05/$0.10 USD) - 2021/01/23 15:38:44 ET
Table 'Jihlava III' 6-max Seat #5 is the button
Seat 1: ccmf123 ($2.62 in chips) 
Seat 2: vlfrm ($10.10 in chips) 
Seat 3: Boolik414 ($32.53 in chips) 
Seat 4: zizou_11 ($12.89 in chips) 
Seat 5: Lumbojack ($9.85 in chips) 
Seat 6: droog318 ($11.30 in chips) 
droog318: posts small blind $0.05
ccmf123: posts big blind $0.10
*** HOLE CARDS ***
vlfrm: raises $0.15 to $0.25
Boolik414: folds 
zizou_11: folds 
Lumbojack: folds 
droog318: folds 
ccmf123: calls $0.15
*** FLOP *** [Ac 7d Td]
ccmf123: checks 
vlfrm: bets $0.17
ccmf123: folds 
Uncalled bet ($0.17) returned to vlfrm
vlfrm collected $0.53 from pot
vlfrm: doesn't show hand 
*** SUMMARY ***
Total pot $0.55 | Rake $0.02 
Board [Ac 7d Td]
Seat 1: ccmf123 (big blind) folded on the Flop
Seat 2: vlfrm collected ($0.53)
Seat 3: Boolik414 folded before Flop (didn't bet)
Seat 4: zizou_11 folded before Flop (didn't bet)
Seat 5: Lumbojack (button) folded before Flop (didn't bet)
Seat 6: droog318 (small blind) folded before Flop



PokerStars Hand #222969838280:  Hold'em No Limit ($0.05/$0.10 USD) - 2021/01/23 15:39:01 ET
Table 'Jihlava III' 6-max Seat #6 is the button
Seat 1: ccmf123 ($2.37 in chips) 
Seat 2: vlfrm ($10.38 in chips) 
Seat 3: Boolik414 ($32.53 in chips) 
Seat 4: zizou_11 ($12.89 in chips) 
Seat 5: Lumbojack ($9.85 in chips) 
Seat 6: droog318 ($11.25 in chips) 
ccmf123: posts small blind $0.05
vlfrm: posts big blind $0.10
*** HOLE CARDS ***
Boolik414: folds 
zizou_11: folds 
Lumbojack: folds 
droog318: raises $0.20 to $0.30
ccmf123: folds 
vlfrm: calls $0.20
*** FLOP *** [Qs 8d Jc]
vlfrm: checks 
droog318: checks 
*** TURN *** [Qs 8d Jc] [As]
vlfrm: checks 
droog318: bets $0.31
vlfrm: calls $0.31
*** RIVER *** [Qs 8d Jc As] [Qd]
vlfrm: checks 
droog318: bets $0.70
vlfrm: folds 
Uncalled bet ($0.70) returned to droog318
droog318 collected $1.21 from pot
droog318: doesn't show hand 
*** SUMMARY ***
Total pot $1.27 | Rake $0.06 
Board [Qs 8d Jc As Qd]
Seat 1: ccmf123 (small blind) folded before Flop
Seat 2: vlfrm (big blind) folded on the River
Seat 3: Boolik414 folded before Flop (didn't bet)
Seat 4: zizou_11 folded before Flop (didn't bet)
Seat 5: Lumbojack folded before Flop (didn't bet)
Seat 6: droog318 (button) collected ($1.21)



PokerStars Hand #222969883641:  Hold'em No Limit ($0.05/$0.10 USD) - 2021/01/23 15:39:55 ET
Table 'Jihlava III' 6-max Seat #1 is the button
Seat 1: ccmf123 ($2.32 in chips) 
Seat 2: vlfrm ($10 in chips) 
Seat 3: Boolik414 ($32.53 in chips) 
Seat 4: zizou_11 ($12.89 in chips) 
Seat 5: Lumbojack ($9.85 in chips) 
Seat 6: droog318 ($11.85 in chips) 
vlfrm: posts small blind $0.05
Boolik414: posts big blind $0.10
*** HOLE CARDS ***
zizou_11: folds 
Lumbojack: folds 
droog318: folds 
ccmf123: calls $0.10
vlfrm: calls $0.05
Boolik414: checks 
*** FLOP *** [Qh 9d Th]
vlfrm: checks 
Boolik414: checks 
ccmf123: checks 
*** TURN *** [Qh 9d Th] [5d]
vlfrm: checks 
Boolik414: bets $0.22
ccmf123: folds 
vlfrm: folds 
Uncalled bet ($0.22) returned to Boolik414
Boolik414 collected $0.29 from pot
Boolik414: doesn't show hand 
*** SUMMARY ***
Total pot $0.30 | Rake $0.01 
Board [Qh 9d Th 5d]
Seat 1: ccmf123 (button) folded on the Turn
Seat 2: vlfrm (small blind) folded on the Turn
Seat 3: Boolik414 (big blind) collected ($0.29)
Seat 4: zizou_11 folded before Flop (didn't bet)
Seat 5: Lumbojack folded before Flop (didn't bet)
Seat 6: droog318 folded before Flop (didn't bet)



PokerStars Hand #222969937055:  Hold'em No Limit ($0.05/$0.10 USD) - 2021/01/23 15:40:58 ET
Table 'Jihlava III' 6-max Seat #2 is the button
Seat 1: ccmf123 ($2.22 in chips) 
Seat 2: vlfrm ($10 in chips) 
Seat 3: Boolik414 ($32.72 in chips) 
Seat 4: zizou_11 ($12.89 in chips) 
Seat 5: Lumbojack ($9.85 in chips) 
Seat 6: droog318 ($11.85 in chips) 
Boolik414: posts small blind $0.05
zizou_11: posts big blind $0.10
*** HOLE CARDS ***
Lumbojack: folds 
droog318: folds 
ccmf123: folds 
vlfrm: folds 
Boolik414: raises $0.25 to $0.35
zizou_11: calls $0.25
*** FLOP *** [9s Ac 5h]
Boolik414: bets $0.34
zizou_11: calls $0.34
*** TURN *** [9s Ac 5h] [2d]
Boolik414: checks 
zizou_11: bets $0.92
Boolik414: folds 
Uncalled bet ($0.92) returned to zizou_11
zizou_11 collected $1.32 from pot
zizou_11: doesn't show hand 
*** SUMMARY ***
Total pot $1.38 | Rake $0.06 
Board [9s Ac 5h 2d]
Seat 1: ccmf123 folded before Flop (didn't bet)
Seat 2: vlfrm (button) folded before Flop (didn't bet)
Seat 3: Boolik414 (small blind) folded on the Turn
Seat 4: zizou_11 (big blind) collected ($1.32)
Seat 5: Lumbojack folded before Flop (didn't bet)
Seat 6: droog318 folded before Flop (didn't bet)



PokerStars Hand #222969990869:  Hold'em No Limit ($0.05/$0.10 USD) - 2021/01/23 15:42:02 ET
Table 'Jihlava III' 6-max Seat #3 is the button
Seat 1: ccmf123 ($2.22 in chips) 
Seat 2: vlfrm ($10 in chips) 
Seat 3: Boolik414 ($32.03 in chips) 
Seat 4: zizou_11 ($13.52 in chips) 
Seat 5: Lumbojack ($9.85 in chips) 
Seat 6: droog318 ($11.85 in chips) 
zizou_11: posts small blind $0.05
Lumbojack: posts big blind $0.10
*** HOLE CARDS ***
droog318: folds 
ccmf123: calls $0.10
vlfrm: raises $0.40 to $0.50
Boolik414: calls $0.50
zizou_11: folds 
Lumbojack: folds 
ccmf123: calls $0.40
*** FLOP *** [2c 5c 6h]
ccmf123: checks 
vlfrm: checks 
Boolik414: bets $0.79
ccmf123: calls $0.79
vlfrm: folds 
*** TURN *** [2c 5c 6h] [Js]
ccmf123: bets $0.93 and is all-in
Boolik414: calls $0.93
*** RIVER *** [2c 5c 6h Js] [Ks]
*** SHOW DOWN ***
ccmf123: shows [7h 8h] (high card King)
Boolik414: shows [Th Jd] (a pair of Jacks)
Boolik414 collected $4.86 from pot
*** SUMMARY ***
Total pot $5.09 | Rake $0.23 
Board [2c 5c 6h Js Ks]
Seat 1: ccmf123 showed [7h 8h] and lost with high card King
Seat 2: vlfrm folded on the Flop
Seat 3: Boolik414 (button) showed [Th Jd] and won ($4.86) with a pair of Jacks
Seat 4: zizou_11 (small blind) folded before Flop
Seat 5: Lumbojack (big blind) folded before Flop
Seat 6: droog318 folded before Flop (didn't bet)



PokerStars Hand #222970052085:  Hold'em No Limit ($0.05/$0.10 USD) - 2021/01/23 15:43:15 ET
Table 'Jihlava III' 6-max Seat #4 is the button
Seat 2: vlfrm ($10 in chips) 
Seat 3: Boolik414 ($34.67 in chips) 
Seat 4: zizou_11 ($13.47 in chips) 
Seat 5: Lumbojack ($9.75 in chips) 
Seat 6: droog318 ($11.85 in chips) 
Lumbojack: posts small blind $0.05
droog318: posts big blind $0.10
*** HOLE CARDS ***
vlfrm: folds 
ccmf123 leaves the table
Boolik414: raises $0.25 to $0.35
zizou_11: folds 
Lumbojack: raises $1.05 to $1.40
droog318: folds 
19991986830 joins the table at seat #1 
Boolik414: calls $1.05
*** FLOP *** [7c 4d 5h]
Lumbojack: checks 
Boolik414: checks 
*** TURN *** [7c 4d 5h] [3h]
Lumbojack: checks 
Boolik414: checks 
*** RIVER *** [7c 4d 5h 3h] [2h]
Lumbojack: checks 
Boolik414: bets $1.39
Lumbojack: calls $1.39
*** SHOW DOWN ***
Boolik414: shows [8h Ah] (a flush, Ace high)
Lumbojack: mucks hand 
Boolik414 collected $5.42 from pot
*** SUMMARY ***
Total pot $5.68 | Rake $0.26 
Board [7c 4d 5h 3h 2h]
Seat 2: vlfrm folded before Flop (didn't bet)
Seat 3: Boolik414 showed [8h Ah] and won ($5.42) with a flush, Ace high
Seat 4: zizou_11 (button) folded before Flop (didn't bet)
Seat 5: Lumbojack (small blind) mucked
Seat 6: droog318 (big blind) folded before Flop



PokerStars Hand #222970138762:  Hold'em No Limit ($0.05/$0.10 USD) - 2021/01/23 15:44:58 ET
Table 'Jihlava III' 6-max Seat #5 is the button
Seat 1: 19991986830 ($10 in chips) 
Seat 2: vlfrm ($10 in chips) 
Seat 3: Boolik414 ($37.30 in chips) 
Seat 4: zizou_11 ($13.47 in chips) 
Seat 5: Lumbojack ($10 in chips) 
Seat 6: droog318 ($11.75 in chips) 
droog318: posts small blind $0.05
19991986830: posts big blind $0.10
*** HOLE CARDS ***
vlfrm: folds 
Boolik414: folds 
zizou_11: folds 
Lumbojack: raises $0.20 to $0.30
droog318: folds 
19991986830: calls $0.20
*** FLOP *** [4d 8c 5h]
19991986830: checks 
Lumbojack: checks 
*** TURN *** [4d 8c 5h] [7d]
19991986830: checks 
Lumbojack: bets $0.40
19991986830: calls $0.40
*** RIVER *** [4d 8c 5h 7d] [4s]
19991986830: checks 
Lumbojack: checks 
*** SHOW DOWN ***
19991986830: shows [Jh 6d] (a straight, Four to Eight)
Lumbojack: mucks hand 
19991986830 collected $1.38 from pot
*** SUMMARY ***
Total pot $1.45 | Rake $0.07 
Board [4d 8c 5h 7d 4s]
Seat 1: 19991986830 (big blind) showed [Jh 6d] and won ($1.38) with a straight, Four to Eight
Seat 2: vlfrm folded before Flop (didn't bet)
Seat 3: Boolik414 folded before Flop (didn't bet)
Seat 4: zizou_11 folded before Flop (didn't bet)
Seat 5: Lumbojack (button) mucked
Seat 6: droog318 (small blind) folded before Flop



PokerStars Hand #222970191723:  Hold'em No Limit ($0.05/$0.10 USD) - 2021/01/23 15:46:01 ET
Table 'Jihlava III' 6-max Seat #6 is the button
Seat 1: 19991986830 ($10.68 in chips) 
Seat 3: Boolik414 ($37.30 in chips) 
Seat 4: zizou_11 ($13.47 in chips) 
Seat 5: Lumbojack ($9.30 in chips) 
Seat 6: droog318 ($11.70 in chips) 
19991986830: posts small blind $0.05
vlfrm: is sitting out 
Boolik414: posts big blind $0.10
*** HOLE CARDS ***
vlfrm leaves the table
zizou_11: folds 
kingquebe joins the table at seat #2 
Lumbojack: raises $0.15 to $0.25
droog318: folds 
19991986830: folds 
Boolik414: calls $0.15
*** FLOP *** [Jd 9s Jc]
Boolik414: checks 
Lumbojack: checks 
*** TURN *** [Jd 9s Jc] [Js]
Boolik414: checks 
Lumbojack: checks 
*** RIVER *** [Jd 9s Jc Js] [2s]
Boolik414: checks 
Lumbojack: checks 
*** SHOW DOWN ***
Boolik414: shows [8c 3c] (three of a kind, Jacks)
Lumbojack: shows [2d 2c] (a full house, Jacks full of Deuces)
Lumbojack collected $0.53 from pot
*** SUMMARY ***
Total pot $0.55 | Rake $0.02 
Board [Jd 9s Jc Js 2s]
Seat 1: 19991986830 (small blind) folded before Flop
Seat 3: Boolik414 (big blind) showed [8c 3c] and lost with three of a kind, Jacks
Seat 4: zizou_11 folded before Flop (didn't bet)
Seat 5: Lumbojack showed [2d 2c] and won ($0.53) with a full house, Jacks full of Deuces
Seat 6: droog318 (button) folded before Flop (didn't bet)



PokerStars Hand #222970244407:  Hold'em No Limit ($0.05/$0.10 USD) - 2021/01/23 15:47:04 ET
Table 'Jihlava III' 6-max Seat #1 is the button
Seat 1: 19991986830 ($10.63 in chips) 
Seat 3: Boolik414 ($37.05 in chips) 
Seat 4: zizou_11 ($13.47 in chips) 
Seat 5: Lumbojack ($9.58 in chips) 
Seat 6: droog318 ($11.70 in chips) 
Boolik414: posts small blind $0.05
zizou_11: posts big blind $0.10
*** HOLE CARDS ***
Lumbojack: folds 
droog318: folds 
19991986830: calls $0.10
Boolik414: calls $0.05
zizou_11: checks 
*** FLOP *** [2c Qd Ah]
Boolik414: checks 
zizou_11: checks 
19991986830: checks 
*** TURN *** [2c Qd Ah] [Jd]
Boolik414: checks 
zizou_11: bets $0.20
19991986830: folds 
Boolik414: calls $0.20
*** RIVER *** [2c Qd Ah Jd] [6h]
Boolik414: checks 
zizou_11: checks 
*** SHOW DOWN ***
Boolik414: shows [4d 2d] (a pair of Deuces)
zizou_11: shows [Ac 3c] (a pair of Aces)
zizou_11 collected $0.67 from pot
*** SUMMARY ***
Total pot $0.70 | Rake $0.03 
Board [2c Qd Ah Jd 6h]
Seat 1: 19991986830 (button) folded on the Turn
Seat 3: Boolik414 (small blind) showed [4d 2d] and lost with a pair of Deuces
Seat 4: zizou_11 (big blind) showed [Ac 3c] and won ($0.67) with a pair of Aces
Seat 5: Lumbojack folded before Flop (didn't bet)
Seat 6: droog318 folded before Flop (didn't bet)



PokerStars Hand #222970308371:  Hold'em No Limit ($0.05/$0.10 USD) - 2021/01/23 15:48:21 ET
Table 'Jihlava III' 6-max Seat #3 is the button
Seat 1: 19991986830 ($10.53 in chips) 
Seat 2: kingquebe ($10 in chips) 
Seat 3: Boolik414 ($36.75 in chips) 
Seat 4: zizou_11 ($13.84 in chips) 
Seat 5: Lumbojack ($9.58 in chips) 
Seat 6: droog318 ($11.70 in chips) 
zizou_11: posts small blind $0.05
Lumbojack: posts big blind $0.10
kingquebe: posts big blind $0.10
*** HOLE CARDS ***
droog318: folds 
19991986830: calls $0.10
kingquebe: checks 
Boolik414: folds 
zizou_11: folds 
Lumbojack: checks 
*** FLOP *** [5h 9h Ah]
Lumbojack: checks 
19991986830: checks 
kingquebe: checks 
*** TURN *** [5h 9h Ah] [Kh]
Lumbojack: bets $0.60
19991986830: folds 
kingquebe: folds 
Uncalled bet ($0.60) returned to Lumbojack
Lumbojack collected $0.33 from pot
Lumbojack: doesn't show hand 
*** SUMMARY ***
Total pot $0.35 | Rake $0.02 
Board [5h 9h Ah Kh]
Seat 1: 19991986830 folded on the Turn
Seat 2: kingquebe folded on the Turn (didn't bet)
Seat 3: Boolik414 (button) folded before Flop (didn't bet)
Seat 4: zizou_11 (small blind) folded before Flop
Seat 5: Lumbojack (big blind) collected ($0.33)
Seat 6: droog318 folded before Flop (didn't bet)



PokerStars Hand #222970335921:  Hold'em No Limit ($0.05/$0.10 USD) - 2021/01/23 15:48:54 ET
Table 'Jihlava III' 6-max Seat #4 is the button
Seat 1: 19991986830 ($10.43 in chips) 
Seat 2: kingquebe ($9.90 in chips) 
Seat 3: Boolik414 ($36.75 in chips) 
Seat 4: zizou_11 ($13.79 in chips) 
Seat 5: Lumbojack ($9.81 in chips) 
Seat 6: droog318 ($11.70 in chips) 
Lumbojack: posts small blind $0.05
droog318: posts big blind $0.10
*** HOLE CARDS ***
19991986830: raises $0.10 to $0.20
kingquebe: folds 
Boolik414: raises $0.38 to $0.58
zizou_11: folds 
Lumbojack: folds 
droog318: folds 
19991986830: calls $0.38
*** FLOP *** [Qd 9d Td]
19991986830: checks 
Boolik414: bets $0.94
19991986830: folds 
Uncalled bet ($0.94) returned to Boolik414
Boolik414 collected $1.25 from pot
Boolik414: doesn't show hand 
*** SUMMARY ***
Total pot $1.31 | Rake $0.06 
Board [Qd 9d Td]
Seat 1: 19991986830 folded on the Flop
Seat 2: kingquebe folded before Flop (didn't bet)
Seat 3: Boolik414 collected ($1.25)
Seat 4: zizou_11 (button) folded before Flop (didn't bet)
Seat 5: Lumbojack (small blind) folded before Flop
Seat 6: droog318 (big blind) folded before Flop



PokerStars Hand #222970401918:  Hold'em No Limit ($0.05/$0.10 USD) - 2021/01/23 15:50:13 ET
Table 'Jihlava III' 6-max Seat #5 is the button
Seat 1: 19991986830 ($9.85 in chips) 
Seat 2: kingquebe ($9.90 in chips) 
Seat 3: Boolik414 ($37.42 in chips) 
Seat 4: zizou_11 ($13.79 in chips) 
Seat 5: Lumbojack ($9.76 in chips) 
Seat 6: droog318 ($11.60 in chips) 
droog318: posts small blind $0.05
19991986830: posts big blind $0.10
*** HOLE CARDS ***
kingquebe: raises $0.20 to $0.30
Boolik414: calls $0.30
zizou_11: folds 
Lumbojack: folds 
droog318: raises $1 to $1.30
19991986830: folds 
kingquebe: calls $1
Boolik414: calls $1
*** FLOP *** [7c 2c 4s]
droog318: bets $2.30
kingquebe: folds 
Boolik414: calls $2.30
*** TURN *** [7c 2c 4s] [6s]
droog318: checks 
Boolik414: checks 
*** RIVER *** [7c 2c 4s 6s] [3h]
droog318: bets $8 and is all-in
Boolik414: calls $8
*** SHOW DOWN ***
droog318: shows [Ks Ah] (high card Ace)
Boolik414: shows [9c 9d] (a pair of Nines)
Boolik414 collected $23.49 from pot
*** SUMMARY ***
Total pot $24.60 | Rake $1.11 
Board [7c 2c 4s 6s 3h]
Seat 1: 19991986830 (big blind) folded before Flop
Seat 2: kingquebe folded on the Flop
Seat 3: Boolik414 showed [9c 9d] and won ($23.49) with a pair of Nines
Seat 4: zizou_11 folded before Flop (didn't bet)
Seat 5: Lumbojack (button) folded before Flop (didn't bet)
Seat 6: droog318 (small blind) showed [Ks Ah] and lost with high card Ace



PokerStars Hand #222970512561:  Hold'em No Limit ($0.05/$0.10 USD) - 2021/01/23 15:52:26 ET
Table 'Jihlava III' 6-max Seat #6 is the button
Seat 1: 19991986830 ($9.75 in chips) 
Seat 2: kingquebe ($8.60 in chips) 
Seat 3: Boolik414 ($49.31 in chips) 
Seat 4: zizou_11 ($13.79 in chips) 
Seat 5: Lumbojack ($9.76 in chips) 
Seat 6: droog318 ($10 in chips) 
19991986830: posts small blind $0.05
kingquebe: posts big blind $0.10
*** HOLE CARDS ***
Boolik414: raises $0.15 to $0.25
zizou_11 has timed out
zizou_11: folds 
Lumbojack: folds 
droog318: folds 
19991986830: folds 
kingquebe: calls $0.15
*** FLOP *** [8d 3c 6h]
kingquebe: bets $0.10
Boolik414: raises $0.37 to $0.47
kingquebe: calls $0.37
*** TURN *** [8d 3c 6h] [Ah]
kingquebe: checks 
Boolik414: checks 
*** RIVER *** [8d 3c 6h Ah] [Kh]
kingquebe: bets $0.71
Boolik414: folds 
Uncalled bet ($0.71) returned to kingquebe
kingquebe collected $1.42 from pot
kingquebe: doesn't show hand 
*** SUMMARY ***
Total pot $1.49 | Rake $0.07 
Board [8d 3c 6h Ah Kh]
Seat 1: 19991986830 (small blind) folded before Flop
Seat 2: kingquebe (big blind) collected ($1.42)
Seat 3: Boolik414 folded on the River
Seat 4: zizou_11 folded before Flop (didn't bet)
Seat 5: Lumbojack folded before Flop (didn't bet)
Seat 6: droog318 (button) folded before Flop (didn't bet)



PokerStars Hand #222970587995:  Hold'em No Limit ($0.05/$0.10 USD) - 2021/01/23 15:53:56 ET
Table 'Jihlava III' 6-max Seat #1 is the button
Seat 1: 19991986830 ($9.70 in chips) 
Seat 2: kingquebe ($9.30 in chips) 
Seat 3: Boolik414 ($48.59 in chips) 
Seat 5: Lumbojack ($9.76 in chips) 
Seat 6: droog318 ($10 in chips) 
kingquebe: posts small blind $0.05
Boolik414: posts big blind $0.10
*** HOLE CARDS ***
Lumbojack: folds 
droog318: folds 
19991986830: raises $0.20 to $0.30
kingquebe: folds 
Boolik414: calls $0.20
*** FLOP *** [Ks Qc Qd]
Boolik414: checks 
19991986830: checks 
*** TURN *** [Ks Qc Qd] [Jc]
Boolik414: bets $0.31
19991986830: folds 
Uncalled bet ($0.31) returned to Boolik414
Boolik414 collected $0.62 from pot
Boolik414: doesn't show hand 
*** SUMMARY ***
Total pot $0.65 | Rake $0.03 
Board [Ks Qc Qd Jc]
Seat 1: 19991986830 (button) folded on the Turn
Seat 2: kingquebe (small blind) folded before Flop
Seat 3: Boolik414 (big blind) collected ($0.62)
Seat 5: Lumbojack folded before Flop (didn't bet)
Seat 6: droog318 folded before Flop (didn't bet)



PokerStars Hand #222970631035:  Hold'em No Limit ($0.05/$0.10 USD) - 2021/01/23 15:54:48 ET
Table 'Jihlava III' 6-max Seat #2 is the button
Seat 1: 19991986830 ($9.40 in chips) 
Seat 2: kingquebe ($9.25 in chips) 
Seat 3: Boolik414 ($48.91 in chips) 
Seat 5: Lumbojack ($9.76 in chips) 
Seat 6: droog318 ($10 in chips) 
Boolik414: posts small blind $0.05
Lumbojack: posts big blind $0.10
*** HOLE CARDS ***
droog318: folds 
19991986830: folds 
kingquebe: calls $0.10
Boolik414: calls $0.05
Lumbojack: checks 
*** FLOP *** [Qh Js 3h]
Boolik414: checks 
Lumbojack: checks 
kingquebe: checks 
*** TURN *** [Qh Js 3h] [7c]
Boolik414: checks 
Lumbojack: checks 
kingquebe: checks 
*** RIVER *** [Qh Js 3h 7c] [8h]
Boolik414: bets $0.22
Lumbojack: calls $0.22
kingquebe: folds 
*** SHOW DOWN ***
Boolik414: shows [6c 8d] (a pair of Eights)
Lumbojack: shows [8c 7d] (two pair, Eights and Sevens)
Lumbojack collected $0.71 from pot
*** SUMMARY ***
Total pot $0.74 | Rake $0.03 
Board [Qh Js 3h 7c 8h]
Seat 1: 19991986830 folded before Flop (didn't bet)
Seat 2: kingquebe (button) folded on the River
Seat 3: Boolik414 (small blind) showed [6c 8d] and lost with a pair of Eights
Seat 5: Lumbojack (big blind) showed [8c 7d] and won ($0.71) with two pair, Eights and Sevens
Seat 6: droog318 folded before Flop (didn't bet)



PokerStars Hand #222970669151:  Hold'em No Limit ($0.05/$0.10 USD) - 2021/01/23 15:55:47 ET
Table 'Jihlava III' 6-max Seat #3 is the button
Seat 1: 19991986830 ($9.40 in chips) 
Seat 2: kingquebe ($9.15 in chips) 
Seat 3: Boolik414 ($48.59 in chips) 
Seat 5: Lumbojack ($10.15 in chips) 
Seat 6: droog318 ($10 in chips) 
Lumbojack: posts small blind $0.05
droog318: posts big blind $0.10
*** HOLE CARDS ***
19991986830: raises $0.20 to $0.30
kingquebe: calls $0.30
Boolik414: folds 
Lumbojack: folds 
droog318: folds 
*** FLOP *** [Kh 8s Js]
19991986830: checks 
kingquebe: bets $0.72
19991986830: folds 
Uncalled bet ($0.72) returned to kingquebe
kingquebe collected $0.72 from pot
kingquebe: doesn't show hand 
*** SUMMARY ***
Total pot $0.75 | Rake $0.03 
Board [Kh 8s Js]
Seat 1: 19991986830 folded on the Flop
Seat 2: kingquebe collected ($0.72)
Seat 3: Boolik414 (button) folded before Flop (didn't bet)
Seat 5: Lumbojack (small blind) folded before Flop
Seat 6: droog318 (big blind) folded before Flop



PokerStars Hand #222970689282:  Hold'em No Limit ($0.05/$0.10 USD) - 2021/01/23 15:56:14 ET
Table 'Jihlava III' 6-max Seat #5 is the button
Seat 1: 19991986830 ($9.10 in chips) 
Seat 2: kingquebe ($9.57 in chips) 
Seat 3: Boolik414 ($48.59 in chips) 
Seat 5: Lumbojack ($10.10 in chips) 
Seat 6: droog318 ($10 in chips) 
droog318: posts small blind $0.05
19991986830: posts big blind $0.10
*** HOLE CARDS ***
kingquebe: calls $0.10
Boolik414: folds 
Lumbojack: folds 
droog318: calls $0.05
19991986830: checks 
*** FLOP *** [2d Ad 3c]
droog318: checks 
19991986830: checks 
kingquebe: checks 
*** TURN *** [2d Ad 3c] [Jd]
droog318: checks 
19991986830: bets $0.20
kingquebe: folds 
droog318: folds 
Uncalled bet ($0.20) returned to 19991986830
19991986830 collected $0.29 from pot
*** SUMMARY ***
Total pot $0.30 | Rake $0.01 
Board [2d Ad 3c Jd]
Seat 1: 19991986830 (big blind) collected ($0.29)
Seat 2: kingquebe folded on the Turn
Seat 3: Boolik414 folded before Flop (didn't bet)
Seat 5: Lumbojack (button) folded before Flop (didn't bet)
Seat 6: droog318 (small blind) folded on the Turn



PokerStars Hand #222970714023:  Hold'em No Limit ($0.05/$0.10 USD) - 2021/01/23 15:56:57 ET
Table 'Jihlava III' 6-max Seat #6 is the button
Seat 1: 19991986830 ($9.29 in chips) 
Seat 2: kingquebe ($9.47 in chips) 
Seat 3: Boolik414 ($48.59 in chips) 
Seat 5: Lumbojack ($10.10 in chips) 
Seat 6: droog318 ($10 in chips) 
19991986830: posts small blind $0.05
kingquebe: posts big blind $0.10
*** HOLE CARDS ***
Boolik414: raises $0.15 to $0.25
Lumbojack: folds 
droog318: folds 
19991986830: calls $0.20
kingquebe: folds 
*** FLOP *** [4c Kd Kc]
19991986830: checks 
Boolik414: bets $0.43
19991986830: calls $0.43
*** TURN *** [4c Kd Kc] [7c]
19991986830: checks 
Boolik414: bets $1.04
19991986830: calls $1.04
*** RIVER *** [4c Kd Kc 7c] [8h]
19991986830: checks 
Boolik414: bets $2.54
19991986830: folds 
Uncalled bet ($2.54) returned to Boolik414
Boolik414 collected $3.38 from pot
Boolik414: doesn't show hand 
*** SUMMARY ***
Total pot $3.54 | Rake $0.16 
Board [4c Kd Kc 7c 8h]
Seat 1: 19991986830 (small blind) folded on the River
Seat 2: kingquebe (big blind) folded before Flop
Seat 3: Boolik414 collected ($3.38)
Seat 5: Lumbojack folded before Flop (didn't bet)
Seat 6: droog318 (button) folded before Flop (didn't bet)



PokerStars Hand #222970770951:  Hold'em No Limit ($0.05/$0.10 USD) - 2021/01/23 15:58:38 ET
Table 'Jihlava III' 6-max Seat #1 is the button
Seat 1: 19991986830 ($7.57 in chips) 
Seat 2: kingquebe ($9.37 in chips) 
Seat 3: Boolik414 ($50.25 in chips) 
Seat 5: Lumbojack ($10.10 in chips) 
Seat 6: droog318 ($10 in chips) 
kingquebe: posts small blind $0.05
Boolik414: posts big blind $0.10
*** HOLE CARDS ***
Lumbojack: raises $0.15 to $0.25
droog318: folds 
19991986830: calls $0.25
kingquebe: calls $0.20
Boolik414: calls $0.15
*** FLOP *** [8d 8c As]
kingquebe: checks 
Boolik414: checks 
Lumbojack: checks 
19991986830: checks 
*** TURN *** [8d 8c As] [Qs]
kingquebe: checks 
Boolik414: bets $0.29
Lumbojack: folds 
19991986830: folds 
kingquebe: folds 
Uncalled bet ($0.29) returned to Boolik414
Boolik414 collected $0.96 from pot
Boolik414: doesn't show hand 
*** SUMMARY ***
Total pot $1 | Rake $0.04 
Board [8d 8c As Qs]
Seat 1: 19991986830 (button) folded on the Turn
Seat 2: kingquebe (small blind) folded on the Turn
Seat 3: Boolik414 (big blind) collected ($0.96)
Seat 5: Lumbojack folded on the Turn
Seat 6: droog318 folded before Flop (didn't bet)



PokerStars Hand #222970798338:  Hold'em No Limit ($0.05/$0.10 USD) - 2021/01/23 15:59:26 ET
Table 'Jihlava III' 6-max Seat #2 is the button
Seat 1: 19991986830 ($8.17 in chips) 
Seat 2: kingquebe ($9.12 in chips) 
Seat 3: Boolik414 ($50.96 in chips) 
Seat 5: Lumbojack ($9.85 in chips) 
Seat 6: droog318 ($10 in chips) 
Boolik414: posts small blind $0.05
Lumbojack: posts big blind $0.10
*** HOLE CARDS ***
droog318: folds 
19991986830: raises $0.20 to $0.30
kingquebe: calls $0.30
Boolik414: folds 
Lumbojack: raises $0.90 to $1.20
19991986830: folds 
kingquebe: calls $0.90
*** FLOP *** [7d Qs Ah]
Lumbojack: bets $1.37
kingquebe: raises $1.37 to $2.74
Lumbojack: folds 
Uncalled bet ($1.37) returned to kingquebe
kingquebe collected $5.24 from pot
kingquebe: doesn't show hand 
*** SUMMARY ***
Total pot $5.49 | Rake $0.25 
Board [7d Qs Ah]
Seat 1: 19991986830 folded before Flop
Seat 2: kingquebe (button) collected ($5.24)
Seat 3: Boolik414 (small blind) folded before Flop
Seat 5: Lumbojack (big blind) folded on the Flop
Seat 6: droog318 folded before Flop (didn't bet)



PokerStars Hand #222970825816:  Hold'em No Limit ($0.05/$0.10 USD) - 2021/01/23 16:00:13 ET
Table 'Jihlava III' 6-max Seat #3 is the button
Seat 1: 19991986830 ($7.87 in chips) 
Seat 2: kingquebe ($11.79 in chips) 
Seat 3: Boolik414 ($50.91 in chips) 
Seat 5: Lumbojack ($10 in chips) 
Seat 6: droog318 ($10 in chips) 
Lumbojack: posts small blind $0.05
droog318: posts big blind $0.10
*** HOLE CARDS ***
19991986830: raises $0.20 to $0.30
kingquebe: calls $0.30
Boolik414: folds 
Lumbojack: folds 
droog318: folds 
*** FLOP *** [Ac Ks 4s]
19991986830: checks 
kingquebe: bets $0.36
19991986830: folds 
Uncalled bet ($0.36) returned to kingquebe
kingquebe collected $0.72 from pot
kingquebe: doesn't show hand 
*** SUMMARY ***
Total pot $0.75 | Rake $0.03 
Board [Ac Ks 4s]
Seat 1: 19991986830 folded on the Flop
Seat 2: kingquebe collected ($0.72)
Seat 3: Boolik414 (button) folded before Flop (didn't bet)
Seat 5: Lumbojack (small blind) folded before Flop
Seat 6: droog318 (big blind) folded before Flop



PokerStars Hand #222970846648:  Hold'em No Limit ($0.05/$0.10 USD) - 2021/01/23 16:00:46 ET
Table 'Jihlava III' 6-max Seat #5 is the button
Seat 1: 19991986830 ($7.57 in chips) 
Seat 2: kingquebe ($12.21 in chips) 
Seat 3: Boolik414 ($50.91 in chips) 
Seat 5: Lumbojack ($9.95 in chips) 
Seat 6: droog318 ($10 in chips) 
droog318: posts small blind $0.05
19991986830: posts big blind $0.10
*** HOLE CARDS ***
kingquebe: calls $0.10
Boolik414: folds 
Lumbojack: folds 
droog318: folds 
19991986830: raises $0.20 to $0.30
kingquebe: calls $0.20
*** FLOP *** [4h 8c 8s]
19991986830: checks 
kingquebe: checks 
*** TURN *** [4h 8c 8s] [Jh]
19991986830: checks 
kingquebe: checks 
*** RIVER *** [4h 8c 8s Jh] [7h]
19991986830: bets $0.31
kingquebe: folds 
Uncalled bet ($0.31) returned to 19991986830
19991986830 collected $0.62 from pot
*** SUMMARY ***
Total pot $0.65 | Rake $0.03 
Board [4h 8c 8s Jh 7h]
Seat 1: 19991986830 (big blind) collected ($0.62)
Seat 2: kingquebe folded on the River
Seat 3: Boolik414 folded before Flop (didn't bet)
Seat 5: Lumbojack (button) folded before Flop (didn't bet)
Seat 6: droog318 (small blind) folded before Flop



PokerStars Hand #222970876188:  Hold'em No Limit ($0.05/$0.10 USD) - 2021/01/23 16:01:30 ET
Table 'Jihlava III' 6-max Seat #6 is the button
Seat 1: 19991986830 ($7.89 in chips) 
Seat 2: kingquebe ($11.91 in chips) 
Seat 3: Boolik414 ($50.91 in chips) 
Seat 5: Lumbojack ($9.95 in chips) 
Seat 6: droog318 ($10 in chips) 
19991986830: posts small blind $0.05
kingquebe: posts big blind $0.10
*** HOLE CARDS ***
Boolik414: folds 
Lumbojack: folds 
droog318: folds 
19991986830: raises $0.30 to $0.40
kingquebe: calls $0.30
*** FLOP *** [Ac 4h 7d]
19991986830: checks 
kingquebe: bets $0.38
19991986830: calls $0.38
*** TURN *** [Ac 4h 7d] [Tc]
19991986830: checks 
kingquebe: checks 
*** RIVER *** [Ac 4h 7d Tc] [Jc]
19991986830: checks 
kingquebe: bets $0.50
19991986830: raises $0.50 to $1
kingquebe: calls $0.50
*** SHOW DOWN ***
19991986830: shows [Kh Qd] (a straight, Ten to Ace)
kingquebe: mucks hand 
19991986830 collected $3.40 from pot
*** SUMMARY ***
Total pot $3.56 | Rake $0.16 
Board [Ac 4h 7d Tc Jc]
Seat 1: 19991986830 (small blind) showed [Kh Qd] and won ($3.40) with a straight, Ten to Ace
Seat 2: kingquebe (big blind) mucked
Seat 3: Boolik414 folded before Flop (didn't bet)
Seat 5: Lumbojack folded before Flop (didn't bet)
Seat 6: droog318 (button) folded before Flop (didn't bet)



PokerStars Hand #222970920507:  Hold'em No Limit ($0.05/$0.10 USD) - 2021/01/23 16:02:28 ET
Table 'Jihlava III' 6-max Seat #1 is the button
Seat 1: 19991986830 ($9.51 in chips) 
Seat 2: kingquebe ($10.13 in chips) 
Seat 3: Boolik414 ($50.91 in chips) 
Seat 5: Lumbojack ($9.95 in chips) 
Seat 6: droog318 ($10 in chips) 
kingquebe: posts small blind $0.05
Boolik414: posts big blind $0.10
*** HOLE CARDS ***
Lumbojack: folds 
droog318: folds 
19991986830: raises $0.10 to $0.20
kingquebe: calls $0.15
Boolik414: folds 
*** FLOP *** [9c Jc 2c]
kingquebe: checks 
19991986830: bets $0.10
kingquebe: folds 
Uncalled bet ($0.10) returned to 19991986830
19991986830 collected $0.48 from pot
*** SUMMARY ***
Total pot $0.50 | Rake $0.02 
Board [9c Jc 2c]
Seat 1: 19991986830 (button) collected ($0.48)
Seat 2: kingquebe (small blind) folded on the Flop
Seat 3: Boolik414 (big blind) folded before Flop
Seat 5: Lumbojack folded before Flop (didn't bet)
Seat 6: droog318 folded before Flop (didn't bet)



PokerStars Hand #222970938815:  Hold'em No Limit ($0.05/$0.10 USD) - 2021/01/23 16:02:51 ET
Table 'Jihlava III' 6-max Seat #2 is the button
Seat 1: 19991986830 ($9.79 in chips) 
Seat 2: kingquebe ($9.93 in chips) 
Seat 3: Boolik414 ($50.81 in chips) 
Seat 5: Lumbojack ($9.95 in chips) 
Seat 6: droog318 ($10 in chips) 
Boolik414: posts small blind $0.05
Lumbojack: posts big blind $0.10
*** HOLE CARDS ***
droog318: folds 
19991986830: folds 
kingquebe: folds 
Boolik414: folds 
Uncalled bet ($0.05) returned to Lumbojack
Lumbojack collected $0.10 from pot
Lumbojack: doesn't show hand 
*** SUMMARY ***
Total pot $0.10 | Rake $0 
Seat 1: 19991986830 folded before Flop (didn't bet)
Seat 2: kingquebe (button) folded before Flop (didn't bet)
Seat 3: Boolik414 (small blind) folded before Flop
Seat 5: Lumbojack (big blind) collected ($0.10)
Seat 6: droog318 folded before Flop (didn't bet)



PokerStars Hand #222970945991:  Hold'em No Limit ($0.05/$0.10 USD) - 2021/01/23 16:02:59 ET
Table 'Jihlava III' 6-max Seat #3 is the button
Seat 1: 19991986830 ($9.79 in chips) 
Seat 2: kingquebe ($9.93 in chips) 
Seat 3: Boolik414 ($50.76 in chips) 
Seat 5: Lumbojack ($10 in chips) 
Seat 6: droog318 ($10 in chips) 
Lumbojack: posts small blind $0.05
droog318: posts big blind $0.10
*** HOLE CARDS ***
19991986830: folds 
kingquebe: folds 
Boolik414: raises $0.25 to $0.35
Lumbojack: folds 
droog318: folds 
Uncalled bet ($0.25) returned to Boolik414
Boolik414 collected $0.25 from pot
Boolik414: doesn't show hand 
*** SUMMARY ***
Total pot $0.25 | Rake $0 
Seat 1: 19991986830 folded before Flop (didn't bet)
Seat 2: kingquebe folded before Flop (didn't bet)
Seat 3: Boolik414 (button) collected ($0.25)
Seat 5: Lumbojack (small blind) folded before Flop
Seat 6: droog318 (big blind) folded before Flop



PokerStars Hand #222970964894:  Hold'em No Limit ($0.05/$0.10 USD) - 2021/01/23 16:03:23 ET
Table 'Jihlava III' 6-max Seat #5 is the button
Seat 1: 19991986830 ($9.79 in chips) 
Seat 2: kingquebe ($9.93 in chips) 
Seat 3: Boolik414 ($50.91 in chips) 
Seat 5: Lumbojack ($9.95 in chips) 
Seat 6: droog318 ($10 in chips) 
droog318: posts small blind $0.05
19991986830: posts big blind $0.10
*** HOLE CARDS ***
kingquebe: raises $0.10 to $0.20
Boolik414: calls $0.20
Lumbojack: folds 
droog318: calls $0.15
19991986830: raises $0.30 to $0.50
kingquebe: calls $0.30
Boolik414: calls $0.30
droog318: calls $0.30
*** FLOP *** [Kh 2d Th]
droog318: checks 
19991986830: checks 
kingquebe: bets $0.60
Boolik414: calls $0.60
droog318: folds 
19991986830: calls $0.60
*** TURN *** [Kh 2d Th] [4h]
19991986830: checks 
kingquebe: checks 
Boolik414: bets $1.82
19991986830: calls $1.82
kingquebe: folds 
*** RIVER *** [Kh 2d Th 4h] [Ah]
19991986830: checks 
Boolik414: bets $2.13
19991986830: calls $2.13
*** SHOW DOWN ***
Boolik414: shows [Jh Qd] (a flush, Ace high)
19991986830: mucks hand 
Boolik414 collected $11.17 from pot
*** SUMMARY ***
Total pot $11.70 | Rake $0.53 
Board [Kh 2d Th 4h Ah]
Seat 1: 19991986830 (big blind) mucked
Seat 2: kingquebe folded on the Turn
Seat 3: Boolik414 showed [Jh Qd] and won ($11.17) with a flush, Ace high
Seat 5: Lumbojack (button) folded before Flop (didn't bet)
Seat 6: droog318 (small blind) folded on the Flop



PokerStars Hand #222971071225:  Hold'em No Limit ($0.05/$0.10 USD) - 2021/01/23 16:05:31 ET
Table 'Jihlava III' 6-max Seat #6 is the button
Seat 1: 19991986830 ($4.74 in chips) 
Seat 2: kingquebe ($8.83 in chips) 
Seat 3: Boolik414 ($57.03 in chips) 
Seat 5: Lumbojack ($9.95 in chips) 
Seat 6: droog318 ($10 in chips) 
19991986830: posts small blind $0.05
kingquebe: posts big blind $0.10
*** HOLE CARDS ***
Boolik414: folds 
Lumbojack: raises $0.15 to $0.25
droog318: folds 
19991986830: raises $0.15 to $0.40
kingquebe: folds 
Lumbojack: calls $0.15
*** FLOP *** [7s As Qh]
19991986830: checks 
Lumbojack: checks 
*** TURN *** [7s As Qh] [3s]
19991986830: checks 
Lumbojack: bets $0.45
19991986830: calls $0.45
*** RIVER *** [7s As Qh 3s] [4c]
19991986830: checks 
Lumbojack: bets $1.20
19991986830: calls $1.20
*** SHOW DOWN ***
Lumbojack: shows [Kd Jc] (high card Ace)
19991986830: shows [3d Qs] (two pair, Queens and Threes)
19991986830 collected $4.01 from pot
*** SUMMARY ***
Total pot $4.20 | Rake $0.19 
Board [7s As Qh 3s 4c]
Seat 1: 19991986830 (small blind) showed [3d Qs] and won ($4.01) with two pair, Queens and Threes
Seat 2: kingquebe (big blind) folded before Flop
Seat 3: Boolik414 folded before Flop (didn't bet)
Seat 5: Lumbojack showed [Kd Jc] and lost with high card Ace
Seat 6: droog318 (button) folded before Flop (didn't bet)



PokerStars Hand #222971109362:  Hold'em No Limit ($0.05/$0.10 USD) - 2021/01/23 16:06:16 ET
Table 'Jihlava III' 6-max Seat #1 is the button
Seat 1: 19991986830 ($6.70 in chips) 
Seat 2: kingquebe ($8.73 in chips) 
Seat 3: Boolik414 ($57.03 in chips) 
Seat 5: Lumbojack ($10 in chips) 
Seat 6: droog318 ($10 in chips) 
kingquebe: posts small blind $0.05
Boolik414: posts big blind $0.10
*** HOLE CARDS ***
Lumbojack: folds 
droog318: folds 
19991986830: calls $0.10
kingquebe: calls $0.05
Boolik414: checks 
*** FLOP *** [4s Jh 8c]
kingquebe: checks 
Boolik414: checks 
19991986830: checks 
*** TURN *** [4s Jh 8c] [9c]
kingquebe: bets $0.10
Boolik414: folds 
19991986830: calls $0.10
*** RIVER *** [4s Jh 8c 9c] [Kd]
kingquebe: bets $0.24
19991986830: folds 
Uncalled bet ($0.24) returned to kingquebe
kingquebe collected $0.48 from pot
kingquebe: doesn't show hand 
*** SUMMARY ***
Total pot $0.50 | Rake $0.02 
Board [4s Jh 8c 9c Kd]
Seat 1: 19991986830 (button) folded on the River
Seat 2: kingquebe (small blind) collected ($0.48)
Seat 3: Boolik414 (big blind) folded on the Turn
Seat 5: Lumbojack folded before Flop (didn't bet)
Seat 6: droog318 folded before Flop (didn't bet)



PokerStars Hand #222971165667:  Hold'em No Limit ($0.05/$0.10 USD) - 2021/01/23 16:07:24 ET
Table 'Jihlava III' 6-max Seat #2 is the button
Seat 1: 19991986830 ($6.50 in chips) 
Seat 2: kingquebe ($9.01 in chips) 
Seat 3: Boolik414 ($56.93 in chips) 
Seat 5: Lumbojack ($10 in chips) 
Seat 6: droog318 ($10 in chips) 
Boolik414: posts small blind $0.05
Lumbojack: posts big blind $0.10
*** HOLE CARDS ***
droog318: folds 
19991986830: folds 
kingquebe: raises $0.25 to $0.35
Boolik414: folds 
Lumbojack: folds 
Uncalled bet ($0.25) returned to kingquebe
kingquebe collected $0.25 from pot
zizou_11 was removed from the table for failing to post
zizou_11 leaves the table
kingquebe: doesn't show hand 
*** SUMMARY ***
Total pot $0.25 | Rake $0 
Seat 1: 19991986830 folded before Flop (didn't bet)
Seat 2: kingquebe (button) collected ($0.25)
Seat 3: Boolik414 (small blind) folded before Flop
Seat 5: Lumbojack (big blind) folded before Flop
Seat 6: droog318 folded before Flop (didn't bet)



PokerStars Hand #222971179255:  Hold'em No Limit ($0.05/$0.10 USD) - 2021/01/23 16:07:40 ET
Table 'Jihlava III' 6-max Seat #3 is the button
Seat 1: 19991986830 ($6.50 in chips) 
Seat 2: kingquebe ($9.16 in chips) 
Seat 3: Boolik414 ($56.88 in chips) 
Seat 5: Lumbojack ($9.90 in chips) 
Seat 6: droog318 ($10 in chips) 
Lumbojack: posts small blind $0.05
droog318: posts big blind $0.10
*** HOLE CARDS ***
Nodrik joins the table at seat #4 
19991986830: raises $0.20 to $0.30
kingquebe: folds 
Boolik414: calls $0.30
Lumbojack: folds 
droog318: raises $0.95 to $1.25
19991986830: folds 
Boolik414: folds 
Uncalled bet ($0.95) returned to droog318
droog318 collected $0.95 from pot
droog318: doesn't show hand 
*** SUMMARY ***
Total pot $0.95 | Rake $0 
Seat 1: 19991986830 folded before Flop
Seat 2: kingquebe folded before Flop (didn't bet)
Seat 3: Boolik414 (button) folded before Flop
Seat 5: Lumbojack (small blind) folded before Flop
Seat 6: droog318 (big blind) collected ($0.95)



PokerStars Hand #222971219604:  Hold'em No Limit ($0.05/$0.10 USD) - 2021/01/23 16:08:29 ET
Table 'Jihlava III' 6-max Seat #5 is the button
Seat 1: 19991986830 ($6.20 in chips) 
Seat 2: kingquebe ($9.16 in chips) 
Seat 3: Boolik414 ($56.58 in chips) 
Seat 5: Lumbojack ($9.85 in chips) 
Seat 6: droog318 ($10.65 in chips) 
droog318: posts small blind $0.05
19991986830: posts big blind $0.10
Nodrik: sits out 
*** HOLE CARDS ***
kingquebe: raises $0.10 to $0.20
Boolik414: folds 
Lumbojack: raises $0.50 to $0.70
droog318: calls $0.65
19991986830: calls $0.60
kingquebe: calls $0.50
*** FLOP *** [Qd 2d 3h]
droog318: checks 
19991986830: checks 
kingquebe: checks 
Lumbojack: bets $2
droog318: folds 
19991986830: folds 
kingquebe: folds 
Uncalled bet ($2) returned to Lumbojack
Lumbojack collected $2.67 from pot
Lumbojack: doesn't show hand 
*** SUMMARY ***
Total pot $2.80 | Rake $0.13 
Board [Qd 2d 3h]
Seat 1: 19991986830 (big blind) folded on the Flop
Seat 2: kingquebe folded on the Flop
Seat 3: Boolik414 folded before Flop (didn't bet)
Seat 5: Lumbojack (button) collected ($2.67)
Seat 6: droog318 (small blind) folded on the Flop



PokerStars Hand #222971255835:  Hold'em No Limit ($0.05/$0.10 USD) - 2021/01/23 16:09:12 ET
Table 'Jihlava III' 6-max Seat #6 is the button
Seat 1: 19991986830 ($5.50 in chips) 
Seat 2: kingquebe ($8.46 in chips) 
Seat 3: Boolik414 ($56.58 in chips) 
Seat 5: Lumbojack ($11.82 in chips) 
Seat 6: droog318 ($10 in chips) 
19991986830: posts small blind $0.05
kingquebe: posts big blind $0.10
Nodrik: sits out 
*** HOLE CARDS ***
Boolik414: raises $0.15 to $0.25
Lumbojack: folds 
droog318: folds 
19991986830: folds 
kingquebe: calls $0.15
*** FLOP *** [As Tc Ad]
kingquebe: bets $0.26
Boolik414: calls $0.26
*** TURN *** [As Tc Ad] [4h]
kingquebe: checks 
Boolik414: bets $0.31
kingquebe: folds 
Uncalled bet ($0.31) returned to Boolik414
Boolik414 collected $1.02 from pot
Boolik414: doesn't show hand 
*** SUMMARY ***
Total pot $1.07 | Rake $0.05 
Board [As Tc Ad 4h]
Seat 1: 19991986830 (small blind) folded before Flop
Seat 2: kingquebe (big blind) folded on the Turn
Seat 3: Boolik414 collected ($1.02)
Seat 5: Lumbojack folded before Flop (didn't bet)
Seat 6: droog318 (button) folded before Flop (didn't bet)



PokerStars Hand #222971303391:  Hold'em No Limit ($0.05/$0.10 USD) - 2021/01/23 16:10:10 ET
Table 'Jihlava III' 6-max Seat #1 is the button
Seat 1: 19991986830 ($5.45 in chips) 
Seat 2: kingquebe ($7.95 in chips) 
Seat 3: Boolik414 ($57.09 in chips) 
Seat 5: Lumbojack ($11.82 in chips) 
Seat 6: droog318 ($10 in chips) 
kingquebe: posts small blind $0.05
Boolik414: posts big blind $0.10
Nodrik: sits out 
*** HOLE CARDS ***
Lumbojack: raises $0.15 to $0.25
droog318: folds 
19991986830: folds 
kingquebe: calls $0.20
Boolik414: folds 
*** FLOP *** [4s Jh Kd]
kingquebe: bets $0.10
Lumbojack: raises $0.20 to $0.30
kingquebe: raises $0.20 to $0.50
Lumbojack: calls $0.20
*** TURN *** [4s Jh Kd] [9c]
kingquebe: checks 
Lumbojack: bets $1
kingquebe: calls $1
*** RIVER *** [4s Jh Kd 9c] [8c]
kingquebe: checks 
Lumbojack: checks 
*** SHOW DOWN ***
kingquebe: shows [Kc 7c] (a pair of Kings)
Lumbojack: shows [Ad Kh] (a pair of Kings - Ace kicker)
Lumbojack collected $3.44 from pot
*** SUMMARY ***
Total pot $3.60 | Rake $0.16 
Board [4s Jh Kd 9c 8c]
Seat 1: 19991986830 (button) folded before Flop (didn't bet)
Seat 2: kingquebe (small blind) showed [Kc 7c] and lost with a pair of Kings
Seat 3: Boolik414 (big blind) folded before Flop
Seat 5: Lumbojack showed [Ad Kh] and won ($3.44) with a pair of Kings
Seat 6: droog318 folded before Flop (didn't bet)



PokerStars Hand #222971351696:  Hold'em No Limit ($0.05/$0.10 USD) - 2021/01/23 16:11:07 ET
Table 'Jihlava III' 6-max Seat #2 is the button
Seat 1: 19991986830 ($5.45 in chips) 
Seat 2: kingquebe ($6.20 in chips) 
Seat 3: Boolik414 ($56.99 in chips) 
Seat 4: Nodrik ($10 in chips) 
Seat 5: Lumbojack ($13.51 in chips) 
Seat 6: droog318 ($10 in chips) 
Boolik414: posts small blind $0.05
Nodrik: posts big blind $0.10
*** HOLE CARDS ***
Lumbojack: raises $0.15 to $0.25
droog318: folds 
19991986830: raises $0.45 to $0.70
kingquebe: calls $0.70
Boolik414: folds 
Nodrik: calls $0.60
Lumbojack: calls $0.45
*** FLOP *** [Th 5s Ah]
Nodrik: checks 
Lumbojack: checks 
19991986830: bets $1
kingquebe: raises $4.50 to $5.50 and is all-in
Nodrik: folds 
Lumbojack: folds 
19991986830: calls $3.75 and is all-in
Uncalled bet ($0.75) returned to kingquebe
*** TURN *** [Th 5s Ah] [Js]
*** RIVER *** [Th 5s Ah Js] [Ks]
*** SHOW DOWN ***
19991986830: shows [As Qc] (a straight, Ten to Ace)
kingquebe: shows [7h Kh] (a pair of Kings)
19991986830 collected $11.79 from pot
*** SUMMARY ***
Total pot $12.35 | Rake $0.56 
Board [Th 5s Ah Js Ks]
Seat 1: 19991986830 showed [As Qc] and won ($11.79) with a straight, Ten to Ace
Seat 2: kingquebe (button) showed [7h Kh] and lost with a pair of Kings
Seat 3: Boolik414 (small blind) folded before Flop
Seat 4: Nodrik (big blind) folded on the Flop
Seat 5: Lumbojack folded on the Flop
Seat 6: droog318 folded before Flop (didn't bet)



PokerStars Hand #222971396147:  Hold'em No Limit ($0.05/$0.10 USD) - 2021/01/23 16:12:01 ET
Table 'Jihlava III' 6-max Seat #3 is the button
Seat 1: 19991986830 ($11.79 in chips) 
Seat 2: kingquebe ($0.75 in chips) 
Seat 3: Boolik414 ($56.94 in chips) 
Seat 4: Nodrik ($10 in chips) 
Seat 5: Lumbojack ($12.81 in chips) 
Seat 6: droog318 ($10 in chips) 
Nodrik: posts small blind $0.05
Lumbojack: posts big blind $0.10
*** HOLE CARDS ***
droog318: folds 
19991986830: raises $0.40 to $0.50
kingquebe: raises $0.25 to $0.75 and is all-in
Boolik414: folds 
Nodrik: folds 
Lumbojack: raises $1.25 to $2
19991986830: calls $1.50
*** FLOP *** [4h 9s Qs]
Lumbojack: bets $2.40
19991986830: folds 
Uncalled bet ($2.40) returned to Lumbojack
*** TURN *** [4h 9s Qs] [7d]
*** RIVER *** [4h 9s Qs 7d] [3d]
*** SHOW DOWN ***
Lumbojack: shows [4c 5c] (a pair of Fours)
Lumbojack collected $2.38 from side pot
kingquebe: shows [Ac Jd] (high card Ace)
Lumbojack collected $2.20 from main pot
*** SUMMARY ***
Total pot $4.80 Main pot $2.20. Side pot $2.38. | Rake $0.22 
Board [4h 9s Qs 7d 3d]
Seat 1: 19991986830 folded on the Flop
Seat 2: kingquebe showed [Ac Jd] and lost with high card Ace
Seat 3: Boolik414 (button) folded before Flop (didn't bet)
Seat 4: Nodrik (small blind) folded before Flop
Seat 5: Lumbojack (big blind) showed [4c 5c] and won ($4.58) with a pair of Fours
Seat 6: droog318 folded before Flop (didn't bet)



PokerStars Hand #222971450485:  Hold'em No Limit ($0.05/$0.10 USD) - 2021/01/23 16:12:58 ET
Table 'Jihlava III' 6-max Seat #4 is the button
Seat 1: 19991986830 ($9.79 in chips) 
Seat 3: Boolik414 ($56.94 in chips) 
Seat 4: Nodrik ($10 in chips) 
Seat 5: Lumbojack ($15.39 in chips) 
Seat 6: droog318 ($10 in chips) 
Lumbojack: posts small blind $0.05
droog318: posts big blind $0.10
*** HOLE CARDS ***
19991986830: raises $0.40 to $0.50
Boolik414: folds 
Nodrik: folds 
Lumbojack: folds 
droog318: folds 
Uncalled bet ($0.40) returned to 19991986830
19991986830 collected $0.25 from pot
*** SUMMARY ***
Total pot $0.25 | Rake $0 
Seat 1: 19991986830 collected ($0.25)
Seat 3: Boolik414 folded before Flop (didn't bet)
Seat 4: Nodrik (button) folded before Flop (didn't bet)
Seat 5: Lumbojack (small blind) folded before Flop
Seat 6: droog318 (big blind) folded before Flop



PokerStars Hand #222971466734:  Hold'em No Limit ($0.05/$0.10 USD) - 2021/01/23 16:13:17 ET
Table 'Jihlava III' 6-max Seat #5 is the button
Seat 1: 19991986830 ($9.94 in chips) 
Seat 2: kingquebe ($10 in chips) 
Seat 3: Boolik414 ($56.94 in chips) 
Seat 4: Nodrik ($10 in chips) 
Seat 5: Lumbojack ($15.34 in chips) 
Seat 6: droog318 ($10 in chips) 
droog318: posts small blind $0.05
19991986830: posts big blind $0.10
*** HOLE CARDS ***
kingquebe: folds 
Boolik414: raises $0.15 to $0.25
Nodrik: folds 
Lumbojack: folds 
droog318: folds 
19991986830: calls $0.15
*** FLOP *** [Kd 8h 7h]
19991986830: checks 
Boolik414: bets $0.40
19991986830: calls $0.40
*** TURN *** [Kd 8h 7h] [Kc]
19991986830: checks 
Boolik414: bets $0.97
19991986830: calls $0.97
*** RIVER *** [Kd 8h 7h Kc] [2h]
19991986830: checks 
Boolik414: checks 
*** SHOW DOWN ***
19991986830: shows [Kh 3c] (three of a kind, Kings)
Boolik414: mucks hand 
19991986830 collected $3.14 from pot
*** SUMMARY ***
Total pot $3.29 | Rake $0.15 
Board [Kd 8h 7h Kc 2h]
Seat 1: 19991986830 (big blind) showed [Kh 3c] and won ($3.14) with three of a kind, Kings
Seat 2: kingquebe folded before Flop (didn't bet)
Seat 3: Boolik414 mucked
Seat 4: Nodrik folded before Flop (didn't bet)
Seat 5: Lumbojack (button) folded before Flop (didn't bet)
Seat 6: droog318 (small blind) folded before Flop



PokerStars Hand #222971533244:  Hold'em No Limit ($0.05/$0.10 USD) - 2021/01/23 16:14:38 ET
Table 'Jihlava III' 6-max Seat #6 is the button
Seat 1: 19991986830 ($11.46 in chips) 
Seat 2: kingquebe ($10 in chips) 
Seat 3: Boolik414 ($55.32 in chips) 
Seat 4: Nodrik ($10 in chips) 
Seat 5: Lumbojack ($15.34 in chips) 
Seat 6: droog318 ($10 in chips) 
19991986830: posts small blind $0.05
kingquebe: posts big blind $0.10
*** HOLE CARDS ***
Boolik414: raises $0.15 to $0.25
Nodrik: folds 
Lumbojack: folds 
droog318: folds 
19991986830: calls $0.20
kingquebe: calls $0.15
*** FLOP *** [Ks Kd 5h]
19991986830: checks 
kingquebe: checks 
Boolik414: checks 
*** TURN *** [Ks Kd 5h] [9c]
19991986830: bets $0.10
kingquebe: raises $0.10 to $0.20
Boolik414: folds 
19991986830: calls $0.10
*** RIVER *** [Ks Kd 5h 9c] [Ad]
19991986830: checks 
kingquebe: bets $1.10
19991986830: folds [Jh]
Uncalled bet ($1.10) returned to kingquebe
kingquebe collected $1.10 from pot
kingquebe: doesn't show hand 
*** SUMMARY ***
Total pot $1.15 | Rake $0.05 
Board [Ks Kd 5h 9c Ad]
Seat 1: 19991986830 (small blind) folded on the River
Seat 2: kingquebe (big blind) collected ($1.10)
Seat 3: Boolik414 folded on the Turn
Seat 4: Nodrik folded before Flop (didn't bet)
Seat 5: Lumbojack folded before Flop (didn't bet)
Seat 6: droog318 (button) folded before Flop (didn't bet)



PokerStars Hand #222971603002:  Hold'em No Limit ($0.05/$0.10 USD) - 2021/01/23 16:16:00 ET
Table 'Jihlava III' 6-max Seat #1 is the button
Seat 1: 19991986830 ($11.01 in chips) 
Seat 2: kingquebe ($10.65 in chips) 
Seat 3: Boolik414 ($55.07 in chips) 
Seat 4: Nodrik ($10 in chips) 
Seat 5: Lumbojack ($15.34 in chips) 
Seat 6: droog318 ($10 in chips) 
kingquebe: posts small blind $0.05
Boolik414: posts big blind $0.10
*** HOLE CARDS ***
Nodrik: folds 
Lumbojack: folds 
droog318: raises $0.20 to $0.30
19991986830: calls $0.30
kingquebe: calls $0.25
Boolik414: folds 
*** FLOP *** [Qs 4c 5d]
kingquebe: bets $0.48
droog318: folds 
19991986830: calls $0.48
*** TURN *** [Qs 4c 5d] [Jc]
kingquebe: bets $0.93
19991986830: calls $0.93
*** RIVER *** [Qs 4c 5d Jc] [Kd]
kingquebe: bets $1
19991986830: raises $2 to $3
kingquebe: calls $2
*** SHOW DOWN ***
19991986830: shows [Ks 5c] (two pair, Kings and Fives)
kingquebe: mucks hand 
19991986830 collected $9.38 from pot
*** SUMMARY ***
Total pot $9.82 | Rake $0.44 
Board [Qs 4c 5d Jc Kd]
Seat 1: 19991986830 (button) showed [Ks 5c] and won ($9.38) with two pair, Kings and Fives
Seat 2: kingquebe (small blind) mucked
Seat 3: Boolik414 (big blind) folded before Flop
Seat 4: Nodrik folded before Flop (didn't bet)
Seat 5: Lumbojack folded before Flop (didn't bet)
Seat 6: droog318 folded on the Flop



PokerStars Hand #222971669149:  Hold'em No Limit ($0.05/$0.10 USD) - 2021/01/23 16:17:17 ET
Table 'Jihlava III' 6-max Seat #2 is the button
Seat 1: 19991986830 ($15.68 in chips) 
Seat 2: kingquebe ($5.94 in chips) 
Seat 3: Boolik414 ($54.97 in chips) 
Seat 4: Nodrik ($10 in chips) 
Seat 5: Lumbojack ($15.34 in chips) 
Seat 6: droog318 ($10 in chips) 
Boolik414: posts small blind $0.05
Nodrik: posts big blind $0.10
*** HOLE CARDS ***
Lumbojack: folds 
droog318: folds 
19991986830: folds 
kingquebe: folds 
Boolik414: folds 
Uncalled bet ($0.05) returned to Nodrik
Nodrik collected $0.10 from pot
Nodrik: doesn't show hand 
*** SUMMARY ***
Total pot $0.10 | Rake $0 
Seat 1: 19991986830 folded before Flop (didn't bet)
Seat 2: kingquebe (button) folded before Flop (didn't bet)
Seat 3: Boolik414 (small blind) folded before Flop
Seat 4: Nodrik (big blind) collected ($0.10)
Seat 5: Lumbojack folded before Flop (didn't bet)
Seat 6: droog318 folded before Flop (didn't bet)



PokerStars Hand #222971677084:  Hold'em No Limit ($0.05/$0.10 USD) - 2021/01/23 16:17:26 ET
Table 'Jihlava III' 6-max Seat #3 is the button
Seat 1: 19991986830 ($15.68 in chips) 
Seat 2: kingquebe ($5.94 in chips) 
Seat 3: Boolik414 ($54.92 in chips) 
Seat 4: Nodrik ($10.05 in chips) 
Seat 5: Lumbojack ($15.34 in chips) 
Seat 6: droog318 ($10 in chips) 
Nodrik: posts small blind $0.05
Lumbojack: posts big blind $0.10
*** HOLE CARDS ***
droog318: folds 
19991986830: raises $0.10 to $0.20
kingquebe: folds 
kingquebe leaves the table
Boolik414: folds 
Nodrik: folds 
Lumbojack: folds 
Uncalled bet ($0.10) returned to 19991986830
19991986830 collected $0.25 from pot
*** SUMMARY ***
Total pot $0.25 | Rake $0 
Seat 1: 19991986830 collected ($0.25)
Seat 2: kingquebe folded before Flop (didn't bet)
Seat 3: Boolik414 (button) folded before Flop (didn't bet)
Seat 4: Nodrik (small blind) folded before Flop
Seat 5: Lumbojack (big blind) folded before Flop
Seat 6: droog318 folded before Flop (didn't bet)



PokerStars Hand #222971686671:  Hold'em No Limit ($0.05/$0.10 USD) - 2021/01/23 16:17:37 ET
Table 'Jihlava III' 6-max Seat #4 is the button
Seat 1: 19991986830 ($15.83 in chips) 
Seat 3: Boolik414 ($54.92 in chips) 
Seat 4: Nodrik ($10 in chips) 
Seat 5: Lumbojack ($15.24 in chips) 
Seat 6: droog318 ($10 in chips) 
Lumbojack: posts small blind $0.05
droog318: posts big blind $0.10
*** HOLE CARDS ***
19991986830: raises $0.10 to $0.20
Ansjofish joins the table at seat #2 
Boolik414: calls $0.20
Nodrik: folds 
Lumbojack: folds 
droog318: raises $0.80 to $1
19991986830: calls $0.80
Boolik414: calls $0.80
*** FLOP *** [2c 3c 8c]
droog318: bets $1.90
19991986830: folds 
Boolik414: folds 
Uncalled bet ($1.90) returned to droog318
droog318 collected $2.91 from pot
droog318: doesn't show hand 
*** SUMMARY ***
Total pot $3.05 | Rake $0.14 
Board [2c 3c 8c]
Seat 1: 19991986830 folded on the Flop
Seat 3: Boolik414 folded on the Flop
Seat 4: Nodrik (button) folded before Flop (didn't bet)
Seat 5: Lumbojack (small blind) folded before Flop
Seat 6: droog318 (big blind) collected ($2.91)



PokerStars Hand #222971761470:  Hold'em No Limit ($0.05/$0.10 USD) - 2021/01/23 16:19:03 ET
Table 'Jihlava III' 6-max Seat #5 is the button
Seat 1: 19991986830 ($14.83 in chips) 
Seat 3: Boolik414 ($53.92 in chips) 
Seat 4: Nodrik ($10 in chips) 
Seat 5: Lumbojack ($15.19 in chips) 
Seat 6: droog318 ($11.91 in chips) 
droog318: posts small blind $0.05
19991986830: posts big blind $0.10
Ansjofish: sits out 
*** HOLE CARDS ***
Boolik414: folds 
Nodrik: folds 
Lumbojack: raises $0.20 to $0.30
droog318: folds 
19991986830: folds 
Uncalled bet ($0.20) returned to Lumbojack
Lumbojack collected $0.25 from pot
Lumbojack: doesn't show hand 
*** SUMMARY ***
Total pot $0.25 | Rake $0 
Seat 1: 19991986830 (big blind) folded before Flop
Seat 3: Boolik414 folded before Flop (didn't bet)
Seat 4: Nodrik folded before Flop (didn't bet)
Seat 5: Lumbojack (button) collected ($0.25)
Seat 6: droog318 (small blind) folded before Flop



PokerStars Hand #222971780390:  Hold'em No Limit ($0.05/$0.10 USD) - 2021/01/23 16:19:25 ET
Table 'Jihlava III' 6-max Seat #6 is the button
Seat 1: 19991986830 ($14.73 in chips) 
Seat 2: Ansjofish ($10 in chips) 
Seat 3: Boolik414 ($53.92 in chips) 
Seat 4: Nodrik ($10 in chips) 
Seat 5: Lumbojack ($15.34 in chips) 
Seat 6: droog318 ($11.86 in chips) 
19991986830: posts small blind $0.05
Ansjofish: posts big blind $0.10
*** HOLE CARDS ***
Boolik414: folds 
Nodrik: folds 
Lumbojack: folds 
droog318: folds 
19991986830: folds 
Uncalled bet ($0.05) returned to Ansjofish
Ansjofish collected $0.10 from pot
Ansjofish: doesn't show hand 
*** SUMMARY ***
Total pot $0.10 | Rake $0 
Seat 1: 19991986830 (small blind) folded before Flop
Seat 2: Ansjofish (big blind) collected ($0.10)
Seat 3: Boolik414 folded before Flop (didn't bet)
Seat 4: Nodrik folded before Flop (didn't bet)
Seat 5: Lumbojack folded before Flop (didn't bet)
Seat 6: droog318 (button) folded before Flop (didn't bet)



PokerStars Hand #222971791488:  Hold'em No Limit ($0.05/$0.10 USD) - 2021/01/23 16:19:38 ET
Table 'Jihlava III' 6-max Seat #1 is the button
Seat 1: 19991986830 ($14.68 in chips) 
Seat 2: Ansjofish ($10.05 in chips) 
Seat 3: Boolik414 ($53.92 in chips) 
Seat 4: Nodrik ($10 in chips) 
Seat 5: Lumbojack ($15.34 in chips) 
Seat 6: droog318 ($11.86 in chips) 
Ansjofish: posts small blind $0.05
Boolik414: posts big blind $0.10
*** HOLE CARDS ***
Nodrik: folds 
Lumbojack: folds 
droog318: folds 
19991986830: raises $0.20 to $0.30
Ansjofish: folds 
Boolik414: calls $0.20
*** FLOP *** [Qc 2s 7s]
Boolik414: checks 
19991986830: bets $0.62
Boolik414: calls $0.62
*** TURN *** [Qc 2s 7s] [7h]
Boolik414: checks 
19991986830: bets $1.80
Boolik414: folds 
Uncalled bet ($1.80) returned to 19991986830
19991986830 collected $1.80 from pot
*** SUMMARY ***
Total pot $1.89 | Rake $0.09 
Board [Qc 2s 7s 7h]
Seat 1: 19991986830 (button) collected ($1.80)
Seat 2: Ansjofish (small blind) folded before Flop
Seat 3: Boolik414 (big blind) folded on the Turn
Seat 4: Nodrik folded before Flop (didn't bet)
Seat 5: Lumbojack folded before Flop (didn't bet)
Seat 6: droog318 folded before Flop (didn't bet)



PokerStars Hand #222971865019:  Hold'em No Limit ($0.05/$0.10 USD) - 2021/01/23 16:21:04 ET
Table 'Jihlava III' 6-max Seat #2 is the button
Seat 1: 19991986830 ($15.56 in chips) 
Seat 2: Ansjofish ($10 in chips) 
Seat 3: Boolik414 ($53 in chips) 
Seat 4: Nodrik ($10 in chips) 
Seat 5: Lumbojack ($15.34 in chips) 
Seat 6: droog318 ($11.86 in chips) 
Boolik414: posts small blind $0.05
Nodrik: posts big blind $0.10
*** HOLE CARDS ***
Lumbojack: raises $0.15 to $0.25
droog318: folds 
19991986830: folds 
Ansjofish: folds 
Boolik414: folds 
Nodrik: folds 
Uncalled bet ($0.15) returned to Lumbojack
Lumbojack collected $0.25 from pot
Lumbojack: doesn't show hand 
*** SUMMARY ***
Total pot $0.25 | Rake $0 
Seat 1: 19991986830 folded before Flop (didn't bet)
Seat 2: Ansjofish (button) folded before Flop (didn't bet)
Seat 3: Boolik414 (small blind) folded before Flop
Seat 4: Nodrik (big blind) folded before Flop
Seat 5: Lumbojack collected ($0.25)
Seat 6: droog318 folded before Flop (didn't bet)



PokerStars Hand #222971877436:  Hold'em No Limit ($0.05/$0.10 USD) - 2021/01/23 16:21:18 ET
Table 'Jihlava III' 6-max Seat #3 is the button
Seat 1: 19991986830 ($15.56 in chips) 
Seat 2: Ansjofish ($10 in chips) 
Seat 3: Boolik414 ($52.95 in chips) 
Seat 4: Nodrik ($10 in chips) 
Seat 5: Lumbojack ($15.49 in chips) 
Seat 6: droog318 ($11.86 in chips) 
Nodrik: posts small blind $0.05
Lumbojack: posts big blind $0.10
*** HOLE CARDS ***
droog318: folds 
19991986830: folds 
Ansjofish: folds 
Boolik414: raises $0.25 to $0.35
Nodrik: folds 
Lumbojack: folds 
Uncalled bet ($0.25) returned to Boolik414
Boolik414 collected $0.25 from pot
Boolik414: doesn't show hand 
*** SUMMARY ***
Total pot $0.25 | Rake $0 
Seat 1: 19991986830 folded before Flop (didn't bet)
Seat 2: Ansjofish folded before Flop (didn't bet)
Seat 3: Boolik414 (button) collected ($0.25)
Seat 4: Nodrik (small blind) folded before Flop
Seat 5: Lumbojack (big blind) folded before Flop
Seat 6: droog318 folded before Flop (didn't bet)



PokerStars Hand #222971893061:  Hold'em No Limit ($0.05/$0.10 USD) - 2021/01/23 16:21:36 ET
Table 'Jihlava III' 6-max Seat #4 is the button
Seat 1: 19991986830 ($15.56 in chips) 
Seat 2: Ansjofish ($10 in chips) 
Seat 3: Boolik414 ($53.10 in chips) 
Seat 4: Nodrik ($10 in chips) 
Seat 5: Lumbojack ($15.39 in chips) 
Seat 6: droog318 ($11.86 in chips) 
Lumbojack: posts small blind $0.05
droog318: posts big blind $0.10
*** HOLE CARDS ***
19991986830: folds 
Ansjofish: folds 
Boolik414: raises $0.15 to $0.25
Nodrik: folds 
Lumbojack: folds 
droog318: calls $0.15
*** FLOP *** [6h 6s Jc]
droog318: checks 
Boolik414: checks 
*** TURN *** [6h 6s Jc] [3h]
droog318: bets $0.30
Boolik414: folds 
Uncalled bet ($0.30) returned to droog318
droog318 collected $0.53 from pot
droog318: doesn't show hand 
*** SUMMARY ***
Total pot $0.55 | Rake $0.02 
Board [6h 6s Jc 3h]
Seat 1: 19991986830 folded before Flop (didn't bet)
Seat 2: Ansjofish folded before Flop (didn't bet)
Seat 3: Boolik414 folded on the Turn
Seat 4: Nodrik (button) folded before Flop (didn't bet)
Seat 5: Lumbojack (small blind) folded before Flop
Seat 6: droog318 (big blind) collected ($0.53)



PokerStars Hand #222971956550:  Hold'em No Limit ($0.05/$0.10 USD) - 2021/01/23 16:22:50 ET
Table 'Jihlava III' 6-max Seat #5 is the button
Seat 2: Ansjofish ($10 in chips) 
Seat 3: Boolik414 ($52.85 in chips) 
Seat 4: Nodrik ($10 in chips) 
Seat 5: Lumbojack ($15.34 in chips) 
Seat 6: droog318 ($12.14 in chips) 
droog318: posts small blind $0.05
Ansjofish: posts big blind $0.10
*** HOLE CARDS ***
Boolik414: folds 
Nodrik: folds 
Lumbojack: raises $0.20 to $0.30
droog318: folds 
Ansjofish: folds 
Uncalled bet ($0.20) returned to Lumbojack
Lumbojack collected $0.25 from pot
Lumbojack: doesn't show hand 
*** SUMMARY ***
Total pot $0.25 | Rake $0 
Seat 2: Ansjofish (big blind) folded before Flop
Seat 3: Boolik414 folded before Flop (didn't bet)
Seat 4: Nodrik folded before Flop (didn't bet)
Seat 5: Lumbojack (button) collected ($0.25)
Seat 6: droog318 (small blind) folded before Flop



PokerStars Hand #222971980175:  Hold'em No Limit ($0.05/$0.10 USD) - 2021/01/23 16:23:10 ET
Table 'Jihlava III' 6-max Seat #6 is the button
Seat 2: Ansjofish ($10 in chips) 
Seat 3: Boolik414 ($52.85 in chips) 
Seat 4: Nodrik ($10 in chips) 
Seat 5: Lumbojack ($15.49 in chips) 
Seat 6: droog318 ($12.09 in chips) 
Ansjofish: posts small blind $0.05
Boolik414: posts big blind $0.10
*** HOLE CARDS ***
Nodrik: folds 
Lumbojack: raises $0.15 to $0.25
droog318: folds 
Ansjofish: folds 
Boolik414: folds 
Uncalled bet ($0.15) returned to Lumbojack
Lumbojack collected $0.25 from pot
Lumbojack: doesn't show hand 
*** SUMMARY ***
Total pot $0.25 | Rake $0 
Seat 2: Ansjofish (small blind) folded before Flop
Seat 3: Boolik414 (big blind) folded before Flop
Seat 4: Nodrik folded before Flop (didn't bet)
Seat 5: Lumbojack collected ($0.25)
Seat 6: droog318 (button) folded before Flop (didn't bet)



PokerStars Hand #222971989797:  Hold'em No Limit ($0.05/$0.10 USD) - 2021/01/23 16:23:21 ET
Table 'Jihlava III' 6-max Seat #2 is the button
Seat 2: Ansjofish ($10 in chips) 
Seat 3: Boolik414 ($52.75 in chips) 
Seat 4: Nodrik ($10 in chips) 
Seat 5: Lumbojack ($15.64 in chips) 
Seat 6: droog318 ($12.09 in chips) 
Boolik414: posts small blind $0.05
Nodrik: posts big blind $0.10
*** HOLE CARDS ***
Lumbojack: raises $0.15 to $0.25
droog318: folds 
Ansjofish: raises $0.55 to $0.80
Boolik414: folds 
Nodrik: folds 
Lumbojack: calls $0.55
*** FLOP *** [Ad 7d 3d]
Lumbojack: checks 
Ansjofish: checks 
*** TURN *** [Ad 7d 3d] [9s]
Lumbojack: bets $0.87
Ansjofish: calls $0.87
*** RIVER *** [Ad 7d 3d 9s] [2h]
Lumbojack: bets $1.80
Ansjofish: calls $1.80
*** SHOW DOWN ***
Lumbojack: shows [9d 9h] (three of a kind, Nines)
Ansjofish: mucks hand 
Lumbojack collected $6.77 from pot
*** SUMMARY ***
Total pot $7.09 | Rake $0.32 
Board [Ad 7d 3d 9s 2h]
Seat 2: Ansjofish (button) mucked
Seat 3: Boolik414 (small blind) folded before Flop
Seat 4: Nodrik (big blind) folded before Flop
Seat 5: Lumbojack showed [9d 9h] and won ($6.77) with three of a kind, Nines
Seat 6: droog318 folded before Flop (didn't bet)



PokerStars Hand #222972041888:  Hold'em No Limit ($0.05/$0.10 USD) - 2021/01/23 16:24:22 ET
Table 'Jihlava III' 6-max Seat #3 is the button
Seat 3: Boolik414 ($52.70 in chips) 
Seat 4: Nodrik ($10 in chips) 
Seat 5: Lumbojack ($18.94 in chips) 
Seat 6: droog318 ($12.09 in chips) 
Nodrik: posts small blind $0.05
Lumbojack: posts big blind $0.10
*** HOLE CARDS ***
droog318: folds 
Boolik414: folds 
Feryman78 joins the table at seat #2 
Nodrik: raises $0.20 to $0.30
Lumbojack: folds 
Uncalled bet ($0.20) returned to Nodrik
Nodrik collected $0.20 from pot
Nodrik: doesn't show hand 
*** SUMMARY ***
Total pot $0.20 | Rake $0 
Seat 3: Boolik414 (button) folded before Flop (didn't bet)
Seat 4: Nodrik (small blind) collected ($0.20)
Seat 5: Lumbojack (big blind) folded before Flop
Seat 6: droog318 folded before Flop (didn't bet)



PokerStars Hand #222972062808:  Hold'em No Limit ($0.05/$0.10 USD) - 2021/01/23 16:24:47 ET
Table 'Jihlava III' 6-max Seat #4 is the button
Seat 3: Boolik414 ($52.70 in chips) 
Seat 4: Nodrik ($10.10 in chips) 
Seat 5: Lumbojack ($18.84 in chips) 
Seat 6: droog318 ($12.09 in chips) 
Lumbojack: posts small blind $0.05
droog318: posts big blind $0.10
Feryman78: sits out 
*** HOLE CARDS ***
Boolik414: raises $0.25 to $0.35
Nodrik: folds 
Lumbojack: folds 
droog318: folds 
Uncalled bet ($0.25) returned to Boolik414
Boolik414 collected $0.25 from pot
Boolik414: doesn't show hand 
*** SUMMARY ***
Total pot $0.25 | Rake $0 
Seat 3: Boolik414 collected ($0.25)
Seat 4: Nodrik (button) folded before Flop (didn't bet)
Seat 5: Lumbojack (small blind) folded before Flop
Seat 6: droog318 (big blind) folded before Flop



PokerStars Hand #222972080381:  Hold'em No Limit ($0.05/$0.10 USD) - 2021/01/23 16:25:07 ET
Table 'Jihlava III' 6-max Seat #5 is the button
Seat 1: 19991986830 ($15.56 in chips) 
Seat 3: Boolik414 ($52.85 in chips) 
Seat 4: Nodrik ($10.10 in chips) 
Seat 5: Lumbojack ($18.79 in chips) 
Seat 6: droog318 ($11.99 in chips) 
droog318: posts small blind $0.05
19991986830: posts big blind $0.10
Feryman78: sits out 
*** HOLE CARDS ***
Boolik414: folds 
Nodrik: folds 
Lumbojack: folds 
droog318: folds 
Uncalled bet ($0.05) returned to 19991986830
19991986830 collected $0.10 from pot
*** SUMMARY ***
Total pot $0.10 | Rake $0 
Seat 1: 19991986830 (big blind) collected ($0.10)
Seat 3: Boolik414 folded before Flop (didn't bet)
Seat 4: Nodrik folded before Flop (didn't bet)
Seat 5: Lumbojack (button) folded before Flop (didn't bet)
Seat 6: droog318 (small blind) folded before Flop



PokerStars Hand #222972090386:  Hold'em No Limit ($0.05/$0.10 USD) - 2021/01/23 16:25:19 ET
Table 'Jihlava III' 6-max Seat #6 is the button
Seat 3: Boolik414 ($52.85 in chips) 
Seat 4: Nodrik ($10.10 in chips) 
Seat 5: Lumbojack ($18.79 in chips) 
Seat 6: droog318 ($11.94 in chips) 
Boolik414: posts small blind $0.05
Nodrik: posts big blind $0.10
*** HOLE CARDS ***
Lumbojack: folds 
droog318: folds 
Boolik414: folds 
Uncalled bet ($0.05) returned to Nodrik
Nodrik collected $0.10 from pot
Nodrik: doesn't show hand 
*** SUMMARY ***
Total pot $0.10 | Rake $0 
Seat 3: Boolik414 (small blind) folded before Flop
Seat 4: Nodrik (big blind) collected ($0.10)
Seat 5: Lumbojack folded before Flop (didn't bet)
Seat 6: droog318 (button) folded before Flop (didn't bet)



PokerStars Hand #222972096830:  Hold'em No Limit ($0.05/$0.10 USD) - 2021/01/23 16:25:27 ET
Table 'Jihlava III' 6-max Seat #3 is the button
Seat 3: Boolik414 ($52.80 in chips) 
Seat 4: Nodrik ($10.15 in chips) 
Seat 5: Lumbojack ($18.79 in chips) 
Seat 6: droog318 ($11.94 in chips) 
Nodrik: posts small blind $0.05
Lumbojack: posts big blind $0.10
Feryman78: sits out 
*** HOLE CARDS ***
droog318: folds 
Boolik414: folds 
Nodrik: calls $0.05
Lumbojack: checks 
*** FLOP *** [2h Js 8d]
Nodrik: checks 
Lumbojack: checks 
*** TURN *** [2h Js 8d] [Kc]
Nodrik: bets $0.13
Lumbojack: folds 
Uncalled bet ($0.13) returned to Nodrik
Nodrik collected $0.19 from pot
Nodrik: doesn't show hand 
*** SUMMARY ***
Total pot $0.20 | Rake $0.01 
Board [2h Js 8d Kc]
Seat 3: Boolik414 (button) folded before Flop (didn't bet)
Seat 4: Nodrik (small blind) collected ($0.19)
Seat 5: Lumbojack (big blind) folded on the Turn
Seat 6: droog318 folded before Flop (didn't bet)



PokerStars Hand #222972131230:  Hold'em No Limit ($0.05/$0.10 USD) - 2021/01/23 16:26:08 ET
Table 'Jihlava III' 6-max Seat #4 is the button
Seat 1: 19991986830 ($15.61 in chips) 
Seat 3: Boolik414 ($52.80 in chips) 
Seat 4: Nodrik ($10.24 in chips) 
Seat 5: Lumbojack ($18.69 in chips) 
Seat 6: droog318 ($11.94 in chips) 
Lumbojack: posts small blind $0.05
droog318: posts big blind $0.10
19991986830: posts small blind $0.05
Feryman78: sits out 
*** HOLE CARDS ***
Feryman78 leaves the table
19991986830 has timed out
19991986830: folds 
Boolik414: folds 
Nodrik: folds 
Lumbojack: folds 
Uncalled bet ($0.05) returned to droog318
droog318 collected $0.15 from pot
droog318: doesn't show hand 
*** SUMMARY ***
Total pot $0.15 | Rake $0 
Seat 1: 19991986830 folded before Flop (didn't bet)
Seat 3: Boolik414 folded before Flop (didn't bet)
Seat 4: Nodrik (button) folded before Flop (didn't bet)
Seat 5: Lumbojack (small blind) folded before Flop
Seat 6: droog318 (big blind) collected ($0.15)



PokerStars Hand #222972155403:  Hold'em No Limit ($0.05/$0.10 USD) - 2021/01/23 16:26:36 ET
Table 'Jihlava III' 6-max Seat #5 is the button
Seat 1: 19991986830 ($15.56 in chips) 
Seat 3: Boolik414 ($52.80 in chips) 
Seat 4: Nodrik ($10.24 in chips) 
Seat 5: Lumbojack ($18.64 in chips) 
Seat 6: droog318 ($12.04 in chips) 
droog318: posts small blind $0.05
19991986830: posts big blind $0.10
*** HOLE CARDS ***
Boolik414: raises $0.15 to $0.25
Nodrik: folds 
ghost4c joins the table at seat #2 
Lumbojack: folds 
droog318: folds 
19991986830: calls $0.15
*** FLOP *** [2d Th 6d]
19991986830: checks 
Boolik414: bets $0.40
19991986830: calls $0.40
*** TURN *** [2d Th 6d] [Td]
19991986830: checks 
Boolik414: checks 
*** RIVER *** [2d Th 6d Td] [9d]
19991986830: bets $0.40
Boolik414: folds 
Uncalled bet ($0.40) returned to 19991986830
19991986830 collected $1.29 from pot
*** SUMMARY ***
Total pot $1.35 | Rake $0.06 
Board [2d Th 6d Td 9d]
Seat 1: 19991986830 (big blind) collected ($1.29)
Seat 3: Boolik414 folded on the River
Seat 4: Nodrik folded before Flop (didn't bet)
Seat 5: Lumbojack (button) folded before Flop (didn't bet)
Seat 6: droog318 (small blind) folded before Flop



PokerStars Hand #222972215611:  Hold'em No Limit ($0.05/$0.10 USD) - 2021/01/23 16:27:47 ET
Table 'Jihlava III' 6-max Seat #6 is the button
Seat 1: 19991986830 ($16.20 in chips) 
Seat 2: ghost4c ($10 in chips) 
Seat 3: Boolik414 ($52.15 in chips) 
Seat 4: Nodrik ($10.24 in chips) 
Seat 5: Lumbojack ($18.64 in chips) 
Seat 6: droog318 ($11.99 in chips) 
19991986830: posts small blind $0.05
ghost4c: posts big blind $0.10
*** HOLE CARDS ***
Boolik414: folds 
Nodrik: folds 
Lumbojack: raises $0.15 to $0.25
droog318: folds 
19991986830: folds 
ghost4c: calls $0.15
*** FLOP *** [Qd 4s Ts]
ghost4c: checks 
Lumbojack: bets $0.28
ghost4c: calls $0.28
*** TURN *** [Qd 4s Ts] [8d]
ghost4c: checks 
Lumbojack: bets $0.70
ghost4c: calls $0.70
*** RIVER *** [Qd 4s Ts 8d] [3h]
ghost4c: checks 
Lumbojack: bets $2
ghost4c: folds 
Uncalled bet ($2) returned to Lumbojack
Lumbojack collected $2.40 from pot
Lumbojack: doesn't show hand 
*** SUMMARY ***
Total pot $2.51 | Rake $0.11 
Board [Qd 4s Ts 8d 3h]
Seat 1: 19991986830 (small blind) folded before Flop
Seat 2: ghost4c (big blind) folded on the River
Seat 3: Boolik414 folded before Flop (didn't bet)
Seat 4: Nodrik folded before Flop (didn't bet)
Seat 5: Lumbojack collected ($2.40)
Seat 6: droog318 (button) folded before Flop (didn't bet)



PokerStars Hand #222972261182:  Hold'em No Limit ($0.05/$0.10 USD) - 2021/01/23 16:28:40 ET
Table 'Jihlava III' 6-max Seat #1 is the button
Seat 1: 19991986830 ($16.15 in chips) 
Seat 2: ghost4c ($8.77 in chips) 
Seat 3: Boolik414 ($52.15 in chips) 
Seat 4: Nodrik ($10.24 in chips) 
Seat 5: Lumbojack ($19.81 in chips) 
Seat 6: droog318 ($11.99 in chips) 
ghost4c: posts small blind $0.05
Boolik414: posts big blind $0.10
*** HOLE CARDS ***
Nodrik: folds 
Lumbojack: raises $0.15 to $0.25
droog318: folds 
19991986830: calls $0.25
ghost4c: folds 
Boolik414: calls $0.15
*** FLOP *** [4h Ad Ks]
Boolik414: checks 
Lumbojack: bets $0.40
19991986830: calls $0.40
Boolik414: folds 
*** TURN *** [4h Ad Ks] [Th]
Lumbojack: bets $0.90
19991986830: folds 
Uncalled bet ($0.90) returned to Lumbojack
Lumbojack collected $1.53 from pot
Lumbojack: doesn't show hand 
*** SUMMARY ***
Total pot $1.60 | Rake $0.07 
Board [4h Ad Ks Th]
Seat 1: 19991986830 (button) folded on the Turn
Seat 2: ghost4c (small blind) folded before Flop
Seat 3: Boolik414 (big blind) folded on the Flop
Seat 4: Nodrik folded before Flop (didn't bet)
Seat 5: Lumbojack collected ($1.53)
Seat 6: droog318 folded before Flop (didn't bet)



PokerStars Hand #222972296725:  Hold'em No Limit ($0.05/$0.10 USD) - 2021/01/23 16:29:22 ET
Table 'Jihlava III' 6-max Seat #2 is the button
Seat 1: 19991986830 ($15.50 in chips) 
Seat 2: ghost4c ($8.72 in chips) 
Seat 3: Boolik414 ($51.90 in chips) 
Seat 4: Nodrik ($10.24 in chips) 
Seat 5: Lumbojack ($20.69 in chips) 
Seat 6: droog318 ($11.99 in chips) 
Boolik414: posts small blind $0.05
Nodrik: posts big blind $0.10
*** HOLE CARDS ***
Lumbojack: folds 
droog318: raises $0.20 to $0.30
19991986830: calls $0.30
ghost4c: calls $0.30
Boolik414: folds 
Nodrik: folds 
*** FLOP *** [Jh Jc 3h]
droog318: checks 
19991986830: checks 
ghost4c: bets $0.50
droog318: folds 
19991986830: calls $0.50
*** TURN *** [Jh Jc 3h] [2h]
19991986830: checks 
ghost4c: checks 
*** RIVER *** [Jh Jc 3h 2h] [9c]
19991986830: checks 
ghost4c: bets $1.20
19991986830: folds 
Uncalled bet ($1.20) returned to ghost4c
ghost4c collected $1.96 from pot
ghost4c: doesn't show hand 
*** SUMMARY ***
Total pot $2.05 | Rake $0.09 
Board [Jh Jc 3h 2h 9c]
Seat 1: 19991986830 folded on the River
Seat 2: ghost4c (button) collected ($1.96)
Seat 3: Boolik414 (small blind) folded before Flop
Seat 4: Nodrik (big blind) folded before Flop
Seat 5: Lumbojack folded before Flop (didn't bet)
Seat 6: droog318 folded on the Flop



PokerStars Hand #222972339102:  Hold'em No Limit ($0.05/$0.10 USD) - 2021/01/23 16:30:12 ET
Table 'Jihlava III' 6-max Seat #3 is the button
Seat 1: 19991986830 ($14.70 in chips) 
Seat 2: ghost4c ($9.88 in chips) 
Seat 3: Boolik414 ($51.85 in chips) 
Seat 4: Nodrik ($10.14 in chips) 
Seat 5: Lumbojack ($20.69 in chips) 
Seat 6: droog318 ($11.69 in chips) 
Nodrik: posts small blind $0.05
Lumbojack: posts big blind $0.10
*** HOLE CARDS ***
droog318: folds 
19991986830: raises $0.10 to $0.20
ghost4c: raises $0.20 to $0.40
Boolik414: calls $0.40
Nodrik: folds 
Lumbojack: folds 
19991986830: calls $0.20
*** FLOP *** [3d 3s Ts]
19991986830: checks 
ghost4c: checks 
Boolik414: checks 
*** TURN *** [3d 3s Ts] [8h]
19991986830: checks 
ghost4c: checks 
Boolik414: checks 
*** RIVER *** [3d 3s Ts 8h] [Kh]
19991986830: checks 
ghost4c: bets $1
Boolik414: folds 
19991986830: folds 
Uncalled bet ($1) returned to ghost4c
ghost4c collected $1.29 from pot
ghost4c: doesn't show hand 
*** SUMMARY ***
Total pot $1.35 | Rake $0.06 
Board [3d 3s Ts 8h Kh]
Seat 1: 19991986830 folded on the River
Seat 2: ghost4c collected ($1.29)
Seat 3: Boolik414 (button) folded on the River
Seat 4: Nodrik (small blind) folded before Flop
Seat 5: Lumbojack (big blind) folded before Flop
Seat 6: droog318 folded before Flop (didn't bet)



PokerStars Hand #222972396547:  Hold'em No Limit ($0.05/$0.10 USD) - 2021/01/23 16:31:15 ET
Table 'Jihlava III' 6-max Seat #4 is the button
Seat 1: 19991986830 ($14.30 in chips) 
Seat 2: ghost4c ($10.77 in chips) 
Seat 3: Boolik414 ($51.45 in chips) 
Seat 4: Nodrik ($10.09 in chips) 
Seat 5: Lumbojack ($20.59 in chips) 
Lumbojack: posts small blind $0.05
droog318: is sitting out 
droog318 leaves the table
19991986830: posts big blind $0.10
*** HOLE CARDS ***
ghost4c: folds 
Boolik414: folds 
Nodrik: raises $0.13 to $0.23
Lumbojack: raises $0.67 to $0.90
19991986830: folds 
decentfello82 joins the table at seat #6 
Nodrik: folds 
Uncalled bet ($0.67) returned to Lumbojack
Lumbojack collected $0.56 from pot
Lumbojack: doesn't show hand 
*** SUMMARY ***
Total pot $0.56 | Rake $0 
Seat 1: 19991986830 (big blind) folded before Flop
Seat 2: ghost4c folded before Flop (didn't bet)
Seat 3: Boolik414 folded before Flop (didn't bet)
Seat 4: Nodrik (button) folded before Flop
Seat 5: Lumbojack (small blind) collected ($0.56)



PokerStars Hand #222972424545:  Hold'em No Limit ($0.05/$0.10 USD) - 2021/01/23 16:31:47 ET
Table 'Jihlava III' 6-max Seat #5 is the button
Seat 2: ghost4c ($10.77 in chips) 
Seat 3: Boolik414 ($51.45 in chips) 
Seat 4: Nodrik ($10 in chips) 
Seat 5: Lumbojack ($20.92 in chips) 
ghost4c: posts small blind $0.05
Boolik414: posts big blind $0.10
*** HOLE CARDS ***
Nodrik: folds 
Lumbojack: folds 
ghost4c: raises $0.20 to $0.30
Boolik414: calls $0.20
*** FLOP *** [5d Qh Qs]
ghost4c: checks 
Boolik414: bets $0.43
ghost4c: calls $0.43
*** TURN *** [5d Qh Qs] [7c]
ghost4c: checks 
Boolik414: checks 
*** RIVER *** [5d Qh Qs 7c] [5s]
ghost4c: bets $1
Boolik414: calls $1
*** SHOW DOWN ***
ghost4c: shows [Kd Kc] (two pair, Kings and Queens)
Boolik414: shows [4s 5h] (a full house, Fives full of Queens)
Boolik414 collected $3.30 from pot
*** SUMMARY ***
Total pot $3.46 | Rake $0.16 
Board [5d Qh Qs 7c 5s]
Seat 2: ghost4c (small blind) showed [Kd Kc] and lost with two pair, Kings and Queens
Seat 3: Boolik414 (big blind) showed [4s 5h] and won ($3.30) with a full house, Fives full of Queens
Seat 4: Nodrik folded before Flop (didn't bet)
Seat 5: Lumbojack (button) folded before Flop (didn't bet)



PokerStars Hand #222972457969:  Hold'em No Limit ($0.05/$0.10 USD) - 2021/01/23 16:32:27 ET
Table 'Jihlava III' 6-max Seat #2 is the button
Seat 1: 19991986830 ($14.20 in chips) 
Seat 2: ghost4c ($9.04 in chips) 
Seat 3: Boolik414 ($53.02 in chips) 
Seat 4: Nodrik ($10 in chips) 
Seat 5: Lumbojack ($20.92 in chips) 
Seat 6: decentfello82 ($10 in chips) 
Boolik414: posts small blind $0.05
Nodrik: posts big blind $0.10
decentfello82: posts big blind $0.10
19991986830: posts small blind $0.05
*** HOLE CARDS ***
Lumbojack: folds 
decentfello82: checks 
19991986830: raises $0.20 to $0.30
ghost4c: folds 
Boolik414: folds 
Nodrik: folds 
decentfello82: calls $0.20
*** FLOP *** [5s 3c 2h]
decentfello82: checks 
19991986830: checks 
*** TURN *** [5s 3c 2h] [6c]
decentfello82: bets $0.76
19991986830: folds 
Uncalled bet ($0.76) returned to decentfello82
decentfello82 collected $0.76 from pot
*** SUMMARY ***
Total pot $0.80 | Rake $0.04 
Board [5s 3c 2h 6c]
Seat 1: 19991986830 folded on the Turn
Seat 2: ghost4c (button) folded before Flop (didn't bet)
Seat 3: Boolik414 (small blind) folded before Flop
Seat 4: Nodrik (big blind) folded before Flop
Seat 5: Lumbojack folded before Flop (didn't bet)
Seat 6: decentfello82 collected ($0.76)



PokerStars Hand #222972493093:  Hold'em No Limit ($0.05/$0.10 USD) - 2021/01/23 16:33:09 ET
Table 'Jihlava III' 6-max Seat #3 is the button
Seat 1: 19991986830 ($13.85 in chips) 
Seat 2: ghost4c ($9.04 in chips) 
Seat 3: Boolik414 ($52.97 in chips) 
Seat 4: Nodrik ($10 in chips) 
Seat 5: Lumbojack ($20.92 in chips) 
Seat 6: decentfello82 ($10.46 in chips) 
Nodrik: posts small blind $0.05
Lumbojack: posts big blind $0.10
*** HOLE CARDS ***
decentfello82: calls $0.10
19991986830: folds 
ghost4c: folds 
Boolik414: raises $0.25 to $0.35
Nodrik: folds 
Lumbojack: raises $1.05 to $1.40
decentfello82: folds 
Boolik414: calls $1.05
*** FLOP *** [5d 6c 8c]
Lumbojack: checks 
Boolik414: checks 
*** TURN *** [5d 6c 8c] [Qc]
Lumbojack: bets $1.60
Boolik414: folds 
Uncalled bet ($1.60) returned to Lumbojack
Lumbojack collected $2.82 from pot
Lumbojack: doesn't show hand 
*** SUMMARY ***
Total pot $2.95 | Rake $0.13 
Board [5d 6c 8c Qc]
Seat 1: 19991986830 folded before Flop (didn't bet)
Seat 2: ghost4c folded before Flop (didn't bet)
Seat 3: Boolik414 (button) folded on the Turn
Seat 4: Nodrik (small blind) folded before Flop
Seat 5: Lumbojack (big blind) collected ($2.82)
Seat 6: decentfello82 folded before Flop



PokerStars Hand #222972554919:  Hold'em No Limit ($0.05/$0.10 USD) - 2021/01/23 16:34:22 ET
Table 'Jihlava III' 6-max Seat #4 is the button
Seat 1: 19991986830 ($13.85 in chips) 
Seat 2: ghost4c ($9.04 in chips) 
Seat 3: Boolik414 ($51.57 in chips) 
Seat 4: Nodrik ($10 in chips) 
Seat 5: Lumbojack ($22.34 in chips) 
Seat 6: decentfello82 ($10.36 in chips) 
Lumbojack: posts small blind $0.05
decentfello82: posts big blind $0.10
*** HOLE CARDS ***
19991986830: folds 
ghost4c: folds 
Boolik414: folds 
Nodrik: raises $0.13 to $0.23
Lumbojack: folds 
decentfello82: calls $0.13
*** FLOP *** [Ts Ac 7h]
decentfello82: checks 
Nodrik: bets $0.27
decentfello82: calls $0.27
*** TURN *** [Ts Ac 7h] [Kd]
decentfello82: checks 
Nodrik: checks 
*** RIVER *** [Ts Ac 7h Kd] [6h]
decentfello82: bets $0.50
Nodrik: folds 
Uncalled bet ($0.50) returned to decentfello82
decentfello82 collected $1 from pot
*** SUMMARY ***
Total pot $1.05 | Rake $0.05 
Board [Ts Ac 7h Kd 6h]
Seat 1: 19991986830 folded before Flop (didn't bet)
Seat 2: ghost4c folded before Flop (didn't bet)
Seat 3: Boolik414 folded before Flop (didn't bet)
Seat 4: Nodrik (button) folded on the River
Seat 5: Lumbojack (small blind) folded before Flop
Seat 6: decentfello82 (big blind) collected ($1)



PokerStars Hand #222972608280:  Hold'em No Limit ($0.05/$0.10 USD) - 2021/01/23 16:35:26 ET
Table 'Jihlava III' 6-max Seat #5 is the button
Seat 1: 19991986830 ($13.85 in chips) 
Seat 2: ghost4c ($9.04 in chips) 
Seat 3: Boolik414 ($51.57 in chips) 
Seat 4: Nodrik ($10 in chips) 
Seat 5: Lumbojack ($22.29 in chips) 
Seat 6: decentfello82 ($10.86 in chips) 
decentfello82: posts small blind $0.05
19991986830: posts big blind $0.10
*** HOLE CARDS ***
ghost4c: folds 
Boolik414: folds 
Nodrik: raises $0.13 to $0.23
Lumbojack: folds 
decentfello82: folds 
19991986830: calls $0.13
*** FLOP *** [Qh 3c 9d]
19991986830: checks 
Nodrik: bets $0.34
19991986830: calls $0.34
*** TURN *** [Qh 3c 9d] [5d]
19991986830: checks 
Nodrik: bets $0.79
19991986830: calls $0.79
*** RIVER *** [Qh 3c 9d 5d] [6s]
19991986830: checks 
Nodrik: bets $1.46
19991986830: folds 
Uncalled bet ($1.46) returned to Nodrik
Nodrik collected $2.65 from pot
Nodrik: doesn't show hand 
*** SUMMARY ***
Total pot $2.77 | Rake $0.12 
Board [Qh 3c 9d 5d 6s]
Seat 1: 19991986830 (big blind) folded on the River
Seat 2: ghost4c folded before Flop (didn't bet)
Seat 3: Boolik414 folded before Flop (didn't bet)
Seat 4: Nodrik collected ($2.65)
Seat 5: Lumbojack (button) folded before Flop (didn't bet)
Seat 6: decentfello82 (small blind) folded before Flop



PokerStars Hand #222972659348:  Hold'em No Limit ($0.05/$0.10 USD) - 2021/01/23 16:36:27 ET
Table 'Jihlava III' 6-max Seat #6 is the button
Seat 1: 19991986830 ($12.49 in chips) 
Seat 2: ghost4c ($9.04 in chips) 
Seat 3: Boolik414 ($51.57 in chips) 
Seat 4: Nodrik ($11.29 in chips) 
Seat 5: Lumbojack ($22.29 in chips) 
Seat 6: decentfello82 ($10.81 in chips) 
19991986830: posts small blind $0.05
ghost4c: posts big blind $0.10
*** HOLE CARDS ***
Boolik414: folds 
Nodrik: raises $0.10 to $0.20
Lumbojack: folds 
decentfello82: folds 
19991986830: calls $0.15
ghost4c: folds 
*** FLOP *** [6s 6d Kd]
19991986830: checks 
Nodrik: bets $0.26
Boolik414 leaves the table
19991986830: folds 
Uncalled bet ($0.26) returned to Nodrik
Nodrik collected $0.48 from pot
Nodrik: doesn't show hand 
*** SUMMARY ***
Total pot $0.50 | Rake $0.02 
Board [6s 6d Kd]
Seat 1: 19991986830 (small blind) folded on the Flop
Seat 2: ghost4c (big blind) folded before Flop
Seat 3: Boolik414 folded before Flop (didn't bet)
Seat 4: Nodrik collected ($0.48)
Seat 5: Lumbojack folded before Flop (didn't bet)
Seat 6: decentfello82 (button) folded before Flop (didn't bet)



PokerStars Hand #222972683520:  Hold'em No Limit ($0.05/$0.10 USD) - 2021/01/23 16:36:55 ET
Table 'Jihlava III' 6-max Seat #1 is the button
Seat 1: 19991986830 ($12.29 in chips) 
Seat 2: ghost4c ($8.94 in chips) 
Seat 4: Nodrik ($11.57 in chips) 
Seat 5: Lumbojack ($22.29 in chips) 
Seat 6: decentfello82 ($10.81 in chips) 
ghost4c: posts small blind $0.05
Nodrik: posts big blind $0.10
*** HOLE CARDS ***
Vladiku777 joins the table at seat #3 
Lumbojack: folds 
decentfello82: raises $0.25 to $0.35
19991986830: calls $0.35
ghost4c: folds 
Nodrik: folds 
*** FLOP *** [5h 3c 5s]
decentfello82: bets $0.81
19991986830: folds 
Uncalled bet ($0.81) returned to decentfello82
decentfello82 collected $0.81 from pot
*** SUMMARY ***
Total pot $0.85 | Rake $0.04 
Board [5h 3c 5s]
Seat 1: 19991986830 (button) folded on the Flop
Seat 2: ghost4c (small blind) folded before Flop
Seat 4: Nodrik (big blind) folded before Flop
Seat 5: Lumbojack folded before Flop (didn't bet)
Seat 6: decentfello82 collected ($0.81)



PokerStars Hand #222972715883:  Hold'em No Limit ($0.05/$0.10 USD) - 2021/01/23 16:37:34 ET
Table 'Jihlava III' 6-max Seat #2 is the button
Seat 1: 19991986830 ($11.94 in chips) 
Seat 2: ghost4c ($8.89 in chips) 
Seat 4: Nodrik ($11.47 in chips) 
Seat 5: Lumbojack ($22.29 in chips) 
Seat 6: decentfello82 ($11.27 in chips) 
Nodrik: posts small blind $0.05
Lumbojack: posts big blind $0.10
*** HOLE CARDS ***
decentfello82: folds 
19991986830: raises $0.20 to $0.30
ghost4c: folds 
Nodrik: folds 
Lumbojack: raises $0.90 to $1.20
19991986830: calls $0.90
*** FLOP *** [Qd Qs 2h]
Lumbojack: checks 
19991986830: checks 
*** TURN *** [Qd Qs 2h] [9h]
Lumbojack: bets $1.30
19991986830: calls $1.30
*** RIVER *** [Qd Qs 2h 9h] [3d]
Lumbojack: bets $2.51
19991986830: folds 
Uncalled bet ($2.51) returned to Lumbojack
Lumbojack collected $4.82 from pot
Lumbojack: doesn't show hand 
*** SUMMARY ***
Total pot $5.05 | Rake $0.23 
Board [Qd Qs 2h 9h 3d]
Seat 1: 19991986830 folded on the River
Seat 2: ghost4c (button) folded before Flop (didn't bet)
Seat 4: Nodrik (small blind) folded before Flop
Seat 5: Lumbojack (big blind) collected ($4.82)
Seat 6: decentfello82 folded before Flop (didn't bet)



PokerStars Hand #222972763163:  Hold'em No Limit ($0.05/$0.10 USD) - 2021/01/23 16:38:31 ET
Table 'Jihlava III' 6-max Seat #4 is the button
Seat 1: 19991986830 ($9.44 in chips) 
Seat 2: ghost4c ($8.89 in chips) 
Seat 4: Nodrik ($11.42 in chips) 
Seat 5: Lumbojack ($24.61 in chips) 
Seat 6: decentfello82 ($11.27 in chips) 
Lumbojack: posts small blind $0.05
decentfello82: posts big blind $0.10
Vladiku777: sits out 
*** HOLE CARDS ***
19991986830: calls $0.10
ghost4c: folds 
Nodrik: folds 
Lumbojack: folds 
decentfello82: checks 
*** FLOP *** [Js Jh 6h]
decentfello82: checks 
19991986830: checks 
*** TURN *** [Js Jh 6h] [Ah]
decentfello82: checks 
19991986830: checks 
*** RIVER *** [Js Jh 6h Ah] [Qd]
decentfello82: checks 
19991986830: checks 
*** SHOW DOWN ***
decentfello82: shows [Qc 4c] (two pair, Queens and Jacks)
19991986830: mucks hand 
decentfello82 collected $0.24 from pot
*** SUMMARY ***
Total pot $0.25 | Rake $0.01 
Board [Js Jh 6h Ah Qd]
Seat 1: 19991986830 mucked
Seat 2: ghost4c folded before Flop (didn't bet)
Seat 4: Nodrik (button) folded before Flop (didn't bet)
Seat 5: Lumbojack (small blind) folded before Flop
Seat 6: decentfello82 (big blind) showed [Qc 4c] and won ($0.24) with two pair, Queens and Jacks



PokerStars Hand #222972785328:  Hold'em No Limit ($0.05/$0.10 USD) - 2021/01/23 16:38:57 ET
Table 'Jihlava III' 6-max Seat #5 is the button
Seat 1: 19991986830 ($9.34 in chips) 
Seat 2: ghost4c ($8.89 in chips) 
Seat 4: Nodrik ($11.42 in chips) 
Seat 5: Lumbojack ($24.56 in chips) 
Seat 6: decentfello82 ($11.41 in chips) 
decentfello82: posts small blind $0.05
19991986830: posts big blind $0.10
Vladiku777: sits out 
*** HOLE CARDS ***
ghost4c: folds 
Nodrik: folds 
Lumbojack: folds 
decentfello82: folds 
Uncalled bet ($0.05) returned to 19991986830
19991986830 collected $0.10 from pot
*** SUMMARY ***
Total pot $0.10 | Rake $0 
Seat 1: 19991986830 (big blind) collected ($0.10)
Seat 2: ghost4c folded before Flop (didn't bet)
Seat 4: Nodrik folded before Flop (didn't bet)
Seat 5: Lumbojack (button) folded before Flop (didn't bet)
Seat 6: decentfello82 (small blind) folded before Flop



PokerStars Hand #222972795070:  Hold'em No Limit ($0.05/$0.10 USD) - 2021/01/23 16:39:09 ET
Table 'Jihlava III' 6-max Seat #6 is the button
Seat 1: 19991986830 ($9.39 in chips) 
Seat 2: ghost4c ($8.89 in chips) 
Seat 4: Nodrik ($11.42 in chips) 
Seat 5: Lumbojack ($24.56 in chips) 
Seat 6: decentfello82 ($11.36 in chips) 
19991986830: posts small blind $0.05
ghost4c: posts big blind $0.10
Vladiku777: sits out 
*** HOLE CARDS ***
Nodrik: folds 
Lumbojack: folds 
decentfello82: folds 
19991986830: raises $0.10 to $0.20
ghost4c: folds 
Uncalled bet ($0.10) returned to 19991986830
19991986830 collected $0.20 from pot
*** SUMMARY ***
Total pot $0.20 | Rake $0 
Seat 1: 19991986830 (small blind) collected ($0.20)
Seat 2: ghost4c (big blind) folded before Flop
Seat 4: Nodrik folded before Flop (didn't bet)
Seat 5: Lumbojack folded before Flop (didn't bet)
Seat 6: decentfello82 (button) folded before Flop (didn't bet)



PokerStars Hand #222972804819:  Hold'em No Limit ($0.05/$0.10 USD) - 2021/01/23 16:39:21 ET
Table 'Jihlava III' 6-max Seat #1 is the button
Seat 1: 19991986830 ($9.49 in chips) 
Seat 2: ghost4c ($8.79 in chips) 
Seat 3: Vladiku777 ($8.84 in chips) 
Seat 4: Nodrik ($11.42 in chips) 
Seat 5: Lumbojack ($24.56 in chips) 
Seat 6: decentfello82 ($11.36 in chips) 
ghost4c: posts small blind $0.05
Vladiku777: posts big blind $0.10
*** HOLE CARDS ***
Nodrik: folds 
Lumbojack: folds 
decentfello82: folds 
19991986830: folds 
ghost4c: folds 
Uncalled bet ($0.05) returned to Vladiku777
Vladiku777 collected $0.10 from pot
Vladiku777: doesn't show hand 
*** SUMMARY ***
Total pot $0.10 | Rake $0 
Seat 1: 19991986830 (button) folded before Flop (didn't bet)
Seat 2: ghost4c (small blind) folded before Flop
Seat 3: Vladiku777 (big blind) collected ($0.10)
Seat 4: Nodrik folded before Flop (didn't bet)
Seat 5: Lumbojack folded before Flop (didn't bet)
Seat 6: decentfello82 folded before Flop (didn't bet)



PokerStars Hand #222972814964:  Hold'em No Limit ($0.05/$0.10 USD) - 2021/01/23 16:39:33 ET
Table 'Jihlava III' 6-max Seat #2 is the button
Seat 1: 19991986830 ($9.49 in chips) 
Seat 2: ghost4c ($8.74 in chips) 
Seat 3: Vladiku777 ($8.89 in chips) 
Seat 4: Nodrik ($11.42 in chips) 
Seat 5: Lumbojack ($24.56 in chips) 
Seat 6: decentfello82 ($11.36 in chips) 
Vladiku777: posts small blind $0.05
Nodrik: posts big blind $0.10
*** HOLE CARDS ***
Lumbojack: folds 
decentfello82: calls $0.10
19991986830: calls $0.10
ghost4c: raises $0.20 to $0.30
Vladiku777: folds 
Nodrik: folds 
decentfello82: calls $0.20
19991986830: calls $0.20
*** FLOP *** [5h 4s 7h]
decentfello82: checks 
19991986830: bets $0.30
ghost4c: calls $0.30
decentfello82: calls $0.30
*** TURN *** [5h 4s 7h] [5s]
decentfello82: checks 
19991986830: bets $0.60
ghost4c: calls $0.60
decentfello82: calls $0.60
*** RIVER *** [5h 4s 7h 5s] [3h]
decentfello82: checks 
19991986830: checks 
ghost4c: bets $2.20
decentfello82: folds 
19991986830: calls $2.20
*** SHOW DOWN ***
ghost4c: shows [8h Ah] (a flush, Ace high)
19991986830: mucks hand 
ghost4c collected $7.78 from pot
*** SUMMARY ***
Total pot $8.15 | Rake $0.37 
Board [5h 4s 7h 5s 3h]
Seat 1: 19991986830 mucked
Seat 2: ghost4c (button) showed [8h Ah] and won ($7.78) with a flush, Ace high
Seat 3: Vladiku777 (small blind) folded before Flop
Seat 4: Nodrik (big blind) folded before Flop
Seat 5: Lumbojack folded before Flop (didn't bet)
Seat 6: decentfello82 folded on the River



PokerStars Hand #222972886713:  Hold'em No Limit ($0.05/$0.10 USD) - 2021/01/23 16:40:48 ET
Table 'Jihlava III' 6-max Seat #3 is the button
Seat 1: 19991986830 ($6.09 in chips) 
Seat 2: ghost4c ($13.12 in chips) 
Seat 3: Vladiku777 ($8.84 in chips) 
Seat 4: Nodrik ($11.32 in chips) 
Seat 5: Lumbojack ($24.56 in chips) 
Seat 6: decentfello82 ($10.16 in chips) 
Nodrik: posts small blind $0.05
Lumbojack: posts big blind $0.10
*** HOLE CARDS ***
decentfello82: calls $0.10
19991986830: folds 
ghost4c: folds 
Vladiku777: folds 
Nodrik: folds 
Lumbojack: checks 
*** FLOP *** [Qd 8c 4c]
Lumbojack: checks 
decentfello82: checks 
*** TURN *** [Qd 8c 4c] [7s]
Lumbojack: bets $0.17
decentfello82: folds 
Uncalled bet ($0.17) returned to Lumbojack
Lumbojack collected $0.24 from pot
Lumbojack: doesn't show hand 
*** SUMMARY ***
Total pot $0.25 | Rake $0.01 
Board [Qd 8c 4c 7s]
Seat 1: 19991986830 folded before Flop (didn't bet)
Seat 2: ghost4c folded before Flop (didn't bet)
Seat 3: Vladiku777 (button) folded before Flop (didn't bet)
Seat 4: Nodrik (small blind) folded before Flop
Seat 5: Lumbojack (big blind) collected ($0.24)
Seat 6: decentfello82 folded on the Turn



PokerStars Hand #222972913381:  Hold'em No Limit ($0.05/$0.10 USD) - 2021/01/23 16:41:20 ET
Table 'Jihlava III' 6-max Seat #4 is the button
Seat 1: 19991986830 ($6.09 in chips) 
Seat 2: ghost4c ($13.12 in chips) 
Seat 3: Vladiku777 ($8.84 in chips) 
Seat 4: Nodrik ($11.27 in chips) 
Seat 5: Lumbojack ($24.70 in chips) 
Seat 6: decentfello82 ($10.06 in chips) 
Lumbojack: posts small blind $0.05
decentfello82: posts big blind $0.10
*** HOLE CARDS ***
19991986830: raises $0.20 to $0.30
ghost4c: folds 
Vladiku777: raises $0.75 to $1.05
Nodrik: folds 
Lumbojack: folds 
decentfello82: folds 
19991986830: folds 
Uncalled bet ($0.75) returned to Vladiku777
Vladiku777 collected $0.75 from pot
Vladiku777: doesn't show hand 
*** SUMMARY ***
Total pot $0.75 | Rake $0 
Seat 1: 19991986830 folded before Flop
Seat 2: ghost4c folded before Flop (didn't bet)
Seat 3: Vladiku777 collected ($0.75)
Seat 4: Nodrik (button) folded before Flop (didn't bet)
Seat 5: Lumbojack (small blind) folded before Flop
Seat 6: decentfello82 (big blind) folded before Flop



PokerStars Hand #222972932561:  Hold'em No Limit ($0.05/$0.10 USD) - 2021/01/23 16:41:43 ET
Table 'Jihlava III' 6-max Seat #5 is the button
Seat 1: 19991986830 ($5.79 in chips) 
Seat 2: ghost4c ($13.12 in chips) 
Seat 3: Vladiku777 ($9.29 in chips) 
Seat 4: Nodrik ($11.27 in chips) 
Seat 5: Lumbojack ($24.65 in chips) 
Seat 6: decentfello82 ($9.96 in chips) 
decentfello82: posts small blind $0.05
19991986830: posts big blind $0.10
*** HOLE CARDS ***
ghost4c: folds 
Vladiku777: folds 
Nodrik: folds 
Lumbojack: raises $0.20 to $0.30
decentfello82: calls $0.25
19991986830: raises $0.20 to $0.50
Lumbojack: raises $1 to $1.50
decentfello82: folds 
19991986830: calls $1
*** FLOP *** [8c Tc Jd]
19991986830: checks 
Lumbojack: bets $4.73
19991986830: calls $4.29 and is all-in
Uncalled bet ($0.44) returned to Lumbojack
*** TURN *** [8c Tc Jd] [Qc]
*** RIVER *** [8c Tc Jd Qc] [6s]
*** SHOW DOWN ***
19991986830: shows [Ac Kc] (a flush, Ace high)
Lumbojack: shows [9d 9s] (a straight, Eight to Queen)
19991986830 collected $11.35 from pot
*** SUMMARY ***
Total pot $11.88 | Rake $0.53 
Board [8c Tc Jd Qc 6s]
Seat 1: 19991986830 (big blind) showed [Ac Kc] and won ($11.35) with a flush, Ace high
Seat 2: ghost4c folded before Flop (didn't bet)
Seat 3: Vladiku777 folded before Flop (didn't bet)
Seat 4: Nodrik folded before Flop (didn't bet)
Seat 5: Lumbojack (button) showed [9d 9s] and lost with a straight, Eight to Queen
Seat 6: decentfello82 (small blind) folded before Flop



PokerStars Hand #222972973957:  Hold'em No Limit ($0.05/$0.10 USD) - 2021/01/23 16:42:34 ET
Table 'Jihlava III' 6-max Seat #6 is the button
Seat 1: 19991986830 ($11.35 in chips) 
Seat 2: ghost4c ($13.12 in chips) 
Seat 3: Vladiku777 ($9.29 in chips) 
Seat 4: Nodrik ($11.27 in chips) 
Seat 5: Lumbojack ($18.86 in chips) 
Seat 6: decentfello82 ($9.66 in chips) 
19991986830: posts small blind $0.05
ghost4c: posts big blind $0.10
*** HOLE CARDS ***
Vladiku777: raises $0.25 to $0.35
Nodrik: folds 
Lumbojack: folds 
decentfello82: folds 
19991986830: folds 
ghost4c: calls $0.25
*** FLOP *** [Qh 4s Qs]
ghost4c: checks 
Vladiku777: checks 
*** TURN *** [Qh 4s Qs] [5c]
ghost4c: checks 
Vladiku777: bets $0.72
ghost4c: folds 
Uncalled bet ($0.72) returned to Vladiku777
Vladiku777 collected $0.72 from pot
Vladiku777: doesn't show hand 
*** SUMMARY ***
Total pot $0.75 | Rake $0.03 
Board [Qh 4s Qs 5c]
Seat 1: 19991986830 (small blind) folded before Flop
Seat 2: ghost4c (big blind) folded on the Turn
Seat 3: Vladiku777 collected ($0.72)
Seat 4: Nodrik folded before Flop (didn't bet)
Seat 5: Lumbojack folded before Flop (didn't bet)
Seat 6: decentfello82 (button) folded before Flop (didn't bet)



PokerStars Hand #222972996933:  Hold'em No Limit ($0.05/$0.10 USD) - 2021/01/23 16:43:02 ET
Table 'Jihlava III' 6-max Seat #1 is the button
Seat 1: 19991986830 ($11.30 in chips) 
Seat 2: ghost4c ($12.77 in chips) 
Seat 3: Vladiku777 ($9.66 in chips) 
Seat 4: Nodrik ($11.27 in chips) 
Seat 5: Lumbojack ($18.86 in chips) 
Seat 6: decentfello82 ($9.66 in chips) 
ghost4c: posts small blind $0.05
Vladiku777: posts big blind $0.10
*** HOLE CARDS ***
Nodrik: folds 
Lumbojack: folds 
decentfello82: calls $0.10
19991986830: calls $0.10
ghost4c: folds 
Vladiku777: checks 
*** FLOP *** [9c Jd 6h]
Vladiku777: checks 
decentfello82: checks 
19991986830: checks 
*** TURN *** [9c Jd 6h] [Kc]
Vladiku777: checks 
decentfello82: bets $0.33
19991986830: folds 
Vladiku777: folds 
Uncalled bet ($0.33) returned to decentfello82
decentfello82 collected $0.33 from pot
*** SUMMARY ***
Total pot $0.35 | Rake $0.02 
Board [9c Jd 6h Kc]
Seat 1: 19991986830 (button) folded on the Turn
Seat 2: ghost4c (small blind) folded before Flop
Seat 3: Vladiku777 (big blind) folded on the Turn
Seat 4: Nodrik folded before Flop (didn't bet)
Seat 5: Lumbojack folded before Flop (didn't bet)
Seat 6: decentfello82 collected ($0.33)



PokerStars Hand #222973027536:  Hold'em No Limit ($0.05/$0.10 USD) - 2021/01/23 16:43:40 ET
Table 'Jihlava III' 6-max Seat #2 is the button
Seat 1: 19991986830 ($11.20 in chips) 
Seat 2: ghost4c ($12.72 in chips) 
Seat 3: Vladiku777 ($9.56 in chips) 
Seat 5: Lumbojack ($18.86 in chips) 
Seat 6: decentfello82 ($9.89 in chips) 
Vladiku777: posts small blind $0.05
Nodrik: is sitting out 
Lumbojack: posts big blind $0.10
*** HOLE CARDS ***
decentfello82: calls $0.10
19991986830: calls $0.10
ghost4c: folds 
Nodrik leaves the table
Vladiku777: raises $0.20 to $0.30
jimeshka joins the table at seat #4 
Lumbojack: folds 
decentfello82: calls $0.20
19991986830: calls $0.20
*** FLOP *** [9h 5h 2s]
Vladiku777: checks 
decentfello82: checks 
19991986830: checks 
*** TURN *** [9h 5h 2s] [4d]
Vladiku777: checks 
decentfello82: checks 
19991986830: checks 
*** RIVER *** [9h 5h 2s 4d] [Kc]
Vladiku777: checks 
decentfello82: checks 
19991986830: checks 
*** SHOW DOWN ***
Vladiku777: shows [Ad Th] (high card Ace)
decentfello82: mucks hand 
19991986830: mucks hand 
Vladiku777 collected $0.96 from pot
*** SUMMARY ***
Total pot $1 | Rake $0.04 
Board [9h 5h 2s 4d Kc]
Seat 1: 19991986830 mucked
Seat 2: ghost4c (button) folded before Flop (didn't bet)
Seat 3: Vladiku777 (small blind) showed [Ad Th] and won ($0.96) with high card Ace
Seat 5: Lumbojack (big blind) folded before Flop
Seat 6: decentfello82 mucked



PokerStars Hand #222973085592:  Hold'em No Limit ($0.05/$0.10 USD) - 2021/01/23 16:44:50 ET
Table 'Jihlava III' 6-max Seat #3 is the button
Seat 1: 19991986830 ($10.90 in chips) 
Seat 2: ghost4c ($12.72 in chips) 
Seat 3: Vladiku777 ($10.22 in chips) 
Seat 5: Lumbojack ($18.76 in chips) 
Seat 6: decentfello82 ($9.59 in chips) 
Lumbojack: posts small blind $0.05
decentfello82: posts big blind $0.10
*** HOLE CARDS ***
19991986830: calls $0.10
ghost4c: folds 
Vladiku777: folds 
Lumbojack: folds 
decentfello82: raises $0.25 to $0.35
19991986830: calls $0.25
*** FLOP *** [9c Ah 9d]
decentfello82: checks 
19991986830: checks 
*** TURN *** [9c Ah 9d] [Ad]
decentfello82: checks 
19991986830: checks 
*** RIVER *** [9c Ah 9d Ad] [7d]
decentfello82: checks 
19991986830: bets $0.36
decentfello82: calls $0.36
*** SHOW DOWN ***
19991986830: shows [6h 2s] (two pair, Aces and Nines)
decentfello82: shows [Kh Kd] (two pair, Aces and Kings)
decentfello82 collected $1.40 from pot
*** SUMMARY ***
Total pot $1.47 | Rake $0.07 
Board [9c Ah 9d Ad 7d]
Seat 1: 19991986830 showed [6h 2s] and lost with two pair, Aces and Nines
Seat 2: ghost4c folded before Flop (didn't bet)
Seat 3: Vladiku777 (button) folded before Flop (didn't bet)
Seat 5: Lumbojack (small blind) folded before Flop
Seat 6: decentfello82 (big blind) showed [Kh Kd] and won ($1.40) with two pair, Aces and Kings



PokerStars Hand #222973112157:  Hold'em No Limit ($0.05/$0.10 USD) - 2021/01/23 16:45:23 ET
Table 'Jihlava III' 6-max Seat #5 is the button
Seat 1: 19991986830 ($10.19 in chips) 
Seat 2: ghost4c ($12.72 in chips) 
Seat 3: Vladiku777 ($10.22 in chips) 
Seat 4: jimeshka ($4 in chips) 
Seat 5: Lumbojack ($18.71 in chips) 
Seat 6: decentfello82 ($10.28 in chips) 
decentfello82: posts small blind $0.05
19991986830: posts big blind $0.10
jimeshka: posts big blind $0.10
*** HOLE CARDS ***
ghost4c: folds 
Vladiku777: folds 
jimeshka: checks 
Lumbojack has timed out
Lumbojack: folds 
decentfello82: folds 
19991986830: raises $0.20 to $0.30
jimeshka: folds 
Uncalled bet ($0.20) returned to 19991986830
19991986830 collected $0.25 from pot
*** SUMMARY ***
Total pot $0.25 | Rake $0 
Seat 1: 19991986830 (big blind) collected ($0.25)
Seat 2: ghost4c folded before Flop (didn't bet)
Seat 3: Vladiku777 folded before Flop (didn't bet)
Seat 4: jimeshka folded before Flop (didn't bet)
Seat 5: Lumbojack (button) folded before Flop (didn't bet)
Seat 6: decentfello82 (small blind) folded before Flop



PokerStars Hand #222973135417:  Hold'em No Limit ($0.05/$0.10 USD) - 2021/01/23 16:45:51 ET
Table 'Jihlava III' 6-max Seat #6 is the button
Seat 1: 19991986830 ($10.34 in chips) 
Seat 2: ghost4c ($12.72 in chips) 
Seat 3: Vladiku777 ($10.22 in chips) 
Seat 4: jimeshka ($3.90 in chips) 
Seat 6: decentfello82 ($10.23 in chips) 
19991986830: posts small blind $0.05
ghost4c: posts big blind $0.10
*** HOLE CARDS ***
Vladiku777: calls $0.10
jimeshka: folds 
decentfello82: folds 
19991986830: raises $0.10 to $0.20
ghost4c: raises $0.40 to $0.60
Vladiku777: folds 
19991986830: calls $0.40
*** FLOP *** [9c 3s 8d]
19991986830: checks 
ghost4c: checks 
*** TURN *** [9c 3s 8d] [7s]
19991986830: checks 
ghost4c: checks 
*** RIVER *** [9c 3s 8d 7s] [6s]
19991986830: checks 
ghost4c: checks 
*** SHOW DOWN ***
19991986830: shows [As 4s] (a flush, Ace high)
ghost4c: mucks hand 
19991986830 collected $1.24 from pot
*** SUMMARY ***
Total pot $1.30 | Rake $0.06 
Board [9c 3s 8d 7s 6s]
Seat 1: 19991986830 (small blind) showed [As 4s] and won ($1.24) with a flush, Ace high
Seat 2: ghost4c (big blind) mucked
Seat 3: Vladiku777 folded before Flop
Seat 4: jimeshka folded before Flop (didn't bet)
Seat 6: decentfello82 (button) folded before Flop (didn't bet)



PokerStars Hand #222973178455:  Hold'em No Limit ($0.05/$0.10 USD) - 2021/01/23 16:46:42 ET
Table 'Jihlava III' 6-max Seat #1 is the button
Seat 1: 19991986830 ($10.98 in chips) 
Seat 2: ghost4c ($12.12 in chips) 
Seat 3: Vladiku777 ($10.12 in chips) 
Seat 4: jimeshka ($3.90 in chips) 
Seat 5: Lumbojack ($18.71 in chips) 
Seat 6: decentfello82 ($10.23 in chips) 
ghost4c: posts small blind $0.05
Vladiku777: posts big blind $0.10
*** HOLE CARDS ***
jimeshka: folds 
Lumbojack: raises $0.15 to $0.25
decentfello82: folds 
19991986830: folds 
ghost4c: folds 
Vladiku777: calls $0.15
*** FLOP *** [7d Ah 6h]
Vladiku777: checks 
Lumbojack: bets $0.28
Vladiku777: folds 
Uncalled bet ($0.28) returned to Lumbojack
Lumbojack collected $0.53 from pot
Lumbojack: doesn't show hand 
*** SUMMARY ***
Total pot $0.55 | Rake $0.02 
Board [7d Ah 6h]
Seat 1: 19991986830 (button) folded before Flop (didn't bet)
Seat 2: ghost4c (small blind) folded before Flop
Seat 3: Vladiku777 (big blind) folded on the Flop
Seat 4: jimeshka folded before Flop (didn't bet)
Seat 5: Lumbojack collected ($0.53)
Seat 6: decentfello82 folded before Flop (didn't bet)



PokerStars Hand #222973207356:  Hold'em No Limit ($0.05/$0.10 USD) - 2021/01/23 16:47:17 ET
Table 'Jihlava III' 6-max Seat #2 is the button
Seat 1: 19991986830 ($10.98 in chips) 
Seat 2: ghost4c ($12.07 in chips) 
Seat 3: Vladiku777 ($9.87 in chips) 
Seat 4: jimeshka ($3.90 in chips) 
Seat 5: Lumbojack ($18.99 in chips) 
Seat 6: decentfello82 ($10.23 in chips) 
Vladiku777: posts small blind $0.05
jimeshka: posts big blind $0.10
*** HOLE CARDS ***
Lumbojack: folds 
decentfello82: calls $0.10
19991986830: folds 
ghost4c: folds 
Vladiku777: calls $0.05
jimeshka: checks 
*** FLOP *** [7c 3s 6d]
Vladiku777: checks 
jimeshka: checks 
decentfello82: checks 
*** TURN *** [7c 3s 6d] [Kd]
Vladiku777: checks 
jimeshka: checks 
decentfello82: checks 
*** RIVER *** [7c 3s 6d Kd] [6s]
Vladiku777: checks 
jimeshka: bets $0.29
decentfello82: folds 
Vladiku777: folds 
Uncalled bet ($0.29) returned to jimeshka
jimeshka collected $0.29 from pot
jimeshka: doesn't show hand 
*** SUMMARY ***
Total pot $0.30 | Rake $0.01 
Board [7c 3s 6d Kd 6s]
Seat 1: 19991986830 folded before Flop (didn't bet)
Seat 2: ghost4c (button) folded before Flop (didn't bet)
Seat 3: Vladiku777 (small blind) folded on the River
Seat 4: jimeshka (big blind) collected ($0.29)
Seat 5: Lumbojack folded before Flop (didn't bet)
Seat 6: decentfello82 folded on the River



PokerStars Hand #222973236582:  Hold'em No Limit ($0.05/$0.10 USD) - 2021/01/23 16:47:51 ET
Table 'Jihlava III' 6-max Seat #3 is the button
Seat 1: 19991986830 ($10.98 in chips) 
Seat 2: ghost4c ($12.07 in chips) 
Seat 3: Vladiku777 ($9.77 in chips) 
Seat 4: jimeshka ($4.09 in chips) 
Seat 5: Lumbojack ($18.99 in chips) 
Seat 6: decentfello82 ($10.13 in chips) 
jimeshka: posts small blind $0.05
Lumbojack: posts big blind $0.10
*** HOLE CARDS ***
decentfello82: folds 
19991986830: raises $0.10 to $0.20
ghost4c: folds 
Vladiku777: calls $0.20
jimeshka: folds 
Lumbojack: folds 
*** FLOP *** [2h 5s Ad]
19991986830: checks 
Vladiku777: checks 
*** TURN *** [2h 5s Ad] [9h]
19991986830: checks 
Vladiku777: checks 
*** RIVER *** [2h 5s Ad 9h] [Tc]
19991986830: checks 
Vladiku777: checks 
*** SHOW DOWN ***
19991986830: shows [4s Ks] (high card Ace)
Vladiku777: shows [Kc 7s] (high card Ace - King+Ten+Nine+Seven kicker)
Vladiku777 collected $0.53 from pot
*** SUMMARY ***
Total pot $0.55 | Rake $0.02 
Board [2h 5s Ad 9h Tc]
Seat 1: 19991986830 showed [4s Ks] and lost with high card Ace
Seat 2: ghost4c folded before Flop (didn't bet)
Seat 3: Vladiku777 (button) showed [Kc 7s] and won ($0.53) with high card Ace
Seat 4: jimeshka (small blind) folded before Flop
Seat 5: Lumbojack (big blind) folded before Flop
Seat 6: decentfello82 folded before Flop (didn't bet)



PokerStars Hand #222973273678:  Hold'em No Limit ($0.05/$0.10 USD) - 2021/01/23 16:48:36 ET
Table 'Jihlava III' 6-max Seat #4 is the button
Seat 1: 19991986830 ($10.78 in chips) 
Seat 2: ghost4c ($12.07 in chips) 
Seat 3: Vladiku777 ($10.10 in chips) 
Seat 4: jimeshka ($4.04 in chips) 
Seat 5: Lumbojack ($18.89 in chips) 
Seat 6: decentfello82 ($10.13 in chips) 
Lumbojack: posts small blind $0.05
decentfello82: posts big blind $0.10
*** HOLE CARDS ***
19991986830: raises $0.10 to $0.20
ghost4c: calls $0.20
Vladiku777: folds 
jimeshka: folds 
Lumbojack: folds 
decentfello82: folds 
*** FLOP *** [2d Qd 5s]
19991986830: checks 
ghost4c: checks 
*** TURN *** [2d Qd 5s] [As]
19991986830: checks 
ghost4c: checks 
*** RIVER *** [2d Qd 5s As] [6s]
19991986830: checks 
ghost4c: checks 
*** SHOW DOWN ***
19991986830: shows [8s 9d] (high card Ace)
ghost4c: shows [7d 7s] (a pair of Sevens)
ghost4c collected $0.53 from pot
*** SUMMARY ***
Total pot $0.55 | Rake $0.02 
Board [2d Qd 5s As 6s]
Seat 1: 19991986830 showed [8s 9d] and lost with high card Ace
Seat 2: ghost4c showed [7d 7s] and won ($0.53) with a pair of Sevens
Seat 3: Vladiku777 folded before Flop (didn't bet)
Seat 4: jimeshka (button) folded before Flop (didn't bet)
Seat 5: Lumbojack (small blind) folded before Flop
Seat 6: decentfello82 (big blind) folded before Flop



PokerStars Hand #222973308845:  Hold'em No Limit ($0.05/$0.10 USD) - 2021/01/23 16:49:17 ET
Table 'Jihlava III' 6-max Seat #5 is the button
Seat 1: 19991986830 ($10.58 in chips) 
Seat 2: ghost4c ($12.40 in chips) 
Seat 3: Vladiku777 ($10.10 in chips) 
Seat 4: jimeshka ($4.04 in chips) 
Seat 5: Lumbojack ($18.84 in chips) 
Seat 6: decentfello82 ($10.03 in chips) 
decentfello82: posts small blind $0.05
19991986830: posts big blind $0.10
*** HOLE CARDS ***
ghost4c: folds 
Vladiku777: folds 
jimeshka: calls $0.10
Lumbojack: folds 
decentfello82: calls $0.05
19991986830: checks 
*** FLOP *** [2c Kd 7d]
decentfello82: checks 
19991986830: checks 
jimeshka: bets $0.10
decentfello82: folds 
19991986830: calls $0.10
*** TURN *** [2c Kd 7d] [Ks]
19991986830: checks 
jimeshka: checks 
*** RIVER *** [2c Kd 7d Ks] [4d]
19991986830: checks 
jimeshka: checks 
*** SHOW DOWN ***
19991986830: shows [5h 7s] (two pair, Kings and Sevens)
jimeshka: mucks hand 
19991986830 collected $0.48 from pot
*** SUMMARY ***
Total pot $0.50 | Rake $0.02 
Board [2c Kd 7d Ks 4d]
Seat 1: 19991986830 (big blind) showed [5h 7s] and won ($0.48) with two pair, Kings and Sevens
Seat 2: ghost4c folded before Flop (didn't bet)
Seat 3: Vladiku777 folded before Flop (didn't bet)
Seat 4: jimeshka mucked
Seat 5: Lumbojack (button) folded before Flop (didn't bet)
Seat 6: decentfello82 (small blind) folded on the Flop



PokerStars Hand #222973340442:  Hold'em No Limit ($0.05/$0.10 USD) - 2021/01/23 16:49:55 ET
Table 'Jihlava III' 6-max Seat #6 is the button
Seat 1: 19991986830 ($10.86 in chips) 
Seat 2: ghost4c ($12.40 in chips) 
Seat 3: Vladiku777 ($10.10 in chips) 
Seat 4: jimeshka ($3.84 in chips) 
Seat 5: Lumbojack ($18.84 in chips) 
Seat 6: decentfello82 ($9.93 in chips) 
19991986830: posts small blind $0.05
ghost4c: posts big blind $0.10
*** HOLE CARDS ***
Vladiku777: raises $0.10 to $0.20
jimeshka: folds 
Lumbojack: folds 
decentfello82: folds 
19991986830: calls $0.15
ghost4c: folds 
*** FLOP *** [2d 9h 7s]
19991986830: checks 
Vladiku777: checks 
*** TURN *** [2d 9h 7s] [Ts]
19991986830: checks 
Vladiku777: checks 
*** RIVER *** [2d 9h 7s Ts] [9d]
19991986830: checks 
Vladiku777: bets $0.24
19991986830: calls $0.24
*** SHOW DOWN ***
Vladiku777: shows [Qd 7d] (two pair, Nines and Sevens)
19991986830: mucks hand 
Vladiku777 collected $0.94 from pot
*** SUMMARY ***
Total pot $0.98 | Rake $0.04 
Board [2d 9h 7s Ts 9d]
Seat 1: 19991986830 (small blind) mucked
Seat 2: ghost4c (big blind) folded before Flop
Seat 3: Vladiku777 showed [Qd 7d] and won ($0.94) with two pair, Nines and Sevens
Seat 4: jimeshka folded before Flop (didn't bet)
Seat 5: Lumbojack folded before Flop (didn't bet)
Seat 6: decentfello82 (button) folded before Flop (didn't bet)



PokerStars Hand #222973364066:  Hold'em No Limit ($0.05/$0.10 USD) - 2021/01/23 16:50:23 ET
Table 'Jihlava III' 6-max Seat #1 is the button
Seat 1: 19991986830 ($10.42 in chips) 
Seat 2: ghost4c ($12.30 in chips) 
Seat 3: Vladiku777 ($10.60 in chips) 
Seat 4: jimeshka ($3.84 in chips) 
Seat 5: Lumbojack ($18.84 in chips) 
Seat 6: decentfello82 ($9.93 in chips) 
ghost4c: posts small blind $0.05
Vladiku777: posts big blind $0.10
*** HOLE CARDS ***
jimeshka: folds 
Lumbojack: folds 
decentfello82: folds 
19991986830: raises $0.10 to $0.20
ghost4c: calls $0.15
Vladiku777: calls $0.10
*** FLOP *** [Kh 5s 3c]
ghost4c: checks 
Vladiku777: checks 
19991986830: checks 
*** TURN *** [Kh 5s 3c] [Qd]
ghost4c: checks 
Vladiku777: checks 
19991986830: checks 
*** RIVER *** [Kh 5s 3c Qd] [3s]
ghost4c: checks 
Vladiku777: checks 
19991986830: checks 
*** SHOW DOWN ***
ghost4c: shows [9d Jc] (a pair of Threes)
Vladiku777: shows [As 2d] (a pair of Threes - Ace kicker)
19991986830: mucks hand 
Vladiku777 collected $0.57 from pot
*** SUMMARY ***
Total pot $0.60 | Rake $0.03 
Board [Kh 5s 3c Qd 3s]
Seat 1: 19991986830 (button) mucked
Seat 2: ghost4c (small blind) showed [9d Jc] and lost with a pair of Threes
Seat 3: Vladiku777 (big blind) showed [As 2d] and won ($0.57) with a pair of Threes
Seat 4: jimeshka folded before Flop (didn't bet)
Seat 5: Lumbojack folded before Flop (didn't bet)
Seat 6: decentfello82 folded before Flop (didn't bet)



PokerStars Hand #222973396954:  Hold'em No Limit ($0.05/$0.10 USD) - 2021/01/23 16:51:03 ET
Table 'Jihlava III' 6-max Seat #2 is the button
Seat 1: 19991986830 ($10.22 in chips) 
Seat 2: ghost4c ($12.10 in chips) 
Seat 3: Vladiku777 ($10.97 in chips) 
Seat 4: jimeshka ($3.84 in chips) 
Seat 5: Lumbojack ($18.84 in chips) 
Seat 6: decentfello82 ($9.93 in chips) 
Vladiku777: posts small blind $0.05
jimeshka: posts big blind $0.10
*** HOLE CARDS ***
Lumbojack: folds 
decentfello82: folds 
19991986830: raises $0.10 to $0.20
ghost4c: folds 
Vladiku777: raises $0.10 to $0.30
jimeshka: folds 
19991986830: calls $0.10
*** FLOP *** [Qs Ts 7c]
Vladiku777: checks 
19991986830: bets $0.20
Vladiku777: folds 
Uncalled bet ($0.20) returned to 19991986830
19991986830 collected $0.67 from pot
*** SUMMARY ***
Total pot $0.70 | Rake $0.03 
Board [Qs Ts 7c]
Seat 1: 19991986830 collected ($0.67)
Seat 2: ghost4c (button) folded before Flop (didn't bet)
Seat 3: Vladiku777 (small blind) folded on the Flop
Seat 4: jimeshka (big blind) folded before Flop
Seat 5: Lumbojack folded before Flop (didn't bet)
Seat 6: decentfello82 folded before Flop (didn't bet)



PokerStars Hand #222973422032:  Hold'em No Limit ($0.05/$0.10 USD) - 2021/01/23 16:51:32 ET
Table 'Jihlava III' 6-max Seat #3 is the button
Seat 1: 19991986830 ($10.59 in chips) 
Seat 2: ghost4c ($12.10 in chips) 
Seat 3: Vladiku777 ($10.67 in chips) 
Seat 4: jimeshka ($3.74 in chips) 
Seat 5: Lumbojack ($18.84 in chips) 
Seat 6: decentfello82 ($9.93 in chips) 
jimeshka: posts small blind $0.05
Lumbojack: posts big blind $0.10
*** HOLE CARDS ***
decentfello82: calls $0.10
19991986830: raises $0.30 to $0.40
ghost4c: folds 
Vladiku777: raises $1.05 to $1.45
jimeshka: folds 
Lumbojack: folds 
decentfello82: folds 
19991986830: folds 
Uncalled bet ($1.05) returned to Vladiku777
Vladiku777 collected $1.05 from pot
Vladiku777: doesn't show hand 
*** SUMMARY ***
Total pot $1.05 | Rake $0 
Seat 1: 19991986830 folded before Flop
Seat 2: ghost4c folded before Flop (didn't bet)
Seat 3: Vladiku777 (button) collected ($1.05)
Seat 4: jimeshka (small blind) folded before Flop
Seat 5: Lumbojack (big blind) folded before Flop
Seat 6: decentfello82 folded before Flop



PokerStars Hand #222973451875:  Hold'em No Limit ($0.05/$0.10 USD) - 2021/01/23 16:52:08 ET
Table 'Jihlava III' 6-max Seat #4 is the button
Seat 1: 19991986830 ($10.19 in chips) 
Seat 2: ghost4c ($12.10 in chips) 
Seat 3: Vladiku777 ($11.32 in chips) 
Seat 4: jimeshka ($3.69 in chips) 
Seat 5: Lumbojack ($18.74 in chips) 
Seat 6: decentfello82 ($9.83 in chips) 
Lumbojack: posts small blind $0.05
decentfello82: posts big blind $0.10
*** HOLE CARDS ***
19991986830: calls $0.10
ghost4c: folds 
Vladiku777: raises $0.90 to $1
jimeshka: folds 
Lumbojack: folds 
decentfello82: folds 
19991986830: folds 
Uncalled bet ($0.90) returned to Vladiku777
Vladiku777 collected $0.35 from pot
Vladiku777: doesn't show hand 
*** SUMMARY ***
Total pot $0.35 | Rake $0 
Seat 1: 19991986830 folded before Flop
Seat 2: ghost4c folded before Flop (didn't bet)
Seat 3: Vladiku777 collected ($0.35)
Seat 4: jimeshka (button) folded before Flop (didn't bet)
Seat 5: Lumbojack (small blind) folded before Flop
Seat 6: decentfello82 (big blind) folded before Flop



PokerStars Hand #222973471745:  Hold'em No Limit ($0.05/$0.10 USD) - 2021/01/23 16:52:32 ET
Table 'Jihlava III' 6-max Seat #5 is the button
Seat 1: 19991986830 ($10.09 in chips) 
Seat 2: ghost4c ($12.10 in chips) 
Seat 3: Vladiku777 ($11.57 in chips) 
Seat 4: jimeshka ($3.69 in chips) 
Seat 5: Lumbojack ($18.69 in chips) 
Seat 6: decentfello82 ($9.73 in chips) 
decentfello82: posts small blind $0.05
19991986830: posts big blind $0.10
*** HOLE CARDS ***
ghost4c: folds 
Vladiku777: calls $0.10
jimeshka: folds 
Lumbojack: folds 
decentfello82: folds 
19991986830: checks 
*** FLOP *** [5c 7s Ts]
19991986830: checks 
Vladiku777: bets $0.50
19991986830: calls $0.50
*** TURN *** [5c 7s Ts] [9h]
19991986830: checks 
Vladiku777: checks 
*** RIVER *** [5c 7s Ts 9h] [7h]
19991986830: checks 
Vladiku777: checks 
*** SHOW DOWN ***
19991986830: shows [3h 4d] (a pair of Sevens)
Vladiku777: shows [Qs Td] (two pair, Tens and Sevens)
Vladiku777 collected $1.19 from pot
*** SUMMARY ***
Total pot $1.25 | Rake $0.06 
Board [5c 7s Ts 9h 7h]
Seat 1: 19991986830 (big blind) showed [3h 4d] and lost with a pair of Sevens
Seat 2: ghost4c folded before Flop (didn't bet)
Seat 3: Vladiku777 showed [Qs Td] and won ($1.19) with two pair, Tens and Sevens
Seat 4: jimeshka folded before Flop (didn't bet)
Seat 5: Lumbojack (button) folded before Flop (didn't bet)
Seat 6: decentfello82 (small blind) folded before Flop



PokerStars Hand #222973499864:  Hold'em No Limit ($0.05/$0.10 USD) - 2021/01/23 16:53:05 ET
Table 'Jihlava III' 6-max Seat #6 is the button
Seat 1: 19991986830 ($9.49 in chips) 
Seat 2: ghost4c ($12.10 in chips) 
Seat 3: Vladiku777 ($12.16 in chips) 
Seat 4: jimeshka ($3.69 in chips) 
Seat 5: Lumbojack ($18.69 in chips) 
Seat 6: decentfello82 ($9.68 in chips) 
19991986830: posts small blind $0.05
ghost4c: posts big blind $0.10
*** HOLE CARDS ***
Vladiku777: folds 
jimeshka: calls $0.10
Lumbojack: folds 
decentfello82: calls $0.10
19991986830: raises $0.10 to $0.20
ghost4c: calls $0.10
jimeshka: calls $0.10
decentfello82: calls $0.10
*** FLOP *** [7c Kc 9s]
19991986830: checks 
ghost4c: checks 
jimeshka: checks 
decentfello82: checks 
*** TURN *** [7c Kc 9s] [6d]
19991986830: checks 
ghost4c: checks 
jimeshka: checks 
decentfello82: checks 
*** RIVER *** [7c Kc 9s 6d] [Qc]
19991986830: checks 
ghost4c: checks 
jimeshka: bets $0.38
decentfello82: folds 
19991986830: folds 
ghost4c: folds 
Uncalled bet ($0.38) returned to jimeshka
jimeshka collected $0.76 from pot
jimeshka: doesn't show hand 
*** SUMMARY ***
Total pot $0.80 | Rake $0.04 
Board [7c Kc 9s 6d Qc]
Seat 1: 19991986830 (small blind) folded on the River
Seat 2: ghost4c (big blind) folded on the River
Seat 3: Vladiku777 folded before Flop (didn't bet)
Seat 4: jimeshka collected ($0.76)
Seat 5: Lumbojack folded before Flop (didn't bet)
Seat 6: decentfello82 (button) folded on the River



PokerStars Hand #222973550709:  Hold'em No Limit ($0.05/$0.10 USD) - 2021/01/23 16:54:06 ET
Table 'Jihlava III' 6-max Seat #1 is the button
Seat 1: 19991986830 ($9.29 in chips) 
Seat 2: ghost4c ($11.90 in chips) 
Seat 3: Vladiku777 ($12.16 in chips) 
Seat 4: jimeshka ($4.25 in chips) 
Seat 5: Lumbojack ($18.69 in chips) 
Seat 6: decentfello82 ($9.48 in chips) 
ghost4c: posts small blind $0.05
Vladiku777: posts big blind $0.10
*** HOLE CARDS ***
jimeshka: folds 
Lumbojack: raises $0.15 to $0.25
decentfello82: calls $0.25
19991986830: folds 
ghost4c: folds 
Vladiku777: folds 
*** FLOP *** [7h As 3h]
Lumbojack: bets $0.32
decentfello82: calls $0.32
*** TURN *** [7h As 3h] [7d]
Lumbojack: checks 
decentfello82: bets $0.71
Lumbojack: calls $0.71
*** RIVER *** [7h As 3h 7d] [3c]
Lumbojack: checks 
decentfello82: checks 
*** SHOW DOWN ***
Lumbojack: shows [Ac Jd] (two pair, Aces and Sevens)
decentfello82: mucks hand 
Lumbojack collected $2.59 from pot
*** SUMMARY ***
Total pot $2.71 | Rake $0.12 
Board [7h As 3h 7d 3c]
Seat 1: 19991986830 (button) folded before Flop (didn't bet)
Seat 2: ghost4c (small blind) folded before Flop
Seat 3: Vladiku777 (big blind) folded before Flop
Seat 4: jimeshka folded before Flop (didn't bet)
Seat 5: Lumbojack showed [Ac Jd] and won ($2.59) with two pair, Aces and Sevens
Seat 6: decentfello82 mucked



PokerStars Hand #222973588070:  Hold'em No Limit ($0.05/$0.10 USD) - 2021/01/23 16:54:52 ET
Table 'Jihlava III' 6-max Seat #2 is the button
Seat 1: 19991986830 ($9.29 in chips) 
Seat 2: ghost4c ($11.85 in chips) 
Seat 3: Vladiku777 ($12.06 in chips) 
Seat 4: jimeshka ($4.25 in chips) 
Seat 5: Lumbojack ($20 in chips) 
Seat 6: decentfello82 ($8.20 in chips) 
Vladiku777: posts small blind $0.05
jimeshka: posts big blind $0.10
*** HOLE CARDS ***
Lumbojack: folds 
decentfello82: calls $0.10
19991986830: folds 
ghost4c: folds 
Vladiku777: calls $0.05
jimeshka: checks 
*** FLOP *** [2s 4h Ah]
Vladiku777: checks 
jimeshka: checks 
decentfello82: checks 
*** TURN *** [2s 4h Ah] [8c]
Vladiku777: bets $0.14
jimeshka: folds 
decentfello82: folds 
Uncalled bet ($0.14) returned to Vladiku777
Vladiku777 collected $0.29 from pot
Vladiku777: doesn't show hand 
*** SUMMARY ***
Total pot $0.30 | Rake $0.01 
Board [2s 4h Ah 8c]
Seat 1: 19991986830 folded before Flop (didn't bet)
Seat 2: ghost4c (button) folded before Flop (didn't bet)
Seat 3: Vladiku777 (small blind) collected ($0.29)
Seat 4: jimeshka (big blind) folded on the Turn
Seat 5: Lumbojack folded before Flop (didn't bet)
Seat 6: decentfello82 folded on the Turn



PokerStars Hand #222973608251:  Hold'em No Limit ($0.05/$0.10 USD) - 2021/01/23 16:55:19 ET
Table 'Jihlava III' 6-max Seat #3 is the button
Seat 1: 19991986830 ($9.29 in chips) 
Seat 2: ghost4c ($11.85 in chips) 
Seat 3: Vladiku777 ($12.25 in chips) 
Seat 4: jimeshka ($4.15 in chips) 
Seat 5: Lumbojack ($20 in chips) 
Seat 6: decentfello82 ($8.10 in chips) 
jimeshka: posts small blind $0.05
Lumbojack: posts big blind $0.10
*** HOLE CARDS ***
decentfello82: folds 
19991986830: calls $0.10
ghost4c: folds 
Vladiku777: folds 
jimeshka: calls $0.05
Lumbojack: checks 
*** FLOP *** [As Jc 3s]
jimeshka: checks 
Lumbojack: checks 
19991986830: bets $0.10
jimeshka: folds 
Lumbojack: folds 
Uncalled bet ($0.10) returned to 19991986830
19991986830 collected $0.29 from pot
*** SUMMARY ***
Total pot $0.30 | Rake $0.01 
Board [As Jc 3s]
Seat 1: 19991986830 collected ($0.29)
Seat 2: ghost4c folded before Flop (didn't bet)
Seat 3: Vladiku777 (button) folded before Flop (didn't bet)
Seat 4: jimeshka (small blind) folded on the Flop
Seat 5: Lumbojack (big blind) folded on the Flop
Seat 6: decentfello82 folded before Flop (didn't bet)



PokerStars Hand #222973623350:  Hold'em No Limit ($0.05/$0.10 USD) - 2021/01/23 16:55:45 ET
Table 'Jihlava III' 6-max Seat #4 is the button
Seat 1: 19991986830 ($9.48 in chips) 
Seat 2: ghost4c ($11.85 in chips) 
Seat 3: Vladiku777 ($12.25 in chips) 
Seat 4: jimeshka ($4.05 in chips) 
Seat 5: Lumbojack ($19.90 in chips) 
Seat 6: decentfello82 ($8.10 in chips) 
Lumbojack: posts small blind $0.05
decentfello82: posts big blind $0.10
*** HOLE CARDS ***
19991986830: folds 
ghost4c: folds 
Vladiku777: folds 
jimeshka: calls $0.10
Lumbojack: raises $0.40 to $0.50
decentfello82: folds 
jimeshka: folds 
Uncalled bet ($0.40) returned to Lumbojack
Lumbojack collected $0.30 from pot
Lumbojack: doesn't show hand 
*** SUMMARY ***
Total pot $0.30 | Rake $0 
Seat 1: 19991986830 folded before Flop (didn't bet)
Seat 2: ghost4c folded before Flop (didn't bet)
Seat 3: Vladiku777 folded before Flop (didn't bet)
Seat 4: jimeshka (button) folded before Flop
Seat 5: Lumbojack (small blind) collected ($0.30)
Seat 6: decentfello82 (big blind) folded before Flop



PokerStars Hand #222973637909:  Hold'em No Limit ($0.05/$0.10 USD) - 2021/01/23 16:56:11 ET
Table 'Jihlava III' 6-max Seat #5 is the button
Seat 1: 19991986830 ($9.48 in chips) 
Seat 2: ghost4c ($11.85 in chips) 
Seat 3: Vladiku777 ($12.25 in chips) 
Seat 4: jimeshka ($3.95 in chips) 
Seat 5: Lumbojack ($20.10 in chips) 
Seat 6: decentfello82 ($8 in chips) 
decentfello82: posts small blind $0.05
19991986830: posts big blind $0.10
*** HOLE CARDS ***
ghost4c: raises $0.20 to $0.30
Vladiku777: folds 
jimeshka: folds 
Lumbojack: folds 
decentfello82: calls $0.25
19991986830: calls $0.20
*** FLOP *** [4d Qh 5h]
decentfello82: checks 
19991986830: bets $0.20
ghost4c: calls $0.20
decentfello82: folds 
*** TURN *** [4d Qh 5h] [Ks]
19991986830: bets $0.40
ghost4c: folds 
Uncalled bet ($0.40) returned to 19991986830
19991986830 collected $1.24 from pot
*** SUMMARY ***
Total pot $1.30 | Rake $0.06 
Board [4d Qh 5h Ks]
Seat 1: 19991986830 (big blind) collected ($1.24)
Seat 2: ghost4c folded on the Turn
Seat 3: Vladiku777 folded before Flop (didn't bet)
Seat 4: jimeshka folded before Flop (didn't bet)
Seat 5: Lumbojack (button) folded before Flop (didn't bet)
Seat 6: decentfello82 (small blind) folded on the Flop



PokerStars Hand #222973657713:  Hold'em No Limit ($0.05/$0.10 USD) - 2021/01/23 16:56:46 ET
Table 'Jihlava III' 6-max Seat #6 is the button
Seat 1: 19991986830 ($10.22 in chips) 
Seat 2: ghost4c ($11.35 in chips) 
Seat 3: Vladiku777 ($12.25 in chips) 
Seat 4: jimeshka ($3.95 in chips) 
Seat 5: Lumbojack ($20.10 in chips) 
Seat 6: decentfello82 ($7.70 in chips) 
19991986830: posts small blind $0.05
ghost4c: posts big blind $0.10
*** HOLE CARDS ***
Vladiku777: calls $0.10
jimeshka: raises $0.10 to $0.20
Lumbojack: raises $0.50 to $0.70
decentfello82: calls $0.70
19991986830: folds 
ghost4c: folds 
Vladiku777: folds 
jimeshka: calls $0.50
*** FLOP *** [Qs 5c Jh]
jimeshka: checks 
Lumbojack: bets $1.16
decentfello82: folds 
jimeshka: calls $1.16
*** TURN *** [Qs 5c Jh] [Kd]
jimeshka: checks 
Lumbojack: bets $2.32
jimeshka: calls $2.09 and is all-in
Uncalled bet ($0.23) returned to Lumbojack
*** RIVER *** [Qs 5c Jh Kd] [Ts]
*** SHOW DOWN ***
jimeshka: shows [Kh Ad] (a straight, Ten to Ace)
Lumbojack: shows [Qh Qd] (three of a kind, Queens)
jimeshka collected $8.45 from pot
*** SUMMARY ***
Total pot $8.85 | Rake $0.40 
Board [Qs 5c Jh Kd Ts]
Seat 1: 19991986830 (small blind) folded before Flop
Seat 2: ghost4c (big blind) folded before Flop
Seat 3: Vladiku777 folded before Flop
Seat 4: jimeshka showed [Kh Ad] and won ($8.45) with a straight, Ten to Ace
Seat 5: Lumbojack showed [Qh Qd] and lost with three of a kind, Queens
Seat 6: decentfello82 (button) folded on the Flop



PokerStars Hand #222973685242:  Hold'em No Limit ($0.05/$0.10 USD) - 2021/01/23 16:57:33 ET
Table 'Jihlava III' 6-max Seat #1 is the button
Seat 1: 19991986830 ($10.17 in chips) 
Seat 2: ghost4c ($11.25 in chips) 
Seat 3: Vladiku777 ($12.15 in chips) 
Seat 4: jimeshka ($8.45 in chips) 
Seat 5: Lumbojack ($16.15 in chips) 
Seat 6: decentfello82 ($7 in chips) 
ghost4c: posts small blind $0.05
Vladiku777: posts big blind $0.10
*** HOLE CARDS ***
jimeshka: calls $0.10
Lumbojack: folds 
decentfello82: folds 
19991986830: raises $0.20 to $0.30
ghost4c: calls $0.25
Vladiku777: calls $0.20
jimeshka: calls $0.20
*** FLOP *** [Qc 8d 5s]
ghost4c: checks 
Vladiku777: checks 
jimeshka: checks 
19991986830: bets $0.30
ghost4c: calls $0.30
Vladiku777: folds 
jimeshka: calls $0.30
*** TURN *** [Qc 8d 5s] [Qd]
ghost4c: checks 
jimeshka: checks 
19991986830: checks 
*** RIVER *** [Qc 8d 5s Qd] [5c]
ghost4c: bets $1
jimeshka: raises $1.60 to $2.60
19991986830: raises $1.60 to $4.20
ghost4c: folds 
jimeshka: raises $2.20 to $6.40
19991986830: raises $3.17 to $9.57 and is all-in
jimeshka: calls $1.45 and is all-in
Uncalled bet ($1.72) returned to 19991986830
*** SHOW DOWN ***
19991986830: shows [8s Qs] (a full house, Queens full of Eights)
jimeshka: shows [Qh Ks] (a full house, Queens full of Fives)
19991986830 collected $17.95 from pot
*** SUMMARY ***
Total pot $18.80 | Rake $0.85 
Board [Qc 8d 5s Qd 5c]
Seat 1: 19991986830 (button) showed [8s Qs] and won ($17.95) with a full house, Queens full of Eights
Seat 2: ghost4c (small blind) folded on the River
Seat 3: Vladiku777 (big blind) folded on the Flop
Seat 4: jimeshka showed [Qh Ks] and lost with a full house, Queens full of Fives
Seat 5: Lumbojack folded before Flop (didn't bet)
Seat 6: decentfello82 folded before Flop (didn't bet)



PokerStars Hand #222973730729:  Hold'em No Limit ($0.05/$0.10 USD) - 2021/01/23 16:58:52 ET
Table 'Jihlava III' 6-max Seat #2 is the button
Seat 1: 19991986830 ($19.67 in chips) 
Seat 2: ghost4c ($9.65 in chips) 
Seat 3: Vladiku777 ($11.85 in chips) 
Seat 5: Lumbojack ($16.15 in chips) 
Seat 6: decentfello82 ($7 in chips) 
Vladiku777: posts small blind $0.05
Lumbojack: posts big blind $0.10
*** HOLE CARDS ***
decentfello82: calls $0.10
19991986830: folds 
ghost4c: raises $0.20 to $0.30
Vladiku777: folds 
Lumbojack: folds 
decentfello82: calls $0.20
*** FLOP *** [6c 9c 9d]
decentfello82: checks 
ghost4c: checks 
*** TURN *** [6c 9c 9d] [Jc]
decentfello82: bets $0.36
ghost4c: calls $0.36
*** RIVER *** [6c 9c 9d Jc] [9h]
decentfello82: checks 
ghost4c: checks 
*** SHOW DOWN ***
decentfello82: shows [Td Ac] (three of a kind, Nines)
ghost4c: shows [Kc Qc] (a flush, King high)
ghost4c collected $1.40 from pot
*** SUMMARY ***
Total pot $1.47 | Rake $0.07 
Board [6c 9c 9d Jc 9h]
Seat 1: 19991986830 folded before Flop (didn't bet)
Seat 2: ghost4c (button) showed [Kc Qc] and won ($1.40) with a flush, King high
Seat 3: Vladiku777 (small blind) folded before Flop
Seat 5: Lumbojack (big blind) folded before Flop
Seat 6: decentfello82 showed [Td Ac] and lost with three of a kind, Nines



PokerStars Hand #222973756329:  Hold'em No Limit ($0.05/$0.10 USD) - 2021/01/23 16:59:36 ET
Table 'Jihlava III' 6-max Seat #3 is the button
Seat 1: 19991986830 ($19.67 in chips) 
Seat 2: ghost4c ($10.39 in chips) 
Seat 3: Vladiku777 ($11.80 in chips) 
Seat 5: Lumbojack ($16.05 in chips) 
Seat 6: decentfello82 ($6.34 in chips) 
Lumbojack: posts small blind $0.05
decentfello82: posts big blind $0.10
*** HOLE CARDS ***
19991986830: calls $0.10
ghost4c: folds 
Vladiku777: calls $0.10
Lumbojack: folds 
decentfello82: checks 
*** FLOP *** [Tc 6s 9c]
decentfello82 has timed out
decentfello82: checks 
19991986830: checks 
Vladiku777: checks 
*** TURN *** [Tc 6s 9c] [Qd]
decentfello82 has timed out
decentfello82: checks 
19991986830: bets $0.20
Vladiku777: raises $0.80 to $1
decentfello82: folds 
19991986830: folds 
Uncalled bet ($0.80) returned to Vladiku777
Vladiku777 collected $0.72 from pot
Vladiku777: doesn't show hand 
*** SUMMARY ***
Total pot $0.75 | Rake $0.03 
Board [Tc 6s 9c Qd]
Seat 1: 19991986830 folded on the Turn
Seat 2: ghost4c folded before Flop (didn't bet)
Seat 3: Vladiku777 (button) collected ($0.72)
Seat 5: Lumbojack (small blind) folded before Flop
Seat 6: decentfello82 (big blind) folded on the Turn



PokerStars Hand #222973822749:  Hold'em No Limit ($0.05/$0.10 USD) - 2021/01/23 17:01:18 ET
Table 'Jihlava III' 6-max Seat #5 is the button
Seat 1: 19991986830 ($19.37 in chips) 
Seat 2: ghost4c ($10.39 in chips) 
Seat 3: Vladiku777 ($12.22 in chips) 
Seat 4: jimeshka ($4 in chips) 
Seat 5: Lumbojack ($16 in chips) 
Seat 6: decentfello82 ($6.24 in chips) 
decentfello82: posts small blind $0.05
19991986830: posts big blind $0.10
jimeshka: posts small & big blinds $0.15
*** HOLE CARDS ***
ghost4c: folds 
Vladiku777: calls $0.10
jimeshka: checks 
Lumbojack: calls $0.10
decentfello82: calls $0.05
19991986830: raises $0.20 to $0.30
Vladiku777: calls $0.20
jimeshka: folds 
Lumbojack: calls $0.20
decentfello82: calls $0.20
*** FLOP *** [2d 3d 2h]
decentfello82: checks 
19991986830: bets $0.30
Vladiku777: folds 
Lumbojack: calls $0.30
decentfello82: folds 
*** TURN *** [2d 3d 2h] [8c]
19991986830: checks 
Lumbojack: bets $1.40
decentfello82 leaves the table
19991986830: folds 
Uncalled bet ($1.40) returned to Lumbojack
Lumbojack collected $1.86 from pot
Lumbojack: doesn't show hand 
*** SUMMARY ***
Total pot $1.95 | Rake $0.09 
Board [2d 3d 2h 8c]
Seat 1: 19991986830 (big blind) folded on the Turn
Seat 2: ghost4c folded before Flop (didn't bet)
Seat 3: Vladiku777 folded on the Flop
Seat 4: jimeshka folded before Flop (didn't bet)
Seat 5: Lumbojack (button) collected ($1.86)
Seat 6: decentfello82 (small blind) folded on the Flop



PokerStars Hand #222973871219:  Hold'em No Limit ($0.05/$0.10 USD) - 2021/01/23 17:02:18 ET
Table 'Jihlava III' 6-max Seat #1 is the button
Seat 1: 19991986830 ($18.77 in chips) 
Seat 2: ghost4c ($10.39 in chips) 
Seat 3: Vladiku777 ($11.92 in chips) 
Seat 4: jimeshka ($3.85 in chips) 
Seat 5: Lumbojack ($17.26 in chips) 
ghost4c: posts small blind $0.05
Vladiku777: posts big blind $0.10
*** HOLE CARDS ***
jimeshka: folds 
Lumbojack: folds 
19991986830: raises $0.20 to $0.30
ghost4c: folds 
Vladiku777: calls $0.20
*** FLOP *** [Kc 8h Ac]
Vladiku777: checks 
DrLevty joins the table at seat #6 
19991986830: checks 
*** TURN *** [Kc 8h Ac] [7d]
Vladiku777: folds 
Vladiku777 leaves the table
19991986830 collected $0.62 from pot
*** SUMMARY ***
Total pot $0.65 | Rake $0.03 
Board [Kc 8h Ac 7d]
Seat 1: 19991986830 (button) collected ($0.62)
Seat 2: ghost4c (small blind) folded before Flop
Seat 3: Vladiku777 (big blind) folded on the Turn
Seat 4: jimeshka folded before Flop (didn't bet)
Seat 5: Lumbojack folded before Flop (didn't bet)



PokerStars Hand #222973905863:  Hold'em No Limit ($0.05/$0.10 USD) - 2021/01/23 17:03:00 ET
Table 'Jihlava III' 6-max Seat #2 is the button
Seat 2: ghost4c ($10.34 in chips) 
Seat 4: jimeshka ($3.85 in chips) 
Seat 5: Lumbojack ($17.26 in chips) 
jimeshka: posts small blind $0.05
Lumbojack: posts big blind $0.10
DrLevty: sits out 
*** HOLE CARDS ***
ghost4c: folds 
jimeshka: calls $0.05
Lumbojack: checks 
*** FLOP *** [2h 4c Ah]
jimeshka: checks 
Lumbojack: checks 
*** TURN *** [2h 4c Ah] [3c]
jimeshka: checks 
Lumbojack: bets $0.14
jimeshka: folds 
Uncalled bet ($0.14) returned to Lumbojack
Lumbojack collected $0.19 from pot
Lumbojack: doesn't show hand 
*** SUMMARY ***
Total pot $0.20 | Rake $0.01 
Board [2h 4c Ah 3c]
Seat 2: ghost4c (button) folded before Flop (didn't bet)
Seat 4: jimeshka (small blind) folded on the Turn
Seat 5: Lumbojack (big blind) collected ($0.19)



PokerStars Hand #222973935919:  Hold'em No Limit ($0.05/$0.10 USD) - 2021/01/23 17:03:35 ET
Table 'Jihlava III' 6-max Seat #4 is the button
Seat 1: 19991986830 ($19.09 in chips) 
Seat 2: ghost4c ($10.34 in chips) 
Seat 4: jimeshka ($3.75 in chips) 
Seat 5: Lumbojack ($17.35 in chips) 
Seat 6: DrLevty ($10 in chips) 
Lumbojack: posts small blind $0.05
DrLevty: posts big blind $0.10
*** HOLE CARDS ***
19991986830: folds 
ghost4c: folds 
jimeshka: folds 
Lumbojack: folds 
Uncalled bet ($0.05) returned to DrLevty
DrLevty collected $0.10 from pot
DrLevty: doesn't show hand 
*** SUMMARY ***
Total pot $0.10 | Rake $0 
Seat 1: 19991986830 folded before Flop (didn't bet)
Seat 2: ghost4c folded before Flop (didn't bet)
Seat 4: jimeshka (button) folded before Flop (didn't bet)
Seat 5: Lumbojack (small blind) folded before Flop
Seat 6: DrLevty (big blind) collected ($0.10)



PokerStars Hand #222973941537:  Hold'em No Limit ($0.05/$0.10 USD) - 2021/01/23 17:03:42 ET
Table 'Jihlava III' 6-max Seat #5 is the button
Seat 1: 19991986830 ($19.09 in chips) 
Seat 2: ghost4c ($10.34 in chips) 
Seat 4: jimeshka ($3.75 in chips) 
Seat 5: Lumbojack ($17.30 in chips) 
Seat 6: DrLevty ($10.05 in chips) 
DrLevty: posts small blind $0.05
19991986830: posts big blind $0.10
*** HOLE CARDS ***
ghost4c: folds 
jimeshka: folds 
Lumbojack: folds 
DrLevty: raises $0.20 to $0.30
19991986830: folds 
Uncalled bet ($0.20) returned to DrLevty
DrLevty collected $0.20 from pot
DrLevty: doesn't show hand 
*** SUMMARY ***
Total pot $0.20 | Rake $0 
Seat 1: 19991986830 (big blind) folded before Flop
Seat 2: ghost4c folded before Flop (didn't bet)
Seat 4: jimeshka folded before Flop (didn't bet)
Seat 5: Lumbojack (button) folded before Flop (didn't bet)
Seat 6: DrLevty (small blind) collected ($0.20)



PokerStars Hand #222975153309:  Hold'em No Limit ($0.05/$0.10 USD) - 2021/01/23 17:27:50 ET
Table 'Jihlava III' 6-max Seat #4 is the button
Seat 1: 19991986830 ($19.76 in chips) 
Seat 2: ghost4c ($6.66 in chips) 
Seat 3: rioma10 ($10.02 in chips) 
Seat 4: jimeshka ($5.32 in chips) 
Seat 6: DrLevty ($10.60 in chips) 
DrLevty: posts small blind $0.05
19991986830: posts big blind $0.10
*** HOLE CARDS ***
ghost4c: folds 
rioma10: raises $0.20 to $0.30
jimeshka: folds 
DrLevty: folds 
19991986830: raises $0.20 to $0.50
rioma10: calls $0.20
*** FLOP *** [4d 6d 2h]
19991986830: bets $0.50
rioma10: calls $0.50
*** TURN *** [4d 6d 2h] [Jd]
19991986830: checks 
rioma10: checks 
*** RIVER *** [4d 6d 2h Jd] [7c]
19991986830: checks 
rioma10: checks 
*** SHOW DOWN ***
19991986830: shows [Js Jh] (three of a kind, Jacks)
rioma10: mucks hand 
19991986830 collected $1.96 from pot
*** SUMMARY ***
Total pot $2.05 | Rake $0.09 
Board [4d 6d 2h Jd 7c]
Seat 1: 19991986830 (big blind) showed [Js Jh] and won ($1.96) with three of a kind, Jacks
Seat 2: ghost4c folded before Flop (didn't bet)
Seat 3: rioma10 mucked
Seat 4: jimeshka (button) folded before Flop (didn't bet)
Seat 6: DrLevty (small blind) folded before Flop



PokerStars Hand #222973948032:  Hold'em No Limit ($0.05/$0.10 USD) - 2021/01/23 17:03:50 ET
Table 'Jihlava III' 6-max Seat #6 is the button
Seat 1: 19991986830 ($18.99 in chips) 
Seat 2: ghost4c ($10.34 in chips) 
Seat 4: jimeshka ($3.75 in chips) 
Seat 5: Lumbojack ($17.30 in chips) 
Seat 6: DrLevty ($10.15 in chips) 
19991986830: posts small blind $0.05
ghost4c: posts big blind $0.10
*** HOLE CARDS ***
jimeshka: folds 
Lumbojack: folds 
DrLevty: raises $0.20 to $0.30
19991986830: folds 
ghost4c: folds 
Uncalled bet ($0.20) returned to DrLevty
DrLevty collected $0.25 from pot
DrLevty: doesn't show hand 
*** SUMMARY ***
Total pot $0.25 | Rake $0 
Seat 1: 19991986830 (small blind) folded before Flop
Seat 2: ghost4c (big blind) folded before Flop
Seat 4: jimeshka folded before Flop (didn't bet)
Seat 5: Lumbojack folded before Flop (didn't bet)
Seat 6: DrLevty (button) collected ($0.25)



PokerStars Hand #222975197318:  Hold'em No Limit ($0.05/$0.10 USD) - 2021/01/23 17:28:45 ET
Table 'Jihlava III' 6-max Seat #6 is the button
Seat 1: 19991986830 ($20.72 in chips) 
Seat 2: ghost4c ($6.66 in chips) 
Seat 3: rioma10 ($9.02 in chips) 
Seat 4: jimeshka ($5.32 in chips) 
Seat 6: DrLevty ($10.55 in chips) 
19991986830: posts small blind $0.05
ghost4c: posts big blind $0.10
Jacub1987: sits out 
*** HOLE CARDS ***
rioma10: folds 
jimeshka: calls $0.10
DrLevty: folds 
19991986830: calls $0.05
ghost4c: checks 
*** FLOP *** [2h 8c Kh]
19991986830: checks 
ghost4c: checks 
jimeshka: checks 
*** TURN *** [2h 8c Kh] [9d]
19991986830: bets $0.10
ghost4c: calls $0.10
jimeshka: calls $0.10
*** RIVER *** [2h 8c Kh 9d] [3s]
19991986830: bets $0.10
ghost4c: calls $0.10
jimeshka: folds 
*** SHOW DOWN ***
19991986830: shows [7c 3d] (a pair of Threes)
ghost4c: shows [Jh 9c] (a pair of Nines)
ghost4c collected $0.76 from pot
*** SUMMARY ***
Total pot $0.80 | Rake $0.04 
Board [2h 8c Kh 9d 3s]
Seat 1: 19991986830 (small blind) showed [7c 3d] and lost with a pair of Threes
Seat 2: ghost4c (big blind) showed [Jh 9c] and won ($0.76) with a pair of Nines
Seat 3: rioma10 folded before Flop (didn't bet)
Seat 4: jimeshka folded on the River
Seat 6: DrLevty (button) folded before Flop (didn't bet)



PokerStars Hand #222973969205:  Hold'em No Limit ($0.05/$0.10 USD) - 2021/01/23 17:04:03 ET
Table 'Jihlava III' 6-max Seat #1 is the button
Seat 1: 19991986830 ($18.94 in chips) 
Seat 2: ghost4c ($10.24 in chips) 
Seat 4: jimeshka ($3.75 in chips) 
Seat 5: Lumbojack ($17.30 in chips) 
Seat 6: DrLevty ($10.30 in chips) 
ghost4c: posts small blind $0.05
jimeshka: posts big blind $0.10
*** HOLE CARDS ***
Lumbojack: folds 
DrLevty: folds 
19991986830: folds 
ghost4c: folds 
Uncalled bet ($0.05) returned to jimeshka
jimeshka collected $0.10 from pot
jimeshka: doesn't show hand 
*** SUMMARY ***
Total pot $0.10 | Rake $0 
Seat 1: 19991986830 (button) folded before Flop (didn't bet)
Seat 2: ghost4c (small blind) folded before Flop
Seat 4: jimeshka (big blind) collected ($0.10)
Seat 5: Lumbojack folded before Flop (didn't bet)
Seat 6: DrLevty folded before Flop (didn't bet)



PokerStars Hand #222975232600:  Hold'em No Limit ($0.05/$0.10 USD) - 2021/01/23 17:29:30 ET
Table 'Jihlava III' 6-max Seat #1 is the button
Seat 1: 19991986830 ($20.42 in chips) 
Seat 2: ghost4c ($7.12 in chips) 
Seat 3: rioma10 ($9.02 in chips) 
Seat 4: jimeshka ($5.12 in chips) 
Seat 6: DrLevty ($10.55 in chips) 
ghost4c: posts small blind $0.05
rioma10: posts big blind $0.10
Jacub1987: sits out 
*** HOLE CARDS ***
jimeshka: raises $0.10 to $0.20
DrLevty: folds 
19991986830: folds 
ghost4c: folds 
rioma10: calls $0.10
*** FLOP *** [8c 9d 2h]
rioma10: checks 
jimeshka: bets $0.22
rioma10: folds 
Uncalled bet ($0.22) returned to jimeshka
jimeshka collected $0.43 from pot
jimeshka: doesn't show hand 
*** SUMMARY ***
Total pot $0.45 | Rake $0.02 
Board [8c 9d 2h]
Seat 1: 19991986830 (button) folded before Flop (didn't bet)
Seat 2: ghost4c (small blind) folded before Flop
Seat 3: rioma10 (big blind) folded on the Flop
Seat 4: jimeshka collected ($0.43)
Seat 6: DrLevty folded before Flop (didn't bet)



PokerStars Hand #222973990810:  Hold'em No Limit ($0.05/$0.10 USD) - 2021/01/23 17:04:18 ET
Table 'Jihlava III' 6-max Seat #2 is the button
Seat 1: 19991986830 ($18.94 in chips) 
Seat 2: ghost4c ($10.19 in chips) 
Seat 4: jimeshka ($3.80 in chips) 
Seat 5: Lumbojack ($17.30 in chips) 
Seat 6: DrLevty ($10.30 in chips) 
jimeshka: posts small blind $0.05
Lumbojack: posts big blind $0.10
*** HOLE CARDS ***
DrLevty: folds 
19991986830: folds 
ghost4c: folds 
jimeshka: calls $0.05
goatyx joins the table at seat #3 
Lumbojack: raises $0.30 to $0.40
jimeshka: folds 
Uncalled bet ($0.30) returned to Lumbojack
Lumbojack collected $0.20 from pot
Lumbojack: doesn't show hand 
*** SUMMARY ***
Total pot $0.20 | Rake $0 
Seat 1: 19991986830 folded before Flop (didn't bet)
Seat 2: ghost4c (button) folded before Flop (didn't bet)
Seat 4: jimeshka (small blind) folded before Flop
Seat 5: Lumbojack (big blind) collected ($0.20)
Seat 6: DrLevty folded before Flop (didn't bet)



PokerStars Hand #222975250171:  Hold'em No Limit ($0.05/$0.10 USD) - 2021/01/23 17:29:52 ET
Table 'Jihlava III' 6-max Seat #2 is the button
Seat 1: 19991986830 ($20.42 in chips) 
Seat 2: ghost4c ($7.07 in chips) 
Seat 3: rioma10 ($10 in chips) 
Seat 4: jimeshka ($5.35 in chips) 
Seat 6: DrLevty ($10.55 in chips) 
rioma10: posts small blind $0.05
jimeshka: posts big blind $0.10
Jacub1987: sits out 
*** HOLE CARDS ***
DrLevty: folds 
19991986830: raises $0.20 to $0.30
ghost4c: folds 
rioma10: folds 
jimeshka: folds 
Uncalled bet ($0.20) returned to 19991986830
19991986830 collected $0.25 from pot
*** SUMMARY ***
Total pot $0.25 | Rake $0 
Seat 1: 19991986830 collected ($0.25)
Seat 2: ghost4c (button) folded before Flop (didn't bet)
Seat 3: rioma10 (small blind) folded before Flop
Seat 4: jimeshka (big blind) folded before Flop
Seat 6: DrLevty folded before Flop (didn't bet)



PokerStars Hand #222974003262:  Hold'em No Limit ($0.05/$0.10 USD) - 2021/01/23 17:04:33 ET
Table 'Jihlava III' 6-max Seat #4 is the button
Seat 1: 19991986830 ($18.94 in chips) 
Seat 2: ghost4c ($10.19 in chips) 
Seat 3: goatyx ($10 in chips) 
Seat 4: jimeshka ($3.70 in chips) 
Seat 5: Lumbojack ($17.40 in chips) 
Seat 6: DrLevty ($10.30 in chips) 
Lumbojack: posts small blind $0.05
DrLevty: posts big blind $0.10
goatyx: posts big blind $0.10
*** HOLE CARDS ***
19991986830: raises $0.10 to $0.20
ghost4c: folds 
goatyx: raises $0.10 to $0.30
jimeshka: folds 
Lumbojack: folds 
DrLevty: folds 
19991986830: calls $0.10
*** FLOP *** [6d Qh Ad]
19991986830: checks 
goatyx: bets $0.72
19991986830: calls $0.72
*** TURN *** [6d Qh Ad] [5s]
19991986830: checks 
goatyx: checks 
*** RIVER *** [6d Qh Ad 5s] [9c]
19991986830: checks 
goatyx: checks 
*** SHOW DOWN ***
19991986830: shows [Ah 2c] (a pair of Aces)
goatyx: mucks hand 
19991986830 collected $2.09 from pot
*** SUMMARY ***
Total pot $2.19 | Rake $0.10 
Board [6d Qh Ad 5s 9c]
Seat 1: 19991986830 showed [Ah 2c] and won ($2.09) with a pair of Aces
Seat 2: ghost4c folded before Flop (didn't bet)
Seat 3: goatyx mucked
Seat 4: jimeshka (button) folded before Flop (didn't bet)
Seat 5: Lumbojack (small blind) folded before Flop
Seat 6: DrLevty (big blind) folded before Flop



PokerStars Hand #222975259428:  Hold'em No Limit ($0.05/$0.10 USD) - 2021/01/23 17:30:03 ET
Table 'Jihlava III' 6-max Seat #3 is the button
Seat 1: 19991986830 ($20.57 in chips) 
Seat 2: ghost4c ($7.07 in chips) 
Seat 3: rioma10 ($9.95 in chips) 
Seat 4: jimeshka ($5.25 in chips) 
Seat 5: Jacub1987 ($10 in chips) 
Seat 6: DrLevty ($10.55 in chips) 
jimeshka: posts small blind $0.05
Jacub1987: posts big blind $0.10
*** HOLE CARDS ***
DrLevty: raises $0.20 to $0.30
19991986830: calls $0.30
ghost4c: folds 
rioma10: folds 
jimeshka: folds 
Jacub1987: folds 
*** FLOP *** [Qh 5h Ah]
DrLevty: checks 
19991986830: bets $0.20
DrLevty: calls $0.20
*** TURN *** [Qh 5h Ah] [Ts]
DrLevty: checks 
19991986830: checks 
*** RIVER *** [Qh 5h Ah Ts] [4h]
DrLevty: checks 
19991986830: checks 
*** SHOW DOWN ***
DrLevty: shows [9s 9h] (a flush, Ace high)
19991986830: mucks hand 
DrLevty collected $1.10 from pot
*** SUMMARY ***
Total pot $1.15 | Rake $0.05 
Board [Qh 5h Ah Ts 4h]
Seat 1: 19991986830 mucked
Seat 2: ghost4c folded before Flop (didn't bet)
Seat 3: rioma10 (button) folded before Flop (didn't bet)
Seat 4: jimeshka (small blind) folded before Flop
Seat 5: Jacub1987 (big blind) folded before Flop
Seat 6: DrLevty showed [9s 9h] and won ($1.10) with a flush, Ace high



PokerStars Hand #222974037973:  Hold'em No Limit ($0.05/$0.10 USD) - 2021/01/23 17:05:14 ET
Table 'Jihlava III' 6-max Seat #5 is the button
Seat 1: 19991986830 ($20.01 in chips) 
Seat 2: ghost4c ($10.19 in chips) 
Seat 3: goatyx ($8.98 in chips) 
Seat 4: jimeshka ($3.70 in chips) 
Seat 5: Lumbojack ($17.35 in chips) 
Seat 6: DrLevty ($10.20 in chips) 
DrLevty: posts small blind $0.05
19991986830: posts big blind $0.10
*** HOLE CARDS ***
ghost4c: folds 
goatyx: calls $0.10
jimeshka: calls $0.10
Lumbojack has timed out
Lumbojack: folds 
DrLevty: folds 
19991986830: checks 
*** FLOP *** [7c 7d 9h]
19991986830 has timed out
19991986830: checks 
goatyx: checks 
jimeshka: checks 
*** TURN *** [7c 7d 9h] [4c]
19991986830 has timed out
19991986830: checks 
goatyx: bets $0.17
jimeshka: calls $0.17
19991986830 has timed out
19991986830: folds 
*** RIVER *** [7c 7d 9h 4c] [Jh]
goatyx: checks 
jimeshka: bets $0.33
goatyx: folds 
Uncalled bet ($0.33) returned to jimeshka
jimeshka collected $0.66 from pot
jimeshka: doesn't show hand 
*** SUMMARY ***
Total pot $0.69 | Rake $0.03 
Board [7c 7d 9h 4c Jh]
Seat 1: 19991986830 (big blind) folded on the Turn
Seat 2: ghost4c folded before Flop (didn't bet)
Seat 3: goatyx folded on the River
Seat 4: jimeshka collected ($0.66)
Seat 5: Lumbojack (button) folded before Flop (didn't bet)
Seat 6: DrLevty (small blind) folded before Flop



PokerStars Hand #222975289101:  Hold'em No Limit ($0.05/$0.10 USD) - 2021/01/23 17:30:41 ET
Table 'Jihlava III' 6-max Seat #4 is the button
Seat 1: 19991986830 ($20.07 in chips) 
Seat 2: ghost4c ($7.07 in chips) 
Seat 3: rioma10 ($9.95 in chips) 
Seat 4: jimeshka ($5.20 in chips) 
Seat 5: Jacub1987 ($10 in chips) 
Seat 6: DrLevty ($11.15 in chips) 
Jacub1987: posts small blind $0.05
DrLevty: posts big blind $0.10
*** HOLE CARDS ***
19991986830: calls $0.10
ghost4c: raises $0.30 to $0.40
rioma10: folds 
jimeshka: calls $0.40
Jacub1987: folds 
DrLevty: folds 
19991986830: calls $0.30
*** FLOP *** [As Kc 8c]
19991986830: checks 
ghost4c: bets $0.65
jimeshka: folds 
19991986830: folds 
Uncalled bet ($0.65) returned to ghost4c
ghost4c collected $1.29 from pot
ghost4c: doesn't show hand 
*** SUMMARY ***
Total pot $1.35 | Rake $0.06 
Board [As Kc 8c]
Seat 1: 19991986830 folded on the Flop
Seat 2: ghost4c collected ($1.29)
Seat 3: rioma10 folded before Flop (didn't bet)
Seat 4: jimeshka (button) folded on the Flop
Seat 5: Jacub1987 (small blind) folded before Flop
Seat 6: DrLevty (big blind) folded before Flop



PokerStars Hand #222974152772:  Hold'em No Limit ($0.05/$0.10 USD) - 2021/01/23 17:07:31 ET
Table 'Jihlava III' 6-max Seat #6 is the button
Seat 2: ghost4c ($10.19 in chips) 
Seat 3: goatyx ($8.71 in chips) 
Seat 4: jimeshka ($4.09 in chips) 
Seat 6: DrLevty ($10.15 in chips) 
ghost4c: posts small blind $0.05
goatyx: posts big blind $0.10
*** HOLE CARDS ***
jimeshka: calls $0.10
DrLevty: raises $0.40 to $0.50
ghost4c: folds 
goatyx: folds 
jimeshka: folds 
Uncalled bet ($0.40) returned to DrLevty
DrLevty collected $0.35 from pot
DrLevty: doesn't show hand 
*** SUMMARY ***
Total pot $0.35 | Rake $0 
Seat 2: ghost4c (small blind) folded before Flop
Seat 3: goatyx (big blind) folded before Flop
Seat 4: jimeshka folded before Flop
Seat 6: DrLevty (button) collected ($0.35)



PokerStars Hand #222975313864:  Hold'em No Limit ($0.05/$0.10 USD) - 2021/01/23 17:31:12 ET
Table 'Jihlava III' 6-max Seat #5 is the button
Seat 1: 19991986830 ($19.67 in chips) 
Seat 2: ghost4c ($7.96 in chips) 
Seat 3: rioma10 ($9.95 in chips) 
Seat 4: jimeshka ($4.80 in chips) 
Seat 5: Jacub1987 ($10 in chips) 
Seat 6: DrLevty ($11.05 in chips) 
DrLevty: posts small blind $0.05
19991986830: posts big blind $0.10
*** HOLE CARDS ***
ghost4c: folds 
rioma10: folds 
jimeshka: folds 
Jacub1987 has timed out
Jacub1987: folds 
DrLevty: raises $0.20 to $0.30
19991986830: calls $0.20
*** FLOP *** [2h 9d 4d]
DrLevty: checks 
19991986830: bets $0.20
DrLevty: calls $0.20
*** TURN *** [2h 9d 4d] [Jh]
DrLevty: checks 
19991986830: bets $0.30
DrLevty: folds 
Uncalled bet ($0.30) returned to 19991986830
19991986830 collected $0.96 from pot
*** SUMMARY ***
Total pot $1 | Rake $0.04 
Board [2h 9d 4d Jh]
Seat 1: 19991986830 (big blind) collected ($0.96)
Seat 2: ghost4c folded before Flop (didn't bet)
Seat 3: rioma10 folded before Flop (didn't bet)
Seat 4: jimeshka folded before Flop (didn't bet)
Seat 5: Jacub1987 (button) folded before Flop (didn't bet)
Seat 6: DrLevty (small blind) folded on the Turn



PokerStars Hand #222974164525:  Hold'em No Limit ($0.05/$0.10 USD) - 2021/01/23 17:07:46 ET
Table 'Jihlava III' 6-max Seat #2 is the button
Seat 2: ghost4c ($10.14 in chips) 
Seat 3: goatyx ($8.61 in chips) 
Seat 4: jimeshka ($3.99 in chips) 
Seat 5: Lumbojack ($17.35 in chips) 
Seat 6: DrLevty ($10.40 in chips) 
goatyx: posts small blind $0.05
jimeshka: posts big blind $0.10
*** HOLE CARDS ***
Lumbojack: folds 
DrLevty: raises $0.20 to $0.30
ghost4c: folds 
goatyx: folds 
jimeshka: folds 
Uncalled bet ($0.20) returned to DrLevty
DrLevty collected $0.25 from pot
DrLevty: doesn't show hand 
*** SUMMARY ***
Total pot $0.25 | Rake $0 
Seat 2: ghost4c (button) folded before Flop (didn't bet)
Seat 3: goatyx (small blind) folded before Flop
Seat 4: jimeshka (big blind) folded before Flop
Seat 5: Lumbojack folded before Flop (didn't bet)
Seat 6: DrLevty collected ($0.25)



PokerStars Hand #222975347675:  Hold'em No Limit ($0.05/$0.10 USD) - 2021/01/23 17:31:55 ET
Table 'Jihlava III' 6-max Seat #6 is the button
Seat 1: 19991986830 ($20.13 in chips) 
Seat 2: ghost4c ($7.96 in chips) 
Seat 3: rioma10 ($9.95 in chips) 
Seat 4: jimeshka ($4.80 in chips) 
Seat 5: Jacub1987 ($10 in chips) 
Seat 6: DrLevty ($10.55 in chips) 
19991986830: posts small blind $0.05
ghost4c: posts big blind $0.10
*** HOLE CARDS ***
rioma10: raises $0.20 to $0.30
jimeshka: folds 
Jacub1987: folds 
DrLevty: folds 
19991986830: calls $0.25
ghost4c: calls $0.20
*** FLOP *** [4s Qh Kh]
19991986830: checks 
ghost4c: bets $0.65
rioma10: folds 
19991986830: folds 
Uncalled bet ($0.65) returned to ghost4c
ghost4c collected $0.86 from pot
ghost4c: doesn't show hand 
*** SUMMARY ***
Total pot $0.90 | Rake $0.04 
Board [4s Qh Kh]
Seat 1: 19991986830 (small blind) folded on the Flop
Seat 2: ghost4c (big blind) collected ($0.86)
Seat 3: rioma10 folded on the Flop
Seat 4: jimeshka folded before Flop (didn't bet)
Seat 5: Jacub1987 folded before Flop (didn't bet)
Seat 6: DrLevty (button) folded before Flop (didn't bet)



PokerStars Hand #222974172353:  Hold'em No Limit ($0.05/$0.10 USD) - 2021/01/23 17:07:55 ET
Table 'Jihlava III' 6-max Seat #3 is the button
Seat 1: 19991986830 ($19.91 in chips) 
Seat 2: ghost4c ($10.14 in chips) 
Seat 3: goatyx ($8.56 in chips) 
Seat 4: jimeshka ($3.89 in chips) 
Seat 5: Lumbojack ($17.35 in chips) 
Seat 6: DrLevty ($10.55 in chips) 
jimeshka: posts small blind $0.05
Lumbojack: posts big blind $0.10
19991986830: posts small blind $0.05
*** HOLE CARDS ***
DrLevty: folds 
19991986830: calls $0.10
ghost4c: raises $0.30 to $0.40
goatyx: raises $0.40 to $0.80
jimeshka: folds 
Lumbojack: folds 
19991986830: folds 
ghost4c: calls $0.40
*** FLOP *** [8d Ah 8h]
ghost4c: checks 
goatyx: bets $0.91
ghost4c: calls $0.91
*** TURN *** [8d Ah 8h] [4s]
ghost4c: checks 
goatyx: bets $1.78
ghost4c: folds 
Uncalled bet ($1.78) returned to goatyx
goatyx collected $3.55 from pot
goatyx: doesn't show hand 
*** SUMMARY ***
Total pot $3.72 | Rake $0.17 
Board [8d Ah 8h 4s]
Seat 1: 19991986830 folded before Flop
Seat 2: ghost4c folded on the Turn
Seat 3: goatyx (button) collected ($3.55)
Seat 4: jimeshka (small blind) folded before Flop
Seat 5: Lumbojack (big blind) folded before Flop
Seat 6: DrLevty folded before Flop (didn't bet)



PokerStars Hand #222975374980:  Hold'em No Limit ($0.05/$0.10 USD) - 2021/01/23 17:32:30 ET
Table 'Jihlava III' 6-max Seat #1 is the button
Seat 1: 19991986830 ($19.83 in chips) 
Seat 2: ghost4c ($8.52 in chips) 
Seat 3: rioma10 ($9.65 in chips) 
Seat 4: jimeshka ($4.80 in chips) 
Seat 5: Jacub1987 ($10 in chips) 
Seat 6: DrLevty ($10.55 in chips) 
ghost4c: posts small blind $0.05
rioma10: posts big blind $0.10
*** HOLE CARDS ***
jimeshka: calls $0.10
Jacub1987: folds 
DrLevty: folds 
19991986830: folds 
ghost4c: folds 
rioma10: checks 
*** FLOP *** [3c Qc 5s]
rioma10: checks 
jimeshka: bets $0.10
rioma10: folds 
Uncalled bet ($0.10) returned to jimeshka
jimeshka collected $0.24 from pot
jimeshka: doesn't show hand 
*** SUMMARY ***
Total pot $0.25 | Rake $0.01 
Board [3c Qc 5s]
Seat 1: 19991986830 (button) folded before Flop (didn't bet)
Seat 2: ghost4c (small blind) folded before Flop
Seat 3: rioma10 (big blind) folded on the Flop
Seat 4: jimeshka collected ($0.24)
Seat 5: Jacub1987 folded before Flop (didn't bet)
Seat 6: DrLevty folded before Flop (didn't bet)



PokerStars Hand #222974216580:  Hold'em No Limit ($0.05/$0.10 USD) - 2021/01/23 17:08:48 ET
Table 'Jihlava III' 6-max Seat #4 is the button
Seat 1: 19991986830 ($19.76 in chips) 
Seat 2: ghost4c ($8.43 in chips) 
Seat 3: goatyx ($10.40 in chips) 
Seat 4: jimeshka ($3.84 in chips) 
Seat 5: Lumbojack ($17.25 in chips) 
Seat 6: DrLevty ($10.55 in chips) 
Lumbojack: posts small blind $0.05
DrLevty: posts big blind $0.10
*** HOLE CARDS ***
19991986830: raises $0.10 to $0.20
ghost4c: calls $0.20
goatyx: folds 
jimeshka: calls $0.20
Lumbojack: folds 
DrLevty: folds 
*** FLOP *** [8h Qd 2c]
19991986830: bets $0.36
goatyx leaves the table
ghost4c: folds 
jimeshka: calls $0.36
*** TURN *** [8h Qd 2c] [6d]
rioma10 joins the table at seat #3 
19991986830: bets $0.70
jimeshka: folds 
Uncalled bet ($0.70) returned to 19991986830
19991986830 collected $1.40 from pot
*** SUMMARY ***
Total pot $1.47 | Rake $0.07 
Board [8h Qd 2c 6d]
Seat 1: 19991986830 collected ($1.40)
Seat 2: ghost4c folded on the Flop
Seat 3: goatyx folded before Flop (didn't bet)
Seat 4: jimeshka (button) folded on the Turn
Seat 5: Lumbojack (small blind) folded before Flop
Seat 6: DrLevty (big blind) folded before Flop



PokerStars Hand #222975400079:  Hold'em No Limit ($0.05/$0.10 USD) - 2021/01/23 17:33:02 ET
Table 'Jihlava III' 6-max Seat #2 is the button
Seat 1: 19991986830 ($19.83 in chips) 
Seat 2: ghost4c ($8.47 in chips) 
Seat 3: rioma10 ($9.55 in chips) 
Seat 4: jimeshka ($4.94 in chips) 
Seat 5: Jacub1987 ($10 in chips) 
Seat 6: DrLevty ($10.55 in chips) 
rioma10: posts small blind $0.05
jimeshka: posts big blind $0.10
*** HOLE CARDS ***
Jacub1987: folds 
DrLevty: folds 
19991986830: folds 
ghost4c: raises $0.20 to $0.30
rioma10: folds 
jimeshka: calls $0.20
*** FLOP *** [5c 9h 8s]
jimeshka: checks 
ghost4c: bets $0.31
jimeshka: folds 
Uncalled bet ($0.31) returned to ghost4c
ghost4c collected $0.62 from pot
ghost4c: doesn't show hand 
*** SUMMARY ***
Total pot $0.65 | Rake $0.03 
Board [5c 9h 8s]
Seat 1: 19991986830 folded before Flop (didn't bet)
Seat 2: ghost4c (button) collected ($0.62)
Seat 3: rioma10 (small blind) folded before Flop
Seat 4: jimeshka (big blind) folded on the Flop
Seat 5: Jacub1987 folded before Flop (didn't bet)
Seat 6: DrLevty folded before Flop (didn't bet)



PokerStars Hand #222974250128:  Hold'em No Limit ($0.05/$0.10 USD) - 2021/01/23 17:09:28 ET
Table 'Jihlava III' 6-max Seat #5 is the button
Seat 1: 19991986830 ($20.60 in chips) 
Seat 2: ghost4c ($8.23 in chips) 
Seat 4: jimeshka ($3.28 in chips) 
Seat 5: Lumbojack ($17.20 in chips) 
Seat 6: DrLevty ($10.45 in chips) 
DrLevty: posts small blind $0.05
19991986830: posts big blind $0.10
rioma10: sits out 
*** HOLE CARDS ***
ghost4c: folds 
jimeshka: folds 
Lumbojack: raises $0.20 to $0.30
DrLevty: folds 
19991986830: folds 
Uncalled bet ($0.20) returned to Lumbojack
Lumbojack collected $0.25 from pot
Lumbojack: doesn't show hand 
*** SUMMARY ***
Total pot $0.25 | Rake $0 
Seat 1: 19991986830 (big blind) folded before Flop
Seat 2: ghost4c folded before Flop (didn't bet)
Seat 4: jimeshka folded before Flop (didn't bet)
Seat 5: Lumbojack (button) collected ($0.25)
Seat 6: DrLevty (small blind) folded before Flop



PokerStars Hand #222975423974:  Hold'em No Limit ($0.05/$0.10 USD) - 2021/01/23 17:33:32 ET
Table 'Jihlava III' 6-max Seat #3 is the button
Seat 1: 19991986830 ($19.83 in chips) 
Seat 2: ghost4c ($8.79 in chips) 
Seat 3: rioma10 ($9.50 in chips) 
Seat 4: jimeshka ($4.64 in chips) 
Seat 5: Jacub1987 ($10 in chips) 
Seat 6: DrLevty ($10.55 in chips) 
jimeshka: posts small blind $0.05
Jacub1987: posts big blind $0.10
*** HOLE CARDS ***
DrLevty: folds 
19991986830: raises $0.10 to $0.20
ghost4c: folds 
rioma10: folds 
jimeshka: calls $0.15
Jacub1987: folds 
*** FLOP *** [3d 3c 2h]
jimeshka: checks 
19991986830: bets $0.20
jimeshka: calls $0.20
*** TURN *** [3d 3c 2h] [Ks]
jimeshka: checks 
19991986830: checks 
*** RIVER *** [3d 3c 2h Ks] [8d]
jimeshka: bets $0.86
19991986830: calls $0.86
*** SHOW DOWN ***
jimeshka: shows [7d 6d] (a pair of Threes)
19991986830: shows [2s Kc] (two pair, Kings and Threes)
19991986830 collected $2.50 from pot
*** SUMMARY ***
Total pot $2.62 | Rake $0.12 
Board [3d 3c 2h Ks 8d]
Seat 1: 19991986830 showed [2s Kc] and won ($2.50) with two pair, Kings and Threes
Seat 2: ghost4c folded before Flop (didn't bet)
Seat 3: rioma10 (button) folded before Flop (didn't bet)
Seat 4: jimeshka (small blind) showed [7d 6d] and lost with a pair of Threes
Seat 5: Jacub1987 (big blind) folded before Flop
Seat 6: DrLevty folded before Flop (didn't bet)



PokerStars Hand #222974258730:  Hold'em No Limit ($0.05/$0.10 USD) - 2021/01/23 17:09:39 ET
Table 'Jihlava III' 6-max Seat #6 is the button
Seat 1: 19991986830 ($20.50 in chips) 
Seat 2: ghost4c ($8.23 in chips) 
Seat 4: jimeshka ($3.28 in chips) 
Seat 5: Lumbojack ($17.35 in chips) 
Seat 6: DrLevty ($10.40 in chips) 
19991986830: posts small blind $0.05
ghost4c: posts big blind $0.10
rioma10: sits out 
*** HOLE CARDS ***
jimeshka: folds 
Lumbojack: raises $0.15 to $0.25
DrLevty: folds 
19991986830: folds 
ghost4c: folds 
Uncalled bet ($0.15) returned to Lumbojack
Lumbojack collected $0.25 from pot
Lumbojack: doesn't show hand 
*** SUMMARY ***
Total pot $0.25 | Rake $0 
Seat 1: 19991986830 (small blind) folded before Flop
Seat 2: ghost4c (big blind) folded before Flop
Seat 4: jimeshka folded before Flop (didn't bet)
Seat 5: Lumbojack collected ($0.25)
Seat 6: DrLevty (button) folded before Flop (didn't bet)



PokerStars Hand #222975452639:  Hold'em No Limit ($0.05/$0.10 USD) - 2021/01/23 17:34:09 ET
Table 'Jihlava III' 6-max Seat #4 is the button
Seat 1: 19991986830 ($21.07 in chips) 
Seat 2: ghost4c ($8.79 in chips) 
Seat 3: rioma10 ($9.50 in chips) 
Seat 4: jimeshka ($3.38 in chips) 
Seat 5: Jacub1987 ($10 in chips) 
Seat 6: DrLevty ($10.55 in chips) 
Jacub1987: posts small blind $0.05
DrLevty: posts big blind $0.10
*** HOLE CARDS ***
19991986830: raises $0.10 to $0.20
ghost4c: folds 
rioma10: raises $0.60 to $0.80
jimeshka: folds 
Jacub1987: calls $0.75
DrLevty: folds 
19991986830: calls $0.60
*** FLOP *** [Jc 3s 9d]
Jacub1987: checks 
19991986830: checks 
rioma10: checks 
*** TURN *** [Jc 3s 9d] [Jd]
Jacub1987: bets $1.24
19991986830: folds 
rioma10: folds 
Uncalled bet ($1.24) returned to Jacub1987
Jacub1987 collected $2.39 from pot
*** SUMMARY ***
Total pot $2.50 | Rake $0.11 
Board [Jc 3s 9d Jd]
Seat 1: 19991986830 folded on the Turn
Seat 2: ghost4c folded before Flop (didn't bet)
Seat 3: rioma10 folded on the Turn
Seat 4: jimeshka (button) folded before Flop (didn't bet)
Seat 5: Jacub1987 (small blind) collected ($2.39)
Seat 6: DrLevty (big blind) folded before Flop



PokerStars Hand #222974267581:  Hold'em No Limit ($0.05/$0.10 USD) - 2021/01/23 17:09:50 ET
Table 'Jihlava III' 6-max Seat #1 is the button
Seat 1: 19991986830 ($20.45 in chips) 
Seat 2: ghost4c ($8.13 in chips) 
Seat 3: rioma10 ($10 in chips) 
Seat 4: jimeshka ($3.28 in chips) 
Seat 5: Lumbojack ($17.50 in chips) 
Seat 6: DrLevty ($10.40 in chips) 
ghost4c: posts small blind $0.05
rioma10: posts big blind $0.10
*** HOLE CARDS ***
jimeshka: calls $0.10
Lumbojack: folds 
DrLevty: folds 
19991986830: raises $0.20 to $0.30
ghost4c: folds 
rioma10: folds 
jimeshka: calls $0.20
*** FLOP *** [3d 5s 2c]
jimeshka: checks 
19991986830: bets $0.36
jimeshka: folds 
Uncalled bet ($0.36) returned to 19991986830
19991986830 collected $0.72 from pot
*** SUMMARY ***
Total pot $0.75 | Rake $0.03 
Board [3d 5s 2c]
Seat 1: 19991986830 (button) collected ($0.72)
Seat 2: ghost4c (small blind) folded before Flop
Seat 3: rioma10 (big blind) folded before Flop
Seat 4: jimeshka folded on the Flop
Seat 5: Lumbojack folded before Flop (didn't bet)
Seat 6: DrLevty folded before Flop (didn't bet)



PokerStars Hand #222975495790:  Hold'em No Limit ($0.05/$0.10 USD) - 2021/01/23 17:35:04 ET
Table 'Jihlava III' 6-max Seat #5 is the button
Seat 1: 19991986830 ($20.27 in chips) 
Seat 2: ghost4c ($8.79 in chips) 
Seat 3: rioma10 ($10 in chips) 
Seat 4: jimeshka ($3.38 in chips) 
Seat 5: Jacub1987 ($11.59 in chips) 
Seat 6: DrLevty ($10.45 in chips) 
DrLevty: posts small blind $0.05
19991986830: posts big blind $0.10
*** HOLE CARDS ***
ghost4c: folds 
rioma10: folds 
jimeshka: calls $0.10
Jacub1987: raises $0.25 to $0.35
DrLevty: folds 
ghost4c leaves the table
19991986830: raises $0.25 to $0.60
jimeshka: folds 
Jacub1987: calls $0.25
*** FLOP *** [7s Kd 7h]
19991986830: checks 
Jacub1987: checks 
*** TURN *** [7s Kd 7h] [Qh]
19991986830: checks 
Jacub1987: bets $0.67
19991986830: calls $0.67
*** RIVER *** [7s Kd 7h Qh] [Ts]
19991986830: checks 
Jacub1987: checks 
*** SHOW DOWN ***
19991986830: shows [Kh Ac] (two pair, Kings and Sevens)
Jacub1987: mucks hand 
19991986830 collected $2.57 from pot
*** SUMMARY ***
Total pot $2.69 | Rake $0.12 
Board [7s Kd 7h Qh Ts]
Seat 1: 19991986830 (big blind) showed [Kh Ac] and won ($2.57) with two pair, Kings and Sevens
Seat 2: ghost4c folded before Flop (didn't bet)
Seat 3: rioma10 folded before Flop (didn't bet)
Seat 4: jimeshka folded before Flop
Seat 5: Jacub1987 (button) mucked
Seat 6: DrLevty (small blind) folded before Flop



PokerStars Hand #222974285596:  Hold'em No Limit ($0.05/$0.10 USD) - 2021/01/23 17:10:11 ET
Table 'Jihlava III' 6-max Seat #2 is the button
Seat 1: 19991986830 ($20.87 in chips) 
Seat 2: ghost4c ($8.08 in chips) 
Seat 3: rioma10 ($9.90 in chips) 
Seat 4: jimeshka ($2.98 in chips) 
Seat 5: Lumbojack ($17.50 in chips) 
Seat 6: DrLevty ($10.40 in chips) 
rioma10: posts small blind $0.05
jimeshka: posts big blind $0.10
*** HOLE CARDS ***
Lumbojack: folds 
DrLevty: folds 
19991986830: calls $0.10
ghost4c: folds 
rioma10: raises $0.30 to $0.40
jimeshka: folds 
19991986830: calls $0.30
*** FLOP *** [4h 6h 8h]
rioma10: checks 
19991986830: checks 
*** TURN *** [4h 6h 8h] [Tc]
rioma10: checks 
19991986830: checks 
*** RIVER *** [4h 6h 8h Tc] [6c]
rioma10: checks 
19991986830: bets $0.43
rioma10: folds 
Uncalled bet ($0.43) returned to 19991986830
19991986830 collected $0.86 from pot
*** SUMMARY ***
Total pot $0.90 | Rake $0.04 
Board [4h 6h 8h Tc 6c]
Seat 1: 19991986830 collected ($0.86)
Seat 2: ghost4c (button) folded before Flop (didn't bet)
Seat 3: rioma10 (small blind) folded on the River
Seat 4: jimeshka (big blind) folded before Flop
Seat 5: Lumbojack folded before Flop (didn't bet)
Seat 6: DrLevty folded before Flop (didn't bet)



PokerStars Hand #222975543183:  Hold'em No Limit ($0.05/$0.10 USD) - 2021/01/23 17:35:52 ET
Table 'Jihlava III' 6-max Seat #6 is the button
Seat 1: 19991986830 ($21.57 in chips) 
Seat 3: rioma10 ($10 in chips) 
Seat 4: jimeshka ($3.28 in chips) 
Seat 5: Jacub1987 ($10.32 in chips) 
Seat 6: DrLevty ($10.40 in chips) 
19991986830: posts small blind $0.05
rioma10: posts big blind $0.10
*** HOLE CARDS ***
No1Sparkles joins the table at seat #2 
jimeshka: calls $0.10
Jacub1987: raises $0.35 to $0.45
DrLevty: folds 
19991986830: calls $0.40
rioma10: folds 
jimeshka: calls $0.35
*** FLOP *** [7c 9c 9h]
19991986830: checks 
jimeshka: checks 
Jacub1987: bets $0.55
19991986830: calls $0.55
jimeshka: calls $0.55
*** TURN *** [7c 9c 9h] [5h]
19991986830: checks 
jimeshka: checks 
Jacub1987: checks 
*** RIVER *** [7c 9c 9h 5h] [Ad]
19991986830: checks 
jimeshka: checks 
Jacub1987: checks 
*** SHOW DOWN ***
19991986830: shows [9d Qs] (three of a kind, Nines)
jimeshka: mucks hand 
Jacub1987: mucks hand 
19991986830 collected $2.96 from pot
*** SUMMARY ***
Total pot $3.10 | Rake $0.14 
Board [7c 9c 9h 5h Ad]
Seat 1: 19991986830 (small blind) showed [9d Qs] and won ($2.96) with three of a kind, Nines
Seat 3: rioma10 (big blind) folded before Flop
Seat 4: jimeshka mucked
Seat 5: Jacub1987 mucked
Seat 6: DrLevty (button) folded before Flop (didn't bet)



PokerStars Hand #222974337136:  Hold'em No Limit ($0.05/$0.10 USD) - 2021/01/23 17:11:13 ET
Table 'Jihlava III' 6-max Seat #3 is the button
Seat 1: 19991986830 ($21.33 in chips) 
Seat 2: ghost4c ($8.08 in chips) 
Seat 3: rioma10 ($9.50 in chips) 
Seat 4: jimeshka ($2.88 in chips) 
Seat 5: Lumbojack ($17.50 in chips) 
Seat 6: DrLevty ($10.40 in chips) 
jimeshka: posts small blind $0.05
Lumbojack: posts big blind $0.10
*** HOLE CARDS ***
DrLevty: raises $0.20 to $0.30
19991986830: folds 
ghost4c: folds 
rioma10: calls $0.30
jimeshka: folds 
Lumbojack: folds 
*** FLOP *** [4d 7s 6d]
DrLevty: checks 
rioma10: checks 
*** TURN *** [4d 7s 6d] [Qc]
DrLevty: bets $0.54
rioma10: calls $0.54
*** RIVER *** [4d 7s 6d Qc] [8s]
DrLevty: checks 
rioma10: checks 
*** SHOW DOWN ***
DrLevty: shows [Th Jh] (high card Queen)
rioma10: shows [Qh Kh] (a pair of Queens)
rioma10 collected $1.75 from pot
*** SUMMARY ***
Total pot $1.83 | Rake $0.08 
Board [4d 7s 6d Qc 8s]
Seat 1: 19991986830 folded before Flop (didn't bet)
Seat 2: ghost4c folded before Flop (didn't bet)
Seat 3: rioma10 (button) showed [Qh Kh] and won ($1.75) with a pair of Queens
Seat 4: jimeshka (small blind) folded before Flop
Seat 5: Lumbojack (big blind) folded before Flop
Seat 6: DrLevty showed [Th Jh] and lost with high card Queen



PokerStars Hand #222975580268:  Hold'em No Limit ($0.05/$0.10 USD) - 2021/01/23 17:36:40 ET
Table 'Jihlava III' 6-max Seat #1 is the button
Seat 1: 19991986830 ($23.53 in chips) 
Seat 3: rioma10 ($9.90 in chips) 
Seat 4: jimeshka ($2.28 in chips) 
Seat 5: Jacub1987 ($10 in chips) 
Seat 6: DrLevty ($10.40 in chips) 
rioma10: posts small blind $0.05
jimeshka: posts big blind $0.10
*** HOLE CARDS ***
Jacub1987: folds 
DrLevty: folds 
19991986830: folds 
rioma10: folds 
Uncalled bet ($0.05) returned to jimeshka
jimeshka collected $0.10 from pot
jimeshka: doesn't show hand 
*** SUMMARY ***
Total pot $0.10 | Rake $0 
Seat 1: 19991986830 (button) folded before Flop (didn't bet)
Seat 3: rioma10 (small blind) folded before Flop
Seat 4: jimeshka (big blind) collected ($0.10)
Seat 5: Jacub1987 folded before Flop (didn't bet)
Seat 6: DrLevty folded before Flop (didn't bet)



PokerStars Hand #222974373080:  Hold'em No Limit ($0.05/$0.10 USD) - 2021/01/23 17:11:57 ET
Table 'Jihlava III' 6-max Seat #4 is the button
Seat 1: 19991986830 ($21.33 in chips) 
Seat 2: ghost4c ($8.08 in chips) 
Seat 3: rioma10 ($10.41 in chips) 
Seat 4: jimeshka ($2.83 in chips) 
Seat 5: Lumbojack ($17.40 in chips) 
Seat 6: DrLevty ($10 in chips) 
Lumbojack: posts small blind $0.05
DrLevty: posts big blind $0.10
*** HOLE CARDS ***
19991986830: raises $0.10 to $0.20
ghost4c: calls $0.20
rioma10: folds 
jimeshka: folds 
Lumbojack: folds 
DrLevty: calls $0.10
*** FLOP *** [8h 3s Kh]
DrLevty: checks 
19991986830: bets $0.20
ghost4c: folds 
DrLevty: folds 
Uncalled bet ($0.20) returned to 19991986830
19991986830 collected $0.62 from pot
*** SUMMARY ***
Total pot $0.65 | Rake $0.03 
Board [8h 3s Kh]
Seat 1: 19991986830 collected ($0.62)
Seat 2: ghost4c folded on the Flop
Seat 3: rioma10 folded before Flop (didn't bet)
Seat 4: jimeshka (button) folded before Flop (didn't bet)
Seat 5: Lumbojack (small blind) folded before Flop
Seat 6: DrLevty (big blind) folded on the Flop



PokerStars Hand #222975592153:  Hold'em No Limit ($0.05/$0.10 USD) - 2021/01/23 17:36:56 ET
Table 'Jihlava III' 6-max Seat #3 is the button
Seat 1: 19991986830 ($23.53 in chips) 
Seat 3: rioma10 ($9.85 in chips) 
Seat 4: jimeshka ($2.33 in chips) 
Seat 5: Jacub1987 ($10 in chips) 
Seat 6: DrLevty ($10.40 in chips) 
jimeshka: posts small blind $0.05
Jacub1987: posts big blind $0.10
No1Sparkles: sits out 
*** HOLE CARDS ***
DrLevty: folds 
19991986830: raises $0.10 to $0.20
rioma10: folds 
jimeshka: calls $0.15
Jacub1987: folds 
*** FLOP *** [Ts 8d Jh]
jimeshka: checks 
19991986830: bets $0.30
jimeshka: calls $0.30
*** TURN *** [Ts 8d Jh] [5c]
jimeshka: checks 
19991986830: bets $0.30
jimeshka: calls $0.30
*** RIVER *** [Ts 8d Jh 5c] [9d]
jimeshka: bets $1.53 and is all-in
19991986830: folds 
Uncalled bet ($1.53) returned to jimeshka
jimeshka collected $1.62 from pot
jimeshka: doesn't show hand 
*** SUMMARY ***
Total pot $1.70 | Rake $0.08 
Board [Ts 8d Jh 5c 9d]
Seat 1: 19991986830 folded on the River
Seat 3: rioma10 (button) folded before Flop (didn't bet)
Seat 4: jimeshka (small blind) collected ($1.62)
Seat 5: Jacub1987 (big blind) folded before Flop
Seat 6: DrLevty folded before Flop (didn't bet)



PokerStars Hand #222974399164:  Hold'em No Limit ($0.05/$0.10 USD) - 2021/01/23 17:12:28 ET
Table 'Jihlava III' 6-max Seat #5 is the button
Seat 1: 19991986830 ($21.75 in chips) 
Seat 2: ghost4c ($7.88 in chips) 
Seat 3: rioma10 ($10.41 in chips) 
Seat 4: jimeshka ($2.83 in chips) 
Seat 5: Lumbojack ($17.35 in chips) 
Seat 6: DrLevty ($10 in chips) 
DrLevty: posts small blind $0.05
19991986830: posts big blind $0.10
*** HOLE CARDS ***
ghost4c: folds 
rioma10: folds 
jimeshka: folds 
Lumbojack: raises $0.20 to $0.30
DrLevty: raises $1.05 to $1.35
19991986830: folds 
Lumbojack: folds 
Uncalled bet ($1.05) returned to DrLevty
DrLevty collected $0.70 from pot
DrLevty: doesn't show hand 
*** SUMMARY ***
Total pot $0.70 | Rake $0 
Seat 1: 19991986830 (big blind) folded before Flop
Seat 2: ghost4c folded before Flop (didn't bet)
Seat 3: rioma10 folded before Flop (didn't bet)
Seat 4: jimeshka folded before Flop (didn't bet)
Seat 5: Lumbojack (button) folded before Flop
Seat 6: DrLevty (small blind) collected ($0.70)



PokerStars Hand #222975625772:  Hold'em No Limit ($0.05/$0.10 USD) - 2021/01/23 17:37:39 ET
Table 'Jihlava III' 6-max Seat #4 is the button
Seat 1: 19991986830 ($22.73 in chips) 
Seat 3: rioma10 ($9.85 in chips) 
Seat 4: jimeshka ($3.15 in chips) 
Seat 5: Jacub1987 ($10 in chips) 
Seat 6: DrLevty ($10.40 in chips) 
Jacub1987: posts small blind $0.05
DrLevty: posts big blind $0.10
No1Sparkles: sits out 
*** HOLE CARDS ***
19991986830: raises $0.20 to $0.30
rioma10: folds 
jimeshka: calls $0.30
Jacub1987: folds 
DrLevty: calls $0.20
*** FLOP *** [2h 2c Kd]
DrLevty: checks 
19991986830: checks 
jimeshka: bets $0.46
DrLevty: calls $0.46
19991986830: calls $0.46
*** TURN *** [2h 2c Kd] [Ah]
DrLevty: checks 
19991986830: checks 
jimeshka: checks 
*** RIVER *** [2h 2c Kd Ah] [7c]
DrLevty: checks 
19991986830: checks 
jimeshka: checks 
*** SHOW DOWN ***
DrLevty: shows [Ks Jh] (two pair, Kings and Deuces)
19991986830: mucks hand 
jimeshka: mucks hand 
DrLevty collected $2.23 from pot
*** SUMMARY ***
Total pot $2.33 | Rake $0.10 
Board [2h 2c Kd Ah 7c]
Seat 1: 19991986830 mucked
Seat 3: rioma10 folded before Flop (didn't bet)
Seat 4: jimeshka (button) mucked
Seat 5: Jacub1987 (small blind) folded before Flop
Seat 6: DrLevty (big blind) showed [Ks Jh] and won ($2.23) with two pair, Kings and Deuces



PokerStars Hand #222974427839:  Hold'em No Limit ($0.05/$0.10 USD) - 2021/01/23 17:13:03 ET
Table 'Jihlava III' 6-max Seat #6 is the button
Seat 1: 19991986830 ($21.65 in chips) 
Seat 2: ghost4c ($7.88 in chips) 
Seat 3: rioma10 ($10.41 in chips) 
Seat 4: jimeshka ($2.83 in chips) 
Seat 5: Lumbojack ($17.05 in chips) 
Seat 6: DrLevty ($10.40 in chips) 
19991986830: posts small blind $0.05
ghost4c: posts big blind $0.10
*** HOLE CARDS ***
rioma10: folds 
jimeshka: folds 
Lumbojack: folds 
DrLevty: raises $0.20 to $0.30
19991986830: calls $0.25
ghost4c: calls $0.20
*** FLOP *** [8h 5h Kd]
19991986830: checks 
ghost4c: checks 
DrLevty: bets $0.28
19991986830: calls $0.28
ghost4c: folds 
*** TURN *** [8h 5h Kd] [5s]
19991986830: checks 
DrLevty: checks 
*** RIVER *** [8h 5h Kd 5s] [3d]
19991986830: bets $0.40
DrLevty: folds 
Uncalled bet ($0.40) returned to 19991986830
19991986830 collected $1.39 from pot
*** SUMMARY ***
Total pot $1.46 | Rake $0.07 
Board [8h 5h Kd 5s 3d]
Seat 1: 19991986830 (small blind) collected ($1.39)
Seat 2: ghost4c (big blind) folded on the Flop
Seat 3: rioma10 folded before Flop (didn't bet)
Seat 4: jimeshka folded before Flop (didn't bet)
Seat 5: Lumbojack folded before Flop (didn't bet)
Seat 6: DrLevty (button) folded on the River



PokerStars Hand #222975656998:  Hold'em No Limit ($0.05/$0.10 USD) - 2021/01/23 17:38:20 ET
Table 'Jihlava III' 6-max Seat #5 is the button
Seat 1: 19991986830 ($21.97 in chips) 
Seat 3: rioma10 ($9.85 in chips) 
Seat 4: jimeshka ($2.39 in chips) 
Seat 5: Jacub1987 ($10 in chips) 
Seat 6: DrLevty ($11.87 in chips) 
DrLevty: posts small blind $0.05
19991986830: posts big blind $0.10
No1Sparkles: sits out 
*** HOLE CARDS ***
rioma10: raises $0.20 to $0.30
jimeshka: folds 
Jacub1987: raises $0.70 to $1
DrLevty: folds 
19991986830: folds 
rioma10: calls $0.70
*** FLOP *** [Jh 6h 5h]
rioma10: checks 
Jacub1987: bets $1.10
rioma10: calls $1.10
*** TURN *** [Jh 6h 5h] [8h]
rioma10: checks 
Jacub1987: checks 
*** RIVER *** [Jh 6h 5h 8h] [5d]
rioma10: bets $1.55
Jacub1987: folds 
Uncalled bet ($1.55) returned to rioma10
rioma10 collected $4.15 from pot
rioma10: doesn't show hand 
*** SUMMARY ***
Total pot $4.35 | Rake $0.20 
Board [Jh 6h 5h 8h 5d]
Seat 1: 19991986830 (big blind) folded before Flop
Seat 3: rioma10 collected ($4.15)
Seat 4: jimeshka folded before Flop (didn't bet)
Seat 5: Jacub1987 (button) folded on the River
Seat 6: DrLevty (small blind) folded before Flop



PokerStars Hand #222974484491:  Hold'em No Limit ($0.05/$0.10 USD) - 2021/01/23 17:14:12 ET
Table 'Jihlava III' 6-max Seat #1 is the button
Seat 1: 19991986830 ($22.46 in chips) 
Seat 2: ghost4c ($7.58 in chips) 
Seat 3: rioma10 ($10.41 in chips) 
Seat 4: jimeshka ($2.83 in chips) 
Seat 5: Lumbojack ($17.05 in chips) 
Seat 6: DrLevty ($10 in chips) 
ghost4c: posts small blind $0.05
rioma10: posts big blind $0.10
*** HOLE CARDS ***
jimeshka: folds 
Lumbojack: folds 
DrLevty: raises $0.20 to $0.30
19991986830: calls $0.30
ghost4c: folds 
rioma10: folds 
*** FLOP *** [9h Ks 4c]
DrLevty: bets $0.24
19991986830: calls $0.24
*** TURN *** [9h Ks 4c] [Qc]
DrLevty: bets $0.88
19991986830: calls $0.88
*** RIVER *** [9h Ks 4c Qc] [Js]
DrLevty: bets $0.70
19991986830: calls $0.70
*** SHOW DOWN ***
DrLevty: shows [Kc Qs] (two pair, Kings and Queens)
19991986830: shows [Jh Th] (a straight, Nine to King)
19991986830 collected $4.19 from pot
*** SUMMARY ***
Total pot $4.39 | Rake $0.20 
Board [9h Ks 4c Qc Js]
Seat 1: 19991986830 (button) showed [Jh Th] and won ($4.19) with a straight, Nine to King
Seat 2: ghost4c (small blind) folded before Flop
Seat 3: rioma10 (big blind) folded before Flop
Seat 4: jimeshka folded before Flop (didn't bet)
Seat 5: Lumbojack folded before Flop (didn't bet)
Seat 6: DrLevty showed [Kc Qs] and lost with two pair, Kings and Queens



PokerStars Hand #222975707261:  Hold'em No Limit ($0.05/$0.10 USD) - 2021/01/23 17:39:26 ET
Table 'Jihlava III' 6-max Seat #6 is the button
Seat 1: 19991986830 ($21.87 in chips) 
Seat 2: No1Sparkles ($10 in chips) 
Seat 3: rioma10 ($11.90 in chips) 
Seat 4: jimeshka ($2.39 in chips) 
Seat 5: Jacub1987 ($10 in chips) 
Seat 6: DrLevty ($11.82 in chips) 
19991986830: posts small blind $0.05
No1Sparkles: posts big blind $0.10
*** HOLE CARDS ***
rioma10: folds 
jimeshka: calls $0.10
Jacub1987: folds 
DrLevty: folds 
19991986830: folds 
No1Sparkles: checks 
*** FLOP *** [Td Kd 8s]
No1Sparkles: checks 
jimeshka: bets $0.10
No1Sparkles: raises $0.30 to $0.40
jimeshka: calls $0.30
*** TURN *** [Td Kd 8s] [2s]
No1Sparkles: checks 
jimeshka: checks 
*** RIVER *** [Td Kd 8s 2s] [Jc]
No1Sparkles: bets $0.75
jimeshka: folds 
Uncalled bet ($0.75) returned to No1Sparkles
No1Sparkles collected $1 from pot
No1Sparkles: doesn't show hand 
*** SUMMARY ***
Total pot $1.05 | Rake $0.05 
Board [Td Kd 8s 2s Jc]
Seat 1: 19991986830 (small blind) folded before Flop
Seat 2: No1Sparkles (big blind) collected ($1)
Seat 3: rioma10 folded before Flop (didn't bet)
Seat 4: jimeshka folded on the River
Seat 5: Jacub1987 folded before Flop (didn't bet)
Seat 6: DrLevty (button) folded before Flop (didn't bet)



PokerStars Hand #222974520230:  Hold'em No Limit ($0.05/$0.10 USD) - 2021/01/23 17:14:56 ET
Table 'Jihlava III' 6-max Seat #2 is the button
Seat 1: 19991986830 ($24.53 in chips) 
Seat 2: ghost4c ($7.53 in chips) 
Seat 3: rioma10 ($10.31 in chips) 
Seat 4: jimeshka ($2.83 in chips) 
Seat 5: Lumbojack ($17.05 in chips) 
Seat 6: DrLevty ($10 in chips) 
rioma10: posts small blind $0.05
jimeshka: posts big blind $0.10
*** HOLE CARDS ***
Lumbojack: folds 
DrLevty: folds 
19991986830: raises $0.10 to $0.20
ghost4c: calls $0.20
rioma10: folds 
jimeshka: calls $0.10
*** FLOP *** [Qd Ad Ac]
jimeshka: checks 
19991986830: bets $0.20
ghost4c: folds 
jimeshka: calls $0.20
*** TURN *** [Qd Ad Ac] [3d]
jimeshka: checks 
19991986830: checks 
*** RIVER *** [Qd Ad Ac 3d] [4d]
jimeshka: checks 
19991986830: bets $0.40
jimeshka: calls $0.40
*** SHOW DOWN ***
19991986830: shows [Js 6h] (a pair of Aces)
jimeshka: shows [8d As] (a flush, Ace high)
jimeshka collected $1.77 from pot
*** SUMMARY ***
Total pot $1.85 | Rake $0.08 
Board [Qd Ad Ac 3d 4d]
Seat 1: 19991986830 showed [Js 6h] and lost with a pair of Aces
Seat 2: ghost4c (button) folded on the Flop
Seat 3: rioma10 (small blind) folded before Flop
Seat 4: jimeshka (big blind) showed [8d As] and won ($1.77) with a flush, Ace high
Seat 5: Lumbojack folded before Flop (didn't bet)
Seat 6: DrLevty folded before Flop (didn't bet)



PokerStars Hand #222975749012:  Hold'em No Limit ($0.05/$0.10 USD) - 2021/01/23 17:40:20 ET
Table 'Jihlava III' 6-max Seat #1 is the button
Seat 1: 19991986830 ($21.82 in chips) 
Seat 2: No1Sparkles ($10.50 in chips) 
Seat 3: rioma10 ($11.90 in chips) 
Seat 4: jimeshka ($1.89 in chips) 
Seat 5: Jacub1987 ($10 in chips) 
Seat 6: DrLevty ($11.82 in chips) 
No1Sparkles: posts small blind $0.05
rioma10: posts big blind $0.10
*** HOLE CARDS ***
jimeshka: folds 
Jacub1987: folds 
DrLevty: folds 
19991986830: calls $0.10
No1Sparkles: folds 
rioma10: checks 
*** FLOP *** [Ac 4c As]
rioma10: checks 
19991986830: checks 
*** TURN *** [Ac 4c As] [6h]
rioma10: checks 
19991986830: bets $0.20
rioma10: folds 
Uncalled bet ($0.20) returned to 19991986830
19991986830 collected $0.24 from pot
*** SUMMARY ***
Total pot $0.25 | Rake $0.01 
Board [Ac 4c As 6h]
Seat 1: 19991986830 (button) collected ($0.24)
Seat 2: No1Sparkles (small blind) folded before Flop
Seat 3: rioma10 (big blind) folded on the Turn
Seat 4: jimeshka folded before Flop (didn't bet)
Seat 5: Jacub1987 folded before Flop (didn't bet)
Seat 6: DrLevty folded before Flop (didn't bet)



PokerStars Hand #222974557171:  Hold'em No Limit ($0.05/$0.10 USD) - 2021/01/23 17:15:40 ET
Table 'Jihlava III' 6-max Seat #3 is the button
Seat 1: 19991986830 ($23.73 in chips) 
Seat 2: ghost4c ($7.33 in chips) 
Seat 3: rioma10 ($10.26 in chips) 
Seat 4: jimeshka ($3.80 in chips) 
Seat 5: Lumbojack ($17.05 in chips) 
Seat 6: DrLevty ($10 in chips) 
jimeshka: posts small blind $0.05
Lumbojack: posts big blind $0.10
*** HOLE CARDS ***
DrLevty: folds 
19991986830: raises $0.20 to $0.30
ghost4c: folds 
rioma10: folds 
jimeshka: folds 
Lumbojack: folds 
Uncalled bet ($0.20) returned to 19991986830
19991986830 collected $0.25 from pot
*** SUMMARY ***
Total pot $0.25 | Rake $0 
Seat 1: 19991986830 collected ($0.25)
Seat 2: ghost4c folded before Flop (didn't bet)
Seat 3: rioma10 (button) folded before Flop (didn't bet)
Seat 4: jimeshka (small blind) folded before Flop
Seat 5: Lumbojack (big blind) folded before Flop
Seat 6: DrLevty folded before Flop (didn't bet)



PokerStars Hand #222975770779:  Hold'em No Limit ($0.05/$0.10 USD) - 2021/01/23 17:40:48 ET
Table 'Jihlava III' 6-max Seat #2 is the button
Seat 1: 19991986830 ($21.96 in chips) 
Seat 2: No1Sparkles ($10.45 in chips) 
Seat 3: rioma10 ($11.80 in chips) 
Seat 4: jimeshka ($1.89 in chips) 
Seat 5: Jacub1987 ($10 in chips) 
Seat 6: DrLevty ($11.82 in chips) 
rioma10: posts small blind $0.05
jimeshka: posts big blind $0.10
*** HOLE CARDS ***
Jacub1987: raises $0.15 to $0.25
DrLevty: folds 
19991986830: calls $0.25
No1Sparkles: folds 
rioma10: folds 
jimeshka: calls $0.15
*** FLOP *** [As Jh 4c]
jimeshka: checks 
Jacub1987: checks 
19991986830: checks 
*** TURN *** [As Jh 4c] [6c]
jimeshka: checks 
Jacub1987: bets $0.30
19991986830: calls $0.30
jimeshka: folds 
*** RIVER *** [As Jh 4c 6c] [7s]
Jacub1987: bets $0.54
19991986830: raises $0.54 to $1.08
Jacub1987: folds 
Uncalled bet ($0.54) returned to 19991986830
19991986830 collected $2.37 from pot
*** SUMMARY ***
Total pot $2.48 | Rake $0.11 
Board [As Jh 4c 6c 7s]
Seat 1: 19991986830 collected ($2.37)
Seat 2: No1Sparkles (button) folded before Flop (didn't bet)
Seat 3: rioma10 (small blind) folded before Flop
Seat 4: jimeshka (big blind) folded on the Turn
Seat 5: Jacub1987 folded on the River
Seat 6: DrLevty folded before Flop (didn't bet)



PokerStars Hand #222974578872:  Hold'em No Limit ($0.05/$0.10 USD) - 2021/01/23 17:16:06 ET
Table 'Jihlava III' 6-max Seat #4 is the button
Seat 1: 19991986830 ($23.88 in chips) 
Seat 2: ghost4c ($7.33 in chips) 
Seat 3: rioma10 ($10.26 in chips) 
Seat 4: jimeshka ($3.75 in chips) 
Seat 5: Lumbojack ($16.95 in chips) 
Seat 6: DrLevty ($10 in chips) 
Lumbojack: posts small blind $0.05
DrLevty: posts big blind $0.10
*** HOLE CARDS ***
19991986830: folds 
ghost4c: raises $0.20 to $0.30
rioma10: folds 
jimeshka: calls $0.30
Lumbojack: folds 
DrLevty: calls $0.20
*** FLOP *** [Td Ad 7s]
DrLevty: checks 
ghost4c: checks 
jimeshka: bets $0.20
DrLevty: calls $0.20
ghost4c: folds 
*** TURN *** [Td Ad 7s] [4c]
DrLevty: checks 
jimeshka: bets $0.30
DrLevty: folds 
Uncalled bet ($0.30) returned to jimeshka
jimeshka collected $1.29 from pot
jimeshka: doesn't show hand 
*** SUMMARY ***
Total pot $1.35 | Rake $0.06 
Board [Td Ad 7s 4c]
Seat 1: 19991986830 folded before Flop (didn't bet)
Seat 2: ghost4c folded on the Flop
Seat 3: rioma10 folded before Flop (didn't bet)
Seat 4: jimeshka (button) collected ($1.29)
Seat 5: Lumbojack (small blind) folded before Flop
Seat 6: DrLevty (big blind) folded on the Turn



PokerStars Hand #222975810050:  Hold'em No Limit ($0.05/$0.10 USD) - 2021/01/23 17:41:40 ET
Table 'Jihlava III' 6-max Seat #3 is the button
Seat 1: 19991986830 ($23.24 in chips) 
Seat 2: No1Sparkles ($10.45 in chips) 
Seat 3: rioma10 ($11.75 in chips) 
Seat 4: jimeshka ($1.64 in chips) 
Seat 5: Jacub1987 ($10 in chips) 
Seat 6: DrLevty ($11.82 in chips) 
jimeshka: posts small blind $0.05
Jacub1987: posts big blind $0.10
*** HOLE CARDS ***
DrLevty: folds 
19991986830: folds 
No1Sparkles: raises $0.20 to $0.30
rioma10: folds 
jimeshka: calls $0.25
Jacub1987: calls $0.20
*** FLOP *** [Qc Ks 7c]
jimeshka: checks 
Jacub1987: checks 
No1Sparkles: bets $0.43
jimeshka: folds 
Jacub1987: folds 
Uncalled bet ($0.43) returned to No1Sparkles
No1Sparkles collected $0.86 from pot
No1Sparkles: doesn't show hand 
*** SUMMARY ***
Total pot $0.90 | Rake $0.04 
Board [Qc Ks 7c]
Seat 1: 19991986830 folded before Flop (didn't bet)
Seat 2: No1Sparkles collected ($0.86)
Seat 3: rioma10 (button) folded before Flop (didn't bet)
Seat 4: jimeshka (small blind) folded on the Flop
Seat 5: Jacub1987 (big blind) folded on the Flop
Seat 6: DrLevty folded before Flop (didn't bet)



PokerStars Hand #222974608156:  Hold'em No Limit ($0.05/$0.10 USD) - 2021/01/23 17:16:42 ET
Table 'Jihlava III' 6-max Seat #5 is the button
Seat 1: 19991986830 ($23.88 in chips) 
Seat 2: ghost4c ($7.03 in chips) 
Seat 3: rioma10 ($10.26 in chips) 
Seat 4: jimeshka ($4.54 in chips) 
Seat 5: Lumbojack ($16.90 in chips) 
Seat 6: DrLevty ($10 in chips) 
DrLevty: posts small blind $0.05
19991986830: posts big blind $0.10
*** HOLE CARDS ***
ghost4c: folds 
rioma10: folds 
jimeshka: folds 
Lumbojack: raises $0.20 to $0.30
DrLevty: folds 
19991986830: calls $0.20
*** FLOP *** [9s 3d Ah]
19991986830: checks 
Lumbojack: bets $0.32
19991986830: calls $0.32
*** TURN *** [9s 3d Ah] [4d]
19991986830: checks 
Lumbojack: bets $0.80
19991986830: calls $0.80
*** RIVER *** [9s 3d Ah 4d] [9d]
19991986830: checks 
Lumbojack: checks 
*** SHOW DOWN ***
19991986830: shows [5s 6s] (a pair of Nines)
Lumbojack: shows [As 4h] (two pair, Aces and Nines)
Lumbojack collected $2.76 from pot
*** SUMMARY ***
Total pot $2.89 | Rake $0.13 
Board [9s 3d Ah 4d 9d]
Seat 1: 19991986830 (big blind) showed [5s 6s] and lost with a pair of Nines
Seat 2: ghost4c folded before Flop (didn't bet)
Seat 3: rioma10 folded before Flop (didn't bet)
Seat 4: jimeshka folded before Flop (didn't bet)
Seat 5: Lumbojack (button) showed [As 4h] and won ($2.76) with two pair, Aces and Nines
Seat 6: DrLevty (small blind) folded before Flop



PokerStars Hand #222975841800:  Hold'em No Limit ($0.05/$0.10 USD) - 2021/01/23 17:42:21 ET
Table 'Jihlava III' 6-max Seat #4 is the button
Seat 1: 19991986830 ($23.24 in chips) 
Seat 2: No1Sparkles ($11.01 in chips) 
Seat 3: rioma10 ($11.75 in chips) 
Seat 4: jimeshka ($1.34 in chips) 
Seat 5: Jacub1987 ($10 in chips) 
Seat 6: DrLevty ($11.82 in chips) 
Jacub1987: posts small blind $0.05
DrLevty: posts big blind $0.10
*** HOLE CARDS ***
19991986830: calls $0.10
No1Sparkles: folds 
rioma10: raises $0.30 to $0.40
jimeshka: folds 
Jacub1987: folds 
DrLevty: calls $0.30
19991986830: calls $0.30
*** FLOP *** [2c 9h 8c]
DrLevty: checks 
19991986830: checks 
rioma10: checks 
*** TURN *** [2c 9h 8c] [3c]
DrLevty: checks 
19991986830: checks 
rioma10: checks 
*** RIVER *** [2c 9h 8c 3c] [2h]
DrLevty: checks 
19991986830: bets $0.60
rioma10: folds 
DrLevty: folds 
Uncalled bet ($0.60) returned to 19991986830
19991986830 collected $1.19 from pot
*** SUMMARY ***
Total pot $1.25 | Rake $0.06 
Board [2c 9h 8c 3c 2h]
Seat 1: 19991986830 collected ($1.19)
Seat 2: No1Sparkles folded before Flop (didn't bet)
Seat 3: rioma10 folded on the River
Seat 4: jimeshka (button) folded before Flop (didn't bet)
Seat 5: Jacub1987 (small blind) folded before Flop
Seat 6: DrLevty (big blind) folded on the River



PokerStars Hand #222974643246:  Hold'em No Limit ($0.05/$0.10 USD) - 2021/01/23 17:17:25 ET
Table 'Jihlava III' 6-max Seat #6 is the button
Seat 1: 19991986830 ($22.46 in chips) 
Seat 2: ghost4c ($7.03 in chips) 
Seat 3: rioma10 ($10.26 in chips) 
Seat 4: jimeshka ($4.54 in chips) 
Seat 5: Lumbojack ($18.24 in chips) 
Seat 6: DrLevty ($10 in chips) 
19991986830: posts small blind $0.05
ghost4c: posts big blind $0.10
*** HOLE CARDS ***
rioma10: folds 
jimeshka: folds 
Lumbojack: raises $0.15 to $0.25
DrLevty: folds 
19991986830: folds 
ghost4c: calls $0.15
*** FLOP *** [Ts 9s Kh]
ghost4c: checks 
Lumbojack: bets $0.28
ghost4c: calls $0.28
*** TURN *** [Ts 9s Kh] [Ks]
ghost4c: checks 
Lumbojack: checks 
*** RIVER *** [Ts 9s Kh Ks] [Th]
ghost4c: checks 
Lumbojack: checks 
*** SHOW DOWN ***
ghost4c: shows [Tc Qc] (a full house, Tens full of Kings)
Lumbojack: mucks hand 
ghost4c collected $1.06 from pot
*** SUMMARY ***
Total pot $1.11 | Rake $0.05 
Board [Ts 9s Kh Ks Th]
Seat 1: 19991986830 (small blind) folded before Flop
Seat 2: ghost4c (big blind) showed [Tc Qc] and won ($1.06) with a full house, Tens full of Kings
Seat 3: rioma10 folded before Flop (didn't bet)
Seat 4: jimeshka folded before Flop (didn't bet)
Seat 5: Lumbojack mucked
Seat 6: DrLevty (button) folded before Flop (didn't bet)



PokerStars Hand #222975876421:  Hold'em No Limit ($0.05/$0.10 USD) - 2021/01/23 17:43:06 ET
Table 'Jihlava III' 6-max Seat #5 is the button
Seat 1: 19991986830 ($24.03 in chips) 
Seat 2: No1Sparkles ($11.01 in chips) 
Seat 3: rioma10 ($11.35 in chips) 
Seat 4: jimeshka ($1.34 in chips) 
Seat 5: Jacub1987 ($10 in chips) 
Seat 6: DrLevty ($11.42 in chips) 
DrLevty: posts small blind $0.05
19991986830: posts big blind $0.10
*** HOLE CARDS ***
No1Sparkles: folds 
rioma10: folds 
jimeshka: calls $0.10
Jacub1987: folds 
DrLevty: calls $0.05
19991986830: checks 
*** FLOP *** [6h 4s Kc]
DrLevty: checks 
19991986830: checks 
jimeshka: bets $0.10
DrLevty: folds 
19991986830: folds 
Uncalled bet ($0.10) returned to jimeshka
jimeshka collected $0.29 from pot
jimeshka: doesn't show hand 
*** SUMMARY ***
Total pot $0.30 | Rake $0.01 
Board [6h 4s Kc]
Seat 1: 19991986830 (big blind) folded on the Flop
Seat 2: No1Sparkles folded before Flop (didn't bet)
Seat 3: rioma10 folded before Flop (didn't bet)
Seat 4: jimeshka collected ($0.29)
Seat 5: Jacub1987 (button) folded before Flop (didn't bet)
Seat 6: DrLevty (small blind) folded on the Flop



PokerStars Hand #222974685617:  Hold'em No Limit ($0.05/$0.10 USD) - 2021/01/23 17:18:16 ET
Table 'Jihlava III' 6-max Seat #1 is the button
Seat 1: 19991986830 ($22.41 in chips) 
Seat 2: ghost4c ($7.56 in chips) 
Seat 3: rioma10 ($10.26 in chips) 
Seat 4: jimeshka ($4.54 in chips) 
Seat 5: Lumbojack ($17.71 in chips) 
Seat 6: DrLevty ($10 in chips) 
ghost4c: posts small blind $0.05
rioma10: posts big blind $0.10
*** HOLE CARDS ***
jimeshka: calls $0.10
Lumbojack: folds 
DrLevty: folds 
19991986830: raises $0.10 to $0.20
ghost4c: folds 
rioma10: folds 
jimeshka: calls $0.10
*** FLOP *** [2c Jc Tc]
jimeshka: checks 
19991986830: checks 
*** TURN *** [2c Jc Tc] [Qc]
jimeshka: bets $0.10
19991986830: calls $0.10
*** RIVER *** [2c Jc Tc Qc] [8d]
jimeshka: bets $0.20
19991986830: calls $0.20
*** SHOW DOWN ***
jimeshka: shows [Kd 9c] (a flush, Queen high)
19991986830: mucks hand 
jimeshka collected $1.10 from pot
*** SUMMARY ***
Total pot $1.15 | Rake $0.05 
Board [2c Jc Tc Qc 8d]
Seat 1: 19991986830 (button) mucked
Seat 2: ghost4c (small blind) folded before Flop
Seat 3: rioma10 (big blind) folded before Flop
Seat 4: jimeshka showed [Kd 9c] and won ($1.10) with a flush, Queen high
Seat 5: Lumbojack folded before Flop (didn't bet)
Seat 6: DrLevty folded before Flop (didn't bet)



PokerStars Hand #222975905631:  Hold'em No Limit ($0.05/$0.10 USD) - 2021/01/23 17:43:45 ET
Table 'Jihlava III' 6-max Seat #6 is the button
Seat 1: 19991986830 ($23.93 in chips) 
Seat 2: No1Sparkles ($11.01 in chips) 
Seat 3: rioma10 ($11.35 in chips) 
Seat 4: jimeshka ($1.53 in chips) 
Seat 5: Jacub1987 ($10 in chips) 
Seat 6: DrLevty ($11.32 in chips) 
19991986830: posts small blind $0.05
No1Sparkles: posts big blind $0.10
*** HOLE CARDS ***
rioma10: folds 
jimeshka: folds 
Jacub1987: folds 
DrLevty: folds 
19991986830: raises $0.10 to $0.20
No1Sparkles: folds 
Uncalled bet ($0.10) returned to 19991986830
19991986830 collected $0.20 from pot
*** SUMMARY ***
Total pot $0.20 | Rake $0 
Seat 1: 19991986830 (small blind) collected ($0.20)
Seat 2: No1Sparkles (big blind) folded before Flop
Seat 3: rioma10 folded before Flop (didn't bet)
Seat 4: jimeshka folded before Flop (didn't bet)
Seat 5: Jacub1987 folded before Flop (didn't bet)
Seat 6: DrLevty (button) folded before Flop (didn't bet)



PokerStars Hand #222974721273:  Hold'em No Limit ($0.05/$0.10 USD) - 2021/01/23 17:19:00 ET
Table 'Jihlava III' 6-max Seat #2 is the button
Seat 1: 19991986830 ($21.91 in chips) 
Seat 2: ghost4c ($7.51 in chips) 
Seat 3: rioma10 ($10.16 in chips) 
Seat 4: jimeshka ($5.14 in chips) 
Seat 5: Lumbojack ($17.71 in chips) 
Seat 6: DrLevty ($10 in chips) 
rioma10: posts small blind $0.05
jimeshka: posts big blind $0.10
*** HOLE CARDS ***
Lumbojack: folds 
DrLevty: folds 
19991986830: raises $0.10 to $0.20
ghost4c: folds 
rioma10: folds 
jimeshka: calls $0.10
*** FLOP *** [5s 3s 9h]
jimeshka: checks 
19991986830: checks 
*** TURN *** [5s 3s 9h] [2h]
jimeshka: bets $0.20
19991986830: calls $0.20
*** RIVER *** [5s 3s 9h 2h] [Qh]
jimeshka: bets $0.41
19991986830: folds 
Uncalled bet ($0.41) returned to jimeshka
jimeshka collected $0.81 from pot
jimeshka: doesn't show hand 
*** SUMMARY ***
Total pot $0.85 | Rake $0.04 
Board [5s 3s 9h 2h Qh]
Seat 1: 19991986830 folded on the River
Seat 2: ghost4c (button) folded before Flop (didn't bet)
Seat 3: rioma10 (small blind) folded before Flop
Seat 4: jimeshka (big blind) collected ($0.81)
Seat 5: Lumbojack folded before Flop (didn't bet)
Seat 6: DrLevty folded before Flop (didn't bet)



PokerStars Hand #222975916492:  Hold'em No Limit ($0.05/$0.10 USD) - 2021/01/23 17:43:59 ET
Table 'Jihlava III' 6-max Seat #2 is the button
Seat 2: No1Sparkles ($10.91 in chips) 
Seat 3: rioma10 ($11.35 in chips) 
Seat 4: jimeshka ($1.53 in chips) 
Seat 5: Jacub1987 ($10 in chips) 
Seat 6: DrLevty ($11.32 in chips) 
rioma10: posts small blind $0.05
jimeshka: posts big blind $0.10
*** HOLE CARDS ***
Jacub1987: folds 
DrLevty: folds 
No1Sparkles: raises $0.20 to $0.30
rioma10: folds 
jimeshka: folds 
Uncalled bet ($0.20) returned to No1Sparkles
No1Sparkles collected $0.25 from pot
No1Sparkles: doesn't show hand 
*** SUMMARY ***
Total pot $0.25 | Rake $0 
Seat 2: No1Sparkles (button) collected ($0.25)
Seat 3: rioma10 (small blind) folded before Flop
Seat 4: jimeshka (big blind) folded before Flop
Seat 5: Jacub1987 folded before Flop (didn't bet)
Seat 6: DrLevty folded before Flop (didn't bet)



PokerStars Hand #222974750617:  Hold'em No Limit ($0.05/$0.10 USD) - 2021/01/23 17:19:36 ET
Table 'Jihlava III' 6-max Seat #3 is the button
Seat 1: 19991986830 ($21.51 in chips) 
Seat 2: ghost4c ($7.51 in chips) 
Seat 3: rioma10 ($10.11 in chips) 
Seat 4: jimeshka ($5.55 in chips) 
Seat 5: Lumbojack ($17.71 in chips) 
Seat 6: DrLevty ($10 in chips) 
jimeshka: posts small blind $0.05
Lumbojack: posts big blind $0.10
*** HOLE CARDS ***
DrLevty: folds 
19991986830: raises $0.10 to $0.20
ghost4c: folds 
rioma10: calls $0.20
jimeshka: calls $0.15
Lumbojack: folds 
*** FLOP *** [Qd 2h 7c]
jimeshka: checks 
19991986830: bets $0.20
rioma10: folds 
jimeshka: calls $0.20
*** TURN *** [Qd 2h 7c] [Ah]
jimeshka: checks 
19991986830: checks 
*** RIVER *** [Qd 2h 7c Ah] [6d]
jimeshka: bets $0.53
19991986830: folds 
Uncalled bet ($0.53) returned to jimeshka
jimeshka collected $1.05 from pot
jimeshka: doesn't show hand 
*** SUMMARY ***
Total pot $1.10 | Rake $0.05 
Board [Qd 2h 7c Ah 6d]
Seat 1: 19991986830 folded on the River
Seat 2: ghost4c folded before Flop (didn't bet)
Seat 3: rioma10 (button) folded on the Flop
Seat 4: jimeshka (small blind) collected ($1.05)
Seat 5: Lumbojack (big blind) folded before Flop
Seat 6: DrLevty folded before Flop (didn't bet)



PokerStars Hand #222975927670:  Hold'em No Limit ($0.05/$0.10 USD) - 2021/01/23 17:44:14 ET
Table 'Jihlava III' 6-max Seat #3 is the button
Seat 2: No1Sparkles ($11.06 in chips) 
Seat 3: rioma10 ($11.30 in chips) 
Seat 4: jimeshka ($1.43 in chips) 
Seat 5: Jacub1987 ($10 in chips) 
Seat 6: DrLevty ($11.32 in chips) 
jimeshka: posts small blind $0.05
Jacub1987: posts big blind $0.10
*** HOLE CARDS ***
DrLevty: folds 
No1Sparkles: folds 
rioma10: raises $0.15 to $0.25
jimeshka: calls $0.20
Jacub1987: calls $0.15
*** FLOP *** [As Th Kh]
jimeshka: checks 
Jacub1987: checks 
rioma10: bets $0.24
jimeshka: raises $0.94 to $1.18 and is all-in
Jacub1987: folds 
rioma10: calls $0.94
*** TURN *** [As Th Kh] [Kd]
*** RIVER *** [As Th Kh Kd] [Qd]
*** SHOW DOWN ***
jimeshka: shows [Kc 9c] (three of a kind, Kings)
rioma10: shows [6h 5h] (a pair of Kings)
jimeshka collected $2.97 from pot
*** SUMMARY ***
Total pot $3.11 | Rake $0.14 
Board [As Th Kh Kd Qd]
Seat 2: No1Sparkles folded before Flop (didn't bet)
Seat 3: rioma10 (button) showed [6h 5h] and lost with a pair of Kings
Seat 4: jimeshka (small blind) showed [Kc 9c] and won ($2.97) with three of a kind, Kings
Seat 5: Jacub1987 (big blind) folded on the Flop
Seat 6: DrLevty folded before Flop (didn't bet)



PokerStars Hand #222974782524:  Hold'em No Limit ($0.05/$0.10 USD) - 2021/01/23 17:20:15 ET
Table 'Jihlava III' 6-max Seat #4 is the button
Seat 1: 19991986830 ($21.11 in chips) 
Seat 2: ghost4c ($7.51 in chips) 
Seat 3: rioma10 ($9.91 in chips) 
Seat 4: jimeshka ($6.20 in chips) 
Seat 5: Lumbojack ($17.61 in chips) 
Seat 6: DrLevty ($10 in chips) 
Lumbojack: posts small blind $0.05
DrLevty: posts big blind $0.10
*** HOLE CARDS ***
19991986830: raises $0.20 to $0.30
ghost4c: folds 
rioma10: folds 
jimeshka: calls $0.30
Lumbojack: folds 
DrLevty: folds 
*** FLOP *** [4c Ad 4d]
19991986830: bets $0.20
jimeshka: calls $0.20
*** TURN *** [4c Ad 4d] [Tc]
19991986830: checks 
jimeshka: checks 
*** RIVER *** [4c Ad 4d Tc] [Ac]
19991986830: checks 
jimeshka: checks 
*** SHOW DOWN ***
19991986830: shows [Ts 9s] (two pair, Aces and Tens)
jimeshka: mucks hand 
19991986830 collected $1.10 from pot
*** SUMMARY ***
Total pot $1.15 | Rake $0.05 
Board [4c Ad 4d Tc Ac]
Seat 1: 19991986830 showed [Ts 9s] and won ($1.10) with two pair, Aces and Tens
Seat 2: ghost4c folded before Flop (didn't bet)
Seat 3: rioma10 folded before Flop (didn't bet)
Seat 4: jimeshka (button) mucked
Seat 5: Lumbojack (small blind) folded before Flop
Seat 6: DrLevty (big blind) folded before Flop



PokerStars Hand #222975956036:  Hold'em No Limit ($0.05/$0.10 USD) - 2021/01/23 17:44:52 ET
Table 'Jihlava III' 6-max Seat #4 is the button
Seat 2: No1Sparkles ($11.06 in chips) 
Seat 3: rioma10 ($9.87 in chips) 
Seat 4: jimeshka ($2.97 in chips) 
Seat 5: Jacub1987 ($10 in chips) 
Seat 6: DrLevty ($11.32 in chips) 
Jacub1987: posts small blind $0.05
DrLevty: posts big blind $0.10
*** HOLE CARDS ***
No1Sparkles: folds 
rioma10: folds 
jimeshka: folds 
Jacub1987: raises $0.20 to $0.30
DrLevty: folds 
Uncalled bet ($0.20) returned to Jacub1987
Jacub1987 collected $0.20 from pot
*** SUMMARY ***
Total pot $0.20 | Rake $0 
Seat 2: No1Sparkles folded before Flop (didn't bet)
Seat 3: rioma10 folded before Flop (didn't bet)
Seat 4: jimeshka (button) folded before Flop (didn't bet)
Seat 5: Jacub1987 (small blind) collected ($0.20)
Seat 6: DrLevty (big blind) folded before Flop



PokerStars Hand #222974816028:  Hold'em No Limit ($0.05/$0.10 USD) - 2021/01/23 17:20:56 ET
Table 'Jihlava III' 6-max Seat #5 is the button
Seat 1: 19991986830 ($21.71 in chips) 
Seat 2: ghost4c ($7.51 in chips) 
Seat 3: rioma10 ($9.91 in chips) 
Seat 4: jimeshka ($5.70 in chips) 
Seat 5: Lumbojack ($17.56 in chips) 
Seat 6: DrLevty ($10 in chips) 
DrLevty: posts small blind $0.05
19991986830: posts big blind $0.10
*** HOLE CARDS ***
ghost4c: folds 
rioma10: folds 
jimeshka: folds 
Lumbojack: folds 
DrLevty: folds 
Uncalled bet ($0.05) returned to 19991986830
19991986830 collected $0.10 from pot
*** SUMMARY ***
Total pot $0.10 | Rake $0 
Seat 1: 19991986830 (big blind) collected ($0.10)
Seat 2: ghost4c folded before Flop (didn't bet)
Seat 3: rioma10 folded before Flop (didn't bet)
Seat 4: jimeshka folded before Flop (didn't bet)
Seat 5: Lumbojack (button) folded before Flop (didn't bet)
Seat 6: DrLevty (small blind) folded before Flop



PokerStars Hand #222975963789:  Hold'em No Limit ($0.05/$0.10 USD) - 2021/01/23 17:45:02 ET
Table 'Jihlava III' 6-max Seat #5 is the button
Seat 2: No1Sparkles ($11.06 in chips) 
Seat 3: rioma10 ($9.87 in chips) 
Seat 4: jimeshka ($2.97 in chips) 
Seat 5: Jacub1987 ($10.10 in chips) 
Seat 6: DrLevty ($11.22 in chips) 
DrLevty: posts small blind $0.05
No1Sparkles: posts big blind $0.10
*** HOLE CARDS ***
rioma10: folds 
jimeshka: calls $0.10
Jacub1987: folds 
DrLevty: folds 
No1Sparkles: checks 
*** FLOP *** [2c Ah Qs]
No1Sparkles: checks 
jimeshka: checks 
*** TURN *** [2c Ah Qs] [Ad]
No1Sparkles: checks 
jimeshka: bets $0.10
No1Sparkles: calls $0.10
*** RIVER *** [2c Ah Qs Ad] [9c]
No1Sparkles: checks 
jimeshka: bets $0.22
No1Sparkles: folds 
Uncalled bet ($0.22) returned to jimeshka
jimeshka collected $0.43 from pot
jimeshka: doesn't show hand 
*** SUMMARY ***
Total pot $0.45 | Rake $0.02 
Board [2c Ah Qs Ad 9c]
Seat 2: No1Sparkles (big blind) folded on the River
Seat 3: rioma10 folded before Flop (didn't bet)
Seat 4: jimeshka collected ($0.43)
Seat 5: Jacub1987 (button) folded before Flop (didn't bet)
Seat 6: DrLevty (small blind) folded before Flop



PokerStars Hand #222974827135:  Hold'em No Limit ($0.05/$0.10 USD) - 2021/01/23 17:21:10 ET
Table 'Jihlava III' 6-max Seat #6 is the button
Seat 1: 19991986830 ($21.76 in chips) 
Seat 2: ghost4c ($7.51 in chips) 
Seat 3: rioma10 ($9.91 in chips) 
Seat 4: jimeshka ($5.70 in chips) 
Seat 5: Lumbojack ($17.56 in chips) 
Seat 6: DrLevty ($10 in chips) 
19991986830: posts small blind $0.05
ghost4c: posts big blind $0.10
*** HOLE CARDS ***
rioma10: raises $0.20 to $0.30
jimeshka: folds 
Lumbojack: folds 
DrLevty: folds 
19991986830: calls $0.25
ghost4c: folds 
*** FLOP *** [9c 6s Qd]
19991986830: bets $0.20
rioma10: calls $0.20
*** TURN *** [9c 6s Qd] [9h]
19991986830: checks 
rioma10: checks 
*** RIVER *** [9c 6s Qd 9h] [Th]
19991986830: bets $0.30
rioma10: calls $0.30
*** SHOW DOWN ***
19991986830: shows [9s Jd] (three of a kind, Nines)
rioma10: mucks hand 
19991986830 collected $1.62 from pot
*** SUMMARY ***
Total pot $1.70 | Rake $0.08 
Board [9c 6s Qd 9h Th]
Seat 1: 19991986830 (small blind) showed [9s Jd] and won ($1.62) with three of a kind, Nines
Seat 2: ghost4c (big blind) folded before Flop
Seat 3: rioma10 mucked
Seat 4: jimeshka folded before Flop (didn't bet)
Seat 5: Lumbojack folded before Flop (didn't bet)
Seat 6: DrLevty (button) folded before Flop (didn't bet)



PokerStars Hand #222975985698:  Hold'em No Limit ($0.05/$0.10 USD) - 2021/01/23 17:45:31 ET
Table 'Jihlava III' 6-max Seat #6 is the button
Seat 2: No1Sparkles ($10.86 in chips) 
Seat 3: rioma10 ($9.87 in chips) 
Seat 4: jimeshka ($3.20 in chips) 
Seat 5: Jacub1987 ($10.10 in chips) 
Seat 6: DrLevty ($11.17 in chips) 
No1Sparkles: posts small blind $0.05
rioma10: posts big blind $0.10
*** HOLE CARDS ***
jimeshka: raises $0.10 to $0.20
Jacub1987: folds 
DrLevty: folds 
No1Sparkles: folds 
rioma10: folds 
Uncalled bet ($0.10) returned to jimeshka
jimeshka collected $0.25 from pot
jimeshka: doesn't show hand 
*** SUMMARY ***
Total pot $0.25 | Rake $0 
Seat 2: No1Sparkles (small blind) folded before Flop
Seat 3: rioma10 (big blind) folded before Flop
Seat 4: jimeshka collected ($0.25)
Seat 5: Jacub1987 folded before Flop (didn't bet)
Seat 6: DrLevty (button) folded before Flop (didn't bet)



PokerStars Hand #222974865012:  Hold'em No Limit ($0.05/$0.10 USD) - 2021/01/23 17:21:56 ET
Table 'Jihlava III' 6-max Seat #1 is the button
Seat 1: 19991986830 ($22.58 in chips) 
Seat 2: ghost4c ($7.41 in chips) 
Seat 3: rioma10 ($9.11 in chips) 
Seat 4: jimeshka ($5.70 in chips) 
Seat 5: Lumbojack ($17.56 in chips) 
Seat 6: DrLevty ($10 in chips) 
ghost4c: posts small blind $0.05
rioma10: posts big blind $0.10
*** HOLE CARDS ***
jimeshka: calls $0.10
Lumbojack: folds 
DrLevty: folds 
19991986830: raises $0.20 to $0.30
ghost4c: folds 
rioma10: calls $0.20
jimeshka: calls $0.20
*** FLOP *** [Qd 5d Jc]
rioma10: checks 
jimeshka: checks 
19991986830: checks 
*** TURN *** [Qd 5d Jc] [4h]
rioma10: checks 
jimeshka: checks 
19991986830: checks 
*** RIVER *** [Qd 5d Jc 4h] [6c]
rioma10: bets $0.60
jimeshka: folds 
19991986830: folds 
Uncalled bet ($0.60) returned to rioma10
rioma10 collected $0.91 from pot
rioma10: doesn't show hand 
*** SUMMARY ***
Total pot $0.95 | Rake $0.04 
Board [Qd 5d Jc 4h 6c]
Seat 1: 19991986830 (button) folded on the River
Seat 2: ghost4c (small blind) folded before Flop
Seat 3: rioma10 (big blind) collected ($0.91)
Seat 4: jimeshka folded on the River
Seat 5: Lumbojack folded before Flop (didn't bet)
Seat 6: DrLevty folded before Flop (didn't bet)



PokerStars Hand #222975995221:  Hold'em No Limit ($0.05/$0.10 USD) - 2021/01/23 17:45:44 ET
Table 'Jihlava III' 6-max Seat #2 is the button
Seat 1: 19991986830 ($24.03 in chips) 
Seat 2: No1Sparkles ($10.81 in chips) 
Seat 3: rioma10 ($9.77 in chips) 
Seat 4: jimeshka ($3.35 in chips) 
Seat 5: Jacub1987 ($10.10 in chips) 
Seat 6: DrLevty ($11.17 in chips) 
rioma10: posts small blind $0.05
jimeshka: posts big blind $0.10
19991986830: posts small & big blinds $0.15
*** HOLE CARDS ***
Jacub1987: folds 
DrLevty: folds 
19991986830: checks 
No1Sparkles: folds 
rioma10: calls $0.05
jimeshka: checks 
*** FLOP *** [Ks Jh 5d]
rioma10: checks 
jimeshka: checks 
19991986830: checks 
*** TURN *** [Ks Jh 5d] [Ad]
rioma10: checks 
DrLevty leaves the table
jimeshka: checks 
19991986830: bets $0.20
Guslalala joins the table at seat #6 
rioma10: folds 
No1Sparkles was removed from the table for failing to post
No1Sparkles leaves the table
jimeshka: folds 
Uncalled bet ($0.20) returned to 19991986830
19991986830 collected $0.33 from pot
*** SUMMARY ***
Total pot $0.35 | Rake $0.02 
Board [Ks Jh 5d Ad]
Seat 1: 19991986830 collected ($0.33)
Seat 2: No1Sparkles (button) folded before Flop (didn't bet)
Seat 3: rioma10 (small blind) folded on the Turn
Seat 4: jimeshka (big blind) folded on the Turn
Seat 5: Jacub1987 folded before Flop (didn't bet)
Seat 6: DrLevty folded before Flop (didn't bet)



PokerStars Hand #222974908512:  Hold'em No Limit ($0.05/$0.10 USD) - 2021/01/23 17:22:50 ET
Table 'Jihlava III' 6-max Seat #2 is the button
Seat 1: 19991986830 ($22.28 in chips) 
Seat 2: ghost4c ($7.36 in chips) 
Seat 3: rioma10 ($9.72 in chips) 
Seat 4: jimeshka ($5.40 in chips) 
Seat 5: Lumbojack ($17.56 in chips) 
Seat 6: DrLevty ($10 in chips) 
rioma10: posts small blind $0.05
jimeshka: posts big blind $0.10
*** HOLE CARDS ***
Lumbojack: raises $0.15 to $0.25
DrLevty: folds 
19991986830: calls $0.25
ghost4c: folds 
rioma10: folds 
jimeshka: folds 
*** FLOP *** [5d 8h 9d]
Lumbojack: checks 
19991986830: checks 
*** TURN *** [5d 8h 9d] [7c]
Lumbojack: bets $0.32
19991986830: calls $0.32
*** RIVER *** [5d 8h 9d 7c] [3d]
Lumbojack: checks 
19991986830: checks 
*** SHOW DOWN ***
Lumbojack: shows [Ac 6c] (a straight, Five to Nine)
19991986830: mucks hand 
Lumbojack collected $1.23 from pot
*** SUMMARY ***
Total pot $1.29 | Rake $0.06 
Board [5d 8h 9d 7c 3d]
Seat 1: 19991986830 mucked
Seat 2: ghost4c (button) folded before Flop (didn't bet)
Seat 3: rioma10 (small blind) folded before Flop
Seat 4: jimeshka (big blind) folded before Flop
Seat 5: Lumbojack showed [Ac 6c] and won ($1.23) with a straight, Five to Nine
Seat 6: DrLevty folded before Flop (didn't bet)



PokerStars Hand #222976024076:  Hold'em No Limit ($0.05/$0.10 USD) - 2021/01/23 17:46:22 ET
Table 'Jihlava III' 6-max Seat #3 is the button
Seat 1: 19991986830 ($24.21 in chips) 
Seat 3: rioma10 ($9.67 in chips) 
Seat 4: jimeshka ($3.25 in chips) 
Seat 5: Jacub1987 ($10.10 in chips) 
jimeshka: posts small blind $0.05
Jacub1987: posts big blind $0.10
Guslalala: sits out 
*** HOLE CARDS ***
d2jones joins the table at seat #2 
19991986830: folds 
rioma10: folds 
jimeshka: calls $0.05
Jacub1987: checks 
*** FLOP *** [4d Jh 2c]
jimeshka: checks 
Jacub1987: bets $0.14
jimeshka: folds 
Uncalled bet ($0.14) returned to Jacub1987
Jacub1987 collected $0.19 from pot
*** SUMMARY ***
Total pot $0.20 | Rake $0.01 
Board [4d Jh 2c]
Seat 1: 19991986830 folded before Flop (didn't bet)
Seat 3: rioma10 (button) folded before Flop (didn't bet)
Seat 4: jimeshka (small blind) folded on the Flop
Seat 5: Jacub1987 (big blind) collected ($0.19)



PokerStars Hand #222974953586:  Hold'em No Limit ($0.05/$0.10 USD) - 2021/01/23 17:23:45 ET
Table 'Jihlava III' 6-max Seat #3 is the button
Seat 1: 19991986830 ($21.71 in chips) 
Seat 2: ghost4c ($7.36 in chips) 
Seat 3: rioma10 ($9.67 in chips) 
Seat 4: jimeshka ($5.30 in chips) 
Seat 5: Lumbojack ($18.22 in chips) 
Seat 6: DrLevty ($10 in chips) 
jimeshka: posts small blind $0.05
Lumbojack: posts big blind $0.10
*** HOLE CARDS ***
DrLevty: folds 
19991986830: raises $0.20 to $0.30
ghost4c: folds 
rioma10: folds 
jimeshka: folds 
Lumbojack: folds 
Uncalled bet ($0.20) returned to 19991986830
19991986830 collected $0.25 from pot
*** SUMMARY ***
Total pot $0.25 | Rake $0 
Seat 1: 19991986830 collected ($0.25)
Seat 2: ghost4c folded before Flop (didn't bet)
Seat 3: rioma10 (button) folded before Flop (didn't bet)
Seat 4: jimeshka (small blind) folded before Flop
Seat 5: Lumbojack (big blind) folded before Flop
Seat 6: DrLevty folded before Flop (didn't bet)



PokerStars Hand #222976039006:  Hold'em No Limit ($0.05/$0.10 USD) - 2021/01/23 17:46:42 ET
Table 'Jihlava III' 6-max Seat #4 is the button
Seat 1: 19991986830 ($24.21 in chips) 
Seat 2: d2jones ($10 in chips) 
Seat 3: rioma10 ($9.67 in chips) 
Seat 4: jimeshka ($3.15 in chips) 
Seat 5: Jacub1987 ($10.19 in chips) 
Seat 6: Guslalala ($10 in chips) 
Jacub1987: posts small blind $0.05
Guslalala: posts big blind $0.10
d2jones: posts big blind $0.10
*** HOLE CARDS ***
19991986830: raises $0.10 to $0.20
d2jones: calls $0.10
rioma10: folds 
jimeshka: folds 
Jacub1987: calls $0.15
Guslalala: folds 
*** FLOP *** [Qc 7c 2c]
Jacub1987: checks 
19991986830: checks 
d2jones: bets $0.34
Jacub1987: folds 
19991986830: calls $0.34
*** TURN *** [Qc 7c 2c] [Kh]
19991986830: checks 
d2jones: bets $0.66
19991986830: calls $0.66
*** RIVER *** [Qc 7c 2c Kh] [6h]
19991986830: checks 
d2jones: checks 
*** SHOW DOWN ***
19991986830: shows [Ks Jc] (a pair of Kings)
d2jones: mucks hand 
19991986830 collected $2.58 from pot
*** SUMMARY ***
Total pot $2.70 | Rake $0.12 
Board [Qc 7c 2c Kh 6h]
Seat 1: 19991986830 showed [Ks Jc] and won ($2.58) with a pair of Kings
Seat 2: d2jones mucked
Seat 3: rioma10 folded before Flop (didn't bet)
Seat 4: jimeshka (button) folded before Flop (didn't bet)
Seat 5: Jacub1987 (small blind) folded on the Flop
Seat 6: Guslalala (big blind) folded before Flop



PokerStars Hand #222974964503:  Hold'em No Limit ($0.05/$0.10 USD) - 2021/01/23 17:23:59 ET
Table 'Jihlava III' 6-max Seat #4 is the button
Seat 1: 19991986830 ($21.86 in chips) 
Seat 2: ghost4c ($7.36 in chips) 
Seat 3: rioma10 ($9.67 in chips) 
Seat 4: jimeshka ($5.25 in chips) 
Seat 5: Lumbojack ($18.12 in chips) 
Seat 6: DrLevty ($10 in chips) 
Lumbojack: posts small blind $0.05
DrLevty: posts big blind $0.10
*** HOLE CARDS ***
19991986830: folds 
ghost4c: folds 
rioma10: raises $0.20 to $0.30
jimeshka: folds 
Lumbojack: folds 
DrLevty: folds 
Uncalled bet ($0.20) returned to rioma10
rioma10 collected $0.25 from pot
rioma10: doesn't show hand 
*** SUMMARY ***
Total pot $0.25 | Rake $0 
Seat 1: 19991986830 folded before Flop (didn't bet)
Seat 2: ghost4c folded before Flop (didn't bet)
Seat 3: rioma10 collected ($0.25)
Seat 4: jimeshka (button) folded before Flop (didn't bet)
Seat 5: Lumbojack (small blind) folded before Flop
Seat 6: DrLevty (big blind) folded before Flop



PokerStars Hand #222974972829:  Hold'em No Limit ($0.05/$0.10 USD) - 2021/01/23 17:24:09 ET
Table 'Jihlava III' 6-max Seat #5 is the button
Seat 1: 19991986830 ($21.86 in chips) 
Seat 2: ghost4c ($7.36 in chips) 
Seat 3: rioma10 ($9.82 in chips) 
Seat 4: jimeshka ($5.25 in chips) 
Seat 5: Lumbojack ($18.07 in chips) 
Seat 6: DrLevty ($10 in chips) 
DrLevty: posts small blind $0.05
19991986830: posts big blind $0.10
*** HOLE CARDS ***
ghost4c: raises $0.20 to $0.30
rioma10: folds 
jimeshka: calls $0.30
Lumbojack: folds 
DrLevty: folds 
19991986830: calls $0.20
*** FLOP *** [Th Td 9s]
19991986830: checks 
ghost4c: checks 
jimeshka: bets $0.91
19991986830: folds 
ghost4c: folds 
Uncalled bet ($0.91) returned to jimeshka
jimeshka collected $0.91 from pot
jimeshka: doesn't show hand 
*** SUMMARY ***
Total pot $0.95 | Rake $0.04 
Board [Th Td 9s]
Seat 1: 19991986830 (big blind) folded on the Flop
Seat 2: ghost4c folded on the Flop
Seat 3: rioma10 folded before Flop (didn't bet)
Seat 4: jimeshka collected ($0.91)
Seat 5: Lumbojack (button) folded before Flop (didn't bet)
Seat 6: DrLevty (small blind) folded before Flop



PokerStars Hand #222974994439:  Hold'em No Limit ($0.05/$0.10 USD) - 2021/01/23 17:24:36 ET
Table 'Jihlava III' 6-max Seat #6 is the button
Seat 1: 19991986830 ($21.56 in chips) 
Seat 2: ghost4c ($7.06 in chips) 
Seat 3: rioma10 ($9.82 in chips) 
Seat 4: jimeshka ($5.86 in chips) 
Seat 5: Lumbojack ($18.07 in chips) 
Seat 6: DrLevty ($10 in chips) 
19991986830: posts small blind $0.05
ghost4c: posts big blind $0.10
*** HOLE CARDS ***
rioma10: folds 
jimeshka: raises $0.30 to $0.40
Lumbojack: raises $0.80 to $1.20
DrLevty: folds 
19991986830: calls $1.15
ghost4c: folds 
jimeshka: calls $0.80
*** FLOP *** [3c 8d Th]
19991986830: checks 
jimeshka: checks 
Lumbojack: checks 
*** TURN *** [3c 8d Th] [Jc]
19991986830: checks 
jimeshka: bets $0.40
Lumbojack: calls $0.40
19991986830: calls $0.40
*** RIVER *** [3c 8d Th Jc] [Qh]
19991986830: checks 
jimeshka: checks 
Lumbojack: checks 
*** SHOW DOWN ***
19991986830: shows [Jh Ac] (a pair of Jacks)
jimeshka: mucks hand 
Lumbojack: shows [9d 9h] (a straight, Eight to Queen)
Lumbojack collected $4.68 from pot
*** SUMMARY ***
Total pot $4.90 | Rake $0.22 
Board [3c 8d Th Jc Qh]
Seat 1: 19991986830 (small blind) showed [Jh Ac] and lost with a pair of Jacks
Seat 2: ghost4c (big blind) folded before Flop
Seat 3: rioma10 folded before Flop (didn't bet)
Seat 4: jimeshka mucked
Seat 5: Lumbojack showed [9d 9h] and won ($4.68) with a straight, Eight to Queen
Seat 6: DrLevty (button) folded before Flop (didn't bet)



PokerStars Hand #222975059519:  Hold'em No Limit ($0.05/$0.10 USD) - 2021/01/23 17:25:57 ET
Table 'Jihlava III' 6-max Seat #1 is the button
Seat 1: 19991986830 ($19.96 in chips) 
Seat 2: ghost4c ($6.96 in chips) 
Seat 3: rioma10 ($9.82 in chips) 
Seat 4: jimeshka ($4.26 in chips) 
Seat 5: Lumbojack ($21.15 in chips) 
Seat 6: DrLevty ($10 in chips) 
ghost4c: posts small blind $0.05
rioma10: posts big blind $0.10
*** HOLE CARDS ***
jimeshka: calls $0.10
Lumbojack: raises $0.35 to $0.45
DrLevty: raises $1.15 to $1.60
19991986830: folds 
ghost4c: folds 
rioma10: folds 
jimeshka: folds 
Lumbojack: folds 
Uncalled bet ($1.15) returned to DrLevty
DrLevty collected $1.15 from pot
DrLevty: doesn't show hand 
*** SUMMARY ***
Total pot $1.15 | Rake $0 
Seat 1: 19991986830 (button) folded before Flop (didn't bet)
Seat 2: ghost4c (small blind) folded before Flop
Seat 3: rioma10 (big blind) folded before Flop
Seat 4: jimeshka folded before Flop
Seat 5: Lumbojack folded before Flop
Seat 6: DrLevty collected ($1.15)



PokerStars Hand #222975082554:  Hold'em No Limit ($0.05/$0.10 USD) - 2021/01/23 17:26:26 ET
Table 'Jihlava III' 6-max Seat #2 is the button
Seat 1: 19991986830 ($19.96 in chips) 
Seat 2: ghost4c ($6.91 in chips) 
Seat 3: rioma10 ($9.72 in chips) 
Seat 4: jimeshka ($4.16 in chips) 
Seat 5: Lumbojack ($20.70 in chips) 
Seat 6: DrLevty ($10.70 in chips) 
rioma10: posts small blind $0.05
jimeshka: posts big blind $0.10
*** HOLE CARDS ***
Lumbojack: raises $0.15 to $0.25
DrLevty: folds 
19991986830: folds 
ghost4c: calls $0.25
rioma10: folds 
jimeshka: calls $0.15
*** FLOP *** [Qs Ts 9s]
jimeshka: checks 
Lumbojack: checks 
ghost4c: checks 
*** TURN *** [Qs Ts 9s] [7d]
jimeshka: checks 
Lumbojack: checks 
ghost4c: checks 
*** RIVER *** [Qs Ts 9s 7d] [Ac]
jimeshka: bets $0.76
Lumbojack: calls $0.76
ghost4c: folds 
*** SHOW DOWN ***
jimeshka: shows [8c 6d] (a straight, Six to Ten)
Lumbojack: mucks hand 
jimeshka collected $2.22 from pot
*** SUMMARY ***
Total pot $2.32 | Rake $0.10 
Board [Qs Ts 9s 7d Ac]
Seat 1: 19991986830 folded before Flop (didn't bet)
Seat 2: ghost4c (button) folded on the River
Seat 3: rioma10 (small blind) folded before Flop
Seat 4: jimeshka (big blind) showed [8c 6d] and won ($2.22) with a straight, Six to Ten
Seat 5: Lumbojack mucked
Seat 6: DrLevty folded before Flop (didn't bet)



PokerStars Hand #222975120905:  Hold'em No Limit ($0.05/$0.10 USD) - 2021/01/23 17:27:13 ET
Table 'Jihlava III' 6-max Seat #3 is the button
Seat 1: 19991986830 ($19.96 in chips) 
Seat 2: ghost4c ($6.66 in chips) 
Seat 3: rioma10 ($9.67 in chips) 
Seat 4: jimeshka ($5.37 in chips) 
Seat 6: DrLevty ($10.70 in chips) 
jimeshka: posts small blind $0.05
Lumbojack: is sitting out 
DrLevty: posts big blind $0.10
*** HOLE CARDS ***
19991986830: raises $0.10 to $0.20
Lumbojack leaves the table
ghost4c: folds 
Jacub1987 joins the table at seat #5 
rioma10: raises $0.60 to $0.80
jimeshka: folds 
DrLevty: folds 
19991986830: folds 
Uncalled bet ($0.60) returned to rioma10
rioma10 collected $0.55 from pot
rioma10: doesn't show hand 
*** SUMMARY ***
Total pot $0.55 | Rake $0 
Seat 1: 19991986830 folded before Flop
Seat 2: ghost4c folded before Flop (didn't bet)
Seat 3: rioma10 (button) collected ($0.55)
Seat 4: jimeshka (small blind) folded before Flop
Seat 6: DrLevty (big blind) folded before Flop



PokerStars Hand #222976076121:  Hold'em No Limit ($0.05/$0.10 USD) - 2021/01/23 17:47:32 ET
Table 'Jihlava III' 6-max Seat #5 is the button
Seat 1: 19991986830 ($25.59 in chips) 
Seat 2: d2jones ($8.80 in chips) 
Seat 3: rioma10 ($9.67 in chips) 
Seat 4: jimeshka ($3.15 in chips) 
Seat 5: Jacub1987 ($10 in chips) 
Seat 6: Guslalala ($10 in chips) 
Guslalala: posts small blind $0.05
19991986830: posts big blind $0.10
*** HOLE CARDS ***
d2jones: folds 
rioma10: folds 
jimeshka: calls $0.10
Jacub1987: raises $0.25 to $0.35
Guslalala: folds 
19991986830: calls $0.25
jimeshka: calls $0.25
*** FLOP *** [Jh Ad Td]
19991986830: checks 
jimeshka: checks 
Jacub1987: checks 
*** TURN *** [Jh Ad Td] [Js]
19991986830: checks 
jimeshka: checks 
Jacub1987: bets $0.55
19991986830: calls $0.55
jimeshka: folds 
*** RIVER *** [Jh Ad Td Js] [3h]
19991986830: checks 
Jacub1987: bets $1.09
19991986830: folds 
Uncalled bet ($1.09) returned to Jacub1987
Jacub1987 collected $2.10 from pot
*** SUMMARY ***
Total pot $2.20 | Rake $0.10 
Board [Jh Ad Td Js 3h]
Seat 1: 19991986830 (big blind) folded on the River
Seat 2: d2jones folded before Flop (didn't bet)
Seat 3: rioma10 folded before Flop (didn't bet)
Seat 4: jimeshka folded on the Turn
Seat 5: Jacub1987 (button) collected ($2.10)
Seat 6: Guslalala (small blind) folded before Flop



PokerStars Hand #222976107638:  Hold'em No Limit ($0.05/$0.10 USD) - 2021/01/23 17:48:14 ET
Table 'Jihlava III' 6-max Seat #6 is the button
Seat 1: 19991986830 ($24.69 in chips) 
Seat 2: d2jones ($8.80 in chips) 
Seat 3: rioma10 ($9.67 in chips) 
Seat 4: jimeshka ($2.80 in chips) 
Seat 5: Jacub1987 ($11.20 in chips) 
Seat 6: Guslalala ($10 in chips) 
19991986830: posts small blind $0.05
d2jones: posts big blind $0.10
*** HOLE CARDS ***
rioma10: raises $0.20 to $0.30
jimeshka: folds 
Jacub1987: folds 
Guslalala: folds 
19991986830: folds 
d2jones: folds 
Uncalled bet ($0.20) returned to rioma10
rioma10 collected $0.25 from pot
rioma10: doesn't show hand 
*** SUMMARY ***
Total pot $0.25 | Rake $0 
Seat 1: 19991986830 (small blind) folded before Flop
Seat 2: d2jones (big blind) folded before Flop
Seat 3: rioma10 collected ($0.25)
Seat 4: jimeshka folded before Flop (didn't bet)
Seat 5: Jacub1987 folded before Flop (didn't bet)
Seat 6: Guslalala (button) folded before Flop (didn't bet)



PokerStars Hand #222976116066:  Hold'em No Limit ($0.05/$0.10 USD) - 2021/01/23 17:48:25 ET
Table 'Jihlava III' 6-max Seat #1 is the button
Seat 1: 19991986830 ($24.64 in chips) 
Seat 2: d2jones ($8.70 in chips) 
Seat 3: rioma10 ($9.82 in chips) 
Seat 4: jimeshka ($2.80 in chips) 
Seat 5: Jacub1987 ($11.20 in chips) 
Seat 6: Guslalala ($10 in chips) 
d2jones: posts small blind $0.05
rioma10: posts big blind $0.10
*** HOLE CARDS ***
jimeshka: calls $0.10
Jacub1987: folds 
Guslalala: folds 
19991986830: folds 
d2jones: folds 
rioma10: checks 
*** FLOP *** [7c 6s 3s]
rioma10: checks 
jimeshka: bets $0.10
rioma10: calls $0.10
*** TURN *** [7c 6s 3s] [9h]
rioma10: checks 
jimeshka: bets $0.20
rioma10: folds 
Uncalled bet ($0.20) returned to jimeshka
jimeshka collected $0.43 from pot
jimeshka: doesn't show hand 
*** SUMMARY ***
Total pot $0.45 | Rake $0.02 
Board [7c 6s 3s 9h]
Seat 1: 19991986830 (button) folded before Flop (didn't bet)
Seat 2: d2jones (small blind) folded before Flop
Seat 3: rioma10 (big blind) folded on the Turn
Seat 4: jimeshka collected ($0.43)
Seat 5: Jacub1987 folded before Flop (didn't bet)
Seat 6: Guslalala folded before Flop (didn't bet)



PokerStars Hand #222976153719:  Hold'em No Limit ($0.05/$0.10 USD) - 2021/01/23 17:49:16 ET
Table 'Jihlava III' 6-max Seat #2 is the button
Seat 1: 19991986830 ($24.64 in chips) 
Seat 2: d2jones ($8.65 in chips) 
Seat 3: rioma10 ($9.62 in chips) 
Seat 4: jimeshka ($3.03 in chips) 
Seat 5: Jacub1987 ($11.20 in chips) 
Seat 6: Guslalala ($10 in chips) 
rioma10: posts small blind $0.05
jimeshka: posts big blind $0.10
*** HOLE CARDS ***
Jacub1987: folds 
Guslalala: folds 
19991986830: raises $0.20 to $0.30
d2jones: folds 
rioma10: folds 
jimeshka: calls $0.20
*** FLOP *** [3s 4d Js]
jimeshka: checks 
19991986830: bets $0.20
jimeshka: calls $0.20
*** TURN *** [3s 4d Js] [Jd]
jimeshka: checks 
19991986830: bets $0.40
jimeshka: calls $0.40
*** RIVER *** [3s 4d Js Jd] [8c]
jimeshka: checks 
19991986830: checks 
*** SHOW DOWN ***
jimeshka: shows [8h Kd] (two pair, Jacks and Eights)
19991986830: shows [Td Ts] (two pair, Jacks and Tens)
19991986830 collected $1.77 from pot
*** SUMMARY ***
Total pot $1.85 | Rake $0.08 
Board [3s 4d Js Jd 8c]
Seat 1: 19991986830 showed [Td Ts] and won ($1.77) with two pair, Jacks and Tens
Seat 2: d2jones (button) folded before Flop (didn't bet)
Seat 3: rioma10 (small blind) folded before Flop
Seat 4: jimeshka (big blind) showed [8h Kd] and lost with two pair, Jacks and Eights
Seat 5: Jacub1987 folded before Flop (didn't bet)
Seat 6: Guslalala folded before Flop (didn't bet)



PokerStars Hand #222976189810:  Hold'em No Limit ($0.05/$0.10 USD) - 2021/01/23 17:50:05 ET
Table 'Jihlava III' 6-max Seat #3 is the button
Seat 1: 19991986830 ($25.51 in chips) 
Seat 2: d2jones ($8.65 in chips) 
Seat 3: rioma10 ($9.57 in chips) 
Seat 4: jimeshka ($2.13 in chips) 
Seat 5: Jacub1987 ($11.20 in chips) 
Seat 6: Guslalala ($10 in chips) 
jimeshka: posts small blind $0.05
Jacub1987: posts big blind $0.10
*** HOLE CARDS ***
Guslalala: folds 
19991986830: raises $0.10 to $0.20
d2jones: folds 
rioma10: raises $0.60 to $0.80
jimeshka: folds 
Jacub1987: folds 
19991986830: folds 
Uncalled bet ($0.60) returned to rioma10
rioma10 collected $0.55 from pot
rioma10: doesn't show hand 
*** SUMMARY ***
Total pot $0.55 | Rake $0 
Seat 1: 19991986830 folded before Flop
Seat 2: d2jones folded before Flop (didn't bet)
Seat 3: rioma10 (button) collected ($0.55)
Seat 4: jimeshka (small blind) folded before Flop
Seat 5: Jacub1987 (big blind) folded before Flop
Seat 6: Guslalala folded before Flop (didn't bet)



PokerStars Hand #222976205608:  Hold'em No Limit ($0.05/$0.10 USD) - 2021/01/23 17:50:27 ET
Table 'Jihlava III' 6-max Seat #4 is the button
Seat 1: 19991986830 ($25.31 in chips) 
Seat 2: d2jones ($8.65 in chips) 
Seat 3: rioma10 ($9.92 in chips) 
Seat 4: jimeshka ($2.08 in chips) 
Seat 5: Jacub1987 ($11.10 in chips) 
Seat 6: Guslalala ($10 in chips) 
Jacub1987: posts small blind $0.05
Guslalala: posts big blind $0.10
*** HOLE CARDS ***
19991986830: raises $0.10 to $0.20
d2jones: calls $0.20
rioma10: folds 
jimeshka: calls $0.20
Jacub1987: folds 
Guslalala: folds 
*** FLOP *** [7s 4s Kh]
19991986830: checks 
d2jones: bets $0.72
jimeshka: folds 
19991986830: folds 
Uncalled bet ($0.72) returned to d2jones
d2jones collected $0.72 from pot
*** SUMMARY ***
Total pot $0.75 | Rake $0.03 
Board [7s 4s Kh]
Seat 1: 19991986830 folded on the Flop
Seat 2: d2jones collected ($0.72)
Seat 3: rioma10 folded before Flop (didn't bet)
Seat 4: jimeshka (button) folded on the Flop
Seat 5: Jacub1987 (small blind) folded before Flop
Seat 6: Guslalala (big blind) folded before Flop



PokerStars Hand #222976231416:  Hold'em No Limit ($0.05/$0.10 USD) - 2021/01/23 17:51:02 ET
Table 'Jihlava III' 6-max Seat #5 is the button
Seat 1: 19991986830 ($25.11 in chips) 
Seat 2: d2jones ($9.17 in chips) 
Seat 3: rioma10 ($9.92 in chips) 
Seat 4: jimeshka ($1.88 in chips) 
Seat 5: Jacub1987 ($11.05 in chips) 
Seat 6: Guslalala ($10 in chips) 
Guslalala: posts small blind $0.05
19991986830: posts big blind $0.10
*** HOLE CARDS ***
d2jones: folds 
rioma10: folds 
jimeshka: calls $0.10
Jacub1987: raises $0.25 to $0.35
Guslalala: folds 
19991986830: folds 
jimeshka: calls $0.25
*** FLOP *** [2h 6d 2s]
jimeshka: checks 
Jacub1987: checks 
*** TURN *** [2h 6d 2s] [2c]
jimeshka: checks 
Jacub1987: bets $0.42
jimeshka: folds 
Uncalled bet ($0.42) returned to Jacub1987
Jacub1987 collected $0.81 from pot
*** SUMMARY ***
Total pot $0.85 | Rake $0.04 
Board [2h 6d 2s 2c]
Seat 1: 19991986830 (big blind) folded before Flop
Seat 2: d2jones folded before Flop (didn't bet)
Seat 3: rioma10 folded before Flop (didn't bet)
Seat 4: jimeshka folded on the Turn
Seat 5: Jacub1987 (button) collected ($0.81)
Seat 6: Guslalala (small blind) folded before Flop



PokerStars Hand #222976252875:  Hold'em No Limit ($0.05/$0.10 USD) - 2021/01/23 17:51:31 ET
Table 'Jihlava III' 6-max Seat #6 is the button
Seat 1: 19991986830 ($25.01 in chips) 
Seat 2: d2jones ($9.17 in chips) 
Seat 3: rioma10 ($9.92 in chips) 
Seat 4: jimeshka ($1.53 in chips) 
Seat 5: Jacub1987 ($11.51 in chips) 
Seat 6: Guslalala ($10 in chips) 
19991986830: posts small blind $0.05
d2jones: posts big blind $0.10
*** HOLE CARDS ***
rioma10: folds 
jimeshka: calls $0.10
Jacub1987 has timed out
Jacub1987: folds 
Guslalala: folds 
19991986830: folds 
d2jones: checks 
*** FLOP *** [Th Js 8c]
d2jones: bets $0.24
jimeshka: folds 
Uncalled bet ($0.24) returned to d2jones
d2jones collected $0.24 from pot
*** SUMMARY ***
Total pot $0.25 | Rake $0.01 
Board [Th Js 8c]
Seat 1: 19991986830 (small blind) folded before Flop
Seat 2: d2jones (big blind) collected ($0.24)
Seat 3: rioma10 folded before Flop (didn't bet)
Seat 4: jimeshka folded on the Flop
Seat 5: Jacub1987 folded before Flop (didn't bet)
Seat 6: Guslalala (button) folded before Flop (didn't bet)



PokerStars Hand #222976281118:  Hold'em No Limit ($0.05/$0.10 USD) - 2021/01/23 17:52:10 ET
Table 'Jihlava III' 6-max Seat #1 is the button
Seat 1: 19991986830 ($24.96 in chips) 
Seat 2: d2jones ($9.31 in chips) 
Seat 3: rioma10 ($9.92 in chips) 
Seat 4: jimeshka ($1.43 in chips) 
Seat 5: Jacub1987 ($11.51 in chips) 
Seat 6: Guslalala ($10 in chips) 
d2jones: posts small blind $0.05
rioma10: posts big blind $0.10
*** HOLE CARDS ***
jimeshka: folds 
Jacub1987: raises $0.15 to $0.25
Guslalala: folds 
19991986830: calls $0.25
d2jones: folds 
rioma10: folds 
*** FLOP *** [5h 2d Ah]
Jacub1987: bets $0.32
19991986830: folds 
Uncalled bet ($0.32) returned to Jacub1987
Jacub1987 collected $0.62 from pot
*** SUMMARY ***
Total pot $0.65 | Rake $0.03 
Board [5h 2d Ah]
Seat 1: 19991986830 (button) folded on the Flop
Seat 2: d2jones (small blind) folded before Flop
Seat 3: rioma10 (big blind) folded before Flop
Seat 4: jimeshka folded before Flop (didn't bet)
Seat 5: Jacub1987 collected ($0.62)
Seat 6: Guslalala folded before Flop (didn't bet)



PokerStars Hand #222976296660:  Hold'em No Limit ($0.05/$0.10 USD) - 2021/01/23 17:52:31 ET
Table 'Jihlava III' 6-max Seat #2 is the button
Seat 1: 19991986830 ($24.71 in chips) 
Seat 2: d2jones ($9.26 in chips) 
Seat 3: rioma10 ($9.82 in chips) 
Seat 4: jimeshka ($1.43 in chips) 
Seat 5: Jacub1987 ($11.88 in chips) 
Seat 6: Guslalala ($10 in chips) 
rioma10: posts small blind $0.05
jimeshka: posts big blind $0.10
*** HOLE CARDS ***
Jacub1987: folds 
Guslalala: raises $0.20 to $0.30
19991986830: calls $0.30
d2jones: folds 
rioma10: folds 
jimeshka: folds 
*** FLOP *** [Ah Qh 5d]
Guslalala: bets $0.45
19991986830: calls $0.45
*** TURN *** [Ah Qh 5d] [Qd]
Guslalala: checks 
19991986830: checks 
*** RIVER *** [Ah Qh 5d Qd] [4c]
Guslalala: bets $0.52
19991986830: calls $0.52
*** SHOW DOWN ***
Guslalala: shows [Kd Js] (a pair of Queens)
19991986830: shows [As 6d] (two pair, Aces and Queens)
19991986830 collected $2.57 from pot
*** SUMMARY ***
Total pot $2.69 | Rake $0.12 
Board [Ah Qh 5d Qd 4c]
Seat 1: 19991986830 showed [As 6d] and won ($2.57) with two pair, Aces and Queens
Seat 2: d2jones (button) folded before Flop (didn't bet)
Seat 3: rioma10 (small blind) folded before Flop
Seat 4: jimeshka (big blind) folded before Flop
Seat 5: Jacub1987 folded before Flop (didn't bet)
Seat 6: Guslalala showed [Kd Js] and lost with a pair of Queens



PokerStars Hand #222976316354:  Hold'em No Limit ($0.05/$0.10 USD) - 2021/01/23 17:52:59 ET
Table 'Jihlava III' 6-max Seat #3 is the button
Seat 1: 19991986830 ($26.01 in chips) 
Seat 2: d2jones ($9.26 in chips) 
Seat 3: rioma10 ($9.77 in chips) 
Seat 4: jimeshka ($1.33 in chips) 
Seat 5: Jacub1987 ($11.88 in chips) 
Seat 6: Guslalala ($10 in chips) 
jimeshka: posts small blind $0.05
Jacub1987: posts big blind $0.10
*** HOLE CARDS ***
Guslalala: folds 
19991986830: folds 
d2jones: calls $0.10
rioma10: folds 
jimeshka: calls $0.05
Jacub1987: checks 
*** FLOP *** [Jd 6s 3c]
jimeshka: checks 
Jacub1987: checks 
d2jones: bets $0.29
jimeshka: folds 
Jacub1987: folds 
Uncalled bet ($0.29) returned to d2jones
d2jones collected $0.29 from pot
*** SUMMARY ***
Total pot $0.30 | Rake $0.01 
Board [Jd 6s 3c]
Seat 1: 19991986830 folded before Flop (didn't bet)
Seat 2: d2jones collected ($0.29)
Seat 3: rioma10 (button) folded before Flop (didn't bet)
Seat 4: jimeshka (small blind) folded on the Flop
Seat 5: Jacub1987 (big blind) folded on the Flop
Seat 6: Guslalala folded before Flop (didn't bet)



PokerStars Hand #222976336338:  Hold'em No Limit ($0.05/$0.10 USD) - 2021/01/23 17:53:26 ET
Table 'Jihlava III' 6-max Seat #4 is the button
Seat 1: 19991986830 ($26.01 in chips) 
Seat 2: d2jones ($9.45 in chips) 
Seat 3: rioma10 ($9.77 in chips) 
Seat 4: jimeshka ($1.23 in chips) 
Seat 5: Jacub1987 ($11.78 in chips) 
Seat 6: Guslalala ($10 in chips) 
Jacub1987: posts small blind $0.05
Guslalala: posts big blind $0.10
*** HOLE CARDS ***
19991986830: folds 
d2jones: raises $0.10 to $0.20
rioma10: folds 
jimeshka: folds 
Jacub1987: folds 
Guslalala: folds 
Uncalled bet ($0.10) returned to d2jones
d2jones collected $0.25 from pot
*** SUMMARY ***
Total pot $0.25 | Rake $0 
Seat 1: 19991986830 folded before Flop (didn't bet)
Seat 2: d2jones collected ($0.25)
Seat 3: rioma10 folded before Flop (didn't bet)
Seat 4: jimeshka (button) folded before Flop (didn't bet)
Seat 5: Jacub1987 (small blind) folded before Flop
Seat 6: Guslalala (big blind) folded before Flop



PokerStars Hand #222976344820:  Hold'em No Limit ($0.05/$0.10 USD) - 2021/01/23 17:53:38 ET
Table 'Jihlava III' 6-max Seat #5 is the button
Seat 1: 19991986830 ($26.01 in chips) 
Seat 2: d2jones ($9.60 in chips) 
Seat 3: rioma10 ($9.77 in chips) 
Seat 4: jimeshka ($1.23 in chips) 
Seat 5: Jacub1987 ($11.73 in chips) 
Seat 6: Guslalala ($10 in chips) 
Guslalala: posts small blind $0.05
19991986830: posts big blind $0.10
*** HOLE CARDS ***
d2jones: folds 
rioma10: folds 
jimeshka: calls $0.10
Jacub1987: folds 
Guslalala: folds 
19991986830: checks 
*** FLOP *** [9h 5h 7d]
19991986830: checks 
jimeshka: bets $0.10
19991986830: calls $0.10
*** TURN *** [9h 5h 7d] [5s]
19991986830: bets $0.10
jimeshka: calls $0.10
*** RIVER *** [9h 5h 7d 5s] [5c]
19991986830: bets $0.10
jimeshka: calls $0.10
*** SHOW DOWN ***
19991986830: shows [8h Tc] (three of a kind, Fives)
jimeshka: shows [Qh Ad] (three of a kind, Fives - Ace kicker)
jimeshka collected $0.81 from pot
*** SUMMARY ***
Total pot $0.85 | Rake $0.04 
Board [9h 5h 7d 5s 5c]
Seat 1: 19991986830 (big blind) showed [8h Tc] and lost with three of a kind, Fives
Seat 2: d2jones folded before Flop (didn't bet)
Seat 3: rioma10 folded before Flop (didn't bet)
Seat 4: jimeshka showed [Qh Ad] and won ($0.81) with three of a kind, Fives
Seat 5: Jacub1987 (button) folded before Flop (didn't bet)
Seat 6: Guslalala (small blind) folded before Flop



PokerStars Hand #222976371377:  Hold'em No Limit ($0.05/$0.10 USD) - 2021/01/23 17:54:15 ET
Table 'Jihlava III' 6-max Seat #6 is the button
Seat 1: 19991986830 ($25.61 in chips) 
Seat 2: d2jones ($9.60 in chips) 
Seat 3: rioma10 ($9.77 in chips) 
Seat 4: jimeshka ($1.64 in chips) 
Seat 5: Jacub1987 ($11.73 in chips) 
Seat 6: Guslalala ($10 in chips) 
19991986830: posts small blind $0.05
d2jones: posts big blind $0.10
*** HOLE CARDS ***
rioma10: folds 
jimeshka: folds 
Jacub1987: folds 
Guslalala: raises $0.14 to $0.24
19991986830: calls $0.19
d2jones: calls $0.14
*** FLOP *** [7s Ah Js]
19991986830: checks 
d2jones: bets $0.69
Guslalala: folds 
19991986830: folds 
Uncalled bet ($0.69) returned to d2jones
d2jones collected $0.69 from pot
*** SUMMARY ***
Total pot $0.72 | Rake $0.03 
Board [7s Ah Js]
Seat 1: 19991986830 (small blind) folded on the Flop
Seat 2: d2jones (big blind) collected ($0.69)
Seat 3: rioma10 folded before Flop (didn't bet)
Seat 4: jimeshka folded before Flop (didn't bet)
Seat 5: Jacub1987 folded before Flop (didn't bet)
Seat 6: Guslalala (button) folded on the Flop



PokerStars Hand #222976392006:  Hold'em No Limit ($0.05/$0.10 USD) - 2021/01/23 17:54:43 ET
Table 'Jihlava III' 6-max Seat #1 is the button
Seat 1: 19991986830 ($25.37 in chips) 
Seat 2: d2jones ($10.05 in chips) 
Seat 3: rioma10 ($9.77 in chips) 
Seat 4: jimeshka ($1.64 in chips) 
Seat 5: Jacub1987 ($11.73 in chips) 
Seat 6: Guslalala ($10 in chips) 
d2jones: posts small blind $0.05
rioma10: posts big blind $0.10
*** HOLE CARDS ***
jimeshka: raises $0.40 to $0.50
Jacub1987: folds 
Guslalala: folds 
19991986830: folds 
d2jones: folds 
rioma10: folds 
Uncalled bet ($0.40) returned to jimeshka
jimeshka collected $0.25 from pot
jimeshka: doesn't show hand 
*** SUMMARY ***
Total pot $0.25 | Rake $0 
Seat 1: 19991986830 (button) folded before Flop (didn't bet)
Seat 2: d2jones (small blind) folded before Flop
Seat 3: rioma10 (big blind) folded before Flop
Seat 4: jimeshka collected ($0.25)
Seat 5: Jacub1987 folded before Flop (didn't bet)
Seat 6: Guslalala folded before Flop (didn't bet)



PokerStars Hand #222976402205:  Hold'em No Limit ($0.05/$0.10 USD) - 2021/01/23 17:54:57 ET
Table 'Jihlava III' 6-max Seat #2 is the button
Seat 1: 19991986830 ($25.37 in chips) 
Seat 2: d2jones ($10 in chips) 
Seat 3: rioma10 ($9.67 in chips) 
Seat 4: jimeshka ($1.79 in chips) 
Seat 5: Jacub1987 ($11.73 in chips) 
Seat 6: Guslalala ($10 in chips) 
rioma10: posts small blind $0.05
jimeshka: posts big blind $0.10
*** HOLE CARDS ***
Jacub1987: folds 
Guslalala: raises $0.20 to $0.30
19991986830: folds 
d2jones: folds 
rioma10: folds 
jimeshka: calls $0.20
*** FLOP *** [5d 8s Kd]
jimeshka: checks 
Guslalala: bets $0.45
jimeshka: folds 
Uncalled bet ($0.45) returned to Guslalala
Guslalala collected $0.62 from pot
Guslalala: doesn't show hand 
*** SUMMARY ***
Total pot $0.65 | Rake $0.03 
Board [5d 8s Kd]
Seat 1: 19991986830 folded before Flop (didn't bet)
Seat 2: d2jones (button) folded before Flop (didn't bet)
Seat 3: rioma10 (small blind) folded before Flop
Seat 4: jimeshka (big blind) folded on the Flop
Seat 5: Jacub1987 folded before Flop (didn't bet)
Seat 6: Guslalala collected ($0.62)



PokerStars Hand #222976414612:  Hold'em No Limit ($0.05/$0.10 USD) - 2021/01/23 17:55:16 ET
Table 'Jihlava III' 6-max Seat #3 is the button
Seat 1: 19991986830 ($25.37 in chips) 
Seat 2: d2jones ($10 in chips) 
Seat 3: rioma10 ($9.62 in chips) 
Seat 4: jimeshka ($1.49 in chips) 
Seat 5: Jacub1987 ($11.73 in chips) 
Seat 6: Guslalala ($10.32 in chips) 
jimeshka: posts small blind $0.05
Jacub1987: posts big blind $0.10
*** HOLE CARDS ***
Guslalala: folds 
19991986830: raises $0.10 to $0.20
d2jones: calls $0.20
rioma10: calls $0.20
jimeshka: calls $0.15
Jacub1987: folds 
*** FLOP *** [Js 2c Th]
jimeshka: checks 
19991986830: checks 
d2jones: checks 
rioma10: bets $0.45
jimeshka: folds 
19991986830: calls $0.45
d2jones: folds 
*** TURN *** [Js 2c Th] [4d]
19991986830: checks 
rioma10: bets $1.15
19991986830: folds 
Uncalled bet ($1.15) returned to rioma10
rioma10 collected $1.72 from pot
rioma10: doesn't show hand 
*** SUMMARY ***
Total pot $1.80 | Rake $0.08 
Board [Js 2c Th 4d]
Seat 1: 19991986830 folded on the Turn
Seat 2: d2jones folded on the Flop
Seat 3: rioma10 (button) collected ($1.72)
Seat 4: jimeshka (small blind) folded on the Flop
Seat 5: Jacub1987 (big blind) folded before Flop
Seat 6: Guslalala folded before Flop (didn't bet)



PokerStars Hand #222976446688:  Hold'em No Limit ($0.05/$0.10 USD) - 2021/01/23 17:56:18 ET
Table 'Jihlava III' 6-max Seat #4 is the button
Seat 1: 19991986830 ($24.72 in chips) 
Seat 2: d2jones ($9.80 in chips) 
Seat 3: rioma10 ($10.69 in chips) 
Seat 4: jimeshka ($1.29 in chips) 
Seat 5: Jacub1987 ($11.63 in chips) 
Seat 6: Guslalala ($10.32 in chips) 
Jacub1987: posts small blind $0.05
Guslalala: posts big blind $0.10
*** HOLE CARDS ***
19991986830: raises $0.20 to $0.30
d2jones: folds 
rioma10: folds 
jimeshka: folds 
Jacub1987: folds 
Guslalala: folds 
Uncalled bet ($0.20) returned to 19991986830
19991986830 collected $0.25 from pot
*** SUMMARY ***
Total pot $0.25 | Rake $0 
Seat 1: 19991986830 collected ($0.25)
Seat 2: d2jones folded before Flop (didn't bet)
Seat 3: rioma10 folded before Flop (didn't bet)
Seat 4: jimeshka (button) folded before Flop (didn't bet)
Seat 5: Jacub1987 (small blind) folded before Flop
Seat 6: Guslalala (big blind) folded before Flop



PokerStars Hand #222976452962:  Hold'em No Limit ($0.05/$0.10 USD) - 2021/01/23 17:56:29 ET
Table 'Jihlava III' 6-max Seat #5 is the button
Seat 1: 19991986830 ($24.87 in chips) 
Seat 2: d2jones ($9.80 in chips) 
Seat 3: rioma10 ($10.69 in chips) 
Seat 4: jimeshka ($1.29 in chips) 
Seat 5: Jacub1987 ($11.58 in chips) 
Seat 6: Guslalala ($10.22 in chips) 
Guslalala: posts small blind $0.05
19991986830: posts big blind $0.10
*** HOLE CARDS ***
d2jones has timed out
d2jones: folds 
rioma10: folds 
jimeshka: calls $0.10
Jacub1987: raises $0.35 to $0.45
Guslalala: folds 
19991986830: calls $0.35
jimeshka: calls $0.35
*** FLOP *** [4d 9c 6s]
19991986830: bets $0.67
jimeshka: folds 
Jacub1987: folds 
Uncalled bet ($0.67) returned to 19991986830
19991986830 collected $1.34 from pot
*** SUMMARY ***
Total pot $1.40 | Rake $0.06 
Board [4d 9c 6s]
Seat 1: 19991986830 (big blind) collected ($1.34)
Seat 2: d2jones folded before Flop (didn't bet)
Seat 3: rioma10 folded before Flop (didn't bet)
Seat 4: jimeshka folded on the Flop
Seat 5: Jacub1987 (button) folded on the Flop
Seat 6: Guslalala (small blind) folded before Flop



PokerStars Hand #222976472127:  Hold'em No Limit ($0.05/$0.10 USD) - 2021/01/23 17:57:06 ET
Table 'Jihlava III' 6-max Seat #6 is the button
Seat 1: 19991986830 ($25.76 in chips) 
Seat 2: d2jones ($9.80 in chips) 
Seat 3: rioma10 ($10.69 in chips) 
Seat 4: jimeshka ($0.84 in chips) 
Seat 5: Jacub1987 ($11.13 in chips) 
Seat 6: Guslalala ($10.17 in chips) 
19991986830: posts small blind $0.05
d2jones: posts big blind $0.10
*** HOLE CARDS ***
rioma10: folds 
jimeshka: folds 
Jacub1987: folds 
Guslalala: folds 
19991986830: raises $0.20 to $0.30
d2jones: calls $0.20
*** FLOP *** [2c 6s 9s]
19991986830: bets $0.29
d2jones: calls $0.29
*** TURN *** [2c 6s 9s] [3c]
19991986830: bets $0.57
d2jones: calls $0.57
*** RIVER *** [2c 6s 9s 3c] [3s]
19991986830: checks 
d2jones: bets $2.22
19991986830: folds 
Uncalled bet ($2.22) returned to d2jones
d2jones collected $2.22 from pot
*** SUMMARY ***
Total pot $2.32 | Rake $0.10 
Board [2c 6s 9s 3c 3s]
Seat 1: 19991986830 (small blind) folded on the River
Seat 2: d2jones (big blind) collected ($2.22)
Seat 3: rioma10 folded before Flop (didn't bet)
Seat 4: jimeshka folded before Flop (didn't bet)
Seat 5: Jacub1987 folded before Flop (didn't bet)
Seat 6: Guslalala (button) folded before Flop (didn't bet)



PokerStars Hand #222976494172:  Hold'em No Limit ($0.05/$0.10 USD) - 2021/01/23 17:57:47 ET
Table 'Jihlava III' 6-max Seat #1 is the button
Seat 1: 19991986830 ($24.60 in chips) 
Seat 2: d2jones ($10.86 in chips) 
Seat 3: rioma10 ($10.69 in chips) 
Seat 4: jimeshka ($0.84 in chips) 
Seat 5: Jacub1987 ($11.13 in chips) 
Seat 6: Guslalala ($10.17 in chips) 
d2jones: posts small blind $0.05
rioma10: posts big blind $0.10
*** HOLE CARDS ***
jimeshka: folds 
Jacub1987: folds 
Guslalala: raises $0.16 to $0.26
19991986830: calls $0.26
d2jones: folds 
rioma10: raises $1.24 to $1.50
Guslalala: folds 
19991986830: folds 
Uncalled bet ($1.24) returned to rioma10
d2jones leaves the table
rioma10 collected $0.83 from pot
rioma10: doesn't show hand 
*** SUMMARY ***
Total pot $0.83 | Rake $0 
Seat 1: 19991986830 (button) folded before Flop
Seat 2: d2jones (small blind) folded before Flop
Seat 3: rioma10 (big blind) collected ($0.83)
Seat 4: jimeshka folded before Flop (didn't bet)
Seat 5: Jacub1987 folded before Flop (didn't bet)
Seat 6: Guslalala folded before Flop



PokerStars Hand #222976509872:  Hold'em No Limit ($0.05/$0.10 USD) - 2021/01/23 17:58:16 ET
Table 'Jihlava III' 6-max Seat #3 is the button
Seat 1: 19991986830 ($24.34 in chips) 
Seat 3: rioma10 ($11.26 in chips) 
Seat 4: jimeshka ($0.84 in chips) 
Seat 5: Jacub1987 ($11.13 in chips) 
Seat 6: Guslalala ($10 in chips) 
jimeshka: posts small blind $0.05
Jacub1987: posts big blind $0.10
*** HOLE CARDS ***
Guslalala: folds 
19991986830: raises $0.20 to $0.30
rioma10: folds 
jimeshka: raises $0.30 to $0.60
Jacub1987: folds 
19991986830: calls $0.30
*** FLOP *** [Jc Ks Td]
jimeshka: bets $0.24 and is all-in
19991986830: calls $0.24
Gavrik 1981 joins the table at seat #2 
*** TURN *** [Jc Ks Td] [As]
*** RIVER *** [Jc Ks Td As] [Tc]
*** SHOW DOWN ***
jimeshka: shows [Qd Qc] (a straight, Ten to Ace)
19991986830: shows [5s Qs] (a straight, Ten to Ace)
jimeshka collected $0.85 from pot
19991986830 collected $0.85 from pot
*** SUMMARY ***
Total pot $1.78 | Rake $0.08 
Board [Jc Ks Td As Tc]
Seat 1: 19991986830 showed [5s Qs] and won ($0.85) with a straight, Ten to Ace
Seat 3: rioma10 (button) folded before Flop (didn't bet)
Seat 4: jimeshka (small blind) showed [Qd Qc] and won ($0.85) with a straight, Ten to Ace
Seat 5: Jacub1987 (big blind) folded before Flop
Seat 6: Guslalala folded before Flop (didn't bet)



PokerStars Hand #222976525400:  Hold'em No Limit ($0.05/$0.10 USD) - 2021/01/23 17:58:46 ET
Table 'Jihlava III' 6-max Seat #4 is the button
Seat 1: 19991986830 ($24.35 in chips) 
Seat 2: Gavrik 1981 ($10 in chips) 
Seat 3: rioma10 ($11.26 in chips) 
Seat 4: jimeshka ($0.85 in chips) 
Seat 5: Jacub1987 ($11.03 in chips) 
Seat 6: Guslalala ($10 in chips) 
Jacub1987: posts small blind $0.05
Guslalala: posts big blind $0.10
Gavrik 1981: posts big blind $0.10
*** HOLE CARDS ***
19991986830: calls $0.10
Gavrik 1981: checks 
rioma10: folds 
jimeshka: folds 
Jacub1987: calls $0.05
Guslalala: raises $0.70 to $0.80
19991986830: calls $0.70
Gavrik 1981: folds 
Jacub1987: folds 
*** FLOP *** [2c 6s Td]
Guslalala: bets $0.60
19991986830: calls $0.60
*** TURN *** [2c 6s Td] [Ts]
Guslalala: bets $1.60
19991986830: folds 
Uncalled bet ($1.60) returned to Guslalala
Guslalala collected $2.86 from pot
Guslalala: doesn't show hand 
*** SUMMARY ***
Total pot $3 | Rake $0.14 
Board [2c 6s Td Ts]
Seat 1: 19991986830 folded on the Turn
Seat 2: Gavrik 1981 folded before Flop (didn't bet)
Seat 3: rioma10 folded before Flop (didn't bet)
Seat 4: jimeshka (button) folded before Flop (didn't bet)
Seat 5: Jacub1987 (small blind) folded before Flop
Seat 6: Guslalala (big blind) collected ($2.86)



PokerStars Hand #222976553120:  Hold'em No Limit ($0.05/$0.10 USD) - 2021/01/23 17:59:29 ET
Table 'Jihlava III' 6-max Seat #5 is the button
Seat 1: 19991986830 ($22.95 in chips) 
Seat 2: Gavrik 1981 ($9.90 in chips) 
Seat 3: rioma10 ($11.26 in chips) 
Seat 4: jimeshka ($0.85 in chips) 
Seat 5: Jacub1987 ($10.93 in chips) 
Seat 6: Guslalala ($11.46 in chips) 
Guslalala: posts small blind $0.05
19991986830: posts big blind $0.10
*** HOLE CARDS ***
Gavrik 1981: folds 
rioma10: folds 
jimeshka: calls $0.10
Jacub1987: folds 
Guslalala: folds 
19991986830: checks 
*** FLOP *** [4s Kd 9c]
19991986830: checks 
jimeshka: checks 
*** TURN *** [4s Kd 9c] [2h]
19991986830: checks 
jimeshka: checks 
*** RIVER *** [4s Kd 9c 2h] [Jd]
19991986830: checks 
jimeshka: bets $0.10
19991986830: folds 
Uncalled bet ($0.10) returned to jimeshka
jimeshka collected $0.24 from pot
jimeshka: doesn't show hand 
*** SUMMARY ***
Total pot $0.25 | Rake $0.01 
Board [4s Kd 9c 2h Jd]
Seat 1: 19991986830 (big blind) folded on the River
Seat 2: Gavrik 1981 folded before Flop (didn't bet)
Seat 3: rioma10 folded before Flop (didn't bet)
Seat 4: jimeshka collected ($0.24)
Seat 5: Jacub1987 (button) folded before Flop (didn't bet)
Seat 6: Guslalala (small blind) folded before Flop



PokerStars Hand #222976568007:  Hold'em No Limit ($0.05/$0.10 USD) - 2021/01/23 17:59:57 ET
Table 'Jihlava III' 6-max Seat #6 is the button
Seat 1: 19991986830 ($22.85 in chips) 
Seat 2: Gavrik 1981 ($9.90 in chips) 
Seat 3: rioma10 ($11.26 in chips) 
Seat 4: jimeshka ($0.99 in chips) 
Seat 5: Jacub1987 ($10.93 in chips) 
Seat 6: Guslalala ($11.41 in chips) 
19991986830: posts small blind $0.05
Gavrik 1981: posts big blind $0.10
*** HOLE CARDS ***
rioma10: folds 
jimeshka: folds 
Jacub1987: folds 
Guslalala: raises $0.14 to $0.24
19991986830: calls $0.19
Gavrik 1981: calls $0.14
*** FLOP *** [8h 9d 4c]
19991986830: checks 
Gavrik 1981: checks 
Guslalala: bets $0.38
19991986830: calls $0.38
Gavrik 1981: calls $0.38
*** TURN *** [8h 9d 4c] [3c]
19991986830: checks 
Gavrik 1981: checks 
Guslalala: checks 
*** RIVER *** [8h 9d 4c 3c] [2s]
19991986830: checks 
Gavrik 1981: bets $0.89
Guslalala: folds 
19991986830: folds 
Uncalled bet ($0.89) returned to Gavrik 1981
Gavrik 1981 collected $1.78 from pot
Gavrik 1981: doesn't show hand 
*** SUMMARY ***
Total pot $1.86 | Rake $0.08 
Board [8h 9d 4c 3c 2s]
Seat 1: 19991986830 (small blind) folded on the River
Seat 2: Gavrik 1981 (big blind) collected ($1.78)
Seat 3: rioma10 folded before Flop (didn't bet)
Seat 4: jimeshka folded before Flop (didn't bet)
Seat 5: Jacub1987 folded before Flop (didn't bet)
Seat 6: Guslalala (button) folded on the River



PokerStars Hand #222976599682:  Hold'em No Limit ($0.05/$0.10 USD) - 2021/01/23 18:00:51 ET
Table 'Jihlava III' 6-max Seat #1 is the button
Seat 1: 19991986830 ($22.23 in chips) 
Seat 2: Gavrik 1981 ($11.06 in chips) 
Seat 3: rioma10 ($11.26 in chips) 
Seat 4: jimeshka ($0.99 in chips) 
Seat 5: Jacub1987 ($10.93 in chips) 
Seat 6: Guslalala ($10.79 in chips) 
Gavrik 1981: posts small blind $0.05
rioma10: posts big blind $0.10
*** HOLE CARDS ***
jimeshka: folds 
Jacub1987: folds 
Guslalala: raises $0.16 to $0.26
19991986830: calls $0.26
Gavrik 1981: folds 
rioma10: folds 
*** FLOP *** [6c Ac 3h]
Guslalala: bets $0.40
19991986830: calls $0.40
*** TURN *** [6c Ac 3h] [2s]
Guslalala: bets $0.90
19991986830: calls $0.90
*** RIVER *** [6c Ac 3h 2s] [5d]
Guslalala: checks 
19991986830: checks 
*** SHOW DOWN ***
Guslalala: shows [Ah 2d] (two pair, Aces and Deuces)
19991986830: mucks hand 
Guslalala collected $3.12 from pot
*** SUMMARY ***
Total pot $3.27 | Rake $0.15 
Board [6c Ac 3h 2s 5d]
Seat 1: 19991986830 (button) mucked
Seat 2: Gavrik 1981 (small blind) folded before Flop
Seat 3: rioma10 (big blind) folded before Flop
Seat 4: jimeshka folded before Flop (didn't bet)
Seat 5: Jacub1987 folded before Flop (didn't bet)
Seat 6: Guslalala showed [Ah 2d] and won ($3.12) with two pair, Aces and Deuces



PokerStars Hand #222976620059:  Hold'em No Limit ($0.05/$0.10 USD) - 2021/01/23 18:01:23 ET
Table 'Jihlava III' 6-max Seat #2 is the button
Seat 1: 19991986830 ($20.67 in chips) 
Seat 2: Gavrik 1981 ($11.01 in chips) 
Seat 3: rioma10 ($11.16 in chips) 
Seat 4: jimeshka ($0.99 in chips) 
Seat 5: Jacub1987 ($10.93 in chips) 
Seat 6: Guslalala ($12.35 in chips) 
rioma10: posts small blind $0.05
jimeshka: posts big blind $0.10
*** HOLE CARDS ***
Jacub1987: folds 
Guslalala: folds 
19991986830: raises $0.10 to $0.20
Gavrik 1981: folds 
rioma10: folds 
jimeshka: calls $0.10
*** FLOP *** [6h Td 5h]
jimeshka: checks 
19991986830: bets $0.22
jimeshka: folds 
Uncalled bet ($0.22) returned to 19991986830
19991986830 collected $0.43 from pot
*** SUMMARY ***
Total pot $0.45 | Rake $0.02 
Board [6h Td 5h]
Seat 1: 19991986830 collected ($0.43)
Seat 2: Gavrik 1981 (button) folded before Flop (didn't bet)
Seat 3: rioma10 (small blind) folded before Flop
Seat 4: jimeshka (big blind) folded on the Flop
Seat 5: Jacub1987 folded before Flop (didn't bet)
Seat 6: Guslalala folded before Flop (didn't bet)



PokerStars Hand #222976633647:  Hold'em No Limit ($0.05/$0.10 USD) - 2021/01/23 18:01:44 ET
Table 'Jihlava III' 6-max Seat #3 is the button
Seat 1: 19991986830 ($20.90 in chips) 
Seat 2: Gavrik 1981 ($11.01 in chips) 
Seat 3: rioma10 ($11.11 in chips) 
Seat 4: jimeshka ($0.79 in chips) 
Seat 5: Jacub1987 ($10.93 in chips) 
Seat 6: Guslalala ($12.35 in chips) 
jimeshka: posts small blind $0.05
Jacub1987: posts big blind $0.10
*** HOLE CARDS ***
Guslalala: folds 
19991986830: raises $0.20 to $0.30
Gavrik 1981: calls $0.30
rioma10: folds 
jimeshka: calls $0.25
Jacub1987: folds 
*** FLOP *** [4d 6h 7h]
jimeshka: checks 
19991986830: checks 
Gavrik 1981: bets $0.96
jimeshka: folds 
19991986830: calls $0.96
*** TURN *** [4d 6h 7h] [5d]
19991986830: checks 
Gavrik 1981: checks 
*** RIVER *** [4d 6h 7h 5d] [4s]
19991986830: bets $1.20
Gavrik 1981: raises $2.60 to $3.80
19991986830: calls $2.60
*** SHOW DOWN ***
Gavrik 1981: shows [9c Kc] (a pair of Fours)
19991986830: shows [7d 8h] (a straight, Four to Eight)
19991986830 collected $10.05 from pot
*** SUMMARY ***
Total pot $10.52 | Rake $0.47 
Board [4d 6h 7h 5d 4s]
Seat 1: 19991986830 showed [7d 8h] and won ($10.05) with a straight, Four to Eight
Seat 2: Gavrik 1981 showed [9c Kc] and lost with a pair of Fours
Seat 3: rioma10 (button) folded before Flop (didn't bet)
Seat 4: jimeshka (small blind) folded on the Flop
Seat 5: Jacub1987 (big blind) folded before Flop
Seat 6: Guslalala folded before Flop (didn't bet)



PokerStars Hand #222976686126:  Hold'em No Limit ($0.05/$0.10 USD) - 2021/01/23 18:03:00 ET
Table 'Jihlava III' 6-max Seat #4 is the button
Seat 1: 19991986830 ($25.89 in chips) 
Seat 2: Gavrik 1981 ($5.95 in chips) 
Seat 3: rioma10 ($11.11 in chips) 
Seat 4: jimeshka ($0.49 in chips) 
Seat 5: Jacub1987 ($10.83 in chips) 
Seat 6: Guslalala ($12.35 in chips) 
Jacub1987: posts small blind $0.05
Guslalala: posts big blind $0.10
*** HOLE CARDS ***
19991986830: raises $0.20 to $0.30
Gavrik 1981: folds 
rioma10: folds 
jimeshka: folds 
Jacub1987: calls $0.25
Guslalala: folds 
*** FLOP *** [Ah 6c 8h]
Jacub1987: checks 
19991986830: bets $0.20
Jacub1987: calls $0.20
*** TURN *** [Ah 6c 8h] [Jc]
Jacub1987: checks 
19991986830: bets $0.30
Jacub1987: calls $0.30
*** RIVER *** [Ah 6c 8h Jc] [Qh]
Jacub1987: bets $1.23
19991986830: calls $1.23
*** SHOW DOWN ***
Jacub1987: shows [Th Kh] (a flush, Ace high)
19991986830: mucks hand 
Jacub1987 collected $3.97 from pot
*** SUMMARY ***
Total pot $4.16 | Rake $0.19 
Board [Ah 6c 8h Jc Qh]
Seat 1: 19991986830 mucked
Seat 2: Gavrik 1981 folded before Flop (didn't bet)
Seat 3: rioma10 folded before Flop (didn't bet)
Seat 4: jimeshka (button) folded before Flop (didn't bet)
Seat 5: Jacub1987 (small blind) showed [Th Kh] and won ($3.97) with a flush, Ace high
Seat 6: Guslalala (big blind) folded before Flop



PokerStars Hand #222976713570:  Hold'em No Limit ($0.05/$0.10 USD) - 2021/01/23 18:03:39 ET
Table 'Jihlava III' 6-max Seat #5 is the button
Seat 1: 19991986830 ($23.86 in chips) 
Seat 2: Gavrik 1981 ($10 in chips) 
Seat 3: rioma10 ($11.11 in chips) 
Seat 4: jimeshka ($0.49 in chips) 
Seat 5: Jacub1987 ($12.77 in chips) 
Seat 6: Guslalala ($12.25 in chips) 
Guslalala: posts small blind $0.05
19991986830: posts big blind $0.10
*** HOLE CARDS ***
Gavrik 1981: raises $0.20 to $0.30
rioma10: folds 
jimeshka: folds 
Jacub1987: folds 
Guslalala: calls $0.25
19991986830: calls $0.20
*** FLOP *** [Tc Td 7d]
Guslalala: checks 
19991986830: checks 
Gavrik 1981: bets $0.43
Guslalala: folds 
19991986830: calls $0.43
*** TURN *** [Tc Td 7d] [6c]
19991986830: checks 
Gavrik 1981: checks 
*** RIVER *** [Tc Td 7d 6c] [Kd]
19991986830: checks 
Gavrik 1981: checks 
*** SHOW DOWN ***
19991986830: shows [2h 2s] (two pair, Tens and Deuces)
Gavrik 1981: mucks hand 
19991986830 collected $1.68 from pot
*** SUMMARY ***
Total pot $1.76 | Rake $0.08 
Board [Tc Td 7d 6c Kd]
Seat 1: 19991986830 (big blind) showed [2h 2s] and won ($1.68) with two pair, Tens and Deuces
Seat 2: Gavrik 1981 mucked
Seat 3: rioma10 folded before Flop (didn't bet)
Seat 4: jimeshka folded before Flop (didn't bet)
Seat 5: Jacub1987 (button) folded before Flop (didn't bet)
Seat 6: Guslalala (small blind) folded on the Flop



PokerStars Hand #222976735772:  Hold'em No Limit ($0.05/$0.10 USD) - 2021/01/23 18:04:10 ET
Table 'Jihlava III' 6-max Seat #6 is the button
Seat 1: 19991986830 ($24.81 in chips) 
Seat 2: Gavrik 1981 ($9.27 in chips) 
Seat 3: rioma10 ($11.11 in chips) 
Seat 4: jimeshka ($0.49 in chips) 
Seat 5: Jacub1987 ($12.77 in chips) 
Seat 6: Guslalala ($11.95 in chips) 
19991986830: posts small blind $0.05
Gavrik 1981: posts big blind $0.10
*** HOLE CARDS ***
rioma10: raises $0.20 to $0.30
jimeshka: folds 
Jacub1987: folds 
Guslalala: folds 
19991986830: calls $0.25
Gavrik 1981: folds 
*** FLOP *** [6c 9d Th]
19991986830: checks 
rioma10: bets $0.25
19991986830: calls $0.25
*** TURN *** [6c 9d Th] [7s]
19991986830: checks 
rioma10: checks 
*** RIVER *** [6c 9d Th 7s] [6d]
19991986830: checks 
rioma10: checks 
*** SHOW DOWN ***
19991986830: shows [Jd 2d] (a pair of Sixes)
rioma10: shows [Ah Td] (two pair, Tens and Sixes)
rioma10 collected $1.15 from pot
*** SUMMARY ***
Total pot $1.20 | Rake $0.05 
Board [6c 9d Th 7s 6d]
Seat 1: 19991986830 (small blind) showed [Jd 2d] and lost with a pair of Sixes
Seat 2: Gavrik 1981 (big blind) folded before Flop
Seat 3: rioma10 showed [Ah Td] and won ($1.15) with two pair, Tens and Sixes
Seat 4: jimeshka folded before Flop (didn't bet)
Seat 5: Jacub1987 folded before Flop (didn't bet)
Seat 6: Guslalala (button) folded before Flop (didn't bet)



PokerStars Hand #222976768164:  Hold'em No Limit ($0.05/$0.10 USD) - 2021/01/23 18:04:56 ET
Table 'Jihlava III' 6-max Seat #1 is the button
Seat 1: 19991986830 ($24.26 in chips) 
Seat 2: Gavrik 1981 ($9.17 in chips) 
Seat 3: rioma10 ($11.71 in chips) 
Seat 4: jimeshka ($0.49 in chips) 
Seat 5: Jacub1987 ($12.77 in chips) 
Seat 6: Guslalala ($11.95 in chips) 
Gavrik 1981: posts small blind $0.05
rioma10: posts big blind $0.10
*** HOLE CARDS ***
jimeshka: raises $0.39 to $0.49 and is all-in
Jacub1987: folds 
Guslalala: folds 
19991986830: calls $0.49
Gavrik 1981: folds 
rioma10: folds 
*** FLOP *** [6h 2c 3d]
*** TURN *** [6h 2c 3d] [2h]
*** RIVER *** [6h 2c 3d 2h] [Th]
*** SHOW DOWN ***
jimeshka: shows [7c 7s] (two pair, Sevens and Deuces)
19991986830: shows [5h 6s] (two pair, Sixes and Deuces)
jimeshka collected $1.08 from pot
*** SUMMARY ***
Total pot $1.13 | Rake $0.05 
Board [6h 2c 3d 2h Th]
Seat 1: 19991986830 (button) showed [5h 6s] and lost with two pair, Sixes and Deuces
Seat 2: Gavrik 1981 (small blind) folded before Flop
Seat 3: rioma10 (big blind) folded before Flop
Seat 4: jimeshka showed [7c 7s] and won ($1.08) with two pair, Sevens and Deuces
Seat 5: Jacub1987 folded before Flop (didn't bet)
Seat 6: Guslalala folded before Flop (didn't bet)



PokerStars Hand #222976781855:  Hold'em No Limit ($0.05/$0.10 USD) - 2021/01/23 18:05:15 ET
Table 'Jihlava III' 6-max Seat #2 is the button
Seat 1: 19991986830 ($23.77 in chips) 
Seat 2: Gavrik 1981 ($9.12 in chips) 
Seat 3: rioma10 ($11.61 in chips) 
Seat 4: jimeshka ($1.08 in chips) 
Seat 5: Jacub1987 ($12.77 in chips) 
Seat 6: Guslalala ($11.95 in chips) 
rioma10: posts small blind $0.05
jimeshka: posts big blind $0.10
*** HOLE CARDS ***
Jacub1987: raises $0.25 to $0.35
Guslalala: folds 
19991986830: calls $0.35
Gavrik 1981: calls $0.35
rioma10: calls $0.30
jimeshka: raises $0.73 to $1.08 and is all-in
Jacub1987: raises $1.42 to $2.50
19991986830: folds 
Gavrik 1981: folds 
rioma10: folds 
Uncalled bet ($1.42) returned to Jacub1987
*** FLOP *** [Jd 9c Jh]
*** TURN *** [Jd 9c Jh] [Js]
*** RIVER *** [Jd 9c Jh Js] [5d]
*** SHOW DOWN ***
jimeshka: shows [9d 9s] (a full house, Jacks full of Nines)
Jacub1987: shows [Kc As] (three of a kind, Jacks)
jimeshka collected $3.07 from pot
*** SUMMARY ***
Total pot $3.21 | Rake $0.14 
Board [Jd 9c Jh Js 5d]
Seat 1: 19991986830 folded before Flop
Seat 2: Gavrik 1981 (button) folded before Flop
Seat 3: rioma10 (small blind) folded before Flop
Seat 4: jimeshka (big blind) showed [9d 9s] and won ($3.07) with a full house, Jacks full of Nines
Seat 5: Jacub1987 showed [Kc As] and lost with three of a kind, Jacks
Seat 6: Guslalala folded before Flop (didn't bet)



PokerStars Hand #222976808664:  Hold'em No Limit ($0.05/$0.10 USD) - 2021/01/23 18:05:52 ET
Table 'Jihlava III' 6-max Seat #3 is the button
Seat 1: 19991986830 ($23.42 in chips) 
Seat 2: Gavrik 1981 ($8.77 in chips) 
Seat 3: rioma10 ($11.26 in chips) 
Seat 4: jimeshka ($3.07 in chips) 
Seat 5: Jacub1987 ($11.69 in chips) 
Seat 6: Guslalala ($11.95 in chips) 
jimeshka: posts small blind $0.05
Jacub1987: posts big blind $0.10
*** HOLE CARDS ***
Guslalala: folds 
19991986830: raises $0.10 to $0.20
Gavrik 1981: folds 
rioma10: raises $0.60 to $0.80
jimeshka: folds 
Jacub1987: folds 
19991986830: calls $0.60
*** FLOP *** [Td 8d Qs]
19991986830: checks 
rioma10: checks 
*** TURN *** [Td 8d Qs] [2h]
19991986830: checks 
rioma10: bets $0.95
19991986830: calls $0.95
*** RIVER *** [Td 8d Qs 2h] [9h]
19991986830: checks 
rioma10: checks 
*** SHOW DOWN ***
19991986830: shows [Qc 2c] (two pair, Queens and Deuces)
rioma10: mucks hand 
19991986830 collected $3.49 from pot
*** SUMMARY ***
Total pot $3.65 | Rake $0.16 
Board [Td 8d Qs 2h 9h]
Seat 1: 19991986830 showed [Qc 2c] and won ($3.49) with two pair, Queens and Deuces
Seat 2: Gavrik 1981 folded before Flop (didn't bet)
Seat 3: rioma10 (button) mucked
Seat 4: jimeshka (small blind) folded before Flop
Seat 5: Jacub1987 (big blind) folded before Flop
Seat 6: Guslalala folded before Flop (didn't bet)



PokerStars Hand #222976852775:  Hold'em No Limit ($0.05/$0.10 USD) - 2021/01/23 18:06:55 ET
Table 'Jihlava III' 6-max Seat #4 is the button
Seat 1: 19991986830 ($25.16 in chips) 
Seat 2: Gavrik 1981 ($10 in chips) 
Seat 3: rioma10 ($9.51 in chips) 
Seat 4: jimeshka ($3.02 in chips) 
Seat 5: Jacub1987 ($11.59 in chips) 
Seat 6: Guslalala ($11.95 in chips) 
Jacub1987: posts small blind $0.05
Guslalala: posts big blind $0.10
*** HOLE CARDS ***
19991986830: raises $0.20 to $0.30
Gavrik 1981: calls $0.30
rioma10: folds 
jimeshka: folds 
Jacub1987: folds 
Guslalala: folds 
*** FLOP *** [9d 7c Tc]
19991986830: checks 
Gavrik 1981: checks 
*** TURN *** [9d 7c Tc] [Qh]
19991986830: checks 
Gavrik 1981: bets $0.36
19991986830: folds [4d]
Uncalled bet ($0.36) returned to Gavrik 1981
Gavrik 1981 collected $0.72 from pot
Gavrik 1981: doesn't show hand 
*** SUMMARY ***
Total pot $0.75 | Rake $0.03 
Board [9d 7c Tc Qh]
Seat 1: 19991986830 folded on the Turn
Seat 2: Gavrik 1981 collected ($0.72)
Seat 3: rioma10 folded before Flop (didn't bet)
Seat 4: jimeshka (button) folded before Flop (didn't bet)
Seat 5: Jacub1987 (small blind) folded before Flop
Seat 6: Guslalala (big blind) folded before Flop



PokerStars Hand #222976878963:  Hold'em No Limit ($0.05/$0.10 USD) - 2021/01/23 18:07:33 ET
Table 'Jihlava III' 6-max Seat #5 is the button
Seat 1: 19991986830 ($24.86 in chips) 
Seat 2: Gavrik 1981 ($10.42 in chips) 
Seat 3: rioma10 ($9.51 in chips) 
Seat 4: jimeshka ($3.02 in chips) 
Seat 5: Jacub1987 ($11.54 in chips) 
Seat 6: Guslalala ($11.85 in chips) 
Guslalala: posts small blind $0.05
19991986830: posts big blind $0.10
*** HOLE CARDS ***
Gavrik 1981: folds 
rioma10: folds 
jimeshka: calls $0.10
Jacub1987: folds 
Guslalala: folds 
19991986830: raises $0.10 to $0.20
jimeshka: calls $0.10
*** FLOP *** [4h 7s Jh]
19991986830: bets $0.43
jimeshka: calls $0.43
*** TURN *** [4h 7s Jh] [8c]
19991986830: checks 
jimeshka: bets $0.63
19991986830: calls $0.63
*** RIVER *** [4h 7s Jh 8c] [3h]
19991986830: checks 
jimeshka: checks 
*** SHOW DOWN ***
19991986830: shows [6c 6h] (a pair of Sixes)
jimeshka: shows [Jc Td] (a pair of Jacks)
jimeshka collected $2.45 from pot
*** SUMMARY ***
Total pot $2.57 | Rake $0.12 
Board [4h 7s Jh 8c 3h]
Seat 1: 19991986830 (big blind) showed [6c 6h] and lost with a pair of Sixes
Seat 2: Gavrik 1981 folded before Flop (didn't bet)
Seat 3: rioma10 folded before Flop (didn't bet)
Seat 4: jimeshka showed [Jc Td] and won ($2.45) with a pair of Jacks
Seat 5: Jacub1987 (button) folded before Flop (didn't bet)
Seat 6: Guslalala (small blind) folded before Flop



PokerStars Hand #222976904321:  Hold'em No Limit ($0.05/$0.10 USD) - 2021/01/23 18:08:09 ET
Table 'Jihlava III' 6-max Seat #6 is the button
Seat 1: 19991986830 ($23.60 in chips) 
Seat 2: Gavrik 1981 ($10.42 in chips) 
Seat 3: rioma10 ($9.51 in chips) 
Seat 4: jimeshka ($4.21 in chips) 
Seat 5: Jacub1987 ($11.54 in chips) 
Seat 6: Guslalala ($11.80 in chips) 
19991986830: posts small blind $0.05
Gavrik 1981: posts big blind $0.10
*** HOLE CARDS ***
rioma10: folds 
jimeshka: folds 
Jacub1987: folds 
Guslalala: folds 
19991986830: folds 
Uncalled bet ($0.05) returned to Gavrik 1981
Gavrik 1981 collected $0.10 from pot
Gavrik 1981: doesn't show hand 
*** SUMMARY ***
Total pot $0.10 | Rake $0 
Seat 1: 19991986830 (small blind) folded before Flop
Seat 2: Gavrik 1981 (big blind) collected ($0.10)
Seat 3: rioma10 folded before Flop (didn't bet)
Seat 4: jimeshka folded before Flop (didn't bet)
Seat 5: Jacub1987 folded before Flop (didn't bet)
Seat 6: Guslalala (button) folded before Flop (didn't bet)



PokerStars Hand #222976911042:  Hold'em No Limit ($0.05/$0.10 USD) - 2021/01/23 18:08:19 ET
Table 'Jihlava III' 6-max Seat #1 is the button
Seat 1: 19991986830 ($23.55 in chips) 
Seat 2: Gavrik 1981 ($10.47 in chips) 
Seat 3: rioma10 ($9.51 in chips) 
Seat 4: jimeshka ($4.21 in chips) 
Seat 5: Jacub1987 ($11.54 in chips) 
Seat 6: Guslalala ($11.80 in chips) 
Gavrik 1981: posts small blind $0.05
rioma10: posts big blind $0.10
*** HOLE CARDS ***
jimeshka: folds 
Jacub1987: folds 
Guslalala: raises $0.20 to $0.30
19991986830: folds 
Gavrik 1981: calls $0.25
rioma10: calls $0.20
*** FLOP *** [Th 8c 7s]
Gavrik 1981: checks 
rioma10: checks 
Guslalala: checks 
*** TURN *** [Th 8c 7s] [8d]
Gavrik 1981: checks 
rioma10: bets $0.57
Guslalala: folds 
Gavrik 1981: folds 
Uncalled bet ($0.57) returned to rioma10
rioma10 collected $0.86 from pot
rioma10: doesn't show hand 
*** SUMMARY ***
Total pot $0.90 | Rake $0.04 
Board [Th 8c 7s 8d]
Seat 1: 19991986830 (button) folded before Flop (didn't bet)
Seat 2: Gavrik 1981 (small blind) folded on the Turn
Seat 3: rioma10 (big blind) collected ($0.86)
Seat 4: jimeshka folded before Flop (didn't bet)
Seat 5: Jacub1987 folded before Flop (didn't bet)
Seat 6: Guslalala folded on the Turn



PokerStars Hand #222976943180:  Hold'em No Limit ($0.05/$0.10 USD) - 2021/01/23 18:09:05 ET
Table 'Jihlava III' 6-max Seat #2 is the button
Seat 1: 19991986830 ($23.55 in chips) 
Seat 2: Gavrik 1981 ($10.17 in chips) 
Seat 3: rioma10 ($10.07 in chips) 
Seat 4: jimeshka ($4.21 in chips) 
Seat 5: Jacub1987 ($11.54 in chips) 
Seat 6: Guslalala ($11.50 in chips) 
rioma10: posts small blind $0.05
jimeshka: posts big blind $0.10
*** HOLE CARDS ***
Jacub1987: folds 
Guslalala: folds 
19991986830: raises $0.20 to $0.30
Gavrik 1981: raises $0.75 to $1.05
rioma10: folds 
jimeshka: folds 
19991986830: calls $0.75
*** FLOP *** [4s 8c 5d]
19991986830: checks 
Gavrik 1981: checks 
*** TURN *** [4s 8c 5d] [7h]
19991986830: bets $0.50
Gavrik 1981: calls $0.50
*** RIVER *** [4s 8c 5d 7h] [8d]
19991986830: bets $1
Gavrik 1981: calls $1
*** SHOW DOWN ***
19991986830: shows [Kh Ad] (a pair of Eights)
Gavrik 1981: shows [Qd Qs] (two pair, Queens and Eights)
Gavrik 1981 collected $5.01 from pot
*** SUMMARY ***
Total pot $5.25 | Rake $0.24 
Board [4s 8c 5d 7h 8d]
Seat 1: 19991986830 showed [Kh Ad] and lost with a pair of Eights
Seat 2: Gavrik 1981 (button) showed [Qd Qs] and won ($5.01) with two pair, Queens and Eights
Seat 3: rioma10 (small blind) folded before Flop
Seat 4: jimeshka (big blind) folded before Flop
Seat 5: Jacub1987 folded before Flop (didn't bet)
Seat 6: Guslalala folded before Flop (didn't bet)



PokerStars Hand #222976979293:  Hold'em No Limit ($0.05/$0.10 USD) - 2021/01/23 18:09:49 ET
Table 'Jihlava III' 6-max Seat #3 is the button
Seat 1: 19991986830 ($21 in chips) 
Seat 2: Gavrik 1981 ($12.63 in chips) 
Seat 3: rioma10 ($10.02 in chips) 
Seat 4: jimeshka ($4.11 in chips) 
Seat 5: Jacub1987 ($11.54 in chips) 
Seat 6: Guslalala ($11.50 in chips) 
jimeshka: posts small blind $0.05
Jacub1987: posts big blind $0.10
*** HOLE CARDS ***
Guslalala: raises $0.20 to $0.30
19991986830: raises $0.20 to $0.50
Gavrik 1981: calls $0.50
rioma10: folds 
jimeshka: calls $0.45
Jacub1987: folds 
Guslalala: calls $0.20
*** FLOP *** [Ad Jd 5h]
jimeshka: checks 
Guslalala: checks 
19991986830: bets $0.50
Gavrik 1981: folds 
jimeshka: calls $0.50
Guslalala: folds 
*** TURN *** [Ad Jd 5h] [2h]
jimeshka: checks 
19991986830: checks 
*** RIVER *** [Ad Jd 5h 2h] [8d]
jimeshka: bets $1.48
19991986830: calls $1.48
*** SHOW DOWN ***
jimeshka: shows [As 3s] (a pair of Aces)
19991986830: shows [6s Ah] (a pair of Aces - Jack+Eight+Six kicker)
19991986830 collected $5.79 from pot
*** SUMMARY ***
Total pot $6.06 | Rake $0.27 
Board [Ad Jd 5h 2h 8d]
Seat 1: 19991986830 showed [6s Ah] and won ($5.79) with a pair of Aces
Seat 2: Gavrik 1981 folded on the Flop
Seat 3: rioma10 (button) folded before Flop (didn't bet)
Seat 4: jimeshka (small blind) showed [As 3s] and lost with a pair of Aces
Seat 5: Jacub1987 (big blind) folded before Flop
Seat 6: Guslalala folded on the Flop



PokerStars Hand #222977028947:  Hold'em No Limit ($0.05/$0.10 USD) - 2021/01/23 18:10:51 ET
Table 'Jihlava III' 6-max Seat #4 is the button
Seat 1: 19991986830 ($24.31 in chips) 
Seat 2: Gavrik 1981 ($12.13 in chips) 
Seat 3: rioma10 ($10.02 in chips) 
Seat 4: jimeshka ($1.63 in chips) 
Seat 5: Jacub1987 ($11.44 in chips) 
Seat 6: Guslalala ($11 in chips) 
Jacub1987: posts small blind $0.05
Guslalala: posts big blind $0.10
*** HOLE CARDS ***
19991986830: raises $0.30 to $0.40
Gavrik 1981: calls $0.40
rioma10: folds 
jimeshka: folds 
Jacub1987: folds 
Guslalala: folds 
*** FLOP *** [5d 7s Th]
19991986830: bets $0.30
Gavrik 1981: calls $0.30
*** TURN *** [5d 7s Th] [3s]
19991986830: bets $0.40
Gavrik 1981: calls $0.40
*** RIVER *** [5d 7s Th 3s] [Jd]
19991986830: checks 
Gavrik 1981: checks 
*** SHOW DOWN ***
19991986830: shows [Tc 6c] (a pair of Tens)
Gavrik 1981: mucks hand 
19991986830 collected $2.24 from pot
*** SUMMARY ***
Total pot $2.35 | Rake $0.11 
Board [5d 7s Th 3s Jd]
Seat 1: 19991986830 showed [Tc 6c] and won ($2.24) with a pair of Tens
Seat 2: Gavrik 1981 mucked
Seat 3: rioma10 folded before Flop (didn't bet)
Seat 4: jimeshka (button) folded before Flop (didn't bet)
Seat 5: Jacub1987 (small blind) folded before Flop
Seat 6: Guslalala (big blind) folded before Flop



PokerStars Hand #222977055188:  Hold'em No Limit ($0.05/$0.10 USD) - 2021/01/23 18:11:30 ET
Table 'Jihlava III' 6-max Seat #5 is the button
Seat 1: 19991986830 ($25.45 in chips) 
Seat 2: Gavrik 1981 ($11.03 in chips) 
Seat 3: rioma10 ($10.02 in chips) 
Seat 4: jimeshka ($1.63 in chips) 
Seat 5: Jacub1987 ($11.39 in chips) 
Seat 6: Guslalala ($10.90 in chips) 
Guslalala: posts small blind $0.05
19991986830: posts big blind $0.10
*** HOLE CARDS ***
Gavrik 1981: folds 
rioma10: raises $0.20 to $0.30
jimeshka: folds 
Jacub1987: folds 
Guslalala: folds 
19991986830: calls $0.20
*** FLOP *** [Js 5c 5d]
19991986830: checks 
rioma10: checks 
*** TURN *** [Js 5c 5d] [Ac]
19991986830: checks 
rioma10: checks 
*** RIVER *** [Js 5c 5d Ac] [3s]
19991986830: checks 
rioma10: bets $0.41
19991986830: folds 
Uncalled bet ($0.41) returned to rioma10
rioma10 collected $0.62 from pot
rioma10: doesn't show hand 
*** SUMMARY ***
Total pot $0.65 | Rake $0.03 
Board [Js 5c 5d Ac 3s]
Seat 1: 19991986830 (big blind) folded on the River
Seat 2: Gavrik 1981 folded before Flop (didn't bet)
Seat 3: rioma10 collected ($0.62)
Seat 4: jimeshka folded before Flop (didn't bet)
Seat 5: Jacub1987 (button) folded before Flop (didn't bet)
Seat 6: Guslalala (small blind) folded before Flop



PokerStars Hand #222977078507:  Hold'em No Limit ($0.05/$0.10 USD) - 2021/01/23 18:12:03 ET
Table 'Jihlava III' 6-max Seat #6 is the button
Seat 1: 19991986830 ($25.15 in chips) 
Seat 2: Gavrik 1981 ($11.03 in chips) 
Seat 3: rioma10 ($10.34 in chips) 
Seat 4: jimeshka ($1.63 in chips) 
Seat 5: Jacub1987 ($11.39 in chips) 
Seat 6: Guslalala ($10.85 in chips) 
19991986830: posts small blind $0.05
Gavrik 1981: posts big blind $0.10
*** HOLE CARDS ***
rioma10: folds 
jimeshka: folds 
Jacub1987: raises $0.15 to $0.25
Guslalala has timed out
Guslalala: folds 
19991986830: calls $0.20
Gavrik 1981: calls $0.15
*** FLOP *** [8h As Qd]
19991986830: checks 
Gavrik 1981: checks 
Jacub1987: bets $0.29
19991986830: folds 
Gavrik 1981: calls $0.29
*** TURN *** [8h As Qd] [7d]
Gavrik 1981: checks 
Jacub1987: checks 
*** RIVER *** [8h As Qd 7d] [2c]
Gavrik 1981: checks 
Jacub1987: checks 
*** SHOW DOWN ***
Gavrik 1981: shows [Ad 9d] (a pair of Aces)
Jacub1987: mucks hand 
Gavrik 1981 collected $1.27 from pot
*** SUMMARY ***
Total pot $1.33 | Rake $0.06 
Board [8h As Qd 7d 2c]
Seat 1: 19991986830 (small blind) folded on the Flop
Seat 2: Gavrik 1981 (big blind) showed [Ad 9d] and won ($1.27) with a pair of Aces
Seat 3: rioma10 folded before Flop (didn't bet)
Seat 4: jimeshka folded before Flop (didn't bet)
Seat 5: Jacub1987 mucked
Seat 6: Guslalala (button) folded before Flop (didn't bet)



PokerStars Hand #222977114295:  Hold'em No Limit ($0.05/$0.10 USD) - 2021/01/23 18:12:55 ET
Table 'Jihlava III' 6-max Seat #1 is the button
Seat 1: 19991986830 ($24.90 in chips) 
Seat 2: Gavrik 1981 ($11.76 in chips) 
Seat 3: rioma10 ($10.34 in chips) 
Seat 4: jimeshka ($1.63 in chips) 
Seat 5: Jacub1987 ($10.85 in chips) 
Seat 6: Guslalala ($10.85 in chips) 
Gavrik 1981: posts small blind $0.05
rioma10: posts big blind $0.10
*** HOLE CARDS ***
jimeshka: folds 
Jacub1987: raises $0.20 to $0.30
Guslalala: folds 
19991986830: calls $0.30
Gavrik 1981: folds 
rioma10: folds 
*** FLOP *** [Qc 7d 8c]
Jacub1987: bets $0.37
19991986830: folds 
Uncalled bet ($0.37) returned to Jacub1987
Jacub1987 collected $0.72 from pot
*** SUMMARY ***
Total pot $0.75 | Rake $0.03 
Board [Qc 7d 8c]
Seat 1: 19991986830 (button) folded on the Flop
Seat 2: Gavrik 1981 (small blind) folded before Flop
Seat 3: rioma10 (big blind) folded before Flop
Seat 4: jimeshka folded before Flop (didn't bet)
Seat 5: Jacub1987 collected ($0.72)
Seat 6: Guslalala folded before Flop (didn't bet)



PokerStars Hand #222977129091:  Hold'em No Limit ($0.05/$0.10 USD) - 2021/01/23 18:13:17 ET
Table 'Jihlava III' 6-max Seat #2 is the button
Seat 1: 19991986830 ($24.60 in chips) 
Seat 2: Gavrik 1981 ($11.71 in chips) 
Seat 3: rioma10 ($10.24 in chips) 
Seat 4: jimeshka ($1.63 in chips) 
Seat 5: Jacub1987 ($11.27 in chips) 
Seat 6: Guslalala ($10.85 in chips) 
rioma10: posts small blind $0.05
jimeshka: posts big blind $0.10
*** HOLE CARDS ***
Jacub1987: folds 
Guslalala: folds 
19991986830: folds 
Gavrik 1981: raises $0.20 to $0.30
rioma10: folds 
jimeshka: calls $0.20
*** FLOP *** [9c Kc 7d]
jimeshka: checks 
Gavrik 1981: bets $0.31
jimeshka: folds 
Uncalled bet ($0.31) returned to Gavrik 1981
Gavrik 1981 collected $0.62 from pot
Gavrik 1981: doesn't show hand 
*** SUMMARY ***
Total pot $0.65 | Rake $0.03 
Board [9c Kc 7d]
Seat 1: 19991986830 folded before Flop (didn't bet)
Seat 2: Gavrik 1981 (button) collected ($0.62)
Seat 3: rioma10 (small blind) folded before Flop
Seat 4: jimeshka (big blind) folded on the Flop
Seat 5: Jacub1987 folded before Flop (didn't bet)
Seat 6: Guslalala folded before Flop (didn't bet)



PokerStars Hand #222977146507:  Hold'em No Limit ($0.05/$0.10 USD) - 2021/01/23 18:13:42 ET
Table 'Jihlava III' 6-max Seat #3 is the button
Seat 1: 19991986830 ($24.60 in chips) 
Seat 2: Gavrik 1981 ($12.03 in chips) 
Seat 3: rioma10 ($10.19 in chips) 
Seat 4: jimeshka ($1.33 in chips) 
Seat 5: Jacub1987 ($11.27 in chips) 
Seat 6: Guslalala ($10.85 in chips) 
jimeshka: posts small blind $0.05
Jacub1987: posts big blind $0.10
*** HOLE CARDS ***
Guslalala: folds 
19991986830: folds 
Gavrik 1981: raises $0.20 to $0.30
rioma10: folds 
jimeshka: folds 
Jacub1987: folds 
Uncalled bet ($0.20) returned to Gavrik 1981
Gavrik 1981 collected $0.25 from pot
Gavrik 1981: doesn't show hand 
*** SUMMARY ***
Total pot $0.25 | Rake $0 
Seat 1: 19991986830 folded before Flop (didn't bet)
Seat 2: Gavrik 1981 collected ($0.25)
Seat 3: rioma10 (button) folded before Flop (didn't bet)
Seat 4: jimeshka (small blind) folded before Flop
Seat 5: Jacub1987 (big blind) folded before Flop
Seat 6: Guslalala folded before Flop (didn't bet)



PokerStars Hand #222977156588:  Hold'em No Limit ($0.05/$0.10 USD) - 2021/01/23 18:13:57 ET
Table 'Jihlava III' 6-max Seat #4 is the button
Seat 1: 19991986830 ($24.60 in chips) 
Seat 2: Gavrik 1981 ($12.18 in chips) 
Seat 3: rioma10 ($10.19 in chips) 
Seat 4: jimeshka ($1.28 in chips) 
Seat 5: Jacub1987 ($11.17 in chips) 
Seat 6: Guslalala ($10.85 in chips) 
Jacub1987: posts small blind $0.05
Guslalala: posts big blind $0.10
*** HOLE CARDS ***
19991986830: folds 
Gavrik 1981: folds 
rioma10: folds 
jimeshka: calls $0.10
Jacub1987: folds 
Guslalala: checks 
*** FLOP *** [9h 8h Ac]
Guslalala: checks 
jimeshka: checks 
*** TURN *** [9h 8h Ac] [9s]
Guslalala: checks 
jimeshka: bets $0.10
Guslalala: calls $0.10
*** RIVER *** [9h 8h Ac 9s] [6h]
Guslalala: checks 
jimeshka: checks 
*** SHOW DOWN ***
Guslalala: shows [8d 6c] (two pair, Nines and Eights)
jimeshka: mucks hand 
Guslalala collected $0.43 from pot
*** SUMMARY ***
Total pot $0.45 | Rake $0.02 
Board [9h 8h Ac 9s 6h]
Seat 1: 19991986830 folded before Flop (didn't bet)
Seat 2: Gavrik 1981 folded before Flop (didn't bet)
Seat 3: rioma10 folded before Flop (didn't bet)
Seat 4: jimeshka (button) mucked
Seat 5: Jacub1987 (small blind) folded before Flop
Seat 6: Guslalala (big blind) showed [8d 6c] and won ($0.43) with two pair, Nines and Eights



PokerStars Hand #222977175932:  Hold'em No Limit ($0.05/$0.10 USD) - 2021/01/23 18:14:25 ET
Table 'Jihlava III' 6-max Seat #5 is the button
Seat 1: 19991986830 ($24.60 in chips) 
Seat 2: Gavrik 1981 ($12.18 in chips) 
Seat 3: rioma10 ($10.19 in chips) 
Seat 4: jimeshka ($1.08 in chips) 
Seat 5: Jacub1987 ($11.12 in chips) 
Seat 6: Guslalala ($11.08 in chips) 
Guslalala: posts small blind $0.05
19991986830: posts big blind $0.10
*** HOLE CARDS ***
Gavrik 1981: folds 
rioma10: folds 
jimeshka: folds 
Jacub1987: raises $0.20 to $0.30
Guslalala: folds 
19991986830: calls $0.20
*** FLOP *** [5h 5d Qc]
19991986830: checks 
Jacub1987: bets $0.32
19991986830: calls $0.32
*** TURN *** [5h 5d Qc] [3c]
19991986830: checks 
Jacub1987: checks 
*** RIVER *** [5h 5d Qc 3c] [2d]
19991986830: checks 
Jacub1987: bets $0.64
19991986830: folds 
Uncalled bet ($0.64) returned to Jacub1987
Jacub1987 collected $1.23 from pot
*** SUMMARY ***
Total pot $1.29 | Rake $0.06 
Board [5h 5d Qc 3c 2d]
Seat 1: 19991986830 (big blind) folded on the River
Seat 2: Gavrik 1981 folded before Flop (didn't bet)
Seat 3: rioma10 folded before Flop (didn't bet)
Seat 4: jimeshka folded before Flop (didn't bet)
Seat 5: Jacub1987 (button) collected ($1.23)
Seat 6: Guslalala (small blind) folded before Flop



PokerStars Hand #222977210522:  Hold'em No Limit ($0.05/$0.10 USD) - 2021/01/23 18:15:16 ET
Table 'Jihlava III' 6-max Seat #6 is the button
Seat 1: 19991986830 ($23.98 in chips) 
Seat 2: Gavrik 1981 ($12.18 in chips) 
Seat 3: rioma10 ($10.19 in chips) 
Seat 4: jimeshka ($1.08 in chips) 
Seat 5: Jacub1987 ($11.73 in chips) 
Seat 6: Guslalala ($11.03 in chips) 
19991986830: posts small blind $0.05
Gavrik 1981: posts big blind $0.10
*** HOLE CARDS ***
rioma10: folds 
jimeshka: raises $0.10 to $0.20
Jacub1987: calls $0.20
Guslalala: folds 
19991986830: folds 
Gavrik 1981: calls $0.10
*** FLOP *** [8c Jh 3s]
Gavrik 1981: checks 
jimeshka: checks 
Jacub1987: bets $0.32
Gavrik 1981: folds 
jimeshka: calls $0.32
*** TURN *** [8c Jh 3s] [5c]
jimeshka: checks 
Jacub1987: bets $0.64
jimeshka: calls $0.56 and is all-in
Uncalled bet ($0.08) returned to Jacub1987
*** RIVER *** [8c Jh 3s 5c] [Qd]
*** SHOW DOWN ***
jimeshka: shows [Ad Kd] (high card Ace)
Jacub1987: shows [Tc Kc] (high card King)
jimeshka collected $2.30 from pot
*** SUMMARY ***
Total pot $2.41 | Rake $0.11 
Board [8c Jh 3s 5c Qd]
Seat 1: 19991986830 (small blind) folded before Flop
Seat 2: Gavrik 1981 (big blind) folded on the Flop
Seat 3: rioma10 folded before Flop (didn't bet)
Seat 4: jimeshka showed [Ad Kd] and won ($2.30) with high card Ace
Seat 5: Jacub1987 showed [Tc Kc] and lost with high card King
Seat 6: Guslalala (button) folded before Flop (didn't bet)



PokerStars Hand #222977243549:  Hold'em No Limit ($0.05/$0.10 USD) - 2021/01/23 18:16:04 ET
Table 'Jihlava III' 6-max Seat #1 is the button
Seat 1: 19991986830 ($23.93 in chips) 
Seat 2: Gavrik 1981 ($11.98 in chips) 
Seat 4: jimeshka ($2.30 in chips) 
Seat 5: Jacub1987 ($10.65 in chips) 
Seat 6: Guslalala ($11.03 in chips) 
Gavrik 1981: posts small blind $0.05
rioma10: is sitting out 
jimeshka: posts big blind $0.10
*** HOLE CARDS ***
rioma10 leaves the table
Jacub1987: raises $0.20 to $0.30
Guslalala: folds 
19991986830: folds 
Gavrik 1981: calls $0.25
jimeshka: calls $0.20
*** FLOP *** [4d 8c Kc]
Gavrik 1981: checks 
jimeshka: checks 
Jacub1987: checks 
*** TURN *** [4d 8c Kc] [Kh]
Gavrik 1981: bets $0.43
SD HAMMER joins the table at seat #3 
jimeshka: calls $0.43
Jacub1987: folds 
*** RIVER *** [4d 8c Kc Kh] [7h]
Gavrik 1981: bets $0.84
jimeshka: raises $0.73 to $1.57 and is all-in
Gavrik 1981: calls $0.73
*** SHOW DOWN ***
jimeshka: shows [Jd Kd] (three of a kind, Kings)
Gavrik 1981: shows [3c Ac] (a pair of Kings)
jimeshka collected $4.68 from pot
*** SUMMARY ***
Total pot $4.90 | Rake $0.22 
Board [4d 8c Kc Kh 7h]
Seat 1: 19991986830 (button) folded before Flop (didn't bet)
Seat 2: Gavrik 1981 (small blind) showed [3c Ac] and lost with a pair of Kings
Seat 4: jimeshka (big blind) showed [Jd Kd] and won ($4.68) with three of a kind, Kings
Seat 5: Jacub1987 folded on the Turn
Seat 6: Guslalala folded before Flop (didn't bet)



PokerStars Hand #222977290193:  Hold'em No Limit ($0.05/$0.10 USD) - 2021/01/23 18:17:13 ET
Table 'Jihlava III' 6-max Seat #2 is the button
Seat 1: 19991986830 ($23.93 in chips) 
Seat 2: Gavrik 1981 ($9.68 in chips) 
Seat 4: jimeshka ($4.68 in chips) 
Seat 5: Jacub1987 ($10.35 in chips) 
Seat 6: Guslalala ($11.03 in chips) 
jimeshka: posts small blind $0.05
Jacub1987: posts big blind $0.10
*** HOLE CARDS ***
Guslalala: folds 
19991986830: raises $0.10 to $0.20
Gavrik 1981: calls $0.20
jimeshka: raises $0.20 to $0.40
Jacub1987: folds 
19991986830: calls $0.20
Gavrik 1981: calls $0.20
*** FLOP *** [4h 2h 9d]
jimeshka: bets $0.62
19991986830: calls $0.62
Gavrik 1981: folds 
*** TURN *** [4h 2h 9d] [Jc]
jimeshka: bets $1.22
19991986830: calls $1.22
*** RIVER *** [4h 2h 9d Jc] [5d]
jimeshka: checks 
19991986830: checks 
*** SHOW DOWN ***
jimeshka: shows [Ac Qc] (high card Ace)
19991986830: mucks hand 
jimeshka collected $4.76 from pot
*** SUMMARY ***
Total pot $4.98 | Rake $0.22 
Board [4h 2h 9d Jc 5d]
Seat 1: 19991986830 mucked
Seat 2: Gavrik 1981 (button) folded on the Flop
Seat 4: jimeshka (small blind) showed [Ac Qc] and won ($4.76) with high card Ace
Seat 5: Jacub1987 (big blind) folded before Flop
Seat 6: Guslalala folded before Flop (didn't bet)



PokerStars Hand #222977331316:  Hold'em No Limit ($0.05/$0.10 USD) - 2021/01/23 18:18:14 ET
Table 'Jihlava III' 6-max Seat #4 is the button
Seat 1: 19991986830 ($21.69 in chips) 
Seat 2: Gavrik 1981 ($9.28 in chips) 
Seat 4: jimeshka ($7.20 in chips) 
Seat 5: Jacub1987 ($10.25 in chips) 
Seat 6: Guslalala ($11.03 in chips) 
Jacub1987: posts small blind $0.05
Guslalala: posts big blind $0.10
SD HAMMER: sits out 
*** HOLE CARDS ***
19991986830: raises $0.10 to $0.20
Gavrik 1981: calls $0.20
jimeshka: calls $0.20
Jacub1987: raises $1 to $1.20
Guslalala: folds 
19991986830: folds 
Gavrik 1981: calls $1
jimeshka: folds 
*** FLOP *** [7d Th 9h]
Jacub1987: bets $1.44
Gavrik 1981: calls $1.44
*** TURN *** [7d Th 9h] [5s]
Jacub1987: bets $2.21
Gavrik 1981: calls $2.21
*** RIVER *** [7d Th 9h 5s] [4s]
Jacub1987: checks 
Gavrik 1981: bets $4.43 and is all-in
Jacub1987: calls $4.43
*** SHOW DOWN ***
Gavrik 1981: shows [Js 7s] (a pair of Sevens)
Jacub1987: shows [Ah Ts] (a pair of Tens)
Jacub1987 collected $18.20 from pot
*** SUMMARY ***
Total pot $19.06 | Rake $0.86 
Board [7d Th 9h 5s 4s]
Seat 1: 19991986830 folded before Flop
Seat 2: Gavrik 1981 showed [Js 7s] and lost with a pair of Sevens
Seat 4: jimeshka (button) folded before Flop
Seat 5: Jacub1987 (small blind) showed [Ah Ts] and won ($18.20) with a pair of Tens
Seat 6: Guslalala (big blind) folded before Flop



PokerStars Hand #222977362023:  Hold'em No Limit ($0.05/$0.10 USD) - 2021/01/23 18:19:00 ET
Table 'Jihlava III' 6-max Seat #5 is the button
Seat 1: 19991986830 ($21.49 in chips) 
Seat 4: jimeshka ($7 in chips) 
Seat 5: Jacub1987 ($19.17 in chips) 
Seat 6: Guslalala ($10.93 in chips) 
Guslalala: posts small blind $0.05
19991986830: posts big blind $0.10
SD HAMMER: sits out 
*** HOLE CARDS ***
jimeshka: calls $0.10
Jacub1987: raises $0.35 to $0.45
Guslalala: folds 
19991986830: folds 
Gavrik 1981 leaves the table
jimeshka: calls $0.35
*** FLOP *** [4c 5d 6d]
jimeshka: checks 
Jacub1987: bets $0.52
jimeshka: calls $0.52
*** TURN *** [4c 5d 6d] [9d]
jimeshka: checks 
Jacub1987: bets $0.80
jimeshka: calls $0.80
*** RIVER *** [4c 5d 6d 9d] [As]
marcin116 joins the table at seat #2 
jimeshka: checks 
Jacub1987: checks 
*** SHOW DOWN ***
jimeshka: shows [Kc Qd] (high card Ace)
Jacub1987: shows [5h Ah] (two pair, Aces and Fives)
Jacub1987 collected $3.52 from pot
*** SUMMARY ***
Total pot $3.69 | Rake $0.17 
Board [4c 5d 6d 9d As]
Seat 1: 19991986830 (big blind) folded before Flop
Seat 4: jimeshka showed [Kc Qd] and lost with high card Ace
Seat 5: Jacub1987 (button) showed [5h Ah] and won ($3.52) with two pair, Aces and Fives
Seat 6: Guslalala (small blind) folded before Flop



PokerStars Hand #222977384057:  Hold'em No Limit ($0.05/$0.10 USD) - 2021/01/23 18:19:33 ET
Table 'Jihlava III' 6-max Seat #6 is the button
Seat 1: 19991986830 ($21.39 in chips) 
Seat 2: marcin116 ($10 in chips) 
Seat 4: jimeshka ($5.23 in chips) 
Seat 5: Jacub1987 ($20.92 in chips) 
Seat 6: Guslalala ($10.88 in chips) 
19991986830: posts small blind $0.05
marcin116: posts big blind $0.10
SD HAMMER: sits out 
*** HOLE CARDS ***
jimeshka: raises $0.10 to $0.20
Jacub1987: folds 
Guslalala: folds 
19991986830: calls $0.15
marcin116: folds 
*** FLOP *** [3h 8s 4s]
19991986830: checks 
jimeshka: checks 
*** TURN *** [3h 8s 4s] [Kc]
19991986830: checks 
jimeshka: bets $0.20
19991986830: folds 
Uncalled bet ($0.20) returned to jimeshka
jimeshka collected $0.48 from pot
jimeshka: doesn't show hand 
*** SUMMARY ***
Total pot $0.50 | Rake $0.02 
Board [3h 8s 4s Kc]
Seat 1: 19991986830 (small blind) folded on the Turn
Seat 2: marcin116 (big blind) folded before Flop
Seat 4: jimeshka collected ($0.48)
Seat 5: Jacub1987 folded before Flop (didn't bet)
Seat 6: Guslalala (button) folded before Flop (didn't bet)



PokerStars Hand #222977404771:  Hold'em No Limit ($0.05/$0.10 USD) - 2021/01/23 18:20:04 ET
Table 'Jihlava III' 6-max Seat #1 is the button
Seat 1: 19991986830 ($21.19 in chips) 
Seat 2: marcin116 ($10 in chips) 
Seat 3: SD HAMMER ($10 in chips) 
Seat 4: jimeshka ($5.51 in chips) 
Seat 5: Jacub1987 ($20.92 in chips) 
Seat 6: Guslalala ($10.88 in chips) 
marcin116: posts small blind $0.05
SD HAMMER: posts big blind $0.10
*** HOLE CARDS ***
jimeshka: calls $0.10
Jacub1987: folds 
Guslalala: folds 
19991986830: calls $0.10
marcin116: raises $0.50 to $0.60
SD HAMMER: calls $0.50
jimeshka: folds 
19991986830: folds 
*** FLOP *** [2c 8c 8h]
marcin116: bets $1.01
SD HAMMER: folds 
Uncalled bet ($1.01) returned to marcin116
marcin116 collected $1.34 from pot
marcin116: doesn't show hand 
*** SUMMARY ***
Total pot $1.40 | Rake $0.06 
Board [2c 8c 8h]
Seat 1: 19991986830 (button) folded before Flop
Seat 2: marcin116 (small blind) collected ($1.34)
Seat 3: SD HAMMER (big blind) folded on the Flop
Seat 4: jimeshka folded before Flop
Seat 5: Jacub1987 folded before Flop (didn't bet)
Seat 6: Guslalala folded before Flop (didn't bet)



PokerStars Hand #222977424824:  Hold'em No Limit ($0.05/$0.10 USD) - 2021/01/23 18:20:34 ET
Table 'Jihlava III' 6-max Seat #2 is the button
Seat 1: 19991986830 ($21.09 in chips) 
Seat 2: marcin116 ($10.74 in chips) 
Seat 3: SD HAMMER ($10 in chips) 
Seat 4: jimeshka ($5.41 in chips) 
Seat 5: Jacub1987 ($20.92 in chips) 
Seat 6: Guslalala ($10.88 in chips) 
SD HAMMER: posts small blind $0.05
jimeshka: posts big blind $0.10
*** HOLE CARDS ***
Jacub1987: raises $0.15 to $0.25
Guslalala: folds 
19991986830: calls $0.25
marcin116: folds 
SD HAMMER: raises $1.15 to $1.40
jimeshka: folds 
Jacub1987: folds 
19991986830: folds 
Uncalled bet ($1.15) returned to SD HAMMER
SD HAMMER collected $0.85 from pot
SD HAMMER: doesn't show hand 
*** SUMMARY ***
Total pot $0.85 | Rake $0 
Seat 1: 19991986830 folded before Flop
Seat 2: marcin116 (button) folded before Flop (didn't bet)
Seat 3: SD HAMMER (small blind) collected ($0.85)
Seat 4: jimeshka (big blind) folded before Flop
Seat 5: Jacub1987 folded before Flop
Seat 6: Guslalala folded before Flop (didn't bet)



PokerStars Hand #222977443037:  Hold'em No Limit ($0.05/$0.10 USD) - 2021/01/23 18:21:01 ET
Table 'Jihlava III' 6-max Seat #3 is the button
Seat 1: 19991986830 ($20.84 in chips) 
Seat 2: marcin116 ($10.74 in chips) 
Seat 3: SD HAMMER ($10.60 in chips) 
Seat 4: jimeshka ($5.31 in chips) 
Seat 6: Guslalala ($10.88 in chips) 
jimeshka: posts small blind $0.05
Jacub1987: is sitting out 
Jacub1987 leaves the table
Guslalala: posts big blind $0.10
*** HOLE CARDS ***
slucasb joins the table at seat #5 
19991986830: raises $0.10 to $0.20
marcin116: folds 
SD HAMMER: calls $0.20
jimeshka: folds 
Guslalala: raises $1.10 to $1.30
19991986830: folds 
SD HAMMER: calls $1.10
*** FLOP *** [Qh 8h Ad]
Guslalala: bets $0.90
SD HAMMER: calls $0.90
*** TURN *** [Qh 8h Ad] [9c]
Guslalala: checks 
SD HAMMER: checks 
*** RIVER *** [Qh 8h Ad 9c] [5c]
Guslalala: bets $2.55
SD HAMMER: calls $2.55
*** SHOW DOWN ***
Guslalala: shows [As Ac] (three of a kind, Aces)
SD HAMMER: mucks hand 
Guslalala collected $9.31 from pot
*** SUMMARY ***
Total pot $9.75 | Rake $0.44 
Board [Qh 8h Ad 9c 5c]
Seat 1: 19991986830 folded before Flop
Seat 2: marcin116 folded before Flop (didn't bet)
Seat 3: SD HAMMER (button) mucked
Seat 4: jimeshka (small blind) folded before Flop
Seat 6: Guslalala (big blind) showed [As Ac] and won ($9.31) with three of a kind, Aces



PokerStars Hand #222977487849:  Hold'em No Limit ($0.05/$0.10 USD) - 2021/01/23 18:22:09 ET
Table 'Jihlava III' 6-max Seat #4 is the button
Seat 1: 19991986830 ($20.64 in chips) 
Seat 2: marcin116 ($10.74 in chips) 
Seat 3: SD HAMMER ($10 in chips) 
Seat 4: jimeshka ($5.26 in chips) 
Seat 6: Guslalala ($15.44 in chips) 
Guslalala: posts small blind $0.05
19991986830: posts big blind $0.10
*** HOLE CARDS ***
marcin116: folds 
SD HAMMER: folds 
jimeshka: calls $0.10
Guslalala: folds 
19991986830: checks 
*** FLOP *** [4d 6d 5s]
19991986830: checks 
jimeshka: bets $0.10
19991986830: calls $0.10
*** TURN *** [4d 6d 5s] [Qs]
19991986830: checks 
jimeshka: bets $0.22
19991986830: calls $0.22
*** RIVER *** [4d 6d 5s Qs] [8d]
19991986830: checks 
jimeshka: checks 
*** SHOW DOWN ***
19991986830: shows [9c 4h] (a pair of Fours)
jimeshka: mucks hand 
19991986830 collected $0.85 from pot
*** SUMMARY ***
Total pot $0.89 | Rake $0.04 
Board [4d 6d 5s Qs 8d]
Seat 1: 19991986830 (big blind) showed [9c 4h] and won ($0.85) with a pair of Fours
Seat 2: marcin116 folded before Flop (didn't bet)
Seat 3: SD HAMMER folded before Flop (didn't bet)
Seat 4: jimeshka (button) mucked
Seat 6: Guslalala (small blind) folded before Flop



PokerStars Hand #222977510382:  Hold'em No Limit ($0.05/$0.10 USD) - 2021/01/23 18:22:43 ET
Table 'Jihlava III' 6-max Seat #6 is the button
Seat 1: 19991986830 ($21.07 in chips) 
Seat 2: marcin116 ($10.74 in chips) 
Seat 3: SD HAMMER ($10 in chips) 
Seat 4: jimeshka ($4.84 in chips) 
Seat 6: Guslalala ($15.39 in chips) 
19991986830: posts small blind $0.05
marcin116: posts big blind $0.10
slucasb: sits out 
*** HOLE CARDS ***
SD HAMMER: folds 
jimeshka: folds 
Guslalala: folds 
19991986830: calls $0.05
marcin116: raises $0.25 to $0.35
19991986830: calls $0.25
*** FLOP *** [Th Qc 7h]
19991986830: checks 
marcin116: checks 
*** TURN *** [Th Qc 7h] [4d]
19991986830: checks 
marcin116: checks 
*** RIVER *** [Th Qc 7h 4d] [2s]
19991986830: bets $0.20
marcin116: folds 
Uncalled bet ($0.20) returned to 19991986830
19991986830 collected $0.67 from pot
*** SUMMARY ***
Total pot $0.70 | Rake $0.03 
Board [Th Qc 7h 4d 2s]
Seat 1: 19991986830 (small blind) collected ($0.67)
Seat 2: marcin116 (big blind) folded on the River
Seat 3: SD HAMMER folded before Flop (didn't bet)
Seat 4: jimeshka folded before Flop (didn't bet)
Seat 6: Guslalala (button) folded before Flop (didn't bet)



PokerStars Hand #222977543918:  Hold'em No Limit ($0.05/$0.10 USD) - 2021/01/23 18:23:21 ET
Table 'Jihlava III' 6-max Seat #1 is the button
Seat 1: 19991986830 ($21.39 in chips) 
Seat 2: marcin116 ($10.39 in chips) 
Seat 3: SD HAMMER ($10 in chips) 
Seat 4: jimeshka ($4.84 in chips) 
Seat 6: Guslalala ($15.39 in chips) 
marcin116: posts small blind $0.05
SD HAMMER: posts big blind $0.10
slucasb: sits out 
*** HOLE CARDS ***
jimeshka: folds 
Guslalala: folds 
19991986830: folds 
marcin116: folds 
Uncalled bet ($0.05) returned to SD HAMMER
SD HAMMER collected $0.10 from pot
SD HAMMER: doesn't show hand 
*** SUMMARY ***
Total pot $0.10 | Rake $0 
Seat 1: 19991986830 (button) folded before Flop (didn't bet)
Seat 2: marcin116 (small blind) folded before Flop
Seat 3: SD HAMMER (big blind) collected ($0.10)
Seat 4: jimeshka folded before Flop (didn't bet)
Seat 6: Guslalala folded before Flop (didn't bet)



PokerStars Hand #222977548474:  Hold'em No Limit ($0.05/$0.10 USD) - 2021/01/23 18:23:28 ET
Table 'Jihlava III' 6-max Seat #2 is the button
Seat 1: 19991986830 ($21.39 in chips) 
Seat 2: marcin116 ($10.34 in chips) 
Seat 3: SD HAMMER ($10.05 in chips) 
Seat 4: jimeshka ($4.84 in chips) 
Seat 6: Guslalala ($15.39 in chips) 
SD HAMMER: posts small blind $0.05
jimeshka: posts big blind $0.10
slucasb: sits out 
*** HOLE CARDS ***
Guslalala: folds 
19991986830: raises $0.10 to $0.20
marcin116: calls $0.20
SD HAMMER: folds 
jimeshka: calls $0.10
*** FLOP *** [5h 2c 6h]
jimeshka: checks 
19991986830: checks 
marcin116: bets $0.46
jimeshka: calls $0.46
19991986830: calls $0.46
*** TURN *** [5h 2c 6h] [Jc]
jimeshka: checks 
19991986830: checks 
marcin116: checks 
*** RIVER *** [5h 2c 6h Jc] [Th]
jimeshka: checks 
19991986830: checks 
marcin116: checks 
*** SHOW DOWN ***
jimeshka: shows [4c 7s] (high card Jack)
19991986830: shows [Ac Kc] (high card Ace)
marcin116: shows [4h 4s] (a pair of Fours)
marcin116 collected $1.94 from pot
*** SUMMARY ***
Total pot $2.03 | Rake $0.09 
Board [5h 2c 6h Jc Th]
Seat 1: 19991986830 showed [Ac Kc] and lost with high card Ace
Seat 2: marcin116 (button) showed [4h 4s] and won ($1.94) with a pair of Fours
Seat 3: SD HAMMER (small blind) folded before Flop
Seat 4: jimeshka (big blind) showed [4c 7s] and lost with high card Jack
Seat 6: Guslalala folded before Flop (didn't bet)



PokerStars Hand #222977576958:  Hold'em No Limit ($0.05/$0.10 USD) - 2021/01/23 18:24:11 ET
Table 'Jihlava III' 6-max Seat #3 is the button
Seat 1: 19991986830 ($20.73 in chips) 
Seat 2: marcin116 ($11.62 in chips) 
Seat 3: SD HAMMER ($10 in chips) 
Seat 4: jimeshka ($4.18 in chips) 
Seat 5: slucasb ($10 in chips) 
Seat 6: Guslalala ($15.39 in chips) 
jimeshka: posts small blind $0.05
slucasb: posts big blind $0.10
*** HOLE CARDS ***
Guslalala: folds 
19991986830: folds 
marcin116: folds 
SD HAMMER: folds 
jimeshka: calls $0.05
slucasb: checks 
*** FLOP *** [8c 5s 4h]
jimeshka: checks 
slucasb: checks 
*** TURN *** [8c 5s 4h] [7c]
jimeshka: bets $0.10
slucasb: calls $0.10
*** RIVER *** [8c 5s 4h 7c] [Jc]
jimeshka: bets $0.38
slucasb: folds 
Uncalled bet ($0.38) returned to jimeshka
jimeshka collected $0.38 from pot
jimeshka: doesn't show hand 
*** SUMMARY ***
Total pot $0.40 | Rake $0.02 
Board [8c 5s 4h 7c Jc]
Seat 1: 19991986830 folded before Flop (didn't bet)
Seat 2: marcin116 folded before Flop (didn't bet)
Seat 3: SD HAMMER (button) folded before Flop (didn't bet)
Seat 4: jimeshka (small blind) collected ($0.38)
Seat 5: slucasb (big blind) folded on the River
Seat 6: Guslalala folded before Flop (didn't bet)



PokerStars Hand #222977595707:  Hold'em No Limit ($0.05/$0.10 USD) - 2021/01/23 18:24:40 ET
Table 'Jihlava III' 6-max Seat #4 is the button
Seat 1: 19991986830 ($20.73 in chips) 
Seat 2: marcin116 ($11.62 in chips) 
Seat 3: SD HAMMER ($10 in chips) 
Seat 4: jimeshka ($4.36 in chips) 
Seat 5: slucasb ($10 in chips) 
Seat 6: Guslalala ($15.39 in chips) 
slucasb: posts small blind $0.05
Guslalala: posts big blind $0.10
*** HOLE CARDS ***
19991986830: raises $0.10 to $0.20
marcin116: folds 
SD HAMMER: folds 
jimeshka: calls $0.20
slucasb: folds 
Guslalala: calls $0.10
*** FLOP *** [Kh 9h 3s]
Guslalala: checks 
19991986830: checks 
jimeshka: checks 
*** TURN *** [Kh 9h 3s] [9d]
Guslalala: checks 
19991986830: checks 
jimeshka: checks 
*** RIVER *** [Kh 9h 3s 9d] [6s]
Guslalala: checks 
19991986830: bets $0.20
jimeshka: calls $0.20
Guslalala: folds 
*** SHOW DOWN ***
19991986830: shows [Qc Qs] (two pair, Queens and Nines)
jimeshka: mucks hand 
19991986830 collected $1 from pot
*** SUMMARY ***
Total pot $1.05 | Rake $0.05 
Board [Kh 9h 3s 9d 6s]
Seat 1: 19991986830 showed [Qc Qs] and won ($1) with two pair, Queens and Nines
Seat 2: marcin116 folded before Flop (didn't bet)
Seat 3: SD HAMMER folded before Flop (didn't bet)
Seat 4: jimeshka (button) mucked
Seat 5: slucasb (small blind) folded before Flop
Seat 6: Guslalala (big blind) folded on the River



PokerStars Hand #222977618913:  Hold'em No Limit ($0.05/$0.10 USD) - 2021/01/23 18:25:15 ET
Table 'Jihlava III' 6-max Seat #5 is the button
Seat 1: 19991986830 ($21.33 in chips) 
Seat 2: marcin116 ($11.62 in chips) 
Seat 3: SD HAMMER ($10 in chips) 
Seat 4: jimeshka ($3.96 in chips) 
Seat 5: slucasb ($9.95 in chips) 
Seat 6: Guslalala ($15.19 in chips) 
Guslalala: posts small blind $0.05
19991986830: posts big blind $0.10
*** HOLE CARDS ***
marcin116: folds 
SD HAMMER: folds 
jimeshka: raises $0.30 to $0.40
slucasb: folds 
Guslalala: folds 
19991986830: calls $0.30
*** FLOP *** [Js 8c Qs]
19991986830: checks 
jimeshka: bets $0.81
19991986830: calls $0.81
*** TURN *** [Js 8c Qs] [Kd]
19991986830: checks 
jimeshka: bets $1.18
19991986830: calls $1.18
*** RIVER *** [Js 8c Qs Kd] [8d]
19991986830: checks 
jimeshka: bets $1.57 and is all-in
19991986830: folds 
Uncalled bet ($1.57) returned to jimeshka
jimeshka collected $4.61 from pot
jimeshka: doesn't show hand 
*** SUMMARY ***
Total pot $4.83 | Rake $0.22 
Board [Js 8c Qs Kd 8d]
Seat 1: 19991986830 (big blind) folded on the River
Seat 2: marcin116 folded before Flop (didn't bet)
Seat 3: SD HAMMER folded before Flop (didn't bet)
Seat 4: jimeshka collected ($4.61)
Seat 5: slucasb (button) folded before Flop (didn't bet)
Seat 6: Guslalala (small blind) folded before Flop



PokerStars Hand #222977649075:  Hold'em No Limit ($0.05/$0.10 USD) - 2021/01/23 18:26:01 ET
Table 'Jihlava III' 6-max Seat #6 is the button
Seat 1: 19991986830 ($18.94 in chips) 
Seat 2: marcin116 ($11.62 in chips) 
Seat 3: SD HAMMER ($10 in chips) 
Seat 4: jimeshka ($6.18 in chips) 
Seat 5: slucasb ($9.95 in chips) 
Seat 6: Guslalala ($15.14 in chips) 
19991986830: posts small blind $0.05
marcin116: posts big blind $0.10
*** HOLE CARDS ***
SD HAMMER: raises $0.20 to $0.30
jimeshka: calls $0.30
slucasb: folds 
Guslalala: folds 
19991986830: calls $0.25
marcin116: folds 
*** FLOP *** [Ks Kc 2s]
19991986830: checks 
SD HAMMER: bets $0.96
jimeshka: folds 
19991986830: folds 
Uncalled bet ($0.96) returned to SD HAMMER
SD HAMMER collected $0.96 from pot
SD HAMMER: doesn't show hand 
*** SUMMARY ***
Total pot $1 | Rake $0.04 
Board [Ks Kc 2s]
Seat 1: 19991986830 (small blind) folded on the Flop
Seat 2: marcin116 (big blind) folded before Flop
Seat 3: SD HAMMER collected ($0.96)
Seat 4: jimeshka folded on the Flop
Seat 5: slucasb folded before Flop (didn't bet)
Seat 6: Guslalala (button) folded before Flop (didn't bet)



PokerStars Hand #222977666467:  Hold'em No Limit ($0.05/$0.10 USD) - 2021/01/23 18:26:28 ET
Table 'Jihlava III' 6-max Seat #1 is the button
Seat 1: 19991986830 ($18.64 in chips) 
Seat 2: marcin116 ($11.52 in chips) 
Seat 3: SD HAMMER ($10.66 in chips) 
Seat 4: jimeshka ($5.88 in chips) 
Seat 5: slucasb ($9.95 in chips) 
Seat 6: Guslalala ($15.14 in chips) 
marcin116: posts small blind $0.05
SD HAMMER: posts big blind $0.10
*** HOLE CARDS ***
jimeshka: folds 
slucasb: folds 
Guslalala: folds 
19991986830: raises $0.20 to $0.30
marcin116: folds 
SD HAMMER: folds 
Uncalled bet ($0.20) returned to 19991986830
19991986830 collected $0.25 from pot
*** SUMMARY ***
Total pot $0.25 | Rake $0 
Seat 1: 19991986830 (button) collected ($0.25)
Seat 2: marcin116 (small blind) folded before Flop
Seat 3: SD HAMMER (big blind) folded before Flop
Seat 4: jimeshka folded before Flop (didn't bet)
Seat 5: slucasb folded before Flop (didn't bet)
Seat 6: Guslalala folded before Flop (didn't bet)



PokerStars Hand #222977680509:  Hold'em No Limit ($0.05/$0.10 USD) - 2021/01/23 18:26:50 ET
Table 'Jihlava III' 6-max Seat #2 is the button
Seat 1: 19991986830 ($18.79 in chips) 
Seat 2: marcin116 ($11.47 in chips) 
Seat 3: SD HAMMER ($10.56 in chips) 
Seat 4: jimeshka ($5.88 in chips) 
Seat 5: slucasb ($9.95 in chips) 
Seat 6: Guslalala ($15.14 in chips) 
SD HAMMER: posts small blind $0.05
jimeshka: posts big blind $0.10
*** HOLE CARDS ***
slucasb: raises $0.16 to $0.26
Guslalala: folds 
19991986830: calls $0.26
marcin116: folds 
SD HAMMER: calls $0.21
jimeshka: folds 
*** FLOP *** [7h Ks 5d]
SD HAMMER: checks 
slucasb: checks 
19991986830: checks 
*** TURN *** [7h Ks 5d] [8d]
SD HAMMER: checks 
slucasb: bets $0.50
19991986830: calls $0.50
SD HAMMER: calls $0.50
*** RIVER *** [7h Ks 5d 8d] [5s]
SD HAMMER: checks 
slucasb: checks 
19991986830: checks 
*** SHOW DOWN ***
SD HAMMER: shows [7d 4d] (two pair, Sevens and Fives)
slucasb: shows [8s Qs] (two pair, Eights and Fives)
19991986830: shows [Th Tc] (two pair, Tens and Fives)
19991986830 collected $2.27 from pot
*** SUMMARY ***
Total pot $2.38 | Rake $0.11 
Board [7h Ks 5d 8d 5s]
Seat 1: 19991986830 showed [Th Tc] and won ($2.27) with two pair, Tens and Fives
Seat 2: marcin116 (button) folded before Flop (didn't bet)
Seat 3: SD HAMMER (small blind) showed [7d 4d] and lost with two pair, Sevens and Fives
Seat 4: jimeshka (big blind) folded before Flop
Seat 5: slucasb showed [8s Qs] and lost with two pair, Eights and Fives
Seat 6: Guslalala folded before Flop (didn't bet)



PokerStars Hand #222977710592:  Hold'em No Limit ($0.05/$0.10 USD) - 2021/01/23 18:27:35 ET
Table 'Jihlava III' 6-max Seat #3 is the button
Seat 1: 19991986830 ($20.30 in chips) 
Seat 2: marcin116 ($11.47 in chips) 
Seat 3: SD HAMMER ($10 in chips) 
Seat 4: jimeshka ($5.78 in chips) 
Seat 5: slucasb ($10 in chips) 
Seat 6: Guslalala ($15.14 in chips) 
jimeshka: posts small blind $0.05
slucasb: posts big blind $0.10
*** HOLE CARDS ***
Guslalala: raises $0.20 to $0.30
19991986830: calls $0.30
marcin116: folds 
SD HAMMER: raises $1.10 to $1.40
jimeshka: folds 
slucasb: folds 
Guslalala: folds 
19991986830: calls $1.10
*** FLOP *** [2s 7s Jh]
19991986830: checks 
SD HAMMER: bets $1.55
19991986830: calls $1.55
*** TURN *** [2s 7s Jh] [Qs]
19991986830: checks 
SD HAMMER: checks 
*** RIVER *** [2s 7s Jh Qs] [3h]
19991986830: bets $1.60
SD HAMMER: folds 
Uncalled bet ($1.60) returned to 19991986830
19991986830 collected $6.06 from pot
*** SUMMARY ***
Total pot $6.35 | Rake $0.29 
Board [2s 7s Jh Qs 3h]
Seat 1: 19991986830 collected ($6.06)
Seat 2: marcin116 folded before Flop (didn't bet)
Seat 3: SD HAMMER (button) folded on the River
Seat 4: jimeshka (small blind) folded before Flop
Seat 5: slucasb (big blind) folded before Flop
Seat 6: Guslalala folded before Flop



PokerStars Hand #222977754676:  Hold'em No Limit ($0.05/$0.10 USD) - 2021/01/23 18:28:43 ET
Table 'Jihlava III' 6-max Seat #4 is the button
Seat 1: 19991986830 ($23.41 in chips) 
Seat 2: marcin116 ($11.47 in chips) 
Seat 3: SD HAMMER ($10 in chips) 
Seat 4: jimeshka ($5.73 in chips) 
Seat 5: slucasb ($9.90 in chips) 
slucasb: posts small blind $0.05
Guslalala: is sitting out 
19991986830: posts big blind $0.10
*** HOLE CARDS ***
Guslalala leaves the table
marcin116: folds 
alexyo111 joins the table at seat #6 
SD HAMMER: folds 
jimeshka: folds 
slucasb: folds 
Uncalled bet ($0.05) returned to 19991986830
19991986830 collected $0.10 from pot
*** SUMMARY ***
Total pot $0.10 | Rake $0 
Seat 1: 19991986830 (big blind) collected ($0.10)
Seat 2: marcin116 folded before Flop (didn't bet)
Seat 3: SD HAMMER folded before Flop (didn't bet)
Seat 4: jimeshka (button) folded before Flop (didn't bet)
Seat 5: slucasb (small blind) folded before Flop



PokerStars Hand #222977764186:  Hold'em No Limit ($0.05/$0.10 USD) - 2021/01/23 18:28:57 ET
Table 'Jihlava III' 6-max Seat #5 is the button
Seat 1: 19991986830 ($23.46 in chips) 
Seat 2: marcin116 ($11.47 in chips) 
Seat 3: SD HAMMER ($10 in chips) 
Seat 4: jimeshka ($5.73 in chips) 
Seat 5: slucasb ($10 in chips) 
19991986830: posts small blind $0.05
marcin116: posts big blind $0.10
*** HOLE CARDS ***
SD HAMMER: folds 
jimeshka: folds 
slucasb: folds 
19991986830: raises $0.10 to $0.20
marcin116: folds 
Uncalled bet ($0.10) returned to 19991986830
19991986830 collected $0.20 from pot
*** SUMMARY ***
Total pot $0.20 | Rake $0 
Seat 1: 19991986830 (small blind) collected ($0.20)
Seat 2: marcin116 (big blind) folded before Flop
Seat 3: SD HAMMER folded before Flop (didn't bet)
Seat 4: jimeshka folded before Flop (didn't bet)
Seat 5: slucasb (button) folded before Flop (didn't bet)



PokerStars Hand #222977773734:  Hold'em No Limit ($0.05/$0.10 USD) - 2021/01/23 18:29:12 ET
Table 'Jihlava III' 6-max Seat #1 is the button
Seat 1: 19991986830 ($23.56 in chips) 
Seat 2: marcin116 ($11.37 in chips) 
Seat 3: SD HAMMER ($10 in chips) 
Seat 4: jimeshka ($5.73 in chips) 
Seat 5: slucasb ($10 in chips) 
Seat 6: alexyo111 ($4 in chips) 
marcin116: posts small blind $0.05
SD HAMMER: posts big blind $0.10
alexyo111: posts big blind $0.10
*** HOLE CARDS ***
jimeshka: folds 
slucasb: folds 
alexyo111: checks 
19991986830: raises $0.20 to $0.30
marcin116: folds 
SD HAMMER: folds 
alexyo111: calls $0.20
*** FLOP *** [3h 4h 4d]
alexyo111: checks 
19991986830: checks 
*** TURN *** [3h 4h 4d] [Qh]
alexyo111: checks 
19991986830: checks 
*** RIVER *** [3h 4h 4d Qh] [3s]
alexyo111: checks 
19991986830: checks 
*** SHOW DOWN ***
alexyo111: shows [9d 8c] (two pair, Fours and Threes)
19991986830: shows [9s Td] (two pair, Fours and Threes)
alexyo111 collected $0.36 from pot
19991986830 collected $0.36 from pot
*** SUMMARY ***
Total pot $0.75 | Rake $0.03 
Board [3h 4h 4d Qh 3s]
Seat 1: 19991986830 (button) showed [9s Td] and won ($0.36) with two pair, Fours and Threes
Seat 2: marcin116 (small blind) folded before Flop
Seat 3: SD HAMMER (big blind) folded before Flop
Seat 4: jimeshka folded before Flop (didn't bet)
Seat 5: slucasb folded before Flop (didn't bet)
Seat 6: alexyo111 showed [9d 8c] and won ($0.36) with two pair, Fours and Threes



PokerStars Hand #222977794914:  Hold'em No Limit ($0.05/$0.10 USD) - 2021/01/23 18:29:45 ET
Table 'Jihlava III' 6-max Seat #2 is the button
Seat 1: 19991986830 ($23.62 in chips) 
Seat 2: marcin116 ($11.32 in chips) 
Seat 3: SD HAMMER ($10 in chips) 
Seat 4: jimeshka ($5.73 in chips) 
Seat 5: slucasb ($10 in chips) 
Seat 6: alexyo111 ($4.06 in chips) 
SD HAMMER: posts small blind $0.05
jimeshka: posts big blind $0.10
*** HOLE CARDS ***
slucasb: folds 
alexyo111: calls $0.10
19991986830: raises $0.30 to $0.40
marcin116: folds 
SD HAMMER: calls $0.35
jimeshka: folds 
alexyo111: folds 
*** FLOP *** [Jd 9c 8c]
SD HAMMER: checks 
19991986830: bets $0.48
SD HAMMER: folds 
Uncalled bet ($0.48) returned to 19991986830
19991986830 collected $0.96 from pot
*** SUMMARY ***
Total pot $1 | Rake $0.04 
Board [Jd 9c 8c]
Seat 1: 19991986830 collected ($0.96)
Seat 2: marcin116 (button) folded before Flop (didn't bet)
Seat 3: SD HAMMER (small blind) folded on the Flop
Seat 4: jimeshka (big blind) folded before Flop
Seat 5: slucasb folded before Flop (didn't bet)
Seat 6: alexyo111 folded before Flop



PokerStars Hand #222977810992:  Hold'em No Limit ($0.05/$0.10 USD) - 2021/01/23 18:30:10 ET
Table 'Jihlava III' 6-max Seat #3 is the button
Seat 1: 19991986830 ($24.18 in chips) 
Seat 2: marcin116 ($11.32 in chips) 
Seat 3: SD HAMMER ($10 in chips) 
Seat 4: jimeshka ($5.63 in chips) 
Seat 5: slucasb ($10 in chips) 
Seat 6: alexyo111 ($3.96 in chips) 
jimeshka: posts small blind $0.05
slucasb: posts big blind $0.10
*** HOLE CARDS ***
alexyo111: calls $0.10
19991986830: folds 
marcin116: raises $0.35 to $0.45
SD HAMMER: folds 
jimeshka: folds 
slucasb: folds 
alexyo111: calls $0.35
*** FLOP *** [7s 2c Ts]
alexyo111: checks 
marcin116: checks 
*** TURN *** [7s 2c Ts] [8s]
alexyo111: checks 
marcin116: checks 
*** RIVER *** [7s 2c Ts 8s] [6d]
alexyo111: checks 
marcin116: checks 
*** SHOW DOWN ***
alexyo111: shows [4h 6h] (a pair of Sixes)
marcin116: mucks hand 
alexyo111 collected $1 from pot
*** SUMMARY ***
Total pot $1.05 | Rake $0.05 
Board [7s 2c Ts 8s 6d]
Seat 1: 19991986830 folded before Flop (didn't bet)
Seat 2: marcin116 mucked
Seat 3: SD HAMMER (button) folded before Flop (didn't bet)
Seat 4: jimeshka (small blind) folded before Flop
Seat 5: slucasb (big blind) folded before Flop
Seat 6: alexyo111 showed [4h 6h] and won ($1) with a pair of Sixes



PokerStars Hand #222977837768:  Hold'em No Limit ($0.05/$0.10 USD) - 2021/01/23 18:30:50 ET
Table 'Jihlava III' 6-max Seat #4 is the button
Seat 1: 19991986830 ($24.18 in chips) 
Seat 2: marcin116 ($10.87 in chips) 
Seat 3: SD HAMMER ($10 in chips) 
Seat 4: jimeshka ($5.58 in chips) 
Seat 5: slucasb ($9.90 in chips) 
Seat 6: alexyo111 ($4.51 in chips) 
slucasb: posts small blind $0.05
alexyo111: posts big blind $0.10
*** HOLE CARDS ***
19991986830: raises $0.30 to $0.40
marcin116: folds 
SD HAMMER: folds 
jimeshka: folds 
slucasb: folds 
alexyo111: folds 
Uncalled bet ($0.30) returned to 19991986830
19991986830 collected $0.25 from pot
*** SUMMARY ***
Total pot $0.25 | Rake $0 
Seat 1: 19991986830 collected ($0.25)
Seat 2: marcin116 folded before Flop (didn't bet)
Seat 3: SD HAMMER folded before Flop (didn't bet)
Seat 4: jimeshka (button) folded before Flop (didn't bet)
Seat 5: slucasb (small blind) folded before Flop
Seat 6: alexyo111 (big blind) folded before Flop



PokerStars Hand #222977846028:  Hold'em No Limit ($0.05/$0.10 USD) - 2021/01/23 18:31:03 ET
Table 'Jihlava III' 6-max Seat #5 is the button
Seat 1: 19991986830 ($24.33 in chips) 
Seat 2: marcin116 ($10.87 in chips) 
Seat 3: SD HAMMER ($10 in chips) 
Seat 4: jimeshka ($5.58 in chips) 
Seat 5: slucasb ($10 in chips) 
Seat 6: alexyo111 ($4.41 in chips) 
alexyo111: posts small blind $0.05
19991986830: posts big blind $0.10
*** HOLE CARDS ***
marcin116: folds 
SD HAMMER: folds 
jimeshka: folds 
slucasb: folds 
alexyo111: folds 
Uncalled bet ($0.05) returned to 19991986830
19991986830 collected $0.10 from pot
*** SUMMARY ***
Total pot $0.10 | Rake $0 
Seat 1: 19991986830 (big blind) collected ($0.10)
Seat 2: marcin116 folded before Flop (didn't bet)
Seat 3: SD HAMMER folded before Flop (didn't bet)
Seat 4: jimeshka folded before Flop (didn't bet)
Seat 5: slucasb (button) folded before Flop (didn't bet)
Seat 6: alexyo111 (small blind) folded before Flop



PokerStars Hand #222977862403:  Hold'em No Limit ($0.05/$0.10 USD) - 2021/01/23 18:31:28 ET
Table 'Jihlava III' 6-max Seat #6 is the button
Seat 1: 19991986830 ($24.38 in chips) 
Seat 2: marcin116 ($10.87 in chips) 
Seat 3: SD HAMMER ($10 in chips) 
Seat 4: jimeshka ($5.58 in chips) 
Seat 5: slucasb ($10 in chips) 
Seat 6: alexyo111 ($4.36 in chips) 
19991986830: posts small blind $0.05
marcin116: posts big blind $0.10
*** HOLE CARDS ***
SD HAMMER: folds 
jimeshka: calls $0.10
slucasb: folds 
alexyo111: calls $0.10
19991986830: raises $0.30 to $0.40
marcin116: folds 
jimeshka: calls $0.30
alexyo111: raises $3.96 to $4.36 and is all-in
19991986830: folds 
jimeshka: calls $3.96
*** FLOP *** [3c 4h Qh]
*** TURN *** [3c 4h Qh] [3d]
*** RIVER *** [3c 4h Qh 3d] [4d]
*** SHOW DOWN ***
jimeshka: shows [Jc Jd] (two pair, Jacks and Fours)
alexyo111: shows [Ks Kd] (two pair, Kings and Fours)
jimeshka cashed out the hand for $1.61 | Cash Out Fee $0.02
alexyo111 cashed out the hand for $7.11 | Cash Out Fee $0.07
*** SUMMARY ***
Total pot $9.22 | Rake $0.41 
Board [3c 4h Qh 3d 4d]
Seat 1: 19991986830 (small blind) folded before Flop
Seat 2: marcin116 (big blind) folded before Flop
Seat 3: SD HAMMER folded before Flop (didn't bet)
Seat 4: jimeshka showed [Jc Jd] and lost with two pair, Jacks and Fours (cashed out).
Seat 5: slucasb folded before Flop (didn't bet)
Seat 6: alexyo111 (button) showed [Ks Kd] and won ($8.81) with two pair, Kings and Fours (pot not awarded as player cashed out)



PokerStars Hand #222977887557:  Hold'em No Limit ($0.05/$0.10 USD) - 2021/01/23 18:32:06 ET
Table 'Jihlava III' 6-max Seat #1 is the button
Seat 1: 19991986830 ($23.98 in chips) 
Seat 2: marcin116 ($10.77 in chips) 
Seat 3: SD HAMMER ($10 in chips) 
Seat 4: jimeshka ($2.83 in chips) 
Seat 5: slucasb ($10 in chips) 
Seat 6: alexyo111 ($7.11 in chips) 
marcin116: posts small blind $0.05
SD HAMMER: posts big blind $0.10
*** HOLE CARDS ***
jimeshka: folds 
slucasb: folds 
alexyo111: folds 
19991986830: raises $0.30 to $0.40
marcin116: folds 
SD HAMMER: folds 
Uncalled bet ($0.30) returned to 19991986830
19991986830 collected $0.25 from pot
*** SUMMARY ***
Total pot $0.25 | Rake $0 
Seat 1: 19991986830 (button) collected ($0.25)
Seat 2: marcin116 (small blind) folded before Flop
Seat 3: SD HAMMER (big blind) folded before Flop
Seat 4: jimeshka folded before Flop (didn't bet)
Seat 5: slucasb folded before Flop (didn't bet)
Seat 6: alexyo111 folded before Flop (didn't bet)



PokerStars Hand #222977900821:  Hold'em No Limit ($0.05/$0.10 USD) - 2021/01/23 18:32:27 ET
Table 'Jihlava III' 6-max Seat #2 is the button
Seat 1: 19991986830 ($24.13 in chips) 
Seat 2: marcin116 ($10.72 in chips) 
Seat 3: SD HAMMER ($10 in chips) 
Seat 4: jimeshka ($2.83 in chips) 
Seat 5: slucasb ($10 in chips) 
Seat 6: alexyo111 ($7.11 in chips) 
SD HAMMER: posts small blind $0.05
jimeshka: posts big blind $0.10
*** HOLE CARDS ***
slucasb: raises $0.16 to $0.26
alexyo111: calls $0.26
19991986830: calls $0.26
marcin116: calls $0.26
SD HAMMER: calls $0.21
jimeshka: calls $0.16
*** FLOP *** [Jd 4c Ac]
SD HAMMER: checks 
jimeshka: checks 
slucasb: checks 
alexyo111: checks 
19991986830: bets $0.40
marcin116: calls $0.40
SD HAMMER: folds 
jimeshka: calls $0.40
slucasb: folds 
alexyo111: folds 
*** TURN *** [Jd 4c Ac] [Ts]
jimeshka: checks 
19991986830: bets $0.50
marcin116: calls $0.50
jimeshka: calls $0.50
*** RIVER *** [Jd 4c Ac Ts] [Jc]
jimeshka: checks 
19991986830: checks 
marcin116: checks 
*** SHOW DOWN ***
jimeshka: shows [Qc Kh] (a straight, Ten to Ace)
19991986830: mucks hand 
marcin116: mucks hand 
jimeshka collected $4.07 from pot
*** SUMMARY ***
Total pot $4.26 | Rake $0.19 
Board [Jd 4c Ac Ts Jc]
Seat 1: 19991986830 mucked
Seat 2: marcin116 (button) mucked
Seat 3: SD HAMMER (small blind) folded on the Flop
Seat 4: jimeshka (big blind) showed [Qc Kh] and won ($4.07) with a straight, Ten to Ace
Seat 5: slucasb folded on the Flop
Seat 6: alexyo111 folded on the Flop



PokerStars Hand #222977938107:  Hold'em No Limit ($0.05/$0.10 USD) - 2021/01/23 18:33:24 ET
Table 'Jihlava III' 6-max Seat #3 is the button
Seat 1: 19991986830 ($22.97 in chips) 
Seat 2: marcin116 ($10 in chips) 
Seat 3: SD HAMMER ($10 in chips) 
Seat 4: jimeshka ($5.74 in chips) 
Seat 5: slucasb ($10 in chips) 
Seat 6: alexyo111 ($6.85 in chips) 
jimeshka: posts small blind $0.05
slucasb: posts big blind $0.10
*** HOLE CARDS ***
alexyo111: calls $0.10
19991986830: raises $0.10 to $0.20
marcin116: folds 
SD HAMMER: folds 
jimeshka: calls $0.15
slucasb: raises $0.50 to $0.70
alexyo111: folds 
19991986830: folds 
jimeshka: calls $0.50
*** FLOP *** [Kc 5s 2c]
jimeshka: checks 
slucasb: checks 
*** TURN *** [Kc 5s 2c] [7s]
jimeshka: checks 
slucasb: bets $1.10
jimeshka: folds 
Uncalled bet ($1.10) returned to slucasb
slucasb collected $1.62 from pot
slucasb: doesn't show hand 
*** SUMMARY ***
Total pot $1.70 | Rake $0.08 
Board [Kc 5s 2c 7s]
Seat 1: 19991986830 folded before Flop
Seat 2: marcin116 folded before Flop (didn't bet)
Seat 3: SD HAMMER (button) folded before Flop (didn't bet)
Seat 4: jimeshka (small blind) folded on the Turn
Seat 5: slucasb (big blind) collected ($1.62)
Seat 6: alexyo111 folded before Flop



PokerStars Hand #222977967472:  Hold'em No Limit ($0.05/$0.10 USD) - 2021/01/23 18:34:08 ET
Table 'Jihlava III' 6-max Seat #4 is the button
Seat 1: 19991986830 ($22.77 in chips) 
Seat 2: marcin116 ($10 in chips) 
Seat 3: SD HAMMER ($10 in chips) 
Seat 4: jimeshka ($5.04 in chips) 
Seat 5: slucasb ($10.92 in chips) 
Seat 6: alexyo111 ($6.75 in chips) 
slucasb: posts small blind $0.05
alexyo111: posts big blind $0.10
*** HOLE CARDS ***
19991986830: folds 
marcin116: raises $0.25 to $0.35
SD HAMMER: calls $0.35
jimeshka: calls $0.35
slucasb: folds 
alexyo111: calls $0.25
*** FLOP *** [Ad Qs 8h]
alexyo111: checks 
marcin116: checks 
SD HAMMER: checks 
jimeshka: checks 
*** TURN *** [Ad Qs 8h] [8d]
alexyo111: checks 
marcin116: checks 
SD HAMMER: checks 
jimeshka: checks 
*** RIVER *** [Ad Qs 8h 8d] [2h]
alexyo111: checks 
marcin116: checks 
SD HAMMER: checks 
jimeshka: checks 
*** SHOW DOWN ***
alexyo111: shows [9s Jh] (a pair of Eights)
marcin116: shows [Ts Kc] (a pair of Eights - Ace+King kicker)
SD HAMMER: shows [7h 7s] (two pair, Eights and Sevens)
jimeshka: shows [Td Tc] (two pair, Tens and Eights)
jimeshka collected $1.38 from pot
*** SUMMARY ***
Total pot $1.45 | Rake $0.07 
Board [Ad Qs 8h 8d 2h]
Seat 1: 19991986830 folded before Flop (didn't bet)
Seat 2: marcin116 showed [Ts Kc] and lost with a pair of Eights
Seat 3: SD HAMMER showed [7h 7s] and lost with two pair, Eights and Sevens
Seat 4: jimeshka (button) showed [Td Tc] and won ($1.38) with two pair, Tens and Eights
Seat 5: slucasb (small blind) folded before Flop
Seat 6: alexyo111 (big blind) showed [9s Jh] and lost with a pair of Eights



PokerStars Hand #222978001626:  Hold'em No Limit ($0.05/$0.10 USD) - 2021/01/23 18:35:00 ET
Table 'Jihlava III' 6-max Seat #5 is the button
Seat 1: 19991986830 ($22.77 in chips) 
Seat 2: marcin116 ($10 in chips) 
Seat 3: SD HAMMER ($10 in chips) 
Seat 4: jimeshka ($6.07 in chips) 
Seat 5: slucasb ($10.87 in chips) 
Seat 6: alexyo111 ($6.40 in chips) 
alexyo111: posts small blind $0.05
19991986830: posts big blind $0.10
*** HOLE CARDS ***
marcin116: raises $0.25 to $0.35
SD HAMMER: folds 
jimeshka: folds 
slucasb: folds 
alexyo111: raises $6.05 to $6.40 and is all-in
19991986830: folds 
marcin116: folds 
Uncalled bet ($6.05) returned to alexyo111
alexyo111 collected $0.80 from pot
alexyo111: doesn't show hand 
*** SUMMARY ***
Total pot $0.80 | Rake $0 
Seat 1: 19991986830 (big blind) folded before Flop
Seat 2: marcin116 folded before Flop
Seat 3: SD HAMMER folded before Flop (didn't bet)
Seat 4: jimeshka folded before Flop (didn't bet)
Seat 5: slucasb (button) folded before Flop (didn't bet)
Seat 6: alexyo111 (small blind) collected ($0.80)



PokerStars Hand #222978016960:  Hold'em No Limit ($0.05/$0.10 USD) - 2021/01/23 18:35:24 ET
Table 'Jihlava III' 6-max Seat #6 is the button
Seat 1: 19991986830 ($22.67 in chips) 
Seat 2: marcin116 ($10 in chips) 
Seat 3: SD HAMMER ($10 in chips) 
Seat 4: jimeshka ($6.07 in chips) 
Seat 5: slucasb ($10.87 in chips) 
Seat 6: alexyo111 ($6.85 in chips) 
19991986830: posts small blind $0.05
marcin116: posts big blind $0.10
*** HOLE CARDS ***
SD HAMMER: folds 
jimeshka: calls $0.10
slucasb: folds 
alexyo111: folds 
19991986830: raises $0.20 to $0.30
marcin116: folds 
jimeshka: calls $0.20
*** FLOP *** [Ks 6c 9h]
19991986830: bets $0.20
jimeshka: calls $0.20
*** TURN *** [Ks 6c 9h] [Tc]
19991986830: bets $0.30
jimeshka: calls $0.30
*** RIVER *** [Ks 6c 9h Tc] [7h]
19991986830: bets $0.81
jimeshka: calls $0.81
*** SHOW DOWN ***
19991986830: shows [8d Ad] (a straight, Six to Ten)
jimeshka: mucks hand 
19991986830 collected $3.17 from pot
*** SUMMARY ***
Total pot $3.32 | Rake $0.15 
Board [Ks 6c 9h Tc 7h]
Seat 1: 19991986830 (small blind) showed [8d Ad] and won ($3.17) with a straight, Six to Ten
Seat 2: marcin116 (big blind) folded before Flop
Seat 3: SD HAMMER folded before Flop (didn't bet)
Seat 4: jimeshka mucked
Seat 5: slucasb folded before Flop (didn't bet)
Seat 6: alexyo111 (button) folded before Flop (didn't bet)



PokerStars Hand #222978044817:  Hold'em No Limit ($0.05/$0.10 USD) - 2021/01/23 18:36:07 ET
Table 'Jihlava III' 6-max Seat #1 is the button
Seat 1: 19991986830 ($24.23 in chips) 
Seat 2: marcin116 ($10 in chips) 
Seat 3: SD HAMMER ($10 in chips) 
Seat 4: jimeshka ($4.46 in chips) 
Seat 5: slucasb ($10.87 in chips) 
Seat 6: alexyo111 ($6.85 in chips) 
marcin116: posts small blind $0.05
SD HAMMER: posts big blind $0.10
*** HOLE CARDS ***
jimeshka: folds 
slucasb: raises $0.16 to $0.26
alexyo111: folds 
19991986830: raises $0.16 to $0.42
marcin116: folds 
SD HAMMER: folds 
slucasb: calls $0.16
*** FLOP *** [9d 3s Jd]
slucasb: checks 
19991986830: bets $0.48
slucasb: raises $1.02 to $1.50
19991986830: calls $1.02
*** TURN *** [9d 3s Jd] [Qc]
slucasb: checks 
19991986830: checks 
*** RIVER *** [9d 3s Jd Qc] [6c]
slucasb: bets $1.91
19991986830: raises $7.63 to $9.54
slucasb: calls $7.04 and is all-in
Uncalled bet ($0.59) returned to 19991986830
*** SHOW DOWN ***
19991986830: shows [8c Tc] (a straight, Eight to Queen)
slucasb: shows [3d 3h] (three of a kind, Threes)
19991986830 collected $20.90 from pot
*** SUMMARY ***
Total pot $21.89 | Rake $0.99 
Board [9d 3s Jd Qc 6c]
Seat 1: 19991986830 (button) showed [8c Tc] and won ($20.90) with a straight, Eight to Queen
Seat 2: marcin116 (small blind) folded before Flop
Seat 3: SD HAMMER (big blind) folded before Flop
Seat 4: jimeshka folded before Flop (didn't bet)
Seat 5: slucasb showed [3d 3h] and lost with three of a kind, Threes
Seat 6: alexyo111 folded before Flop (didn't bet)



PokerStars Hand #222978088896:  Hold'em No Limit ($0.05/$0.10 USD) - 2021/01/23 18:37:15 ET
Table 'Jihlava III' 6-max Seat #2 is the button
Seat 1: 19991986830 ($34.26 in chips) 
Seat 2: marcin116 ($10 in chips) 
Seat 3: SD HAMMER ($10 in chips) 
Seat 4: jimeshka ($4.46 in chips) 
Seat 5: slucasb ($10 in chips) 
Seat 6: alexyo111 ($6.85 in chips) 
SD HAMMER: posts small blind $0.05
jimeshka: posts big blind $0.10
*** HOLE CARDS ***
slucasb: folds 
alexyo111: folds 
19991986830: folds 
marcin116: folds 
SD HAMMER: raises $0.20 to $0.30
jimeshka: calls $0.20
*** FLOP *** [2h 7d 3c]
SD HAMMER: bets $0.29
slucasb leaves the table
jimeshka: calls $0.29
*** TURN *** [2h 7d 3c] [Ts]
SD HAMMER: checks 
jimeshka: bets $0.57
SD HAMMER: folds 
Uncalled bet ($0.57) returned to jimeshka
jimeshka collected $1.13 from pot
jimeshka: doesn't show hand 
*** SUMMARY ***
Total pot $1.18 | Rake $0.05 
Board [2h 7d 3c Ts]
Seat 1: 19991986830 folded before Flop (didn't bet)
Seat 2: marcin116 (button) folded before Flop (didn't bet)
Seat 3: SD HAMMER (small blind) folded on the Turn
Seat 4: jimeshka (big blind) collected ($1.13)
Seat 5: slucasb folded before Flop (didn't bet)
Seat 6: alexyo111 folded before Flop (didn't bet)



PokerStars Hand #222978110662:  Hold'em No Limit ($0.05/$0.10 USD) - 2021/01/23 18:37:49 ET
Table 'Jihlava III' 6-max Seat #3 is the button
Seat 1: 19991986830 ($34.26 in chips) 
Seat 2: marcin116 ($10 in chips) 
Seat 3: SD HAMMER ($10 in chips) 
Seat 4: jimeshka ($5 in chips) 
Seat 6: alexyo111 ($6.85 in chips) 
jimeshka: posts small blind $0.05
alexyo111: posts big blind $0.10
*** HOLE CARDS ***
19991986830: raises $0.20 to $0.30
marcin116: calls $0.30
SD HAMMER: folds 
SouthFinc joins the table at seat #5 
jimeshka: folds 
alexyo111: calls $0.20
*** FLOP *** [Qd Th Qs]
alexyo111: checks 
19991986830: bets $0.46
marcin116: calls $0.46
alexyo111: folds 
*** TURN *** [Qd Th Qs] [3c]
19991986830: bets $0.90
marcin116: raises $1.79 to $2.69
19991986830: calls $1.79
*** RIVER *** [Qd Th Qs 3c] [Jc]
19991986830: checks 
marcin116: bets $6.55 and is all-in
19991986830: folds 
Uncalled bet ($6.55) returned to marcin116
marcin116 collected $6.92 from pot
marcin116: doesn't show hand 
*** SUMMARY ***
Total pot $7.25 | Rake $0.33 
Board [Qd Th Qs 3c Jc]
Seat 1: 19991986830 folded on the River
Seat 2: marcin116 collected ($6.92)
Seat 3: SD HAMMER (button) folded before Flop (didn't bet)
Seat 4: jimeshka (small blind) folded before Flop
Seat 6: alexyo111 (big blind) folded on the Flop



PokerStars Hand #222978139273:  Hold'em No Limit ($0.05/$0.10 USD) - 2021/01/23 18:38:33 ET
Table 'Jihlava III' 6-max Seat #4 is the button
Seat 1: 19991986830 ($30.81 in chips) 
Seat 2: marcin116 ($13.47 in chips) 
Seat 3: SD HAMMER ($10 in chips) 
Seat 4: jimeshka ($4.95 in chips) 
Seat 6: alexyo111 ($6.55 in chips) 
alexyo111: posts small blind $0.05
19991986830: posts big blind $0.10
*** HOLE CARDS ***
marcin116: folds 
SD HAMMER: folds 
jimeshka: calls $0.10
alexyo111: calls $0.05
19991986830: raises $0.20 to $0.30
jimeshka: calls $0.20
alexyo111: calls $0.20
*** FLOP *** [9h 4d 8d]
alexyo111: checks 
19991986830: bets $0.30
jimeshka: calls $0.30
alexyo111: calls $0.30
*** TURN *** [9h 4d 8d] [Qc]
alexyo111: checks 
19991986830: checks 
jimeshka: bets $0.86
alexyo111: calls $0.86
19991986830: calls $0.86
*** RIVER *** [9h 4d 8d Qc] [Kh]
alexyo111: checks 
19991986830: checks 
jimeshka: bets $2.09
alexyo111: calls $2.09
19991986830: raises $2.09 to $4.18
jimeshka: calls $1.40 and is all-in
alexyo111: calls $2.09
*** SHOW DOWN ***
19991986830: shows [Ah Ad] (a pair of Aces)
alexyo111: shows [Qh 8s] (two pair, Queens and Eights)
alexyo111 collected $1.32 from side pot
jimeshka: shows [Kc Qd] (two pair, Kings and Queens)
jimeshka collected $14.18 from main pot
*** SUMMARY ***
Total pot $16.23 Main pot $14.18. Side pot $1.32. | Rake $0.73 
Board [9h 4d 8d Qc Kh]
Seat 1: 19991986830 (big blind) showed [Ah Ad] and lost with a pair of Aces
Seat 2: marcin116 folded before Flop (didn't bet)
Seat 3: SD HAMMER folded before Flop (didn't bet)
Seat 4: jimeshka (button) showed [Kc Qd] and won ($14.18) with two pair, Kings and Queens
Seat 6: alexyo111 (small blind) showed [Qh 8s] and won ($1.32) with two pair, Queens and Eights



PokerStars Hand #222978183444:  Hold'em No Limit ($0.05/$0.10 USD) - 2021/01/23 18:39:43 ET
Table 'Jihlava III' 6-max Seat #6 is the button
Seat 1: 19991986830 ($25.17 in chips) 
Seat 2: marcin116 ($13.47 in chips) 
Seat 3: SD HAMMER ($10 in chips) 
Seat 4: jimeshka ($14.18 in chips) 
Seat 5: SouthFinc ($10 in chips) 
Seat 6: alexyo111 ($2.23 in chips) 
19991986830: posts small blind $0.05
marcin116: posts big blind $0.10
SouthFinc: posts big blind $0.10
*** HOLE CARDS ***
SD HAMMER: folds 
jimeshka: calls $0.10
SouthFinc: raises $0.35 to $0.45
alexyo111: folds 
19991986830: calls $0.40
marcin116: folds 
jimeshka: calls $0.35
*** FLOP *** [Jh 8c 9d]
19991986830: bets $0.30
jimeshka: calls $0.30
SouthFinc: raises $1.14 to $1.44
19991986830: calls $1.14
jimeshka: folds 
*** TURN *** [Jh 8c 9d] [3c]
19991986830: checks 
SouthFinc: bets $4.42
19991986830: calls $4.42
*** RIVER *** [Jh 8c 9d 3c] [6h]
19991986830: checks 
SouthFinc: bets $3.69 and is all-in
19991986830: calls $3.69
*** SHOW DOWN ***
SouthFinc: shows [4d 4s] (a pair of Fours)
19991986830: shows [8s 8d] (three of a kind, Eights)
19991986830 collected $19.91 from pot
*** SUMMARY ***
Total pot $20.85 | Rake $0.94 
Board [Jh 8c 9d 3c 6h]
Seat 1: 19991986830 (small blind) showed [8s 8d] and won ($19.91) with three of a kind, Eights
Seat 2: marcin116 (big blind) folded before Flop
Seat 3: SD HAMMER folded before Flop (didn't bet)
Seat 4: jimeshka folded on the Flop
Seat 5: SouthFinc showed [4d 4s] and lost with a pair of Fours
Seat 6: alexyo111 (button) folded before Flop (didn't bet)



PokerStars Hand #222978220590:  Hold'em No Limit ($0.05/$0.10 USD) - 2021/01/23 18:40:41 ET
Table 'Jihlava III' 6-max Seat #1 is the button
Seat 1: 19991986830 ($35.08 in chips) 
Seat 2: marcin116 ($13.37 in chips) 
Seat 3: SD HAMMER ($10 in chips) 
Seat 4: jimeshka ($13.43 in chips) 
Seat 6: alexyo111 ($2.23 in chips) 
marcin116: posts small blind $0.05
SD HAMMER: posts big blind $0.10
*** HOLE CARDS ***
SouthFinc leaves the table
jimeshka: calls $0.10
alexyo111: calls $0.10
19991986830: raises $0.10 to $0.20
marcin116: folds 
SD HAMMER: folds 
Hofnarren joins the table at seat #5 
jimeshka: calls $0.10
alexyo111: calls $0.10
*** FLOP *** [7h 9c 3d]
jimeshka: checks 
alexyo111: checks 
19991986830: bets $0.20
jimeshka: calls $0.20
alexyo111: calls $0.20
*** TURN *** [7h 9c 3d] [4c]
jimeshka: checks 
alexyo111: checks 
19991986830: checks 
*** RIVER *** [7h 9c 3d 4c] [6c]
jimeshka: bets $1.29
alexyo111: folds 
19991986830: folds 
Uncalled bet ($1.29) returned to jimeshka
jimeshka collected $1.29 from pot
jimeshka: doesn't show hand 
*** SUMMARY ***
Total pot $1.35 | Rake $0.06 
Board [7h 9c 3d 4c 6c]
Seat 1: 19991986830 (button) folded on the River
Seat 2: marcin116 (small blind) folded before Flop
Seat 3: SD HAMMER (big blind) folded before Flop
Seat 4: jimeshka collected ($1.29)
Seat 6: alexyo111 folded on the River



PokerStars Hand #222978249781:  Hold'em No Limit ($0.05/$0.10 USD) - 2021/01/23 18:41:26 ET
Table 'Jihlava III' 6-max Seat #2 is the button
Seat 1: 19991986830 ($34.68 in chips) 
Seat 2: marcin116 ($13.32 in chips) 
Seat 3: SD HAMMER ($10 in chips) 
Seat 4: jimeshka ($14.32 in chips) 
Seat 5: Hofnarren ($10 in chips) 
Seat 6: alexyo111 ($1.83 in chips) 
SD HAMMER: posts small blind $0.05
jimeshka: posts big blind $0.10
Hofnarren: posts big blind $0.10
*** HOLE CARDS ***
Hofnarren: raises $0.25 to $0.35
alexyo111: calls $0.35
19991986830: calls $0.35
marcin116: folds 
SD HAMMER: folds 
jimeshka: calls $0.25
*** FLOP *** [Ks 6c 3h]
jimeshka: checks 
Hofnarren: bets $1.38
alexyo111: folds 
19991986830: calls $1.38
jimeshka: folds 
*** TURN *** [Ks 6c 3h] [7s]
Hofnarren: bets $4.02
19991986830: calls $4.02
*** RIVER *** [Ks 6c 3h 7s] [8d]
Hofnarren: bets $4.25 and is all-in
19991986830: calls $4.25
*** SHOW DOWN ***
Hofnarren: shows [Th Kh] (a pair of Kings)
19991986830: shows [7c 7h] (three of a kind, Sevens)
19991986830 collected $19.82 from pot
*** SUMMARY ***
Total pot $20.75 | Rake $0.93 
Board [Ks 6c 3h 7s 8d]
Seat 1: 19991986830 showed [7c 7h] and won ($19.82) with three of a kind, Sevens
Seat 2: marcin116 (button) folded before Flop (didn't bet)
Seat 3: SD HAMMER (small blind) folded before Flop
Seat 4: jimeshka (big blind) folded on the Flop
Seat 5: Hofnarren showed [Th Kh] and lost with a pair of Kings
Seat 6: alexyo111 folded on the Flop



PokerStars Hand #222978286699:  Hold'em No Limit ($0.05/$0.10 USD) - 2021/01/23 18:42:10 ET
Table 'Jihlava III' 6-max Seat #3 is the button
Seat 1: 19991986830 ($44.50 in chips) 
Seat 2: marcin116 ($13.32 in chips) 
Seat 3: SD HAMMER ($10 in chips) 
Seat 4: jimeshka ($13.97 in chips) 
Seat 6: alexyo111 ($1.48 in chips) 
jimeshka: posts small blind $0.05
alexyo111: posts big blind $0.10
*** HOLE CARDS ***
Hofnarren leaves the table
19991986830: raises $0.30 to $0.40
casimiro124 joins the table at seat #5 
marcin116: folds 
SD HAMMER: folds 
jimeshka: calls $0.35
alexyo111: folds 
*** FLOP *** [4d Js 2s]
jimeshka: checks 
19991986830: checks 
*** TURN *** [4d Js 2s] [Tc]
jimeshka: checks 
19991986830: checks 
*** RIVER *** [4d Js 2s Tc] [8d]
jimeshka: checks 
19991986830: checks 
*** SHOW DOWN ***
jimeshka: shows [6d Ah] (high card Ace)
19991986830: mucks hand 
jimeshka collected $0.86 from pot
*** SUMMARY ***
Total pot $0.90 | Rake $0.04 
Board [4d Js 2s Tc 8d]
Seat 1: 19991986830 mucked
Seat 2: marcin116 folded before Flop (didn't bet)
Seat 3: SD HAMMER (button) folded before Flop (didn't bet)
Seat 4: jimeshka (small blind) showed [6d Ah] and won ($0.86) with high card Ace
Seat 6: alexyo111 (big blind) folded before Flop



PokerStars Hand #222978317504:  Hold'em No Limit ($0.05/$0.10 USD) - 2021/01/23 18:42:59 ET
Table 'Jihlava III' 6-max Seat #4 is the button
Seat 1: 19991986830 ($44.10 in chips) 
Seat 2: marcin116 ($13.32 in chips) 
Seat 3: SD HAMMER ($10 in chips) 
Seat 4: jimeshka ($14.43 in chips) 
Seat 6: alexyo111 ($1.38 in chips) 
alexyo111: posts small blind $0.05
19991986830: posts big blind $0.10
*** HOLE CARDS ***
marcin116: folds 
SD HAMMER: folds 
jimeshka: folds 
alexyo111: calls $0.05
19991986830: checks 
*** FLOP *** [6s Th Kd]
alexyo111: checks 
19991986830: checks 
*** TURN *** [6s Th Kd] [Qc]
alexyo111: checks 
19991986830: checks 
*** RIVER *** [6s Th Kd Qc] [Ad]
alexyo111: checks 
19991986830: checks 
*** SHOW DOWN ***
alexyo111: shows [Tc 9h] (a pair of Tens)
19991986830: mucks hand 
alexyo111 collected $0.19 from pot
*** SUMMARY ***
Total pot $0.20 | Rake $0.01 
Board [6s Th Kd Qc Ad]
Seat 1: 19991986830 (big blind) mucked
Seat 2: marcin116 folded before Flop (didn't bet)
Seat 3: SD HAMMER folded before Flop (didn't bet)
Seat 4: jimeshka (button) folded before Flop (didn't bet)
Seat 6: alexyo111 (small blind) showed [Tc 9h] and won ($0.19) with a pair of Tens



PokerStars Hand #222978338267:  Hold'em No Limit ($0.05/$0.10 USD) - 2021/01/23 18:43:32 ET
Table 'Jihlava III' 6-max Seat #6 is the button
Seat 2: marcin116 ($13.32 in chips) 
Seat 3: SD HAMMER ($10 in chips) 
Seat 4: jimeshka ($14.43 in chips) 
Seat 6: alexyo111 ($1.47 in chips) 
marcin116: posts small blind $0.05
SD HAMMER: posts big blind $0.10
casimiro124: sits out 
*** HOLE CARDS ***
jimeshka: raises $0.10 to $0.20
alexyo111 has timed out
alexyo111: folds 
marcin116: folds 
SD HAMMER: folds 
Uncalled bet ($0.10) returned to jimeshka
jimeshka collected $0.25 from pot
jimeshka: doesn't show hand 
*** SUMMARY ***
Total pot $0.25 | Rake $0 
Seat 2: marcin116 (small blind) folded before Flop
Seat 3: SD HAMMER (big blind) folded before Flop
Seat 4: jimeshka collected ($0.25)
Seat 6: alexyo111 (button) folded before Flop (didn't bet)



PokerStars Hand #222978355524:  Hold'em No Limit ($0.05/$0.10 USD) - 2021/01/23 18:43:59 ET
Table 'Jihlava III' 6-max Seat #2 is the button
Seat 2: marcin116 ($13.27 in chips) 
Seat 3: SD HAMMER ($10 in chips) 
Seat 4: jimeshka ($14.58 in chips) 
Seat 6: alexyo111 ($1.47 in chips) 
SD HAMMER: posts small blind $0.05
jimeshka: posts big blind $0.10
casimiro124: sits out 
*** HOLE CARDS ***
alexyo111: raises $1.37 to $1.47 and is all-in
marcin116: calls $1.47
SD HAMMER: folds 
jimeshka: folds 
*** FLOP *** [Th 8h Ks]
*** TURN *** [Th 8h Ks] [5d]
*** RIVER *** [Th 8h Ks 5d] [6s]
*** SHOW DOWN ***
alexyo111: shows [Qh Kh] (a pair of Kings)
marcin116: shows [Tc Ac] (a pair of Tens)
alexyo111 collected $2.95 from pot
marcin116 cashed out the hand for $1.70 | Cash Out Fee $0.02
*** SUMMARY ***
Total pot $3.09 | Rake $0.14 
Board [Th 8h Ks 5d 6s]
Seat 2: marcin116 (button) showed [Tc Ac] and lost with a pair of Tens (cashed out).
Seat 3: SD HAMMER (small blind) folded before Flop
Seat 4: jimeshka (big blind) folded before Flop
Seat 6: alexyo111 showed [Qh Kh] and won ($2.95) with a pair of Kings



PokerStars Hand #222978368452:  Hold'em No Limit ($0.05/$0.10 USD) - 2021/01/23 18:44:20 ET
Table 'Jihlava III' 6-max Seat #3 is the button
Seat 2: marcin116 ($13.50 in chips) 
Seat 3: SD HAMMER ($10 in chips) 
Seat 4: jimeshka ($14.48 in chips) 
Seat 5: casimiro124 ($10 in chips) 
Seat 6: alexyo111 ($2.95 in chips) 
jimeshka: posts small blind $0.05
casimiro124: posts big blind $0.10
*** HOLE CARDS ***
alexyo111: folds 
marcin116: folds 
SD HAMMER: folds 
jimeshka: raises $0.10 to $0.20
casimiro124: folds 
Uncalled bet ($0.10) returned to jimeshka
jimeshka collected $0.20 from pot
jimeshka: doesn't show hand 
*** SUMMARY ***
Total pot $0.20 | Rake $0 
Seat 2: marcin116 folded before Flop (didn't bet)
Seat 3: SD HAMMER (button) folded before Flop (didn't bet)
Seat 4: jimeshka (small blind) collected ($0.20)
Seat 5: casimiro124 (big blind) folded before Flop
Seat 6: alexyo111 folded before Flop (didn't bet)



PokerStars Hand #222978375752:  Hold'em No Limit ($0.05/$0.10 USD) - 2021/01/23 18:44:32 ET
Table 'Jihlava III' 6-max Seat #4 is the button
Seat 2: marcin116 ($13.50 in chips) 
Seat 3: SD HAMMER ($10 in chips) 
Seat 4: jimeshka ($14.58 in chips) 
Seat 5: casimiro124 ($10 in chips) 
Seat 6: alexyo111 ($2.95 in chips) 
casimiro124: posts small blind $0.05
alexyo111: posts big blind $0.10
*** HOLE CARDS ***
marcin116: folds 
SD HAMMER: raises $0.20 to $0.30
jimeshka: folds 
casimiro124: folds 
alexyo111: folds 
Uncalled bet ($0.20) returned to SD HAMMER
SD HAMMER collected $0.25 from pot
SD HAMMER: doesn't show hand 
*** SUMMARY ***
Total pot $0.25 | Rake $0 
Seat 2: marcin116 folded before Flop (didn't bet)
Seat 3: SD HAMMER collected ($0.25)
Seat 4: jimeshka (button) folded before Flop (didn't bet)
Seat 5: casimiro124 (small blind) folded before Flop
Seat 6: alexyo111 (big blind) folded before Flop



PokerStars Hand #222978387611:  Hold'em No Limit ($0.05/$0.10 USD) - 2021/01/23 18:44:50 ET
Table 'Jihlava III' 6-max Seat #5 is the button
Seat 2: marcin116 ($13.50 in chips) 
Seat 3: SD HAMMER ($10.15 in chips) 
Seat 4: jimeshka ($14.58 in chips) 
Seat 5: casimiro124 ($10 in chips) 
Seat 6: alexyo111 ($2.85 in chips) 
alexyo111: posts small blind $0.05
marcin116: posts big blind $0.10
*** HOLE CARDS ***
SD HAMMER: raises $0.20 to $0.30
jimeshka: folds 
casimiro124: folds 
alexyo111: folds 
marcin116: folds 
Uncalled bet ($0.20) returned to SD HAMMER
SD HAMMER collected $0.25 from pot
SD HAMMER: doesn't show hand 
*** SUMMARY ***
Total pot $0.25 | Rake $0 
Seat 2: marcin116 (big blind) folded before Flop
Seat 3: SD HAMMER collected ($0.25)
Seat 4: jimeshka folded before Flop (didn't bet)
Seat 5: casimiro124 (button) folded before Flop (didn't bet)
Seat 6: alexyo111 (small blind) folded before Flop



PokerStars Hand #222978395016:  Hold'em No Limit ($0.05/$0.10 USD) - 2021/01/23 18:45:02 ET
Table 'Jihlava III' 6-max Seat #6 is the button
Seat 3: SD HAMMER ($10.30 in chips) 
Seat 4: jimeshka ($14.58 in chips) 
Seat 5: casimiro124 ($10 in chips) 
Seat 6: alexyo111 ($2.80 in chips) 
SD HAMMER: posts small blind $0.05
jimeshka: posts big blind $0.10
*** HOLE CARDS ***
casimiro124: raises $0.15 to $0.25
alexyo111: folds 
SD HAMMER: folds 
jimeshka: calls $0.15
*** FLOP *** [Tc 4h 8d]
jimeshka: checks 
casimiro124: bets $0.28
jimeshka: calls $0.28
*** TURN *** [Tc 4h 8d] [4d]
jimeshka: checks 
casimiro124: checks 
*** RIVER *** [Tc 4h 8d 4d] [Ks]
jimeshka: bets $1.06
casimiro124: folds 
Uncalled bet ($1.06) returned to jimeshka
jimeshka collected $1.06 from pot
jimeshka: doesn't show hand 
*** SUMMARY ***
Total pot $1.11 | Rake $0.05 
Board [Tc 4h 8d 4d Ks]
Seat 3: SD HAMMER (small blind) folded before Flop
Seat 4: jimeshka (big blind) collected ($1.06)
Seat 5: casimiro124 folded on the River
Seat 6: alexyo111 (button) folded before Flop (didn't bet)



PokerStars Hand #222978419392:  Hold'em No Limit ($0.05/$0.10 USD) - 2021/01/23 18:45:41 ET
Table 'Jihlava III' 6-max Seat #3 is the button
Seat 3: SD HAMMER ($10.25 in chips) 
Seat 4: jimeshka ($15.11 in chips) 
Seat 5: casimiro124 ($10 in chips) 
Seat 6: alexyo111 ($2.80 in chips) 
jimeshka: posts small blind $0.05
casimiro124: posts big blind $0.10
*** HOLE CARDS ***
alexyo111: folds 
SD HAMMER: folds 
jimeshka: calls $0.05
casimiro124: checks 
*** FLOP *** [2c Qd 4c]
jimeshka: checks 
casimiro124: checks 
*** TURN *** [2c Qd 4c] [Jd]
jimeshka: bets $0.10
casimiro124: folds 
Uncalled bet ($0.10) returned to jimeshka
jimeshka collected $0.19 from pot
jimeshka: doesn't show hand 
*** SUMMARY ***
Total pot $0.20 | Rake $0.01 
Board [2c Qd 4c Jd]
Seat 3: SD HAMMER (button) folded before Flop (didn't bet)
Seat 4: jimeshka (small blind) collected ($0.19)
Seat 5: casimiro124 (big blind) folded on the Turn
Seat 6: alexyo111 folded before Flop (didn't bet)



PokerStars Hand #222978431520:  Hold'em No Limit ($0.05/$0.10 USD) - 2021/01/23 18:46:00 ET
Table 'Jihlava III' 6-max Seat #4 is the button
Seat 3: SD HAMMER ($10.25 in chips) 
Seat 4: jimeshka ($15.20 in chips) 
Seat 5: casimiro124 ($10 in chips) 
Seat 6: alexyo111 ($2.80 in chips) 
casimiro124: posts small blind $0.05
alexyo111: posts big blind $0.10
*** HOLE CARDS ***
SD HAMMER: folds 
jimeshka: folds 
casimiro124: folds 
Uncalled bet ($0.05) returned to alexyo111
alexyo111 collected $0.10 from pot
alexyo111: doesn't show hand 
*** SUMMARY ***
Total pot $0.10 | Rake $0 
Seat 3: SD HAMMER folded before Flop (didn't bet)
Seat 4: jimeshka (button) folded before Flop (didn't bet)
Seat 5: casimiro124 (small blind) folded before Flop
Seat 6: alexyo111 (big blind) collected ($0.10)



PokerStars Hand #222978435336:  Hold'em No Limit ($0.05/$0.10 USD) - 2021/01/23 18:46:07 ET
Table 'Jihlava III' 6-max Seat #5 is the button
Seat 3: SD HAMMER ($10.25 in chips) 
Seat 4: jimeshka ($15.20 in chips) 
Seat 5: casimiro124 ($10 in chips) 
Seat 6: alexyo111 ($2.85 in chips) 
alexyo111: posts small blind $0.05
SD HAMMER: posts big blind $0.10
*** HOLE CARDS ***
jimeshka: folds 
casimiro124: raises $0.15 to $0.25
alexyo111: folds 
SD HAMMER: folds 
Uncalled bet ($0.15) returned to casimiro124
casimiro124 collected $0.25 from pot
casimiro124: doesn't show hand 
*** SUMMARY ***
Total pot $0.25 | Rake $0 
Seat 3: SD HAMMER (big blind) folded before Flop
Seat 4: jimeshka folded before Flop (didn't bet)
Seat 5: casimiro124 (button) collected ($0.25)
Seat 6: alexyo111 (small blind) folded before Flop



PokerStars Hand #222978441664:  Hold'em No Limit ($0.05/$0.10 USD) - 2021/01/23 18:46:17 ET
Table 'Jihlava III' 6-max Seat #6 is the button
Seat 3: SD HAMMER ($10.15 in chips) 
Seat 4: jimeshka ($15.20 in chips) 
Seat 5: casimiro124 ($10.15 in chips) 
Seat 6: alexyo111 ($2.80 in chips) 
SD HAMMER: posts small blind $0.05
jimeshka: posts big blind $0.10
*** HOLE CARDS ***
casimiro124: folds 
alexyo111: calls $0.10
SD HAMMER: folds 
jimeshka: checks 
*** FLOP *** [9s 8c 9h]
jimeshka: bets $0.10
alexyo111: calls $0.10
*** TURN *** [9s 8c 9h] [Jc]
jimeshka: bets $0.20
alexyo111: calls $0.20
*** RIVER *** [9s 8c 9h Jc] [5d]
jimeshka: bets $0.81
alexyo111: folds 
Uncalled bet ($0.81) returned to jimeshka
jimeshka collected $0.81 from pot
jimeshka: doesn't show hand 
*** SUMMARY ***
Total pot $0.85 | Rake $0.04 
Board [9s 8c 9h Jc 5d]
Seat 3: SD HAMMER (small blind) folded before Flop
Seat 4: jimeshka (big blind) collected ($0.81)
Seat 5: casimiro124 folded before Flop (didn't bet)
Seat 6: alexyo111 (button) folded on the River



PokerStars Hand #222978456263:  Hold'em No Limit ($0.05/$0.10 USD) - 2021/01/23 18:46:40 ET
Table 'Jihlava III' 6-max Seat #3 is the button
Seat 3: SD HAMMER ($10.10 in chips) 
Seat 4: jimeshka ($15.61 in chips) 
Seat 6: alexyo111 ($2.40 in chips) 
jimeshka: posts small blind $0.05
casimiro124: is sitting out 
alexyo111: posts big blind $0.10
*** HOLE CARDS ***
SD HAMMER: folds 
jimeshka: calls $0.05
alexyo111: raises $0.30 to $0.40
jimeshka: folds 
Uncalled bet ($0.30) returned to alexyo111
alexyo111 collected $0.20 from pot
alexyo111: doesn't show hand 
*** SUMMARY ***
Total pot $0.20 | Rake $0 
Seat 3: SD HAMMER (button) folded before Flop (didn't bet)
Seat 4: jimeshka (small blind) folded before Flop
Seat 6: alexyo111 (big blind) collected ($0.20)



PokerStars Hand #222978464176:  Hold'em No Limit ($0.05/$0.10 USD) - 2021/01/23 18:46:53 ET
Table 'Jihlava III' 6-max Seat #4 is the button
Seat 3: SD HAMMER ($10.10 in chips) 
Seat 4: jimeshka ($15.51 in chips) 
Seat 6: alexyo111 ($2.50 in chips) 
alexyo111: posts small blind $0.05
SD HAMMER: posts big blind $0.10
*** HOLE CARDS ***
jimeshka: calls $0.10
alexyo111: calls $0.05
SD HAMMER: raises $0.40 to $0.50
jimeshka: calls $0.40
alexyo111: folds 
*** FLOP *** [Qs 4s As]
SD HAMMER: bets $1.05
jimeshka: calls $1.05
*** TURN *** [Qs 4s As] [9d]
SD HAMMER: bets $2.30
jimeshka: calls $2.30
*** RIVER *** [Qs 4s As 9d] [3h]
SD HAMMER: bets $3.73
jimeshka: folds 
Uncalled bet ($3.73) returned to SD HAMMER
SD HAMMER collected $7.45 from pot
19991986830 was removed from the table for failing to post
19991986830 leaves the table
SD HAMMER: doesn't show hand 
*** SUMMARY ***
Total pot $7.80 | Rake $0.35 
Board [Qs 4s As 9d 3h]
Seat 3: SD HAMMER (big blind) collected ($7.45)
Seat 4: jimeshka (button) folded on the River
Seat 6: alexyo111 (small blind) folded before Flop



PokerStars Hand #222978482390:  Hold'em No Limit ($0.05/$0.10 USD) - 2021/01/23 18:47:22 ET
Table 'Jihlava III' 6-max Seat #6 is the button
Seat 3: SD HAMMER ($13.70 in chips) 
Seat 4: jimeshka ($11.66 in chips) 
Seat 6: alexyo111 ($2.40 in chips) 
SD HAMMER: posts small blind $0.05
jimeshka: posts big blind $0.10
*** HOLE CARDS ***
alexyo111: folds 
SD HAMMER: folds 
Uncalled bet ($0.05) returned to jimeshka
jimeshka collected $0.10 from pot
jimeshka: doesn't show hand 
*** SUMMARY ***
Total pot $0.10 | Rake $0 
Seat 3: SD HAMMER (small blind) folded before Flop
Seat 4: jimeshka (big blind) collected ($0.10)
Seat 6: alexyo111 (button) folded before Flop (didn't bet)



PokerStars Hand #222978485417:  Hold'em No Limit ($0.05/$0.10 USD) - 2021/01/23 18:47:27 ET
Table 'Jihlava III' 6-max Seat #3 is the button
Seat 3: SD HAMMER ($13.65 in chips) 
Seat 4: jimeshka ($11.71 in chips) 
Seat 6: alexyo111 ($2.40 in chips) 
jimeshka: posts small blind $0.05
alexyo111: posts big blind $0.10
*** HOLE CARDS ***
SD HAMMER: raises $0.20 to $0.30
jimeshka: folds 
alexyo111: calls $0.20
*** FLOP *** [Qc 5s 3s]
alexyo111: checks 
SD HAMMER: bets $0.31
alexyo111: folds 
Uncalled bet ($0.31) returned to SD HAMMER
SD HAMMER collected $0.62 from pot
SD HAMMER: doesn't show hand 
*** SUMMARY ***
Total pot $0.65 | Rake $0.03 
Board [Qc 5s 3s]
Seat 3: SD HAMMER (button) collected ($0.62)
Seat 4: jimeshka (small blind) folded before Flop
Seat 6: alexyo111 (big blind) folded on the Flop



PokerStars Hand #222978496504:  Hold'em No Limit ($0.05/$0.10 USD) - 2021/01/23 18:47:45 ET
Table 'Jihlava III' 6-max Seat #4 is the button
Seat 3: SD HAMMER ($13.97 in chips) 
Seat 4: jimeshka ($11.66 in chips) 
Seat 6: alexyo111 ($2.10 in chips) 
alexyo111: posts small blind $0.05
SD HAMMER: posts big blind $0.10
*** HOLE CARDS ***
jimeshka: calls $0.10
alexyo111: calls $0.05
SD HAMMER: checks 
*** FLOP *** [7s 7d 5d]
alexyo111: checks 
SD HAMMER: checks 
jimeshka: checks 
*** TURN *** [7s 7d 5d] [Jd]
alexyo111: checks 
SD HAMMER: checks 
jimeshka: checks 
*** RIVER *** [7s 7d 5d Jd] [7c]
casimiro124 leaves the table
alexyo111: bets $0.10
SD HAMMER: folds 
jimeshka: calls $0.10
*** SHOW DOWN ***
alexyo111: shows [3h 3c] (a full house, Sevens full of Threes)
jimeshka: mucks hand 
alexyo111 collected $0.48 from pot
*** SUMMARY ***
Total pot $0.50 | Rake $0.02 
Board [7s 7d 5d Jd 7c]
Seat 3: SD HAMMER (big blind) folded on the River
Seat 4: jimeshka (button) mucked
Seat 6: alexyo111 (small blind) showed [3h 3c] and won ($0.48) with a full house, Sevens full of Threes



PokerStars Hand #222978512260:  Hold'em No Limit ($0.05/$0.10 USD) - 2021/01/23 18:48:10 ET
Table 'Jihlava III' 6-max Seat #6 is the button
Seat 3: SD HAMMER ($13.87 in chips) 
Seat 4: jimeshka ($11.46 in chips) 
Seat 6: alexyo111 ($2.38 in chips) 
SD HAMMER: posts small blind $0.05
jimeshka: posts big blind $0.10
*** HOLE CARDS ***
alexyo111: calls $0.10
SD HAMMER: calls $0.05
jimeshka: checks 
*** FLOP *** [Js 4s 7h]
SD HAMMER: checks 
jimeshka: checks 
alexyo111: bets $0.20
SD HAMMER: calls $0.20
jimeshka: folds 
*** TURN *** [Js 4s 7h] [3h]
SD HAMMER: checks 
alexyo111: bets $0.60
SD HAMMER: folds 
Uncalled bet ($0.60) returned to alexyo111
alexyo111 collected $0.67 from pot
alexyo111: doesn't show hand 
*** SUMMARY ***
Total pot $0.70 | Rake $0.03 
Board [Js 4s 7h 3h]
Seat 3: SD HAMMER (small blind) folded on the Turn
Seat 4: jimeshka (big blind) folded on the Flop
Seat 6: alexyo111 (button) collected ($0.67)



PokerStars Hand #222978535121:  Hold'em No Limit ($0.05/$0.10 USD) - 2021/01/23 18:48:43 ET
Table 'Jihlava III' 6-max Seat #3 is the button
Seat 3: SD HAMMER ($13.57 in chips) 
Seat 4: jimeshka ($11.36 in chips) 
Seat 6: alexyo111 ($2.75 in chips) 
jimeshka: posts small blind $0.05
alexyo111: posts big blind $0.10
marcin116: sits out 
*** HOLE CARDS ***
SD HAMMER: folds 
jimeshka: calls $0.05
alexyo111: raises $0.30 to $0.40
jimeshka: folds 
Uncalled bet ($0.30) returned to alexyo111
alexyo111 collected $0.20 from pot
alexyo111: doesn't show hand 
*** SUMMARY ***
Total pot $0.20 | Rake $0 
Seat 3: SD HAMMER (button) folded before Flop (didn't bet)
Seat 4: jimeshka (small blind) folded before Flop
Seat 6: alexyo111 (big blind) collected ($0.20)



PokerStars Hand #222978540480:  Hold'em No Limit ($0.05/$0.10 USD) - 2021/01/23 18:48:51 ET
Table 'Jihlava III' 6-max Seat #4 is the button
Seat 2: marcin116 ($13.40 in chips) 
Seat 3: SD HAMMER ($13.57 in chips) 
Seat 4: jimeshka ($11.26 in chips) 
Seat 6: alexyo111 ($2.85 in chips) 
alexyo111: posts small blind $0.05
marcin116: posts big blind $0.10
*** HOLE CARDS ***
19991986830 joins the table at seat #1 
SD HAMMER: folds 
jimeshka: folds 
alexyo111: raises $0.20 to $0.30
bobobabi joins the table at seat #5 
marcin116: calls $0.20
*** FLOP *** [Qd 5c 3c]
alexyo111: bets $0.20
marcin116: folds 
Uncalled bet ($0.20) returned to alexyo111
alexyo111 collected $0.57 from pot
alexyo111: doesn't show hand 
*** SUMMARY ***
Total pot $0.60 | Rake $0.03 
Board [Qd 5c 3c]
Seat 2: marcin116 (big blind) folded on the Flop
Seat 3: SD HAMMER folded before Flop (didn't bet)
Seat 4: jimeshka (button) folded before Flop (didn't bet)
Seat 6: alexyo111 (small blind) collected ($0.57)



PokerStars Hand #222978549765:  Hold'em No Limit ($0.05/$0.10 USD) - 2021/01/23 18:49:06 ET
Table 'Jihlava III' 6-max Seat #6 is the button
Seat 2: marcin116 ($13.10 in chips) 
Seat 3: SD HAMMER ($13.57 in chips) 
Seat 4: jimeshka ($11.26 in chips) 
Seat 6: alexyo111 ($3.12 in chips) 
marcin116: posts small blind $0.05
SD HAMMER: posts big blind $0.10
bobobabi: sits out 
*** HOLE CARDS ***
jimeshka: calls $0.10
alexyo111: calls $0.10
marcin116: folds 
SD HAMMER: checks 
*** FLOP *** [6c Jh Qc]
SD HAMMER: checks 
jimeshka: checks 
alexyo111: checks 
*** TURN *** [6c Jh Qc] [Tc]
SD HAMMER: checks 
jimeshka: checks 
alexyo111: checks 
*** RIVER *** [6c Jh Qc Tc] [5s]
SD HAMMER: checks 
jimeshka: checks 
alexyo111: checks 
*** SHOW DOWN ***
SD HAMMER: shows [Td 7d] (a pair of Tens)
jimeshka: mucks hand 
alexyo111: mucks hand 
SD HAMMER collected $0.33 from pot
*** SUMMARY ***
Total pot $0.35 | Rake $0.02 
Board [6c Jh Qc Tc 5s]
Seat 2: marcin116 (small blind) folded before Flop
Seat 3: SD HAMMER (big blind) showed [Td 7d] and won ($0.33) with a pair of Tens
Seat 4: jimeshka mucked
Seat 6: alexyo111 (button) mucked



PokerStars Hand #222978566715:  Hold'em No Limit ($0.05/$0.10 USD) - 2021/01/23 18:49:34 ET
Table 'Jihlava III' 6-max Seat #2 is the button
Seat 1: 19991986830 ($44 in chips) 
Seat 2: marcin116 ($13.05 in chips) 
Seat 3: SD HAMMER ($13.80 in chips) 
Seat 4: jimeshka ($11.16 in chips) 
Seat 6: alexyo111 ($3.02 in chips) 
SD HAMMER: posts small blind $0.05
jimeshka: posts big blind $0.10
bobobabi: sits out 
19991986830: posts big blind $0.10
*** HOLE CARDS ***
alexyo111: folds 
19991986830: checks 
marcin116: folds 
SD HAMMER: folds 
jimeshka: checks 
*** FLOP *** [7s 7c 6c]
jimeshka: checks 
19991986830: bets $0.30
jimeshka: calls $0.30
*** TURN *** [7s 7c 6c] [3s]
jimeshka: checks 
19991986830: bets $0.30
jimeshka: calls $0.30
*** RIVER *** [7s 7c 6c 3s] [Ad]
jimeshka: checks 
19991986830: checks 
*** SHOW DOWN ***
jimeshka: shows [9d 6d] (two pair, Sevens and Sixes)
19991986830: shows [6s Td] (two pair, Sevens and Sixes)
jimeshka collected $0.69 from pot
19991986830 collected $0.69 from pot
*** SUMMARY ***
Total pot $1.45 | Rake $0.07 
Board [7s 7c 6c 3s Ad]
Seat 1: 19991986830 showed [6s Td] and won ($0.69) with two pair, Sevens and Sixes
Seat 2: marcin116 (button) folded before Flop (didn't bet)
Seat 3: SD HAMMER (small blind) folded before Flop
Seat 4: jimeshka (big blind) showed [9d 6d] and won ($0.69) with two pair, Sevens and Sixes
Seat 6: alexyo111 folded before Flop (didn't bet)



PokerStars Hand #222978585349:  Hold'em No Limit ($0.05/$0.10 USD) - 2021/01/23 18:50:04 ET
Table 'Jihlava III' 6-max Seat #3 is the button
Seat 1: 19991986830 ($43.99 in chips) 
Seat 2: marcin116 ($13.05 in chips) 
Seat 3: SD HAMMER ($13.75 in chips) 
Seat 4: jimeshka ($11.15 in chips) 
Seat 5: bobobabi ($10 in chips) 
Seat 6: alexyo111 ($3.02 in chips) 
jimeshka: posts small blind $0.05
bobobabi: posts big blind $0.10
*** HOLE CARDS ***
alexyo111: calls $0.10
19991986830: raises $0.30 to $0.40
marcin116: folds 
SD HAMMER: folds 
jimeshka: folds 
bobobabi: folds 
alexyo111: folds 
Uncalled bet ($0.30) returned to 19991986830
19991986830 collected $0.35 from pot
*** SUMMARY ***
Total pot $0.35 | Rake $0 
Seat 1: 19991986830 collected ($0.35)
Seat 2: marcin116 folded before Flop (didn't bet)
Seat 3: SD HAMMER (button) folded before Flop (didn't bet)
Seat 4: jimeshka (small blind) folded before Flop
Seat 5: bobobabi (big blind) folded before Flop
Seat 6: alexyo111 folded before Flop



PokerStars Hand #222978605589:  Hold'em No Limit ($0.05/$0.10 USD) - 2021/01/23 18:50:37 ET
Table 'Jihlava III' 6-max Seat #4 is the button
Seat 1: 19991986830 ($44.24 in chips) 
Seat 2: marcin116 ($13.05 in chips) 
Seat 3: SD HAMMER ($13.75 in chips) 
Seat 4: jimeshka ($11.10 in chips) 
Seat 5: bobobabi ($9.90 in chips) 
Seat 6: alexyo111 ($2.92 in chips) 
bobobabi: posts small blind $0.05
alexyo111: posts big blind $0.10
*** HOLE CARDS ***
19991986830: raises $0.30 to $0.40
marcin116: raises $0.95 to $1.35
SD HAMMER: folds 
jimeshka: folds 
bobobabi: folds 
alexyo111: raises $1.57 to $2.92 and is all-in
19991986830: folds 
marcin116: calls $1.57
*** FLOP *** [6h 5s 4d]
*** TURN *** [6h 5s 4d] [5c]
*** RIVER *** [6h 5s 4d 5c] [7s]
*** SHOW DOWN ***
alexyo111: shows [Kd Ks] (two pair, Kings and Fives)
marcin116: shows [As Ad] (two pair, Aces and Fives)
marcin116 cashed out the hand for $4.91 | Cash Out Fee $0.05
*** SUMMARY ***
Total pot $6.29 | Rake $0.28 
Board [6h 5s 4d 5c 7s]
Seat 1: 19991986830 folded before Flop
Seat 2: marcin116 showed [As Ad] and won ($6.01) with two pair, Aces and Fives (pot not awarded as player cashed out)
Seat 3: SD HAMMER folded before Flop (didn't bet)
Seat 4: jimeshka (button) folded before Flop (didn't bet)
Seat 5: bobobabi (small blind) folded before Flop
Seat 6: alexyo111 (big blind) showed [Kd Ks] and lost with two pair, Kings and Fives



PokerStars Hand #222978628171:  Hold'em No Limit ($0.05/$0.10 USD) - 2021/01/23 18:51:15 ET
Table 'Jihlava III' 6-max Seat #5 is the button
Seat 1: 19991986830 ($43.84 in chips) 
Seat 2: marcin116 ($15.04 in chips) 
Seat 3: SD HAMMER ($13.75 in chips) 
Seat 4: jimeshka ($11.10 in chips) 
Seat 5: bobobabi ($9.85 in chips) 
19991986830: posts small blind $0.05
marcin116: posts big blind $0.10
*** HOLE CARDS ***
SD HAMMER: folds 
jimeshka: calls $0.10
alexyo111 leaves the table
bobobabi: folds 
19991986830: raises $0.20 to $0.30
marcin116: folds 
jimeshka: calls $0.20
*** FLOP *** [Jh Td Ad]
19991986830: checks 
KiraLasVegas joins the table at seat #6 
jimeshka: checks 
*** TURN *** [Jh Td Ad] [4c]
19991986830: bets $0.30
jimeshka: calls $0.30
*** RIVER *** [Jh Td Ad 4c] [Kc]
19991986830: bets $0.30
jimeshka: calls $0.30
*** SHOW DOWN ***
19991986830: shows [Jc 8d] (a pair of Jacks)
jimeshka: mucks hand 
19991986830 collected $1.81 from pot
*** SUMMARY ***
Total pot $1.90 | Rake $0.09 
Board [Jh Td Ad 4c Kc]
Seat 1: 19991986830 (small blind) showed [Jc 8d] and won ($1.81) with a pair of Jacks
Seat 2: marcin116 (big blind) folded before Flop
Seat 3: SD HAMMER folded before Flop (didn't bet)
Seat 4: jimeshka mucked
Seat 5: bobobabi (button) folded before Flop (didn't bet)



PokerStars Hand #222978649507:  Hold'em No Limit ($0.05/$0.10 USD) - 2021/01/23 18:51:50 ET
Table 'Jihlava III' 6-max Seat #1 is the button
Seat 1: 19991986830 ($44.75 in chips) 
Seat 2: marcin116 ($14.94 in chips) 
Seat 3: SD HAMMER ($13.75 in chips) 
Seat 4: jimeshka ($10.20 in chips) 
Seat 5: bobobabi ($9.85 in chips) 
marcin116: posts small blind $0.05
SD HAMMER: posts big blind $0.10
KiraLasVegas: sits out 
*** HOLE CARDS ***
jimeshka: raises $0.10 to $0.20
bobobabi: folds 
19991986830: raises $0.20 to $0.40
marcin116: folds 
SD HAMMER: calls $0.30
jimeshka: calls $0.20
*** FLOP *** [Ts Tc 2d]
SD HAMMER: checks 
jimeshka: checks 
19991986830: checks 
*** TURN *** [Ts Tc 2d] [2c]
SD HAMMER: checks 
jimeshka: bets $0.40
19991986830: calls $0.40
SD HAMMER: folds 
*** RIVER *** [Ts Tc 2d 2c] [2s]
jimeshka: bets $1.96
19991986830: calls $1.96
*** SHOW DOWN ***
jimeshka: shows [Jd Ad] (a full house, Deuces full of Tens)
19991986830: shows [7d 6c] (a full house, Deuces full of Tens)
jimeshka collected $2.85 from pot
19991986830 collected $2.85 from pot
*** SUMMARY ***
Total pot $5.97 | Rake $0.27 
Board [Ts Tc 2d 2c 2s]
Seat 1: 19991986830 (button) showed [7d 6c] and won ($2.85) with a full house, Deuces full of Tens
Seat 2: marcin116 (small blind) folded before Flop
Seat 3: SD HAMMER (big blind) folded on the Turn
Seat 4: jimeshka showed [Jd Ad] and won ($2.85) with a full house, Deuces full of Tens
Seat 5: bobobabi folded before Flop (didn't bet)



PokerStars Hand #222978683452:  Hold'em No Limit ($0.05/$0.10 USD) - 2021/01/23 18:52:46 ET
Table 'Jihlava III' 6-max Seat #2 is the button
Seat 1: 19991986830 ($44.84 in chips) 
Seat 2: marcin116 ($14.89 in chips) 
Seat 3: SD HAMMER ($13.35 in chips) 
Seat 4: jimeshka ($10.29 in chips) 
Seat 5: bobobabi ($9.85 in chips) 
SD HAMMER: posts small blind $0.05
jimeshka: posts big blind $0.10
KiraLasVegas: sits out 
*** HOLE CARDS ***
bobobabi: folds 
19991986830: calls $0.10
marcin116: folds 
SD HAMMER: folds 
jimeshka: checks 
*** FLOP *** [8c 4d 4h]
jimeshka: checks 
19991986830: checks 
*** TURN *** [8c 4d 4h] [9h]
jimeshka: bets $0.10
19991986830: raises $0.30 to $0.40
jimeshka: calls $0.30
*** RIVER *** [8c 4d 4h 9h] [4c]
jimeshka: checks 
19991986830: checks 
*** SHOW DOWN ***
jimeshka: shows [Kh 5c] (three of a kind, Fours)
19991986830: mucks hand 
jimeshka collected $1 from pot
*** SUMMARY ***
Total pot $1.05 | Rake $0.05 
Board [8c 4d 4h 9h 4c]
Seat 1: 19991986830 mucked
Seat 2: marcin116 (button) folded before Flop (didn't bet)
Seat 3: SD HAMMER (small blind) folded before Flop
Seat 4: jimeshka (big blind) showed [Kh 5c] and won ($1) with three of a kind, Fours
Seat 5: bobobabi folded before Flop (didn't bet)



PokerStars Hand #222978704424:  Hold'em No Limit ($0.05/$0.10 USD) - 2021/01/23 18:53:21 ET
Table 'Jihlava III' 6-max Seat #3 is the button
Seat 1: 19991986830 ($44.34 in chips) 
Seat 2: marcin116 ($14.89 in chips) 
Seat 3: SD HAMMER ($13.30 in chips) 
Seat 4: jimeshka ($10.79 in chips) 
Seat 5: bobobabi ($9.85 in chips) 
jimeshka: posts small blind $0.05
bobobabi: posts big blind $0.10
KiraLasVegas: sits out 
*** HOLE CARDS ***
19991986830: raises $0.30 to $0.40
marcin116: folds 
SD HAMMER: folds 
jimeshka: calls $0.35
bobobabi: folds 
*** FLOP *** [Qh 6h 7d]
jimeshka: checks 
19991986830: bets $0.30
jimeshka: calls $0.30
*** TURN *** [Qh 6h 7d] [2s]
jimeshka: checks 
19991986830: bets $0.40
jimeshka: calls $0.40
*** RIVER *** [Qh 6h 7d 2s] [6d]
jimeshka: checks 
19991986830: bets $1.10
jimeshka: folds 
Uncalled bet ($1.10) returned to 19991986830
19991986830 collected $2.20 from pot
*** SUMMARY ***
Total pot $2.30 | Rake $0.10 
Board [Qh 6h 7d 2s 6d]
Seat 1: 19991986830 collected ($2.20)
Seat 2: marcin116 folded before Flop (didn't bet)
Seat 3: SD HAMMER (button) folded before Flop (didn't bet)
Seat 4: jimeshka (small blind) folded on the River
Seat 5: bobobabi (big blind) folded before Flop



PokerStars Hand #222978729386:  Hold'em No Limit ($0.05/$0.10 USD) - 2021/01/23 18:54:03 ET
Table 'Jihlava III' 6-max Seat #4 is the button
Seat 1: 19991986830 ($45.44 in chips) 
Seat 2: marcin116 ($14.89 in chips) 
Seat 3: SD HAMMER ($13.30 in chips) 
Seat 4: jimeshka ($9.69 in chips) 
Seat 5: bobobabi ($9.75 in chips) 
Seat 6: KiraLasVegas ($10 in chips) 
bobobabi: posts small blind $0.05
KiraLasVegas: posts big blind $0.10
*** HOLE CARDS ***
19991986830: raises $0.40 to $0.50
marcin116: folds 
SD HAMMER: folds 
jimeshka: folds 
bobobabi: folds 
KiraLasVegas: calls $0.40
*** FLOP *** [2d 4c 3d]
KiraLasVegas: checks 
19991986830: bets $0.50
KiraLasVegas: folds 
Uncalled bet ($0.50) returned to 19991986830
19991986830 collected $1 from pot
*** SUMMARY ***
Total pot $1.05 | Rake $0.05 
Board [2d 4c 3d]
Seat 1: 19991986830 collected ($1)
Seat 2: marcin116 folded before Flop (didn't bet)
Seat 3: SD HAMMER folded before Flop (didn't bet)
Seat 4: jimeshka (button) folded before Flop (didn't bet)
Seat 5: bobobabi (small blind) folded before Flop
Seat 6: KiraLasVegas (big blind) folded on the Flop



PokerStars Hand #222978746461:  Hold'em No Limit ($0.05/$0.10 USD) - 2021/01/23 18:54:31 ET
Table 'Jihlava III' 6-max Seat #5 is the button
Seat 1: 19991986830 ($45.94 in chips) 
Seat 2: marcin116 ($14.89 in chips) 
Seat 3: SD HAMMER ($13.30 in chips) 
Seat 4: jimeshka ($9.69 in chips) 
Seat 5: bobobabi ($9.70 in chips) 
Seat 6: KiraLasVegas ($10 in chips) 
KiraLasVegas: posts small blind $0.05
19991986830: posts big blind $0.10
*** HOLE CARDS ***
marcin116: folds 
SD HAMMER: folds 
jimeshka: folds 
bobobabi: calls $0.10
KiraLasVegas: raises $0.20 to $0.30
19991986830: folds 
bobobabi: calls $0.20
*** FLOP *** [5h 5c Kd]
KiraLasVegas: checks 
bobobabi: checks 
*** TURN *** [5h 5c Kd] [5d]
KiraLasVegas: bets $0.23
bobobabi: folds 
Uncalled bet ($0.23) returned to KiraLasVegas
KiraLasVegas collected $0.67 from pot
KiraLasVegas: doesn't show hand 
*** SUMMARY ***
Total pot $0.70 | Rake $0.03 
Board [5h 5c Kd 5d]
Seat 1: 19991986830 (big blind) folded before Flop
Seat 2: marcin116 folded before Flop (didn't bet)
Seat 3: SD HAMMER folded before Flop (didn't bet)
Seat 4: jimeshka folded before Flop (didn't bet)
Seat 5: bobobabi (button) folded on the Turn
Seat 6: KiraLasVegas (small blind) collected ($0.67)



PokerStars Hand #222978769251:  Hold'em No Limit ($0.05/$0.10 USD) - 2021/01/23 18:55:10 ET
Table 'Jihlava III' 6-max Seat #6 is the button
Seat 1: 19991986830 ($45.84 in chips) 
Seat 2: marcin116 ($14.89 in chips) 
Seat 3: SD HAMMER ($13.30 in chips) 
Seat 4: jimeshka ($9.69 in chips) 
Seat 5: bobobabi ($9.40 in chips) 
Seat 6: KiraLasVegas ($10.37 in chips) 
19991986830: posts small blind $0.05
marcin116: posts big blind $0.10
*** HOLE CARDS ***
SD HAMMER: raises $0.20 to $0.30
jimeshka: folds 
bobobabi: calls $0.30
KiraLasVegas: folds 
19991986830: raises $0.20 to $0.50
marcin116: folds 
SD HAMMER: calls $0.20
bobobabi: calls $0.20
*** FLOP *** [8d 8c 2s]
19991986830: bets $0.50
SD HAMMER: calls $0.50
bobobabi: calls $0.50
*** TURN *** [8d 8c 2s] [9s]
19991986830: checks 
SD HAMMER: checks 
bobobabi: checks 
*** RIVER *** [8d 8c 2s 9s] [4c]
19991986830: checks 
SD HAMMER: checks 
bobobabi: bets $1.50
19991986830: folds 
SD HAMMER: folds 
Uncalled bet ($1.50) returned to bobobabi
bobobabi collected $2.96 from pot
bobobabi: doesn't show hand 
*** SUMMARY ***
Total pot $3.10 | Rake $0.14 
Board [8d 8c 2s 9s 4c]
Seat 1: 19991986830 (small blind) folded on the River
Seat 2: marcin116 (big blind) folded before Flop
Seat 3: SD HAMMER folded on the River
Seat 4: jimeshka folded before Flop (didn't bet)
Seat 5: bobobabi collected ($2.96)
Seat 6: KiraLasVegas (button) folded before Flop (didn't bet)



PokerStars Hand #222978798624:  Hold'em No Limit ($0.05/$0.10 USD) - 2021/01/23 18:56:16 ET
Table 'Jihlava III' 6-max Seat #1 is the button
Seat 1: 19991986830 ($44.84 in chips) 
Seat 2: marcin116 ($14.79 in chips) 
Seat 3: SD HAMMER ($12.30 in chips) 
Seat 4: jimeshka ($9.69 in chips) 
Seat 6: KiraLasVegas ($10.37 in chips) 
marcin116: posts small blind $0.05
SD HAMMER: posts big blind $0.10
*** HOLE CARDS ***
jimeshka: folds 
KiraLasVegas: folds 
19991986830: raises $0.30 to $0.40
marcin116: raises $0.90 to $1.30
SD HAMMER: folds 
19991986830: folds 
Uncalled bet ($0.90) returned to marcin116
marcin116 collected $0.90 from pot
marcin116: doesn't show hand 
*** SUMMARY ***
Total pot $0.90 | Rake $0 
Seat 1: 19991986830 (button) folded before Flop
Seat 2: marcin116 (small blind) collected ($0.90)
Seat 3: SD HAMMER (big blind) folded before Flop
Seat 4: jimeshka folded before Flop (didn't bet)
Seat 6: KiraLasVegas folded before Flop (didn't bet)



PokerStars Hand #222978806769:  Hold'em No Limit ($0.05/$0.10 USD) - 2021/01/23 18:56:34 ET
Table 'Jihlava III' 6-max Seat #2 is the button
Seat 1: 19991986830 ($44.44 in chips) 
Seat 2: marcin116 ($15.29 in chips) 
Seat 3: SD HAMMER ($12.20 in chips) 
Seat 4: jimeshka ($9.69 in chips) 
Seat 6: KiraLasVegas ($10.37 in chips) 
SD HAMMER: posts small blind $0.05
jimeshka: posts big blind $0.10
*** HOLE CARDS ***
KiraLasVegas: raises $0.15 to $0.25
19991986830: raises $0.15 to $0.40
marcin116: calls $0.40
SD HAMMER: folds 
jimeshka: folds 
KiraLasVegas: calls $0.15
*** FLOP *** [3c 9s 3s]
KiraLasVegas: checks 
19991986830: checks 
marcin116: checks 
*** TURN *** [3c 9s 3s] [7d]
KiraLasVegas: checks 
19991986830: bets $0.50
marcin116: calls $0.50
KiraLasVegas: folds 
*** RIVER *** [3c 9s 3s 7d] [Kc]
19991986830: bets $1.12
marcin116: folds 
Uncalled bet ($1.12) returned to 19991986830
19991986830 collected $2.24 from pot
*** SUMMARY ***
Total pot $2.35 | Rake $0.11 
Board [3c 9s 3s 7d Kc]
Seat 1: 19991986830 collected ($2.24)
Seat 2: marcin116 (button) folded on the River
Seat 3: SD HAMMER (small blind) folded before Flop
Seat 4: jimeshka (big blind) folded before Flop
Seat 6: KiraLasVegas folded on the Turn



PokerStars Hand #222978821908:  Hold'em No Limit ($0.05/$0.10 USD) - 2021/01/23 18:57:08 ET
Table 'Jihlava III' 6-max Seat #3 is the button
Seat 1: 19991986830 ($45.78 in chips) 
Seat 2: marcin116 ($14.39 in chips) 
Seat 3: SD HAMMER ($12.15 in chips) 
Seat 4: jimeshka ($9.59 in chips) 
Seat 6: KiraLasVegas ($10 in chips) 
jimeshka: posts small blind $0.05
KiraLasVegas: posts big blind $0.10
*** HOLE CARDS ***
19991986830: raises $0.30 to $0.40
marcin116: calls $0.40
SD HAMMER: folds 
jimeshka: folds 
KiraLasVegas: folds 
*** FLOP *** [5d 3h 8d]
19991986830: bets $0.50
marcin116: raises $0.91 to $1.41
19991986830: calls $0.91
*** TURN *** [5d 3h 8d] [Ts]
19991986830: checks 
marcin116: bets $2.52
19991986830: folds 
Uncalled bet ($2.52) returned to marcin116
marcin116 collected $3.60 from pot
marcin116: doesn't show hand 
*** SUMMARY ***
Total pot $3.77 | Rake $0.17 
Board [5d 3h 8d Ts]
Seat 1: 19991986830 folded on the Turn
Seat 2: marcin116 collected ($3.60)
Seat 3: SD HAMMER (button) folded before Flop (didn't bet)
Seat 4: jimeshka (small blind) folded before Flop
Seat 6: KiraLasVegas (big blind) folded before Flop



PokerStars Hand #222978837522:  Hold'em No Limit ($0.05/$0.10 USD) - 2021/01/23 18:57:43 ET
Table 'Jihlava III' 6-max Seat #4 is the button
Seat 1: 19991986830 ($43.97 in chips) 
Seat 2: marcin116 ($16.18 in chips) 
Seat 3: SD HAMMER ($12.15 in chips) 
Seat 4: jimeshka ($9.54 in chips) 
Seat 6: KiraLasVegas ($10 in chips) 
KiraLasVegas: posts small blind $0.05
19991986830: posts big blind $0.10
*** HOLE CARDS ***
marcin116: folds 
SD HAMMER: folds 
jimeshka: calls $0.10
KiraLasVegas: folds 
19991986830: raises $0.40 to $0.50
jimeshka: calls $0.40
*** FLOP *** [4s 5s Kh]
19991986830: checks 
jimeshka: checks 
*** TURN *** [4s 5s Kh] [9d]
19991986830: checks 
jimeshka: bets $0.30
19991986830: folds 
Uncalled bet ($0.30) returned to jimeshka
jimeshka collected $1 from pot
jimeshka: doesn't show hand 
*** SUMMARY ***
Total pot $1.05 | Rake $0.05 
Board [4s 5s Kh 9d]
Seat 1: 19991986830 (big blind) folded on the Turn
Seat 2: marcin116 folded before Flop (didn't bet)
Seat 3: SD HAMMER folded before Flop (didn't bet)
Seat 4: jimeshka (button) collected ($1)
Seat 6: KiraLasVegas (small blind) folded before Flop



PokerStars Hand #222978849859:  Hold'em No Limit ($0.05/$0.10 USD) - 2021/01/23 18:58:11 ET
Table 'Jihlava III' 6-max Seat #6 is the button
Seat 1: 19991986830 ($43.47 in chips) 
Seat 3: SD HAMMER ($12.15 in chips) 
Seat 4: jimeshka ($10.04 in chips) 
Seat 5: bobobabi ($11.36 in chips) 
Seat 6: KiraLasVegas ($10 in chips) 
19991986830: posts small blind $0.05
SD HAMMER: posts big blind $0.10
bobobabi: posts small & big blinds $0.15
*** HOLE CARDS ***
jimeshka: folds 
bobobabi: checks 
KiraLasVegas: folds 
19991986830: raises $0.40 to $0.50
SD HAMMER: calls $0.40
bobobabi: folds 
*** FLOP *** [As 7d 2d]
19991986830: checks 
SD HAMMER: bets $1.10
19991986830: folds 
Uncalled bet ($1.10) returned to SD HAMMER
SD HAMMER collected $1.10 from pot
SD HAMMER: doesn't show hand 
*** SUMMARY ***
Total pot $1.15 | Rake $0.05 
Board [As 7d 2d]
Seat 1: 19991986830 (small blind) folded on the Flop
Seat 3: SD HAMMER (big blind) collected ($1.10)
Seat 4: jimeshka folded before Flop (didn't bet)
Seat 5: bobobabi folded before Flop (didn't bet)
Seat 6: KiraLasVegas (button) folded before Flop (didn't bet)



PokerStars Hand #222978866356:  Hold'em No Limit ($0.05/$0.10 USD) - 2021/01/23 18:58:48 ET
Table 'Jihlava III' 6-max Seat #1 is the button
Seat 1: 19991986830 ($42.97 in chips) 
Seat 3: SD HAMMER ($12.75 in chips) 
Seat 4: jimeshka ($10.04 in chips) 
Seat 5: bobobabi ($11.21 in chips) 
Seat 6: KiraLasVegas ($10 in chips) 
SD HAMMER: posts small blind $0.05
jimeshka: posts big blind $0.10
*** HOLE CARDS ***
bobobabi: folds 
KiraLasVegas: folds 
19991986830: raises $0.40 to $0.50
SD HAMMER: folds 
jimeshka: folds 
Uncalled bet ($0.40) returned to 19991986830
19991986830 collected $0.25 from pot
*** SUMMARY ***
Total pot $0.25 | Rake $0 
Seat 1: 19991986830 (button) collected ($0.25)
Seat 3: SD HAMMER (small blind) folded before Flop
Seat 4: jimeshka (big blind) folded before Flop
Seat 5: bobobabi folded before Flop (didn't bet)
Seat 6: KiraLasVegas folded before Flop (didn't bet)



PokerStars Hand #222978872940:  Hold'em No Limit ($0.05/$0.10 USD) - 2021/01/23 18:59:03 ET
Table 'Jihlava III' 6-max Seat #3 is the button
Seat 1: 19991986830 ($43.12 in chips) 
Seat 3: SD HAMMER ($12.70 in chips) 
Seat 4: jimeshka ($9.94 in chips) 
Seat 5: bobobabi ($11.21 in chips) 
Seat 6: KiraLasVegas ($10 in chips) 
jimeshka: posts small blind $0.05
bobobabi: posts big blind $0.10
*** HOLE CARDS ***
KiraLasVegas: folds 
19991986830: raises $0.40 to $0.50
SD HAMMER: folds 
jimeshka: calls $0.45
bobobabi: folds 
*** FLOP *** [2h Jc 9s]
jimeshka: checks 
19991986830: bets $0.53
jimeshka: calls $0.53
*** TURN *** [2h Jc 9s] [Qc]
jimeshka: checks 
19991986830: bets $1.03
jimeshka: folds 
Uncalled bet ($1.03) returned to 19991986830
19991986830 collected $2.06 from pot
*** SUMMARY ***
Total pot $2.16 | Rake $0.10 
Board [2h Jc 9s Qc]
Seat 1: 19991986830 collected ($2.06)
Seat 3: SD HAMMER (button) folded before Flop (didn't bet)
Seat 4: jimeshka (small blind) folded on the Turn
Seat 5: bobobabi (big blind) folded before Flop
Seat 6: KiraLasVegas folded before Flop (didn't bet)



PokerStars Hand #222978887600:  Hold'em No Limit ($0.05/$0.10 USD) - 2021/01/23 18:59:36 ET
Table 'Jihlava III' 6-max Seat #4 is the button
Seat 1: 19991986830 ($44.15 in chips) 
Seat 3: SD HAMMER ($12.70 in chips) 
Seat 4: jimeshka ($8.91 in chips) 
Seat 6: KiraLasVegas ($10 in chips) 
KiraLasVegas: posts small blind $0.05
19991986830: posts big blind $0.10
*** HOLE CARDS ***
SD HAMMER: folds 
bobobabi leaves the table
jimeshka: calls $0.10
KiraLasVegas: calls $0.05
pudge.3096 joins the table at seat #5 
19991986830: raises $0.40 to $0.50
jimeshka: calls $0.40
KiraLasVegas: folds 
*** FLOP *** [9c 9h Tc]
19991986830: bets $0.53
jimeshka: calls $0.53
*** TURN *** [9c 9h Tc] [Kd]
19991986830: bets $1.03
jimeshka: calls $1.03
*** RIVER *** [9c 9h Tc Kd] [6h]
19991986830: checks 
jimeshka: checks 
*** SHOW DOWN ***
19991986830: shows [3h Ah] (a pair of Nines)
jimeshka: shows [7s 7c] (two pair, Nines and Sevens)
jimeshka collected $4.03 from pot
*** SUMMARY ***
Total pot $4.22 | Rake $0.19 
Board [9c 9h Tc Kd 6h]
Seat 1: 19991986830 (big blind) showed [3h Ah] and lost with a pair of Nines
Seat 3: SD HAMMER folded before Flop (didn't bet)
Seat 4: jimeshka (button) showed [7s 7c] and won ($4.03) with two pair, Nines and Sevens
Seat 6: KiraLasVegas (small blind) folded before Flop



PokerStars Hand #222978903793:  Hold'em No Limit ($0.05/$0.10 USD) - 2021/01/23 19:00:11 ET
Table 'Jihlava III' 6-max Seat #6 is the button
Seat 1: 19991986830 ($42.09 in chips) 
Seat 3: SD HAMMER ($12.70 in chips) 
Seat 4: jimeshka ($10.88 in chips) 
Seat 6: KiraLasVegas ($10 in chips) 
19991986830: posts small blind $0.05
SD HAMMER: posts big blind $0.10
pudge.3096: sits out 
*** HOLE CARDS ***
jimeshka: calls $0.10
KiraLasVegas: folds 
19991986830: raises $0.40 to $0.50
SD HAMMER: folds 
jimeshka: calls $0.40
*** FLOP *** [9d Kc Ks]
19991986830: bets $0.53
jimeshka: calls $0.53
*** TURN *** [9d Kc Ks] [As]
19991986830: bets $1.03
jimeshka: folds 
Uncalled bet ($1.03) returned to 19991986830
19991986830 collected $2.06 from pot
*** SUMMARY ***
Total pot $2.16 | Rake $0.10 
Board [9d Kc Ks As]
Seat 1: 19991986830 (small blind) collected ($2.06)
Seat 3: SD HAMMER (big blind) folded before Flop
Seat 4: jimeshka folded on the Turn
Seat 6: KiraLasVegas (button) folded before Flop (didn't bet)



PokerStars Hand #222978925756:  Hold'em No Limit ($0.05/$0.10 USD) - 2021/01/23 19:00:55 ET
Table 'Jihlava III' 6-max Seat #1 is the button
Seat 1: 19991986830 ($43.12 in chips) 
Seat 3: SD HAMMER ($12.60 in chips) 
Seat 4: jimeshka ($9.85 in chips) 
Seat 6: KiraLasVegas ($10 in chips) 
SD HAMMER: posts small blind $0.05
jimeshka: posts big blind $0.10
pudge.3096: sits out 
*** HOLE CARDS ***
KiraLasVegas: folds 
19991986830: raises $0.40 to $0.50
SD HAMMER: folds 
jimeshka: calls $0.40
*** FLOP *** [6c 5s 9d]
jimeshka: checks 
19991986830: bets $0.50
jimeshka: calls $0.50
*** TURN *** [6c 5s 9d] [3h]
jimeshka: checks 
19991986830: bets $0.98
jimeshka: calls $0.98
*** RIVER *** [6c 5s 9d 3h] [7h]
jimeshka: checks 
19991986830: bets $3.83
jimeshka: calls $3.83
*** SHOW DOWN ***
19991986830: shows [6d 8d] (a straight, Five to Nine)
jimeshka: mucks hand 
19991986830 collected $11.14 from pot
*** SUMMARY ***
Total pot $11.67 | Rake $0.53 
Board [6c 5s 9d 3h 7h]
Seat 1: 19991986830 (button) showed [6d 8d] and won ($11.14) with a straight, Five to Nine
Seat 3: SD HAMMER (small blind) folded before Flop
Seat 4: jimeshka (big blind) mucked
Seat 6: KiraLasVegas folded before Flop (didn't bet)



PokerStars Hand #222978958151:  Hold'em No Limit ($0.05/$0.10 USD) - 2021/01/23 19:01:53 ET
Table 'Jihlava III' 6-max Seat #3 is the button
Seat 3: SD HAMMER ($12.55 in chips) 
Seat 4: jimeshka ($4.04 in chips) 
Seat 5: pudge.3096 ($10 in chips) 
Seat 6: KiraLasVegas ($10 in chips) 
jimeshka: posts small blind $0.05
pudge.3096: posts big blind $0.10
*** HOLE CARDS ***
KiraLasVegas: raises $0.20 to $0.30
SD HAMMER: folds 
jimeshka: folds 
pudge.3096: folds 
Uncalled bet ($0.20) returned to KiraLasVegas
19991986830 leaves the table
KiraLasVegas collected $0.25 from pot
KiraLasVegas: doesn't show hand 
*** SUMMARY ***
Total pot $0.25 | Rake $0 
Seat 3: SD HAMMER (button) folded before Flop (didn't bet)
Seat 4: jimeshka (small blind) folded before Flop
Seat 5: pudge.3096 (big blind) folded before Flop
Seat 6: KiraLasVegas collected ($0.25)



PokerStars Hand #222978964481:  Hold'em No Limit ($0.05/$0.10 USD) - 2021/01/23 19:02:04 ET
Table 'Jihlava III' 6-max Seat #4 is the button
Seat 3: SD HAMMER ($12.55 in chips) 
Seat 4: jimeshka ($3.99 in chips) 
Seat 5: pudge.3096 ($10 in chips) 
Seat 6: KiraLasVegas ($10.15 in chips) 
pudge.3096: posts small blind $0.05
KiraLasVegas: posts big blind $0.10
marcin116: sits out 
*** HOLE CARDS ***
SD HAMMER: folds 
marcin116 leaves the table
jimeshka: calls $0.10
pudge.3096: raises $0.40 to $0.50
KiraLasVegas: folds 
jimeshka: calls $0.40
*** FLOP *** [5d 5s Ks]
pudge.3096: bets $0.34
jimeshka: calls $0.34
*** TURN *** [5d 5s Ks] [4s]
JerryxzDeity joins the table at seat #2 
pudge.3096: checks 
jimeshka: bets $1.70
pudge.3096: folds 
Uncalled bet ($1.70) returned to jimeshka
jimeshka collected $1.70 from pot
jimeshka: doesn't show hand 
*** SUMMARY ***
Total pot $1.78 | Rake $0.08 
Board [5d 5s Ks 4s]
Seat 3: SD HAMMER folded before Flop (didn't bet)
Seat 4: jimeshka (button) collected ($1.70)
Seat 5: pudge.3096 (small blind) folded on the Turn
Seat 6: KiraLasVegas (big blind) folded before Flop



PokerStars Hand #222978982144:  Hold'em No Limit ($0.05/$0.10 USD) - 2021/01/23 19:02:34 ET
Table 'Jihlava III' 6-max Seat #5 is the button
Seat 2: JerryxzDeity ($10 in chips) 
Seat 3: SD HAMMER ($12.55 in chips) 
Seat 4: jimeshka ($4.85 in chips) 
Seat 5: pudge.3096 ($10 in chips) 
Seat 6: KiraLasVegas ($10.05 in chips) 
KiraLasVegas: posts small blind $0.05
JerryxzDeity: posts big blind $0.10
*** HOLE CARDS ***
SD HAMMER: folds 
jimeshka: folds 
pudge.3096: raises $0.15 to $0.25
KiraLasVegas: folds 
No1Sparkles joins the table at seat #1 
JerryxzDeity: folds 
Uncalled bet ($0.15) returned to pudge.3096
pudge.3096 collected $0.25 from pot
pudge.3096: doesn't show hand 
*** SUMMARY ***
Total pot $0.25 | Rake $0 
Seat 2: JerryxzDeity (big blind) folded before Flop
Seat 3: SD HAMMER folded before Flop (didn't bet)
Seat 4: jimeshka folded before Flop (didn't bet)
Seat 5: pudge.3096 (button) collected ($0.25)
Seat 6: KiraLasVegas (small blind) folded before Flop



PokerStars Hand #222978991316:  Hold'em No Limit ($0.05/$0.10 USD) - 2021/01/23 19:02:51 ET
Table 'Jihlava III' 6-max Seat #6 is the button
Seat 2: JerryxzDeity ($10 in chips) 
Seat 3: SD HAMMER ($12.55 in chips) 
Seat 4: jimeshka ($4.85 in chips) 
Seat 5: pudge.3096 ($10.15 in chips) 
Seat 6: KiraLasVegas ($10 in chips) 
JerryxzDeity: posts small blind $0.05
SD HAMMER: posts big blind $0.10
*** HOLE CARDS ***
jimeshka: folds 
pudge.3096: folds 
KiraLasVegas: folds 
JerryxzDeity: folds 
Uncalled bet ($0.05) returned to SD HAMMER
SD HAMMER collected $0.10 from pot
SD HAMMER: doesn't show hand 
*** SUMMARY ***
Total pot $0.10 | Rake $0 
Seat 2: JerryxzDeity (small blind) folded before Flop
Seat 3: SD HAMMER (big blind) collected ($0.10)
Seat 4: jimeshka folded before Flop (didn't bet)
Seat 5: pudge.3096 folded before Flop (didn't bet)
Seat 6: KiraLasVegas (button) folded before Flop (didn't bet)



PokerStars Hand #222978997608:  Hold'em No Limit ($0.05/$0.10 USD) - 2021/01/23 19:03:01 ET
Table 'Jihlava III' 6-max Seat #2 is the button
Seat 2: JerryxzDeity ($10 in chips) 
Seat 3: SD HAMMER ($12.60 in chips) 
Seat 4: jimeshka ($4.85 in chips) 
Seat 5: pudge.3096 ($10.15 in chips) 
Seat 6: KiraLasVegas ($10 in chips) 
SD HAMMER: posts small blind $0.05
jimeshka: posts big blind $0.10
No1Sparkles: sits out 
*** HOLE CARDS ***
pudge.3096: folds 
pudge.3096 was removed from the table for failing to post
pudge.3096 leaves the table
KiraLasVegas: folds 
JerryxzDeity: folds 
SD HAMMER: folds 
Uncalled bet ($0.05) returned to jimeshka
jimeshka collected $0.10 from pot
jimeshka: doesn't show hand 
*** SUMMARY ***
Total pot $0.10 | Rake $0 
Seat 2: JerryxzDeity (button) folded before Flop (didn't bet)
Seat 3: SD HAMMER (small blind) folded before Flop
Seat 4: jimeshka (big blind) collected ($0.10)
Seat 5: pudge.3096 folded before Flop (didn't bet)
Seat 6: KiraLasVegas folded before Flop (didn't bet)



PokerStars Hand #222979003895:  Hold'em No Limit ($0.05/$0.10 USD) - 2021/01/23 19:03:12 ET
Table 'Jihlava III' 6-max Seat #3 is the button
Seat 1: No1Sparkles ($10.81 in chips) 
Seat 2: JerryxzDeity ($10 in chips) 
Seat 3: SD HAMMER ($12.55 in chips) 
Seat 4: jimeshka ($4.90 in chips) 
jimeshka: posts small blind $0.05
KiraLasVegas: is sitting out 
No1Sparkles: posts big blind $0.10
*** HOLE CARDS ***
JerryxzDeity: folds 
fyllejon joins the table at seat #5 
SD HAMMER: folds 
jimeshka: calls $0.05
No1Sparkles: checks 
*** FLOP *** [8h 6s Qs]
jimeshka: checks 
No1Sparkles: checks 
*** TURN *** [8h 6s Qs] [8c]
jimeshka: bets $0.10
No1Sparkles: folds 
Uncalled bet ($0.10) returned to jimeshka
jimeshka collected $0.19 from pot
jimeshka: doesn't show hand 
*** SUMMARY ***
Total pot $0.20 | Rake $0.01 
Board [8h 6s Qs 8c]
Seat 1: No1Sparkles (big blind) folded on the Turn
Seat 2: JerryxzDeity folded before Flop (didn't bet)
Seat 3: SD HAMMER (button) folded before Flop (didn't bet)
Seat 4: jimeshka (small blind) collected ($0.19)



PokerStars Hand #222979014819:  Hold'em No Limit ($0.05/$0.10 USD) - 2021/01/23 19:03:31 ET
Table 'Jihlava III' 6-max Seat #4 is the button
Seat 1: No1Sparkles ($10.71 in chips) 
Seat 2: JerryxzDeity ($10 in chips) 
Seat 3: SD HAMMER ($12.55 in chips) 
Seat 4: jimeshka ($4.99 in chips) 
No1Sparkles: posts small blind $0.05
JerryxzDeity: posts big blind $0.10
*** HOLE CARDS ***
SD HAMMER: folds 
jimeshka: folds 
No1Sparkles: raises $0.20 to $0.30
JerryxzDeity: folds 
Uncalled bet ($0.20) returned to No1Sparkles
No1Sparkles collected $0.20 from pot
No1Sparkles: doesn't show hand 
*** SUMMARY ***
Total pot $0.20 | Rake $0 
Seat 1: No1Sparkles (small blind) collected ($0.20)
Seat 2: JerryxzDeity (big blind) folded before Flop
Seat 3: SD HAMMER folded before Flop (didn't bet)
Seat 4: jimeshka (button) folded before Flop (didn't bet)



PokerStars Hand #222979022416:  Hold'em No Limit ($0.05/$0.10 USD) - 2021/01/23 19:03:44 ET
Table 'Jihlava III' 6-max Seat #1 is the button
Seat 1: No1Sparkles ($10.81 in chips) 
Seat 2: JerryxzDeity ($10 in chips) 
Seat 3: SD HAMMER ($12.55 in chips) 
Seat 4: jimeshka ($4.99 in chips) 
Seat 5: fyllejon ($10 in chips) 
JerryxzDeity: posts small blind $0.05
SD HAMMER: posts big blind $0.10
fyllejon: posts big blind $0.10
*** HOLE CARDS ***
jimeshka: folds 
fyllejon: checks 
No1Sparkles: raises $0.30 to $0.40
JerryxzDeity: calls $0.35
SD HAMMER: folds 
fyllejon: calls $0.30
*** FLOP *** [4d Td Js]
JerryxzDeity: checks 
fyllejon: checks 
No1Sparkles: checks 
*** TURN *** [4d Td Js] [3s]
JerryxzDeity: bets $0.60
fyllejon: calls $0.60
No1Sparkles: calls $0.60
*** RIVER *** [4d Td Js 3s] [5h]
JerryxzDeity: checks 
fyllejon: checks 
No1Sparkles: checks 
*** SHOW DOWN ***
JerryxzDeity: shows [Ac Tc] (a pair of Tens)
fyllejon: mucks hand 
No1Sparkles: mucks hand 
JerryxzDeity collected $2.96 from pot
*** SUMMARY ***
Total pot $3.10 | Rake $0.14 
Board [4d Td Js 3s 5h]
Seat 1: No1Sparkles (button) mucked
Seat 2: JerryxzDeity (small blind) showed [Ac Tc] and won ($2.96) with a pair of Tens
Seat 3: SD HAMMER (big blind) folded before Flop
Seat 4: jimeshka folded before Flop (didn't bet)
Seat 5: fyllejon mucked



PokerStars Hand #222979071864:  Hold'em No Limit ($0.05/$0.10 USD) - 2021/01/23 19:04:58 ET
Table 'Jihlava III' 6-max Seat #2 is the button
Seat 1: No1Sparkles ($10 in chips) 
Seat 2: JerryxzDeity ($11.96 in chips) 
Seat 3: SD HAMMER ($12.45 in chips) 
Seat 5: fyllejon ($9 in chips) 
SD HAMMER: posts small blind $0.05
fyllejon: posts big blind $0.10
*** HOLE CARDS ***
No1Sparkles: folds 
JerryxzDeity: folds 
SD HAMMER: raises $0.20 to $0.30
fyllejon: calls $0.20
*** FLOP *** [2s Qh 4s]
SD HAMMER: bets $0.40
fyllejon: folds 
Uncalled bet ($0.40) returned to SD HAMMER
SD HAMMER collected $0.57 from pot
SD HAMMER: doesn't show hand 
*** SUMMARY ***
Total pot $0.60 | Rake $0.03 
Board [2s Qh 4s]
Seat 1: No1Sparkles folded before Flop (didn't bet)
Seat 2: JerryxzDeity (button) folded before Flop (didn't bet)
Seat 3: SD HAMMER (small blind) collected ($0.57)
Seat 5: fyllejon (big blind) folded on the Flop



PokerStars Hand #222979083929:  Hold'em No Limit ($0.05/$0.10 USD) - 2021/01/23 19:05:18 ET
Table 'Jihlava III' 6-max Seat #3 is the button
Seat 1: No1Sparkles ($10 in chips) 
Seat 2: JerryxzDeity ($11.96 in chips) 
Seat 3: SD HAMMER ($12.72 in chips) 
Seat 5: fyllejon ($8.70 in chips) 
fyllejon: posts small blind $0.05
No1Sparkles: posts big blind $0.10
*** HOLE CARDS ***
JerryxzDeity: folds 
SD HAMMER: folds 
fyllejon: folds 
Uncalled bet ($0.05) returned to No1Sparkles
No1Sparkles collected $0.10 from pot
No1Sparkles: doesn't show hand 
*** SUMMARY ***
Total pot $0.10 | Rake $0 
Seat 1: No1Sparkles (big blind) collected ($0.10)
Seat 2: JerryxzDeity folded before Flop (didn't bet)
Seat 3: SD HAMMER (button) folded before Flop (didn't bet)
Seat 5: fyllejon (small blind) folded before Flop



PokerStars Hand #222979089339:  Hold'em No Limit ($0.05/$0.10 USD) - 2021/01/23 19:05:27 ET
Table 'Jihlava III' 6-max Seat #5 is the button
Seat 1: No1Sparkles ($10.05 in chips) 
Seat 2: JerryxzDeity ($11.96 in chips) 
Seat 3: SD HAMMER ($12.72 in chips) 
Seat 5: fyllejon ($8.65 in chips) 
No1Sparkles: posts small blind $0.05
JerryxzDeity: posts big blind $0.10
*** HOLE CARDS ***
SD HAMMER: folds 
fyllejon: folds 
No1Sparkles: folds 
Uncalled bet ($0.05) returned to JerryxzDeity
JerryxzDeity collected $0.10 from pot
*** SUMMARY ***
Total pot $0.10 | Rake $0 
Seat 1: No1Sparkles (small blind) folded before Flop
Seat 2: JerryxzDeity (big blind) collected ($0.10)
Seat 3: SD HAMMER folded before Flop (didn't bet)
Seat 5: fyllejon (button) folded before Flop (didn't bet)



PokerStars Hand #222979093605:  Hold'em No Limit ($0.05/$0.10 USD) - 2021/01/23 19:05:34 ET
Table 'Jihlava III' 6-max Seat #1 is the button
Seat 1: No1Sparkles ($10 in chips) 
Seat 2: JerryxzDeity ($12.01 in chips) 
Seat 3: SD HAMMER ($12.72 in chips) 
Seat 5: fyllejon ($8.65 in chips) 
JerryxzDeity: posts small blind $0.05
SD HAMMER: posts big blind $0.10
*** HOLE CARDS ***
fyllejon: folds 
KiraLasVegas leaves the table
No1Sparkles: folds 
JerryxzDeity: folds 
Uncalled bet ($0.05) returned to SD HAMMER
JerryxzDeity was removed from the table for failing to post
JerryxzDeity leaves the table
SD HAMMER collected $0.10 from pot
SD HAMMER: doesn't show hand 
*** SUMMARY ***
Total pot $0.10 | Rake $0 
Seat 1: No1Sparkles (button) folded before Flop (didn't bet)
Seat 2: JerryxzDeity (small blind) folded before Flop
Seat 3: SD HAMMER (big blind) collected ($0.10)
Seat 5: fyllejon folded before Flop (didn't bet)



PokerStars Hand #222979099807:  Hold'em No Limit ($0.05/$0.10 USD) - 2021/01/23 19:05:45 ET
Table 'Jihlava III' 6-max Seat #3 is the button
Seat 1: No1Sparkles ($10 in chips) 
Seat 3: SD HAMMER ($12.77 in chips) 
Seat 5: fyllejon ($8.65 in chips) 
fyllejon: posts small blind $0.05
No1Sparkles: posts big blind $0.10
*** HOLE CARDS ***
SD HAMMER: raises $0.20 to $0.30
fyllejon: calls $0.25
No1Sparkles: folds 
*** FLOP *** [Tc Th Qh]
fyllejon: checks 
SD HAMMER: bets $0.40
fyllejon: calls $0.40
*** TURN *** [Tc Th Qh] [4c]
fyllejon: checks 
SD HAMMER: checks 
*** RIVER *** [Tc Th Qh 4c] [7s]
fyllejon: checks 
SD HAMMER: checks 
*** SHOW DOWN ***
fyllejon: shows [Qs Qd] (a full house, Queens full of Tens)
SD HAMMER: mucks hand 
fyllejon collected $1.43 from pot
*** SUMMARY ***
Total pot $1.50 | Rake $0.07 
Board [Tc Th Qh 4c 7s]
Seat 1: No1Sparkles (big blind) folded before Flop
Seat 3: SD HAMMER (button) mucked
Seat 5: fyllejon (small blind) showed [Qs Qd] and won ($1.43) with a full house, Queens full of Tens



PokerStars Hand #222979116686:  Hold'em No Limit ($0.05/$0.10 USD) - 2021/01/23 19:06:14 ET
Table 'Jihlava III' 6-max Seat #5 is the button
Seat 1: No1Sparkles ($10 in chips) 
Seat 3: SD HAMMER ($12.07 in chips) 
Seat 5: fyllejon ($9.38 in chips) 
No1Sparkles: posts small blind $0.05
SD HAMMER: posts big blind $0.10
*** HOLE CARDS ***
fyllejon: folds 
No1Sparkles: folds 
Uncalled bet ($0.05) returned to SD HAMMER
SD HAMMER collected $0.10 from pot
SD HAMMER: doesn't show hand 
*** SUMMARY ***
Total pot $0.10 | Rake $0 
Seat 1: No1Sparkles (small blind) folded before Flop
Seat 3: SD HAMMER (big blind) collected ($0.10)
Seat 5: fyllejon (button) folded before Flop (didn't bet)



PokerStars Hand #222979120754:  Hold'em No Limit ($0.05/$0.10 USD) - 2021/01/23 19:06:21 ET
Table 'Jihlava III' 6-max Seat #1 is the button
Seat 1: No1Sparkles ($10 in chips) 
Seat 3: SD HAMMER ($12.12 in chips) 
Seat 5: fyllejon ($9.38 in chips) 
SD HAMMER: posts small blind $0.05
fyllejon: posts big blind $0.10
*** HOLE CARDS ***
No1Sparkles: folds 
JJOOKKEER 77 joins the table at seat #2 
SD HAMMER: raises $0.20 to $0.30
fyllejon: raises $0.20 to $0.50
SD HAMMER: calls $0.20
*** FLOP *** [9s Qs Ks]
SD HAMMER: checks 
fyllejon: bets $0.50
SD HAMMER: folds 
Uncalled bet ($0.50) returned to fyllejon
fyllejon collected $0.96 from pot
fyllejon: doesn't show hand 
*** SUMMARY ***
Total pot $1 | Rake $0.04 
Board [9s Qs Ks]
Seat 1: No1Sparkles (button) folded before Flop (didn't bet)
Seat 3: SD HAMMER (small blind) folded on the Flop
Seat 5: fyllejon (big blind) collected ($0.96)



PokerStars Hand #222979135307:  Hold'em No Limit ($0.05/$0.10 USD) - 2021/01/23 19:06:46 ET
Table 'Jihlava III' 6-max Seat #3 is the button
Seat 1: No1Sparkles ($10 in chips) 
Seat 3: SD HAMMER ($11.62 in chips) 
Seat 5: fyllejon ($9.84 in chips) 
fyllejon: posts small blind $0.05
No1Sparkles: posts big blind $0.10
JJOOKKEER 77: sits out 
*** HOLE CARDS ***
SD HAMMER: raises $0.20 to $0.30
fyllejon: folds 
No1Sparkles: folds 
Uncalled bet ($0.20) returned to SD HAMMER
SD HAMMER collected $0.25 from pot
SD HAMMER: doesn't show hand 
*** SUMMARY ***
Total pot $0.25 | Rake $0 
Seat 1: No1Sparkles (big blind) folded before Flop
Seat 3: SD HAMMER (button) collected ($0.25)
Seat 5: fyllejon (small blind) folded before Flop



PokerStars Hand #222979141090:  Hold'em No Limit ($0.05/$0.10 USD) - 2021/01/23 19:06:56 ET
Table 'Jihlava III' 6-max Seat #5 is the button
Seat 1: No1Sparkles ($10 in chips) 
Seat 2: JJOOKKEER 77 ($4 in chips) 
Seat 3: SD HAMMER ($11.77 in chips) 
Seat 4: jimeshka ($4.99 in chips) 
Seat 5: fyllejon ($9.79 in chips) 
No1Sparkles: posts small blind $0.05
JJOOKKEER 77: posts big blind $0.10
jimeshka: posts small & big blinds $0.15
*** HOLE CARDS ***
SD HAMMER: raises $0.20 to $0.30
jimeshka: calls $0.20
fyllejon: folds 
No1Sparkles: folds 
JJOOKKEER 77: folds 
*** FLOP *** [Kc As Jh]
SD HAMMER: bets $0.76
jimeshka: calls $0.76
*** TURN *** [Kc As Jh] [Js]
SD HAMMER: bets $1.11
jimeshka: folds 
Uncalled bet ($1.11) returned to SD HAMMER
SD HAMMER collected $2.22 from pot
SD HAMMER: doesn't show hand 
*** SUMMARY ***
Total pot $2.32 | Rake $0.10 
Board [Kc As Jh Js]
Seat 1: No1Sparkles (small blind) folded before Flop
Seat 2: JJOOKKEER 77 (big blind) folded before Flop
Seat 3: SD HAMMER collected ($2.22)
Seat 4: jimeshka folded on the Turn
Seat 5: fyllejon (button) folded before Flop (didn't bet)



PokerStars Hand #222979171787:  Hold'em No Limit ($0.05/$0.10 USD) - 2021/01/23 19:07:33 ET
Table 'Jihlava III' 6-max Seat #1 is the button
Seat 1: No1Sparkles ($10 in chips) 
Seat 2: JJOOKKEER 77 ($3.90 in chips) 
Seat 3: SD HAMMER ($12.93 in chips) 
Seat 4: jimeshka ($3.88 in chips) 
Seat 5: fyllejon ($9.79 in chips) 
JJOOKKEER 77: posts small blind $0.05
SD HAMMER: posts big blind $0.10
*** HOLE CARDS ***
jimeshka: raises $0.10 to $0.20
fyllejon: folds 
No1Sparkles: folds 
JJOOKKEER 77: calls $0.15
SD HAMMER: folds 
*** FLOP *** [Th Jc 4h]
JJOOKKEER 77: checks 
jimeshka: bets $0.24
JJOOKKEER 77: folds 
Uncalled bet ($0.24) returned to jimeshka
jimeshka collected $0.48 from pot
jimeshka: doesn't show hand 
*** SUMMARY ***
Total pot $0.50 | Rake $0.02 
Board [Th Jc 4h]
Seat 1: No1Sparkles (button) folded before Flop (didn't bet)
Seat 2: JJOOKKEER 77 (small blind) folded on the Flop
Seat 3: SD HAMMER (big blind) folded before Flop
Seat 4: jimeshka collected ($0.48)
Seat 5: fyllejon folded before Flop (didn't bet)



PokerStars Hand #222979186286:  Hold'em No Limit ($0.05/$0.10 USD) - 2021/01/23 19:07:59 ET
Table 'Jihlava III' 6-max Seat #2 is the button
Seat 1: No1Sparkles ($10 in chips) 
Seat 2: JJOOKKEER 77 ($3.70 in chips) 
Seat 3: SD HAMMER ($12.83 in chips) 
Seat 4: jimeshka ($4.16 in chips) 
Seat 5: fyllejon ($9.79 in chips) 
SD HAMMER: posts small blind $0.05
jimeshka: posts big blind $0.10
*** HOLE CARDS ***
fyllejon: folds 
No1Sparkles: folds 
JJOOKKEER 77: folds 
SD HAMMER: raises $0.20 to $0.30
jimeshka: calls $0.20
*** FLOP *** [2d 9c 9h]
SD HAMMER: bets $0.57
jimeshka: folds 
Uncalled bet ($0.57) returned to SD HAMMER
SD HAMMER collected $0.57 from pot
SD HAMMER: doesn't show hand 
*** SUMMARY ***
Total pot $0.60 | Rake $0.03 
Board [2d 9c 9h]
Seat 1: No1Sparkles folded before Flop (didn't bet)
Seat 2: JJOOKKEER 77 (button) folded before Flop (didn't bet)
Seat 3: SD HAMMER (small blind) collected ($0.57)
Seat 4: jimeshka (big blind) folded on the Flop
Seat 5: fyllejon folded before Flop (didn't bet)



PokerStars Hand #222979196732:  Hold'em No Limit ($0.05/$0.10 USD) - 2021/01/23 19:08:18 ET
Table 'Jihlava III' 6-max Seat #3 is the button
Seat 1: No1Sparkles ($10 in chips) 
Seat 2: JJOOKKEER 77 ($3.70 in chips) 
Seat 3: SD HAMMER ($13.10 in chips) 
Seat 4: jimeshka ($3.86 in chips) 
Seat 5: fyllejon ($9.79 in chips) 
jimeshka: posts small blind $0.05
fyllejon: posts big blind $0.10
*** HOLE CARDS ***
No1Sparkles: folds 
JJOOKKEER 77: folds 
SD HAMMER: folds 
jimeshka: calls $0.05
fyllejon: checks 
*** FLOP *** [Ad 7c 2d]
pmakise joins the table at seat #6 
jimeshka: checks 
fyllejon: bets $0.10
jimeshka: folds 
Uncalled bet ($0.10) returned to fyllejon
fyllejon collected $0.19 from pot
fyllejon: doesn't show hand 
*** SUMMARY ***
Total pot $0.20 | Rake $0.01 
Board [Ad 7c 2d]
Seat 1: No1Sparkles folded before Flop (didn't bet)
Seat 2: JJOOKKEER 77 folded before Flop (didn't bet)
Seat 3: SD HAMMER (button) folded before Flop (didn't bet)
Seat 4: jimeshka (small blind) folded on the Flop
Seat 5: fyllejon (big blind) collected ($0.19)



PokerStars Hand #222979206740:  Hold'em No Limit ($0.05/$0.10 USD) - 2021/01/23 19:08:35 ET
Table 'Jihlava III' 6-max Seat #4 is the button
Seat 1: No1Sparkles ($10 in chips) 
Seat 2: JJOOKKEER 77 ($3.70 in chips) 
Seat 3: SD HAMMER ($13.10 in chips) 
Seat 4: jimeshka ($3.76 in chips) 
Seat 5: fyllejon ($9.88 in chips) 
Seat 6: pmakise ($10 in chips) 
fyllejon: posts small blind $0.05
pmakise: posts big blind $0.10
*** HOLE CARDS ***
No1Sparkles: folds 
JJOOKKEER 77: raises $0.20 to $0.30
SD HAMMER: folds 
jimeshka: folds 
fyllejon: folds 
pmakise: calls $0.20
*** FLOP *** [Td 3s Kd]
pmakise: checks 
JJOOKKEER 77: bets $0.40
pmakise: folds 
Uncalled bet ($0.40) returned to JJOOKKEER 77
JJOOKKEER 77 collected $0.62 from pot
*** SUMMARY ***
Total pot $0.65 | Rake $0.03 
Board [Td 3s Kd]
Seat 1: No1Sparkles folded before Flop (didn't bet)
Seat 2: JJOOKKEER 77 collected ($0.62)
Seat 3: SD HAMMER folded before Flop (didn't bet)
Seat 4: jimeshka (button) folded before Flop (didn't bet)
Seat 5: fyllejon (small blind) folded before Flop
Seat 6: pmakise (big blind) folded on the Flop



PokerStars Hand #222979220115:  Hold'em No Limit ($0.05/$0.10 USD) - 2021/01/23 19:08:59 ET
Table 'Jihlava III' 6-max Seat #5 is the button
Seat 1: No1Sparkles ($10 in chips) 
Seat 2: JJOOKKEER 77 ($4.02 in chips) 
Seat 3: SD HAMMER ($13.10 in chips) 
Seat 4: jimeshka ($3.76 in chips) 
Seat 5: fyllejon ($9.83 in chips) 
Seat 6: pmakise ($9.70 in chips) 
pmakise: posts small blind $0.05
No1Sparkles: posts big blind $0.10
*** HOLE CARDS ***
JJOOKKEER 77: folds 
SD HAMMER: folds 
jimeshka: folds 
fyllejon: raises $0.20 to $0.30
pmakise: raises $0.70 to $1
No1Sparkles: folds 
fyllejon: calls $0.70
*** FLOP *** [Kh 6d Tc]
pmakise: bets $0.70
fyllejon: raises $1.10 to $1.80
pmakise: folds 
Uncalled bet ($1.10) returned to fyllejon
fyllejon collected $3.34 from pot
fyllejon: doesn't show hand 
*** SUMMARY ***
Total pot $3.50 | Rake $0.16 
Board [Kh 6d Tc]
Seat 1: No1Sparkles (big blind) folded before Flop
Seat 2: JJOOKKEER 77 folded before Flop (didn't bet)
Seat 3: SD HAMMER folded before Flop (didn't bet)
Seat 4: jimeshka folded before Flop (didn't bet)
Seat 5: fyllejon (button) collected ($3.34)
Seat 6: pmakise (small blind) folded on the Flop



PokerStars Hand #222979243911:  Hold'em No Limit ($0.05/$0.10 USD) - 2021/01/23 19:09:42 ET
Table 'Jihlava III' 6-max Seat #6 is the button
Seat 1: No1Sparkles ($10 in chips) 
Seat 2: JJOOKKEER 77 ($4.02 in chips) 
Seat 3: SD HAMMER ($13.10 in chips) 
Seat 4: jimeshka ($3.76 in chips) 
Seat 5: fyllejon ($11.47 in chips) 
Seat 6: pmakise ($8 in chips) 
No1Sparkles: posts small blind $0.05
JJOOKKEER 77: posts big blind $0.10
*** HOLE CARDS ***
SD HAMMER: folds 
jimeshka: folds 
fyllejon: folds 
pmakise: folds 
No1Sparkles: folds 
Uncalled bet ($0.05) returned to JJOOKKEER 77
JJOOKKEER 77 collected $0.10 from pot
*** SUMMARY ***
Total pot $0.10 | Rake $0 
Seat 1: No1Sparkles (small blind) folded before Flop
Seat 2: JJOOKKEER 77 (big blind) collected ($0.10)
Seat 3: SD HAMMER folded before Flop (didn't bet)
Seat 4: jimeshka folded before Flop (didn't bet)
Seat 5: fyllejon folded before Flop (didn't bet)
Seat 6: pmakise (button) folded before Flop (didn't bet)



PokerStars Hand #222979252239:  Hold'em No Limit ($0.05/$0.10 USD) - 2021/01/23 19:09:56 ET
Table 'Jihlava III' 6-max Seat #1 is the button
Seat 1: No1Sparkles ($10 in chips) 
Seat 2: JJOOKKEER 77 ($4.07 in chips) 
Seat 4: jimeshka ($3.76 in chips) 
Seat 5: fyllejon ($11.47 in chips) 
Seat 6: pmakise ($8 in chips) 
JJOOKKEER 77: posts small blind $0.05
SD HAMMER: is sitting out 
SD HAMMER leaves the table
jimeshka: posts big blind $0.10
*** HOLE CARDS ***
fyllejon: folds 
pmakise: folds 
No1Sparkles: raises $0.20 to $0.30
JJOOKKEER 77: folds 
Marauder777 joins the table at seat #3 
jimeshka: folds 
Uncalled bet ($0.20) returned to No1Sparkles
No1Sparkles collected $0.25 from pot
No1Sparkles: doesn't show hand 
*** SUMMARY ***
Total pot $0.25 | Rake $0 
Seat 1: No1Sparkles (button) collected ($0.25)
Seat 2: JJOOKKEER 77 (small blind) folded before Flop
Seat 4: jimeshka (big blind) folded before Flop
Seat 5: fyllejon folded before Flop (didn't bet)
Seat 6: pmakise folded before Flop (didn't bet)



PokerStars Hand #222979258948:  Hold'em No Limit ($0.05/$0.10 USD) - 2021/01/23 19:10:08 ET
Table 'Jihlava III' 6-max Seat #2 is the button
Seat 1: No1Sparkles ($10.15 in chips) 
Seat 2: JJOOKKEER 77 ($4.02 in chips) 
Seat 4: jimeshka ($3.66 in chips) 
Seat 5: fyllejon ($11.47 in chips) 
Seat 6: pmakise ($8 in chips) 
jimeshka: posts small blind $0.05
fyllejon: posts big blind $0.10
*** HOLE CARDS ***
pmakise: folds 
No1Sparkles: folds 
JJOOKKEER 77: raises $0.10 to $0.20
jimeshka: folds 
fyllejon: calls $0.10
*** FLOP *** [As 3d 2s]
fyllejon: checks 
JJOOKKEER 77: bets $0.20
fyllejon: calls $0.20
*** TURN *** [As 3d 2s] [Ah]
fyllejon: checks 
JJOOKKEER 77: bets $0.40
fyllejon: calls $0.40
*** RIVER *** [As 3d 2s Ah] [8h]
fyllejon: checks 
JJOOKKEER 77: bets $1.30
fyllejon: folds 
Uncalled bet ($1.30) returned to JJOOKKEER 77
JJOOKKEER 77 collected $1.58 from pot
*** SUMMARY ***
Total pot $1.65 | Rake $0.07 
Board [As 3d 2s Ah 8h]
Seat 1: No1Sparkles folded before Flop (didn't bet)
Seat 2: JJOOKKEER 77 (button) collected ($1.58)
Seat 4: jimeshka (small blind) folded before Flop
Seat 5: fyllejon (big blind) folded on the River
Seat 6: pmakise folded before Flop (didn't bet)



PokerStars Hand #222979282399:  Hold'em No Limit ($0.05/$0.10 USD) - 2021/01/23 19:10:50 ET
Table 'Jihlava III' 6-max Seat #4 is the button
Seat 1: No1Sparkles ($10.15 in chips) 
Seat 2: JJOOKKEER 77 ($4.80 in chips) 
Seat 4: jimeshka ($3.61 in chips) 
Seat 5: fyllejon ($10.67 in chips) 
Seat 6: pmakise ($8 in chips) 
fyllejon: posts small blind $0.05
pmakise: posts big blind $0.10
*** HOLE CARDS ***
No1Sparkles: folds 
JJOOKKEER 77: folds 
jimeshka: calls $0.10
fyllejon: calls $0.05
pmakise: checks 
*** FLOP *** [7c Kd 4s]
fyllejon: checks 
pmakise: checks 
jimeshka: bets $0.10
fyllejon: folds 
pmakise: folds 
Uncalled bet ($0.10) returned to jimeshka
jimeshka collected $0.29 from pot
jimeshka: doesn't show hand 
*** SUMMARY ***
Total pot $0.30 | Rake $0.01 
Board [7c Kd 4s]
Seat 1: No1Sparkles folded before Flop (didn't bet)
Seat 2: JJOOKKEER 77 folded before Flop (didn't bet)
Seat 4: jimeshka (button) collected ($0.29)
Seat 5: fyllejon (small blind) folded on the Flop
Seat 6: pmakise (big blind) folded on the Flop



PokerStars Hand #222979296032:  Hold'em No Limit ($0.05/$0.10 USD) - 2021/01/23 19:11:14 ET
Table 'Jihlava III' 6-max Seat #5 is the button
Seat 1: No1Sparkles ($10.15 in chips) 
Seat 2: JJOOKKEER 77 ($4.80 in chips) 
Seat 4: jimeshka ($3.80 in chips) 
Seat 5: fyllejon ($10.57 in chips) 
Seat 6: pmakise ($7.90 in chips) 
pmakise: posts small blind $0.05
No1Sparkles: posts big blind $0.10
Marauder777: sits out 
*** HOLE CARDS ***
JJOOKKEER 77: folds 
jimeshka: raises $0.10 to $0.20
fyllejon: raises $0.10 to $0.30
pmakise: folds 
No1Sparkles: folds 
jimeshka: calls $0.10
*** FLOP *** [Jd Kc 4c]
jimeshka: checks 
fyllejon: bets $0.30
jimeshka: calls $0.30
*** TURN *** [Jd Kc 4c] [3c]
jimeshka: checks 
fyllejon: bets $0.50
jimeshka: calls $0.50
*** RIVER *** [Jd Kc 4c 3c] [Th]
jimeshka: bets $2.24
fyllejon: folds 
Uncalled bet ($2.24) returned to jimeshka
jimeshka collected $2.24 from pot
jimeshka: doesn't show hand 
*** SUMMARY ***
Total pot $2.35 | Rake $0.11 
Board [Jd Kc 4c 3c Th]
Seat 1: No1Sparkles (big blind) folded before Flop
Seat 2: JJOOKKEER 77 folded before Flop (didn't bet)
Seat 4: jimeshka collected ($2.24)
Seat 5: fyllejon (button) folded on the River
Seat 6: pmakise (small blind) folded before Flop



PokerStars Hand #222979319234:  Hold'em No Limit ($0.05/$0.10 USD) - 2021/01/23 19:11:55 ET
Table 'Jihlava III' 6-max Seat #6 is the button
Seat 1: No1Sparkles ($10.05 in chips) 
Seat 2: JJOOKKEER 77 ($4.80 in chips) 
Seat 4: jimeshka ($4.94 in chips) 
Seat 5: fyllejon ($9.47 in chips) 
Seat 6: pmakise ($7.85 in chips) 
No1Sparkles: posts small blind $0.05
JJOOKKEER 77: posts big blind $0.10
Marauder777: sits out 
*** HOLE CARDS ***
jimeshka: folds 
fyllejon: raises $0.20 to $0.30
pmakise: folds 
No1Sparkles: raises $0.60 to $0.90
JJOOKKEER 77: folds 
fyllejon: calls $0.60
*** FLOP *** [Js Kd Jc]
No1Sparkles: checks 
fyllejon: bets $0.90
No1Sparkles: calls $0.90
*** TURN *** [Js Kd Jc] [9s]
No1Sparkles: checks 
fyllejon: checks 
*** RIVER *** [Js Kd Jc 9s] [3s]
No1Sparkles: bets $1.77
fyllejon: calls $1.77
*** SHOW DOWN ***
No1Sparkles: shows [Ad Kh] (two pair, Kings and Jacks)
fyllejon: mucks hand 
No1Sparkles collected $6.91 from pot
*** SUMMARY ***
Total pot $7.24 | Rake $0.33 
Board [Js Kd Jc 9s 3s]
Seat 1: No1Sparkles (small blind) showed [Ad Kh] and won ($6.91) with two pair, Kings and Jacks
Seat 2: JJOOKKEER 77 (big blind) folded before Flop
Seat 4: jimeshka folded before Flop (didn't bet)
Seat 5: fyllejon mucked
Seat 6: pmakise (button) folded before Flop (didn't bet)



PokerStars Hand #222979342783:  Hold'em No Limit ($0.05/$0.10 USD) - 2021/01/23 19:12:38 ET
Table 'Jihlava III' 6-max Seat #1 is the button
Seat 1: No1Sparkles ($13.39 in chips) 
Seat 2: JJOOKKEER 77 ($4.70 in chips) 
Seat 3: Marauder777 ($10 in chips) 
Seat 4: jimeshka ($4.94 in chips) 
Seat 5: fyllejon ($5.90 in chips) 
Seat 6: pmakise ($7.85 in chips) 
JJOOKKEER 77: posts small blind $0.05
Marauder777: posts big blind $0.10
*** HOLE CARDS ***
jimeshka: folds 
fyllejon: folds 
pmakise: folds 
No1Sparkles: folds 
JJOOKKEER 77: folds 
Uncalled bet ($0.05) returned to Marauder777
Marauder777 collected $0.10 from pot
Marauder777: doesn't show hand 
*** SUMMARY ***
Total pot $0.10 | Rake $0 
Seat 1: No1Sparkles (button) folded before Flop (didn't bet)
Seat 2: JJOOKKEER 77 (small blind) folded before Flop
Seat 3: Marauder777 (big blind) collected ($0.10)
Seat 4: jimeshka folded before Flop (didn't bet)
Seat 5: fyllejon folded before Flop (didn't bet)
Seat 6: pmakise folded before Flop (didn't bet)



PokerStars Hand #222979348854:  Hold'em No Limit ($0.05/$0.10 USD) - 2021/01/23 19:12:49 ET
Table 'Jihlava III' 6-max Seat #2 is the button
Seat 1: No1Sparkles ($13.39 in chips) 
Seat 2: JJOOKKEER 77 ($4.65 in chips) 
Seat 3: Marauder777 ($10.05 in chips) 
Seat 4: jimeshka ($4.94 in chips) 
Seat 5: fyllejon ($5.90 in chips) 
Seat 6: pmakise ($7.85 in chips) 
Marauder777: posts small blind $0.05
jimeshka: posts big blind $0.10
*** HOLE CARDS ***
fyllejon: raises $0.20 to $0.30
pmakise: folds 
No1Sparkles: folds 
JJOOKKEER 77: folds 
Marauder777: calls $0.25
jimeshka: folds 
*** FLOP *** [9d 8s 5d]
Marauder777: checks 
fyllejon: bets $0.30
Marauder777: calls $0.30
*** TURN *** [9d 8s 5d] [4s]
Marauder777: checks 
fyllejon: bets $0.80
Marauder777: folds 
Uncalled bet ($0.80) returned to fyllejon
fyllejon collected $1.24 from pot
fyllejon: doesn't show hand 
*** SUMMARY ***
Total pot $1.30 | Rake $0.06 
Board [9d 8s 5d 4s]
Seat 1: No1Sparkles folded before Flop (didn't bet)
Seat 2: JJOOKKEER 77 (button) folded before Flop (didn't bet)
Seat 3: Marauder777 (small blind) folded on the Turn
Seat 4: jimeshka (big blind) folded before Flop
Seat 5: fyllejon collected ($1.24)
Seat 6: pmakise folded before Flop (didn't bet)



PokerStars Hand #222979370010:  Hold'em No Limit ($0.05/$0.10 USD) - 2021/01/23 19:13:27 ET
Table 'Jihlava III' 6-max Seat #3 is the button
Seat 1: No1Sparkles ($13.39 in chips) 
Seat 2: JJOOKKEER 77 ($4.65 in chips) 
Seat 3: Marauder777 ($10 in chips) 
Seat 4: jimeshka ($4.84 in chips) 
Seat 5: fyllejon ($6.54 in chips) 
Seat 6: pmakise ($7.85 in chips) 
jimeshka: posts small blind $0.05
fyllejon: posts big blind $0.10
*** HOLE CARDS ***
pmakise: folds 
No1Sparkles: folds 
JJOOKKEER 77: folds 
Marauder777: raises $0.12 to $0.22
jimeshka: folds 
fyllejon: calls $0.12
*** FLOP *** [Kh 9d 5h]
fyllejon: checks 
Marauder777: bets $0.16
fyllejon: calls $0.16
*** TURN *** [Kh 9d 5h] [4d]
fyllejon: checks 
Marauder777: checks 
*** RIVER *** [Kh 9d 5h 4d] [Ad]
fyllejon: checks 
Marauder777: bets $0.59
fyllejon: folds 
Uncalled bet ($0.59) returned to Marauder777
Marauder777 collected $0.77 from pot
Marauder777: doesn't show hand 
*** SUMMARY ***
Total pot $0.81 | Rake $0.04 
Board [Kh 9d 5h 4d Ad]
Seat 1: No1Sparkles folded before Flop (didn't bet)
Seat 2: JJOOKKEER 77 folded before Flop (didn't bet)
Seat 3: Marauder777 (button) collected ($0.77)
Seat 4: jimeshka (small blind) folded before Flop
Seat 5: fyllejon (big blind) folded on the River
Seat 6: pmakise folded before Flop (didn't bet)



PokerStars Hand #222979390721:  Hold'em No Limit ($0.05/$0.10 USD) - 2021/01/23 19:14:04 ET
Table 'Jihlava III' 6-max Seat #4 is the button
Seat 1: No1Sparkles ($13.39 in chips) 
Seat 2: JJOOKKEER 77 ($4.65 in chips) 
Seat 3: Marauder777 ($10.39 in chips) 
Seat 4: jimeshka ($4.79 in chips) 
Seat 5: fyllejon ($6.16 in chips) 
Seat 6: pmakise ($7.85 in chips) 
fyllejon: posts small blind $0.05
pmakise: posts big blind $0.10
*** HOLE CARDS ***
No1Sparkles: folds 
JJOOKKEER 77: folds 
Marauder777: folds 
jimeshka: folds 
fyllejon: folds 
Uncalled bet ($0.05) returned to pmakise
pmakise collected $0.10 from pot
pmakise: doesn't show hand 
*** SUMMARY ***
Total pot $0.10 | Rake $0 
Seat 1: No1Sparkles folded before Flop (didn't bet)
Seat 2: JJOOKKEER 77 folded before Flop (didn't bet)
Seat 3: Marauder777 folded before Flop (didn't bet)
Seat 4: jimeshka (button) folded before Flop (didn't bet)
Seat 5: fyllejon (small blind) folded before Flop
Seat 6: pmakise (big blind) collected ($0.10)



PokerStars Hand #222979398302:  Hold'em No Limit ($0.05/$0.10 USD) - 2021/01/23 19:14:18 ET
Table 'Jihlava III' 6-max Seat #5 is the button
Seat 1: No1Sparkles ($13.39 in chips) 
Seat 2: JJOOKKEER 77 ($4.65 in chips) 
Seat 3: Marauder777 ($10.39 in chips) 
Seat 4: jimeshka ($4.79 in chips) 
Seat 5: fyllejon ($6.11 in chips) 
Seat 6: pmakise ($7.90 in chips) 
pmakise: posts small blind $0.05
No1Sparkles: posts big blind $0.10
*** HOLE CARDS ***
JJOOKKEER 77: folds 
Marauder777: raises $0.12 to $0.22
jimeshka: folds 
fyllejon: folds 
pmakise: calls $0.17
No1Sparkles: folds 
*** FLOP *** [Jh Qd 6h]
pmakise: checks 
Marauder777: checks 
*** TURN *** [Jh Qd 6h] [Qh]
pmakise: checks 
Marauder777: bets $0.18
pmakise: calls $0.18
*** RIVER *** [Jh Qd 6h Qh] [6d]
pmakise: checks 
Marauder777: checks 
*** SHOW DOWN ***
pmakise: shows [Jc Kd] (two pair, Queens and Jacks)
Marauder777: mucks hand 
pmakise collected $0.86 from pot
*** SUMMARY ***
Total pot $0.90 | Rake $0.04 
Board [Jh Qd 6h Qh 6d]
Seat 1: No1Sparkles (big blind) folded before Flop
Seat 2: JJOOKKEER 77 folded before Flop (didn't bet)
Seat 3: Marauder777 mucked
Seat 4: jimeshka folded before Flop (didn't bet)
Seat 5: fyllejon (button) folded before Flop (didn't bet)
Seat 6: pmakise (small blind) showed [Jc Kd] and won ($0.86) with two pair, Queens and Jacks



PokerStars Hand #222979436306:  Hold'em No Limit ($0.05/$0.10 USD) - 2021/01/23 19:15:27 ET
Table 'Jihlava III' 6-max Seat #6 is the button
Seat 1: No1Sparkles ($13.29 in chips) 
Seat 2: JJOOKKEER 77 ($4.65 in chips) 
Seat 3: Marauder777 ($10 in chips) 
Seat 4: jimeshka ($4.79 in chips) 
Seat 5: fyllejon ($6.11 in chips) 
Seat 6: pmakise ($8.36 in chips) 
No1Sparkles: posts small blind $0.05
JJOOKKEER 77: posts big blind $0.10
*** HOLE CARDS ***
Marauder777: folds 
jimeshka: folds 
fyllejon: folds 
pmakise: raises $0.20 to $0.30
No1Sparkles: folds 
JJOOKKEER 77: folds 
Uncalled bet ($0.20) returned to pmakise
pmakise collected $0.25 from pot
pmakise: doesn't show hand 
*** SUMMARY ***
Total pot $0.25 | Rake $0 
Seat 1: No1Sparkles (small blind) folded before Flop
Seat 2: JJOOKKEER 77 (big blind) folded before Flop
Seat 3: Marauder777 folded before Flop (didn't bet)
Seat 4: jimeshka folded before Flop (didn't bet)
Seat 5: fyllejon folded before Flop (didn't bet)
Seat 6: pmakise (button) collected ($0.25)



PokerStars Hand #222979445233:  Hold'em No Limit ($0.05/$0.10 USD) - 2021/01/23 19:15:43 ET
Table 'Jihlava III' 6-max Seat #1 is the button
Seat 1: No1Sparkles ($13.24 in chips) 
Seat 2: JJOOKKEER 77 ($4.55 in chips) 
Seat 3: Marauder777 ($10 in chips) 
Seat 4: jimeshka ($4.79 in chips) 
Seat 5: fyllejon ($6.11 in chips) 
Seat 6: pmakise ($8.51 in chips) 
JJOOKKEER 77: posts small blind $0.05
Marauder777: posts big blind $0.10
*** HOLE CARDS ***
jimeshka: calls $0.10
fyllejon: folds 
pmakise: folds 
No1Sparkles: raises $0.30 to $0.40
JJOOKKEER 77: folds 
Marauder777: folds 
jimeshka: calls $0.30
*** FLOP *** [Ts 5c 8s]
jimeshka: checks 
No1Sparkles: checks 
*** TURN *** [Ts 5c 8s] [Kd]
jimeshka: bets $0.30
No1Sparkles: calls $0.30
*** RIVER *** [Ts 5c 8s Kd] [Jc]
jimeshka: bets $0.74
No1Sparkles: raises $1.26 to $2
jimeshka: folds 
Uncalled bet ($1.26) returned to No1Sparkles
No1Sparkles collected $2.89 from pot
No1Sparkles: doesn't show hand 
*** SUMMARY ***
Total pot $3.03 | Rake $0.14 
Board [Ts 5c 8s Kd Jc]
Seat 1: No1Sparkles (button) collected ($2.89)
Seat 2: JJOOKKEER 77 (small blind) folded before Flop
Seat 3: Marauder777 (big blind) folded before Flop
Seat 4: jimeshka folded on the River
Seat 5: fyllejon folded before Flop (didn't bet)
Seat 6: pmakise folded before Flop (didn't bet)



PokerStars Hand #222979476599:  Hold'em No Limit ($0.05/$0.10 USD) - 2021/01/23 19:16:40 ET
Table 'Jihlava III' 6-max Seat #2 is the button
Seat 1: No1Sparkles ($14.69 in chips) 
Seat 2: JJOOKKEER 77 ($4.50 in chips) 
Seat 3: Marauder777 ($10 in chips) 
Seat 4: jimeshka ($3.35 in chips) 
Seat 5: fyllejon ($6.11 in chips) 
Seat 6: pmakise ($8.51 in chips) 
Marauder777: posts small blind $0.05
jimeshka: posts big blind $0.10
*** HOLE CARDS ***
fyllejon: folds 
pmakise: raises $0.20 to $0.30
No1Sparkles: folds 
JJOOKKEER 77: folds 
Marauder777: folds 
jimeshka: calls $0.20
*** FLOP *** [3h Qd 7s]
jimeshka: checks 
pmakise: bets $0.21
jimeshka: folds 
Uncalled bet ($0.21) returned to pmakise
pmakise collected $0.62 from pot
pmakise: doesn't show hand 
*** SUMMARY ***
Total pot $0.65 | Rake $0.03 
Board [3h Qd 7s]
Seat 1: No1Sparkles folded before Flop (didn't bet)
Seat 2: JJOOKKEER 77 (button) folded before Flop (didn't bet)
Seat 3: Marauder777 (small blind) folded before Flop
Seat 4: jimeshka (big blind) folded on the Flop
Seat 5: fyllejon folded before Flop (didn't bet)
Seat 6: pmakise collected ($0.62)



PokerStars Hand #222979488396:  Hold'em No Limit ($0.05/$0.10 USD) - 2021/01/23 19:17:02 ET
Table 'Jihlava III' 6-max Seat #3 is the button
Seat 1: No1Sparkles ($14.69 in chips) 
Seat 2: JJOOKKEER 77 ($4.50 in chips) 
Seat 3: Marauder777 ($10 in chips) 
Seat 4: jimeshka ($3.05 in chips) 
Seat 5: fyllejon ($6.11 in chips) 
Seat 6: pmakise ($8.83 in chips) 
jimeshka: posts small blind $0.05
fyllejon: posts big blind $0.10
*** HOLE CARDS ***
pmakise: folds 
No1Sparkles: folds 
JJOOKKEER 77: folds 
Marauder777: raises $0.12 to $0.22
jimeshka: folds 
fyllejon: calls $0.12
*** FLOP *** [8h 7s Kc]
fyllejon: checks 
Marauder777: bets $0.16
fyllejon: calls $0.16
*** TURN *** [8h 7s Kc] [Qd]
fyllejon: checks 
Marauder777: bets $0.49
fyllejon: folds 
Uncalled bet ($0.49) returned to Marauder777
Marauder777 collected $0.77 from pot
Marauder777: doesn't show hand 
*** SUMMARY ***
Total pot $0.81 | Rake $0.04 
Board [8h 7s Kc Qd]
Seat 1: No1Sparkles folded before Flop (didn't bet)
Seat 2: JJOOKKEER 77 folded before Flop (didn't bet)
Seat 3: Marauder777 (button) collected ($0.77)
Seat 4: jimeshka (small blind) folded before Flop
Seat 5: fyllejon (big blind) folded on the Turn
Seat 6: pmakise folded before Flop (didn't bet)



PokerStars Hand #222979503500:  Hold'em No Limit ($0.05/$0.10 USD) - 2021/01/23 19:17:30 ET
Table 'Jihlava III' 6-max Seat #4 is the button
Seat 1: No1Sparkles ($14.69 in chips) 
Seat 2: JJOOKKEER 77 ($4.50 in chips) 
Seat 3: Marauder777 ($10.39 in chips) 
Seat 4: jimeshka ($3 in chips) 
Seat 5: fyllejon ($5.73 in chips) 
Seat 6: pmakise ($8.83 in chips) 
fyllejon: posts small blind $0.05
pmakise: posts big blind $0.10
*** HOLE CARDS ***
No1Sparkles: folds 
JJOOKKEER 77: folds 
Marauder777: folds 
jimeshka: folds 
fyllejon: folds 
Uncalled bet ($0.05) returned to pmakise
pmakise collected $0.10 from pot
pmakise: doesn't show hand 
*** SUMMARY ***
Total pot $0.10 | Rake $0 
Seat 1: No1Sparkles folded before Flop (didn't bet)
Seat 2: JJOOKKEER 77 folded before Flop (didn't bet)
Seat 3: Marauder777 folded before Flop (didn't bet)
Seat 4: jimeshka (button) folded before Flop (didn't bet)
Seat 5: fyllejon (small blind) folded before Flop
Seat 6: pmakise (big blind) collected ($0.10)



PokerStars Hand #222979507156:  Hold'em No Limit ($0.05/$0.10 USD) - 2021/01/23 19:17:36 ET
Table 'Jihlava III' 6-max Seat #5 is the button
Seat 1: No1Sparkles ($14.69 in chips) 
Seat 2: JJOOKKEER 77 ($4.50 in chips) 
Seat 3: Marauder777 ($10.39 in chips) 
Seat 4: jimeshka ($3 in chips) 
Seat 5: fyllejon ($5.68 in chips) 
Seat 6: pmakise ($8.88 in chips) 
pmakise: posts small blind $0.05
No1Sparkles: posts big blind $0.10
*** HOLE CARDS ***
JJOOKKEER 77: folds 
Marauder777: folds 
jimeshka: calls $0.10
fyllejon: folds 
pmakise: raises $0.30 to $0.40
No1Sparkles: folds 
jimeshka: calls $0.30
*** FLOP *** [Kh Jh Jd]
pmakise: bets $0.33
jimeshka: raises $0.47 to $0.80
pmakise: calls $0.47
*** TURN *** [Kh Jh Jd] [As]
pmakise: checks 
jimeshka: bets $1.20
pmakise: calls $1.20
*** RIVER *** [Kh Jh Jd As] [2s]
pmakise: checks 
jimeshka: bets $0.10
pmakise: calls $0.10
*** SHOW DOWN ***
jimeshka: shows [8s Ad] (two pair, Aces and Jacks)
pmakise: shows [Qh Ac] (two pair, Aces and Jacks)
pmakise collected $2.44 from pot
jimeshka collected $2.43 from pot
*** SUMMARY ***
Total pot $5.10 | Rake $0.23 
Board [Kh Jh Jd As 2s]
Seat 1: No1Sparkles (big blind) folded before Flop
Seat 2: JJOOKKEER 77 folded before Flop (didn't bet)
Seat 3: Marauder777 folded before Flop (didn't bet)
Seat 4: jimeshka showed [8s Ad] and won ($2.43) with two pair, Aces and Jacks
Seat 5: fyllejon (button) folded before Flop (didn't bet)
Seat 6: pmakise (small blind) showed [Qh Ac] and won ($2.44) with two pair, Aces and Jacks



PokerStars Hand #222979537648:  Hold'em No Limit ($0.05/$0.10 USD) - 2021/01/23 19:18:33 ET
Table 'Jihlava III' 6-max Seat #6 is the button
Seat 1: No1Sparkles ($14.59 in chips) 
Seat 2: JJOOKKEER 77 ($4.50 in chips) 
Seat 3: Marauder777 ($10.39 in chips) 
Seat 4: jimeshka ($2.93 in chips) 
Seat 5: fyllejon ($5.68 in chips) 
Seat 6: pmakise ($8.82 in chips) 
No1Sparkles: posts small blind $0.05
JJOOKKEER 77: posts big blind $0.10
*** HOLE CARDS ***
Marauder777: folds 
jimeshka: folds 
fyllejon: raises $0.10 to $0.20
pmakise: folds 
No1Sparkles: folds 
JJOOKKEER 77: folds 
Uncalled bet ($0.10) returned to fyllejon
fyllejon collected $0.25 from pot
fyllejon: doesn't show hand 
*** SUMMARY ***
Total pot $0.25 | Rake $0 
Seat 1: No1Sparkles (small blind) folded before Flop
Seat 2: JJOOKKEER 77 (big blind) folded before Flop
Seat 3: Marauder777 folded before Flop (didn't bet)
Seat 4: jimeshka folded before Flop (didn't bet)
Seat 5: fyllejon collected ($0.25)
Seat 6: pmakise (button) folded before Flop (didn't bet)



PokerStars Hand #222979545262:  Hold'em No Limit ($0.05/$0.10 USD) - 2021/01/23 19:18:47 ET
Table 'Jihlava III' 6-max Seat #1 is the button
Seat 1: No1Sparkles ($14.54 in chips) 
Seat 2: JJOOKKEER 77 ($4.40 in chips) 
Seat 4: jimeshka ($2.93 in chips) 
Seat 5: fyllejon ($5.83 in chips) 
Seat 6: pmakise ($8.82 in chips) 
JJOOKKEER 77: posts small blind $0.05
Marauder777: is sitting out 
jimeshka: posts big blind $0.10
*** HOLE CARDS ***
fyllejon: folds 
pmakise: raises $0.20 to $0.30
No1Sparkles: folds 
JJOOKKEER 77: folds 
jimeshka: folds 
Uncalled bet ($0.20) returned to pmakise
pmakise collected $0.25 from pot
pmakise: doesn't show hand 
*** SUMMARY ***
Total pot $0.25 | Rake $0 
Seat 1: No1Sparkles (button) folded before Flop (didn't bet)
Seat 2: JJOOKKEER 77 (small blind) folded before Flop
Seat 4: jimeshka (big blind) folded before Flop
Seat 5: fyllejon folded before Flop (didn't bet)
Seat 6: pmakise collected ($0.25)



PokerStars Hand #222979553741:  Hold'em No Limit ($0.05/$0.10 USD) - 2021/01/23 19:19:02 ET
Table 'Jihlava III' 6-max Seat #2 is the button
Seat 1: No1Sparkles ($14.54 in chips) 
Seat 2: JJOOKKEER 77 ($4.35 in chips) 
Seat 4: jimeshka ($2.83 in chips) 
Seat 5: fyllejon ($5.83 in chips) 
Seat 6: pmakise ($8.97 in chips) 
jimeshka: posts small blind $0.05
fyllejon: posts big blind $0.10
*** HOLE CARDS ***
pmakise: folds 
No1Sparkles: raises $0.20 to $0.30
JJOOKKEER 77: calls $0.30
jimeshka: folds 
fyllejon: folds 
*** FLOP *** [4d Kh Ts]
No1Sparkles: bets $0.36
JJOOKKEER 77: folds 
Uncalled bet ($0.36) returned to No1Sparkles
No1Sparkles collected $0.72 from pot
No1Sparkles: doesn't show hand 
*** SUMMARY ***
Total pot $0.75 | Rake $0.03 
Board [4d Kh Ts]
Seat 1: No1Sparkles collected ($0.72)
Seat 2: JJOOKKEER 77 (button) folded on the Flop
Seat 4: jimeshka (small blind) folded before Flop
Seat 5: fyllejon (big blind) folded before Flop
Seat 6: pmakise folded before Flop (didn't bet)



PokerStars Hand #222979565856:  Hold'em No Limit ($0.05/$0.10 USD) - 2021/01/23 19:19:25 ET
Table 'Jihlava III' 6-max Seat #4 is the button
Seat 1: No1Sparkles ($14.96 in chips) 
Seat 2: JJOOKKEER 77 ($4.05 in chips) 
Seat 4: jimeshka ($2.78 in chips) 
Seat 5: fyllejon ($5.73 in chips) 
Seat 6: pmakise ($8.97 in chips) 
fyllejon: posts small blind $0.05
pmakise: posts big blind $0.10
*** HOLE CARDS ***
No1Sparkles: raises $0.20 to $0.30
JJOOKKEER 77: folds 
jimeshka: folds 
fyllejon: raises $0.50 to $0.80
pmakise: folds 
No1Sparkles: raises $1.40 to $2.20
fyllejon: raises $3.53 to $5.73 and is all-in
No1Sparkles: calls $3.53
*** FLOP *** [9s Ac 8c]
*** TURN *** [9s Ac 8c] [6s]
*** RIVER *** [9s Ac 8c 6s] [Ks]
*** SHOW DOWN ***
fyllejon: shows [Ah Kc] (two pair, Aces and Kings)
No1Sparkles: shows [Jd Js] (a pair of Jacks)
fyllejon collected $11.04 from pot
*** SUMMARY ***
Total pot $11.56 | Rake $0.52 
Board [9s Ac 8c 6s Ks]
Seat 1: No1Sparkles showed [Jd Js] and lost with a pair of Jacks
Seat 2: JJOOKKEER 77 folded before Flop (didn't bet)
Seat 4: jimeshka (button) folded before Flop (didn't bet)
Seat 5: fyllejon (small blind) showed [Ah Kc] and won ($11.04) with two pair, Aces and Kings
Seat 6: pmakise (big blind) folded before Flop



PokerStars Hand #222979585758:  Hold'em No Limit ($0.05/$0.10 USD) - 2021/01/23 19:20:02 ET
Table 'Jihlava III' 6-max Seat #5 is the button
Seat 1: No1Sparkles ($10 in chips) 
Seat 2: JJOOKKEER 77 ($4.05 in chips) 
Seat 4: jimeshka ($2.78 in chips) 
Seat 5: fyllejon ($11.04 in chips) 
Seat 6: pmakise ($8.87 in chips) 
pmakise: posts small blind $0.05
No1Sparkles: posts big blind $0.10
*** HOLE CARDS ***
JJOOKKEER 77: folds 
jimeshka: calls $0.10
fyllejon: folds 
pmakise: calls $0.05
No1Sparkles: checks 
*** FLOP *** [4c 7d 9s]
pmakise: checks 
No1Sparkles: checks 
jimeshka: checks 
*** TURN *** [4c 7d 9s] [As]
pmakise: checks 
No1Sparkles: checks 
jimeshka: bets $0.10
pmakise: calls $0.10
No1Sparkles: folds 
*** RIVER *** [4c 7d 9s As] [Jd]
pmakise: checks 
jimeshka: bets $0.48
pmakise: folds 
Uncalled bet ($0.48) returned to jimeshka
jimeshka collected $0.48 from pot
jimeshka: doesn't show hand 
*** SUMMARY ***
Total pot $0.50 | Rake $0.02 
Board [4c 7d 9s As Jd]
Seat 1: No1Sparkles (big blind) folded on the Turn
Seat 2: JJOOKKEER 77 folded before Flop (didn't bet)
Seat 4: jimeshka collected ($0.48)
Seat 5: fyllejon (button) folded before Flop (didn't bet)
Seat 6: pmakise (small blind) folded on the River



PokerStars Hand #222979614193:  Hold'em No Limit ($0.05/$0.10 USD) - 2021/01/23 19:20:55 ET
Table 'Jihlava III' 6-max Seat #6 is the button
Seat 1: No1Sparkles ($10 in chips) 
Seat 2: JJOOKKEER 77 ($4.05 in chips) 
Seat 4: jimeshka ($3.06 in chips) 
Seat 5: fyllejon ($11.04 in chips) 
Seat 6: pmakise ($8.67 in chips) 
No1Sparkles: posts small blind $0.05
JJOOKKEER 77: posts big blind $0.10
*** HOLE CARDS ***
jimeshka: calls $0.10
fyllejon: folds 
pmakise: calls $0.10
No1Sparkles: folds 
JJOOKKEER 77: raises $0.35 to $0.45
jimeshka: folds 
pmakise: calls $0.35
*** FLOP *** [Jc 2c 5d]
JJOOKKEER 77: checks 
pmakise: checks 
*** TURN *** [Jc 2c 5d] [8s]
JJOOKKEER 77: checks 
pmakise: checks 
*** RIVER *** [Jc 2c 5d 8s] [6c]
JJOOKKEER 77: checks 
pmakise: bets $0.50
JJOOKKEER 77: calls $0.50
*** SHOW DOWN ***
pmakise: shows [Kc 9s] (high card King)
JJOOKKEER 77: shows [Ad Td] (high card Ace)
JJOOKKEER 77 collected $1.96 from pot
*** SUMMARY ***
Total pot $2.05 | Rake $0.09 
Board [Jc 2c 5d 8s 6c]
Seat 1: No1Sparkles (small blind) folded before Flop
Seat 2: JJOOKKEER 77 (big blind) showed [Ad Td] and won ($1.96) with high card Ace
Seat 4: jimeshka folded before Flop
Seat 5: fyllejon folded before Flop (didn't bet)
Seat 6: pmakise (button) showed [Kc 9s] and lost with high card King



PokerStars Hand #222979633786:  Hold'em No Limit ($0.05/$0.10 USD) - 2021/01/23 19:21:32 ET
Table 'Jihlava III' 6-max Seat #1 is the button
Seat 1: No1Sparkles ($10 in chips) 
Seat 2: JJOOKKEER 77 ($5.06 in chips) 
Seat 4: jimeshka ($2.96 in chips) 
Seat 5: fyllejon ($11.04 in chips) 
Seat 6: pmakise ($7.72 in chips) 
JJOOKKEER 77: posts small blind $0.05
jimeshka: posts big blind $0.10
*** HOLE CARDS ***
fyllejon: folds 
pmakise: folds 
No1Sparkles: folds 
JJOOKKEER 77: calls $0.05
jimeshka: checks 
*** FLOP *** [Js 4s Ac]
JJOOKKEER 77: checks 
jimeshka: checks 
*** TURN *** [Js 4s Ac] [Kh]
JJOOKKEER 77: bets $0.10
jimeshka: folds 
Uncalled bet ($0.10) returned to JJOOKKEER 77
JJOOKKEER 77 collected $0.19 from pot
*** SUMMARY ***
Total pot $0.20 | Rake $0.01 
Board [Js 4s Ac Kh]
Seat 1: No1Sparkles (button) folded before Flop (didn't bet)
Seat 2: JJOOKKEER 77 (small blind) collected ($0.19)
Seat 4: jimeshka (big blind) folded on the Turn
Seat 5: fyllejon folded before Flop (didn't bet)
Seat 6: pmakise folded before Flop (didn't bet)



PokerStars Hand #222979646782:  Hold'em No Limit ($0.05/$0.10 USD) - 2021/01/23 19:21:56 ET
Table 'Jihlava III' 6-max Seat #2 is the button
Seat 1: No1Sparkles ($10 in chips) 
Seat 2: JJOOKKEER 77 ($5.15 in chips) 
Seat 4: jimeshka ($2.86 in chips) 
Seat 5: fyllejon ($11.04 in chips) 
Seat 6: pmakise ($7.72 in chips) 
jimeshka: posts small blind $0.05
fyllejon: posts big blind $0.10
*** HOLE CARDS ***
pmakise: raises $0.20 to $0.30
No1Sparkles: folds 
JJOOKKEER 77: folds 
jimeshka: folds 
fyllejon: folds 
Uncalled bet ($0.20) returned to pmakise
pmakise collected $0.25 from pot
pmakise: doesn't show hand 
*** SUMMARY ***
Total pot $0.25 | Rake $0 
Seat 1: No1Sparkles folded before Flop (didn't bet)
Seat 2: JJOOKKEER 77 (button) folded before Flop (didn't bet)
Seat 4: jimeshka (small blind) folded before Flop
Seat 5: fyllejon (big blind) folded before Flop
Seat 6: pmakise collected ($0.25)



PokerStars Hand #222979658337:  Hold'em No Limit ($0.05/$0.10 USD) - 2021/01/23 19:22:18 ET
Table 'Jihlava III' 6-max Seat #4 is the button
Seat 1: No1Sparkles ($10 in chips) 
Seat 2: JJOOKKEER 77 ($5.15 in chips) 
Seat 4: jimeshka ($2.81 in chips) 
Seat 5: fyllejon ($10.94 in chips) 
Seat 6: pmakise ($7.87 in chips) 
fyllejon: posts small blind $0.05
pmakise: posts big blind $0.10
*** HOLE CARDS ***
No1Sparkles: folds 
JJOOKKEER 77: folds 
jimeshka: folds 
fyllejon: folds 
Uncalled bet ($0.05) returned to pmakise
pmakise collected $0.10 from pot
pmakise: doesn't show hand 
*** SUMMARY ***
Total pot $0.10 | Rake $0 
Seat 1: No1Sparkles folded before Flop (didn't bet)
Seat 2: JJOOKKEER 77 folded before Flop (didn't bet)
Seat 4: jimeshka (button) folded before Flop (didn't bet)
Seat 5: fyllejon (small blind) folded before Flop
Seat 6: pmakise (big blind) collected ($0.10)



PokerStars Hand #222979662255:  Hold'em No Limit ($0.05/$0.10 USD) - 2021/01/23 19:22:25 ET
Table 'Jihlava III' 6-max Seat #5 is the button
Seat 1: No1Sparkles ($10 in chips) 
Seat 2: JJOOKKEER 77 ($5.15 in chips) 
Seat 4: jimeshka ($2.81 in chips) 
Seat 5: fyllejon ($10.89 in chips) 
Seat 6: pmakise ($7.92 in chips) 
pmakise: posts small blind $0.05
No1Sparkles: posts big blind $0.10
*** HOLE CARDS ***
JJOOKKEER 77: raises $0.10 to $0.20
jimeshka: folds 
Marauder777 leaves the table
fyllejon: calls $0.20
pudge.3096 joins the table at seat #3 
pmakise: raises $0.70 to $0.90
No1Sparkles: folds 
JJOOKKEER 77: folds 
fyllejon: calls $0.70
*** FLOP *** [5s Ts Jc]
pmakise: bets $0.80
fyllejon: calls $0.80
*** TURN *** [5s Ts Jc] [Qd]
pmakise: checks 
fyllejon: checks 
*** RIVER *** [5s Ts Jc Qd] [3s]
pmakise: checks 
fyllejon: bets $2.30
pmakise: calls $2.30
*** SHOW DOWN ***
fyllejon: shows [As 9s] (a flush, Ace high)
pmakise: mucks hand 
fyllejon collected $7.93 from pot
*** SUMMARY ***
Total pot $8.30 | Rake $0.37 
Board [5s Ts Jc Qd 3s]
Seat 1: No1Sparkles (big blind) folded before Flop
Seat 2: JJOOKKEER 77 folded before Flop
Seat 4: jimeshka folded before Flop (didn't bet)
Seat 5: fyllejon (button) showed [As 9s] and won ($7.93) with a flush, Ace high
Seat 6: pmakise (small blind) mucked



PokerStars Hand #222979687727:  Hold'em No Limit ($0.05/$0.10 USD) - 2021/01/23 19:23:13 ET
Table 'Jihlava III' 6-max Seat #6 is the button
Seat 1: No1Sparkles ($10 in chips) 
Seat 2: JJOOKKEER 77 ($4.95 in chips) 
Seat 4: jimeshka ($2.81 in chips) 
Seat 5: fyllejon ($14.82 in chips) 
Seat 6: pmakise ($3.92 in chips) 
No1Sparkles: posts small blind $0.05
JJOOKKEER 77: posts big blind $0.10
pudge.3096: sits out 
*** HOLE CARDS ***
jimeshka: calls $0.10
fyllejon: folds 
pmakise: folds 
pmakise leaves the table
No1Sparkles: folds 
JJOOKKEER 77: checks 
*** FLOP *** [7s 3d 8d]
JJOOKKEER 77: checks 
jimeshka: bets $0.10
JJOOKKEER 77: calls $0.10
*** TURN *** [7s 3d 8d] [Th]
JJOOKKEER 77: checks 
jimeshka: bets $0.30
JJOOKKEER 77: raises $1.03 to $1.33
jimeshka: folds 
Uncalled bet ($1.03) returned to JJOOKKEER 77
JJOOKKEER 77 collected $1 from pot
*** SUMMARY ***
Total pot $1.05 | Rake $0.05 
Board [7s 3d 8d Th]
Seat 1: No1Sparkles (small blind) folded before Flop
Seat 2: JJOOKKEER 77 (big blind) collected ($1)
Seat 4: jimeshka folded on the Turn
Seat 5: fyllejon folded before Flop (didn't bet)
Seat 6: pmakise (button) folded before Flop (didn't bet)



PokerStars Hand #222979701506:  Hold'em No Limit ($0.05/$0.10 USD) - 2021/01/23 19:23:39 ET
Table 'Jihlava III' 6-max Seat #1 is the button
Seat 1: No1Sparkles ($10 in chips) 
Seat 2: JJOOKKEER 77 ($5.45 in chips) 
Seat 3: pudge.3096 ($10.15 in chips) 
Seat 4: jimeshka ($2.31 in chips) 
Seat 5: fyllejon ($14.82 in chips) 
JJOOKKEER 77: posts small blind $0.05
pudge.3096: posts big blind $0.10
*** HOLE CARDS ***
jimeshka: folds 
fyllejon: calls $0.10
No1Sparkles: raises $0.30 to $0.40
JJOOKKEER 77: folds 
pudge.3096: folds 
fyllejon: calls $0.30
*** FLOP *** [9c 2s Jc]
fyllejon: checks 
No1Sparkles: checks 
*** TURN *** [9c 2s Jc] [6h]
Dimas.irk joins the table at seat #6 
pudge.3096 leaves the table
fyllejon: checks 
No1Sparkles: bets $0.30
fyllejon: calls $0.30
*** RIVER *** [9c 2s Jc 6h] [8h]
fyllejon: bets $1.60
No1Sparkles: folds 
Uncalled bet ($1.60) returned to fyllejon
fyllejon collected $1.48 from pot
fyllejon: doesn't show hand 
*** SUMMARY ***
Total pot $1.55 | Rake $0.07 
Board [9c 2s Jc 6h 8h]
Seat 1: No1Sparkles (button) folded on the River
Seat 2: JJOOKKEER 77 (small blind) folded before Flop
Seat 3: pudge.3096 (big blind) folded before Flop
Seat 4: jimeshka folded before Flop (didn't bet)
Seat 5: fyllejon collected ($1.48)



PokerStars Hand #222979725652:  Hold'em No Limit ($0.05/$0.10 USD) - 2021/01/23 19:24:25 ET
Table 'Jihlava III' 6-max Seat #2 is the button
Seat 1: No1Sparkles ($10 in chips) 
Seat 2: JJOOKKEER 77 ($5.40 in chips) 
Seat 4: jimeshka ($2.31 in chips) 
Seat 5: fyllejon ($15.60 in chips) 
jimeshka: posts small blind $0.05
fyllejon: posts big blind $0.10
Dimas.irk: sits out 
*** HOLE CARDS ***
KiraLasVegas joins the table at seat #3 
No1Sparkles: folds 
JJOOKKEER 77: folds 
jimeshka: calls $0.05
fyllejon: checks 
*** FLOP *** [Tc 7c Ah]
jimeshka: bets $0.10
fyllejon: calls $0.10
*** TURN *** [Tc 7c Ah] [Kc]
jimeshka: bets $0.10
fyllejon: calls $0.10
*** RIVER *** [Tc 7c Ah Kc] [9d]
jimeshka: bets $0.57
fyllejon: calls $0.57
*** SHOW DOWN ***
jimeshka: shows [7h 9h] (two pair, Nines and Sevens)
fyllejon: shows [6d 8s] (a straight, Six to Ten)
fyllejon collected $1.66 from pot
*** SUMMARY ***
Total pot $1.74 | Rake $0.08 
Board [Tc 7c Ah Kc 9d]
Seat 1: No1Sparkles folded before Flop (didn't bet)
Seat 2: JJOOKKEER 77 (button) folded before Flop (didn't bet)
Seat 4: jimeshka (small blind) showed [7h 9h] and lost with two pair, Nines and Sevens
Seat 5: fyllejon (big blind) showed [6d 8s] and won ($1.66) with a straight, Six to Ten



PokerStars Hand #222979740566:  Hold'em No Limit ($0.05/$0.10 USD) - 2021/01/23 19:24:53 ET
Table 'Jihlava III' 6-max Seat #4 is the button
Seat 1: No1Sparkles ($10 in chips) 
Seat 2: JJOOKKEER 77 ($5.40 in chips) 
Seat 4: jimeshka ($1.44 in chips) 
Seat 5: fyllejon ($16.39 in chips) 
Seat 6: Dimas.irk ($10 in chips) 
fyllejon: posts small blind $0.05
Dimas.irk: posts big blind $0.10
KiraLasVegas: sits out 
*** HOLE CARDS ***
No1Sparkles: folds 
JJOOKKEER 77: raises $0.20 to $0.30
jimeshka: calls $0.30
fyllejon: folds 
Dimas.irk: folds 
*** FLOP *** [5s 7c 2d]
JJOOKKEER 77: bets $0.36
jimeshka: calls $0.36
*** TURN *** [5s 7c 2d] [8d]
JJOOKKEER 77: bets $1.40
jimeshka: folds 
Uncalled bet ($1.40) returned to JJOOKKEER 77
JJOOKKEER 77 collected $1.40 from pot
*** SUMMARY ***
Total pot $1.47 | Rake $0.07 
Board [5s 7c 2d 8d]
Seat 1: No1Sparkles folded before Flop (didn't bet)
Seat 2: JJOOKKEER 77 collected ($1.40)
Seat 4: jimeshka (button) folded on the Turn
Seat 5: fyllejon (small blind) folded before Flop
Seat 6: Dimas.irk (big blind) folded before Flop



PokerStars Hand #222979763492:  Hold'em No Limit ($0.05/$0.10 USD) - 2021/01/23 19:25:36 ET
Table 'Jihlava III' 6-max Seat #5 is the button
Seat 1: No1Sparkles ($10 in chips) 
Seat 2: JJOOKKEER 77 ($6.14 in chips) 
Seat 4: jimeshka ($0.78 in chips) 
Seat 5: fyllejon ($16.34 in chips) 
Seat 6: Dimas.irk ($9.90 in chips) 
Dimas.irk: posts small blind $0.05
No1Sparkles: posts big blind $0.10
KiraLasVegas: sits out 
*** HOLE CARDS ***
JJOOKKEER 77: folds 
jimeshka: folds 
fyllejon: folds 
Dimas.irk: folds 
Uncalled bet ($0.05) returned to No1Sparkles
No1Sparkles collected $0.10 from pot
No1Sparkles: doesn't show hand 
*** SUMMARY ***
Total pot $0.10 | Rake $0 
Seat 1: No1Sparkles (big blind) collected ($0.10)
Seat 2: JJOOKKEER 77 folded before Flop (didn't bet)
Seat 4: jimeshka folded before Flop (didn't bet)
Seat 5: fyllejon (button) folded before Flop (didn't bet)
Seat 6: Dimas.irk (small blind) folded before Flop



PokerStars Hand #222979767835:  Hold'em No Limit ($0.05/$0.10 USD) - 2021/01/23 19:25:45 ET
Table 'Jihlava III' 6-max Seat #6 is the button
Seat 1: No1Sparkles ($10.05 in chips) 
Seat 2: JJOOKKEER 77 ($6.14 in chips) 
Seat 4: jimeshka ($0.78 in chips) 
Seat 5: fyllejon ($16.34 in chips) 
Seat 6: Dimas.irk ($9.85 in chips) 
No1Sparkles: posts small blind $0.05
JJOOKKEER 77: posts big blind $0.10
KiraLasVegas: sits out 
*** HOLE CARDS ***
jimeshka: folds 
fyllejon: raises $0.10 to $0.20
Dimas.irk: folds 
No1Sparkles: raises $0.50 to $0.70
JJOOKKEER 77: folds 
fyllejon: folds 
Uncalled bet ($0.50) returned to No1Sparkles
No1Sparkles collected $0.50 from pot
No1Sparkles: doesn't show hand 
*** SUMMARY ***
Total pot $0.50 | Rake $0 
Seat 1: No1Sparkles (small blind) collected ($0.50)
Seat 2: JJOOKKEER 77 (big blind) folded before Flop
Seat 4: jimeshka folded before Flop (didn't bet)
Seat 5: fyllejon folded before Flop
Seat 6: Dimas.irk (button) folded before Flop (didn't bet)



PokerStars Hand #222979776662:  Hold'em No Limit ($0.05/$0.10 USD) - 2021/01/23 19:26:01 ET
Table 'Jihlava III' 6-max Seat #1 is the button
Seat 1: No1Sparkles ($10.35 in chips) 
Seat 2: JJOOKKEER 77 ($6.04 in chips) 
Seat 3: KiraLasVegas ($10 in chips) 
Seat 4: jimeshka ($0.78 in chips) 
Seat 5: fyllejon ($16.14 in chips) 
Seat 6: Dimas.irk ($9.85 in chips) 
JJOOKKEER 77: posts small blind $0.05
KiraLasVegas: posts big blind $0.10
*** HOLE CARDS ***
jimeshka: raises $0.10 to $0.20
fyllejon: calls $0.20
Dimas.irk: folds 
No1Sparkles: folds 
JJOOKKEER 77: calls $0.15
KiraLasVegas: folds 
*** FLOP *** [4d Ts 8s]
JJOOKKEER 77: checks 
jimeshka: checks 
fyllejon: bets $0.30
JJOOKKEER 77: calls $0.30
jimeshka: folds 
*** TURN *** [4d Ts 8s] [3d]
JJOOKKEER 77: checks 
fyllejon: bets $0.50
JJOOKKEER 77: calls $0.50
*** RIVER *** [4d Ts 8s 3d] [Ks]
JJOOKKEER 77: bets $1.60
fyllejon: calls $1.60
*** SHOW DOWN ***
JJOOKKEER 77: shows [7s 6d] (high card King)
fyllejon: shows [4h 8h] (two pair, Eights and Fours)
fyllejon collected $5.25 from pot
*** SUMMARY ***
Total pot $5.50 | Rake $0.25 
Board [4d Ts 8s 3d Ks]
Seat 1: No1Sparkles (button) folded before Flop (didn't bet)
Seat 2: JJOOKKEER 77 (small blind) showed [7s 6d] and lost with high card King
Seat 3: KiraLasVegas (big blind) folded before Flop
Seat 4: jimeshka folded on the Flop
Seat 5: fyllejon showed [4h 8h] and won ($5.25) with two pair, Eights and Fours
Seat 6: Dimas.irk folded before Flop (didn't bet)



PokerStars Hand #222979816223:  Hold'em No Limit ($0.05/$0.10 USD) - 2021/01/23 19:27:12 ET
Table 'Jihlava III' 6-max Seat #2 is the button
Seat 1: No1Sparkles ($10.35 in chips) 
Seat 2: JJOOKKEER 77 ($3.44 in chips) 
Seat 3: KiraLasVegas ($10 in chips) 
Seat 4: jimeshka ($0.58 in chips) 
Seat 5: fyllejon ($18.79 in chips) 
Seat 6: Dimas.irk ($9.85 in chips) 
KiraLasVegas: posts small blind $0.05
jimeshka: posts big blind $0.10
*** HOLE CARDS ***
fyllejon: folds 
Dimas.irk: raises $0.20 to $0.30
No1Sparkles: folds 
JJOOKKEER 77: folds 
KiraLasVegas: folds 
jimeshka: folds 
Uncalled bet ($0.20) returned to Dimas.irk
Dimas.irk collected $0.25 from pot
Dimas.irk: doesn't show hand 
*** SUMMARY ***
Total pot $0.25 | Rake $0 
Seat 1: No1Sparkles folded before Flop (didn't bet)
Seat 2: JJOOKKEER 77 (button) folded before Flop (didn't bet)
Seat 3: KiraLasVegas (small blind) folded before Flop
Seat 4: jimeshka (big blind) folded before Flop
Seat 5: fyllejon folded before Flop (didn't bet)
Seat 6: Dimas.irk collected ($0.25)



PokerStars Hand #222979826498:  Hold'em No Limit ($0.05/$0.10 USD) - 2021/01/23 19:27:31 ET
Table 'Jihlava III' 6-max Seat #3 is the button
Seat 1: No1Sparkles ($10.35 in chips) 
Seat 2: JJOOKKEER 77 ($3.44 in chips) 
Seat 3: KiraLasVegas ($10 in chips) 
Seat 4: jimeshka ($0.48 in chips) 
Seat 5: fyllejon ($18.79 in chips) 
Seat 6: Dimas.irk ($10 in chips) 
jimeshka: posts small blind $0.05
fyllejon: posts big blind $0.10
*** HOLE CARDS ***
Dimas.irk: folds 
No1Sparkles: folds 
JJOOKKEER 77: raises $0.20 to $0.30
KiraLasVegas: folds 
jimeshka: folds 
fyllejon: folds 
Uncalled bet ($0.20) returned to JJOOKKEER 77
JJOOKKEER 77 collected $0.25 from pot
*** SUMMARY ***
Total pot $0.25 | Rake $0 
Seat 1: No1Sparkles folded before Flop (didn't bet)
Seat 2: JJOOKKEER 77 collected ($0.25)
Seat 3: KiraLasVegas (button) folded before Flop (didn't bet)
Seat 4: jimeshka (small blind) folded before Flop
Seat 5: fyllejon (big blind) folded before Flop
Seat 6: Dimas.irk folded before Flop (didn't bet)



PokerStars Hand #222979837188:  Hold'em No Limit ($0.05/$0.10 USD) - 2021/01/23 19:27:51 ET
Table 'Jihlava III' 6-max Seat #4 is the button
Seat 1: No1Sparkles ($10.35 in chips) 
Seat 2: JJOOKKEER 77 ($3.59 in chips) 
Seat 3: KiraLasVegas ($10 in chips) 
Seat 4: jimeshka ($0.43 in chips) 
Seat 5: fyllejon ($18.69 in chips) 
Seat 6: Dimas.irk ($10 in chips) 
fyllejon: posts small blind $0.05
Dimas.irk: posts big blind $0.10
*** HOLE CARDS ***
No1Sparkles: folds 
JJOOKKEER 77: raises $0.10 to $0.20
KiraLasVegas: folds 
jimeshka: calls $0.20
fyllejon: raises $0.30 to $0.50
Dimas.irk: folds 
JJOOKKEER 77: calls $0.30
jimeshka: calls $0.23 and is all-in
*** FLOP *** [Ks Qh 9c]
fyllejon: checks 
JJOOKKEER 77: bets $0.40
fyllejon: calls $0.40
*** TURN *** [Ks Qh 9c] [5s]
fyllejon: checks 
Dimas.irk leaves the table
JJOOKKEER 77: bets $0.90
fyllejon: calls $0.90
*** RIVER *** [Ks Qh 9c 5s] [9h]
fyllejon: checks 
JJOOKKEER 77: bets $1.79 and is all-in
fyllejon: calls $1.79
*** SHOW DOWN ***
JJOOKKEER 77: shows [Js Tc] (a straight, Nine to King)
fyllejon: shows [Td Ts] (two pair, Tens and Nines)
JJOOKKEER 77 collected $6.03 from side pot
jimeshka: shows [As Th] (a pair of Nines)
JJOOKKEER 77 collected $1.33 from main pot
*** SUMMARY ***
Total pot $7.71 Main pot $1.33. Side pot $6.03. | Rake $0.35 
Board [Ks Qh 9c 5s 9h]
Seat 1: No1Sparkles folded before Flop (didn't bet)
Seat 2: JJOOKKEER 77 showed [Js Tc] and won ($7.36) with a straight, Nine to King
Seat 3: KiraLasVegas folded before Flop (didn't bet)
Seat 4: jimeshka (button) showed [As Th] and lost with a pair of Nines
Seat 5: fyllejon (small blind) showed [Td Ts] and lost with two pair, Tens and Nines
Seat 6: Dimas.irk (big blind) folded before Flop



PokerStars Hand #222979869362:  Hold'em No Limit ($0.05/$0.10 USD) - 2021/01/23 19:28:53 ET
Table 'Jihlava III' 6-max Seat #5 is the button
Seat 1: No1Sparkles ($10.35 in chips) 
Seat 2: JJOOKKEER 77 ($7.36 in chips) 
Seat 3: KiraLasVegas ($10 in chips) 
Seat 5: fyllejon ($15.10 in chips) 
No1Sparkles: posts small blind $0.05
JJOOKKEER 77: posts big blind $0.10
*** HOLE CARDS ***
jimeshka leaves the table
KiraLasVegas: folds 
fyllejon: folds 
No1Sparkles: folds 
Uncalled bet ($0.05) returned to JJOOKKEER 77
JJOOKKEER 77 collected $0.10 from pot
fyllejon leaves the table
*** SUMMARY ***
Total pot $0.10 | Rake $0 
Seat 1: No1Sparkles (small blind) folded before Flop
Seat 2: JJOOKKEER 77 (big blind) collected ($0.10)
Seat 3: KiraLasVegas folded before Flop (didn't bet)
Seat 5: fyllejon (button) folded before Flop (didn't bet)



PokerStars Hand #222979875032:  Hold'em No Limit ($0.05/$0.10 USD) - 2021/01/23 19:29:04 ET
Table 'Jihlava III' 6-max Seat #1 is the button
Seat 1: No1Sparkles ($10.30 in chips) 
Seat 2: JJOOKKEER 77 ($7.41 in chips) 
Seat 3: KiraLasVegas ($10 in chips) 
JJOOKKEER 77: posts small blind $0.05
KiraLasVegas: posts big blind $0.10
*** HOLE CARDS ***
No1Sparkles: folds 
JJOOKKEER 77: folds 
Uncalled bet ($0.05) returned to KiraLasVegas
KiraLasVegas collected $0.10 from pot
KiraLasVegas: doesn't show hand 
*** SUMMARY ***
Total pot $0.10 | Rake $0 
Seat 1: No1Sparkles (button) folded before Flop (didn't bet)
Seat 2: JJOOKKEER 77 (small blind) folded before Flop
Seat 3: KiraLasVegas (big blind) collected ($0.10)



PokerStars Hand #222979878819:  Hold'em No Limit ($0.05/$0.10 USD) - 2021/01/23 19:29:11 ET
Table 'Jihlava III' 6-max Seat #3 is the button
Seat 2: JJOOKKEER 77 ($7.36 in chips) 
Seat 3: KiraLasVegas ($10.05 in chips) 
KiraLasVegas: posts small blind $0.05
No1Sparkles: is sitting out 
No1Sparkles leaves the table
JJOOKKEER 77: posts big blind $0.10
*** HOLE CARDS ***
KiraLasVegas: raises $0.15 to $0.25
Vecherov joins the table at seat #4 
JJOOKKEER 77: calls $0.15
*** FLOP *** [Td Jc Ks]
JJOOKKEER 77: checks 
KiraLasVegas: bets $0.17
JJOOKKEER 77: folds 
Uncalled bet ($0.17) returned to KiraLasVegas
KiraLasVegas collected $0.48 from pot
KiraLasVegas: doesn't show hand 
*** SUMMARY ***
Total pot $0.50 | Rake $0.02 
Board [Td Jc Ks]
Seat 2: JJOOKKEER 77 (big blind) folded on the Flop
Seat 3: KiraLasVegas (button) (small blind) collected ($0.48)



PokerStars Hand #222979887949:  Hold'em No Limit ($0.05/$0.10 USD) - 2021/01/23 19:29:29 ET
Table 'Jihlava III' 6-max Seat #2 is the button
Seat 2: JJOOKKEER 77 ($7.11 in chips) 
Seat 3: KiraLasVegas ($10.28 in chips) 
Seat 4: Vecherov ($10 in chips) 
KiraLasVegas: posts small blind $0.05
Vecherov: posts big blind $0.10
*** HOLE CARDS ***
JJOOKKEER 77: folds 
JJOOKKEER 77 leaves the table
KiraLasVegas: folds 
Uncalled bet ($0.05) returned to Vecherov
Vecherov collected $0.10 from pot
Vecherov: doesn't show hand 
*** SUMMARY ***
Total pot $0.10 | Rake $0 
Seat 2: JJOOKKEER 77 (button) folded before Flop (didn't bet)
Seat 3: KiraLasVegas (small blind) folded before Flop
Seat 4: Vecherov (big blind) collected ($0.10)



