PokerStars Hand #222960121588:  Hold'em No Limit ($0.05/$0.10 USD) - 2021/01/23 11:58:33 ET
Table 'Shura III' 6-max Seat #2 is the button
Seat 2: kkiely241 ($5.25 in chips) 
Seat 3: Burlica2013 ($10.18 in chips) 
Seat 4: eldar919 ($10 in chips) 
Burlica2013: posts small blind $0.05
eldar919: posts big blind $0.10
sampforeve: sits out 
*** HOLE CARDS ***
kkiely241: folds 
Burlica2013: raises $0.15 to $0.25
Daurado joins the table at seat #5 
eldar919: calls $0.15
*** FLOP *** [Qd Jd 7d]
Burlica2013: bets $0.24
eldar919: folds 
Uncalled bet ($0.24) returned to Burlica2013
Burlica2013 collected $0.48 from pot
*** SUMMARY ***
Total pot $0.50 | Rake $0.02 
Board [Qd Jd 7d]
Seat 2: kkiely241 (button) folded before Flop (didn't bet)
Seat 3: Burlica2013 (small blind) collected ($0.48)
Seat 4: eldar919 (big blind) folded on the Flop



PokerStars Hand #222960132987:  Hold'em No Limit ($0.05/$0.10 USD) - 2021/01/23 11:58:57 ET
Table 'Shura III' 6-max Seat #3 is the button
Seat 2: kkiely241 ($5.25 in chips) 
Seat 3: Burlica2013 ($10.41 in chips) 
Seat 4: eldar919 ($10 in chips) 
Seat 5: Daurado ($10 in chips) 
eldar919: posts small blind $0.05
Daurado: posts big blind $0.10
sampforeve: sits out 
*** HOLE CARDS ***
kkiely241: folds 
Burlica2013: raises $0.15 to $0.25
eldar919: folds 
samrowe1 joins the table at seat #6 
Daurado: folds 
Uncalled bet ($0.15) returned to Burlica2013
Burlica2013 collected $0.25 from pot
*** SUMMARY ***
Total pot $0.25 | Rake $0 
Seat 2: kkiely241 folded before Flop (didn't bet)
Seat 3: Burlica2013 (button) collected ($0.25)
Seat 4: eldar919 (small blind) folded before Flop
Seat 5: Daurado (big blind) folded before Flop



PokerStars Hand #222960139356:  Hold'em No Limit ($0.05/$0.10 USD) - 2021/01/23 11:59:11 ET
Table 'Shura III' 6-max Seat #4 is the button
Seat 2: kkiely241 ($5.25 in chips) 
Seat 3: Burlica2013 ($10.56 in chips) 
Seat 4: eldar919 ($10 in chips) 
Seat 5: Daurado ($10 in chips) 
Seat 6: samrowe1 ($10 in chips) 
Daurado: posts small blind $0.05
samrowe1: posts big blind $0.10
sampforeve: sits out 
*** HOLE CARDS ***
kkiely241: folds 
Burlica2013: raises $0.15 to $0.25
eldar919: raises $0.65 to $0.90
Daurado: folds 
samrowe1: calls $0.80
Burlica2013: folds 
*** FLOP *** [Qd 2c 7d]
samrowe1: checks 
eldar919: checks 
*** TURN *** [Qd 2c 7d] [6c]
samrowe1: checks 
eldar919: bets $1.45
samrowe1: calls $1.45
*** RIVER *** [Qd 2c 7d 6c] [7h]
samrowe1: checks 
eldar919: bets $4.78
samrowe1: folds 
Uncalled bet ($4.78) returned to eldar919
eldar919 collected $4.78 from pot
eldar919: doesn't show hand 
*** SUMMARY ***
Total pot $5 | Rake $0.22 
Board [Qd 2c 7d 6c 7h]
Seat 2: kkiely241 folded before Flop (didn't bet)
Seat 3: Burlica2013 folded before Flop
Seat 4: eldar919 (button) collected ($4.78)
Seat 5: Daurado (small blind) folded before Flop
Seat 6: samrowe1 (big blind) folded on the River



PokerStars Hand #222960158736:  Hold'em No Limit ($0.05/$0.10 USD) - 2021/01/23 11:59:52 ET
Table 'Shura III' 6-max Seat #5 is the button
Seat 1: sampforeve ($10 in chips) 
Seat 2: kkiely241 ($5.25 in chips) 
Seat 3: Burlica2013 ($10.31 in chips) 
Seat 4: eldar919 ($12.43 in chips) 
Seat 5: Daurado ($10 in chips) 
Seat 6: samrowe1 ($7.65 in chips) 
samrowe1: posts small blind $0.05
sampforeve: posts big blind $0.10
*** HOLE CARDS ***
kkiely241: calls $0.10
Burlica2013: folds 
eldar919: folds 
Daurado: folds 
samrowe1: raises $0.20 to $0.30
sampforeve: folds 
kkiely241: calls $0.20
*** FLOP *** [3s 9d Kd]
samrowe1: bets $0.10
kkiely241: calls $0.10
*** TURN *** [3s 9d Kd] [2h]
samrowe1: checks 
kkiely241: checks 
*** RIVER *** [3s 9d Kd 2h] [7s]
samrowe1: checks 
kkiely241: checks 
*** SHOW DOWN ***
samrowe1: shows [Qs Ks] (a pair of Kings)
kkiely241: mucks hand 
samrowe1 collected $0.86 from pot
*** SUMMARY ***
Total pot $0.90 | Rake $0.04 
Board [3s 9d Kd 2h 7s]
Seat 1: sampforeve (big blind) folded before Flop
Seat 2: kkiely241 mucked
Seat 3: Burlica2013 folded before Flop (didn't bet)
Seat 4: eldar919 folded before Flop (didn't bet)
Seat 5: Daurado (button) folded before Flop (didn't bet)
Seat 6: samrowe1 (small blind) showed [Qs Ks] and won ($0.86) with a pair of Kings



PokerStars Hand #222960182637:  Hold'em No Limit ($0.05/$0.10 USD) - 2021/01/23 12:00:39 ET
Table 'Shura III' 6-max Seat #6 is the button
Seat 1: sampforeve ($10 in chips) 
Seat 2: kkiely241 ($4.85 in chips) 
Seat 3: Burlica2013 ($10.31 in chips) 
Seat 4: eldar919 ($12.43 in chips) 
Seat 5: Daurado ($10 in chips) 
Seat 6: samrowe1 ($8.11 in chips) 
sampforeve: posts small blind $0.05
kkiely241: posts big blind $0.10
*** HOLE CARDS ***
Burlica2013: folds 
eldar919: raises $0.15 to $0.25
Daurado: folds 
samrowe1: folds 
sampforeve: folds 
kkiely241: folds 
Uncalled bet ($0.15) returned to eldar919
eldar919 collected $0.25 from pot
eldar919: doesn't show hand 
*** SUMMARY ***
Total pot $0.25 | Rake $0 
Seat 1: sampforeve (small blind) folded before Flop
Seat 2: kkiely241 (big blind) folded before Flop
Seat 3: Burlica2013 folded before Flop (didn't bet)
Seat 4: eldar919 collected ($0.25)
Seat 5: Daurado folded before Flop (didn't bet)
Seat 6: samrowe1 (button) folded before Flop (didn't bet)



PokerStars Hand #222960187117:  Hold'em No Limit ($0.05/$0.10 USD) - 2021/01/23 12:00:48 ET
Table 'Shura III' 6-max Seat #1 is the button
Seat 1: sampforeve ($10 in chips) 
Seat 2: kkiely241 ($4.75 in chips) 
Seat 3: Burlica2013 ($10.31 in chips) 
Seat 4: eldar919 ($12.58 in chips) 
Seat 5: Daurado ($10 in chips) 
Seat 6: samrowe1 ($8.11 in chips) 
kkiely241: posts small blind $0.05
Burlica2013: posts big blind $0.10
*** HOLE CARDS ***
eldar919: folds 
Daurado: folds 
samrowe1: calls $0.10
sampforeve: folds 
kkiely241: calls $0.05
Burlica2013: checks 
*** FLOP *** [Tc 4d 4h]
kkiely241: checks 
Burlica2013: checks 
samrowe1: checks 
*** TURN *** [Tc 4d 4h] [2h]
kkiely241: checks 
Burlica2013: bets $0.22
samrowe1: folds 
kkiely241: folds 
Uncalled bet ($0.22) returned to Burlica2013
Burlica2013 collected $0.29 from pot
*** SUMMARY ***
Total pot $0.30 | Rake $0.01 
Board [Tc 4d 4h 2h]
Seat 1: sampforeve (button) folded before Flop (didn't bet)
Seat 2: kkiely241 (small blind) folded on the Turn
Seat 3: Burlica2013 (big blind) collected ($0.29)
Seat 4: eldar919 folded before Flop (didn't bet)
Seat 5: Daurado folded before Flop (didn't bet)
Seat 6: samrowe1 folded on the Turn



PokerStars Hand #222960214315:  Hold'em No Limit ($0.05/$0.10 USD) - 2021/01/23 12:01:23 ET
Table 'Shura III' 6-max Seat #2 is the button
Seat 1: sampforeve ($10 in chips) 
Seat 2: kkiely241 ($4.65 in chips) 
Seat 3: Burlica2013 ($10.50 in chips) 
Seat 4: eldar919 ($12.58 in chips) 
Seat 5: Daurado ($10 in chips) 
Seat 6: samrowe1 ($8.01 in chips) 
Burlica2013: posts small blind $0.05
eldar919: posts big blind $0.10
*** HOLE CARDS ***
Daurado: folds 
samrowe1: folds 
sampforeve: folds 
kkiely241: folds 
Burlica2013: folds 
Uncalled bet ($0.05) returned to eldar919
eldar919 collected $0.10 from pot
eldar919: doesn't show hand 
*** SUMMARY ***
Total pot $0.10 | Rake $0 
Seat 1: sampforeve folded before Flop (didn't bet)
Seat 2: kkiely241 (button) folded before Flop (didn't bet)
Seat 3: Burlica2013 (small blind) folded before Flop
Seat 4: eldar919 (big blind) collected ($0.10)
Seat 5: Daurado folded before Flop (didn't bet)
Seat 6: samrowe1 folded before Flop (didn't bet)



PokerStars Hand #222960220170:  Hold'em No Limit ($0.05/$0.10 USD) - 2021/01/23 12:01:33 ET
Table 'Shura III' 6-max Seat #3 is the button
Seat 1: sampforeve ($10 in chips) 
Seat 2: kkiely241 ($4.65 in chips) 
Seat 3: Burlica2013 ($10.45 in chips) 
Seat 4: eldar919 ($12.63 in chips) 
Seat 5: Daurado ($10 in chips) 
Seat 6: samrowe1 ($8.01 in chips) 
eldar919: posts small blind $0.05
Daurado: posts big blind $0.10
*** HOLE CARDS ***
samrowe1: raises $0.20 to $0.30
sampforeve: folds 
kkiely241: folds 
Burlica2013: folds 
eldar919: raises $0.55 to $0.85
Daurado: folds 
samrowe1: calls $0.55
*** FLOP *** [3c Th 9s]
eldar919: bets $0.86
kkiely241 leaves the table
samrowe1: calls $0.86
*** TURN *** [3c Th 9s] [7h]
The-12Discipol joins the table at seat #2 
eldar919: bets $1.68
samrowe1: raises $1.68 to $3.36
eldar919: folds 
Uncalled bet ($1.68) returned to samrowe1
samrowe1 collected $6.57 from pot
*** SUMMARY ***
Total pot $6.88 | Rake $0.31 
Board [3c Th 9s 7h]
Seat 1: sampforeve folded before Flop (didn't bet)
Seat 2: kkiely241 folded before Flop (didn't bet)
Seat 3: Burlica2013 (button) folded before Flop (didn't bet)
Seat 4: eldar919 (small blind) folded on the Turn
Seat 5: Daurado (big blind) folded before Flop
Seat 6: samrowe1 collected ($6.57)



PokerStars Hand #222960243706:  Hold'em No Limit ($0.05/$0.10 USD) - 2021/01/23 12:02:11 ET
Table 'Shura III' 6-max Seat #4 is the button
Seat 1: sampforeve ($10 in chips) 
Seat 2: The-12Discipol ($6.07 in chips) 
Seat 3: Burlica2013 ($10.45 in chips) 
Seat 4: eldar919 ($10 in chips) 
Seat 5: Daurado ($10 in chips) 
Seat 6: samrowe1 ($11.19 in chips) 
Daurado: posts small blind $0.05
samrowe1: posts big blind $0.10
The-12Discipol: posts big blind $0.10
*** HOLE CARDS ***
sampforeve: folds 
The-12Discipol: raises $0.30 to $0.40
Burlica2013: folds 
eldar919: calls $0.40
Daurado: folds 
samrowe1: folds 
*** FLOP *** [6h Ac 2s]
The-12Discipol: checks 
eldar919: bets $0.46
The-12Discipol: raises $0.76 to $1.22
eldar919: folds 
Uncalled bet ($0.76) returned to The-12Discipol
The-12Discipol collected $1.79 from pot
*** SUMMARY ***
Total pot $1.87 | Rake $0.08 
Board [6h Ac 2s]
Seat 1: sampforeve folded before Flop (didn't bet)
Seat 2: The-12Discipol collected ($1.79)
Seat 3: Burlica2013 folded before Flop (didn't bet)
Seat 4: eldar919 (button) folded on the Flop
Seat 5: Daurado (small blind) folded before Flop
Seat 6: samrowe1 (big blind) folded before Flop



PokerStars Hand #222960258023:  Hold'em No Limit ($0.05/$0.10 USD) - 2021/01/23 12:02:35 ET
Table 'Shura III' 6-max Seat #5 is the button
Seat 1: sampforeve ($10 in chips) 
Seat 2: The-12Discipol ($7 in chips) 
Seat 3: Burlica2013 ($10.45 in chips) 
Seat 4: eldar919 ($10 in chips) 
Seat 5: Daurado ($10 in chips) 
Seat 6: samrowe1 ($11.09 in chips) 
samrowe1: posts small blind $0.05
sampforeve: posts big blind $0.10
*** HOLE CARDS ***
The-12Discipol: folds 
Burlica2013: folds 
eldar919: folds 
Daurado: folds 
samrowe1: raises $0.20 to $0.30
sampforeve: calls $0.20
*** FLOP *** [5h 5c 2h]
samrowe1: checks 
sampforeve: checks 
*** TURN *** [5h 5c 2h] [Jh]
samrowe1: bets $0.10
sampforeve: raises $0.25 to $0.35
samrowe1: raises $0.25 to $0.60
sampforeve: calls $0.25
*** RIVER *** [5h 5c 2h Jh] [2d]
samrowe1: bets $0.86
sampforeve: folds 
Uncalled bet ($0.86) returned to samrowe1
samrowe1 collected $1.72 from pot
samrowe1: doesn't show hand 
*** SUMMARY ***
Total pot $1.80 | Rake $0.08 
Board [5h 5c 2h Jh 2d]
Seat 1: sampforeve (big blind) folded on the River
Seat 2: The-12Discipol folded before Flop (didn't bet)
Seat 3: Burlica2013 folded before Flop (didn't bet)
Seat 4: eldar919 folded before Flop (didn't bet)
Seat 5: Daurado (button) folded before Flop (didn't bet)
Seat 6: samrowe1 (small blind) collected ($1.72)



PokerStars Hand #222960280066:  Hold'em No Limit ($0.05/$0.10 USD) - 2021/01/23 12:03:10 ET
Table 'Shura III' 6-max Seat #6 is the button
Seat 1: sampforeve ($10 in chips) 
Seat 2: The-12Discipol ($7 in chips) 
Seat 3: Burlica2013 ($10.45 in chips) 
Seat 4: eldar919 ($10 in chips) 
Seat 5: Daurado ($10 in chips) 
Seat 6: samrowe1 ($11.91 in chips) 
sampforeve: posts small blind $0.05
The-12Discipol: posts big blind $0.10
*** HOLE CARDS ***
Burlica2013: folds 
eldar919: raises $0.20 to $0.30
Daurado: folds 
samrowe1: folds 
sampforeve: folds 
The-12Discipol: raises $0.65 to $0.95
eldar919: calls $0.65
*** FLOP *** [Kd Ah 5c]
The-12Discipol: bets $6.05 and is all-in
eldar919: folds 
Uncalled bet ($6.05) returned to The-12Discipol
The-12Discipol collected $1.86 from pot
*** SUMMARY ***
Total pot $1.95 | Rake $0.09 
Board [Kd Ah 5c]
Seat 1: sampforeve (small blind) folded before Flop
Seat 2: The-12Discipol (big blind) collected ($1.86)
Seat 3: Burlica2013 folded before Flop (didn't bet)
Seat 4: eldar919 folded on the Flop
Seat 5: Daurado folded before Flop (didn't bet)
Seat 6: samrowe1 (button) folded before Flop (didn't bet)



PokerStars Hand #222960304967:  Hold'em No Limit ($0.05/$0.10 USD) - 2021/01/23 12:03:50 ET
Table 'Shura III' 6-max Seat #1 is the button
Seat 1: sampforeve ($10 in chips) 
Seat 2: The-12Discipol ($7.91 in chips) 
Seat 3: Burlica2013 ($10.45 in chips) 
Seat 4: eldar919 ($10 in chips) 
Seat 5: Daurado ($10 in chips) 
Seat 6: samrowe1 ($11.91 in chips) 
The-12Discipol: posts small blind $0.05
Burlica2013: posts big blind $0.10
*** HOLE CARDS ***
eldar919 has timed out
eldar919: folds 
Daurado: folds 
samrowe1: calls $0.10
sampforeve: folds 
The-12Discipol: folds 
Burlica2013: checks 
*** FLOP *** [Th Td 6s]
Burlica2013: checks 
samrowe1: checks 
*** TURN *** [Th Td 6s] [5d]
Burlica2013: checks 
samrowe1: checks 
*** RIVER *** [Th Td 6s 5d] [Qc]
Burlica2013: checks 
samrowe1: checks 
*** SHOW DOWN ***
Burlica2013: shows [3s Jd] (a pair of Tens)
samrowe1: shows [2c Jc] (a pair of Tens)
Burlica2013 collected $0.12 from pot
samrowe1 collected $0.12 from pot
*** SUMMARY ***
Total pot $0.25 | Rake $0.01 
Board [Th Td 6s 5d Qc]
Seat 1: sampforeve (button) folded before Flop (didn't bet)
Seat 2: The-12Discipol (small blind) folded before Flop
Seat 3: Burlica2013 (big blind) showed [3s Jd] and won ($0.12) with a pair of Tens
Seat 4: eldar919 folded before Flop (didn't bet)
Seat 5: Daurado folded before Flop (didn't bet)
Seat 6: samrowe1 showed [2c Jc] and won ($0.12) with a pair of Tens



PokerStars Hand #222960333324:  Hold'em No Limit ($0.05/$0.10 USD) - 2021/01/23 12:04:35 ET
Table 'Shura III' 6-max Seat #2 is the button
Seat 1: sampforeve ($10 in chips) 
Seat 2: The-12Discipol ($7.86 in chips) 
Seat 3: Burlica2013 ($10.47 in chips) 
Seat 4: eldar919 ($10 in chips) 
Seat 5: Daurado ($10 in chips) 
Seat 6: samrowe1 ($11.93 in chips) 
Burlica2013: posts small blind $0.05
eldar919: posts big blind $0.10
*** HOLE CARDS ***
Daurado: folds 
samrowe1: folds 
sampforeve: raises $0.20 to $0.30
The-12Discipol: folds 
Burlica2013: folds 
The-12Discipol leaves the table
eldar919: folds 
Uncalled bet ($0.20) returned to sampforeve
sampforeve collected $0.25 from pot
*** SUMMARY ***
Total pot $0.25 | Rake $0 
Seat 1: sampforeve collected ($0.25)
Seat 2: The-12Discipol (button) folded before Flop (didn't bet)
Seat 3: Burlica2013 (small blind) folded before Flop
Seat 4: eldar919 (big blind) folded before Flop
Seat 5: Daurado folded before Flop (didn't bet)
Seat 6: samrowe1 folded before Flop (didn't bet)



PokerStars Hand #222960347394:  Hold'em No Limit ($0.05/$0.10 USD) - 2021/01/23 12:04:57 ET
Table 'Shura III' 6-max Seat #3 is the button
Seat 1: sampforeve ($10.15 in chips) 
Seat 3: Burlica2013 ($10.42 in chips) 
Seat 4: eldar919 ($10 in chips) 
Seat 5: Daurado ($10 in chips) 
Seat 6: samrowe1 ($11.93 in chips) 
eldar919: posts small blind $0.05
Daurado: posts big blind $0.10
*** HOLE CARDS ***
samrowe1: calls $0.10
sampforeve: raises $0.30 to $0.40
Burlica2013: folds 
eldar919: folds 
Daurado: folds 
samrowe1: calls $0.30
*** FLOP *** [3h Ts 6h]
samrowe1: checks 
sampforeve: bets $0.50
samrowe1: calls $0.50
*** TURN *** [3h Ts 6h] [Kd]
samrowe1: checks 
sampforeve: bets $1.40
samrowe1: calls $1.40
*** RIVER *** [3h Ts 6h Kd] [Qc]
samrowe1: checks 
sampforeve: bets $1.50
samrowe1: folds 
Uncalled bet ($1.50) returned to sampforeve
sampforeve collected $4.54 from pot
*** SUMMARY ***
Total pot $4.75 | Rake $0.21 
Board [3h Ts 6h Kd Qc]
Seat 1: sampforeve collected ($4.54)
Seat 3: Burlica2013 (button) folded before Flop (didn't bet)
Seat 4: eldar919 (small blind) folded before Flop
Seat 5: Daurado (big blind) folded before Flop
Seat 6: samrowe1 folded on the River



PokerStars Hand #222960381804:  Hold'em No Limit ($0.05/$0.10 USD) - 2021/01/23 12:05:52 ET
Table 'Shura III' 6-max Seat #4 is the button
Seat 1: sampforeve ($12.39 in chips) 
Seat 3: Burlica2013 ($10.42 in chips) 
Seat 4: eldar919 ($10 in chips) 
Seat 5: Daurado ($10 in chips) 
Seat 6: samrowe1 ($9.63 in chips) 
Daurado: posts small blind $0.05
samrowe1: posts big blind $0.10
*** HOLE CARDS ***
sampforeve: raises $0.20 to $0.30
Burlica2013: raises $0.90 to $1.20
eldar919: calls $1.20
Daurado: folds 
samrowe1: folds 
sampforeve: folds 
*** FLOP *** [5s 7h Qc]
Burlica2013: bets $1.36
eldar919: raises $1.36 to $2.72
Burlica2013: calls $1.36
*** TURN *** [5s 7h Qc] [6d]
Burlica2013: checks 
eldar919: checks 
*** RIVER *** [5s 7h Qc 6d] [4d]
Burlica2013: checks 
eldar919: bets $3.96
Burlica2013: calls $3.96
*** SHOW DOWN ***
eldar919: shows [Kd Kh] (a pair of Kings)
Burlica2013: shows [Ks Kc] (a pair of Kings)
Burlica2013 collected $7.74 from pot
eldar919 collected $7.74 from pot
*** SUMMARY ***
Total pot $16.21 | Rake $0.73 
Board [5s 7h Qc 6d 4d]
Seat 1: sampforeve folded before Flop
Seat 3: Burlica2013 showed [Ks Kc] and won ($7.74) with a pair of Kings
Seat 4: eldar919 (button) showed [Kd Kh] and won ($7.74) with a pair of Kings
Seat 5: Daurado (small blind) folded before Flop
Seat 6: samrowe1 (big blind) folded before Flop



PokerStars Hand #222960430962:  Hold'em No Limit ($0.05/$0.10 USD) - 2021/01/23 12:07:09 ET
Table 'Shura III' 6-max Seat #5 is the button
Seat 1: sampforeve ($12.09 in chips) 
Seat 3: Burlica2013 ($10.28 in chips) 
Seat 4: eldar919 ($10 in chips) 
Seat 5: Daurado ($10 in chips) 
Seat 6: samrowe1 ($9.53 in chips) 
samrowe1: posts small blind $0.05
sampforeve: posts big blind $0.10
*** HOLE CARDS ***
Burlica2013: folds 
eldar919 has timed out
eldar919: folds 
Daurado: folds 
samrowe1: calls $0.05
sampforeve: checks 
*** FLOP *** [Qh Jd 3d]
samrowe1: checks 
D9_nvkz joins the table at seat #2 
sampforeve: checks 
*** TURN *** [Qh Jd 3d] [9h]
samrowe1: bets $0.70
sampforeve: folds 
Uncalled bet ($0.70) returned to samrowe1
samrowe1 collected $0.19 from pot
*** SUMMARY ***
Total pot $0.20 | Rake $0.01 
Board [Qh Jd 3d 9h]
Seat 1: sampforeve (big blind) folded on the Turn
Seat 3: Burlica2013 folded before Flop (didn't bet)
Seat 4: eldar919 folded before Flop (didn't bet)
Seat 5: Daurado (button) folded before Flop (didn't bet)
Seat 6: samrowe1 (small blind) collected ($0.19)



PokerStars Hand #222960456649:  Hold'em No Limit ($0.05/$0.10 USD) - 2021/01/23 12:07:50 ET
Table 'Shura III' 6-max Seat #6 is the button
Seat 1: sampforeve ($11.99 in chips) 
Seat 2: D9_nvkz ($10 in chips) 
Seat 3: Burlica2013 ($10.28 in chips) 
Seat 4: eldar919 ($10 in chips) 
Seat 5: Daurado ($10 in chips) 
Seat 6: samrowe1 ($9.62 in chips) 
sampforeve: posts small blind $0.05
D9_nvkz: posts big blind $0.10
*** HOLE CARDS ***
Burlica2013: folds 
eldar919: folds 
Daurado: raises $0.15 to $0.25
samrowe1: folds 
sampforeve: folds 
D9_nvkz: folds 
Uncalled bet ($0.15) returned to Daurado
Daurado collected $0.25 from pot
Daurado: doesn't show hand 
*** SUMMARY ***
Total pot $0.25 | Rake $0 
Seat 1: sampforeve (small blind) folded before Flop
Seat 2: D9_nvkz (big blind) folded before Flop
Seat 3: Burlica2013 folded before Flop (didn't bet)
Seat 4: eldar919 folded before Flop (didn't bet)
Seat 5: Daurado collected ($0.25)
Seat 6: samrowe1 (button) folded before Flop (didn't bet)



PokerStars Hand #222960467058:  Hold'em No Limit ($0.05/$0.10 USD) - 2021/01/23 12:08:07 ET
Table 'Shura III' 6-max Seat #1 is the button
Seat 1: sampforeve ($11.94 in chips) 
Seat 2: D9_nvkz ($10 in chips) 
Seat 3: Burlica2013 ($10.28 in chips) 
Seat 4: eldar919 ($10 in chips) 
Seat 5: Daurado ($10.15 in chips) 
Seat 6: samrowe1 ($9.62 in chips) 
D9_nvkz: posts small blind $0.05
Burlica2013: posts big blind $0.10
*** HOLE CARDS ***
eldar919: folds 
Daurado: folds 
samrowe1: calls $0.10
sampforeve: folds 
D9_nvkz: calls $0.05
Burlica2013: checks 
*** FLOP *** [5s 7c 6h]
D9_nvkz: bets $0.29
Burlica2013: folds 
samrowe1: calls $0.29
*** TURN *** [5s 7c 6h] [5c]
D9_nvkz: bets $0.84
samrowe1: calls $0.84
*** RIVER *** [5s 7c 6h 5c] [6c]
D9_nvkz: checks 
samrowe1: bets $1.40
D9_nvkz: calls $1.40
*** SHOW DOWN ***
samrowe1: shows [Qc 9d] (two pair, Sixes and Fives)
D9_nvkz: shows [4c 8h] (a straight, Four to Eight)
D9_nvkz collected $5.12 from pot
*** SUMMARY ***
Total pot $5.36 | Rake $0.24 
Board [5s 7c 6h 5c 6c]
Seat 1: sampforeve (button) folded before Flop (didn't bet)
Seat 2: D9_nvkz (small blind) showed [4c 8h] and won ($5.12) with a straight, Four to Eight
Seat 3: Burlica2013 (big blind) folded on the Flop
Seat 4: eldar919 folded before Flop (didn't bet)
Seat 5: Daurado folded before Flop (didn't bet)
Seat 6: samrowe1 showed [Qc 9d] and lost with two pair, Sixes and Fives



PokerStars Hand #222960499374:  Hold'em No Limit ($0.05/$0.10 USD) - 2021/01/23 12:08:58 ET
Table 'Shura III' 6-max Seat #2 is the button
Seat 1: sampforeve ($11.94 in chips) 
Seat 2: D9_nvkz ($12.49 in chips) 
Seat 3: Burlica2013 ($10.18 in chips) 
Seat 4: eldar919 ($10 in chips) 
Seat 5: Daurado ($10.15 in chips) 
Seat 6: samrowe1 ($6.99 in chips) 
Burlica2013: posts small blind $0.05
eldar919: posts big blind $0.10
*** HOLE CARDS ***
Daurado: folds 
samrowe1: calls $0.10
sampforeve: folds 
D9_nvkz: raises $0.20 to $0.30
Burlica2013: folds 
eldar919: folds 
samrowe1: raises $0.20 to $0.50
D9_nvkz: calls $0.20
*** FLOP *** [9c 4s Jd]
samrowe1: bets $0.10
D9_nvkz: calls $0.10
*** TURN *** [9c 4s Jd] [5d]
samrowe1: bets $0.65
D9_nvkz: calls $0.65
*** RIVER *** [9c 4s Jd 5d] [7c]
samrowe1: checks 
D9_nvkz: bets $2.53
samrowe1: folds 
Uncalled bet ($2.53) returned to D9_nvkz
D9_nvkz collected $2.53 from pot
D9_nvkz: doesn't show hand 
*** SUMMARY ***
Total pot $2.65 | Rake $0.12 
Board [9c 4s Jd 5d 7c]
Seat 1: sampforeve folded before Flop (didn't bet)
Seat 2: D9_nvkz (button) collected ($2.53)
Seat 3: Burlica2013 (small blind) folded before Flop
Seat 4: eldar919 (big blind) folded before Flop
Seat 5: Daurado folded before Flop (didn't bet)
Seat 6: samrowe1 folded on the River



PokerStars Hand #222960544928:  Hold'em No Limit ($0.05/$0.10 USD) - 2021/01/23 12:10:10 ET
Table 'Shura III' 6-max Seat #3 is the button
Seat 1: sampforeve ($11.94 in chips) 
Seat 2: D9_nvkz ($13.77 in chips) 
Seat 3: Burlica2013 ($10.13 in chips) 
Seat 4: eldar919 ($10 in chips) 
Seat 6: samrowe1 ($5.74 in chips) 
eldar919: posts small blind $0.05
Daurado: is sitting out 
samrowe1: posts big blind $0.10
*** HOLE CARDS ***
sampforeve: folds 
D9_nvkz: folds 
Burlica2013: folds 
eldar919: folds 
Uncalled bet ($0.05) returned to samrowe1
samrowe1 collected $0.10 from pot
*** SUMMARY ***
Total pot $0.10 | Rake $0 
Seat 1: sampforeve folded before Flop (didn't bet)
Seat 2: D9_nvkz folded before Flop (didn't bet)
Seat 3: Burlica2013 (button) folded before Flop (didn't bet)
Seat 4: eldar919 (small blind) folded before Flop
Seat 6: samrowe1 (big blind) collected ($0.10)



PokerStars Hand #222960549369:  Hold'em No Limit ($0.05/$0.10 USD) - 2021/01/23 12:10:17 ET
Table 'Shura III' 6-max Seat #4 is the button
Seat 1: sampforeve ($11.94 in chips) 
Seat 2: D9_nvkz ($13.77 in chips) 
Seat 3: Burlica2013 ($10.13 in chips) 
Seat 4: eldar919 ($10 in chips) 
Seat 6: samrowe1 ($5.79 in chips) 
samrowe1: posts small blind $0.05
sampforeve: posts big blind $0.10
*** HOLE CARDS ***
D9_nvkz: folds 
Burlica2013: folds 
eldar919: raises $0.20 to $0.30
samrowe1: folds 
sampforeve: folds 
Uncalled bet ($0.20) returned to eldar919
eldar919 collected $0.25 from pot
eldar919: doesn't show hand 
*** SUMMARY ***
Total pot $0.25 | Rake $0 
Seat 1: sampforeve (big blind) folded before Flop
Seat 2: D9_nvkz folded before Flop (didn't bet)
Seat 3: Burlica2013 folded before Flop (didn't bet)
Seat 4: eldar919 (button) collected ($0.25)
Seat 6: samrowe1 (small blind) folded before Flop



PokerStars Hand #222960556588:  Hold'em No Limit ($0.05/$0.10 USD) - 2021/01/23 12:10:29 ET
Table 'Shura III' 6-max Seat #6 is the button
Seat 1: sampforeve ($11.84 in chips) 
Seat 2: D9_nvkz ($13.77 in chips) 
Seat 3: Burlica2013 ($10.13 in chips) 
Seat 4: eldar919 ($10.15 in chips) 
Seat 6: samrowe1 ($5.74 in chips) 
sampforeve: posts small blind $0.05
D9_nvkz: posts big blind $0.10
*** HOLE CARDS ***
Burlica2013: raises $0.15 to $0.25
eldar919: folds 
samrowe1: calls $0.25
sampforeve: calls $0.20
D9_nvkz: folds 
*** FLOP *** [4c Kd Tc]
sampforeve: checks 
Burlica2013: checks 
samrowe1: checks 
*** TURN *** [4c Kd Tc] [5c]
sampforeve: bets $0.54
Burlica2013: folds 
samrowe1: calls $0.54
*** RIVER *** [4c Kd Tc 5c] [As]
sampforeve: checks 
samrowe1: checks 
*** SHOW DOWN ***
sampforeve: shows [Jc Ks] (a pair of Kings)
samrowe1: mucks hand 
sampforeve collected $1.84 from pot
*** SUMMARY ***
Total pot $1.93 | Rake $0.09 
Board [4c Kd Tc 5c As]
Seat 1: sampforeve (small blind) showed [Jc Ks] and won ($1.84) with a pair of Kings
Seat 2: D9_nvkz (big blind) folded before Flop
Seat 3: Burlica2013 folded on the Turn
Seat 4: eldar919 folded before Flop (didn't bet)
Seat 6: samrowe1 (button) mucked



PokerStars Hand #222960586935:  Hold'em No Limit ($0.05/$0.10 USD) - 2021/01/23 12:11:17 ET
Table 'Shura III' 6-max Seat #1 is the button
Seat 1: sampforeve ($12.89 in chips) 
Seat 2: D9_nvkz ($13.67 in chips) 
Seat 3: Burlica2013 ($10 in chips) 
Seat 4: eldar919 ($10.15 in chips) 
Seat 6: samrowe1 ($4.95 in chips) 
D9_nvkz: posts small blind $0.05
Burlica2013: posts big blind $0.10
*** HOLE CARDS ***
eldar919: folds 
samrowe1: calls $0.10
sampforeve: folds 
D9_nvkz: folds 
Burlica2013: checks 
*** FLOP *** [Qd 3s 6d]
Burlica2013: checks 
samrowe1: bets $0.40
Burlica2013: folds 
Uncalled bet ($0.40) returned to samrowe1
samrowe1 collected $0.24 from pot
*** SUMMARY ***
Total pot $0.25 | Rake $0.01 
Board [Qd 3s 6d]
Seat 1: sampforeve (button) folded before Flop (didn't bet)
Seat 2: D9_nvkz (small blind) folded before Flop
Seat 3: Burlica2013 (big blind) folded on the Flop
Seat 4: eldar919 folded before Flop (didn't bet)
Seat 6: samrowe1 collected ($0.24)



PokerStars Hand #222960600597:  Hold'em No Limit ($0.05/$0.10 USD) - 2021/01/23 12:11:39 ET
Table 'Shura III' 6-max Seat #2 is the button
Seat 1: sampforeve ($12.89 in chips) 
Seat 2: D9_nvkz ($13.62 in chips) 
Seat 3: Burlica2013 ($10 in chips) 
Seat 4: eldar919 ($10.15 in chips) 
Seat 6: samrowe1 ($5.09 in chips) 
Burlica2013: posts small blind $0.05
eldar919: posts big blind $0.10
*** HOLE CARDS ***
samrowe1: calls $0.10
sampforeve: folds 
D9_nvkz: raises $0.35 to $0.45
Burlica2013: folds 
eldar919: folds 
samrowe1: folds 
Uncalled bet ($0.35) returned to D9_nvkz
D9_nvkz collected $0.35 from pot
D9_nvkz: doesn't show hand 
*** SUMMARY ***
Total pot $0.35 | Rake $0 
Seat 1: sampforeve folded before Flop (didn't bet)
Seat 2: D9_nvkz (button) collected ($0.35)
Seat 3: Burlica2013 (small blind) folded before Flop
Seat 4: eldar919 (big blind) folded before Flop
Seat 6: samrowe1 folded before Flop



PokerStars Hand #222960613032:  Hold'em No Limit ($0.05/$0.10 USD) - 2021/01/23 12:11:58 ET
Table 'Shura III' 6-max Seat #3 is the button
Seat 1: sampforeve ($12.89 in chips) 
Seat 2: D9_nvkz ($13.87 in chips) 
Seat 3: Burlica2013 ($10 in chips) 
Seat 4: eldar919 ($10.05 in chips) 
Seat 6: samrowe1 ($4.99 in chips) 
eldar919: posts small blind $0.05
samrowe1: posts big blind $0.10
*** HOLE CARDS ***
sampforeve: folds 
D9_nvkz: raises $0.20 to $0.30
Burlica2013: folds 
eldar919: folds 
samrowe1: folds 
Uncalled bet ($0.20) returned to D9_nvkz
D9_nvkz collected $0.25 from pot
D9_nvkz: doesn't show hand 
*** SUMMARY ***
Total pot $0.25 | Rake $0 
Seat 1: sampforeve folded before Flop (didn't bet)
Seat 2: D9_nvkz collected ($0.25)
Seat 3: Burlica2013 (button) folded before Flop (didn't bet)
Seat 4: eldar919 (small blind) folded before Flop
Seat 6: samrowe1 (big blind) folded before Flop



PokerStars Hand #222960622003:  Hold'em No Limit ($0.05/$0.10 USD) - 2021/01/23 12:12:13 ET
Table 'Shura III' 6-max Seat #4 is the button
Seat 1: sampforeve ($12.89 in chips) 
Seat 2: D9_nvkz ($14.02 in chips) 
Seat 3: Burlica2013 ($10 in chips) 
Seat 4: eldar919 ($10 in chips) 
Seat 6: samrowe1 ($4.89 in chips) 
samrowe1: posts small blind $0.05
sampforeve: posts big blind $0.10
*** HOLE CARDS ***
D9_nvkz: folds 
Burlica2013: folds 
eldar919: folds 
samrowe1: raises $0.10 to $0.20
sampforeve: folds 
Uncalled bet ($0.10) returned to samrowe1
samrowe1 collected $0.20 from pot
samrowe1: doesn't show hand 
*** SUMMARY ***
Total pot $0.20 | Rake $0 
Seat 1: sampforeve (big blind) folded before Flop
Seat 2: D9_nvkz folded before Flop (didn't bet)
Seat 3: Burlica2013 folded before Flop (didn't bet)
Seat 4: eldar919 (button) folded before Flop (didn't bet)
Seat 6: samrowe1 (small blind) collected ($0.20)



PokerStars Hand #222960632503:  Hold'em No Limit ($0.05/$0.10 USD) - 2021/01/23 12:12:29 ET
Table 'Shura III' 6-max Seat #6 is the button
Seat 1: sampforeve ($12.79 in chips) 
Seat 2: D9_nvkz ($14.02 in chips) 
Seat 3: Burlica2013 ($10 in chips) 
Seat 4: eldar919 ($10 in chips) 
Seat 6: samrowe1 ($4.99 in chips) 
sampforeve: posts small blind $0.05
D9_nvkz: posts big blind $0.10
*** HOLE CARDS ***
Burlica2013: folds 
eldar919: raises $0.20 to $0.30
samrowe1: folds 
sampforeve: folds 
D9_nvkz: folds 
Uncalled bet ($0.20) returned to eldar919
eldar919 collected $0.25 from pot
eldar919: doesn't show hand 
*** SUMMARY ***
Total pot $0.25 | Rake $0 
Seat 1: sampforeve (small blind) folded before Flop
Seat 2: D9_nvkz (big blind) folded before Flop
Seat 3: Burlica2013 folded before Flop (didn't bet)
Seat 4: eldar919 collected ($0.25)
Seat 6: samrowe1 (button) folded before Flop (didn't bet)



PokerStars Hand #222960646211:  Hold'em No Limit ($0.05/$0.10 USD) - 2021/01/23 12:12:51 ET
Table 'Shura III' 6-max Seat #1 is the button
Seat 1: sampforeve ($12.74 in chips) 
Seat 2: D9_nvkz ($13.92 in chips) 
Seat 3: Burlica2013 ($10 in chips) 
Seat 4: eldar919 ($10.15 in chips) 
Seat 6: samrowe1 ($4.99 in chips) 
D9_nvkz: posts small blind $0.05
Burlica2013: posts big blind $0.10
*** HOLE CARDS ***
eldar919: folds 
samrowe1: raises $0.20 to $0.30
sampforeve: folds 
D9_nvkz: folds 
Burlica2013: folds 
Uncalled bet ($0.20) returned to samrowe1
samrowe1 collected $0.25 from pot
*** SUMMARY ***
Total pot $0.25 | Rake $0 
Seat 1: sampforeve (button) folded before Flop (didn't bet)
Seat 2: D9_nvkz (small blind) folded before Flop
Seat 3: Burlica2013 (big blind) folded before Flop
Seat 4: eldar919 folded before Flop (didn't bet)
Seat 6: samrowe1 collected ($0.25)



PokerStars Hand #222960653848:  Hold'em No Limit ($0.05/$0.10 USD) - 2021/01/23 12:13:03 ET
Table 'Shura III' 6-max Seat #2 is the button
Seat 1: sampforeve ($12.74 in chips) 
Seat 2: D9_nvkz ($13.87 in chips) 
Seat 3: Burlica2013 ($10 in chips) 
Seat 4: eldar919 ($10.15 in chips) 
Seat 6: samrowe1 ($5.14 in chips) 
Burlica2013: posts small blind $0.05
eldar919: posts big blind $0.10
*** HOLE CARDS ***
samrowe1: calls $0.10
sampforeve: folds 
D9_nvkz: folds 
Burlica2013: folds 
eldar919: checks 
*** FLOP *** [Qh 9s Qc]
eldar919: checks 
samrowe1: checks 
*** TURN *** [Qh 9s Qc] [8h]
eldar919: bets $0.24
samrowe1: folds 
Uncalled bet ($0.24) returned to eldar919
eldar919 collected $0.24 from pot
eldar919: doesn't show hand 
*** SUMMARY ***
Total pot $0.25 | Rake $0.01 
Board [Qh 9s Qc 8h]
Seat 1: sampforeve folded before Flop (didn't bet)
Seat 2: D9_nvkz (button) folded before Flop (didn't bet)
Seat 3: Burlica2013 (small blind) folded before Flop
Seat 4: eldar919 (big blind) collected ($0.24)
Seat 6: samrowe1 folded on the Turn



PokerStars Hand #222960677044:  Hold'em No Limit ($0.05/$0.10 USD) - 2021/01/23 12:13:38 ET
Table 'Shura III' 6-max Seat #3 is the button
Seat 1: sampforeve ($12.74 in chips) 
Seat 2: D9_nvkz ($13.87 in chips) 
Seat 3: Burlica2013 ($10 in chips) 
Seat 4: eldar919 ($10.29 in chips) 
Seat 6: samrowe1 ($5.04 in chips) 
eldar919: posts small blind $0.05
samrowe1: posts big blind $0.10
*** HOLE CARDS ***
sampforeve: folds 
D9_nvkz: folds 
Burlica2013: folds 
eldar919: folds 
Uncalled bet ($0.05) returned to samrowe1
samrowe1 collected $0.10 from pot
*** SUMMARY ***
Total pot $0.10 | Rake $0 
Seat 1: sampforeve folded before Flop (didn't bet)
Seat 2: D9_nvkz folded before Flop (didn't bet)
Seat 3: Burlica2013 (button) folded before Flop (didn't bet)
Seat 4: eldar919 (small blind) folded before Flop
Seat 6: samrowe1 (big blind) collected ($0.10)



PokerStars Hand #222960685643:  Hold'em No Limit ($0.05/$0.10 USD) - 2021/01/23 12:13:51 ET
Table 'Shura III' 6-max Seat #4 is the button
Seat 1: sampforeve ($12.74 in chips) 
Seat 2: D9_nvkz ($13.87 in chips) 
Seat 3: Burlica2013 ($10 in chips) 
Seat 4: eldar919 ($10.24 in chips) 
Seat 6: samrowe1 ($5.09 in chips) 
samrowe1: posts small blind $0.05
sampforeve: posts big blind $0.10
*** HOLE CARDS ***
D9_nvkz: raises $0.20 to $0.30
Burlica2013: folds 
eldar919: folds 
samrowe1: raises $0.20 to $0.50
sampforeve: folds 
D9_nvkz: calls $0.20
*** FLOP *** [6h 6c 4s]
samrowe1: bets $0.53
D9_nvkz: calls $0.53
*** TURN *** [6h 6c 4s] [3d]
samrowe1: bets $2.06
D9_nvkz: folds 
Uncalled bet ($2.06) returned to samrowe1
samrowe1 collected $2.06 from pot
*** SUMMARY ***
Total pot $2.16 | Rake $0.10 
Board [6h 6c 4s 3d]
Seat 1: sampforeve (big blind) folded before Flop
Seat 2: D9_nvkz folded on the Turn
Seat 3: Burlica2013 folded before Flop (didn't bet)
Seat 4: eldar919 (button) folded before Flop (didn't bet)
Seat 6: samrowe1 (small blind) collected ($2.06)



PokerStars Hand #222960714441:  Hold'em No Limit ($0.05/$0.10 USD) - 2021/01/23 12:14:37 ET
Table 'Shura III' 6-max Seat #6 is the button
Seat 1: sampforeve ($12.64 in chips) 
Seat 2: D9_nvkz ($12.84 in chips) 
Seat 3: Burlica2013 ($10 in chips) 
Seat 4: eldar919 ($10.24 in chips) 
Seat 6: samrowe1 ($6.12 in chips) 
sampforeve: posts small blind $0.05
D9_nvkz: posts big blind $0.10
*** HOLE CARDS ***
Burlica2013: raises $0.15 to $0.25
eldar919: folds 
samrowe1: calls $0.25
sampforeve: folds 
D9_nvkz: calls $0.15
*** FLOP *** [3s 9d 5h]
D9_nvkz: checks 
Burlica2013: checks 
samrowe1: bets $0.38
D9_nvkz: folds 
Burlica2013: folds 
Uncalled bet ($0.38) returned to samrowe1
samrowe1 collected $0.76 from pot
*** SUMMARY ***
Total pot $0.80 | Rake $0.04 
Board [3s 9d 5h]
Seat 1: sampforeve (small blind) folded before Flop
Seat 2: D9_nvkz (big blind) folded on the Flop
Seat 3: Burlica2013 folded on the Flop
Seat 4: eldar919 folded before Flop (didn't bet)
Seat 6: samrowe1 (button) collected ($0.76)



PokerStars Hand #222960728800:  Hold'em No Limit ($0.05/$0.10 USD) - 2021/01/23 12:15:00 ET
Table 'Shura III' 6-max Seat #1 is the button
Seat 1: sampforeve ($12.59 in chips) 
Seat 2: D9_nvkz ($12.59 in chips) 
Seat 4: eldar919 ($10.24 in chips) 
Seat 6: samrowe1 ($6.63 in chips) 
D9_nvkz: posts small blind $0.05
Burlica2013: is sitting out 
eldar919: posts big blind $0.10
*** HOLE CARDS ***
samrowe1: folds 
sampforeve: folds 
Burlica2013 leaves the table
D9_nvkz: folds 
Uncalled bet ($0.05) returned to eldar919
eldar919 collected $0.10 from pot
eldar919: doesn't show hand 
*** SUMMARY ***
Total pot $0.10 | Rake $0 
Seat 1: sampforeve (button) folded before Flop (didn't bet)
Seat 2: D9_nvkz (small blind) folded before Flop
Seat 4: eldar919 (big blind) collected ($0.10)
Seat 6: samrowe1 folded before Flop (didn't bet)



PokerStars Hand #222960738358:  Hold'em No Limit ($0.05/$0.10 USD) - 2021/01/23 12:15:15 ET
Table 'Shura III' 6-max Seat #2 is the button
Seat 1: sampforeve ($12.59 in chips) 
Seat 2: D9_nvkz ($12.54 in chips) 
Seat 4: eldar919 ($10.29 in chips) 
Seat 5: Daurado ($10.15 in chips) 
Seat 6: samrowe1 ($6.63 in chips) 
eldar919: posts small blind $0.05
Daurado: posts big blind $0.10
*** HOLE CARDS ***
samrowe1: raises $0.20 to $0.30
llosjone joins the table at seat #3 
sampforeve: raises $0.60 to $0.90
D9_nvkz: folds 
eldar919: folds 
Daurado: folds 
samrowe1: raises $1.95 to $2.85
sampforeve: raises $9.74 to $12.59 and is all-in
samrowe1: calls $3.78 and is all-in
Uncalled bet ($5.96) returned to sampforeve
*** FLOP *** [Kc 3s Qs]
*** TURN *** [Kc 3s Qs] [2h]
*** RIVER *** [Kc 3s Qs 2h] [7d]
*** SHOW DOWN ***
samrowe1: shows [2s 2c] (three of a kind, Deuces)
sampforeve: shows [Ah Qh] (a pair of Queens)
samrowe1 collected $12.81 from pot
sampforeve cashed out the hand for $6.39 | Cash Out Fee $0.06
*** SUMMARY ***
Total pot $13.41 | Rake $0.60 
Board [Kc 3s Qs 2h 7d]
Seat 1: sampforeve showed [Ah Qh] and lost with a pair of Queens (cashed out).
Seat 2: D9_nvkz (button) folded before Flop (didn't bet)
Seat 4: eldar919 (small blind) folded before Flop
Seat 5: Daurado (big blind) folded before Flop
Seat 6: samrowe1 showed [2s 2c] and won ($12.81) with three of a kind, Deuces



PokerStars Hand #222960767008:  Hold'em No Limit ($0.05/$0.10 USD) - 2021/01/23 12:16:01 ET
Table 'Shura III' 6-max Seat #4 is the button
Seat 1: sampforeve ($12.35 in chips) 
Seat 2: D9_nvkz ($12.54 in chips) 
Seat 4: eldar919 ($10.24 in chips) 
Seat 5: Daurado ($10.05 in chips) 
Seat 6: samrowe1 ($12.81 in chips) 
Daurado: posts small blind $0.05
samrowe1: posts big blind $0.10
llosjone: sits out 
*** HOLE CARDS ***
sampforeve: folds 
D9_nvkz: folds 
eldar919: folds 
Daurado: raises $0.20 to $0.30
samrowe1: calls $0.20
*** FLOP *** [5d 7h Ad]
Daurado: checks 
samrowe1: checks 
*** TURN *** [5d 7h Ad] [Ac]
Daurado: bets $0.38
samrowe1: folds 
Uncalled bet ($0.38) returned to Daurado
Daurado collected $0.57 from pot
Daurado: doesn't show hand 
*** SUMMARY ***
Total pot $0.60 | Rake $0.03 
Board [5d 7h Ad Ac]
Seat 1: sampforeve folded before Flop (didn't bet)
Seat 2: D9_nvkz folded before Flop (didn't bet)
Seat 4: eldar919 (button) folded before Flop (didn't bet)
Seat 5: Daurado (small blind) collected ($0.57)
Seat 6: samrowe1 (big blind) folded on the Turn



PokerStars Hand #222960782354:  Hold'em No Limit ($0.05/$0.10 USD) - 2021/01/23 12:16:25 ET
Table 'Shura III' 6-max Seat #5 is the button
Seat 1: sampforeve ($12.35 in chips) 
Seat 2: D9_nvkz ($12.54 in chips) 
Seat 4: eldar919 ($10.24 in chips) 
Seat 5: Daurado ($10.32 in chips) 
Seat 6: samrowe1 ($12.51 in chips) 
samrowe1: posts small blind $0.05
sampforeve: posts big blind $0.10
llosjone: sits out 
*** HOLE CARDS ***
D9_nvkz: folds 
eldar919: folds 
Daurado: folds 
samrowe1: calls $0.05
sampforeve: checks 
*** FLOP *** [3d 9s 8d]
samrowe1: checks 
sampforeve: checks 
*** TURN *** [3d 9s 8d] [2c]
samrowe1: checks 
sampforeve: checks 
*** RIVER *** [3d 9s 8d 2c] [Kh]
samrowe1: bets $0.10
sampforeve: calls $0.10
*** SHOW DOWN ***
samrowe1: shows [Kc Ac] (a pair of Kings)
sampforeve: mucks hand 
samrowe1 collected $0.38 from pot
*** SUMMARY ***
Total pot $0.40 | Rake $0.02 
Board [3d 9s 8d 2c Kh]
Seat 1: sampforeve (big blind) mucked
Seat 2: D9_nvkz folded before Flop (didn't bet)
Seat 4: eldar919 folded before Flop (didn't bet)
Seat 5: Daurado (button) folded before Flop (didn't bet)
Seat 6: samrowe1 (small blind) showed [Kc Ac] and won ($0.38) with a pair of Kings



PokerStars Hand #222960808945:  Hold'em No Limit ($0.05/$0.10 USD) - 2021/01/23 12:17:06 ET
Table 'Shura III' 6-max Seat #6 is the button
Seat 1: sampforeve ($12.15 in chips) 
Seat 2: D9_nvkz ($12.54 in chips) 
Seat 4: eldar919 ($10.24 in chips) 
Seat 5: Daurado ($10.32 in chips) 
Seat 6: samrowe1 ($12.69 in chips) 
sampforeve: posts small blind $0.05
D9_nvkz: posts big blind $0.10
llosjone: sits out 
*** HOLE CARDS ***
eldar919: folds 
Daurado: folds 
samrowe1: folds 
sampforeve: raises $0.15 to $0.25
D9_nvkz: raises $12.29 to $12.54 and is all-in
sampforeve: folds 
Uncalled bet ($12.29) returned to D9_nvkz
D9_nvkz collected $0.50 from pot
D9_nvkz: doesn't show hand 
*** SUMMARY ***
Total pot $0.50 | Rake $0 
Seat 1: sampforeve (small blind) folded before Flop
Seat 2: D9_nvkz (big blind) collected ($0.50)
Seat 4: eldar919 folded before Flop (didn't bet)
Seat 5: Daurado folded before Flop (didn't bet)
Seat 6: samrowe1 (button) folded before Flop (didn't bet)



PokerStars Hand #222960825225:  Hold'em No Limit ($0.05/$0.10 USD) - 2021/01/23 12:17:32 ET
Table 'Shura III' 6-max Seat #1 is the button
Seat 1: sampforeve ($11.90 in chips) 
Seat 2: D9_nvkz ($12.79 in chips) 
Seat 3: llosjone ($10 in chips) 
Seat 4: eldar919 ($10.24 in chips) 
Seat 5: Daurado ($10.32 in chips) 
Seat 6: samrowe1 ($12.69 in chips) 
D9_nvkz: posts small blind $0.05
llosjone: posts big blind $0.10
*** HOLE CARDS ***
eldar919: folds 
Daurado: raises $0.20 to $0.30
samrowe1: folds 
sampforeve: folds 
D9_nvkz: folds 
llosjone: calls $0.20
*** FLOP *** [9h 4d 3d]
llosjone: checks 
Daurado: checks 
*** TURN *** [9h 4d 3d] [4c]
llosjone: checks 
Daurado: checks 
*** RIVER *** [9h 4d 3d 4c] [Ks]
llosjone: checks 
Daurado: checks 
*** SHOW DOWN ***
llosjone: shows [Jc Td] (a pair of Fours)
Daurado: shows [7s As] (a pair of Fours - Ace kicker)
Daurado collected $0.62 from pot
*** SUMMARY ***
Total pot $0.65 | Rake $0.03 
Board [9h 4d 3d 4c Ks]
Seat 1: sampforeve (button) folded before Flop (didn't bet)
Seat 2: D9_nvkz (small blind) folded before Flop
Seat 3: llosjone (big blind) showed [Jc Td] and lost with a pair of Fours
Seat 4: eldar919 folded before Flop (didn't bet)
Seat 5: Daurado showed [7s As] and won ($0.62) with a pair of Fours
Seat 6: samrowe1 folded before Flop (didn't bet)



PokerStars Hand #222960854649:  Hold'em No Limit ($0.05/$0.10 USD) - 2021/01/23 12:18:16 ET
Table 'Shura III' 6-max Seat #2 is the button
Seat 1: sampforeve ($11.90 in chips) 
Seat 2: D9_nvkz ($12.74 in chips) 
Seat 3: llosjone ($9.70 in chips) 
Seat 4: eldar919 ($10.24 in chips) 
Seat 5: Daurado ($10.64 in chips) 
Seat 6: samrowe1 ($12.69 in chips) 
llosjone: posts small blind $0.05
eldar919: posts big blind $0.10
*** HOLE CARDS ***
Daurado: raises $0.20 to $0.30
samrowe1: calls $0.30
sampforeve: folds 
D9_nvkz: folds 
llosjone: calls $0.25
eldar919: calls $0.20
*** FLOP *** [5h 3d Th]
llosjone: checks 
eldar919: checks 
Daurado: bets $0.38
samrowe1: folds 
samrowe1 leaves the table
llosjone: folds 
eldar919: folds 
Uncalled bet ($0.38) returned to Daurado
Daurado collected $1.15 from pot
Daurado: doesn't show hand 
*** SUMMARY ***
Total pot $1.20 | Rake $0.05 
Board [5h 3d Th]
Seat 1: sampforeve folded before Flop (didn't bet)
Seat 2: D9_nvkz (button) folded before Flop (didn't bet)
Seat 3: llosjone (small blind) folded on the Flop
Seat 4: eldar919 (big blind) folded on the Flop
Seat 5: Daurado collected ($1.15)
Seat 6: samrowe1 folded on the Flop



PokerStars Hand #222960883677:  Hold'em No Limit ($0.05/$0.10 USD) - 2021/01/23 12:19:01 ET
Table 'Shura III' 6-max Seat #3 is the button
Seat 1: sampforeve ($11.90 in chips) 
Seat 2: D9_nvkz ($12.74 in chips) 
Seat 3: llosjone ($9.40 in chips) 
Seat 4: eldar919 ($10 in chips) 
Seat 5: Daurado ($11.49 in chips) 
eldar919: posts small blind $0.05
Daurado: posts big blind $0.10
*** HOLE CARDS ***
sampforeve: folds 
D9_nvkz: raises $0.20 to $0.30
llosjone: folds 
hempju1ce joins the table at seat #6 
eldar919: folds 
Daurado: folds 
Uncalled bet ($0.20) returned to D9_nvkz
D9_nvkz collected $0.25 from pot
D9_nvkz: doesn't show hand 
*** SUMMARY ***
Total pot $0.25 | Rake $0 
Seat 1: sampforeve folded before Flop (didn't bet)
Seat 2: D9_nvkz collected ($0.25)
Seat 3: llosjone (button) folded before Flop (didn't bet)
Seat 4: eldar919 (small blind) folded before Flop
Seat 5: Daurado (big blind) folded before Flop



PokerStars Hand #222960895056:  Hold'em No Limit ($0.05/$0.10 USD) - 2021/01/23 12:19:20 ET
Table 'Shura III' 6-max Seat #4 is the button
Seat 1: sampforeve ($11.90 in chips) 
Seat 2: D9_nvkz ($12.89 in chips) 
Seat 3: llosjone ($9.40 in chips) 
Seat 4: eldar919 ($10 in chips) 
Seat 5: Daurado ($11.39 in chips) 
Seat 6: hempju1ce ($10 in chips) 
Daurado: posts small blind $0.05
hempju1ce: posts big blind $0.10
*** HOLE CARDS ***
sampforeve: raises $0.20 to $0.30
D9_nvkz: folds 
llosjone: folds 
eldar919: folds 
Daurado: folds 
hempju1ce: folds 
Uncalled bet ($0.20) returned to sampforeve
sampforeve collected $0.25 from pot
*** SUMMARY ***
Total pot $0.25 | Rake $0 
Seat 1: sampforeve collected ($0.25)
Seat 2: D9_nvkz folded before Flop (didn't bet)
Seat 3: llosjone folded before Flop (didn't bet)
Seat 4: eldar919 (button) folded before Flop (didn't bet)
Seat 5: Daurado (small blind) folded before Flop
Seat 6: hempju1ce (big blind) folded before Flop



PokerStars Hand #222960907647:  Hold'em No Limit ($0.05/$0.10 USD) - 2021/01/23 12:19:39 ET
Table 'Shura III' 6-max Seat #5 is the button
Seat 1: sampforeve ($12.05 in chips) 
Seat 2: D9_nvkz ($12.89 in chips) 
Seat 3: llosjone ($9.40 in chips) 
Seat 4: eldar919 ($10 in chips) 
Seat 5: Daurado ($11.34 in chips) 
Seat 6: hempju1ce ($9.90 in chips) 
hempju1ce: posts small blind $0.05
sampforeve: posts big blind $0.10
*** HOLE CARDS ***
D9_nvkz: folds 
llosjone: folds 
eldar919: folds 
Daurado: folds 
hempju1ce: calls $0.05
sampforeve: checks 
*** FLOP *** [Qh 8s 6d]
hempju1ce: bets $0.10
sampforeve: folds 
Uncalled bet ($0.10) returned to hempju1ce
hempju1ce collected $0.19 from pot
hempju1ce: doesn't show hand 
*** SUMMARY ***
Total pot $0.20 | Rake $0.01 
Board [Qh 8s 6d]
Seat 1: sampforeve (big blind) folded on the Flop
Seat 2: D9_nvkz folded before Flop (didn't bet)
Seat 3: llosjone folded before Flop (didn't bet)
Seat 4: eldar919 folded before Flop (didn't bet)
Seat 5: Daurado (button) folded before Flop (didn't bet)
Seat 6: hempju1ce (small blind) collected ($0.19)



PokerStars Hand #222960926747:  Hold'em No Limit ($0.05/$0.10 USD) - 2021/01/23 12:20:10 ET
Table 'Shura III' 6-max Seat #6 is the button
Seat 1: sampforeve ($11.95 in chips) 
Seat 2: D9_nvkz ($12.89 in chips) 
Seat 3: llosjone ($9.40 in chips) 
Seat 4: eldar919 ($10 in chips) 
Seat 5: Daurado ($11.34 in chips) 
Seat 6: hempju1ce ($9.99 in chips) 
sampforeve: posts small blind $0.05
D9_nvkz: posts big blind $0.10
*** HOLE CARDS ***
llosjone: folds 
eldar919: folds 
Daurado: folds 
hempju1ce: calls $0.10
sampforeve: raises $0.30 to $0.40
D9_nvkz: folds 
hempju1ce: calls $0.30
*** FLOP *** [Td As Ts]
sampforeve: bets $0.28
hempju1ce: raises $0.28 to $0.56
sampforeve: calls $0.28
*** TURN *** [Td As Ts] [7h]
sampforeve: checks 
hempju1ce: bets $0.96
sampforeve: folds 
Uncalled bet ($0.96) returned to hempju1ce
hempju1ce collected $1.93 from pot
hempju1ce: doesn't show hand 
*** SUMMARY ***
Total pot $2.02 | Rake $0.09 
Board [Td As Ts 7h]
Seat 1: sampforeve (small blind) folded on the Turn
Seat 2: D9_nvkz (big blind) folded before Flop
Seat 3: llosjone folded before Flop (didn't bet)
Seat 4: eldar919 folded before Flop (didn't bet)
Seat 5: Daurado folded before Flop (didn't bet)
Seat 6: hempju1ce (button) collected ($1.93)



PokerStars Hand #222960949843:  Hold'em No Limit ($0.05/$0.10 USD) - 2021/01/23 12:20:46 ET
Table 'Shura III' 6-max Seat #1 is the button
Seat 1: sampforeve ($10.99 in chips) 
Seat 2: D9_nvkz ($12.79 in chips) 
Seat 3: llosjone ($9.40 in chips) 
Seat 4: eldar919 ($10 in chips) 
Seat 5: Daurado ($11.34 in chips) 
Seat 6: hempju1ce ($10.96 in chips) 
D9_nvkz: posts small blind $0.05
llosjone: posts big blind $0.10
*** HOLE CARDS ***
eldar919: folds 
Daurado: raises $0.20 to $0.30
hempju1ce: calls $0.30
sampforeve: folds 
D9_nvkz: folds 
llosjone: folds 
*** FLOP *** [7d 4h 5c]
Daurado: checks 
hempju1ce: checks 
*** TURN *** [7d 4h 5c] [6s]
Daurado: checks 
hempju1ce: checks 
*** RIVER *** [7d 4h 5c 6s] [3s]
Daurado: checks 
hempju1ce: checks 
*** SHOW DOWN ***
Daurado: shows [Jd Td] (a straight, Three to Seven)
hempju1ce: shows [Kh Qh] (a straight, Three to Seven)
Daurado collected $0.36 from pot
hempju1ce collected $0.36 from pot
*** SUMMARY ***
Total pot $0.75 | Rake $0.03 
Board [7d 4h 5c 6s 3s]
Seat 1: sampforeve (button) folded before Flop (didn't bet)
Seat 2: D9_nvkz (small blind) folded before Flop
Seat 3: llosjone (big blind) folded before Flop
Seat 4: eldar919 folded before Flop (didn't bet)
Seat 5: Daurado showed [Jd Td] and won ($0.36) with a straight, Three to Seven
Seat 6: hempju1ce showed [Kh Qh] and won ($0.36) with a straight, Three to Seven



PokerStars Hand #222960969417:  Hold'em No Limit ($0.05/$0.10 USD) - 2021/01/23 12:21:18 ET
Table 'Shura III' 6-max Seat #2 is the button
Seat 1: sampforeve ($10.99 in chips) 
Seat 2: D9_nvkz ($12.74 in chips) 
Seat 3: llosjone ($9.30 in chips) 
Seat 5: Daurado ($11.40 in chips) 
Seat 6: hempju1ce ($11.02 in chips) 
llosjone: posts small blind $0.05
eldar919: is sitting out 
Daurado: posts big blind $0.10
*** HOLE CARDS ***
hempju1ce: folds 
eldar919 leaves the table
sampforeve: folds 
D9_nvkz: folds 
llosjone: folds 
Uncalled bet ($0.05) returned to Daurado
Daurado collected $0.10 from pot
Daurado: doesn't show hand 
*** SUMMARY ***
Total pot $0.10 | Rake $0 
Seat 1: sampforeve folded before Flop (didn't bet)
Seat 2: D9_nvkz (button) folded before Flop (didn't bet)
Seat 3: llosjone (small blind) folded before Flop
Seat 5: Daurado (big blind) collected ($0.10)
Seat 6: hempju1ce folded before Flop (didn't bet)



PokerStars Hand #222960977581:  Hold'em No Limit ($0.05/$0.10 USD) - 2021/01/23 12:21:30 ET
Table 'Shura III' 6-max Seat #3 is the button
Seat 1: sampforeve ($10.99 in chips) 
Seat 2: D9_nvkz ($12.74 in chips) 
Seat 3: llosjone ($9.25 in chips) 
Seat 5: Daurado ($11.45 in chips) 
Seat 6: hempju1ce ($11.02 in chips) 
Daurado: posts small blind $0.05
hempju1ce: posts big blind $0.10
*** HOLE CARDS ***
LigoL joins the table at seat #4 
sampforeve: folds 
D9_nvkz: raises $0.20 to $0.30
llosjone: folds 
Daurado: folds 
hempju1ce: folds 
Uncalled bet ($0.20) returned to D9_nvkz
D9_nvkz collected $0.25 from pot
D9_nvkz: doesn't show hand 
*** SUMMARY ***
Total pot $0.25 | Rake $0 
Seat 1: sampforeve folded before Flop (didn't bet)
Seat 2: D9_nvkz collected ($0.25)
Seat 3: llosjone (button) folded before Flop (didn't bet)
Seat 5: Daurado (small blind) folded before Flop
Seat 6: hempju1ce (big blind) folded before Flop



PokerStars Hand #222960988159:  Hold'em No Limit ($0.05/$0.10 USD) - 2021/01/23 12:21:47 ET
Table 'Shura III' 6-max Seat #5 is the button
Seat 2: D9_nvkz ($12.89 in chips) 
Seat 3: llosjone ($9.25 in chips) 
Seat 5: Daurado ($11.40 in chips) 
Seat 6: hempju1ce ($10.92 in chips) 
hempju1ce: posts small blind $0.05
sampforeve: is sitting out 
D9_nvkz: posts big blind $0.10
LigoL: sits out 
*** HOLE CARDS ***
llosjone: folds 
Daurado: folds 
hempju1ce: calls $0.05
D9_nvkz: checks 
*** FLOP *** [6c Tc Js]
hempju1ce: checks 
sampforeve leaves the table
D9_nvkz: checks 
*** TURN *** [6c Tc Js] [5s]
senej joins the table at seat #1 
hempju1ce: checks 
D9_nvkz: checks 
*** RIVER *** [6c Tc Js 5s] [9d]
hempju1ce: checks 
D9_nvkz: checks 
*** SHOW DOWN ***
hempju1ce: shows [8h 5c] (a pair of Fives)
D9_nvkz: shows [9s Kd] (a pair of Nines)
D9_nvkz collected $0.19 from pot
*** SUMMARY ***
Total pot $0.20 | Rake $0.01 
Board [6c Tc Js 5s 9d]
Seat 2: D9_nvkz (big blind) showed [9s Kd] and won ($0.19) with a pair of Nines
Seat 3: llosjone folded before Flop (didn't bet)
Seat 5: Daurado (button) folded before Flop (didn't bet)
Seat 6: hempju1ce (small blind) showed [8h 5c] and lost with a pair of Fives



PokerStars Hand #222961010935:  Hold'em No Limit ($0.05/$0.10 USD) - 2021/01/23 12:22:23 ET
Table 'Shura III' 6-max Seat #6 is the button
Seat 2: D9_nvkz ($12.98 in chips) 
Seat 3: llosjone ($9.25 in chips) 
Seat 5: Daurado ($11.40 in chips) 
Seat 6: hempju1ce ($10.82 in chips) 
D9_nvkz: posts small blind $0.05
llosjone: posts big blind $0.10
LigoL: sits out 
*** HOLE CARDS ***
Daurado: folds 
hempju1ce: folds 
D9_nvkz: raises $0.20 to $0.30
llosjone: folds 
Uncalled bet ($0.20) returned to D9_nvkz
D9_nvkz collected $0.20 from pot
D9_nvkz: doesn't show hand 
*** SUMMARY ***
Total pot $0.20 | Rake $0 
Seat 2: D9_nvkz (small blind) collected ($0.20)
Seat 3: llosjone (big blind) folded before Flop
Seat 5: Daurado folded before Flop (didn't bet)
Seat 6: hempju1ce (button) folded before Flop (didn't bet)



PokerStars Hand #222961018487:  Hold'em No Limit ($0.05/$0.10 USD) - 2021/01/23 12:22:35 ET
Table 'Shura III' 6-max Seat #2 is the button
Seat 2: D9_nvkz ($13.08 in chips) 
Seat 3: llosjone ($9.15 in chips) 
Seat 4: LigoL ($10 in chips) 
Seat 5: Daurado ($11.40 in chips) 
Seat 6: hempju1ce ($10.82 in chips) 
llosjone: posts small blind $0.05
LigoL: posts big blind $0.10
senej: sits out 
*** HOLE CARDS ***
Daurado: folds 
hempju1ce: folds 
D9_nvkz: raises $0.20 to $0.30
llosjone: folds 
LigoL: calls $0.20
*** FLOP *** [Qd 4s 5s]
LigoL: checks 
D9_nvkz: checks 
*** TURN *** [Qd 4s 5s] [6h]
LigoL: checks 
D9_nvkz: bets $0.31
LigoL: folds 
Uncalled bet ($0.31) returned to D9_nvkz
D9_nvkz collected $0.62 from pot
D9_nvkz: doesn't show hand 
*** SUMMARY ***
Total pot $0.65 | Rake $0.03 
Board [Qd 4s 5s 6h]
Seat 2: D9_nvkz (button) collected ($0.62)
Seat 3: llosjone (small blind) folded before Flop
Seat 4: LigoL (big blind) folded on the Turn
Seat 5: Daurado folded before Flop (didn't bet)
Seat 6: hempju1ce folded before Flop (didn't bet)



PokerStars Hand #222961049905:  Hold'em No Limit ($0.05/$0.10 USD) - 2021/01/23 12:23:24 ET
Table 'Shura III' 6-max Seat #3 is the button
Seat 2: D9_nvkz ($13.40 in chips) 
Seat 3: llosjone ($9.10 in chips) 
Seat 4: LigoL ($10 in chips) 
Seat 5: Daurado ($11.40 in chips) 
Seat 6: hempju1ce ($10.82 in chips) 
LigoL: posts small blind $0.05
Daurado: posts big blind $0.10
senej: sits out 
*** HOLE CARDS ***
hempju1ce: folds 
D9_nvkz: raises $0.20 to $0.30
llosjone: folds 
LigoL: folds 
Daurado: folds 
Uncalled bet ($0.20) returned to D9_nvkz
D9_nvkz collected $0.25 from pot
D9_nvkz: doesn't show hand 
*** SUMMARY ***
Total pot $0.25 | Rake $0 
Seat 2: D9_nvkz collected ($0.25)
Seat 3: llosjone (button) folded before Flop (didn't bet)
Seat 4: LigoL (small blind) folded before Flop
Seat 5: Daurado (big blind) folded before Flop
Seat 6: hempju1ce folded before Flop (didn't bet)



PokerStars Hand #222961063944:  Hold'em No Limit ($0.05/$0.10 USD) - 2021/01/23 12:23:46 ET
Table 'Shura III' 6-max Seat #4 is the button
Seat 2: D9_nvkz ($13.55 in chips) 
Seat 3: llosjone ($9.10 in chips) 
Seat 4: LigoL ($10 in chips) 
Seat 5: Daurado ($11.30 in chips) 
Seat 6: hempju1ce ($10.82 in chips) 
Daurado: posts small blind $0.05
hempju1ce: posts big blind $0.10
senej: sits out 
*** HOLE CARDS ***
D9_nvkz: folds 
llosjone: folds 
LigoL: folds 
Daurado: raises $0.20 to $0.30
hempju1ce: folds 
Uncalled bet ($0.20) returned to Daurado
Daurado collected $0.20 from pot
Daurado: doesn't show hand 
*** SUMMARY ***
Total pot $0.20 | Rake $0 
Seat 2: D9_nvkz folded before Flop (didn't bet)
Seat 3: llosjone folded before Flop (didn't bet)
Seat 4: LigoL (button) folded before Flop (didn't bet)
Seat 5: Daurado (small blind) collected ($0.20)
Seat 6: hempju1ce (big blind) folded before Flop



PokerStars Hand #222961082803:  Hold'em No Limit ($0.05/$0.10 USD) - 2021/01/23 12:24:04 ET
Table 'Shura III' 6-max Seat #5 is the button
Seat 1: senej ($10 in chips) 
Seat 2: D9_nvkz ($13.55 in chips) 
Seat 3: llosjone ($9.10 in chips) 
Seat 4: LigoL ($10 in chips) 
Seat 5: Daurado ($11.40 in chips) 
Seat 6: hempju1ce ($10.72 in chips) 
hempju1ce: posts small blind $0.05
senej: posts big blind $0.10
*** HOLE CARDS ***
D9_nvkz: folds 
llosjone: folds 
LigoL: folds 
Daurado: folds 
hempju1ce: calls $0.05
senej: checks 
*** FLOP *** [6c 9c Jd]
hempju1ce: checks 
senej: bets $0.10
hempju1ce: folds 
Uncalled bet ($0.10) returned to senej
senej collected $0.19 from pot
senej: doesn't show hand 
*** SUMMARY ***
Total pot $0.20 | Rake $0.01 
Board [6c 9c Jd]
Seat 1: senej (big blind) collected ($0.19)
Seat 2: D9_nvkz folded before Flop (didn't bet)
Seat 3: llosjone folded before Flop (didn't bet)
Seat 4: LigoL folded before Flop (didn't bet)
Seat 5: Daurado (button) folded before Flop (didn't bet)
Seat 6: hempju1ce (small blind) folded on the Flop



PokerStars Hand #222961095346:  Hold'em No Limit ($0.05/$0.10 USD) - 2021/01/23 12:24:24 ET
Table 'Shura III' 6-max Seat #6 is the button
Seat 1: senej ($10.09 in chips) 
Seat 2: D9_nvkz ($13.55 in chips) 
Seat 3: llosjone ($9.10 in chips) 
Seat 4: LigoL ($10 in chips) 
Seat 5: Daurado ($11.40 in chips) 
Seat 6: hempju1ce ($10.62 in chips) 
senej: posts small blind $0.05
D9_nvkz: posts big blind $0.10
*** HOLE CARDS ***
llosjone: folds 
LigoL: folds 
Daurado: folds 
hempju1ce: raises $0.20 to $0.30
senej: folds 
D9_nvkz: folds 
Uncalled bet ($0.20) returned to hempju1ce
hempju1ce collected $0.25 from pot
hempju1ce: doesn't show hand 
*** SUMMARY ***
Total pot $0.25 | Rake $0 
Seat 1: senej (small blind) folded before Flop
Seat 2: D9_nvkz (big blind) folded before Flop
Seat 3: llosjone folded before Flop (didn't bet)
Seat 4: LigoL folded before Flop (didn't bet)
Seat 5: Daurado folded before Flop (didn't bet)
Seat 6: hempju1ce (button) collected ($0.25)



PokerStars Hand #222961106352:  Hold'em No Limit ($0.05/$0.10 USD) - 2021/01/23 12:24:41 ET
Table 'Shura III' 6-max Seat #1 is the button
Seat 1: senej ($10.04 in chips) 
Seat 2: D9_nvkz ($13.45 in chips) 
Seat 3: llosjone ($9.10 in chips) 
Seat 4: LigoL ($10 in chips) 
Seat 5: Daurado ($11.40 in chips) 
Seat 6: hempju1ce ($10.77 in chips) 
D9_nvkz: posts small blind $0.05
llosjone: posts big blind $0.10
*** HOLE CARDS ***
LigoL: folds 
Daurado: folds 
hempju1ce: folds 
senej: folds 
D9_nvkz: raises $0.20 to $0.30
llosjone: folds 
Uncalled bet ($0.20) returned to D9_nvkz
D9_nvkz collected $0.20 from pot
D9_nvkz: doesn't show hand 
*** SUMMARY ***
Total pot $0.20 | Rake $0 
Seat 1: senej (button) folded before Flop (didn't bet)
Seat 2: D9_nvkz (small blind) collected ($0.20)
Seat 3: llosjone (big blind) folded before Flop
Seat 4: LigoL folded before Flop (didn't bet)
Seat 5: Daurado folded before Flop (didn't bet)
Seat 6: hempju1ce folded before Flop (didn't bet)



PokerStars Hand #222961115051:  Hold'em No Limit ($0.05/$0.10 USD) - 2021/01/23 12:24:55 ET
Table 'Shura III' 6-max Seat #2 is the button
Seat 1: senej ($10.04 in chips) 
Seat 2: D9_nvkz ($13.55 in chips) 
Seat 3: llosjone ($10 in chips) 
Seat 4: LigoL ($10 in chips) 
Seat 5: Daurado ($11.40 in chips) 
Seat 6: hempju1ce ($10.77 in chips) 
llosjone: posts small blind $0.05
LigoL: posts big blind $0.10
*** HOLE CARDS ***
Daurado: folds 
hempju1ce: folds 
senej: folds 
D9_nvkz: raises $0.20 to $0.30
llosjone: folds 
LigoL: folds 
Uncalled bet ($0.20) returned to D9_nvkz
D9_nvkz collected $0.25 from pot
D9_nvkz: doesn't show hand 
*** SUMMARY ***
Total pot $0.25 | Rake $0 
Seat 1: senej folded before Flop (didn't bet)
Seat 2: D9_nvkz (button) collected ($0.25)
Seat 3: llosjone (small blind) folded before Flop
Seat 4: LigoL (big blind) folded before Flop
Seat 5: Daurado folded before Flop (didn't bet)
Seat 6: hempju1ce folded before Flop (didn't bet)



PokerStars Hand #222961129277:  Hold'em No Limit ($0.05/$0.10 USD) - 2021/01/23 12:25:16 ET
Table 'Shura III' 6-max Seat #3 is the button
Seat 1: senej ($10.04 in chips) 
Seat 2: D9_nvkz ($13.70 in chips) 
Seat 3: llosjone ($9.95 in chips) 
Seat 4: LigoL ($10 in chips) 
Seat 6: hempju1ce ($10.77 in chips) 
LigoL: posts small blind $0.05
Daurado: is sitting out 
hempju1ce: posts big blind $0.10
*** HOLE CARDS ***
senej: folds 
D9_nvkz: folds 
llosjone: folds 
LigoL: calls $0.05
hempju1ce: checks 
*** FLOP *** [6h 7c 3c]
LigoL: bets $0.15
hempju1ce: calls $0.15
*** TURN *** [6h 7c 3c] [3s]
LigoL: checks 
hempju1ce: checks 
*** RIVER *** [6h 7c 3c 3s] [Ts]
LigoL: checks 
hempju1ce: checks 
*** SHOW DOWN ***
LigoL: shows [Kh 9c] (a pair of Threes)
hempju1ce: shows [4c 6c] (two pair, Sixes and Threes)
hempju1ce collected $0.48 from pot
*** SUMMARY ***
Total pot $0.50 | Rake $0.02 
Board [6h 7c 3c 3s Ts]
Seat 1: senej folded before Flop (didn't bet)
Seat 2: D9_nvkz folded before Flop (didn't bet)
Seat 3: llosjone (button) folded before Flop (didn't bet)
Seat 4: LigoL (small blind) showed [Kh 9c] and lost with a pair of Threes
Seat 6: hempju1ce (big blind) showed [4c 6c] and won ($0.48) with two pair, Sixes and Threes



PokerStars Hand #222961144461:  Hold'em No Limit ($0.05/$0.10 USD) - 2021/01/23 12:25:40 ET
Table 'Shura III' 6-max Seat #4 is the button
Seat 1: senej ($10.04 in chips) 
Seat 2: D9_nvkz ($13.70 in chips) 
Seat 3: llosjone ($9.95 in chips) 
Seat 4: LigoL ($10 in chips) 
Seat 6: hempju1ce ($11 in chips) 
hempju1ce: posts small blind $0.05
senej: posts big blind $0.10
*** HOLE CARDS ***
D9_nvkz: folds 
llosjone: folds 
LigoL: folds 
hempju1ce: folds 
Uncalled bet ($0.05) returned to senej
senej collected $0.10 from pot
senej: doesn't show hand 
*** SUMMARY ***
Total pot $0.10 | Rake $0 
Seat 1: senej (big blind) collected ($0.10)
Seat 2: D9_nvkz folded before Flop (didn't bet)
Seat 3: llosjone folded before Flop (didn't bet)
Seat 4: LigoL (button) folded before Flop (didn't bet)
Seat 6: hempju1ce (small blind) folded before Flop



PokerStars Hand #222961154051:  Hold'em No Limit ($0.05/$0.10 USD) - 2021/01/23 12:25:55 ET
Table 'Shura III' 6-max Seat #6 is the button
Seat 1: senej ($10.09 in chips) 
Seat 2: D9_nvkz ($13.70 in chips) 
Seat 3: llosjone ($9.95 in chips) 
Seat 4: LigoL ($10 in chips) 
Seat 6: hempju1ce ($10.95 in chips) 
senej: posts small blind $0.05
D9_nvkz: posts big blind $0.10
*** HOLE CARDS ***
Daurado leaves the table
llosjone: raises $0.10 to $0.20
LigoL: folds 
fionn97 joins the table at seat #5 
hempju1ce: folds 
senej: raises $0.60 to $0.80
D9_nvkz: folds 
llosjone: folds 
Uncalled bet ($0.60) returned to senej
senej collected $0.50 from pot
senej: doesn't show hand 
*** SUMMARY ***
Total pot $0.50 | Rake $0 
Seat 1: senej (small blind) collected ($0.50)
Seat 2: D9_nvkz (big blind) folded before Flop
Seat 3: llosjone folded before Flop
Seat 4: LigoL folded before Flop (didn't bet)
Seat 6: hempju1ce (button) folded before Flop (didn't bet)



PokerStars Hand #222961170058:  Hold'em No Limit ($0.05/$0.10 USD) - 2021/01/23 12:26:19 ET
Table 'Shura III' 6-max Seat #1 is the button
Seat 1: senej ($10.39 in chips) 
Seat 2: D9_nvkz ($13.60 in chips) 
Seat 3: llosjone ($9.75 in chips) 
Seat 4: LigoL ($10 in chips) 
Seat 6: hempju1ce ($10.95 in chips) 
D9_nvkz: posts small blind $0.05
llosjone: posts big blind $0.10
fionn97: sits out 
*** HOLE CARDS ***
LigoL: folds 
hempju1ce: folds 
senej: folds 
D9_nvkz: raises $0.20 to $0.30
llosjone: calls $0.20
*** FLOP *** [7h 4h 8d]
D9_nvkz: bets $0.28
llosjone: calls $0.28
*** TURN *** [7h 4h 8d] [Th]
D9_nvkz: checks 
llosjone: bets $0.48
D9_nvkz: folds 
Uncalled bet ($0.48) returned to llosjone
llosjone collected $1.11 from pot
llosjone: doesn't show hand 
*** SUMMARY ***
Total pot $1.16 | Rake $0.05 
Board [7h 4h 8d Th]
Seat 1: senej (button) folded before Flop (didn't bet)
Seat 2: D9_nvkz (small blind) folded on the Turn
Seat 3: llosjone (big blind) collected ($1.11)
Seat 4: LigoL folded before Flop (didn't bet)
Seat 6: hempju1ce folded before Flop (didn't bet)



PokerStars Hand #222961192286:  Hold'em No Limit ($0.05/$0.10 USD) - 2021/01/23 12:26:53 ET
Table 'Shura III' 6-max Seat #2 is the button
Seat 1: senej ($10.39 in chips) 
Seat 2: D9_nvkz ($13.02 in chips) 
Seat 3: llosjone ($10.28 in chips) 
Seat 4: LigoL ($10 in chips) 
Seat 6: hempju1ce ($10.95 in chips) 
llosjone: posts small blind $0.05
LigoL: posts big blind $0.10
fionn97: sits out 
*** HOLE CARDS ***
hempju1ce: folds 
senej: folds 
D9_nvkz: folds 
llosjone: folds 
Uncalled bet ($0.05) returned to LigoL
LigoL collected $0.10 from pot
LigoL: doesn't show hand 
*** SUMMARY ***
Total pot $0.10 | Rake $0 
Seat 1: senej folded before Flop (didn't bet)
Seat 2: D9_nvkz (button) folded before Flop (didn't bet)
Seat 3: llosjone (small blind) folded before Flop
Seat 4: LigoL (big blind) collected ($0.10)
Seat 6: hempju1ce folded before Flop (didn't bet)



PokerStars Hand #222961196969:  Hold'em No Limit ($0.05/$0.10 USD) - 2021/01/23 12:27:00 ET
Table 'Shura III' 6-max Seat #3 is the button
Seat 1: senej ($10.39 in chips) 
Seat 2: D9_nvkz ($13.02 in chips) 
Seat 3: llosjone ($10.23 in chips) 
Seat 4: LigoL ($10.05 in chips) 
Seat 5: fionn97 ($5.45 in chips) 
Seat 6: hempju1ce ($10.95 in chips) 
LigoL: posts small blind $0.05
fionn97: posts big blind $0.10
*** HOLE CARDS ***
hempju1ce: folds 
senej: raises $0.20 to $0.30
D9_nvkz: folds 
llosjone: folds 
LigoL: folds 
fionn97: calls $0.20
*** FLOP *** [2s Ah As]
fionn97: checks 
senej: bets $0.41
fionn97: folds 
Uncalled bet ($0.41) returned to senej
senej collected $0.62 from pot
senej: doesn't show hand 
*** SUMMARY ***
Total pot $0.65 | Rake $0.03 
Board [2s Ah As]
Seat 1: senej collected ($0.62)
Seat 2: D9_nvkz folded before Flop (didn't bet)
Seat 3: llosjone (button) folded before Flop (didn't bet)
Seat 4: LigoL (small blind) folded before Flop
Seat 5: fionn97 (big blind) folded on the Flop
Seat 6: hempju1ce folded before Flop (didn't bet)



PokerStars Hand #222961216166:  Hold'em No Limit ($0.05/$0.10 USD) - 2021/01/23 12:27:30 ET
Table 'Shura III' 6-max Seat #4 is the button
Seat 1: senej ($10.71 in chips) 
Seat 2: D9_nvkz ($13.02 in chips) 
Seat 3: llosjone ($10.23 in chips) 
Seat 4: LigoL ($10 in chips) 
Seat 5: fionn97 ($5.15 in chips) 
Seat 6: hempju1ce ($10.95 in chips) 
fionn97: posts small blind $0.05
hempju1ce: posts big blind $0.10
*** HOLE CARDS ***
senej: raises $0.20 to $0.30
D9_nvkz: folds 
llosjone: calls $0.30
LigoL: folds 
fionn97: folds 
hempju1ce: folds 
*** FLOP *** [9d 3h 4h]
senej: bets $0.48
llosjone: folds 
Uncalled bet ($0.48) returned to senej
senej collected $0.72 from pot
senej: doesn't show hand 
*** SUMMARY ***
Total pot $0.75 | Rake $0.03 
Board [9d 3h 4h]
Seat 1: senej collected ($0.72)
Seat 2: D9_nvkz folded before Flop (didn't bet)
Seat 3: llosjone folded on the Flop
Seat 4: LigoL (button) folded before Flop (didn't bet)
Seat 5: fionn97 (small blind) folded before Flop
Seat 6: hempju1ce (big blind) folded before Flop



PokerStars Hand #222961234437:  Hold'em No Limit ($0.05/$0.10 USD) - 2021/01/23 12:27:58 ET
Table 'Shura III' 6-max Seat #5 is the button
Seat 1: senej ($11.13 in chips) 
Seat 2: D9_nvkz ($13.02 in chips) 
Seat 3: llosjone ($9.93 in chips) 
Seat 4: LigoL ($10 in chips) 
Seat 5: fionn97 ($5.10 in chips) 
Seat 6: hempju1ce ($10.85 in chips) 
hempju1ce: posts small blind $0.05
senej: posts big blind $0.10
*** HOLE CARDS ***
D9_nvkz: folds 
llosjone: folds 
LigoL: folds 
fionn97: calls $0.10
hempju1ce: calls $0.05
senej: checks 
*** FLOP *** [Kh Ks Kd]
hempju1ce: checks 
senej: checks 
fionn97: checks 
*** TURN *** [Kh Ks Kd] [9d]
hempju1ce: checks 
senej: checks 
fionn97: checks 
*** RIVER *** [Kh Ks Kd 9d] [Ts]
hempju1ce: bets $0.10
senej: folds 
fionn97: calls $0.10
*** SHOW DOWN ***
hempju1ce: shows [Kc Js] (four of a kind, Kings)
fionn97: mucks hand 
hempju1ce collected $0.48 from pot
*** SUMMARY ***
Total pot $0.50 | Rake $0.02 
Board [Kh Ks Kd 9d Ts]
Seat 1: senej (big blind) folded on the River
Seat 2: D9_nvkz folded before Flop (didn't bet)
Seat 3: llosjone folded before Flop (didn't bet)
Seat 4: LigoL folded before Flop (didn't bet)
Seat 5: fionn97 (button) mucked
Seat 6: hempju1ce (small blind) showed [Kc Js] and won ($0.48) with four of a kind, Kings



PokerStars Hand #222961262329:  Hold'em No Limit ($0.05/$0.10 USD) - 2021/01/23 12:28:41 ET
Table 'Shura III' 6-max Seat #6 is the button
Seat 1: senej ($11.03 in chips) 
Seat 2: D9_nvkz ($13.02 in chips) 
Seat 3: llosjone ($9.93 in chips) 
Seat 4: LigoL ($10 in chips) 
Seat 5: fionn97 ($4.90 in chips) 
Seat 6: hempju1ce ($11.13 in chips) 
senej: posts small blind $0.05
D9_nvkz: posts big blind $0.10
*** HOLE CARDS ***
llosjone: folds 
LigoL: raises $0.20 to $0.30
fionn97: folds 
hempju1ce: calls $0.30
senej: folds 
D9_nvkz: folds 
*** FLOP *** [7c 5c Qh]
LigoL: checks 
hempju1ce: bets $0.30
LigoL: raises $0.66 to $0.96
hempju1ce: calls $0.66
*** TURN *** [7c 5c Qh] [3h]
LigoL: bets $1.99
hempju1ce: calls $1.99
*** RIVER *** [7c 5c Qh 3h] [Js]
LigoL: bets $6.75 and is all-in
hempju1ce: calls $6.75
*** SHOW DOWN ***
LigoL: shows [Ah Qc] (a pair of Queens)
hempju1ce: shows [8d Qd] (a pair of Queens - lower kicker)
LigoL collected $19.24 from pot
*** SUMMARY ***
Total pot $20.15 | Rake $0.91 
Board [7c 5c Qh 3h Js]
Seat 1: senej (small blind) folded before Flop
Seat 2: D9_nvkz (big blind) folded before Flop
Seat 3: llosjone folded before Flop (didn't bet)
Seat 4: LigoL showed [Ah Qc] and won ($19.24) with a pair of Queens
Seat 5: fionn97 folded before Flop (didn't bet)
Seat 6: hempju1ce (button) showed [8d Qd] and lost with a pair of Queens



PokerStars Hand #222961299979:  Hold'em No Limit ($0.05/$0.10 USD) - 2021/01/23 12:29:39 ET
Table 'Shura III' 6-max Seat #1 is the button
Seat 1: senej ($10.98 in chips) 
Seat 2: D9_nvkz ($12.92 in chips) 
Seat 3: llosjone ($9.93 in chips) 
Seat 4: LigoL ($19.24 in chips) 
Seat 5: fionn97 ($4.90 in chips) 
Seat 6: hempju1ce ($1.13 in chips) 
D9_nvkz: posts small blind $0.05
llosjone: posts big blind $0.10
*** HOLE CARDS ***
LigoL: folds 
fionn97: folds 
hempju1ce: calls $0.10
senej: raises $0.35 to $0.45
D9_nvkz: folds 
llosjone: folds 
hempju1ce: calls $0.35
*** FLOP *** [Ah Jc 3s]
hempju1ce: bets $0.68 and is all-in
senej: calls $0.68
*** TURN *** [Ah Jc 3s] [Tc]
*** RIVER *** [Ah Jc 3s Tc] [Th]
*** SHOW DOWN ***
hempju1ce: shows [2d Ac] (two pair, Aces and Tens)
senej: shows [Jh Kd] (two pair, Jacks and Tens)
hempju1ce collected $2.30 from pot
*** SUMMARY ***
Total pot $2.41 | Rake $0.11 
Board [Ah Jc 3s Tc Th]
Seat 1: senej (button) showed [Jh Kd] and lost with two pair, Jacks and Tens
Seat 2: D9_nvkz (small blind) folded before Flop
Seat 3: llosjone (big blind) folded before Flop
Seat 4: LigoL folded before Flop (didn't bet)
Seat 5: fionn97 folded before Flop (didn't bet)
Seat 6: hempju1ce showed [2d Ac] and won ($2.30) with two pair, Aces and Tens



PokerStars Hand #222961321076:  Hold'em No Limit ($0.05/$0.10 USD) - 2021/01/23 12:30:10 ET
Table 'Shura III' 6-max Seat #2 is the button
Seat 1: senej ($10 in chips) 
Seat 2: D9_nvkz ($12.87 in chips) 
Seat 3: llosjone ($9.83 in chips) 
Seat 4: LigoL ($19.24 in chips) 
Seat 5: fionn97 ($4.90 in chips) 
Seat 6: hempju1ce ($2.30 in chips) 
llosjone: posts small blind $0.05
LigoL: posts big blind $0.10
*** HOLE CARDS ***
fionn97: calls $0.10
hempju1ce: folds 
senej: raises $0.20 to $0.30
D9_nvkz: folds 
llosjone: calls $0.25
LigoL: folds 
fionn97: calls $0.20
*** FLOP *** [Ks 9h 8s]
llosjone: checks 
fionn97: checks 
senej: checks 
*** TURN *** [Ks 9h 8s] [7d]
llosjone: checks 
fionn97: checks 
senej: checks 
*** RIVER *** [Ks 9h 8s 7d] [2d]
llosjone: checks 
fionn97: checks 
senej: checks 
*** SHOW DOWN ***
llosjone: shows [4c 5c] (high card King)
fionn97: shows [Ac 9d] (a pair of Nines)
senej: mucks hand 
fionn97 collected $0.96 from pot
*** SUMMARY ***
Total pot $1 | Rake $0.04 
Board [Ks 9h 8s 7d 2d]
Seat 1: senej mucked
Seat 2: D9_nvkz (button) folded before Flop (didn't bet)
Seat 3: llosjone (small blind) showed [4c 5c] and lost with high card King
Seat 4: LigoL (big blind) folded before Flop
Seat 5: fionn97 showed [Ac 9d] and won ($0.96) with a pair of Nines
Seat 6: hempju1ce folded before Flop (didn't bet)



PokerStars Hand #222961361640:  Hold'em No Limit ($0.05/$0.10 USD) - 2021/01/23 12:31:12 ET
Table 'Shura III' 6-max Seat #3 is the button
Seat 1: senej ($10 in chips) 
Seat 2: D9_nvkz ($12.87 in chips) 
Seat 3: llosjone ($9.53 in chips) 
Seat 4: LigoL ($19.14 in chips) 
Seat 5: fionn97 ($5.56 in chips) 
Seat 6: hempju1ce ($2.30 in chips) 
LigoL: posts small blind $0.05
fionn97: posts big blind $0.10
*** HOLE CARDS ***
hempju1ce: calls $0.10
senej: folds 
D9_nvkz: folds 
llosjone: folds 
LigoL: calls $0.05
fionn97: checks 
*** FLOP *** [3c 5h 3h]
LigoL: checks 
fionn97: checks 
hempju1ce: checks 
*** TURN *** [3c 5h 3h] [Jc]
LigoL: checks 
fionn97: checks 
hempju1ce: checks 
*** RIVER *** [3c 5h 3h Jc] [Th]
LigoL: checks 
fionn97: bets $0.30
hempju1ce: calls $0.30
LigoL: folds 
*** SHOW DOWN ***
fionn97: shows [Kc 3d] (three of a kind, Threes)
hempju1ce: mucks hand 
fionn97 collected $0.86 from pot
*** SUMMARY ***
Total pot $0.90 | Rake $0.04 
Board [3c 5h 3h Jc Th]
Seat 1: senej folded before Flop (didn't bet)
Seat 2: D9_nvkz folded before Flop (didn't bet)
Seat 3: llosjone (button) folded before Flop (didn't bet)
Seat 4: LigoL (small blind) folded on the River
Seat 5: fionn97 (big blind) showed [Kc 3d] and won ($0.86) with three of a kind, Threes
Seat 6: hempju1ce mucked



PokerStars Hand #222961401763:  Hold'em No Limit ($0.05/$0.10 USD) - 2021/01/23 12:32:12 ET
Table 'Shura III' 6-max Seat #4 is the button
Seat 1: senej ($10 in chips) 
Seat 3: llosjone ($9.53 in chips) 
Seat 4: LigoL ($19.04 in chips) 
Seat 5: fionn97 ($6.02 in chips) 
fionn97: posts small blind $0.05
hempju1ce: is sitting out 
senej: posts big blind $0.10
*** HOLE CARDS ***
hempju1ce leaves the table
llosjone: folds 
IrdinTo16 joins the table at seat #6 
LigoL: folds 
fionn97: calls $0.05
senej: checks 
*** FLOP *** [Js 9s Qc]
fionn97: bets $0.20
senej: folds 
Uncalled bet ($0.20) returned to fionn97
fionn97 collected $0.19 from pot
*** SUMMARY ***
Total pot $0.20 | Rake $0.01 
Board [Js 9s Qc]
Seat 1: senej (big blind) folded on the Flop
Seat 3: llosjone folded before Flop (didn't bet)
Seat 4: LigoL (button) folded before Flop (didn't bet)
Seat 5: fionn97 (small blind) collected ($0.19)



PokerStars Hand #222961420369:  Hold'em No Limit ($0.05/$0.10 USD) - 2021/01/23 12:32:40 ET
Table 'Shura III' 6-max Seat #5 is the button
Seat 1: senej ($10 in chips) 
Seat 3: llosjone ($9.53 in chips) 
Seat 4: LigoL ($19.04 in chips) 
Seat 5: fionn97 ($6.11 in chips) 
senej: posts small blind $0.05
llosjone: posts big blind $0.10
*** HOLE CARDS ***
LigoL: folds 
fionn97: folds 
senej: folds 
Uncalled bet ($0.05) returned to llosjone
llosjone collected $0.10 from pot
llosjone: doesn't show hand 
*** SUMMARY ***
Total pot $0.10 | Rake $0 
Seat 1: senej (small blind) folded before Flop
Seat 3: llosjone (big blind) collected ($0.10)
Seat 4: LigoL folded before Flop (didn't bet)
Seat 5: fionn97 (button) folded before Flop (didn't bet)



PokerStars Hand #222961428784:  Hold'em No Limit ($0.05/$0.10 USD) - 2021/01/23 12:32:53 ET
Table 'Shura III' 6-max Seat #1 is the button
Seat 1: senej ($10 in chips) 
Seat 3: llosjone ($9.58 in chips) 
Seat 4: LigoL ($19.04 in chips) 
Seat 5: fionn97 ($6.11 in chips) 
llosjone: posts small blind $0.05
LigoL: posts big blind $0.10
IrdinTo16: sits out 
*** HOLE CARDS ***
fionn97: folds 
senej: raises $0.20 to $0.30
llosjone: folds 
LigoL: folds 
Uncalled bet ($0.20) returned to senej
senej collected $0.25 from pot
senej: doesn't show hand 
*** SUMMARY ***
Total pot $0.25 | Rake $0 
Seat 1: senej (button) collected ($0.25)
Seat 3: llosjone (small blind) folded before Flop
Seat 4: LigoL (big blind) folded before Flop
Seat 5: fionn97 folded before Flop (didn't bet)



PokerStars Hand #222961439732:  Hold'em No Limit ($0.05/$0.10 USD) - 2021/01/23 12:33:09 ET
Table 'Shura III' 6-max Seat #3 is the button
Seat 1: senej ($10.15 in chips) 
Seat 3: llosjone ($9.53 in chips) 
Seat 4: LigoL ($18.94 in chips) 
Seat 5: fionn97 ($6.11 in chips) 
LigoL: posts small blind $0.05
fionn97: posts big blind $0.10
IrdinTo16: sits out 
*** HOLE CARDS ***
senej: folds 
llosjone: raises $0.15 to $0.25
LigoL: folds 
fionn97: folds 
Uncalled bet ($0.15) returned to llosjone
llosjone collected $0.25 from pot
llosjone: doesn't show hand 
*** SUMMARY ***
Total pot $0.25 | Rake $0 
Seat 1: senej folded before Flop (didn't bet)
Seat 3: llosjone (button) collected ($0.25)
Seat 4: LigoL (small blind) folded before Flop
Seat 5: fionn97 (big blind) folded before Flop



PokerStars Hand #222961455733:  Hold'em No Limit ($0.05/$0.10 USD) - 2021/01/23 12:33:33 ET
Table 'Shura III' 6-max Seat #4 is the button
Seat 1: senej ($10.15 in chips) 
Seat 3: llosjone ($9.68 in chips) 
Seat 4: LigoL ($18.89 in chips) 
Seat 5: fionn97 ($6.01 in chips) 
Seat 6: IrdinTo16 ($10 in chips) 
fionn97: posts small blind $0.05
IrdinTo16: posts big blind $0.10
*** HOLE CARDS ***
senej: folds 
llosjone: folds 
LigoL: raises $0.15 to $0.25
fionn97: folds 
IrdinTo16: folds 
Uncalled bet ($0.15) returned to LigoL
LigoL collected $0.25 from pot
LigoL: doesn't show hand 
*** SUMMARY ***
Total pot $0.25 | Rake $0 
Seat 1: senej folded before Flop (didn't bet)
Seat 3: llosjone folded before Flop (didn't bet)
Seat 4: LigoL (button) collected ($0.25)
Seat 5: fionn97 (small blind) folded before Flop
Seat 6: IrdinTo16 (big blind) folded before Flop



PokerStars Hand #222961466101:  Hold'em No Limit ($0.05/$0.10 USD) - 2021/01/23 12:33:48 ET
Table 'Shura III' 6-max Seat #5 is the button
Seat 1: senej ($10.15 in chips) 
Seat 3: llosjone ($9.68 in chips) 
Seat 4: LigoL ($19.04 in chips) 
Seat 5: fionn97 ($5.96 in chips) 
Seat 6: IrdinTo16 ($10 in chips) 
IrdinTo16: posts small blind $0.05
senej: posts big blind $0.10
*** HOLE CARDS ***
llosjone: folds 
LigoL: folds 
fionn97: calls $0.10
IrdinTo16: folds 
senej: checks 
*** FLOP *** [4h 7h Ac]
senej: checks 
fionn97: checks 
*** TURN *** [4h 7h Ac] [Js]
senej: checks 
fionn97: checks 
*** RIVER *** [4h 7h Ac Js] [2s]
senej: checks 
fionn97: bets $0.60
senej: folds 
Uncalled bet ($0.60) returned to fionn97
fionn97 collected $0.24 from pot
*** SUMMARY ***
Total pot $0.25 | Rake $0.01 
Board [4h 7h Ac Js 2s]
Seat 1: senej (big blind) folded on the River
Seat 3: llosjone folded before Flop (didn't bet)
Seat 4: LigoL folded before Flop (didn't bet)
Seat 5: fionn97 (button) collected ($0.24)
Seat 6: IrdinTo16 (small blind) folded before Flop



PokerStars Hand #222961496436:  Hold'em No Limit ($0.05/$0.10 USD) - 2021/01/23 12:34:34 ET
Table 'Shura III' 6-max Seat #6 is the button
Seat 1: senej ($10.05 in chips) 
Seat 3: llosjone ($9.68 in chips) 
Seat 4: LigoL ($19.04 in chips) 
Seat 5: fionn97 ($6.10 in chips) 
Seat 6: IrdinTo16 ($10 in chips) 
senej: posts small blind $0.05
llosjone: posts big blind $0.10
*** HOLE CARDS ***
LigoL: folds 
fionn97: folds 
IrdinTo16: folds 
senej: raises $0.20 to $0.30
llosjone: raises $0.20 to $0.50
senej: calls $0.20
*** FLOP *** [8c 8h 9s]
senej: checks 
llosjone: checks 
*** TURN *** [8c 8h 9s] [Jd]
senej: bets $0.64
llosjone: folds 
Uncalled bet ($0.64) returned to senej
senej collected $0.96 from pot
senej: doesn't show hand 
*** SUMMARY ***
Total pot $1 | Rake $0.04 
Board [8c 8h 9s Jd]
Seat 1: senej (small blind) collected ($0.96)
Seat 3: llosjone (big blind) folded on the Turn
Seat 4: LigoL folded before Flop (didn't bet)
Seat 5: fionn97 folded before Flop (didn't bet)
Seat 6: IrdinTo16 (button) folded before Flop (didn't bet)



PokerStars Hand #222961513448:  Hold'em No Limit ($0.05/$0.10 USD) - 2021/01/23 12:34:59 ET
Table 'Shura III' 6-max Seat #1 is the button
Seat 1: senej ($10.51 in chips) 
Seat 3: llosjone ($9.18 in chips) 
Seat 4: LigoL ($19.04 in chips) 
Seat 5: fionn97 ($6.10 in chips) 
Seat 6: IrdinTo16 ($10 in chips) 
llosjone: posts small blind $0.05
LigoL: posts big blind $0.10
*** HOLE CARDS ***
fionn97: calls $0.10
IrdinTo16: folds 
senej: folds 
llosjone: raises $0.15 to $0.25
LigoL: folds 
fionn97: calls $0.15
*** FLOP *** [Tc Qs Td]
llosjone: bets $0.19
fionn97: folds 
Uncalled bet ($0.19) returned to llosjone
llosjone collected $0.57 from pot
llosjone: doesn't show hand 
*** SUMMARY ***
Total pot $0.60 | Rake $0.03 
Board [Tc Qs Td]
Seat 1: senej (button) folded before Flop (didn't bet)
Seat 3: llosjone (small blind) collected ($0.57)
Seat 4: LigoL (big blind) folded before Flop
Seat 5: fionn97 folded on the Flop
Seat 6: IrdinTo16 folded before Flop (didn't bet)



PokerStars Hand #222961527284:  Hold'em No Limit ($0.05/$0.10 USD) - 2021/01/23 12:35:20 ET
Table 'Shura III' 6-max Seat #3 is the button
Seat 1: senej ($10.51 in chips) 
Seat 3: llosjone ($10 in chips) 
Seat 4: LigoL ($18.94 in chips) 
Seat 5: fionn97 ($5.85 in chips) 
Seat 6: IrdinTo16 ($10 in chips) 
LigoL: posts small blind $0.05
fionn97: posts big blind $0.10
*** HOLE CARDS ***
IrdinTo16: folds 
senej: folds 
llosjone: folds 
LigoL: raises $0.20 to $0.30
fionn97: folds 
Uncalled bet ($0.20) returned to LigoL
LigoL collected $0.20 from pot
LigoL: doesn't show hand 
*** SUMMARY ***
Total pot $0.20 | Rake $0 
Seat 1: senej folded before Flop (didn't bet)
Seat 3: llosjone (button) folded before Flop (didn't bet)
Seat 4: LigoL (small blind) collected ($0.20)
Seat 5: fionn97 (big blind) folded before Flop
Seat 6: IrdinTo16 folded before Flop (didn't bet)



PokerStars Hand #222961543542:  Hold'em No Limit ($0.05/$0.10 USD) - 2021/01/23 12:35:44 ET
Table 'Shura III' 6-max Seat #4 is the button
Seat 1: senej ($10.51 in chips) 
Seat 3: llosjone ($10 in chips) 
Seat 4: LigoL ($19.04 in chips) 
Seat 5: fionn97 ($5.75 in chips) 
Seat 6: IrdinTo16 ($10 in chips) 
fionn97: posts small blind $0.05
IrdinTo16: posts big blind $0.10
*** HOLE CARDS ***
senej: raises $0.20 to $0.30
llosjone: folds 
LigoL: folds 
fionn97: calls $0.25
IrdinTo16: folds 
*** FLOP *** [2c Ad 7s]
fionn97: bets $0.20
senej: calls $0.20
*** TURN *** [2c Ad 7s] [Ts]
fionn97: bets $0.20
senej: calls $0.20
*** RIVER *** [2c Ad 7s Ts] [9h]
fionn97: bets $0.30
senej: raises $9.51 to $9.81 and is all-in
fionn97: folds 
Uncalled bet ($9.51) returned to senej
senej collected $2.01 from pot
senej: doesn't show hand 
*** SUMMARY ***
Total pot $2.10 | Rake $0.09 
Board [2c Ad 7s Ts 9h]
Seat 1: senej collected ($2.01)
Seat 3: llosjone folded before Flop (didn't bet)
Seat 4: LigoL (button) folded before Flop (didn't bet)
Seat 5: fionn97 (small blind) folded on the River
Seat 6: IrdinTo16 (big blind) folded before Flop



PokerStars Hand #222961571459:  Hold'em No Limit ($0.05/$0.10 USD) - 2021/01/23 12:36:26 ET
Table 'Shura III' 6-max Seat #5 is the button
Seat 1: senej ($11.52 in chips) 
Seat 3: llosjone ($10 in chips) 
Seat 4: LigoL ($19.04 in chips) 
Seat 5: fionn97 ($4.75 in chips) 
Seat 6: IrdinTo16 ($10 in chips) 
IrdinTo16: posts small blind $0.05
senej: posts big blind $0.10
*** HOLE CARDS ***
llosjone: folds 
LigoL: folds 
fionn97: calls $0.10
IrdinTo16: folds 
senej: raises $0.40 to $0.50
fionn97: folds 
Uncalled bet ($0.40) returned to senej
senej collected $0.25 from pot
senej: doesn't show hand 
*** SUMMARY ***
Total pot $0.25 | Rake $0 
Seat 1: senej (big blind) collected ($0.25)
Seat 3: llosjone folded before Flop (didn't bet)
Seat 4: LigoL folded before Flop (didn't bet)
Seat 5: fionn97 (button) folded before Flop
Seat 6: IrdinTo16 (small blind) folded before Flop



PokerStars Hand #222961579532:  Hold'em No Limit ($0.05/$0.10 USD) - 2021/01/23 12:36:38 ET
Table 'Shura III' 6-max Seat #6 is the button
Seat 1: senej ($11.67 in chips) 
Seat 3: llosjone ($10 in chips) 
Seat 4: LigoL ($19.04 in chips) 
Seat 5: fionn97 ($4.65 in chips) 
Seat 6: IrdinTo16 ($10 in chips) 
senej: posts small blind $0.05
llosjone: posts big blind $0.10
*** HOLE CARDS ***
LigoL: folds 
fionn97: folds 
IrdinTo16: folds 
senej: folds 
Uncalled bet ($0.05) returned to llosjone
llosjone collected $0.10 from pot
llosjone: doesn't show hand 
*** SUMMARY ***
Total pot $0.10 | Rake $0 
Seat 1: senej (small blind) folded before Flop
Seat 3: llosjone (big blind) collected ($0.10)
Seat 4: LigoL folded before Flop (didn't bet)
Seat 5: fionn97 folded before Flop (didn't bet)
Seat 6: IrdinTo16 (button) folded before Flop (didn't bet)



PokerStars Hand #222961583886:  Hold'em No Limit ($0.05/$0.10 USD) - 2021/01/23 12:36:44 ET
Table 'Shura III' 6-max Seat #1 is the button
Seat 1: senej ($11.62 in chips) 
Seat 3: llosjone ($10.05 in chips) 
Seat 4: LigoL ($19.04 in chips) 
Seat 5: fionn97 ($4.65 in chips) 
Seat 6: IrdinTo16 ($10 in chips) 
llosjone: posts small blind $0.05
LigoL: posts big blind $0.10
*** HOLE CARDS ***
fionn97: folds 
IrdinTo16: folds 
senej: raises $0.20 to $0.30
llosjone: folds 
LigoL: calls $0.20
*** FLOP *** [5h Jh Jc]
LigoL: checks 
senej: bets $0.41
LigoL: folds 
Uncalled bet ($0.41) returned to senej
senej collected $0.62 from pot
senej: doesn't show hand 
*** SUMMARY ***
Total pot $0.65 | Rake $0.03 
Board [5h Jh Jc]
Seat 1: senej (button) collected ($0.62)
Seat 3: llosjone (small blind) folded before Flop
Seat 4: LigoL (big blind) folded on the Flop
Seat 5: fionn97 folded before Flop (didn't bet)
Seat 6: IrdinTo16 folded before Flop (didn't bet)



PokerStars Hand #222961612910:  Hold'em No Limit ($0.05/$0.10 USD) - 2021/01/23 12:37:28 ET
Table 'Shura III' 6-max Seat #3 is the button
Seat 1: senej ($11.94 in chips) 
Seat 3: llosjone ($10 in chips) 
Seat 4: LigoL ($18.74 in chips) 
Seat 5: fionn97 ($4.65 in chips) 
Seat 6: IrdinTo16 ($10 in chips) 
LigoL: posts small blind $0.05
fionn97: posts big blind $0.10
*** HOLE CARDS ***
IrdinTo16: folds 
senej: raises $0.20 to $0.30
llosjone: calls $0.30
LigoL: folds 
fionn97: calls $0.20
*** FLOP *** [4h Jh 8s]
fionn97: bets $0.30
senej: raises $1.01 to $1.31
llosjone: folds 
fionn97: raises $3.04 to $4.35 and is all-in
senej: calls $3.04
*** TURN *** [4h Jh 8s] [Qc]
*** RIVER *** [4h Jh 8s Qc] [8d]
*** SHOW DOWN ***
fionn97: shows [5s Js] (two pair, Jacks and Eights)
senej: shows [5h 6h] (a pair of Eights)
fionn97 collected $9.22 from pot
*** SUMMARY ***
Total pot $9.65 | Rake $0.43 
Board [4h Jh 8s Qc 8d]
Seat 1: senej showed [5h 6h] and lost with a pair of Eights
Seat 3: llosjone (button) folded on the Flop
Seat 4: LigoL (small blind) folded before Flop
Seat 5: fionn97 (big blind) showed [5s Js] and won ($9.22) with two pair, Jacks and Eights
Seat 6: IrdinTo16 folded before Flop (didn't bet)



PokerStars Hand #222961642948:  Hold'em No Limit ($0.05/$0.10 USD) - 2021/01/23 12:38:13 ET
Table 'Shura III' 6-max Seat #4 is the button
Seat 1: senej ($10 in chips) 
Seat 3: llosjone ($9.70 in chips) 
Seat 4: LigoL ($18.69 in chips) 
Seat 5: fionn97 ($9.22 in chips) 
Seat 6: IrdinTo16 ($10 in chips) 
fionn97: posts small blind $0.05
IrdinTo16: posts big blind $0.10
*** HOLE CARDS ***
senej: folds 
llosjone: folds 
LigoL: raises $0.15 to $0.25
fionn97: folds 
IrdinTo16: folds 
Uncalled bet ($0.15) returned to LigoL
LigoL collected $0.25 from pot
LigoL: doesn't show hand 
*** SUMMARY ***
Total pot $0.25 | Rake $0 
Seat 1: senej folded before Flop (didn't bet)
Seat 3: llosjone folded before Flop (didn't bet)
Seat 4: LigoL (button) collected ($0.25)
Seat 5: fionn97 (small blind) folded before Flop
Seat 6: IrdinTo16 (big blind) folded before Flop



PokerStars Hand #222961660011:  Hold'em No Limit ($0.05/$0.10 USD) - 2021/01/23 12:38:38 ET
Table 'Shura III' 6-max Seat #5 is the button
Seat 1: senej ($10 in chips) 
Seat 3: llosjone ($9.70 in chips) 
Seat 4: LigoL ($18.84 in chips) 
Seat 5: fionn97 ($9.17 in chips) 
Seat 6: IrdinTo16 ($10 in chips) 
IrdinTo16: posts small blind $0.05
senej: posts big blind $0.10
D9_nvkz: sits out 
*** HOLE CARDS ***
llosjone: folds 
LigoL: folds 
fionn97: calls $0.10
IrdinTo16: folds 
senej: checks 
*** FLOP *** [9h 3s 8h]
senej: bets $0.16
fionn97: calls $0.16
*** TURN *** [9h 3s 8h] [Jd]
senej: bets $0.36
fionn97: folds 
Uncalled bet ($0.36) returned to senej
senej collected $0.54 from pot
senej: doesn't show hand 
*** SUMMARY ***
Total pot $0.57 | Rake $0.03 
Board [9h 3s 8h Jd]
Seat 1: senej (big blind) collected ($0.54)
Seat 3: llosjone folded before Flop (didn't bet)
Seat 4: LigoL folded before Flop (didn't bet)
Seat 5: fionn97 (button) folded on the Turn
Seat 6: IrdinTo16 (small blind) folded before Flop



PokerStars Hand #222961682067:  Hold'em No Limit ($0.05/$0.10 USD) - 2021/01/23 12:39:11 ET
Table 'Shura III' 6-max Seat #6 is the button
Seat 1: senej ($10.28 in chips) 
Seat 2: D9_nvkz ($12.87 in chips) 
Seat 3: llosjone ($9.70 in chips) 
Seat 4: LigoL ($18.84 in chips) 
Seat 5: fionn97 ($8.91 in chips) 
Seat 6: IrdinTo16 ($10 in chips) 
senej: posts small blind $0.05
D9_nvkz: posts big blind $0.10
*** HOLE CARDS ***
llosjone: raises $0.15 to $0.25
LigoL: folds 
fionn97: calls $0.25
IrdinTo16: folds 
senej: folds 
D9_nvkz: folds 
*** FLOP *** [6c 4s 9d]
llosjone: checks 
fionn97: checks 
*** TURN *** [6c 4s 9d] [7c]
llosjone: checks 
fionn97: checks 
*** RIVER *** [6c 4s 9d 7c] [Kh]
llosjone: bets $0.20
fionn97: raises $0.20 to $0.40
llosjone: calls $0.20
*** SHOW DOWN ***
fionn97: shows [Ah Ts] (high card Ace)
llosjone: shows [Kc Qs] (a pair of Kings)
llosjone collected $1.38 from pot
*** SUMMARY ***
Total pot $1.45 | Rake $0.07 
Board [6c 4s 9d 7c Kh]
Seat 1: senej (small blind) folded before Flop
Seat 2: D9_nvkz (big blind) folded before Flop
Seat 3: llosjone showed [Kc Qs] and won ($1.38) with a pair of Kings
Seat 4: LigoL folded before Flop (didn't bet)
Seat 5: fionn97 showed [Ah Ts] and lost with high card Ace
Seat 6: IrdinTo16 (button) folded before Flop (didn't bet)



PokerStars Hand #222961699801:  Hold'em No Limit ($0.05/$0.10 USD) - 2021/01/23 12:39:37 ET
Table 'Shura III' 6-max Seat #1 is the button
Seat 1: senej ($10.23 in chips) 
Seat 2: D9_nvkz ($12.77 in chips) 
Seat 3: llosjone ($10.43 in chips) 
Seat 4: LigoL ($18.84 in chips) 
Seat 5: fionn97 ($8.26 in chips) 
Seat 6: IrdinTo16 ($10 in chips) 
D9_nvkz: posts small blind $0.05
llosjone: posts big blind $0.10
*** HOLE CARDS ***
LigoL: folds 
fionn97: folds 
fionn97 leaves the table
IrdinTo16: raises $0.20 to $0.30
senej: folds 
D9_nvkz: folds 
llosjone: folds 
Uncalled bet ($0.20) returned to IrdinTo16
IrdinTo16 collected $0.25 from pot
IrdinTo16: doesn't show hand 
*** SUMMARY ***
Total pot $0.25 | Rake $0 
Seat 1: senej (button) folded before Flop (didn't bet)
Seat 2: D9_nvkz (small blind) folded before Flop
Seat 3: llosjone (big blind) folded before Flop
Seat 4: LigoL folded before Flop (didn't bet)
Seat 5: fionn97 folded before Flop (didn't bet)
Seat 6: IrdinTo16 collected ($0.25)



PokerStars Hand #222961708523:  Hold'em No Limit ($0.05/$0.10 USD) - 2021/01/23 12:39:50 ET
Table 'Shura III' 6-max Seat #2 is the button
Seat 1: senej ($10.23 in chips) 
Seat 2: D9_nvkz ($12.72 in chips) 
Seat 3: llosjone ($10.33 in chips) 
Seat 4: LigoL ($18.84 in chips) 
Seat 6: IrdinTo16 ($10.15 in chips) 
llosjone: posts small blind $0.05
LigoL: posts big blind $0.10
*** HOLE CARDS ***
IrdinTo16: folds 
senej: raises $0.20 to $0.30
sólyom333 joins the table at seat #5 
D9_nvkz: raises $0.75 to $1.05
llosjone: folds 
LigoL: folds 
senej: folds 
Uncalled bet ($0.75) returned to D9_nvkz
D9_nvkz collected $0.75 from pot
D9_nvkz: doesn't show hand 
*** SUMMARY ***
Total pot $0.75 | Rake $0 
Seat 1: senej folded before Flop
Seat 2: D9_nvkz (button) collected ($0.75)
Seat 3: llosjone (small blind) folded before Flop
Seat 4: LigoL (big blind) folded before Flop
Seat 6: IrdinTo16 folded before Flop (didn't bet)



PokerStars Hand #222961722223:  Hold'em No Limit ($0.05/$0.10 USD) - 2021/01/23 12:40:10 ET
Table 'Shura III' 6-max Seat #3 is the button
Seat 1: senej ($10 in chips) 
Seat 2: D9_nvkz ($13.17 in chips) 
Seat 3: llosjone ($10.28 in chips) 
Seat 4: LigoL ($18.74 in chips) 
Seat 5: sólyom333 ($10 in chips) 
Seat 6: IrdinTo16 ($10.15 in chips) 
LigoL: posts small blind $0.05
sólyom333: posts big blind $0.10
*** HOLE CARDS ***
IrdinTo16: folds 
senej: folds 
D9_nvkz: raises $0.20 to $0.30
llosjone: calls $0.30
LigoL: folds 
sólyom333: folds 
*** FLOP *** [Qh Jc 8s]
D9_nvkz: bets $0.36
llosjone: calls $0.36
*** TURN *** [Qh Jc 8s] [4c]
D9_nvkz: bets $0.70
llosjone: folds 
Uncalled bet ($0.70) returned to D9_nvkz
D9_nvkz collected $1.40 from pot
D9_nvkz: doesn't show hand 
*** SUMMARY ***
Total pot $1.47 | Rake $0.07 
Board [Qh Jc 8s 4c]
Seat 1: senej folded before Flop (didn't bet)
Seat 2: D9_nvkz collected ($1.40)
Seat 3: llosjone (button) folded on the Turn
Seat 4: LigoL (small blind) folded before Flop
Seat 5: sólyom333 (big blind) folded before Flop
Seat 6: IrdinTo16 folded before Flop (didn't bet)



PokerStars Hand #222961748383:  Hold'em No Limit ($0.05/$0.10 USD) - 2021/01/23 12:40:49 ET
Table 'Shura III' 6-max Seat #4 is the button
Seat 1: senej ($10 in chips) 
Seat 2: D9_nvkz ($13.91 in chips) 
Seat 3: llosjone ($9.62 in chips) 
Seat 4: LigoL ($18.69 in chips) 
Seat 5: sólyom333 ($9.90 in chips) 
sólyom333: posts small blind $0.05
IrdinTo16: is sitting out 
senej: posts big blind $0.10
*** HOLE CARDS ***
IrdinTo16 leaves the table
D9_nvkz: folds 
llosjone: folds 
LigoL: raises $0.20 to $0.30
lemurrr2014 joins the table at seat #6 
sólyom333: folds 
senej: folds 
Uncalled bet ($0.20) returned to LigoL
LigoL collected $0.25 from pot
LigoL: doesn't show hand 
*** SUMMARY ***
Total pot $0.25 | Rake $0 
Seat 1: senej (big blind) folded before Flop
Seat 2: D9_nvkz folded before Flop (didn't bet)
Seat 3: llosjone folded before Flop (didn't bet)
Seat 4: LigoL (button) collected ($0.25)
Seat 5: sólyom333 (small blind) folded before Flop



PokerStars Hand #222961763565:  Hold'em No Limit ($0.05/$0.10 USD) - 2021/01/23 12:41:12 ET
Table 'Shura III' 6-max Seat #5 is the button
Seat 1: senej ($10 in chips) 
Seat 2: D9_nvkz ($13.91 in chips) 
Seat 3: llosjone ($9.62 in chips) 
Seat 4: LigoL ($18.84 in chips) 
Seat 5: sólyom333 ($9.85 in chips) 
senej: posts small blind $0.05
D9_nvkz: posts big blind $0.10
*** HOLE CARDS ***
llosjone: folds 
LigoL: folds 
sólyom333: raises $0.12 to $0.22
senej: folds 
D9_nvkz: calls $0.12
*** FLOP *** [Qd 3d Kh]
D9_nvkz: checks 
sólyom333: checks 
*** TURN *** [Qd 3d Kh] [9h]
D9_nvkz: checks 
sólyom333: bets $0.41
D9_nvkz: folds 
Uncalled bet ($0.41) returned to sólyom333
sólyom333 collected $0.47 from pot
sólyom333: doesn't show hand 
*** SUMMARY ***
Total pot $0.49 | Rake $0.02 
Board [Qd 3d Kh 9h]
Seat 1: senej (small blind) folded before Flop
Seat 2: D9_nvkz (big blind) folded on the Turn
Seat 3: llosjone folded before Flop (didn't bet)
Seat 4: LigoL folded before Flop (didn't bet)
Seat 5: sólyom333 (button) collected ($0.47)



PokerStars Hand #222961796824:  Hold'em No Limit ($0.05/$0.10 USD) - 2021/01/23 12:42:01 ET
Table 'Shura III' 6-max Seat #1 is the button
Seat 1: senej ($10 in chips) 
Seat 2: D9_nvkz ($13.69 in chips) 
Seat 3: llosjone ($9.62 in chips) 
Seat 4: LigoL ($18.84 in chips) 
Seat 5: sólyom333 ($10.10 in chips) 
Seat 6: lemurrr2014 ($4 in chips) 
D9_nvkz: posts small blind $0.05
llosjone: posts big blind $0.10
lemurrr2014: posts big blind $0.10
*** HOLE CARDS ***
LigoL: raises $0.36 to $0.46
sólyom333: calls $0.46
lemurrr2014: folds 
senej: folds 
D9_nvkz: folds 
llosjone: folds 
*** FLOP *** [Qd 6d 2s]
LigoL: bets $0.50
sólyom333: raises $0.95 to $1.45
LigoL: raises $2.01 to $3.46
sólyom333: folds 
Uncalled bet ($2.01) returned to LigoL
LigoL collected $3.89 from pot
LigoL: doesn't show hand 
*** SUMMARY ***
Total pot $4.07 | Rake $0.18 
Board [Qd 6d 2s]
Seat 1: senej (button) folded before Flop (didn't bet)
Seat 2: D9_nvkz (small blind) folded before Flop
Seat 3: llosjone (big blind) folded before Flop
Seat 4: LigoL collected ($3.89)
Seat 5: sólyom333 folded on the Flop
Seat 6: lemurrr2014 folded before Flop (didn't bet)



PokerStars Hand #222961840731:  Hold'em No Limit ($0.05/$0.10 USD) - 2021/01/23 12:43:06 ET
Table 'Shura III' 6-max Seat #2 is the button
Seat 1: senej ($10 in chips) 
Seat 2: D9_nvkz ($13.64 in chips) 
Seat 3: llosjone ($9.52 in chips) 
Seat 4: LigoL ($20.82 in chips) 
Seat 5: sólyom333 ($10 in chips) 
Seat 6: lemurrr2014 ($3.90 in chips) 
llosjone: posts small blind $0.05
LigoL: posts big blind $0.10
*** HOLE CARDS ***
sólyom333: folds 
lemurrr2014: folds 
senej: folds 
D9_nvkz: raises $0.20 to $0.30
llosjone: calls $0.25
LigoL: folds 
*** FLOP *** [8s 9c 3c]
llosjone: checks 
D9_nvkz: bets $0.33
llosjone: calls $0.33
*** TURN *** [8s 9c 3c] [4s]
llosjone: checks 
D9_nvkz: checks 
*** RIVER *** [8s 9c 3c 4s] [Ad]
llosjone: checks 
D9_nvkz: checks 
*** SHOW DOWN ***
llosjone: shows [5c Ac] (a pair of Aces)
D9_nvkz: mucks hand 
llosjone collected $1.30 from pot
*** SUMMARY ***
Total pot $1.36 | Rake $0.06 
Board [8s 9c 3c 4s Ad]
Seat 1: senej folded before Flop (didn't bet)
Seat 2: D9_nvkz (button) mucked
Seat 3: llosjone (small blind) showed [5c Ac] and won ($1.30) with a pair of Aces
Seat 4: LigoL (big blind) folded before Flop
Seat 5: sólyom333 folded before Flop (didn't bet)
Seat 6: lemurrr2014 folded before Flop (didn't bet)



PokerStars Hand #222961881269:  Hold'em No Limit ($0.05/$0.10 USD) - 2021/01/23 12:44:06 ET
Table 'Shura III' 6-max Seat #3 is the button
Seat 1: senej ($10 in chips) 
Seat 2: D9_nvkz ($13.01 in chips) 
Seat 3: llosjone ($10.19 in chips) 
Seat 4: LigoL ($20.72 in chips) 
Seat 5: sólyom333 ($10 in chips) 
Seat 6: lemurrr2014 ($3.90 in chips) 
LigoL: posts small blind $0.05
sólyom333: posts big blind $0.10
*** HOLE CARDS ***
lemurrr2014: folds 
senej: folds 
D9_nvkz: raises $0.20 to $0.30
llosjone: calls $0.30
LigoL: folds 
sólyom333: folds 
*** FLOP *** [3h Qh 9s]
D9_nvkz: checks 
llosjone: checks 
*** TURN *** [3h Qh 9s] [3d]
D9_nvkz: checks 
llosjone: checks 
*** RIVER *** [3h Qh 9s 3d] [Th]
D9_nvkz: checks 
llosjone: checks 
*** SHOW DOWN ***
D9_nvkz: shows [6h 6d] (two pair, Sixes and Threes)
llosjone: shows [Kh 9d] (two pair, Nines and Threes)
llosjone collected $0.72 from pot
*** SUMMARY ***
Total pot $0.75 | Rake $0.03 
Board [3h Qh 9s 3d Th]
Seat 1: senej folded before Flop (didn't bet)
Seat 2: D9_nvkz showed [6h 6d] and lost with two pair, Sixes and Threes
Seat 3: llosjone (button) showed [Kh 9d] and won ($0.72) with two pair, Nines and Threes
Seat 4: LigoL (small blind) folded before Flop
Seat 5: sólyom333 (big blind) folded before Flop
Seat 6: lemurrr2014 folded before Flop (didn't bet)



PokerStars Hand #222961907816:  Hold'em No Limit ($0.05/$0.10 USD) - 2021/01/23 12:44:46 ET
Table 'Shura III' 6-max Seat #4 is the button
Seat 1: senej ($10 in chips) 
Seat 2: D9_nvkz ($12.71 in chips) 
Seat 3: llosjone ($10.61 in chips) 
Seat 4: LigoL ($20.67 in chips) 
Seat 5: sólyom333 ($9.90 in chips) 
Seat 6: lemurrr2014 ($3.90 in chips) 
sólyom333: posts small blind $0.05
lemurrr2014: posts big blind $0.10
*** HOLE CARDS ***
senej: folds 
D9_nvkz: raises $0.20 to $0.30
llosjone: folds 
LigoL: folds 
sólyom333: folds 
lemurrr2014: folds 
Uncalled bet ($0.20) returned to D9_nvkz
D9_nvkz collected $0.25 from pot
D9_nvkz: doesn't show hand 
*** SUMMARY ***
Total pot $0.25 | Rake $0 
Seat 1: senej folded before Flop (didn't bet)
Seat 2: D9_nvkz collected ($0.25)
Seat 3: llosjone folded before Flop (didn't bet)
Seat 4: LigoL (button) folded before Flop (didn't bet)
Seat 5: sólyom333 (small blind) folded before Flop
Seat 6: lemurrr2014 (big blind) folded before Flop



PokerStars Hand #222961924518:  Hold'em No Limit ($0.05/$0.10 USD) - 2021/01/23 12:45:10 ET
Table 'Shura III' 6-max Seat #5 is the button
Seat 1: senej ($10 in chips) 
Seat 2: D9_nvkz ($12.86 in chips) 
Seat 3: llosjone ($10.61 in chips) 
Seat 4: LigoL ($20.67 in chips) 
Seat 5: sólyom333 ($9.85 in chips) 
Seat 6: lemurrr2014 ($3.80 in chips) 
lemurrr2014: posts small blind $0.05
senej: posts big blind $0.10
*** HOLE CARDS ***
D9_nvkz: raises $0.20 to $0.30
llosjone: folds 
LigoL: folds 
sólyom333: folds 
lemurrr2014: folds 
senej: folds 
Uncalled bet ($0.20) returned to D9_nvkz
D9_nvkz collected $0.25 from pot
D9_nvkz: doesn't show hand 
*** SUMMARY ***
Total pot $0.25 | Rake $0 
Seat 1: senej (big blind) folded before Flop
Seat 2: D9_nvkz collected ($0.25)
Seat 3: llosjone folded before Flop (didn't bet)
Seat 4: LigoL folded before Flop (didn't bet)
Seat 5: sólyom333 (button) folded before Flop (didn't bet)
Seat 6: lemurrr2014 (small blind) folded before Flop



PokerStars Hand #222961943263:  Hold'em No Limit ($0.05/$0.10 USD) - 2021/01/23 12:45:38 ET
Table 'Shura III' 6-max Seat #6 is the button
Seat 1: senej ($10 in chips) 
Seat 2: D9_nvkz ($13.01 in chips) 
Seat 3: llosjone ($10.61 in chips) 
Seat 4: LigoL ($20.67 in chips) 
Seat 5: sólyom333 ($9.85 in chips) 
Seat 6: lemurrr2014 ($3.75 in chips) 
senej: posts small blind $0.05
D9_nvkz: posts big blind $0.10
*** HOLE CARDS ***
llosjone: raises $0.15 to $0.25
LigoL: folds 
sólyom333: folds 
lemurrr2014: folds 
senej: folds 
D9_nvkz: folds 
Uncalled bet ($0.15) returned to llosjone
llosjone collected $0.25 from pot
llosjone: doesn't show hand 
*** SUMMARY ***
Total pot $0.25 | Rake $0 
Seat 1: senej (small blind) folded before Flop
Seat 2: D9_nvkz (big blind) folded before Flop
Seat 3: llosjone collected ($0.25)
Seat 4: LigoL folded before Flop (didn't bet)
Seat 5: sólyom333 folded before Flop (didn't bet)
Seat 6: lemurrr2014 (button) folded before Flop (didn't bet)



PokerStars Hand #222961953135:  Hold'em No Limit ($0.05/$0.10 USD) - 2021/01/23 12:45:53 ET
Table 'Shura III' 6-max Seat #1 is the button
Seat 1: senej ($10 in chips) 
Seat 2: D9_nvkz ($12.91 in chips) 
Seat 3: llosjone ($10.76 in chips) 
Seat 4: LigoL ($20.67 in chips) 
Seat 5: sólyom333 ($9.85 in chips) 
Seat 6: lemurrr2014 ($3.75 in chips) 
D9_nvkz: posts small blind $0.05
llosjone: posts big blind $0.10
*** HOLE CARDS ***
LigoL: folds 
sólyom333: folds 
lemurrr2014: folds 
senej: folds 
D9_nvkz: folds 
Uncalled bet ($0.05) returned to llosjone
llosjone collected $0.10 from pot
llosjone: doesn't show hand 
*** SUMMARY ***
Total pot $0.10 | Rake $0 
Seat 1: senej (button) folded before Flop (didn't bet)
Seat 2: D9_nvkz (small blind) folded before Flop
Seat 3: llosjone (big blind) collected ($0.10)
Seat 4: LigoL folded before Flop (didn't bet)
Seat 5: sólyom333 folded before Flop (didn't bet)
Seat 6: lemurrr2014 folded before Flop (didn't bet)



PokerStars Hand #222961962447:  Hold'em No Limit ($0.05/$0.10 USD) - 2021/01/23 12:46:07 ET
Table 'Shura III' 6-max Seat #2 is the button
Seat 1: senej ($10 in chips) 
Seat 2: D9_nvkz ($12.86 in chips) 
Seat 3: llosjone ($10.81 in chips) 
Seat 4: LigoL ($20.67 in chips) 
Seat 5: sólyom333 ($9.85 in chips) 
Seat 6: lemurrr2014 ($3.75 in chips) 
llosjone: posts small blind $0.05
LigoL: posts big blind $0.10
*** HOLE CARDS ***
sólyom333: folds 
lemurrr2014: folds 
senej: folds 
D9_nvkz: folds 
llosjone: folds 
Uncalled bet ($0.05) returned to LigoL
llosjone leaves the table
LigoL collected $0.10 from pot
LigoL: doesn't show hand 
*** SUMMARY ***
Total pot $0.10 | Rake $0 
Seat 1: senej folded before Flop (didn't bet)
Seat 2: D9_nvkz (button) folded before Flop (didn't bet)
Seat 3: llosjone (small blind) folded before Flop
Seat 4: LigoL (big blind) collected ($0.10)
Seat 5: sólyom333 folded before Flop (didn't bet)
Seat 6: lemurrr2014 folded before Flop (didn't bet)



PokerStars Hand #222961967887:  Hold'em No Limit ($0.05/$0.10 USD) - 2021/01/23 12:46:15 ET
Table 'Shura III' 6-max Seat #4 is the button
Seat 1: senej ($10 in chips) 
Seat 2: D9_nvkz ($12.86 in chips) 
Seat 4: LigoL ($20.72 in chips) 
Seat 5: sólyom333 ($9.85 in chips) 
Seat 6: lemurrr2014 ($3.75 in chips) 
sólyom333: posts small blind $0.05
lemurrr2014: posts big blind $0.10
*** HOLE CARDS ***
senej: folds 
D9_nvkz: folds 
LigoL: raises $0.20 to $0.30
sólyom333: folds 
lemurrr2014: folds 
Uncalled bet ($0.20) returned to LigoL
LigoL collected $0.25 from pot
LigoL: doesn't show hand 
*** SUMMARY ***
Total pot $0.25 | Rake $0 
Seat 1: senej folded before Flop (didn't bet)
Seat 2: D9_nvkz folded before Flop (didn't bet)
Seat 4: LigoL (button) collected ($0.25)
Seat 5: sólyom333 (small blind) folded before Flop
Seat 6: lemurrr2014 (big blind) folded before Flop



PokerStars Hand #222961994998:  Hold'em No Limit ($0.05/$0.10 USD) - 2021/01/23 12:46:55 ET
Table 'Shura III' 6-max Seat #5 is the button
Seat 1: senej ($10 in chips) 
Seat 2: D9_nvkz ($12.86 in chips) 
Seat 4: LigoL ($20.87 in chips) 
Seat 5: sólyom333 ($9.80 in chips) 
Seat 6: lemurrr2014 ($3.65 in chips) 
lemurrr2014: posts small blind $0.05
senej: posts big blind $0.10
*** HOLE CARDS ***
D9_nvkz: raises $0.20 to $0.30
LigoL: folds 
sólyom333: folds 
lemurrr2014: folds 
senej: calls $0.20
*** FLOP *** [Jc 5d 8d]
senej: checks 
D9_nvkz: bets $0.41
senej: raises $1.19 to $1.60
RN152 joins the table at seat #3 
RN152 leaves the table
evansr96 joins the table at seat #3 
D9_nvkz: raises $3.82 to $5.42
senej: raises $4.28 to $9.70 and is all-in
D9_nvkz: calls $4.28
evansr96 leaves the table
*** TURN *** [Jc 5d 8d] [Ts]
*** RIVER *** [Jc 5d 8d Ts] [4c]
*** SHOW DOWN ***
senej: shows [8h 8c] (three of a kind, Eights)
D9_nvkz: shows [Qs Qh] (a pair of Queens)
senej collected $19.15 from pot
*** SUMMARY ***
Total pot $20.05 | Rake $0.90 
Board [Jc 5d 8d Ts 4c]
Seat 1: senej (big blind) showed [8h 8c] and won ($19.15) with three of a kind, Eights
Seat 2: D9_nvkz showed [Qs Qh] and lost with a pair of Queens
Seat 4: LigoL folded before Flop (didn't bet)
Seat 5: sólyom333 (button) folded before Flop (didn't bet)
Seat 6: lemurrr2014 (small blind) folded before Flop



PokerStars Hand #222962035695:  Hold'em No Limit ($0.05/$0.10 USD) - 2021/01/23 12:47:55 ET
Table 'Shura III' 6-max Seat #6 is the button
Seat 1: senej ($19.15 in chips) 
Seat 2: D9_nvkz ($10 in chips) 
Seat 4: LigoL ($20.87 in chips) 
Seat 5: sólyom333 ($9.80 in chips) 
Seat 6: lemurrr2014 ($3.60 in chips) 
senej: posts small blind $0.05
D9_nvkz: posts big blind $0.10
*** HOLE CARDS ***
LigoL: folds 
sólyom333: raises $0.18 to $0.28
G oet Mestreech joins the table at seat #3 
lemurrr2014: calls $0.28
senej: folds 
D9_nvkz: calls $0.18
*** FLOP *** [5h 2s Ah]
D9_nvkz: checks 
sólyom333: checks 
lemurrr2014: checks 
*** TURN *** [5h 2s Ah] [9s]
D9_nvkz: bets $0.52
sólyom333: calls $0.52
lemurrr2014: folds 
*** RIVER *** [5h 2s Ah 9s] [Ts]
D9_nvkz: checks 
sólyom333: bets $1.23
D9_nvkz: calls $1.23
*** SHOW DOWN ***
sólyom333: shows [6s 7s] (a flush, Ten high)
D9_nvkz: mucks hand 
sólyom333 collected $4.19 from pot
*** SUMMARY ***
Total pot $4.39 | Rake $0.20 
Board [5h 2s Ah 9s Ts]
Seat 1: senej (small blind) folded before Flop
Seat 2: D9_nvkz (big blind) mucked
Seat 4: LigoL folded before Flop (didn't bet)
Seat 5: sólyom333 showed [6s 7s] and won ($4.19) with a flush, Ten high
Seat 6: lemurrr2014 (button) folded on the Turn



PokerStars Hand #222962068233:  Hold'em No Limit ($0.05/$0.10 USD) - 2021/01/23 12:48:44 ET
Table 'Shura III' 6-max Seat #1 is the button
Seat 1: senej ($19.10 in chips) 
Seat 2: D9_nvkz ($10 in chips) 
Seat 3: G oet Mestreech ($10 in chips) 
Seat 4: LigoL ($20.87 in chips) 
Seat 5: sólyom333 ($11.96 in chips) 
Seat 6: lemurrr2014 ($3.32 in chips) 
D9_nvkz: posts small blind $0.05
G oet Mestreech: posts big blind $0.10
*** HOLE CARDS ***
LigoL: raises $0.20 to $0.30
sólyom333: folds 
lemurrr2014: folds 
senej: folds 
D9_nvkz: folds 
G oet Mestreech: folds 
Uncalled bet ($0.20) returned to LigoL
LigoL collected $0.25 from pot
LigoL: doesn't show hand 
*** SUMMARY ***
Total pot $0.25 | Rake $0 
Seat 1: senej (button) folded before Flop (didn't bet)
Seat 2: D9_nvkz (small blind) folded before Flop
Seat 3: G oet Mestreech (big blind) folded before Flop
Seat 4: LigoL collected ($0.25)
Seat 5: sólyom333 folded before Flop (didn't bet)
Seat 6: lemurrr2014 folded before Flop (didn't bet)



PokerStars Hand #222962075840:  Hold'em No Limit ($0.05/$0.10 USD) - 2021/01/23 12:48:55 ET
Table 'Shura III' 6-max Seat #2 is the button
Seat 1: senej ($19.10 in chips) 
Seat 2: D9_nvkz ($10 in chips) 
Seat 3: G oet Mestreech ($9.90 in chips) 
Seat 4: LigoL ($21.02 in chips) 
Seat 5: sólyom333 ($11.96 in chips) 
Seat 6: lemurrr2014 ($3.32 in chips) 
G oet Mestreech: posts small blind $0.05
LigoL: posts big blind $0.10
*** HOLE CARDS ***
sólyom333: folds 
lemurrr2014: folds 
senej: folds 
D9_nvkz: raises $0.20 to $0.30
G oet Mestreech: calls $0.25
LigoL: raises $1.15 to $1.45
D9_nvkz: folds 
G oet Mestreech: calls $1.15
*** FLOP *** [Kd Tc Jh]
G oet Mestreech: checks 
LigoL: bets $1.40
G oet Mestreech: folds 
Uncalled bet ($1.40) returned to LigoL
LigoL collected $3.06 from pot
LigoL: doesn't show hand 
*** SUMMARY ***
Total pot $3.20 | Rake $0.14 
Board [Kd Tc Jh]
Seat 1: senej folded before Flop (didn't bet)
Seat 2: D9_nvkz (button) folded before Flop
Seat 3: G oet Mestreech (small blind) folded on the Flop
Seat 4: LigoL (big blind) collected ($3.06)
Seat 5: sólyom333 folded before Flop (didn't bet)
Seat 6: lemurrr2014 folded before Flop (didn't bet)



PokerStars Hand #222962100508:  Hold'em No Limit ($0.05/$0.10 USD) - 2021/01/23 12:49:31 ET
Table 'Shura III' 6-max Seat #3 is the button
Seat 1: senej ($19.10 in chips) 
Seat 2: D9_nvkz ($10 in chips) 
Seat 3: G oet Mestreech ($8.45 in chips) 
Seat 4: LigoL ($22.63 in chips) 
Seat 5: sólyom333 ($11.96 in chips) 
Seat 6: lemurrr2014 ($3.32 in chips) 
LigoL: posts small blind $0.05
sólyom333: posts big blind $0.10
*** HOLE CARDS ***
lemurrr2014: folds 
senej: folds 
D9_nvkz: raises $0.20 to $0.30
G oet Mestreech: folds 
LigoL: folds 
sólyom333: folds 
Uncalled bet ($0.20) returned to D9_nvkz
D9_nvkz collected $0.25 from pot
D9_nvkz: doesn't show hand 
*** SUMMARY ***
Total pot $0.25 | Rake $0 
Seat 1: senej folded before Flop (didn't bet)
Seat 2: D9_nvkz collected ($0.25)
Seat 3: G oet Mestreech (button) folded before Flop (didn't bet)
Seat 4: LigoL (small blind) folded before Flop
Seat 5: sólyom333 (big blind) folded before Flop
Seat 6: lemurrr2014 folded before Flop (didn't bet)



PokerStars Hand #222962111964:  Hold'em No Limit ($0.05/$0.10 USD) - 2021/01/23 12:49:48 ET
Table 'Shura III' 6-max Seat #4 is the button
Seat 1: senej ($19.10 in chips) 
Seat 2: D9_nvkz ($10.15 in chips) 
Seat 3: G oet Mestreech ($8.45 in chips) 
Seat 4: LigoL ($22.58 in chips) 
Seat 5: sólyom333 ($11.86 in chips) 
Seat 6: lemurrr2014 ($3.32 in chips) 
sólyom333: posts small blind $0.05
lemurrr2014: posts big blind $0.10
*** HOLE CARDS ***
senej: raises $0.20 to $0.30
D9_nvkz: folds 
G oet Mestreech: folds 
LigoL: folds 
sólyom333: folds 
lemurrr2014: folds 
Uncalled bet ($0.20) returned to senej
senej collected $0.25 from pot
senej: doesn't show hand 
*** SUMMARY ***
Total pot $0.25 | Rake $0 
Seat 1: senej collected ($0.25)
Seat 2: D9_nvkz folded before Flop (didn't bet)
Seat 3: G oet Mestreech folded before Flop (didn't bet)
Seat 4: LigoL (button) folded before Flop (didn't bet)
Seat 5: sólyom333 (small blind) folded before Flop
Seat 6: lemurrr2014 (big blind) folded before Flop



PokerStars Hand #222962129262:  Hold'em No Limit ($0.05/$0.10 USD) - 2021/01/23 12:50:14 ET
Table 'Shura III' 6-max Seat #5 is the button
Seat 1: senej ($19.25 in chips) 
Seat 2: D9_nvkz ($10.15 in chips) 
Seat 3: G oet Mestreech ($8.45 in chips) 
Seat 4: LigoL ($22.58 in chips) 
Seat 5: sólyom333 ($11.81 in chips) 
Seat 6: lemurrr2014 ($3.22 in chips) 
lemurrr2014: posts small blind $0.05
senej: posts big blind $0.10
*** HOLE CARDS ***
D9_nvkz: raises $0.20 to $0.30
G oet Mestreech: calls $0.30
LigoL: folds 
sólyom333: folds 
lemurrr2014: calls $0.25
senej: folds 
*** FLOP *** [9s Ac Ks]
lemurrr2014: checks 
D9_nvkz: checks 
G oet Mestreech: checks 
*** TURN *** [9s Ac Ks] [Th]
lemurrr2014: bets $0.48
D9_nvkz: folds 
G oet Mestreech: calls $0.48
*** RIVER *** [9s Ac Ks Th] [5h]
lemurrr2014: bets $0.93
G oet Mestreech: folds 
Uncalled bet ($0.93) returned to lemurrr2014
lemurrr2014 collected $1.87 from pot
lemurrr2014: doesn't show hand 
*** SUMMARY ***
Total pot $1.96 | Rake $0.09 
Board [9s Ac Ks Th 5h]
Seat 1: senej (big blind) folded before Flop
Seat 2: D9_nvkz folded on the Turn
Seat 3: G oet Mestreech folded on the River
Seat 4: LigoL folded before Flop (didn't bet)
Seat 5: sólyom333 (button) folded before Flop (didn't bet)
Seat 6: lemurrr2014 (small blind) collected ($1.87)



PokerStars Hand #222962161991:  Hold'em No Limit ($0.05/$0.10 USD) - 2021/01/23 12:51:02 ET
Table 'Shura III' 6-max Seat #6 is the button
Seat 1: senej ($19.15 in chips) 
Seat 2: D9_nvkz ($10 in chips) 
Seat 3: G oet Mestreech ($7.67 in chips) 
Seat 4: LigoL ($22.58 in chips) 
Seat 5: sólyom333 ($11.81 in chips) 
Seat 6: lemurrr2014 ($4.31 in chips) 
senej: posts small blind $0.05
D9_nvkz: posts big blind $0.10
*** HOLE CARDS ***
G oet Mestreech: folds 
LigoL: folds 
sólyom333: folds 
lemurrr2014: calls $0.10
senej: folds 
D9_nvkz: checks 
*** FLOP *** [Qd 8d Ac]
D9_nvkz: checks 
lemurrr2014: checks 
*** TURN *** [Qd 8d Ac] [3d]
D9_nvkz: checks 
lemurrr2014: checks 
*** RIVER *** [Qd 8d Ac 3d] [Js]
D9_nvkz: checks 
lemurrr2014: checks 
*** SHOW DOWN ***
D9_nvkz: shows [6c 2h] (high card Ace)
lemurrr2014: shows [Kc 9c] (high card Ace - King kicker)
lemurrr2014 collected $0.24 from pot
*** SUMMARY ***
Total pot $0.25 | Rake $0.01 
Board [Qd 8d Ac 3d Js]
Seat 1: senej (small blind) folded before Flop
Seat 2: D9_nvkz (big blind) showed [6c 2h] and lost with high card Ace
Seat 3: G oet Mestreech folded before Flop (didn't bet)
Seat 4: LigoL folded before Flop (didn't bet)
Seat 5: sólyom333 folded before Flop (didn't bet)
Seat 6: lemurrr2014 (button) showed [Kc 9c] and won ($0.24) with high card Ace



PokerStars Hand #222962188192:  Hold'em No Limit ($0.05/$0.10 USD) - 2021/01/23 12:51:41 ET
Table 'Shura III' 6-max Seat #1 is the button
Seat 1: senej ($19.10 in chips) 
Seat 2: D9_nvkz ($10 in chips) 
Seat 3: G oet Mestreech ($7.67 in chips) 
Seat 4: LigoL ($22.58 in chips) 
Seat 5: sólyom333 ($11.81 in chips) 
Seat 6: lemurrr2014 ($4.45 in chips) 
D9_nvkz: posts small blind $0.05
G oet Mestreech: posts big blind $0.10
*** HOLE CARDS ***
LigoL: raises $0.20 to $0.30
sólyom333: raises $0.58 to $0.88
lemurrr2014: folds 
senej: folds 
D9_nvkz: folds 
G oet Mestreech: folds 
LigoL: calls $0.58
*** FLOP *** [Qc 8c 3d]
LigoL: checks 
sólyom333: bets $0.76
LigoL: calls $0.76
*** TURN *** [Qc 8c 3d] [Kd]
LigoL: checks 
sólyom333: bets $2.19
LigoL: folds 
Uncalled bet ($2.19) returned to sólyom333
sólyom333 collected $3.28 from pot
sólyom333: doesn't show hand 
*** SUMMARY ***
Total pot $3.43 | Rake $0.15 
Board [Qc 8c 3d Kd]
Seat 1: senej (button) folded before Flop (didn't bet)
Seat 2: D9_nvkz (small blind) folded before Flop
Seat 3: G oet Mestreech (big blind) folded before Flop
Seat 4: LigoL folded on the Turn
Seat 5: sólyom333 collected ($3.28)
Seat 6: lemurrr2014 folded before Flop (didn't bet)



PokerStars Hand #222962221459:  Hold'em No Limit ($0.05/$0.10 USD) - 2021/01/23 12:52:30 ET
Table 'Shura III' 6-max Seat #2 is the button
Seat 1: senej ($19.10 in chips) 
Seat 2: D9_nvkz ($10 in chips) 
Seat 3: G oet Mestreech ($7.57 in chips) 
Seat 4: LigoL ($20.94 in chips) 
Seat 5: sólyom333 ($13.45 in chips) 
Seat 6: lemurrr2014 ($4.45 in chips) 
G oet Mestreech: posts small blind $0.05
LigoL: posts big blind $0.10
*** HOLE CARDS ***
sólyom333: folds 
lemurrr2014: folds 
senej: folds 
D9_nvkz: raises $0.20 to $0.30
G oet Mestreech: calls $0.25
LigoL: folds 
*** FLOP *** [4d 7s Js]
G oet Mestreech: checks 
D9_nvkz: bets $0.33
G oet Mestreech: calls $0.33
*** TURN *** [4d 7s Js] [5c]
G oet Mestreech: checks 
D9_nvkz: checks 
*** RIVER *** [4d 7s Js 5c] [2h]
G oet Mestreech: bets $0.65
D9_nvkz: raises $2.60 to $3.25
G oet Mestreech: folds 
Uncalled bet ($2.60) returned to D9_nvkz
D9_nvkz collected $2.54 from pot
D9_nvkz: doesn't show hand 
*** SUMMARY ***
Total pot $2.66 | Rake $0.12 
Board [4d 7s Js 5c 2h]
Seat 1: senej folded before Flop (didn't bet)
Seat 2: D9_nvkz (button) collected ($2.54)
Seat 3: G oet Mestreech (small blind) folded on the River
Seat 4: LigoL (big blind) folded before Flop
Seat 5: sólyom333 folded before Flop (didn't bet)
Seat 6: lemurrr2014 folded before Flop (didn't bet)



PokerStars Hand #222962261998:  Hold'em No Limit ($0.05/$0.10 USD) - 2021/01/23 12:53:21 ET
Table 'Shura III' 6-max Seat #3 is the button
Seat 1: senej ($19.10 in chips) 
Seat 2: D9_nvkz ($11.26 in chips) 
Seat 3: G oet Mestreech ($6.29 in chips) 
Seat 4: LigoL ($20.84 in chips) 
Seat 5: sólyom333 ($13.45 in chips) 
Seat 6: lemurrr2014 ($4.45 in chips) 
LigoL: posts small blind $0.05
sólyom333: posts big blind $0.10
*** HOLE CARDS ***
lemurrr2014: calls $0.10
senej: folds 
D9_nvkz: folds 
G oet Mestreech: raises $0.20 to $0.30
LigoL: folds 
sólyom333: folds 
lemurrr2014: calls $0.20
*** FLOP *** [Jd 7h Kd]
lemurrr2014: checks 
G oet Mestreech: checks 
*** TURN *** [Jd 7h Kd] [6d]
lemurrr2014: checks 
G oet Mestreech: checks 
*** RIVER *** [Jd 7h Kd 6d] [8c]
lemurrr2014: checks 
G oet Mestreech: checks 
*** SHOW DOWN ***
lemurrr2014: shows [Ac 4c] (high card Ace)
G oet Mestreech: shows [5s Ah] (high card Ace)
lemurrr2014 collected $0.36 from pot
G oet Mestreech collected $0.36 from pot
*** SUMMARY ***
Total pot $0.75 | Rake $0.03 
Board [Jd 7h Kd 6d 8c]
Seat 1: senej folded before Flop (didn't bet)
Seat 2: D9_nvkz folded before Flop (didn't bet)
Seat 3: G oet Mestreech (button) showed [5s Ah] and won ($0.36) with high card Ace
Seat 4: LigoL (small blind) folded before Flop
Seat 5: sólyom333 (big blind) folded before Flop
Seat 6: lemurrr2014 showed [Ac 4c] and won ($0.36) with high card Ace



PokerStars Hand #222962282873:  Hold'em No Limit ($0.05/$0.10 USD) - 2021/01/23 12:53:52 ET
Table 'Shura III' 6-max Seat #4 is the button
Seat 1: senej ($19.10 in chips) 
Seat 2: D9_nvkz ($11.26 in chips) 
Seat 3: G oet Mestreech ($6.35 in chips) 
Seat 4: LigoL ($20.79 in chips) 
Seat 5: sólyom333 ($13.35 in chips) 
Seat 6: lemurrr2014 ($4.51 in chips) 
sólyom333: posts small blind $0.05
lemurrr2014: posts big blind $0.10
*** HOLE CARDS ***
senej: raises $0.20 to $0.30
D9_nvkz: folds 
G oet Mestreech: calls $0.30
LigoL: folds 
sólyom333: folds 
lemurrr2014: folds 
*** FLOP *** [Ah Qh 9h]
senej: checks 
G oet Mestreech: checks 
*** TURN *** [Ah Qh 9h] [5d]
senej: bets $0.35
G oet Mestreech: calls $0.35
*** RIVER *** [Ah Qh 9h 5d] [6d]
senej: bets $0.75
G oet Mestreech: calls $0.75
*** SHOW DOWN ***
senej: shows [Qd Kc] (a pair of Queens)
G oet Mestreech: shows [Qs 5c] (two pair, Queens and Fives)
G oet Mestreech collected $2.82 from pot
*** SUMMARY ***
Total pot $2.95 | Rake $0.13 
Board [Ah Qh 9h 5d 6d]
Seat 1: senej showed [Qd Kc] and lost with a pair of Queens
Seat 2: D9_nvkz folded before Flop (didn't bet)
Seat 3: G oet Mestreech showed [Qs 5c] and won ($2.82) with two pair, Queens and Fives
Seat 4: LigoL (button) folded before Flop (didn't bet)
Seat 5: sólyom333 (small blind) folded before Flop
Seat 6: lemurrr2014 (big blind) folded before Flop



PokerStars Hand #222962313547:  Hold'em No Limit ($0.05/$0.10 USD) - 2021/01/23 12:54:38 ET
Table 'Shura III' 6-max Seat #5 is the button
Seat 1: senej ($17.70 in chips) 
Seat 2: D9_nvkz ($11.26 in chips) 
Seat 3: G oet Mestreech ($7.77 in chips) 
Seat 4: LigoL ($20.79 in chips) 
Seat 5: sólyom333 ($13.30 in chips) 
Seat 6: lemurrr2014 ($4.41 in chips) 
lemurrr2014: posts small blind $0.05
senej: posts big blind $0.10
*** HOLE CARDS ***
D9_nvkz: raises $0.20 to $0.30
G oet Mestreech: folds 
LigoL: folds 
sólyom333: folds 
lemurrr2014: folds 
senej: calls $0.20
*** FLOP *** [2d Ad 9h]
senej: checks 
D9_nvkz: bets $0.41
senej: folds 
Uncalled bet ($0.41) returned to D9_nvkz
D9_nvkz collected $0.62 from pot
D9_nvkz: doesn't show hand 
*** SUMMARY ***
Total pot $0.65 | Rake $0.03 
Board [2d Ad 9h]
Seat 1: senej (big blind) folded on the Flop
Seat 2: D9_nvkz collected ($0.62)
Seat 3: G oet Mestreech folded before Flop (didn't bet)
Seat 4: LigoL folded before Flop (didn't bet)
Seat 5: sólyom333 (button) folded before Flop (didn't bet)
Seat 6: lemurrr2014 (small blind) folded before Flop



PokerStars Hand #222962335675:  Hold'em No Limit ($0.05/$0.10 USD) - 2021/01/23 12:55:12 ET
Table 'Shura III' 6-max Seat #6 is the button
Seat 1: senej ($17.40 in chips) 
Seat 2: D9_nvkz ($11.58 in chips) 
Seat 3: G oet Mestreech ($7.77 in chips) 
Seat 4: LigoL ($20.79 in chips) 
Seat 5: sólyom333 ($13.30 in chips) 
Seat 6: lemurrr2014 ($4.36 in chips) 
senej: posts small blind $0.05
D9_nvkz: posts big blind $0.10
*** HOLE CARDS ***
G oet Mestreech: folds 
LigoL: folds 
sólyom333: raises $0.18 to $0.28
lemurrr2014: folds 
senej: folds 
D9_nvkz: folds 
Uncalled bet ($0.18) returned to sólyom333
sólyom333 collected $0.25 from pot
sólyom333: doesn't show hand 
*** SUMMARY ***
Total pot $0.25 | Rake $0 
Seat 1: senej (small blind) folded before Flop
Seat 2: D9_nvkz (big blind) folded before Flop
Seat 3: G oet Mestreech folded before Flop (didn't bet)
Seat 4: LigoL folded before Flop (didn't bet)
Seat 5: sólyom333 collected ($0.25)
Seat 6: lemurrr2014 (button) folded before Flop (didn't bet)



PokerStars Hand #222962340983:  Hold'em No Limit ($0.05/$0.10 USD) - 2021/01/23 12:55:22 ET
Table 'Shura III' 6-max Seat #1 is the button
Seat 1: senej ($17.35 in chips) 
Seat 2: D9_nvkz ($11.48 in chips) 
Seat 3: G oet Mestreech ($7.77 in chips) 
Seat 4: LigoL ($20.79 in chips) 
Seat 5: sólyom333 ($13.45 in chips) 
Seat 6: lemurrr2014 ($4.36 in chips) 
D9_nvkz: posts small blind $0.05
G oet Mestreech: posts big blind $0.10
*** HOLE CARDS ***
LigoL: folds 
sólyom333: folds 
lemurrr2014: calls $0.10
senej: raises $0.35 to $0.45
D9_nvkz: folds 
G oet Mestreech: folds 
lemurrr2014: calls $0.35
*** FLOP *** [7h 2h Kh]
lemurrr2014: checks 
senej: bets $0.55
lemurrr2014: calls $0.55
*** TURN *** [7h 2h Kh] [2c]
lemurrr2014: checks 
senej: checks 
*** RIVER *** [7h 2h Kh 2c] [Ad]
lemurrr2014: bets $3.36 and is all-in
senej: calls $3.36
*** SHOW DOWN ***
lemurrr2014: shows [Qs Jh] (a pair of Deuces)
senej: shows [Td Ac] (two pair, Aces and Deuces)
senej collected $8.47 from pot
*** SUMMARY ***
Total pot $8.87 | Rake $0.40 
Board [7h 2h Kh 2c Ad]
Seat 1: senej (button) showed [Td Ac] and won ($8.47) with two pair, Aces and Deuces
Seat 2: D9_nvkz (small blind) folded before Flop
Seat 3: G oet Mestreech (big blind) folded before Flop
Seat 4: LigoL folded before Flop (didn't bet)
Seat 5: sólyom333 folded before Flop (didn't bet)
Seat 6: lemurrr2014 showed [Qs Jh] and lost with a pair of Deuces



PokerStars Hand #222962363162:  Hold'em No Limit ($0.05/$0.10 USD) - 2021/01/23 12:56:07 ET
Table 'Shura III' 6-max Seat #2 is the button
Seat 1: senej ($21.46 in chips) 
Seat 2: D9_nvkz ($11.43 in chips) 
Seat 3: G oet Mestreech ($7.67 in chips) 
Seat 4: LigoL ($20.79 in chips) 
Seat 5: sólyom333 ($13.45 in chips) 
G oet Mestreech: posts small blind $0.05
LigoL: posts big blind $0.10
*** HOLE CARDS ***
sólyom333: raises $0.18 to $0.28
senej: folds 
D9_nvkz: raises $0.81 to $1.09
G oet Mestreech: folds 
LigoL: folds 
sólyom333: folds 
Uncalled bet ($0.81) returned to D9_nvkz
D9_nvkz collected $0.71 from pot
D9_nvkz: doesn't show hand 
*** SUMMARY ***
Total pot $0.71 | Rake $0 
Seat 1: senej folded before Flop (didn't bet)
Seat 2: D9_nvkz (button) collected ($0.71)
Seat 3: G oet Mestreech (small blind) folded before Flop
Seat 4: LigoL (big blind) folded before Flop
Seat 5: sólyom333 folded before Flop



PokerStars Hand #222962378540:  Hold'em No Limit ($0.05/$0.10 USD) - 2021/01/23 12:56:39 ET
Table 'Shura III' 6-max Seat #3 is the button
Seat 1: senej ($21.46 in chips) 
Seat 2: D9_nvkz ($11.86 in chips) 
Seat 3: G oet Mestreech ($7.62 in chips) 
Seat 4: LigoL ($20.69 in chips) 
Seat 5: sólyom333 ($13.17 in chips) 
LigoL: posts small blind $0.05
sólyom333: posts big blind $0.10
*** HOLE CARDS ***
senej: folds 
D9_nvkz: raises $0.20 to $0.30
G oet Mestreech: calls $0.30
LigoL: folds 
sólyom333: calls $0.20
*** FLOP *** [5s Qd 4c]
sólyom333: checks 
D9_nvkz: checks 
G oet Mestreech: checks 
*** TURN *** [5s Qd 4c] [Qs]
sólyom333: bets $0.61
D9_nvkz: folds 
G oet Mestreech: folds 
Uncalled bet ($0.61) returned to sólyom333
sólyom333 collected $0.91 from pot
sólyom333: doesn't show hand 
*** SUMMARY ***
Total pot $0.95 | Rake $0.04 
Board [5s Qd 4c Qs]
Seat 1: senej folded before Flop (didn't bet)
Seat 2: D9_nvkz folded on the Turn
Seat 3: G oet Mestreech (button) folded on the Turn
Seat 4: LigoL (small blind) folded before Flop
Seat 5: sólyom333 (big blind) collected ($0.91)



PokerStars Hand #222962398250:  Hold'em No Limit ($0.05/$0.10 USD) - 2021/01/23 12:57:19 ET
Table 'Shura III' 6-max Seat #4 is the button
Seat 1: senej ($21.46 in chips) 
Seat 2: D9_nvkz ($11.56 in chips) 
Seat 3: G oet Mestreech ($7.32 in chips) 
Seat 4: LigoL ($20.64 in chips) 
Seat 5: sólyom333 ($13.78 in chips) 
Seat 6: lemurrr2014 ($4 in chips) 
sólyom333: posts small blind $0.05
lemurrr2014: posts big blind $0.10
*** HOLE CARDS ***
senej: folds 
D9_nvkz: folds 
G oet Mestreech: raises $0.20 to $0.30
LigoL: folds 
sólyom333: folds 
lemurrr2014: calls $0.20
*** FLOP *** [8c 5h 3c]
lemurrr2014: checks 
G oet Mestreech: checks 
*** TURN *** [8c 5h 3c] [5c]
lemurrr2014: bets $0.31
G oet Mestreech: folds 
Uncalled bet ($0.31) returned to lemurrr2014
lemurrr2014 collected $0.62 from pot
lemurrr2014: doesn't show hand 
*** SUMMARY ***
Total pot $0.65 | Rake $0.03 
Board [8c 5h 3c 5c]
Seat 1: senej folded before Flop (didn't bet)
Seat 2: D9_nvkz folded before Flop (didn't bet)
Seat 3: G oet Mestreech folded on the Turn
Seat 4: LigoL (button) folded before Flop (didn't bet)
Seat 5: sólyom333 (small blind) folded before Flop
Seat 6: lemurrr2014 (big blind) collected ($0.62)



PokerStars Hand #222962413359:  Hold'em No Limit ($0.05/$0.10 USD) - 2021/01/23 12:57:49 ET
Table 'Shura III' 6-max Seat #5 is the button
Seat 1: senej ($21.46 in chips) 
Seat 2: D9_nvkz ($11.56 in chips) 
Seat 3: G oet Mestreech ($7.02 in chips) 
Seat 4: LigoL ($20.64 in chips) 
Seat 5: sólyom333 ($13.73 in chips) 
Seat 6: lemurrr2014 ($4.32 in chips) 
lemurrr2014: posts small blind $0.05
senej: posts big blind $0.10
*** HOLE CARDS ***
D9_nvkz: folds 
G oet Mestreech: folds 
LigoL: folds 
sólyom333: folds 
lemurrr2014: calls $0.05
senej: checks 
*** FLOP *** [Ks 2h Qc]
lemurrr2014: checks 
senej: checks 
*** TURN *** [Ks 2h Qc] [Qs]
lemurrr2014: bets $0.10
senej: folds 
Uncalled bet ($0.10) returned to lemurrr2014
lemurrr2014 collected $0.19 from pot
lemurrr2014: doesn't show hand 
*** SUMMARY ***
Total pot $0.20 | Rake $0.01 
Board [Ks 2h Qc Qs]
Seat 1: senej (big blind) folded on the Turn
Seat 2: D9_nvkz folded before Flop (didn't bet)
Seat 3: G oet Mestreech folded before Flop (didn't bet)
Seat 4: LigoL folded before Flop (didn't bet)
Seat 5: sólyom333 (button) folded before Flop (didn't bet)
Seat 6: lemurrr2014 (small blind) collected ($0.19)



PokerStars Hand #222962424328:  Hold'em No Limit ($0.05/$0.10 USD) - 2021/01/23 12:58:11 ET
Table 'Shura III' 6-max Seat #6 is the button
Seat 1: senej ($21.36 in chips) 
Seat 2: D9_nvkz ($11.56 in chips) 
Seat 3: G oet Mestreech ($7.02 in chips) 
Seat 4: LigoL ($20.64 in chips) 
Seat 5: sólyom333 ($13.73 in chips) 
Seat 6: lemurrr2014 ($4.41 in chips) 
senej: posts small blind $0.05
D9_nvkz: posts big blind $0.10
*** HOLE CARDS ***
G oet Mestreech: folds 
LigoL: folds 
sólyom333: folds 
lemurrr2014: calls $0.10
senej: folds 
D9_nvkz: checks 
*** FLOP *** [Ah 4h 7c]
D9_nvkz: checks 
lemurrr2014: checks 
*** TURN *** [Ah 4h 7c] [3d]
D9_nvkz: checks 
lemurrr2014: checks 
*** RIVER *** [Ah 4h 7c 3d] [5h]
D9_nvkz: checks 
lemurrr2014: checks 
*** SHOW DOWN ***
D9_nvkz: shows [5d 5s] (three of a kind, Fives)
lemurrr2014: mucks hand 
D9_nvkz collected $0.24 from pot
*** SUMMARY ***
Total pot $0.25 | Rake $0.01 
Board [Ah 4h 7c 3d 5h]
Seat 1: senej (small blind) folded before Flop
Seat 2: D9_nvkz (big blind) showed [5d 5s] and won ($0.24) with three of a kind, Fives
Seat 3: G oet Mestreech folded before Flop (didn't bet)
Seat 4: LigoL folded before Flop (didn't bet)
Seat 5: sólyom333 folded before Flop (didn't bet)
Seat 6: lemurrr2014 (button) mucked



PokerStars Hand #222962445247:  Hold'em No Limit ($0.05/$0.10 USD) - 2021/01/23 12:58:53 ET
Table 'Shura III' 6-max Seat #1 is the button
Seat 1: senej ($21.31 in chips) 
Seat 2: D9_nvkz ($11.70 in chips) 
Seat 3: G oet Mestreech ($7.02 in chips) 
Seat 4: LigoL ($20.64 in chips) 
Seat 5: sólyom333 ($13.73 in chips) 
Seat 6: lemurrr2014 ($4.31 in chips) 
D9_nvkz: posts small blind $0.05
G oet Mestreech: posts big blind $0.10
*** HOLE CARDS ***
LigoL: folds 
sólyom333: folds 
lemurrr2014: calls $0.10
senej: folds 
D9_nvkz: folds 
G oet Mestreech: checks 
*** FLOP *** [As 5c 9h]
G oet Mestreech: checks 
lemurrr2014: bets $0.12
G oet Mestreech: folds 
Uncalled bet ($0.12) returned to lemurrr2014
lemurrr2014 collected $0.24 from pot
lemurrr2014: doesn't show hand 
*** SUMMARY ***
Total pot $0.25 | Rake $0.01 
Board [As 5c 9h]
Seat 1: senej (button) folded before Flop (didn't bet)
Seat 2: D9_nvkz (small blind) folded before Flop
Seat 3: G oet Mestreech (big blind) folded on the Flop
Seat 4: LigoL folded before Flop (didn't bet)
Seat 5: sólyom333 folded before Flop (didn't bet)
Seat 6: lemurrr2014 collected ($0.24)



PokerStars Hand #222962456352:  Hold'em No Limit ($0.05/$0.10 USD) - 2021/01/23 12:59:15 ET
Table 'Shura III' 6-max Seat #2 is the button
Seat 1: senej ($21.31 in chips) 
Seat 2: D9_nvkz ($11.65 in chips) 
Seat 3: G oet Mestreech ($6.92 in chips) 
Seat 4: LigoL ($20.64 in chips) 
Seat 5: sólyom333 ($13.73 in chips) 
Seat 6: lemurrr2014 ($4.45 in chips) 
G oet Mestreech: posts small blind $0.05
LigoL: posts big blind $0.10
*** HOLE CARDS ***
sólyom333: folds 
lemurrr2014: calls $0.10
senej: folds 
D9_nvkz: folds 
G oet Mestreech: calls $0.05
LigoL: checks 
*** FLOP *** [Ah 9s 7h]
G oet Mestreech: checks 
LigoL: checks 
lemurrr2014: checks 
*** TURN *** [Ah 9s 7h] [5d]
G oet Mestreech: checks 
LigoL: checks 
lemurrr2014: checks 
*** RIVER *** [Ah 9s 7h 5d] [Ks]
G oet Mestreech: bets $1.37
LigoL: folds 
lemurrr2014: folds 
Uncalled bet ($1.37) returned to G oet Mestreech
G oet Mestreech collected $0.29 from pot
G oet Mestreech: doesn't show hand 
*** SUMMARY ***
Total pot $0.30 | Rake $0.01 
Board [Ah 9s 7h 5d Ks]
Seat 1: senej folded before Flop (didn't bet)
Seat 2: D9_nvkz (button) folded before Flop (didn't bet)
Seat 3: G oet Mestreech (small blind) collected ($0.29)
Seat 4: LigoL (big blind) folded on the River
Seat 5: sólyom333 folded before Flop (didn't bet)
Seat 6: lemurrr2014 folded on the River



PokerStars Hand #222962475843:  Hold'em No Limit ($0.05/$0.10 USD) - 2021/01/23 12:59:53 ET
Table 'Shura III' 6-max Seat #3 is the button
Seat 1: senej ($21.31 in chips) 
Seat 2: D9_nvkz ($11.65 in chips) 
Seat 3: G oet Mestreech ($7.11 in chips) 
Seat 4: LigoL ($20.54 in chips) 
Seat 5: sólyom333 ($13.73 in chips) 
Seat 6: lemurrr2014 ($4.35 in chips) 
LigoL: posts small blind $0.05
sólyom333: posts big blind $0.10
*** HOLE CARDS ***
lemurrr2014: calls $0.10
senej: folds 
D9_nvkz: folds 
G oet Mestreech: folds 
LigoL: raises $0.55 to $0.65
sólyom333: calls $0.55
lemurrr2014: calls $0.55
*** FLOP *** [6c 8d 9d]
LigoL: bets $1.75
sólyom333: calls $1.75
lemurrr2014: folds 
*** TURN *** [6c 8d 9d] [Jc]
LigoL: checks 
sólyom333: bets $3.35
LigoL: calls $3.35
*** RIVER *** [6c 8d 9d Jc] [4s]
LigoL: checks 
sólyom333: bets $7.98 and is all-in
LigoL: calls $7.98
*** SHOW DOWN ***
sólyom333: shows [Ac Ad] (a pair of Aces)
LigoL: shows [Js Jh] (three of a kind, Jacks)
LigoL collected $26.85 from pot
*** SUMMARY ***
Total pot $28.11 | Rake $1.26 
Board [6c 8d 9d Jc 4s]
Seat 1: senej folded before Flop (didn't bet)
Seat 2: D9_nvkz folded before Flop (didn't bet)
Seat 3: G oet Mestreech (button) folded before Flop (didn't bet)
Seat 4: LigoL (small blind) showed [Js Jh] and won ($26.85) with three of a kind, Jacks
Seat 5: sólyom333 (big blind) showed [Ac Ad] and lost with a pair of Aces
Seat 6: lemurrr2014 folded on the Flop



PokerStars Hand #222962510834:  Hold'em No Limit ($0.05/$0.10 USD) - 2021/01/23 13:00:59 ET
Table 'Shura III' 6-max Seat #4 is the button
Seat 1: senej ($21.31 in chips) 
Seat 2: D9_nvkz ($11.65 in chips) 
Seat 3: G oet Mestreech ($7.11 in chips) 
Seat 4: LigoL ($33.66 in chips) 
Seat 5: sólyom333 ($10 in chips) 
Seat 6: lemurrr2014 ($3.70 in chips) 
sólyom333: posts small blind $0.05
lemurrr2014: posts big blind $0.10
*** HOLE CARDS ***
senej: raises $0.20 to $0.30
D9_nvkz: folds 
G oet Mestreech: calls $0.30
LigoL: folds 
sólyom333: folds 
lemurrr2014: folds 
*** FLOP *** [Qd 6c Tc]
senej: checks 
G oet Mestreech: bets $0.40
senej: folds 
Uncalled bet ($0.40) returned to G oet Mestreech
G oet Mestreech collected $0.72 from pot
G oet Mestreech: doesn't show hand 
*** SUMMARY ***
Total pot $0.75 | Rake $0.03 
Board [Qd 6c Tc]
Seat 1: senej folded on the Flop
Seat 2: D9_nvkz folded before Flop (didn't bet)
Seat 3: G oet Mestreech collected ($0.72)
Seat 4: LigoL (button) folded before Flop (didn't bet)
Seat 5: sólyom333 (small blind) folded before Flop
Seat 6: lemurrr2014 (big blind) folded before Flop



PokerStars Hand #222962527955:  Hold'em No Limit ($0.05/$0.10 USD) - 2021/01/23 13:01:27 ET
Table 'Shura III' 6-max Seat #5 is the button
Seat 1: senej ($21.01 in chips) 
Seat 2: D9_nvkz ($11.65 in chips) 
Seat 3: G oet Mestreech ($7.53 in chips) 
Seat 4: LigoL ($33.66 in chips) 
Seat 5: sólyom333 ($9.95 in chips) 
Seat 6: lemurrr2014 ($3.60 in chips) 
lemurrr2014: posts small blind $0.05
senej: posts big blind $0.10
*** HOLE CARDS ***
D9_nvkz: folds 
G oet Mestreech: folds 
LigoL: folds 
sólyom333: raises $0.12 to $0.22
lemurrr2014: folds 
senej: calls $0.12
*** FLOP *** [9s 8h 3c]
senej: checks 
sólyom333: bets $0.20
senej: folds 
Uncalled bet ($0.20) returned to sólyom333
sólyom333 collected $0.47 from pot
sólyom333: doesn't show hand 
*** SUMMARY ***
Total pot $0.49 | Rake $0.02 
Board [9s 8h 3c]
Seat 1: senej (big blind) folded on the Flop
Seat 2: D9_nvkz folded before Flop (didn't bet)
Seat 3: G oet Mestreech folded before Flop (didn't bet)
Seat 4: LigoL folded before Flop (didn't bet)
Seat 5: sólyom333 (button) collected ($0.47)
Seat 6: lemurrr2014 (small blind) folded before Flop



PokerStars Hand #222962539735:  Hold'em No Limit ($0.05/$0.10 USD) - 2021/01/23 13:01:47 ET
Table 'Shura III' 6-max Seat #6 is the button
Seat 1: senej ($20.79 in chips) 
Seat 2: D9_nvkz ($11.65 in chips) 
Seat 3: G oet Mestreech ($7.53 in chips) 
Seat 4: LigoL ($33.66 in chips) 
Seat 5: sólyom333 ($10.20 in chips) 
Seat 6: lemurrr2014 ($3.55 in chips) 
senej: posts small blind $0.05
D9_nvkz: posts big blind $0.10
*** HOLE CARDS ***
G oet Mestreech: folds 
LigoL: raises $0.20 to $0.30
sólyom333: raises $0.58 to $0.88
lemurrr2014: folds 
senej: folds 
D9_nvkz: folds 
LigoL: calls $0.58
*** FLOP *** [9s 3s Td]
LigoL: checks 
sólyom333: bets $0.76
LigoL: folds 
Uncalled bet ($0.76) returned to sólyom333
sólyom333 collected $1.82 from pot
sólyom333: doesn't show hand 
*** SUMMARY ***
Total pot $1.91 | Rake $0.09 
Board [9s 3s Td]
Seat 1: senej (small blind) folded before Flop
Seat 2: D9_nvkz (big blind) folded before Flop
Seat 3: G oet Mestreech folded before Flop (didn't bet)
Seat 4: LigoL folded on the Flop
Seat 5: sólyom333 collected ($1.82)
Seat 6: lemurrr2014 (button) folded before Flop (didn't bet)



PokerStars Hand #222962582206:  Hold'em No Limit ($0.05/$0.10 USD) - 2021/01/23 13:02:51 ET
Table 'Shura III' 6-max Seat #1 is the button
Seat 1: senej ($20.74 in chips) 
Seat 2: D9_nvkz ($11.55 in chips) 
Seat 3: G oet Mestreech ($7.53 in chips) 
Seat 4: LigoL ($32.78 in chips) 
Seat 5: sólyom333 ($11.14 in chips) 
Seat 6: lemurrr2014 ($3.55 in chips) 
D9_nvkz: posts small blind $0.05
G oet Mestreech: posts big blind $0.10
*** HOLE CARDS ***
LigoL: folds 
sólyom333: folds 
lemurrr2014: calls $0.10
senej: folds 
D9_nvkz: folds 
G oet Mestreech: checks 
*** FLOP *** [6h 4d 4s]
G oet Mestreech: checks 
lemurrr2014: bets $0.12
G oet Mestreech: calls $0.12
*** TURN *** [6h 4d 4s] [As]
G oet Mestreech: checks 
lemurrr2014: bets $0.23
G oet Mestreech: folds 
Uncalled bet ($0.23) returned to lemurrr2014
lemurrr2014 collected $0.47 from pot
lemurrr2014: doesn't show hand 
*** SUMMARY ***
Total pot $0.49 | Rake $0.02 
Board [6h 4d 4s As]
Seat 1: senej (button) folded before Flop (didn't bet)
Seat 2: D9_nvkz (small blind) folded before Flop
Seat 3: G oet Mestreech (big blind) folded on the Turn
Seat 4: LigoL folded before Flop (didn't bet)
Seat 5: sólyom333 folded before Flop (didn't bet)
Seat 6: lemurrr2014 collected ($0.47)



PokerStars Hand #222962604314:  Hold'em No Limit ($0.05/$0.10 USD) - 2021/01/23 13:03:24 ET
Table 'Shura III' 6-max Seat #2 is the button
Seat 1: senej ($20.74 in chips) 
Seat 2: D9_nvkz ($11.50 in chips) 
Seat 3: G oet Mestreech ($7.31 in chips) 
Seat 4: LigoL ($32.78 in chips) 
Seat 5: sólyom333 ($11.14 in chips) 
Seat 6: lemurrr2014 ($3.80 in chips) 
G oet Mestreech: posts small blind $0.05
LigoL: posts big blind $0.10
*** HOLE CARDS ***
sólyom333: folds 
lemurrr2014: folds 
senej: folds 
D9_nvkz: folds 
G oet Mestreech: folds 
Uncalled bet ($0.05) returned to LigoL
LigoL collected $0.10 from pot
LigoL: doesn't show hand 
*** SUMMARY ***
Total pot $0.10 | Rake $0 
Seat 1: senej folded before Flop (didn't bet)
Seat 2: D9_nvkz (button) folded before Flop (didn't bet)
Seat 3: G oet Mestreech (small blind) folded before Flop
Seat 4: LigoL (big blind) collected ($0.10)
Seat 5: sólyom333 folded before Flop (didn't bet)
Seat 6: lemurrr2014 folded before Flop (didn't bet)



PokerStars Hand #222962612471:  Hold'em No Limit ($0.05/$0.10 USD) - 2021/01/23 13:03:36 ET
Table 'Shura III' 6-max Seat #3 is the button
Seat 1: senej ($20.74 in chips) 
Seat 2: D9_nvkz ($11.50 in chips) 
Seat 3: G oet Mestreech ($7.26 in chips) 
Seat 4: LigoL ($32.83 in chips) 
Seat 5: sólyom333 ($11.14 in chips) 
Seat 6: lemurrr2014 ($3.80 in chips) 
LigoL: posts small blind $0.05
sólyom333: posts big blind $0.10
*** HOLE CARDS ***
lemurrr2014: calls $0.10
senej: folds 
D9_nvkz: folds 
G oet Mestreech: folds 
LigoL: folds 
sólyom333: checks 
*** FLOP *** [2c Qd 2s]
sólyom333: checks 
lemurrr2014: bets $0.12
sólyom333: folds 
Uncalled bet ($0.12) returned to lemurrr2014
lemurrr2014 collected $0.24 from pot
lemurrr2014: doesn't show hand 
*** SUMMARY ***
Total pot $0.25 | Rake $0.01 
Board [2c Qd 2s]
Seat 1: senej folded before Flop (didn't bet)
Seat 2: D9_nvkz folded before Flop (didn't bet)
Seat 3: G oet Mestreech (button) folded before Flop (didn't bet)
Seat 4: LigoL (small blind) folded before Flop
Seat 5: sólyom333 (big blind) folded on the Flop
Seat 6: lemurrr2014 collected ($0.24)



PokerStars Hand #222962627164:  Hold'em No Limit ($0.05/$0.10 USD) - 2021/01/23 13:03:57 ET
Table 'Shura III' 6-max Seat #4 is the button
Seat 1: senej ($20.74 in chips) 
Seat 2: D9_nvkz ($11.50 in chips) 
Seat 3: G oet Mestreech ($7.26 in chips) 
Seat 4: LigoL ($32.78 in chips) 
Seat 5: sólyom333 ($11.04 in chips) 
Seat 6: lemurrr2014 ($3.94 in chips) 
sólyom333: posts small blind $0.05
lemurrr2014: posts big blind $0.10
*** HOLE CARDS ***
senej: raises $0.20 to $0.30
D9_nvkz: folds 
G oet Mestreech: calls $0.30
LigoL: folds 
sólyom333: folds 
lemurrr2014: calls $0.20
*** FLOP *** [Qs 5h 2s]
lemurrr2014: checks 
senej: bets $0.61
G oet Mestreech: folds 
lemurrr2014: folds 
Uncalled bet ($0.61) returned to senej
senej collected $0.91 from pot
senej: doesn't show hand 
*** SUMMARY ***
Total pot $0.95 | Rake $0.04 
Board [Qs 5h 2s]
Seat 1: senej collected ($0.91)
Seat 2: D9_nvkz folded before Flop (didn't bet)
Seat 3: G oet Mestreech folded on the Flop
Seat 4: LigoL (button) folded before Flop (didn't bet)
Seat 5: sólyom333 (small blind) folded before Flop
Seat 6: lemurrr2014 (big blind) folded on the Flop



PokerStars Hand #222962649829:  Hold'em No Limit ($0.05/$0.10 USD) - 2021/01/23 13:04:30 ET
Table 'Shura III' 6-max Seat #5 is the button
Seat 1: senej ($21.35 in chips) 
Seat 2: D9_nvkz ($11.50 in chips) 
Seat 3: G oet Mestreech ($6.96 in chips) 
Seat 4: LigoL ($32.78 in chips) 
Seat 5: sólyom333 ($10.99 in chips) 
Seat 6: lemurrr2014 ($3.64 in chips) 
lemurrr2014: posts small blind $0.05
senej: posts big blind $0.10
*** HOLE CARDS ***
D9_nvkz: folds 
G oet Mestreech: raises $0.20 to $0.30
LigoL: folds 
sólyom333: folds 
lemurrr2014: folds 
senej: folds 
Uncalled bet ($0.20) returned to G oet Mestreech
G oet Mestreech collected $0.25 from pot
G oet Mestreech: doesn't show hand 
*** SUMMARY ***
Total pot $0.25 | Rake $0 
Seat 1: senej (big blind) folded before Flop
Seat 2: D9_nvkz folded before Flop (didn't bet)
Seat 3: G oet Mestreech collected ($0.25)
Seat 4: LigoL folded before Flop (didn't bet)
Seat 5: sólyom333 (button) folded before Flop (didn't bet)
Seat 6: lemurrr2014 (small blind) folded before Flop



PokerStars Hand #222962657749:  Hold'em No Limit ($0.05/$0.10 USD) - 2021/01/23 13:04:42 ET
Table 'Shura III' 6-max Seat #6 is the button
Seat 1: senej ($21.25 in chips) 
Seat 2: D9_nvkz ($11.50 in chips) 
Seat 3: G oet Mestreech ($7.11 in chips) 
Seat 4: LigoL ($32.78 in chips) 
Seat 5: sólyom333 ($10.99 in chips) 
Seat 6: lemurrr2014 ($3.59 in chips) 
senej: posts small blind $0.05
D9_nvkz: posts big blind $0.10
*** HOLE CARDS ***
G oet Mestreech: folds 
LigoL: folds 
sólyom333: raises $0.18 to $0.28
lemurrr2014: folds 
senej: folds 
D9_nvkz: raises $0.81 to $1.09
sólyom333: folds 
Uncalled bet ($0.81) returned to D9_nvkz
D9_nvkz collected $0.61 from pot
D9_nvkz: doesn't show hand 
*** SUMMARY ***
Total pot $0.61 | Rake $0 
Seat 1: senej (small blind) folded before Flop
Seat 2: D9_nvkz (big blind) collected ($0.61)
Seat 3: G oet Mestreech folded before Flop (didn't bet)
Seat 4: LigoL folded before Flop (didn't bet)
Seat 5: sólyom333 folded before Flop
Seat 6: lemurrr2014 (button) folded before Flop (didn't bet)



PokerStars Hand #222962671828:  Hold'em No Limit ($0.05/$0.10 USD) - 2021/01/23 13:05:02 ET
Table 'Shura III' 6-max Seat #1 is the button
Seat 1: senej ($21.20 in chips) 
Seat 2: D9_nvkz ($11.83 in chips) 
Seat 3: G oet Mestreech ($7.11 in chips) 
Seat 4: LigoL ($32.78 in chips) 
Seat 5: sólyom333 ($10.71 in chips) 
Seat 6: lemurrr2014 ($3.59 in chips) 
D9_nvkz: posts small blind $0.05
G oet Mestreech: posts big blind $0.10
*** HOLE CARDS ***
LigoL: folds 
sólyom333: folds 
lemurrr2014: folds 
senej: raises $0.20 to $0.30
D9_nvkz: folds 
G oet Mestreech: folds 
Uncalled bet ($0.20) returned to senej
senej collected $0.25 from pot
senej: doesn't show hand 
*** SUMMARY ***
Total pot $0.25 | Rake $0 
Seat 1: senej (button) collected ($0.25)
Seat 2: D9_nvkz (small blind) folded before Flop
Seat 3: G oet Mestreech (big blind) folded before Flop
Seat 4: LigoL folded before Flop (didn't bet)
Seat 5: sólyom333 folded before Flop (didn't bet)
Seat 6: lemurrr2014 folded before Flop (didn't bet)



PokerStars Hand #222962684385:  Hold'em No Limit ($0.05/$0.10 USD) - 2021/01/23 13:05:20 ET
Table 'Shura III' 6-max Seat #2 is the button
Seat 1: senej ($21.35 in chips) 
Seat 2: D9_nvkz ($11.78 in chips) 
Seat 3: G oet Mestreech ($7.01 in chips) 
Seat 4: LigoL ($32.78 in chips) 
Seat 5: sólyom333 ($10.71 in chips) 
Seat 6: lemurrr2014 ($3.59 in chips) 
G oet Mestreech: posts small blind $0.05
LigoL: posts big blind $0.10
*** HOLE CARDS ***
sólyom333: folds 
lemurrr2014: calls $0.10
senej: folds 
D9_nvkz: raises $0.35 to $0.45
G oet Mestreech: folds 
LigoL: folds 
lemurrr2014: folds 
Uncalled bet ($0.35) returned to D9_nvkz
D9_nvkz collected $0.35 from pot
D9_nvkz: doesn't show hand 
*** SUMMARY ***
Total pot $0.35 | Rake $0 
Seat 1: senej folded before Flop (didn't bet)
Seat 2: D9_nvkz (button) collected ($0.35)
Seat 3: G oet Mestreech (small blind) folded before Flop
Seat 4: LigoL (big blind) folded before Flop
Seat 5: sólyom333 folded before Flop (didn't bet)
Seat 6: lemurrr2014 folded before Flop



PokerStars Hand #222962697025:  Hold'em No Limit ($0.05/$0.10 USD) - 2021/01/23 13:05:38 ET
Table 'Shura III' 6-max Seat #3 is the button
Seat 1: senej ($21.35 in chips) 
Seat 2: D9_nvkz ($12.03 in chips) 
Seat 3: G oet Mestreech ($6.96 in chips) 
Seat 4: LigoL ($32.68 in chips) 
Seat 5: sólyom333 ($10.71 in chips) 
Seat 6: lemurrr2014 ($3.49 in chips) 
LigoL: posts small blind $0.05
sólyom333: posts big blind $0.10
*** HOLE CARDS ***
lemurrr2014: folds 
senej: folds 
D9_nvkz: folds 
G oet Mestreech: calls $0.10
LigoL: folds 
sólyom333: raises $0.35 to $0.45
G oet Mestreech: calls $0.35
*** FLOP *** [6d Ac 8d]
sólyom333: bets $0.38
G oet Mestreech: folds 
Uncalled bet ($0.38) returned to sólyom333
sólyom333 collected $0.91 from pot
sólyom333: doesn't show hand 
*** SUMMARY ***
Total pot $0.95 | Rake $0.04 
Board [6d Ac 8d]
Seat 1: senej folded before Flop (didn't bet)
Seat 2: D9_nvkz folded before Flop (didn't bet)
Seat 3: G oet Mestreech (button) folded on the Flop
Seat 4: LigoL (small blind) folded before Flop
Seat 5: sólyom333 (big blind) collected ($0.91)
Seat 6: lemurrr2014 folded before Flop (didn't bet)



PokerStars Hand #222962716946:  Hold'em No Limit ($0.05/$0.10 USD) - 2021/01/23 13:06:07 ET
Table 'Shura III' 6-max Seat #4 is the button
Seat 1: senej ($21.35 in chips) 
Seat 2: D9_nvkz ($12.03 in chips) 
Seat 3: G oet Mestreech ($6.51 in chips) 
Seat 4: LigoL ($32.63 in chips) 
Seat 5: sólyom333 ($11.17 in chips) 
Seat 6: lemurrr2014 ($3.49 in chips) 
sólyom333: posts small blind $0.05
lemurrr2014: posts big blind $0.10
*** HOLE CARDS ***
senej: folds 
D9_nvkz: raises $0.20 to $0.30
G oet Mestreech: folds 
LigoL: folds 
sólyom333: folds 
lemurrr2014: folds 
Uncalled bet ($0.20) returned to D9_nvkz
D9_nvkz collected $0.25 from pot
D9_nvkz: doesn't show hand 
*** SUMMARY ***
Total pot $0.25 | Rake $0 
Seat 1: senej folded before Flop (didn't bet)
Seat 2: D9_nvkz collected ($0.25)
Seat 3: G oet Mestreech folded before Flop (didn't bet)
Seat 4: LigoL (button) folded before Flop (didn't bet)
Seat 5: sólyom333 (small blind) folded before Flop
Seat 6: lemurrr2014 (big blind) folded before Flop



PokerStars Hand #222962727673:  Hold'em No Limit ($0.05/$0.10 USD) - 2021/01/23 13:06:22 ET
Table 'Shura III' 6-max Seat #5 is the button
Seat 1: senej ($21.35 in chips) 
Seat 2: D9_nvkz ($12.18 in chips) 
Seat 3: G oet Mestreech ($6.51 in chips) 
Seat 4: LigoL ($32.63 in chips) 
Seat 5: sólyom333 ($11.12 in chips) 
Seat 6: lemurrr2014 ($3.39 in chips) 
lemurrr2014: posts small blind $0.05
senej: posts big blind $0.10
*** HOLE CARDS ***
D9_nvkz: folds 
G oet Mestreech: folds 
LigoL: folds 
sólyom333: raises $0.12 to $0.22
lemurrr2014: folds 
senej: folds 
Uncalled bet ($0.12) returned to sólyom333
sólyom333 collected $0.25 from pot
sólyom333: doesn't show hand 
*** SUMMARY ***
Total pot $0.25 | Rake $0 
Seat 1: senej (big blind) folded before Flop
Seat 2: D9_nvkz folded before Flop (didn't bet)
Seat 3: G oet Mestreech folded before Flop (didn't bet)
Seat 4: LigoL folded before Flop (didn't bet)
Seat 5: sólyom333 (button) collected ($0.25)
Seat 6: lemurrr2014 (small blind) folded before Flop



PokerStars Hand #222962736601:  Hold'em No Limit ($0.05/$0.10 USD) - 2021/01/23 13:06:35 ET
Table 'Shura III' 6-max Seat #6 is the button
Seat 1: senej ($21.25 in chips) 
Seat 2: D9_nvkz ($12.18 in chips) 
Seat 3: G oet Mestreech ($6.51 in chips) 
Seat 4: LigoL ($32.63 in chips) 
Seat 5: sólyom333 ($11.27 in chips) 
Seat 6: lemurrr2014 ($3.34 in chips) 
senej: posts small blind $0.05
D9_nvkz: posts big blind $0.10
*** HOLE CARDS ***
G oet Mestreech: folds 
LigoL: folds 
sólyom333: folds 
lemurrr2014: calls $0.10
senej: folds 
D9_nvkz: raises $0.45 to $0.55
lemurrr2014: calls $0.45
*** FLOP *** [2h 4s 8d]
D9_nvkz: bets $0.80
lemurrr2014: folds 
Uncalled bet ($0.80) returned to D9_nvkz
D9_nvkz collected $1.10 from pot
D9_nvkz: doesn't show hand 
*** SUMMARY ***
Total pot $1.15 | Rake $0.05 
Board [2h 4s 8d]
Seat 1: senej (small blind) folded before Flop
Seat 2: D9_nvkz (big blind) collected ($1.10)
Seat 3: G oet Mestreech folded before Flop (didn't bet)
Seat 4: LigoL folded before Flop (didn't bet)
Seat 5: sólyom333 folded before Flop (didn't bet)
Seat 6: lemurrr2014 (button) folded on the Flop



PokerStars Hand #222962767714:  Hold'em No Limit ($0.05/$0.10 USD) - 2021/01/23 13:07:21 ET
Table 'Shura III' 6-max Seat #1 is the button
Seat 1: senej ($21.20 in chips) 
Seat 2: D9_nvkz ($12.73 in chips) 
Seat 3: G oet Mestreech ($6.51 in chips) 
Seat 4: LigoL ($32.63 in chips) 
Seat 5: sólyom333 ($11.27 in chips) 
Seat 6: lemurrr2014 ($2.79 in chips) 
D9_nvkz: posts small blind $0.05
G oet Mestreech: posts big blind $0.10
*** HOLE CARDS ***
LigoL: folds 
sólyom333: folds 
lemurrr2014: folds 
senej: folds 
D9_nvkz: folds 
Uncalled bet ($0.05) returned to G oet Mestreech
G oet Mestreech collected $0.10 from pot
G oet Mestreech: doesn't show hand 
*** SUMMARY ***
Total pot $0.10 | Rake $0 
Seat 1: senej (button) folded before Flop (didn't bet)
Seat 2: D9_nvkz (small blind) folded before Flop
Seat 3: G oet Mestreech (big blind) collected ($0.10)
Seat 4: LigoL folded before Flop (didn't bet)
Seat 5: sólyom333 folded before Flop (didn't bet)
Seat 6: lemurrr2014 folded before Flop (didn't bet)



PokerStars Hand #222962776541:  Hold'em No Limit ($0.05/$0.10 USD) - 2021/01/23 13:07:33 ET
Table 'Shura III' 6-max Seat #2 is the button
Seat 1: senej ($21.20 in chips) 
Seat 2: D9_nvkz ($12.68 in chips) 
Seat 3: G oet Mestreech ($6.56 in chips) 
Seat 4: LigoL ($32.63 in chips) 
Seat 5: sólyom333 ($11.27 in chips) 
Seat 6: lemurrr2014 ($2.79 in chips) 
G oet Mestreech: posts small blind $0.05
LigoL: posts big blind $0.10
*** HOLE CARDS ***
sólyom333: folds 
lemurrr2014: folds 
senej: folds 
D9_nvkz: folds 
G oet Mestreech: folds 
Uncalled bet ($0.05) returned to LigoL
LigoL collected $0.10 from pot
LigoL: doesn't show hand 
*** SUMMARY ***
Total pot $0.10 | Rake $0 
Seat 1: senej folded before Flop (didn't bet)
Seat 2: D9_nvkz (button) folded before Flop (didn't bet)
Seat 3: G oet Mestreech (small blind) folded before Flop
Seat 4: LigoL (big blind) collected ($0.10)
Seat 5: sólyom333 folded before Flop (didn't bet)
Seat 6: lemurrr2014 folded before Flop (didn't bet)



PokerStars Hand #222962785403:  Hold'em No Limit ($0.05/$0.10 USD) - 2021/01/23 13:07:46 ET
Table 'Shura III' 6-max Seat #4 is the button
Seat 1: senej ($21.20 in chips) 
Seat 2: D9_nvkz ($12.68 in chips) 
Seat 4: LigoL ($32.68 in chips) 
Seat 5: sólyom333 ($11.27 in chips) 
Seat 6: lemurrr2014 ($2.79 in chips) 
sólyom333: posts small blind $0.05
lemurrr2014: posts big blind $0.10
*** HOLE CARDS ***
senej: folds 
G oet Mestreech leaves the table
D9_nvkz: raises $0.20 to $0.30
LigoL: folds 
sólyom333: folds 
lemurrr2014: folds 
Uncalled bet ($0.20) returned to D9_nvkz
D9_nvkz collected $0.25 from pot
D9_nvkz: doesn't show hand 
*** SUMMARY ***
Total pot $0.25 | Rake $0 
Seat 1: senej folded before Flop (didn't bet)
Seat 2: D9_nvkz collected ($0.25)
Seat 4: LigoL (button) folded before Flop (didn't bet)
Seat 5: sólyom333 (small blind) folded before Flop
Seat 6: lemurrr2014 (big blind) folded before Flop



PokerStars Hand #222962796955:  Hold'em No Limit ($0.05/$0.10 USD) - 2021/01/23 13:08:03 ET
Table 'Shura III' 6-max Seat #5 is the button
Seat 1: senej ($21.20 in chips) 
Seat 2: D9_nvkz ($12.83 in chips) 
Seat 4: LigoL ($32.68 in chips) 
Seat 5: sólyom333 ($11.22 in chips) 
Seat 6: lemurrr2014 ($2.69 in chips) 
lemurrr2014: posts small blind $0.05
senej: posts big blind $0.10
*** HOLE CARDS ***
D9_nvkz: folds 
LigoL: folds 
sólyom333: raises $0.12 to $0.22
lemurrr2014: calls $0.17
senej: calls $0.12
*** FLOP *** [9d Kd 3h]
cj71754 joins the table at seat #3 
lemurrr2014: checks 
senej: checks 
sólyom333: checks 
*** TURN *** [9d Kd 3h] [Js]
lemurrr2014: bets $0.63
senej: folds 
sólyom333: folds 
Uncalled bet ($0.63) returned to lemurrr2014
lemurrr2014 collected $0.63 from pot
lemurrr2014: doesn't show hand 
*** SUMMARY ***
Total pot $0.66 | Rake $0.03 
Board [9d Kd 3h Js]
Seat 1: senej (big blind) folded on the Turn
Seat 2: D9_nvkz folded before Flop (didn't bet)
Seat 4: LigoL folded before Flop (didn't bet)
Seat 5: sólyom333 (button) folded on the Turn
Seat 6: lemurrr2014 (small blind) collected ($0.63)



PokerStars Hand #222962815627:  Hold'em No Limit ($0.05/$0.10 USD) - 2021/01/23 13:08:30 ET
Table 'Shura III' 6-max Seat #6 is the button
Seat 1: senej ($20.98 in chips) 
Seat 2: D9_nvkz ($12.83 in chips) 
Seat 4: LigoL ($32.68 in chips) 
Seat 5: sólyom333 ($11 in chips) 
Seat 6: lemurrr2014 ($3.10 in chips) 
senej: posts small blind $0.05
D9_nvkz: posts big blind $0.10
cj71754: sits out 
*** HOLE CARDS ***
LigoL: folds 
sólyom333: folds 
lemurrr2014: raises $0.25 to $0.35
senej: folds 
D9_nvkz: folds 
Uncalled bet ($0.25) returned to lemurrr2014
lemurrr2014 collected $0.25 from pot
lemurrr2014: doesn't show hand 
*** SUMMARY ***
Total pot $0.25 | Rake $0 
Seat 1: senej (small blind) folded before Flop
Seat 2: D9_nvkz (big blind) folded before Flop
Seat 4: LigoL folded before Flop (didn't bet)
Seat 5: sólyom333 folded before Flop (didn't bet)
Seat 6: lemurrr2014 (button) collected ($0.25)



PokerStars Hand #222962825461:  Hold'em No Limit ($0.05/$0.10 USD) - 2021/01/23 13:08:44 ET
Table 'Shura III' 6-max Seat #1 is the button
Seat 1: senej ($20.93 in chips) 
Seat 2: D9_nvkz ($12.73 in chips) 
Seat 3: cj71754 ($8 in chips) 
Seat 4: LigoL ($32.68 in chips) 
Seat 5: sólyom333 ($11 in chips) 
Seat 6: lemurrr2014 ($3.25 in chips) 
D9_nvkz: posts small blind $0.05
cj71754: posts big blind $0.10
*** HOLE CARDS ***
LigoL: raises $0.20 to $0.30
sólyom333: folds 
lemurrr2014: folds 
senej: folds 
D9_nvkz: folds 
cj71754: calls $0.20
*** FLOP *** [9s 5h 5c]
cj71754: checks 
LigoL: checks 
*** TURN *** [9s 5h 5c] [Qd]
cj71754: checks 
LigoL: bets $0.48
cj71754: folds 
Uncalled bet ($0.48) returned to LigoL
LigoL collected $0.62 from pot
LigoL: doesn't show hand 
*** SUMMARY ***
Total pot $0.65 | Rake $0.03 
Board [9s 5h 5c Qd]
Seat 1: senej (button) folded before Flop (didn't bet)
Seat 2: D9_nvkz (small blind) folded before Flop
Seat 3: cj71754 (big blind) folded on the Turn
Seat 4: LigoL collected ($0.62)
Seat 5: sólyom333 folded before Flop (didn't bet)
Seat 6: lemurrr2014 folded before Flop (didn't bet)



PokerStars Hand #222962856558:  Hold'em No Limit ($0.05/$0.10 USD) - 2021/01/23 13:09:30 ET
Table 'Shura III' 6-max Seat #2 is the button
Seat 1: senej ($20.93 in chips) 
Seat 2: D9_nvkz ($12.68 in chips) 
Seat 3: cj71754 ($7.70 in chips) 
Seat 5: sólyom333 ($11 in chips) 
Seat 6: lemurrr2014 ($3.25 in chips) 
cj71754: posts small blind $0.05
LigoL: is sitting out 
sólyom333: posts big blind $0.10
*** HOLE CARDS ***
LigoL leaves the table
lemurrr2014: calls $0.10
senej: folds 
D9_nvkz: folds 
cj71754: calls $0.05
grasu331 joins the table at seat #4 
sólyom333: checks 
*** FLOP *** [8h As Js]
cj71754: checks 
sólyom333: checks 
lemurrr2014: bets $0.14
cj71754: folds 
sólyom333: folds 
Uncalled bet ($0.14) returned to lemurrr2014
lemurrr2014 collected $0.29 from pot
lemurrr2014: doesn't show hand 
*** SUMMARY ***
Total pot $0.30 | Rake $0.01 
Board [8h As Js]
Seat 1: senej folded before Flop (didn't bet)
Seat 2: D9_nvkz (button) folded before Flop (didn't bet)
Seat 3: cj71754 (small blind) folded on the Flop
Seat 5: sólyom333 (big blind) folded on the Flop
Seat 6: lemurrr2014 collected ($0.29)



PokerStars Hand #222962879636:  Hold'em No Limit ($0.05/$0.10 USD) - 2021/01/23 13:10:03 ET
Table 'Shura III' 6-max Seat #3 is the button
Seat 1: senej ($20.93 in chips) 
Seat 2: D9_nvkz ($12.68 in chips) 
Seat 3: cj71754 ($7.60 in chips) 
Seat 5: sólyom333 ($10.90 in chips) 
Seat 6: lemurrr2014 ($3.44 in chips) 
sólyom333: posts small blind $0.05
lemurrr2014: posts big blind $0.10
*** HOLE CARDS ***
senej: folds 
D9_nvkz: folds 
cj71754: calls $0.10
sólyom333: folds 
lemurrr2014: raises $0.25 to $0.35
cj71754: calls $0.25
*** FLOP *** [3c 4s Qs]
lemurrr2014: bets $0.36
cj71754: folds 
Uncalled bet ($0.36) returned to lemurrr2014
lemurrr2014 collected $0.72 from pot
lemurrr2014: doesn't show hand 
*** SUMMARY ***
Total pot $0.75 | Rake $0.03 
Board [3c 4s Qs]
Seat 1: senej folded before Flop (didn't bet)
Seat 2: D9_nvkz folded before Flop (didn't bet)
Seat 3: cj71754 (button) folded on the Flop
Seat 5: sólyom333 (small blind) folded before Flop
Seat 6: lemurrr2014 (big blind) collected ($0.72)



PokerStars Hand #222962906795:  Hold'em No Limit ($0.05/$0.10 USD) - 2021/01/23 13:10:43 ET
Table 'Shura III' 6-max Seat #5 is the button
Seat 1: senej ($20.93 in chips) 
Seat 2: D9_nvkz ($12.68 in chips) 
Seat 3: cj71754 ($7.25 in chips) 
Seat 4: grasu331 ($8 in chips) 
Seat 5: sólyom333 ($10.85 in chips) 
Seat 6: lemurrr2014 ($3.81 in chips) 
lemurrr2014: posts small blind $0.05
senej: posts big blind $0.10
grasu331: posts big blind $0.10
*** HOLE CARDS ***
D9_nvkz: folds 
cj71754: folds 
grasu331: checks 
sólyom333: raises $0.18 to $0.28
lemurrr2014: folds 
senej: folds 
grasu331: calls $0.18
*** FLOP *** [Th Ts 8d]
grasu331: bets $0.40
sólyom333: calls $0.40
*** TURN *** [Th Ts 8d] [3h]
grasu331: bets $0.72
sólyom333: folds 
Uncalled bet ($0.72) returned to grasu331
grasu331 collected $1.44 from pot
grasu331: doesn't show hand 
*** SUMMARY ***
Total pot $1.51 | Rake $0.07 
Board [Th Ts 8d 3h]
Seat 1: senej (big blind) folded before Flop
Seat 2: D9_nvkz folded before Flop (didn't bet)
Seat 3: cj71754 folded before Flop (didn't bet)
Seat 4: grasu331 collected ($1.44)
Seat 5: sólyom333 (button) folded on the Turn
Seat 6: lemurrr2014 (small blind) folded before Flop



PokerStars Hand #222962932450:  Hold'em No Limit ($0.05/$0.10 USD) - 2021/01/23 13:11:21 ET
Table 'Shura III' 6-max Seat #6 is the button
Seat 1: senej ($20.83 in chips) 
Seat 2: D9_nvkz ($12.68 in chips) 
Seat 3: cj71754 ($7.25 in chips) 
Seat 4: grasu331 ($8.76 in chips) 
Seat 5: sólyom333 ($10.17 in chips) 
Seat 6: lemurrr2014 ($3.76 in chips) 
senej: posts small blind $0.05
D9_nvkz: posts big blind $0.10
*** HOLE CARDS ***
cj71754: folds 
grasu331: calls $0.10
sólyom333: folds 
lemurrr2014: folds 
senej: raises $0.40 to $0.50
D9_nvkz: folds 
grasu331: calls $0.40
*** FLOP *** [9c 5h Td]
senej: bets $0.70
grasu331: folds 
Uncalled bet ($0.70) returned to senej
senej collected $1.05 from pot
senej: doesn't show hand 
*** SUMMARY ***
Total pot $1.10 | Rake $0.05 
Board [9c 5h Td]
Seat 1: senej (small blind) collected ($1.05)
Seat 2: D9_nvkz (big blind) folded before Flop
Seat 3: cj71754 folded before Flop (didn't bet)
Seat 4: grasu331 folded on the Flop
Seat 5: sólyom333 folded before Flop (didn't bet)
Seat 6: lemurrr2014 (button) folded before Flop (didn't bet)



PokerStars Hand #222962963006:  Hold'em No Limit ($0.05/$0.10 USD) - 2021/01/23 13:12:05 ET
Table 'Shura III' 6-max Seat #1 is the button
Seat 1: senej ($21.38 in chips) 
Seat 2: D9_nvkz ($12.58 in chips) 
Seat 3: cj71754 ($7.25 in chips) 
Seat 4: grasu331 ($8.26 in chips) 
Seat 5: sólyom333 ($10.17 in chips) 
Seat 6: lemurrr2014 ($3.76 in chips) 
D9_nvkz: posts small blind $0.05
cj71754: posts big blind $0.10
*** HOLE CARDS ***
grasu331: folds 
sólyom333: folds 
lemurrr2014: folds 
senej: raises $0.20 to $0.30
D9_nvkz: folds 
cj71754: folds 
Uncalled bet ($0.20) returned to senej
senej collected $0.25 from pot
senej: doesn't show hand 
*** SUMMARY ***
Total pot $0.25 | Rake $0 
Seat 1: senej (button) collected ($0.25)
Seat 2: D9_nvkz (small blind) folded before Flop
Seat 3: cj71754 (big blind) folded before Flop
Seat 4: grasu331 folded before Flop (didn't bet)
Seat 5: sólyom333 folded before Flop (didn't bet)
Seat 6: lemurrr2014 folded before Flop (didn't bet)



PokerStars Hand #222962969862:  Hold'em No Limit ($0.05/$0.10 USD) - 2021/01/23 13:12:15 ET
Table 'Shura III' 6-max Seat #2 is the button
Seat 1: senej ($21.53 in chips) 
Seat 2: D9_nvkz ($12.53 in chips) 
Seat 3: cj71754 ($7.15 in chips) 
Seat 4: grasu331 ($8.26 in chips) 
Seat 5: sólyom333 ($10.17 in chips) 
Seat 6: lemurrr2014 ($3.76 in chips) 
cj71754: posts small blind $0.05
grasu331: posts big blind $0.10
*** HOLE CARDS ***
sólyom333: raises $0.18 to $0.28
lemurrr2014: folds 
senej: folds 
D9_nvkz: folds 
cj71754: calls $0.23
grasu331: raises $0.18 to $0.46
sólyom333: calls $0.18
cj71754: folds 
*** FLOP *** [6s 9h 9d]
grasu331: bets $0.40
sólyom333: folds 
Uncalled bet ($0.40) returned to grasu331
grasu331 collected $1.15 from pot
grasu331: doesn't show hand 
*** SUMMARY ***
Total pot $1.20 | Rake $0.05 
Board [6s 9h 9d]
Seat 1: senej folded before Flop (didn't bet)
Seat 2: D9_nvkz (button) folded before Flop (didn't bet)
Seat 3: cj71754 (small blind) folded before Flop
Seat 4: grasu331 (big blind) collected ($1.15)
Seat 5: sólyom333 folded on the Flop
Seat 6: lemurrr2014 folded before Flop (didn't bet)



PokerStars Hand #222962993426:  Hold'em No Limit ($0.05/$0.10 USD) - 2021/01/23 13:12:49 ET
Table 'Shura III' 6-max Seat #3 is the button
Seat 1: senej ($21.53 in chips) 
Seat 2: D9_nvkz ($12.53 in chips) 
Seat 3: cj71754 ($6.87 in chips) 
Seat 4: grasu331 ($8.95 in chips) 
Seat 5: sólyom333 ($9.71 in chips) 
Seat 6: lemurrr2014 ($3.76 in chips) 
grasu331: posts small blind $0.05
sólyom333: posts big blind $0.10
*** HOLE CARDS ***
lemurrr2014: folds 
senej: folds 
D9_nvkz: folds 
cj71754: calls $0.10
grasu331: folds 
sólyom333: checks 
*** FLOP *** [Qs 6c Js]
sólyom333: checks 
senej leaves the table
cj71754: checks 
*** TURN *** [Qs 6c Js] [5d]
sólyom333: bets $0.21
KiraLasVegas joins the table at seat #1 
cj71754: calls $0.21
*** RIVER *** [Qs 6c Js 5d] [6s]
sólyom333: bets $0.43
cj71754: folds 
Uncalled bet ($0.43) returned to sólyom333
sólyom333 collected $0.64 from pot
sólyom333: doesn't show hand 
*** SUMMARY ***
Total pot $0.67 | Rake $0.03 
Board [Qs 6c Js 5d 6s]
Seat 1: senej folded before Flop (didn't bet)
Seat 2: D9_nvkz folded before Flop (didn't bet)
Seat 3: cj71754 (button) folded on the River
Seat 4: grasu331 (small blind) folded before Flop
Seat 5: sólyom333 (big blind) collected ($0.64)
Seat 6: lemurrr2014 folded before Flop (didn't bet)



PokerStars Hand #222963015361:  Hold'em No Limit ($0.05/$0.10 USD) - 2021/01/23 13:13:21 ET
Table 'Shura III' 6-max Seat #4 is the button
Seat 2: D9_nvkz ($12.53 in chips) 
Seat 3: cj71754 ($6.56 in chips) 
Seat 4: grasu331 ($8.90 in chips) 
Seat 5: sólyom333 ($10.04 in chips) 
Seat 6: lemurrr2014 ($3.76 in chips) 
sólyom333: posts small blind $0.05
lemurrr2014: posts big blind $0.10
KiraLasVegas: sits out 
*** HOLE CARDS ***
D9_nvkz: folds 
cj71754: folds 
grasu331: folds 
sólyom333: raises $0.20 to $0.30
lemurrr2014: folds 
Uncalled bet ($0.20) returned to sólyom333
sólyom333 collected $0.20 from pot
sólyom333: doesn't show hand 
*** SUMMARY ***
Total pot $0.20 | Rake $0 
Seat 2: D9_nvkz folded before Flop (didn't bet)
Seat 3: cj71754 folded before Flop (didn't bet)
Seat 4: grasu331 (button) folded before Flop (didn't bet)
Seat 5: sólyom333 (small blind) collected ($0.20)
Seat 6: lemurrr2014 (big blind) folded before Flop



PokerStars Hand #222963029020:  Hold'em No Limit ($0.05/$0.10 USD) - 2021/01/23 13:13:41 ET
Table 'Shura III' 6-max Seat #5 is the button
Seat 1: KiraLasVegas ($10 in chips) 
Seat 2: D9_nvkz ($12.53 in chips) 
Seat 3: cj71754 ($6.56 in chips) 
Seat 4: grasu331 ($8.90 in chips) 
Seat 5: sólyom333 ($10.14 in chips) 
Seat 6: lemurrr2014 ($3.66 in chips) 
lemurrr2014: posts small blind $0.05
KiraLasVegas: posts big blind $0.10
*** HOLE CARDS ***
D9_nvkz: folds 
cj71754: folds 
grasu331: raises $0.10 to $0.20
sólyom333: calls $0.20
lemurrr2014: raises $0.70 to $0.90
KiraLasVegas: folds 
grasu331: calls $0.70
sólyom333: folds 
*** FLOP *** [9c Js As]
lemurrr2014: bets $1
grasu331: folds 
Uncalled bet ($1) returned to lemurrr2014
lemurrr2014 collected $2.01 from pot
lemurrr2014: doesn't show hand 
*** SUMMARY ***
Total pot $2.10 | Rake $0.09 
Board [9c Js As]
Seat 1: KiraLasVegas (big blind) folded before Flop
Seat 2: D9_nvkz folded before Flop (didn't bet)
Seat 3: cj71754 folded before Flop (didn't bet)
Seat 4: grasu331 folded on the Flop
Seat 5: sólyom333 (button) folded before Flop
Seat 6: lemurrr2014 (small blind) collected ($2.01)



PokerStars Hand #222963054424:  Hold'em No Limit ($0.05/$0.10 USD) - 2021/01/23 13:14:19 ET
Table 'Shura III' 6-max Seat #6 is the button
Seat 1: KiraLasVegas ($10 in chips) 
Seat 2: D9_nvkz ($12.53 in chips) 
Seat 3: cj71754 ($6.56 in chips) 
Seat 4: grasu331 ($8 in chips) 
Seat 5: sólyom333 ($9.94 in chips) 
Seat 6: lemurrr2014 ($4.77 in chips) 
KiraLasVegas: posts small blind $0.05
D9_nvkz: posts big blind $0.10
*** HOLE CARDS ***
cj71754: folds 
grasu331: folds 
sólyom333: folds 
lemurrr2014: folds 
KiraLasVegas: folds 
Uncalled bet ($0.05) returned to D9_nvkz
D9_nvkz collected $0.10 from pot
D9_nvkz: doesn't show hand 
*** SUMMARY ***
Total pot $0.10 | Rake $0 
Seat 1: KiraLasVegas (small blind) folded before Flop
Seat 2: D9_nvkz (big blind) collected ($0.10)
Seat 3: cj71754 folded before Flop (didn't bet)
Seat 4: grasu331 folded before Flop (didn't bet)
Seat 5: sólyom333 folded before Flop (didn't bet)
Seat 6: lemurrr2014 (button) folded before Flop (didn't bet)



PokerStars Hand #222963062504:  Hold'em No Limit ($0.05/$0.10 USD) - 2021/01/23 13:14:31 ET
Table 'Shura III' 6-max Seat #1 is the button
Seat 1: KiraLasVegas ($10 in chips) 
Seat 2: D9_nvkz ($12.58 in chips) 
Seat 3: cj71754 ($6.56 in chips) 
Seat 4: grasu331 ($8 in chips) 
Seat 5: sólyom333 ($9.94 in chips) 
Seat 6: lemurrr2014 ($4.77 in chips) 
D9_nvkz: posts small blind $0.05
cj71754: posts big blind $0.10
*** HOLE CARDS ***
grasu331: calls $0.10
sólyom333: folds 
lemurrr2014: raises $0.35 to $0.45
KiraLasVegas: folds 
D9_nvkz: folds 
cj71754: calls $0.35
grasu331: folds 
*** FLOP *** [3d 6c As]
cj71754: bets $0.50
lemurrr2014: calls $0.50
*** TURN *** [3d 6c As] [4d]
cj71754: checks 
lemurrr2014: bets $0.98
cj71754: calls $0.98
*** RIVER *** [3d 6c As 4d] [Qc]
cj71754: checks 
lemurrr2014: checks 
*** SHOW DOWN ***
cj71754: shows [Qh Qs] (three of a kind, Queens)
lemurrr2014: mucks hand 
cj71754 collected $3.83 from pot
*** SUMMARY ***
Total pot $4.01 | Rake $0.18 
Board [3d 6c As 4d Qc]
Seat 1: KiraLasVegas (button) folded before Flop (didn't bet)
Seat 2: D9_nvkz (small blind) folded before Flop
Seat 3: cj71754 (big blind) showed [Qh Qs] and won ($3.83) with three of a kind, Queens
Seat 4: grasu331 folded before Flop
Seat 5: sólyom333 folded before Flop (didn't bet)
Seat 6: lemurrr2014 mucked



PokerStars Hand #222963109932:  Hold'em No Limit ($0.05/$0.10 USD) - 2021/01/23 13:15:26 ET
Table 'Shura III' 6-max Seat #2 is the button
Seat 1: KiraLasVegas ($10 in chips) 
Seat 2: D9_nvkz ($12.53 in chips) 
Seat 3: cj71754 ($8.46 in chips) 
Seat 4: grasu331 ($7.90 in chips) 
Seat 5: sólyom333 ($9.94 in chips) 
Seat 6: lemurrr2014 ($2.84 in chips) 
cj71754: posts small blind $0.05
grasu331: posts big blind $0.10
*** HOLE CARDS ***
sólyom333: raises $0.18 to $0.28
lemurrr2014: folds 
KiraLasVegas: folds 
D9_nvkz: calls $0.28
cj71754: folds 
grasu331: folds 
*** FLOP *** [8d Ah 6c]
sólyom333: checks 
D9_nvkz: checks 
*** TURN *** [8d Ah 6c] [Kc]
sólyom333: bets $0.45
D9_nvkz: folds 
Uncalled bet ($0.45) returned to sólyom333
sólyom333 collected $0.68 from pot
sólyom333: doesn't show hand 
*** SUMMARY ***
Total pot $0.71 | Rake $0.03 
Board [8d Ah 6c Kc]
Seat 1: KiraLasVegas folded before Flop (didn't bet)
Seat 2: D9_nvkz (button) folded on the Turn
Seat 3: cj71754 (small blind) folded before Flop
Seat 4: grasu331 (big blind) folded before Flop
Seat 5: sólyom333 collected ($0.68)
Seat 6: lemurrr2014 folded before Flop (didn't bet)



PokerStars Hand #222963132706:  Hold'em No Limit ($0.05/$0.10 USD) - 2021/01/23 13:15:56 ET
Table 'Shura III' 6-max Seat #3 is the button
Seat 1: KiraLasVegas ($10 in chips) 
Seat 2: D9_nvkz ($12.25 in chips) 
Seat 3: cj71754 ($8.41 in chips) 
Seat 4: grasu331 ($7.80 in chips) 
Seat 5: sólyom333 ($10.34 in chips) 
Seat 6: lemurrr2014 ($2.84 in chips) 
grasu331: posts small blind $0.05
sólyom333: posts big blind $0.10
*** HOLE CARDS ***
lemurrr2014: calls $0.10
KiraLasVegas: folds 
D9_nvkz: folds 
cj71754: calls $0.10
grasu331: calls $0.05
sólyom333: checks 
*** FLOP *** [5h 3s 3d]
grasu331: checks 
sólyom333: checks 
lemurrr2014: checks 
cj71754: checks 
*** TURN *** [5h 3s 3d] [4c]
grasu331: checks 
sólyom333: checks 
lemurrr2014: checks 
cj71754: checks 
*** RIVER *** [5h 3s 3d 4c] [Ad]
grasu331: checks 
sólyom333: bets $0.33
lemurrr2014: folds 
cj71754: folds 
grasu331: folds 
Uncalled bet ($0.33) returned to sólyom333
sólyom333 collected $0.38 from pot
sólyom333: doesn't show hand 
*** SUMMARY ***
Total pot $0.40 | Rake $0.02 
Board [5h 3s 3d 4c Ad]
Seat 1: KiraLasVegas folded before Flop (didn't bet)
Seat 2: D9_nvkz folded before Flop (didn't bet)
Seat 3: cj71754 (button) folded on the River
Seat 4: grasu331 (small blind) folded on the River
Seat 5: sólyom333 (big blind) collected ($0.38)
Seat 6: lemurrr2014 folded on the River



PokerStars Hand #222963181032:  Hold'em No Limit ($0.05/$0.10 USD) - 2021/01/23 13:17:02 ET
Table 'Shura III' 6-max Seat #4 is the button
Seat 1: KiraLasVegas ($10 in chips) 
Seat 2: D9_nvkz ($12.25 in chips) 
Seat 3: cj71754 ($8.31 in chips) 
Seat 4: grasu331 ($7.70 in chips) 
Seat 5: sólyom333 ($10.62 in chips) 
Seat 6: lemurrr2014 ($2.74 in chips) 
sólyom333: posts small blind $0.05
lemurrr2014: posts big blind $0.10
*** HOLE CARDS ***
KiraLasVegas: raises $0.20 to $0.30
D9_nvkz: folds 
cj71754: folds 
grasu331: folds 
sólyom333: folds 
lemurrr2014: folds 
Uncalled bet ($0.20) returned to KiraLasVegas
KiraLasVegas collected $0.25 from pot
KiraLasVegas: doesn't show hand 
*** SUMMARY ***
Total pot $0.25 | Rake $0 
Seat 1: KiraLasVegas collected ($0.25)
Seat 2: D9_nvkz folded before Flop (didn't bet)
Seat 3: cj71754 folded before Flop (didn't bet)
Seat 4: grasu331 (button) folded before Flop (didn't bet)
Seat 5: sólyom333 (small blind) folded before Flop
Seat 6: lemurrr2014 (big blind) folded before Flop



PokerStars Hand #222963205653:  Hold'em No Limit ($0.05/$0.10 USD) - 2021/01/23 13:17:24 ET
Table 'Shura III' 6-max Seat #5 is the button
Seat 1: KiraLasVegas ($10.15 in chips) 
Seat 2: D9_nvkz ($12.25 in chips) 
Seat 3: cj71754 ($8.31 in chips) 
Seat 4: grasu331 ($7.70 in chips) 
Seat 5: sólyom333 ($10.57 in chips) 
Seat 6: lemurrr2014 ($2.64 in chips) 
lemurrr2014: posts small blind $0.05
KiraLasVegas: posts big blind $0.10
*** HOLE CARDS ***
D9_nvkz: folds 
cj71754: folds 
grasu331: raises $0.30 to $0.40
sólyom333: calls $0.40
lemurrr2014: calls $0.35
KiraLasVegas: folds 
*** FLOP *** [4h 3s 9d]
lemurrr2014: checks 
grasu331: checks 
sólyom333: checks 
*** TURN *** [4h 3s 9d] [Ad]
lemurrr2014: checks 
grasu331: bets $0.10
sólyom333: calls $0.10
lemurrr2014: raises $0.77 to $0.87
grasu331: folds 
sólyom333: folds 
Uncalled bet ($0.77) returned to lemurrr2014
lemurrr2014 collected $1.53 from pot
lemurrr2014: doesn't show hand 
*** SUMMARY ***
Total pot $1.60 | Rake $0.07 
Board [4h 3s 9d Ad]
Seat 1: KiraLasVegas (big blind) folded before Flop
Seat 2: D9_nvkz folded before Flop (didn't bet)
Seat 3: cj71754 folded before Flop (didn't bet)
Seat 4: grasu331 folded on the Turn
Seat 5: sólyom333 (button) folded on the Turn
Seat 6: lemurrr2014 (small blind) collected ($1.53)



PokerStars Hand #222963246145:  Hold'em No Limit ($0.05/$0.10 USD) - 2021/01/23 13:18:19 ET
Table 'Shura III' 6-max Seat #6 is the button
Seat 1: KiraLasVegas ($10.05 in chips) 
Seat 2: D9_nvkz ($12.25 in chips) 
Seat 3: cj71754 ($8.31 in chips) 
Seat 4: grasu331 ($7.20 in chips) 
Seat 5: sólyom333 ($10.07 in chips) 
Seat 6: lemurrr2014 ($3.67 in chips) 
KiraLasVegas: posts small blind $0.05
D9_nvkz: posts big blind $0.10
*** HOLE CARDS ***
cj71754: calls $0.10
grasu331: raises $0.10 to $0.20
sólyom333: folds 
lemurrr2014: calls $0.20
KiraLasVegas: folds 
D9_nvkz: folds 
cj71754: calls $0.10
*** FLOP *** [5h Ad 3s]
cj71754: bets $0.36
grasu331: raises $0.36 to $0.72
lemurrr2014: folds 
cj71754: calls $0.36
*** TURN *** [5h Ad 3s] [Td]
cj71754: checks 
grasu331: bets $0.50
cj71754: folds 
Uncalled bet ($0.50) returned to grasu331
grasu331 collected $2.09 from pot
grasu331: doesn't show hand 
*** SUMMARY ***
Total pot $2.19 | Rake $0.10 
Board [5h Ad 3s Td]
Seat 1: KiraLasVegas (small blind) folded before Flop
Seat 2: D9_nvkz (big blind) folded before Flop
Seat 3: cj71754 folded on the Turn
Seat 4: grasu331 collected ($2.09)
Seat 5: sólyom333 folded before Flop (didn't bet)
Seat 6: lemurrr2014 (button) folded on the Flop



PokerStars Hand #222963297849:  Hold'em No Limit ($0.05/$0.10 USD) - 2021/01/23 13:19:28 ET
Table 'Shura III' 6-max Seat #1 is the button
Seat 1: KiraLasVegas ($10 in chips) 
Seat 2: D9_nvkz ($12.15 in chips) 
Seat 3: cj71754 ($7.39 in chips) 
Seat 4: grasu331 ($8.37 in chips) 
Seat 5: sólyom333 ($10.07 in chips) 
Seat 6: lemurrr2014 ($3.47 in chips) 
D9_nvkz: posts small blind $0.05
cj71754: posts big blind $0.10
*** HOLE CARDS ***
grasu331: raises $0.20 to $0.30
sólyom333: calls $0.30
lemurrr2014: folds 
KiraLasVegas: folds 
D9_nvkz: folds 
cj71754: folds 
*** FLOP *** [Jh 2s Qh]
grasu331: bets $0.10
sólyom333: raises $0.39 to $0.49
grasu331: calls $0.39
*** TURN *** [Jh 2s Qh] [Ac]
grasu331: checks 
sólyom333: checks 
*** RIVER *** [Jh 2s Qh Ac] [2c]
grasu331: checks 
sólyom333: checks 
*** SHOW DOWN ***
grasu331: shows [Jd Kc] (two pair, Jacks and Deuces)
sólyom333: mucks hand 
grasu331 collected $1.65 from pot
*** SUMMARY ***
Total pot $1.73 | Rake $0.08 
Board [Jh 2s Qh Ac 2c]
Seat 1: KiraLasVegas (button) folded before Flop (didn't bet)
Seat 2: D9_nvkz (small blind) folded before Flop
Seat 3: cj71754 (big blind) folded before Flop
Seat 4: grasu331 showed [Jd Kc] and won ($1.65) with two pair, Jacks and Deuces
Seat 5: sólyom333 mucked
Seat 6: lemurrr2014 folded before Flop (didn't bet)



PokerStars Hand #222963340099:  Hold'em No Limit ($0.05/$0.10 USD) - 2021/01/23 13:20:24 ET
Table 'Shura III' 6-max Seat #2 is the button
Seat 1: KiraLasVegas ($10 in chips) 
Seat 2: D9_nvkz ($12.10 in chips) 
Seat 3: cj71754 ($7.29 in chips) 
Seat 4: grasu331 ($9.23 in chips) 
Seat 5: sólyom333 ($9.28 in chips) 
Seat 6: lemurrr2014 ($3.47 in chips) 
cj71754: posts small blind $0.05
grasu331: posts big blind $0.10
*** HOLE CARDS ***
sólyom333: folds 
lemurrr2014: folds 
KiraLasVegas: folds 
D9_nvkz: folds 
cj71754: raises $0.10 to $0.20
grasu331: calls $0.10
*** FLOP *** [2c Js Ah]
cj71754: bets $0.30
grasu331: folds 
Uncalled bet ($0.30) returned to cj71754
cj71754 collected $0.38 from pot
cj71754: doesn't show hand 
*** SUMMARY ***
Total pot $0.40 | Rake $0.02 
Board [2c Js Ah]
Seat 1: KiraLasVegas folded before Flop (didn't bet)
Seat 2: D9_nvkz (button) folded before Flop (didn't bet)
Seat 3: cj71754 (small blind) collected ($0.38)
Seat 4: grasu331 (big blind) folded on the Flop
Seat 5: sólyom333 folded before Flop (didn't bet)
Seat 6: lemurrr2014 folded before Flop (didn't bet)



PokerStars Hand #222963362284:  Hold'em No Limit ($0.05/$0.10 USD) - 2021/01/23 13:20:53 ET
Table 'Shura III' 6-max Seat #3 is the button
Seat 1: KiraLasVegas ($10 in chips) 
Seat 2: D9_nvkz ($12.10 in chips) 
Seat 3: cj71754 ($7.47 in chips) 
Seat 4: grasu331 ($9.03 in chips) 
Seat 5: sólyom333 ($9.28 in chips) 
Seat 6: lemurrr2014 ($3.47 in chips) 
grasu331: posts small blind $0.05
sólyom333: posts big blind $0.10
*** HOLE CARDS ***
lemurrr2014: folds 
KiraLasVegas: folds 
D9_nvkz: folds 
cj71754: calls $0.10
grasu331: calls $0.05
sólyom333: raises $0.35 to $0.45
cj71754: calls $0.35
grasu331: folds 
*** FLOP *** [Jc Js 7c]
sólyom333: checks 
cj71754: checks 
*** TURN *** [Jc Js 7c] [Kh]
sólyom333: checks 
cj71754: bets $0.96
sólyom333: folds 
Uncalled bet ($0.96) returned to cj71754
cj71754 collected $0.96 from pot
cj71754: doesn't show hand 
*** SUMMARY ***
Total pot $1 | Rake $0.04 
Board [Jc Js 7c Kh]
Seat 1: KiraLasVegas folded before Flop (didn't bet)
Seat 2: D9_nvkz folded before Flop (didn't bet)
Seat 3: cj71754 (button) collected ($0.96)
Seat 4: grasu331 (small blind) folded before Flop
Seat 5: sólyom333 (big blind) folded on the Turn
Seat 6: lemurrr2014 folded before Flop (didn't bet)



PokerStars Hand #222963406056:  Hold'em No Limit ($0.05/$0.10 USD) - 2021/01/23 13:21:52 ET
Table 'Shura III' 6-max Seat #4 is the button
Seat 1: KiraLasVegas ($10 in chips) 
Seat 2: D9_nvkz ($12.10 in chips) 
Seat 3: cj71754 ($7.98 in chips) 
Seat 4: grasu331 ($8.93 in chips) 
Seat 5: sólyom333 ($10 in chips) 
Seat 6: lemurrr2014 ($3.47 in chips) 
sólyom333: posts small blind $0.05
lemurrr2014: posts big blind $0.10
*** HOLE CARDS ***
KiraLasVegas: folds 
KiraLasVegas leaves the table
D9_nvkz: folds 
tab1988242 joins the table at seat #1 
cj71754: raises $0.20 to $0.30
grasu331: calls $0.30
sólyom333: folds 
lemurrr2014: folds 
*** FLOP *** [4s 2s Jc]
cj71754: bets $0.72
grasu331: folds 
Uncalled bet ($0.72) returned to cj71754
cj71754 collected $0.72 from pot
cj71754: doesn't show hand 
*** SUMMARY ***
Total pot $0.75 | Rake $0.03 
Board [4s 2s Jc]
Seat 1: KiraLasVegas folded before Flop (didn't bet)
Seat 2: D9_nvkz folded before Flop (didn't bet)
Seat 3: cj71754 collected ($0.72)
Seat 4: grasu331 (button) folded on the Flop
Seat 5: sólyom333 (small blind) folded before Flop
Seat 6: lemurrr2014 (big blind) folded before Flop



PokerStars Hand #222963432540:  Hold'em No Limit ($0.05/$0.10 USD) - 2021/01/23 13:22:27 ET
Table 'Shura III' 6-max Seat #5 is the button
Seat 2: D9_nvkz ($12.10 in chips) 
Seat 3: cj71754 ($8.40 in chips) 
Seat 4: grasu331 ($8.63 in chips) 
Seat 5: sólyom333 ($9.95 in chips) 
lemurrr2014 has timed out
lemurrr2014: is sitting out 
tab1988242 will be allowed to play after the button
D9_nvkz: posts small blind $0.05
cj71754: posts big blind $0.10
*** HOLE CARDS ***
grasu331: folds 
sólyom333: folds 
D9_nvkz: raises $0.20 to $0.30
cj71754: calls $0.20
*** FLOP *** [8c 9d 2s]
lemurrr2014 is disconnected 
D9_nvkz: bets $0.28
cj71754: folds 
Uncalled bet ($0.28) returned to D9_nvkz
D9_nvkz collected $0.57 from pot
D9_nvkz: doesn't show hand 
*** SUMMARY ***
Total pot $0.60 | Rake $0.03 
Board [8c 9d 2s]
Seat 2: D9_nvkz (small blind) collected ($0.57)
Seat 3: cj71754 (big blind) folded on the Flop
Seat 4: grasu331 folded before Flop (didn't bet)
Seat 5: sólyom333 (button) folded before Flop (didn't bet)



PokerStars Hand #222963461701:  Hold'em No Limit ($0.05/$0.10 USD) - 2021/01/23 13:23:06 ET
Table 'Shura III' 6-max Seat #2 is the button
Seat 2: D9_nvkz ($12.37 in chips) 
Seat 3: cj71754 ($8.10 in chips) 
Seat 4: grasu331 ($8.63 in chips) 
Seat 5: sólyom333 ($9.95 in chips) 
cj71754: posts small blind $0.05
grasu331: posts big blind $0.10
tab1988242: sits out 
*** HOLE CARDS ***
sólyom333: folds 
D9_nvkz: raises $0.20 to $0.30
cj71754: folds 
grasu331: folds 
Uncalled bet ($0.20) returned to D9_nvkz
D9_nvkz collected $0.25 from pot
D9_nvkz: doesn't show hand 
*** SUMMARY ***
Total pot $0.25 | Rake $0 
Seat 2: D9_nvkz (button) collected ($0.25)
Seat 3: cj71754 (small blind) folded before Flop
Seat 4: grasu331 (big blind) folded before Flop
Seat 5: sólyom333 folded before Flop (didn't bet)



PokerStars Hand #222963471688:  Hold'em No Limit ($0.05/$0.10 USD) - 2021/01/23 13:23:19 ET
Table 'Shura III' 6-max Seat #3 is the button
Seat 2: D9_nvkz ($12.52 in chips) 
Seat 3: cj71754 ($8.05 in chips) 
Seat 4: grasu331 ($8.53 in chips) 
Seat 5: sólyom333 ($9.95 in chips) 
Seat 6: lemurrr2014 ($3.37 in chips) 
grasu331: posts small blind $0.05
sólyom333: posts big blind $0.10
lemurrr2014: posts small blind $0.05
tab1988242: sits out 
*** HOLE CARDS ***
lemurrr2014: folds 
D9_nvkz: folds 
cj71754: folds 
grasu331: calls $0.05
sólyom333: checks 
*** FLOP *** [6c Tc 3h]
grasu331: bets $0.10
sólyom333: raises $0.18 to $0.28
grasu331: calls $0.18
*** TURN *** [6c Tc 3h] [9s]
grasu331: bets $0.38
sólyom333: calls $0.38
*** RIVER *** [6c Tc 3h 9s] [Ac]
grasu331: bets $0.75
sólyom333: folds 
Uncalled bet ($0.75) returned to grasu331
grasu331 collected $1.50 from pot
grasu331: doesn't show hand 
*** SUMMARY ***
Total pot $1.57 | Rake $0.07 
Board [6c Tc 3h 9s Ac]
Seat 2: D9_nvkz folded before Flop (didn't bet)
Seat 3: cj71754 (button) folded before Flop (didn't bet)
Seat 4: grasu331 (small blind) collected ($1.50)
Seat 5: sólyom333 (big blind) folded on the River
Seat 6: lemurrr2014 folded before Flop (didn't bet)



PokerStars Hand #222963499877:  Hold'em No Limit ($0.05/$0.10 USD) - 2021/01/23 13:23:56 ET
Table 'Shura III' 6-max Seat #4 is the button
Seat 2: D9_nvkz ($12.52 in chips) 
Seat 3: cj71754 ($8.05 in chips) 
Seat 4: grasu331 ($9.27 in chips) 
Seat 5: sólyom333 ($9.19 in chips) 
Seat 6: lemurrr2014 ($3.32 in chips) 
sólyom333: posts small blind $0.05
lemurrr2014: posts big blind $0.10
tab1988242: sits out 
*** HOLE CARDS ***
D9_nvkz: folds 
cj71754: folds 
grasu331: calls $0.10
sólyom333: folds 
lemurrr2014: raises $0.10 to $0.20
grasu331: calls $0.10
*** FLOP *** [8s 7c Qh]
lemurrr2014: bets $0.21
grasu331: calls $0.21
*** TURN *** [8s 7c Qh] [2s]
lemurrr2014: bets $0.41
grasu331: folds 
Uncalled bet ($0.41) returned to lemurrr2014
lemurrr2014 collected $0.83 from pot
lemurrr2014: doesn't show hand 
*** SUMMARY ***
Total pot $0.87 | Rake $0.04 
Board [8s 7c Qh 2s]
Seat 2: D9_nvkz folded before Flop (didn't bet)
Seat 3: cj71754 folded before Flop (didn't bet)
Seat 4: grasu331 (button) folded on the Turn
Seat 5: sólyom333 (small blind) folded before Flop
Seat 6: lemurrr2014 (big blind) collected ($0.83)



PokerStars Hand #222963517250:  Hold'em No Limit ($0.05/$0.10 USD) - 2021/01/23 13:24:19 ET
Table 'Shura III' 6-max Seat #5 is the button
Seat 1: tab1988242 ($10 in chips) 
Seat 2: D9_nvkz ($12.52 in chips) 
Seat 3: cj71754 ($8.05 in chips) 
Seat 4: grasu331 ($8.86 in chips) 
Seat 5: sólyom333 ($9.14 in chips) 
Seat 6: lemurrr2014 ($3.74 in chips) 
lemurrr2014: posts small blind $0.05
tab1988242: posts big blind $0.10
*** HOLE CARDS ***
D9_nvkz: folds 
cj71754 has timed out
cj71754: folds 
grasu331: calls $0.10
sólyom333: raises $0.18 to $0.28
lemurrr2014: folds 
tab1988242: folds 
grasu331: calls $0.18
*** FLOP *** [9h 3h Ac]
grasu331: checks 
sólyom333: bets $0.29
grasu331: calls $0.29
*** TURN *** [9h 3h Ac] [Tc]
grasu331: checks 
sólyom333: bets $0.82
grasu331: folds 
Uncalled bet ($0.82) returned to sólyom333
sólyom333 collected $1.23 from pot
sólyom333: doesn't show hand 
*** SUMMARY ***
Total pot $1.29 | Rake $0.06 
Board [9h 3h Ac Tc]
Seat 1: tab1988242 (big blind) folded before Flop
Seat 2: D9_nvkz folded before Flop (didn't bet)
Seat 3: cj71754 folded before Flop (didn't bet)
Seat 4: grasu331 folded on the Turn
Seat 5: sólyom333 (button) collected ($1.23)
Seat 6: lemurrr2014 (small blind) folded before Flop



PokerStars Hand #222963551921:  Hold'em No Limit ($0.05/$0.10 USD) - 2021/01/23 13:25:05 ET
Table 'Shura III' 6-max Seat #6 is the button
Seat 1: tab1988242 ($10 in chips) 
Seat 2: D9_nvkz ($12.52 in chips) 
Seat 3: cj71754 ($8.05 in chips) 
Seat 4: grasu331 ($8.29 in chips) 
Seat 5: sólyom333 ($9.80 in chips) 
Seat 6: lemurrr2014 ($3.69 in chips) 
tab1988242: posts small blind $0.05
D9_nvkz: posts big blind $0.10
*** HOLE CARDS ***
cj71754: calls $0.10
grasu331: raises $0.10 to $0.20
sólyom333: folds 
lemurrr2014: folds 
tab1988242: folds 
D9_nvkz: calls $0.10
cj71754: calls $0.10
*** FLOP *** [6h Jc As]
D9_nvkz: checks 
cj71754: bets $0.31
grasu331: folds 
D9_nvkz: folds 
Uncalled bet ($0.31) returned to cj71754
cj71754 collected $0.62 from pot
cj71754: doesn't show hand 
*** SUMMARY ***
Total pot $0.65 | Rake $0.03 
Board [6h Jc As]
Seat 1: tab1988242 (small blind) folded before Flop
Seat 2: D9_nvkz (big blind) folded on the Flop
Seat 3: cj71754 collected ($0.62)
Seat 4: grasu331 folded on the Flop
Seat 5: sólyom333 folded before Flop (didn't bet)
Seat 6: lemurrr2014 (button) folded before Flop (didn't bet)



PokerStars Hand #222963574198:  Hold'em No Limit ($0.05/$0.10 USD) - 2021/01/23 13:25:34 ET
Table 'Shura III' 6-max Seat #1 is the button
Seat 1: tab1988242 ($10 in chips) 
Seat 2: D9_nvkz ($12.32 in chips) 
Seat 3: cj71754 ($8.47 in chips) 
Seat 4: grasu331 ($8.09 in chips) 
Seat 5: sólyom333 ($9.80 in chips) 
Seat 6: lemurrr2014 ($3.69 in chips) 
D9_nvkz: posts small blind $0.05
cj71754: posts big blind $0.10
*** HOLE CARDS ***
grasu331: raises $0.10 to $0.20
sólyom333: folds 
lemurrr2014: calls $0.20
tab1988242: calls $0.20
D9_nvkz: calls $0.15
cj71754: calls $0.10
*** FLOP *** [7d 2d 4c]
D9_nvkz: checks 
cj71754: bets $0.50
grasu331: folds 
lemurrr2014: folds 
tab1988242: calls $0.50
D9_nvkz: folds 
*** TURN *** [7d 2d 4c] [9c]
cj71754: bets $0.95
tab1988242: folds 
Uncalled bet ($0.95) returned to cj71754
cj71754 collected $1.91 from pot
cj71754: doesn't show hand 
*** SUMMARY ***
Total pot $2 | Rake $0.09 
Board [7d 2d 4c 9c]
Seat 1: tab1988242 (button) folded on the Turn
Seat 2: D9_nvkz (small blind) folded on the Flop
Seat 3: cj71754 (big blind) collected ($1.91)
Seat 4: grasu331 folded on the Flop
Seat 5: sólyom333 folded before Flop (didn't bet)
Seat 6: lemurrr2014 folded on the Flop



PokerStars Hand #222963634851:  Hold'em No Limit ($0.05/$0.10 USD) - 2021/01/23 13:26:54 ET
Table 'Shura III' 6-max Seat #2 is the button
Seat 1: tab1988242 ($10 in chips) 
Seat 2: D9_nvkz ($12.12 in chips) 
Seat 3: cj71754 ($9.68 in chips) 
Seat 4: grasu331 ($7.89 in chips) 
Seat 5: sólyom333 ($9.80 in chips) 
Seat 6: lemurrr2014 ($3.49 in chips) 
cj71754: posts small blind $0.05
grasu331: posts big blind $0.10
*** HOLE CARDS ***
sólyom333: folds 
lemurrr2014: calls $0.10
tab1988242: folds 
D9_nvkz: folds 
cj71754: calls $0.05
grasu331: checks 
*** FLOP *** [8h 2s 8s]
cj71754: checks 
grasu331: checks 
lemurrr2014: checks 
*** TURN *** [8h 2s 8s] [5s]
cj71754: checks 
grasu331: checks 
lemurrr2014: checks 
*** RIVER *** [8h 2s 8s 5s] [4c]
cj71754: checks 
grasu331: checks 
lemurrr2014: checks 
*** SHOW DOWN ***
cj71754: shows [6d Qc] (a pair of Eights)
grasu331: mucks hand 
lemurrr2014: shows [Td Kd] (a pair of Eights - King kicker)
lemurrr2014 collected $0.29 from pot
*** SUMMARY ***
Total pot $0.30 | Rake $0.01 
Board [8h 2s 8s 5s 4c]
Seat 1: tab1988242 folded before Flop (didn't bet)
Seat 2: D9_nvkz (button) folded before Flop (didn't bet)
Seat 3: cj71754 (small blind) showed [6d Qc] and lost with a pair of Eights
Seat 4: grasu331 (big blind) mucked
Seat 5: sólyom333 folded before Flop (didn't bet)
Seat 6: lemurrr2014 showed [Td Kd] and won ($0.29) with a pair of Eights



PokerStars Hand #222963667629:  Hold'em No Limit ($0.05/$0.10 USD) - 2021/01/23 13:27:38 ET
Table 'Shura III' 6-max Seat #3 is the button
Seat 1: tab1988242 ($10 in chips) 
Seat 2: D9_nvkz ($12.12 in chips) 
Seat 3: cj71754 ($9.58 in chips) 
Seat 4: grasu331 ($7.79 in chips) 
Seat 5: sólyom333 ($9.80 in chips) 
Seat 6: lemurrr2014 ($3.68 in chips) 
grasu331: posts small blind $0.05
sólyom333: posts big blind $0.10
*** HOLE CARDS ***
lemurrr2014: folds 
tab1988242: folds 
D9_nvkz: raises $0.20 to $0.30
cj71754: folds 
grasu331: calls $0.25
sólyom333: folds 
*** FLOP *** [Qh 2s Ah]
grasu331: checks 
D9_nvkz: bets $0.33
grasu331: calls $0.33
*** TURN *** [Qh 2s Ah] [8d]
grasu331: checks 
D9_nvkz: bets $0.95
grasu331: calls $0.95
*** RIVER *** [Qh 2s Ah 8d] [2d]
grasu331: checks 
D9_nvkz: bets $1.95
grasu331: calls $1.95
*** SHOW DOWN ***
D9_nvkz: shows [Kc Ad] (two pair, Aces and Deuces)
grasu331: mucks hand 
D9_nvkz collected $6.84 from pot
*** SUMMARY ***
Total pot $7.16 | Rake $0.32 
Board [Qh 2s Ah 8d 2d]
Seat 1: tab1988242 folded before Flop (didn't bet)
Seat 2: D9_nvkz showed [Kc Ad] and won ($6.84) with two pair, Aces and Deuces
Seat 3: cj71754 (button) folded before Flop (didn't bet)
Seat 4: grasu331 (small blind) mucked
Seat 5: sólyom333 (big blind) folded before Flop
Seat 6: lemurrr2014 folded before Flop (didn't bet)



PokerStars Hand #222963713953:  Hold'em No Limit ($0.05/$0.10 USD) - 2021/01/23 13:28:39 ET
Table 'Shura III' 6-max Seat #4 is the button
Seat 1: tab1988242 ($10 in chips) 
Seat 2: D9_nvkz ($15.43 in chips) 
Seat 3: cj71754 ($9.58 in chips) 
Seat 4: grasu331 ($4.26 in chips) 
Seat 5: sólyom333 ($9.70 in chips) 
Seat 6: lemurrr2014 ($3.68 in chips) 
sólyom333: posts small blind $0.05
lemurrr2014: posts big blind $0.10
*** HOLE CARDS ***
tab1988242: folds 
D9_nvkz: raises $0.20 to $0.30
cj71754: folds 
grasu331: calls $0.30
sólyom333: calls $0.25
lemurrr2014: folds 
*** FLOP *** [2c Th 4h]
sólyom333: checks 
tab1988242 leaves the table
D9_nvkz: bets $0.68
grasu331: raises $3.28 to $3.96 and is all-in
ShaunMM joins the table at seat #1 
sólyom333: folds 
D9_nvkz: calls $3.28
*** TURN *** [2c Th 4h] [Td]
*** RIVER *** [2c Th 4h Td] [Jd]
*** SHOW DOWN ***
D9_nvkz: shows [Kc Ks] (two pair, Kings and Tens)
grasu331: shows [5h 8s] (a pair of Tens)
D9_nvkz collected $8.52 from pot
*** SUMMARY ***
Total pot $8.92 | Rake $0.40 
Board [2c Th 4h Td Jd]
Seat 1: tab1988242 folded before Flop (didn't bet)
Seat 2: D9_nvkz showed [Kc Ks] and won ($8.52) with two pair, Kings and Tens
Seat 3: cj71754 folded before Flop (didn't bet)
Seat 4: grasu331 (button) showed [5h 8s] and lost with a pair of Tens
Seat 5: sólyom333 (small blind) folded on the Flop
Seat 6: lemurrr2014 (big blind) folded before Flop



PokerStars Hand #222963744312:  Hold'em No Limit ($0.05/$0.10 USD) - 2021/01/23 13:29:19 ET
Table 'Shura III' 6-max Seat #5 is the button
Seat 1: ShaunMM ($10 in chips) 
Seat 2: D9_nvkz ($19.69 in chips) 
Seat 3: cj71754 ($9.58 in chips) 
Seat 5: sólyom333 ($9.40 in chips) 
Seat 6: lemurrr2014 ($3.58 in chips) 
lemurrr2014: posts small blind $0.05
ShaunMM: posts big blind $0.10
*** HOLE CARDS ***
D9_nvkz: folds 
cj71754: folds 
sólyom333: raises $0.12 to $0.22
lemurrr2014: folds 
grasu331 leaves the table
ShaunMM: calls $0.12
*** FLOP *** [Kc Ac 8c]
ShaunMM: checks 
katalloo joins the table at seat #4 
sólyom333: checks 
*** TURN *** [Kc Ac 8c] [As]
ShaunMM: checks 
sólyom333: bets $0.41
ShaunMM: folds 
Uncalled bet ($0.41) returned to sólyom333
sólyom333 collected $0.47 from pot
sólyom333: doesn't show hand 
*** SUMMARY ***
Total pot $0.49 | Rake $0.02 
Board [Kc Ac 8c As]
Seat 1: ShaunMM (big blind) folded on the Turn
Seat 2: D9_nvkz folded before Flop (didn't bet)
Seat 3: cj71754 folded before Flop (didn't bet)
Seat 5: sólyom333 (button) collected ($0.47)
Seat 6: lemurrr2014 (small blind) folded before Flop



PokerStars Hand #222963769043:  Hold'em No Limit ($0.05/$0.10 USD) - 2021/01/23 13:29:52 ET
Table 'Shura III' 6-max Seat #6 is the button
Seat 1: ShaunMM ($9.78 in chips) 
Seat 2: D9_nvkz ($19.69 in chips) 
Seat 3: cj71754 ($9.58 in chips) 
Seat 5: sólyom333 ($9.65 in chips) 
Seat 6: lemurrr2014 ($3.53 in chips) 
ShaunMM: posts small blind $0.05
D9_nvkz: posts big blind $0.10
katalloo: sits out 
*** HOLE CARDS ***
cj71754: calls $0.10
sólyom333: raises $0.20 to $0.30
lemurrr2014: folds 
ShaunMM: folds 
D9_nvkz: calls $0.20
cj71754: folds 
*** FLOP *** [9c 9d 5d]
D9_nvkz: checks 
sólyom333: bets $0.30
D9_nvkz: calls $0.30
*** TURN *** [9c 9d 5d] [Ac]
D9_nvkz: checks 
sólyom333: bets $0.86
D9_nvkz: calls $0.86
*** RIVER *** [9c 9d 5d Ac] [Kd]
D9_nvkz: checks 
sólyom333: checks 
*** SHOW DOWN ***
D9_nvkz: shows [9h Jh] (three of a kind, Nines)
sólyom333: mucks hand 
D9_nvkz collected $2.93 from pot
*** SUMMARY ***
Total pot $3.07 | Rake $0.14 
Board [9c 9d 5d Ac Kd]
Seat 1: ShaunMM (small blind) folded before Flop
Seat 2: D9_nvkz (big blind) showed [9h Jh] and won ($2.93) with three of a kind, Nines
Seat 3: cj71754 folded before Flop
Seat 5: sólyom333 mucked
Seat 6: lemurrr2014 (button) folded before Flop (didn't bet)



PokerStars Hand #222963830299:  Hold'em No Limit ($0.05/$0.10 USD) - 2021/01/23 13:31:11 ET
Table 'Shura III' 6-max Seat #1 is the button
Seat 1: ShaunMM ($9.73 in chips) 
Seat 2: D9_nvkz ($21.16 in chips) 
Seat 3: cj71754 ($9.48 in chips) 
Seat 5: sólyom333 ($10 in chips) 
Seat 6: lemurrr2014 ($3.53 in chips) 
D9_nvkz: posts small blind $0.05
cj71754: posts big blind $0.10
katalloo: sits out 
*** HOLE CARDS ***
sólyom333: folds 
lemurrr2014: folds 
ShaunMM: folds 
D9_nvkz: folds 
Uncalled bet ($0.05) returned to cj71754
cj71754 collected $0.10 from pot
cj71754: doesn't show hand 
*** SUMMARY ***
Total pot $0.10 | Rake $0 
Seat 1: ShaunMM (button) folded before Flop (didn't bet)
Seat 2: D9_nvkz (small blind) folded before Flop
Seat 3: cj71754 (big blind) collected ($0.10)
Seat 5: sólyom333 folded before Flop (didn't bet)
Seat 6: lemurrr2014 folded before Flop (didn't bet)



PokerStars Hand #222963843697:  Hold'em No Limit ($0.05/$0.10 USD) - 2021/01/23 13:31:28 ET
Table 'Shura III' 6-max Seat #2 is the button
Seat 1: ShaunMM ($9.73 in chips) 
Seat 2: D9_nvkz ($21.11 in chips) 
Seat 3: cj71754 ($9.53 in chips) 
Seat 4: katalloo ($10 in chips) 
Seat 5: sólyom333 ($10 in chips) 
Seat 6: lemurrr2014 ($3.53 in chips) 
cj71754: posts small blind $0.05
katalloo: posts big blind $0.10
*** HOLE CARDS ***
sólyom333: folds 
lemurrr2014: folds 
ShaunMM: raises $0.20 to $0.30
D9_nvkz: folds 
cj71754: folds 
katalloo: folds 
Uncalled bet ($0.20) returned to ShaunMM
ShaunMM collected $0.25 from pot
ShaunMM: doesn't show hand 
*** SUMMARY ***
Total pot $0.25 | Rake $0 
Seat 1: ShaunMM collected ($0.25)
Seat 2: D9_nvkz (button) folded before Flop (didn't bet)
Seat 3: cj71754 (small blind) folded before Flop
Seat 4: katalloo (big blind) folded before Flop
Seat 5: sólyom333 folded before Flop (didn't bet)
Seat 6: lemurrr2014 folded before Flop (didn't bet)



PokerStars Hand #222963863366:  Hold'em No Limit ($0.05/$0.10 USD) - 2021/01/23 13:31:53 ET
Table 'Shura III' 6-max Seat #3 is the button
Seat 1: ShaunMM ($9.88 in chips) 
Seat 2: D9_nvkz ($21.11 in chips) 
Seat 3: cj71754 ($9.48 in chips) 
Seat 4: katalloo ($10 in chips) 
Seat 5: sólyom333 ($10 in chips) 
Seat 6: lemurrr2014 ($3.53 in chips) 
katalloo: posts small blind $0.05
sólyom333: posts big blind $0.10
*** HOLE CARDS ***
lemurrr2014: folds 
ShaunMM: folds 
D9_nvkz: raises $0.20 to $0.30
cj71754: folds 
katalloo: folds 
sólyom333: calls $0.20
*** FLOP *** [4c 2h 9c]
sólyom333: checks 
D9_nvkz: bets $0.31
sólyom333: raises $0.69 to $1
D9_nvkz: folds 
Uncalled bet ($0.69) returned to sólyom333
sólyom333 collected $1.21 from pot
sólyom333: doesn't show hand 
*** SUMMARY ***
Total pot $1.27 | Rake $0.06 
Board [4c 2h 9c]
Seat 1: ShaunMM folded before Flop (didn't bet)
Seat 2: D9_nvkz folded on the Flop
Seat 3: cj71754 (button) folded before Flop (didn't bet)
Seat 4: katalloo (small blind) folded before Flop
Seat 5: sólyom333 (big blind) collected ($1.21)
Seat 6: lemurrr2014 folded before Flop (didn't bet)



PokerStars Hand #222963895478:  Hold'em No Limit ($0.05/$0.10 USD) - 2021/01/23 13:32:34 ET
Table 'Shura III' 6-max Seat #4 is the button
Seat 1: ShaunMM ($9.88 in chips) 
Seat 2: D9_nvkz ($20.50 in chips) 
Seat 3: cj71754 ($9.48 in chips) 
Seat 4: katalloo ($10 in chips) 
Seat 5: sólyom333 ($10.60 in chips) 
Seat 6: lemurrr2014 ($3.53 in chips) 
sólyom333: posts small blind $0.05
lemurrr2014: posts big blind $0.10
*** HOLE CARDS ***
ShaunMM: folds 
D9_nvkz: folds 
cj71754: calls $0.10
katalloo: folds 
sólyom333: folds 
lemurrr2014: checks 
*** FLOP *** [6h Td Qh]
lemurrr2014: checks 
cj71754: checks 
*** TURN *** [6h Td Qh] [4c]
lemurrr2014: checks 
cj71754: checks 
*** RIVER *** [6h Td Qh 4c] [4h]
lemurrr2014: checks 
cj71754: checks 
*** SHOW DOWN ***
lemurrr2014: shows [5d Tc] (two pair, Tens and Fours)
cj71754: mucks hand 
lemurrr2014 collected $0.24 from pot
*** SUMMARY ***
Total pot $0.25 | Rake $0.01 
Board [6h Td Qh 4c 4h]
Seat 1: ShaunMM folded before Flop (didn't bet)
Seat 2: D9_nvkz folded before Flop (didn't bet)
Seat 3: cj71754 mucked
Seat 4: katalloo (button) folded before Flop (didn't bet)
Seat 5: sólyom333 (small blind) folded before Flop
Seat 6: lemurrr2014 (big blind) showed [5d Tc] and won ($0.24) with two pair, Tens and Fours



PokerStars Hand #222963931785:  Hold'em No Limit ($0.05/$0.10 USD) - 2021/01/23 13:33:21 ET
Table 'Shura III' 6-max Seat #5 is the button
Seat 1: ShaunMM ($9.88 in chips) 
Seat 2: D9_nvkz ($20.50 in chips) 
Seat 3: cj71754 ($9.38 in chips) 
Seat 4: katalloo ($10 in chips) 
Seat 5: sólyom333 ($10.55 in chips) 
Seat 6: lemurrr2014 ($3.67 in chips) 
lemurrr2014: posts small blind $0.05
ShaunMM: posts big blind $0.10
*** HOLE CARDS ***
D9_nvkz: folds 
cj71754: calls $0.10
katalloo: folds 
sólyom333: folds 
lemurrr2014: folds 
ShaunMM: checks 
*** FLOP *** [Tc Ks Ac]
ShaunMM: checks 
cj71754: checks 
*** TURN *** [Tc Ks Ac] [Qd]
ShaunMM: checks 
cj71754: checks 
*** RIVER *** [Tc Ks Ac Qd] [5d]
ShaunMM: checks 
cj71754: bets $0.24
ShaunMM: folds 
Uncalled bet ($0.24) returned to cj71754
cj71754 collected $0.24 from pot
cj71754: doesn't show hand 
*** SUMMARY ***
Total pot $0.25 | Rake $0.01 
Board [Tc Ks Ac Qd 5d]
Seat 1: ShaunMM (big blind) folded on the River
Seat 2: D9_nvkz folded before Flop (didn't bet)
Seat 3: cj71754 collected ($0.24)
Seat 4: katalloo folded before Flop (didn't bet)
Seat 5: sólyom333 (button) folded before Flop (didn't bet)
Seat 6: lemurrr2014 (small blind) folded before Flop



PokerStars Hand #222963968618:  Hold'em No Limit ($0.05/$0.10 USD) - 2021/01/23 13:34:08 ET
Table 'Shura III' 6-max Seat #6 is the button
Seat 1: ShaunMM ($9.78 in chips) 
Seat 2: D9_nvkz ($20.50 in chips) 
Seat 3: cj71754 ($9.52 in chips) 
Seat 4: katalloo ($10 in chips) 
Seat 5: sólyom333 ($10.55 in chips) 
Seat 6: lemurrr2014 ($3.62 in chips) 
ShaunMM: posts small blind $0.05
D9_nvkz: posts big blind $0.10
*** HOLE CARDS ***
cj71754: folds 
katalloo: folds 
sólyom333: folds 
lemurrr2014: folds 
ShaunMM: calls $0.05
D9_nvkz: checks 
*** FLOP *** [Jc 6c Qc]
ShaunMM: bets $0.10
D9_nvkz: folds 
Uncalled bet ($0.10) returned to ShaunMM
ShaunMM collected $0.19 from pot
ShaunMM: doesn't show hand 
*** SUMMARY ***
Total pot $0.20 | Rake $0.01 
Board [Jc 6c Qc]
Seat 1: ShaunMM (small blind) collected ($0.19)
Seat 2: D9_nvkz (big blind) folded on the Flop
Seat 3: cj71754 folded before Flop (didn't bet)
Seat 4: katalloo folded before Flop (didn't bet)
Seat 5: sólyom333 folded before Flop (didn't bet)
Seat 6: lemurrr2014 (button) folded before Flop (didn't bet)



PokerStars Hand #222963994493:  Hold'em No Limit ($0.05/$0.10 USD) - 2021/01/23 13:34:41 ET
Table 'Shura III' 6-max Seat #1 is the button
Seat 1: ShaunMM ($9.87 in chips) 
Seat 2: D9_nvkz ($20.40 in chips) 
Seat 3: cj71754 ($9.52 in chips) 
Seat 4: katalloo ($10 in chips) 
Seat 5: sólyom333 ($10.55 in chips) 
Seat 6: lemurrr2014 ($3.62 in chips) 
D9_nvkz: posts small blind $0.05
cj71754: posts big blind $0.10
*** HOLE CARDS ***
katalloo: folds 
sólyom333: folds 
lemurrr2014: folds 
ShaunMM: folds 
D9_nvkz: raises $0.20 to $0.30
cj71754: calls $0.20
*** FLOP *** [Kd 9c 7h]
D9_nvkz: bets $0.28
cj71754: calls $0.28
*** TURN *** [Kd 9c 7h] [3c]
D9_nvkz: bets $0.55
cj71754: raises $0.55 to $1.10
D9_nvkz: calls $0.55
*** RIVER *** [Kd 9c 7h 3c] [As]
D9_nvkz: checks 
cj71754: bets $3.21
D9_nvkz: calls $3.21
*** SHOW DOWN ***
cj71754: shows [9s Qd] (a pair of Nines)
D9_nvkz: shows [5c Kh] (a pair of Kings)
D9_nvkz collected $9.34 from pot
*** SUMMARY ***
Total pot $9.78 | Rake $0.44 
Board [Kd 9c 7h 3c As]
Seat 1: ShaunMM (button) folded before Flop (didn't bet)
Seat 2: D9_nvkz (small blind) showed [5c Kh] and won ($9.34) with a pair of Kings
Seat 3: cj71754 (big blind) showed [9s Qd] and lost with a pair of Nines
Seat 4: katalloo folded before Flop (didn't bet)
Seat 5: sólyom333 folded before Flop (didn't bet)
Seat 6: lemurrr2014 folded before Flop (didn't bet)



PokerStars Hand #222964036734:  Hold'em No Limit ($0.05/$0.10 USD) - 2021/01/23 13:35:36 ET
Table 'Shura III' 6-max Seat #2 is the button
Seat 1: ShaunMM ($9.87 in chips) 
Seat 2: D9_nvkz ($24.85 in chips) 
Seat 3: cj71754 ($4.63 in chips) 
Seat 4: katalloo ($10 in chips) 
Seat 5: sólyom333 ($10.55 in chips) 
Seat 6: lemurrr2014 ($3.62 in chips) 
cj71754: posts small blind $0.05
katalloo: posts big blind $0.10
*** HOLE CARDS ***
sólyom333: raises $0.18 to $0.28
lemurrr2014: folds 
ShaunMM: folds 
D9_nvkz: folds 
cj71754: folds 
katalloo: folds 
Uncalled bet ($0.18) returned to sólyom333
sólyom333 collected $0.25 from pot
sólyom333: doesn't show hand 
*** SUMMARY ***
Total pot $0.25 | Rake $0 
Seat 1: ShaunMM folded before Flop (didn't bet)
Seat 2: D9_nvkz (button) folded before Flop (didn't bet)
Seat 3: cj71754 (small blind) folded before Flop
Seat 4: katalloo (big blind) folded before Flop
Seat 5: sólyom333 collected ($0.25)
Seat 6: lemurrr2014 folded before Flop (didn't bet)



PokerStars Hand #222964053308:  Hold'em No Limit ($0.05/$0.10 USD) - 2021/01/23 13:35:57 ET
Table 'Shura III' 6-max Seat #3 is the button
Seat 1: ShaunMM ($9.87 in chips) 
Seat 2: D9_nvkz ($24.85 in chips) 
Seat 3: cj71754 ($4.58 in chips) 
Seat 4: katalloo ($10 in chips) 
Seat 5: sólyom333 ($10.70 in chips) 
Seat 6: lemurrr2014 ($3.62 in chips) 
katalloo: posts small blind $0.05
sólyom333: posts big blind $0.10
*** HOLE CARDS ***
lemurrr2014: folds 
ShaunMM: folds 
D9_nvkz: folds 
cj71754: calls $0.10
katalloo: folds 
sólyom333: raises $0.35 to $0.45
cj71754: calls $0.35
*** FLOP *** [Tc 7h 2c]
sólyom333: checks 
cj71754: checks 
*** TURN *** [Tc 7h 2c] [Kd]
sólyom333: checks 
cj71754: bets $0.30
sólyom333: calls $0.30
*** RIVER *** [Tc 7h 2c Kd] [7c]
sólyom333: bets $0.99
cj71754: raises $0.99 to $1.98
sólyom333: calls $0.99
*** SHOW DOWN ***
cj71754: shows [2h 2d] (a full house, Deuces full of Sevens)
sólyom333: mucks hand 
cj71754 collected $5.26 from pot
*** SUMMARY ***
Total pot $5.51 | Rake $0.25 
Board [Tc 7h 2c Kd 7c]
Seat 1: ShaunMM folded before Flop (didn't bet)
Seat 2: D9_nvkz folded before Flop (didn't bet)
Seat 3: cj71754 (button) showed [2h 2d] and won ($5.26) with a full house, Deuces full of Sevens
Seat 4: katalloo (small blind) folded before Flop
Seat 5: sólyom333 (big blind) mucked
Seat 6: lemurrr2014 folded before Flop (didn't bet)



PokerStars Hand #222964098574:  Hold'em No Limit ($0.05/$0.10 USD) - 2021/01/23 13:36:56 ET
Table 'Shura III' 6-max Seat #4 is the button
Seat 1: ShaunMM ($9.87 in chips) 
Seat 2: D9_nvkz ($24.85 in chips) 
Seat 3: cj71754 ($7.11 in chips) 
Seat 4: katalloo ($10 in chips) 
Seat 5: sólyom333 ($10 in chips) 
Seat 6: lemurrr2014 ($3.62 in chips) 
sólyom333: posts small blind $0.05
lemurrr2014: posts big blind $0.10
*** HOLE CARDS ***
ShaunMM: folds 
D9_nvkz: folds 
cj71754: raises $0.30 to $0.40
katalloo: folds 
sólyom333: folds 
lemurrr2014: folds 
Uncalled bet ($0.30) returned to cj71754
cj71754 collected $0.25 from pot
cj71754: doesn't show hand 
*** SUMMARY ***
Total pot $0.25 | Rake $0 
Seat 1: ShaunMM folded before Flop (didn't bet)
Seat 2: D9_nvkz folded before Flop (didn't bet)
Seat 3: cj71754 collected ($0.25)
Seat 4: katalloo (button) folded before Flop (didn't bet)
Seat 5: sólyom333 (small blind) folded before Flop
Seat 6: lemurrr2014 (big blind) folded before Flop



PokerStars Hand #222964123831:  Hold'em No Limit ($0.05/$0.10 USD) - 2021/01/23 13:37:28 ET
Table 'Shura III' 6-max Seat #5 is the button
Seat 1: ShaunMM ($9.87 in chips) 
Seat 2: D9_nvkz ($24.85 in chips) 
Seat 3: cj71754 ($7.26 in chips) 
Seat 4: katalloo ($10 in chips) 
Seat 5: sólyom333 ($9.95 in chips) 
Seat 6: lemurrr2014 ($3.52 in chips) 
lemurrr2014: posts small blind $0.05
ShaunMM: posts big blind $0.10
*** HOLE CARDS ***
D9_nvkz: folds 
cj71754: calls $0.10
katalloo: raises $0.30 to $0.40
sólyom333: calls $0.40
lemurrr2014: folds 
ShaunMM: folds 
cj71754: folds 
*** FLOP *** [6c 4c 5s]
katalloo: checks 
sólyom333: bets $0.42
katalloo: folds 
Uncalled bet ($0.42) returned to sólyom333
sólyom333 collected $1 from pot
sólyom333: doesn't show hand 
*** SUMMARY ***
Total pot $1.05 | Rake $0.05 
Board [6c 4c 5s]
Seat 1: ShaunMM (big blind) folded before Flop
Seat 2: D9_nvkz folded before Flop (didn't bet)
Seat 3: cj71754 folded before Flop
Seat 4: katalloo folded on the Flop
Seat 5: sólyom333 (button) collected ($1)
Seat 6: lemurrr2014 (small blind) folded before Flop



PokerStars Hand #222964152744:  Hold'em No Limit ($0.05/$0.10 USD) - 2021/01/23 13:38:06 ET
Table 'Shura III' 6-max Seat #6 is the button
Seat 1: ShaunMM ($9.77 in chips) 
Seat 2: D9_nvkz ($24.85 in chips) 
Seat 3: cj71754 ($7.16 in chips) 
Seat 4: katalloo ($10 in chips) 
Seat 5: sólyom333 ($10.55 in chips) 
Seat 6: lemurrr2014 ($3.47 in chips) 
ShaunMM: posts small blind $0.05
D9_nvkz: posts big blind $0.10
*** HOLE CARDS ***
cj71754: folds 
katalloo: folds 
sólyom333: raises $0.18 to $0.28
lemurrr2014: calls $0.28
ShaunMM: folds 
D9_nvkz: folds 
*** FLOP *** [Jd Js Kc]
sólyom333: bets $0.29
lemurrr2014: folds 
Uncalled bet ($0.29) returned to sólyom333
sólyom333 collected $0.68 from pot
sólyom333: doesn't show hand 
*** SUMMARY ***
Total pot $0.71 | Rake $0.03 
Board [Jd Js Kc]
Seat 1: ShaunMM (small blind) folded before Flop
Seat 2: D9_nvkz (big blind) folded before Flop
Seat 3: cj71754 folded before Flop (didn't bet)
Seat 4: katalloo folded before Flop (didn't bet)
Seat 5: sólyom333 collected ($0.68)
Seat 6: lemurrr2014 (button) folded on the Flop



PokerStars Hand #222964168830:  Hold'em No Limit ($0.05/$0.10 USD) - 2021/01/23 13:38:26 ET
Table 'Shura III' 6-max Seat #1 is the button
Seat 1: ShaunMM ($9.72 in chips) 
Seat 3: cj71754 ($7.16 in chips) 
Seat 4: katalloo ($10 in chips) 
Seat 5: sólyom333 ($10.95 in chips) 
Seat 6: lemurrr2014 ($3.19 in chips) 
cj71754: posts small blind $0.05
katalloo: posts big blind $0.10
*** HOLE CARDS ***
sólyom333: folds 
lemurrr2014: folds 
ShaunMM: folds 
cj71754: calls $0.05
katalloo: checks 
*** FLOP *** [7h Ah 5h]
cj71754: checks 
katalloo: checks 
*** TURN *** [7h Ah 5h] [6h]
cj71754: checks 
katalloo: bets $0.10
cj71754: raises $0.10 to $0.20
D9_nvkz leaves the table
katalloo: folds 
Uncalled bet ($0.10) returned to cj71754
cj71754 collected $0.38 from pot
cj71754: doesn't show hand 
*** SUMMARY ***
Total pot $0.40 | Rake $0.02 
Board [7h Ah 5h 6h]
Seat 1: ShaunMM (button) folded before Flop (didn't bet)
Seat 3: cj71754 (small blind) collected ($0.38)
Seat 4: katalloo (big blind) folded on the Turn
Seat 5: sólyom333 folded before Flop (didn't bet)
Seat 6: lemurrr2014 folded before Flop (didn't bet)



PokerStars Hand #222964202469:  Hold'em No Limit ($0.05/$0.10 USD) - 2021/01/23 13:39:10 ET
Table 'Shura III' 6-max Seat #3 is the button
Seat 1: ShaunMM ($9.72 in chips) 
Seat 3: cj71754 ($7.34 in chips) 
Seat 4: katalloo ($10 in chips) 
Seat 5: sólyom333 ($10.95 in chips) 
Seat 6: lemurrr2014 ($3.19 in chips) 
katalloo: posts small blind $0.05
sólyom333: posts big blind $0.10
*** HOLE CARDS ***
lemurrr2014: folds 
Squires90 joins the table at seat #2 
ShaunMM: folds 
cj71754: calls $0.10
katalloo: folds 
sólyom333: checks 
*** FLOP *** [9s Jc 6s]
sólyom333: checks 
cj71754: bets $0.30
sólyom333: folds 
Uncalled bet ($0.30) returned to cj71754
cj71754 collected $0.24 from pot
cj71754: doesn't show hand 
*** SUMMARY ***
Total pot $0.25 | Rake $0.01 
Board [9s Jc 6s]
Seat 1: ShaunMM folded before Flop (didn't bet)
Seat 3: cj71754 (button) collected ($0.24)
Seat 4: katalloo (small blind) folded before Flop
Seat 5: sólyom333 (big blind) folded on the Flop
Seat 6: lemurrr2014 folded before Flop (didn't bet)



PokerStars Hand #222964219881:  Hold'em No Limit ($0.05/$0.10 USD) - 2021/01/23 13:39:32 ET
Table 'Shura III' 6-max Seat #4 is the button
Seat 1: ShaunMM ($9.72 in chips) 
Seat 2: Squires90 ($8 in chips) 
Seat 3: cj71754 ($7.48 in chips) 
Seat 4: katalloo ($10 in chips) 
Seat 5: sólyom333 ($10.85 in chips) 
Seat 6: lemurrr2014 ($3.19 in chips) 
sólyom333: posts small blind $0.05
lemurrr2014: posts big blind $0.10
Squires90: posts big blind $0.10
*** HOLE CARDS ***
ShaunMM: folds 
Squires90: checks 
cj71754: calls $0.10
katalloo: folds 
sólyom333: folds 
lemurrr2014: checks 
*** FLOP *** [5h Td Tc]
lemurrr2014: checks 
Squires90: bets $0.10
cj71754: raises $0.10 to $0.20
lemurrr2014: folds 
Squires90: calls $0.10
*** TURN *** [5h Td Tc] [5s]
Squires90: checks 
cj71754: checks 
*** RIVER *** [5h Td Tc 5s] [3d]
Squires90: bets $0.36
cj71754: raises $1.44 to $1.80
Squires90: raises $5.90 to $7.70 and is all-in
cj71754: calls $5.38 and is all-in
Uncalled bet ($0.52) returned to Squires90
*** SHOW DOWN ***
Squires90: shows [5c 9d] (a full house, Fives full of Tens)
cj71754: shows [Kd Th] (a full house, Tens full of Fives)
cj71754 collected $14.43 from pot
*** SUMMARY ***
Total pot $15.11 | Rake $0.68 
Board [5h Td Tc 5s 3d]
Seat 1: ShaunMM folded before Flop (didn't bet)
Seat 2: Squires90 showed [5c 9d] and lost with a full house, Fives full of Tens
Seat 3: cj71754 showed [Kd Th] and won ($14.43) with a full house, Tens full of Fives
Seat 4: katalloo (button) folded before Flop (didn't bet)
Seat 5: sólyom333 (small blind) folded before Flop
Seat 6: lemurrr2014 (big blind) folded on the Flop



PokerStars Hand #222964272426:  Hold'em No Limit ($0.05/$0.10 USD) - 2021/01/23 13:40:40 ET
Table 'Shura III' 6-max Seat #5 is the button
Seat 1: ShaunMM ($9.72 in chips) 
Seat 2: Squires90 ($0.52 in chips) 
Seat 3: cj71754 ($14.43 in chips) 
Seat 4: katalloo ($10 in chips) 
Seat 5: sólyom333 ($10.80 in chips) 
Seat 6: lemurrr2014 ($3.09 in chips) 
lemurrr2014: posts small blind $0.05
ShaunMM: posts big blind $0.10
*** HOLE CARDS ***
Squires90 has timed out
Squires90: folds 
cj71754: folds 
cj71754 leaves the table
katalloo: folds 
sólyom333: folds 
lemurrr2014: calls $0.05
Oleg032 joins the table at seat #3 
ShaunMM: checks 
*** FLOP *** [4h Kh Qh]
lemurrr2014: checks 
ShaunMM: checks 
*** TURN *** [4h Kh Qh] [Ac]
lemurrr2014: checks 
ShaunMM: checks 
*** RIVER *** [4h Kh Qh Ac] [5s]
lemurrr2014: bets $0.10
ShaunMM: folds 
Uncalled bet ($0.10) returned to lemurrr2014
lemurrr2014 collected $0.19 from pot
lemurrr2014: doesn't show hand 
*** SUMMARY ***
Total pot $0.20 | Rake $0.01 
Board [4h Kh Qh Ac 5s]
Seat 1: ShaunMM (big blind) folded on the River
Seat 2: Squires90 folded before Flop (didn't bet)
Seat 3: cj71754 folded before Flop (didn't bet)
Seat 4: katalloo folded before Flop (didn't bet)
Seat 5: sólyom333 (button) folded before Flop (didn't bet)
Seat 6: lemurrr2014 (small blind) collected ($0.19)



PokerStars Hand #222964305009:  Hold'em No Limit ($0.05/$0.10 USD) - 2021/01/23 13:41:22 ET
Table 'Shura III' 6-max Seat #6 is the button
Seat 1: ShaunMM ($9.62 in chips) 
Seat 2: Squires90 ($0.52 in chips) 
Seat 4: katalloo ($10 in chips) 
Seat 5: sólyom333 ($10.80 in chips) 
Seat 6: lemurrr2014 ($3.18 in chips) 
ShaunMM: posts small blind $0.05
Squires90: posts big blind $0.10
Oleg032: sits out 
*** HOLE CARDS ***
katalloo: folds 
sólyom333: folds 
lemurrr2014: calls $0.10
ShaunMM: calls $0.05
Squires90: checks 
*** FLOP *** [Jc 9d Ad]
ShaunMM: checks 
Squires90: checks 
lemurrr2014: checks 
*** TURN *** [Jc 9d Ad] [Qd]
ShaunMM: checks 
Squires90: checks 
lemurrr2014: checks 
*** RIVER *** [Jc 9d Ad Qd] [Qh]
ShaunMM: checks 
Squires90: checks 
lemurrr2014: checks 
*** SHOW DOWN ***
ShaunMM: shows [8d 7h] (a pair of Queens)
Squires90: shows [3s 2h] (a pair of Queens)
lemurrr2014: shows [Tc Td] (two pair, Queens and Tens)
lemurrr2014 collected $0.29 from pot
*** SUMMARY ***
Total pot $0.30 | Rake $0.01 
Board [Jc 9d Ad Qd Qh]
Seat 1: ShaunMM (small blind) showed [8d 7h] and lost with a pair of Queens
Seat 2: Squires90 (big blind) showed [3s 2h] and lost with a pair of Queens
Seat 4: katalloo folded before Flop (didn't bet)
Seat 5: sólyom333 folded before Flop (didn't bet)
Seat 6: lemurrr2014 (button) showed [Tc Td] and won ($0.29) with two pair, Queens and Tens



PokerStars Hand #222964333946:  Hold'em No Limit ($0.05/$0.10 USD) - 2021/01/23 13:42:00 ET
Table 'Shura III' 6-max Seat #1 is the button
Seat 1: ShaunMM ($9.52 in chips) 
Seat 2: Squires90 ($0.42 in chips) 
Seat 3: Oleg032 ($10 in chips) 
Seat 4: katalloo ($10 in chips) 
Seat 5: sólyom333 ($10.80 in chips) 
Seat 6: lemurrr2014 ($3.37 in chips) 
Squires90: posts small blind $0.05
Oleg032: posts big blind $0.10
*** HOLE CARDS ***
katalloo: folds 
sólyom333: folds 
lemurrr2014: folds 
ShaunMM: folds 
Squires90: folds 
Uncalled bet ($0.05) returned to Oleg032
Oleg032 collected $0.10 from pot
Oleg032: doesn't show hand 
*** SUMMARY ***
Total pot $0.10 | Rake $0 
Seat 1: ShaunMM (button) folded before Flop (didn't bet)
Seat 2: Squires90 (small blind) folded before Flop
Seat 3: Oleg032 (big blind) collected ($0.10)
Seat 4: katalloo folded before Flop (didn't bet)
Seat 5: sólyom333 folded before Flop (didn't bet)
Seat 6: lemurrr2014 folded before Flop (didn't bet)



PokerStars Hand #222964344141:  Hold'em No Limit ($0.05/$0.10 USD) - 2021/01/23 13:42:13 ET
Table 'Shura III' 6-max Seat #2 is the button
Seat 1: ShaunMM ($9.52 in chips) 
Seat 2: Squires90 ($0.37 in chips) 
Seat 3: Oleg032 ($10.05 in chips) 
Seat 5: sólyom333 ($10.80 in chips) 
Seat 6: lemurrr2014 ($3.37 in chips) 
Oleg032: posts small blind $0.05
katalloo: is sitting out 
sólyom333: posts big blind $0.10
*** HOLE CARDS ***
lemurrr2014: calls $0.10
ShaunMM: folds 
Squires90: folds 
Oleg032: folds 
sólyom333: checks 
*** FLOP *** [3c 6d 4c]
sólyom333: bets $0.21
lemurrr2014: calls $0.21
*** TURN *** [3c 6d 4c] [Qd]
sólyom333: checks 
lemurrr2014: checks 
*** RIVER *** [3c 6d 4c Qd] [2s]
sólyom333: bets $0.56
lemurrr2014: calls $0.56
*** SHOW DOWN ***
sólyom333: shows [4d 2h] (two pair, Fours and Deuces)
lemurrr2014: mucks hand 
sólyom333 collected $1.71 from pot
*** SUMMARY ***
Total pot $1.79 | Rake $0.08 
Board [3c 6d 4c Qd 2s]
Seat 1: ShaunMM folded before Flop (didn't bet)
Seat 2: Squires90 (button) folded before Flop (didn't bet)
Seat 3: Oleg032 (small blind) folded before Flop
Seat 5: sólyom333 (big blind) showed [4d 2h] and won ($1.71) with two pair, Fours and Deuces
Seat 6: lemurrr2014 mucked



PokerStars Hand #222964369514:  Hold'em No Limit ($0.05/$0.10 USD) - 2021/01/23 13:42:46 ET
Table 'Shura III' 6-max Seat #3 is the button
Seat 1: ShaunMM ($9.52 in chips) 
Seat 2: Squires90 ($0.37 in chips) 
Seat 3: Oleg032 ($10 in chips) 
Seat 5: sólyom333 ($11.64 in chips) 
Seat 6: lemurrr2014 ($2.50 in chips) 
sólyom333: posts small blind $0.05
lemurrr2014: posts big blind $0.10
*** HOLE CARDS ***
ShaunMM: folds 
Squires90: calls $0.10
Oleg032: raises $0.35 to $0.45
sólyom333: folds 
lemurrr2014: folds 
katalloo leaves the table
Squires90: calls $0.27 and is all-in
Uncalled bet ($0.08) returned to Oleg032
pussy del777 joins the table at seat #4 
Oleg032 has timed out
*** FLOP *** [Ad Kh Kd]
*** TURN *** [Ad Kh Kd] [Jc]
*** RIVER *** [Ad Kh Kd Jc] [Qc]
*** SHOW DOWN ***
Squires90: shows [Kc 6d] (three of a kind, Kings)
Oleg032: shows [8h 8c] (two pair, Kings and Eights)
Squires90 collected $0.85 from pot
*** SUMMARY ***
Total pot $0.89 | Rake $0.04 
Board [Ad Kh Kd Jc Qc]
Seat 1: ShaunMM folded before Flop (didn't bet)
Seat 2: Squires90 showed [Kc 6d] and won ($0.85) with three of a kind, Kings
Seat 3: Oleg032 (button) showed [8h 8c] and lost with two pair, Kings and Eights
Seat 5: sólyom333 (small blind) folded before Flop
Seat 6: lemurrr2014 (big blind) folded before Flop



PokerStars Hand #222964400876:  Hold'em No Limit ($0.05/$0.10 USD) - 2021/01/23 13:43:26 ET
Table 'Shura III' 6-max Seat #5 is the button
Seat 1: ShaunMM ($9.52 in chips) 
Seat 2: Squires90 ($0.85 in chips) 
Seat 3: Oleg032 ($10 in chips) 
Seat 4: pussy del777 ($10 in chips) 
Seat 5: sólyom333 ($11.59 in chips) 
Seat 6: lemurrr2014 ($2.40 in chips) 
lemurrr2014: posts small blind $0.05
ShaunMM: posts big blind $0.10
pussy del777: posts big blind $0.10
*** HOLE CARDS ***
Squires90: folds 
Oleg032: folds 
pussy del777: checks 
sólyom333: folds 
lemurrr2014: calls $0.05
ShaunMM: checks 
*** FLOP *** [Qd 8s 3s]
lemurrr2014: checks 
ShaunMM: checks 
pussy del777: checks 
*** TURN *** [Qd 8s 3s] [2s]
lemurrr2014: checks 
ShaunMM: checks 
pussy del777: checks 
*** RIVER *** [Qd 8s 3s 2s] [As]
lemurrr2014: checks 
ShaunMM: checks 
pussy del777: checks 
*** SHOW DOWN ***
lemurrr2014: shows [9s Jh] (a flush, Ace high)
ShaunMM: mucks hand 
pussy del777: mucks hand 
lemurrr2014 collected $0.29 from pot
*** SUMMARY ***
Total pot $0.30 | Rake $0.01 
Board [Qd 8s 3s 2s As]
Seat 1: ShaunMM (big blind) mucked
Seat 2: Squires90 folded before Flop (didn't bet)
Seat 3: Oleg032 folded before Flop (didn't bet)
Seat 4: pussy del777 mucked
Seat 5: sólyom333 (button) folded before Flop (didn't bet)
Seat 6: lemurrr2014 (small blind) showed [9s Jh] and won ($0.29) with a flush, Ace high



PokerStars Hand #222964464546:  Hold'em No Limit ($0.05/$0.10 USD) - 2021/01/23 13:44:41 ET
Table 'Shura III' 6-max Seat #6 is the button
Seat 1: ShaunMM ($9.42 in chips) 
Seat 2: Squires90 ($0.85 in chips) 
Seat 3: Oleg032 ($10 in chips) 
Seat 4: pussy del777 ($9.90 in chips) 
Seat 5: sólyom333 ($11.59 in chips) 
Seat 6: lemurrr2014 ($2.59 in chips) 
ShaunMM: posts small blind $0.05
Squires90: posts big blind $0.10
*** HOLE CARDS ***
Oleg032: folds 
pussy del777: folds 
sólyom333: folds 
lemurrr2014: folds 
ShaunMM: calls $0.05
Squires90: checks 
*** FLOP *** [4s Tc 3d]
ShaunMM: checks 
Squires90: checks 
*** TURN *** [4s Tc 3d] [6c]
ShaunMM: checks 
Squires90: checks 
*** RIVER *** [4s Tc 3d 6c] [5h]
ShaunMM: checks 
Squires90: checks 
*** SHOW DOWN ***
ShaunMM: shows [Jh 9c] (high card Jack)
Squires90: shows [9h 4d] (a pair of Fours)
Squires90 collected $0.19 from pot
*** SUMMARY ***
Total pot $0.20 | Rake $0.01 
Board [4s Tc 3d 6c 5h]
Seat 1: ShaunMM (small blind) showed [Jh 9c] and lost with high card Jack
Seat 2: Squires90 (big blind) showed [9h 4d] and won ($0.19) with a pair of Fours
Seat 3: Oleg032 folded before Flop (didn't bet)
Seat 4: pussy del777 folded before Flop (didn't bet)
Seat 5: sólyom333 folded before Flop (didn't bet)
Seat 6: lemurrr2014 (button) folded before Flop (didn't bet)



PokerStars Hand #222964499943:  Hold'em No Limit ($0.05/$0.10 USD) - 2021/01/23 13:45:27 ET
Table 'Shura III' 6-max Seat #1 is the button
Seat 1: ShaunMM ($9.32 in chips) 
Seat 2: Squires90 ($0.94 in chips) 
Seat 3: Oleg032 ($10 in chips) 
Seat 4: pussy del777 ($9.90 in chips) 
Seat 5: sólyom333 ($11.59 in chips) 
Seat 6: lemurrr2014 ($2.59 in chips) 
Squires90: posts small blind $0.05
Oleg032: posts big blind $0.10
*** HOLE CARDS ***
pussy del777: folds 
sólyom333: raises $0.18 to $0.28
lemurrr2014: folds 
ShaunMM: folds 
Squires90: calls $0.23
Oleg032: folds 
*** FLOP *** [9d 3d Tc]
Squires90: bets $0.10
sólyom333: raises $0.35 to $0.45
Squires90: calls $0.35
*** TURN *** [9d 3d Tc] [6d]
Squires90: bets $0.21 and is all-in
sólyom333: calls $0.21
*** RIVER *** [9d 3d Tc 6d] [Jd]
*** SHOW DOWN ***
Squires90: shows [Qc Jc] (a pair of Jacks)
sólyom333: shows [8h 9h] (a pair of Nines)
Squires90 collected $1.89 from pot
*** SUMMARY ***
Total pot $1.98 | Rake $0.09 
Board [9d 3d Tc 6d Jd]
Seat 1: ShaunMM (button) folded before Flop (didn't bet)
Seat 2: Squires90 (small blind) showed [Qc Jc] and won ($1.89) with a pair of Jacks
Seat 3: Oleg032 (big blind) folded before Flop
Seat 4: pussy del777 folded before Flop (didn't bet)
Seat 5: sólyom333 showed [8h 9h] and lost with a pair of Nines
Seat 6: lemurrr2014 folded before Flop (didn't bet)



PokerStars Hand #222964548491:  Hold'em No Limit ($0.05/$0.10 USD) - 2021/01/23 13:46:30 ET
Table 'Shura III' 6-max Seat #2 is the button
Seat 1: ShaunMM ($9.32 in chips) 
Seat 2: Squires90 ($1.89 in chips) 
Seat 3: Oleg032 ($10 in chips) 
Seat 4: pussy del777 ($9.90 in chips) 
Seat 5: sólyom333 ($10.65 in chips) 
Seat 6: lemurrr2014 ($2.59 in chips) 
Oleg032: posts small blind $0.05
pussy del777: posts big blind $0.10
*** HOLE CARDS ***
sólyom333: raises $0.18 to $0.28
lemurrr2014: folds 
ShaunMM: folds 
Squires90: folds 
Oleg032: folds 
pussy del777: folds 
Uncalled bet ($0.18) returned to sólyom333
sólyom333 collected $0.25 from pot
sólyom333: doesn't show hand 
*** SUMMARY ***
Total pot $0.25 | Rake $0 
Seat 1: ShaunMM folded before Flop (didn't bet)
Seat 2: Squires90 (button) folded before Flop (didn't bet)
Seat 3: Oleg032 (small blind) folded before Flop
Seat 4: pussy del777 (big blind) folded before Flop
Seat 5: sólyom333 collected ($0.25)
Seat 6: lemurrr2014 folded before Flop (didn't bet)



PokerStars Hand #222964567660:  Hold'em No Limit ($0.05/$0.10 USD) - 2021/01/23 13:46:55 ET
Table 'Shura III' 6-max Seat #3 is the button
Seat 1: ShaunMM ($9.32 in chips) 
Seat 2: Squires90 ($1.89 in chips) 
Seat 3: Oleg032 ($10 in chips) 
Seat 4: pussy del777 ($9.80 in chips) 
Seat 5: sólyom333 ($10.80 in chips) 
Seat 6: lemurrr2014 ($2.59 in chips) 
pussy del777: posts small blind $0.05
sólyom333: posts big blind $0.10
*** HOLE CARDS ***
lemurrr2014: folds 
ShaunMM: folds 
Squires90: calls $0.10
Oleg032: folds 
pussy del777: calls $0.05
sólyom333: checks 
*** FLOP *** [8c 2c Js]
pussy del777: bets $0.30
sólyom333: folds 
Squires90: calls $0.30
*** TURN *** [8c 2c Js] [9s]
pussy del777: bets $0.40
Squires90: raises $1.09 to $1.49 and is all-in
pussy del777: calls $1.09
*** RIVER *** [8c 2c Js 9s] [9d]
*** SHOW DOWN ***
pussy del777: shows [Jh Qc] (two pair, Jacks and Nines)
Squires90: shows [3d Jd] (two pair, Jacks and Nines - lower kicker)
pussy del777 collected $3.71 from pot
*** SUMMARY ***
Total pot $3.88 | Rake $0.17 
Board [8c 2c Js 9s 9d]
Seat 1: ShaunMM folded before Flop (didn't bet)
Seat 2: Squires90 showed [3d Jd] and lost with two pair, Jacks and Nines
Seat 3: Oleg032 (button) folded before Flop (didn't bet)
Seat 4: pussy del777 (small blind) showed [Jh Qc] and won ($3.71) with two pair, Jacks and Nines
Seat 5: sólyom333 (big blind) folded on the Flop
Seat 6: lemurrr2014 folded before Flop (didn't bet)



PokerStars Hand #222964618406:  Hold'em No Limit ($0.05/$0.10 USD) - 2021/01/23 13:48:02 ET
Table 'Shura III' 6-max Seat #4 is the button
Seat 1: ShaunMM ($9.32 in chips) 
Seat 3: Oleg032 ($10 in chips) 
Seat 4: pussy del777 ($11.62 in chips) 
Seat 5: sólyom333 ($10.70 in chips) 
Seat 6: lemurrr2014 ($2.59 in chips) 
sólyom333: posts small blind $0.05
lemurrr2014: posts big blind $0.10
*** HOLE CARDS ***
ShaunMM: raises $0.20 to $0.30
Oleg032: folds 
Squires90 leaves the table
pussy del777: folds 
sólyom333: folds 
lemurrr2014: folds 
Uncalled bet ($0.20) returned to ShaunMM
ShaunMM collected $0.25 from pot
ShaunMM: doesn't show hand 
*** SUMMARY ***
Total pot $0.25 | Rake $0 
Seat 1: ShaunMM collected ($0.25)
Seat 3: Oleg032 folded before Flop (didn't bet)
Seat 4: pussy del777 (button) folded before Flop (didn't bet)
Seat 5: sólyom333 (small blind) folded before Flop
Seat 6: lemurrr2014 (big blind) folded before Flop



PokerStars Hand #222964636815:  Hold'em No Limit ($0.05/$0.10 USD) - 2021/01/23 13:48:26 ET
Table 'Shura III' 6-max Seat #5 is the button
Seat 1: ShaunMM ($9.47 in chips) 
Seat 3: Oleg032 ($10 in chips) 
Seat 4: pussy del777 ($11.62 in chips) 
Seat 5: sólyom333 ($10.65 in chips) 
Seat 6: lemurrr2014 ($2.49 in chips) 
lemurrr2014: posts small blind $0.05
ShaunMM: posts big blind $0.10
*** HOLE CARDS ***
Oleg032: folds 
pussy del777: folds 
sólyom333: folds 
lemurrr2014: calls $0.05
ShaunMM: checks 
*** FLOP *** [Qh 4c 6s]
lemurrr2014: checks 
ShaunMM: bets $0.10
lemurrr2014: folds 
Uncalled bet ($0.10) returned to ShaunMM
ShaunMM collected $0.19 from pot
ShaunMM: doesn't show hand 
*** SUMMARY ***
Total pot $0.20 | Rake $0.01 
Board [Qh 4c 6s]
Seat 1: ShaunMM (big blind) collected ($0.19)
Seat 3: Oleg032 folded before Flop (didn't bet)
Seat 4: pussy del777 folded before Flop (didn't bet)
Seat 5: sólyom333 (button) folded before Flop (didn't bet)
Seat 6: lemurrr2014 (small blind) folded on the Flop



PokerStars Hand #222964665481:  Hold'em No Limit ($0.05/$0.10 USD) - 2021/01/23 13:49:04 ET
Table 'Shura III' 6-max Seat #6 is the button
Seat 1: ShaunMM ($9.56 in chips) 
Seat 3: Oleg032 ($10 in chips) 
Seat 4: pussy del777 ($11.62 in chips) 
Seat 5: sólyom333 ($10.65 in chips) 
Seat 6: lemurrr2014 ($2.39 in chips) 
ShaunMM: posts small blind $0.05
Oleg032: posts big blind $0.10
*** HOLE CARDS ***
Manon4ik joins the table at seat #2 
pussy del777: raises $0.20 to $0.30
sólyom333: folds 
lemurrr2014: folds 
ShaunMM: folds 
Oleg032: folds 
Uncalled bet ($0.20) returned to pussy del777
pussy del777 collected $0.25 from pot
pussy del777: doesn't show hand 
*** SUMMARY ***
Total pot $0.25 | Rake $0 
Seat 1: ShaunMM (small blind) folded before Flop
Seat 3: Oleg032 (big blind) folded before Flop
Seat 4: pussy del777 collected ($0.25)
Seat 5: sólyom333 folded before Flop (didn't bet)
Seat 6: lemurrr2014 (button) folded before Flop (didn't bet)



PokerStars Hand #222964676074:  Hold'em No Limit ($0.05/$0.10 USD) - 2021/01/23 13:49:18 ET
Table 'Shura III' 6-max Seat #1 is the button
Seat 1: ShaunMM ($9.51 in chips) 
Seat 3: Oleg032 ($10 in chips) 
Seat 4: pussy del777 ($11.77 in chips) 
Seat 5: sólyom333 ($10.65 in chips) 
Seat 6: lemurrr2014 ($2.39 in chips) 
Oleg032: posts small blind $0.05
pussy del777: posts big blind $0.10
*** HOLE CARDS ***
sólyom333: folds 
lemurrr2014: folds 
lemurrr2014 leaves the table
ShaunMM: folds 
Oleg032: raises $0.20 to $0.30
namemattbark joins the table at seat #6 
pussy del777: folds 
Uncalled bet ($0.20) returned to Oleg032
Oleg032 collected $0.20 from pot
Oleg032: doesn't show hand 
*** SUMMARY ***
Total pot $0.20 | Rake $0 
Seat 1: ShaunMM (button) folded before Flop (didn't bet)
Seat 3: Oleg032 (small blind) collected ($0.20)
Seat 4: pussy del777 (big blind) folded before Flop
Seat 5: sólyom333 folded before Flop (didn't bet)
Seat 6: lemurrr2014 folded before Flop (didn't bet)



PokerStars Hand #222964689521:  Hold'em No Limit ($0.05/$0.10 USD) - 2021/01/23 13:49:35 ET
Table 'Shura III' 6-max Seat #3 is the button
Seat 1: ShaunMM ($9.51 in chips) 
Seat 3: Oleg032 ($10.10 in chips) 
Seat 4: pussy del777 ($11.67 in chips) 
Seat 5: sólyom333 ($10.65 in chips) 
pussy del777: posts small blind $0.05
sólyom333: posts big blind $0.10
namemattbark: sits out 
Manon4ik: sits out 
*** HOLE CARDS ***
ShaunMM: folds 
Oleg032: raises $0.15 to $0.25
pussy del777: folds 
sólyom333: calls $0.15
*** FLOP *** [4s Jd 7d]
sólyom333: checks 
Oleg032: checks 
*** TURN *** [4s Jd 7d] [5s]
sólyom333: bets $0.35
Oleg032: folds 
Uncalled bet ($0.35) returned to sólyom333
sólyom333 collected $0.53 from pot
sólyom333: doesn't show hand 
*** SUMMARY ***
Total pot $0.55 | Rake $0.02 
Board [4s Jd 7d 5s]
Seat 1: ShaunMM folded before Flop (didn't bet)
Seat 3: Oleg032 (button) folded on the Turn
Seat 4: pussy del777 (small blind) folded before Flop
Seat 5: sólyom333 (big blind) collected ($0.53)



PokerStars Hand #222964717823:  Hold'em No Limit ($0.05/$0.10 USD) - 2021/01/23 13:50:12 ET
Table 'Shura III' 6-max Seat #4 is the button
Seat 1: ShaunMM ($9.51 in chips) 
Seat 3: Oleg032 ($10 in chips) 
Seat 4: pussy del777 ($11.62 in chips) 
Seat 5: sólyom333 ($10.93 in chips) 
Seat 6: namemattbark ($10 in chips) 
sólyom333: posts small blind $0.05
namemattbark: posts big blind $0.10
Manon4ik: sits out 
*** HOLE CARDS ***
ShaunMM: folds 
Oleg032: raises $0.15 to $0.25
pussy del777: folds 
sólyom333: folds 
namemattbark: folds 
Uncalled bet ($0.15) returned to Oleg032
Oleg032 collected $0.25 from pot
Oleg032: doesn't show hand 
*** SUMMARY ***
Total pot $0.25 | Rake $0 
Seat 1: ShaunMM folded before Flop (didn't bet)
Seat 3: Oleg032 collected ($0.25)
Seat 4: pussy del777 (button) folded before Flop (didn't bet)
Seat 5: sólyom333 (small blind) folded before Flop
Seat 6: namemattbark (big blind) folded before Flop



PokerStars Hand #222964728422:  Hold'em No Limit ($0.05/$0.10 USD) - 2021/01/23 13:50:26 ET
Table 'Shura III' 6-max Seat #5 is the button
Seat 1: ShaunMM ($9.51 in chips) 
Seat 3: Oleg032 ($10.15 in chips) 
Seat 4: pussy del777 ($11.62 in chips) 
Seat 5: sólyom333 ($10.88 in chips) 
Seat 6: namemattbark ($9.90 in chips) 
namemattbark: posts small blind $0.05
ShaunMM: posts big blind $0.10
Manon4ik: sits out 
*** HOLE CARDS ***
Oleg032: folds 
pussy del777: raises $0.10 to $0.20
sólyom333: folds 
namemattbark: folds 
ShaunMM: folds 
Uncalled bet ($0.10) returned to pussy del777
pussy del777 collected $0.25 from pot
pussy del777: doesn't show hand 
*** SUMMARY ***
Total pot $0.25 | Rake $0 
Seat 1: ShaunMM (big blind) folded before Flop
Seat 3: Oleg032 folded before Flop (didn't bet)
Seat 4: pussy del777 collected ($0.25)
Seat 5: sólyom333 (button) folded before Flop (didn't bet)
Seat 6: namemattbark (small blind) folded before Flop



PokerStars Hand #222964741075:  Hold'em No Limit ($0.05/$0.10 USD) - 2021/01/23 13:50:43 ET
Table 'Shura III' 6-max Seat #6 is the button
Seat 1: ShaunMM ($9.41 in chips) 
Seat 2: Manon4ik ($10 in chips) 
Seat 3: Oleg032 ($10.15 in chips) 
Seat 4: pussy del777 ($11.77 in chips) 
Seat 5: sólyom333 ($10.88 in chips) 
Seat 6: namemattbark ($9.85 in chips) 
ShaunMM: posts small blind $0.05
Manon4ik: posts big blind $0.10
*** HOLE CARDS ***
Oleg032: raises $0.15 to $0.25
pussy del777: folds 
sólyom333: folds 
namemattbark: folds 
ShaunMM: folds 
Manon4ik: folds 
Uncalled bet ($0.15) returned to Oleg032
Oleg032 collected $0.25 from pot
Oleg032: doesn't show hand 
*** SUMMARY ***
Total pot $0.25 | Rake $0 
Seat 1: ShaunMM (small blind) folded before Flop
Seat 2: Manon4ik (big blind) folded before Flop
Seat 3: Oleg032 collected ($0.25)
Seat 4: pussy del777 folded before Flop (didn't bet)
Seat 5: sólyom333 folded before Flop (didn't bet)
Seat 6: namemattbark (button) folded before Flop (didn't bet)



PokerStars Hand #222964762410:  Hold'em No Limit ($0.05/$0.10 USD) - 2021/01/23 13:51:11 ET
Table 'Shura III' 6-max Seat #1 is the button
Seat 1: ShaunMM ($9.36 in chips) 
Seat 2: Manon4ik ($10 in chips) 
Seat 3: Oleg032 ($10.30 in chips) 
Seat 4: pussy del777 ($11.77 in chips) 
Seat 5: sólyom333 ($10.88 in chips) 
Seat 6: namemattbark ($9.85 in chips) 
Manon4ik: posts small blind $0.05
Oleg032: posts big blind $0.10
*** HOLE CARDS ***
pussy del777: raises $0.10 to $0.20
sólyom333: folds 
namemattbark: folds 
ShaunMM: calls $0.20
Manon4ik: calls $0.15
Oleg032: folds 
*** FLOP *** [3s Js 3h]
Manon4ik: checks 
pussy del777: checks 
ShaunMM: bets $0.30
Manon4ik: folds 
pussy del777: folds 
Uncalled bet ($0.30) returned to ShaunMM
ShaunMM collected $0.67 from pot
ShaunMM: doesn't show hand 
*** SUMMARY ***
Total pot $0.70 | Rake $0.03 
Board [3s Js 3h]
Seat 1: ShaunMM (button) collected ($0.67)
Seat 2: Manon4ik (small blind) folded on the Flop
Seat 3: Oleg032 (big blind) folded before Flop
Seat 4: pussy del777 folded on the Flop
Seat 5: sólyom333 folded before Flop (didn't bet)
Seat 6: namemattbark folded before Flop (didn't bet)



PokerStars Hand #222964800690:  Hold'em No Limit ($0.05/$0.10 USD) - 2021/01/23 13:52:01 ET
Table 'Shura III' 6-max Seat #2 is the button
Seat 1: ShaunMM ($9.83 in chips) 
Seat 2: Manon4ik ($10 in chips) 
Seat 3: Oleg032 ($10.20 in chips) 
Seat 4: pussy del777 ($11.57 in chips) 
Seat 5: sólyom333 ($10.88 in chips) 
Seat 6: namemattbark ($9.85 in chips) 
Oleg032: posts small blind $0.05
pussy del777: posts big blind $0.10
*** HOLE CARDS ***
sólyom333: folds 
namemattbark: folds 
ShaunMM: calls $0.10
Manon4ik: folds 
Oleg032: raises $0.20 to $0.30
pussy del777: raises $0.50 to $0.80
ShaunMM: folds 
Oleg032: calls $0.50
*** FLOP *** [9c Ac 9s]
Oleg032: checks 
pussy del777: bets $1.80
Oleg032: calls $1.80
*** TURN *** [9c Ac 9s] [7h]
Oleg032: checks 
pussy del777: bets $8.97 and is all-in
Oleg032: folds 
Uncalled bet ($8.97) returned to pussy del777
pussy del777 collected $5.06 from pot
pussy del777: doesn't show hand 
*** SUMMARY ***
Total pot $5.30 | Rake $0.24 
Board [9c Ac 9s 7h]
Seat 1: ShaunMM folded before Flop
Seat 2: Manon4ik (button) folded before Flop (didn't bet)
Seat 3: Oleg032 (small blind) folded on the Turn
Seat 4: pussy del777 (big blind) collected ($5.06)
Seat 5: sólyom333 folded before Flop (didn't bet)
Seat 6: namemattbark folded before Flop (didn't bet)



PokerStars Hand #222964852487:  Hold'em No Limit ($0.05/$0.10 USD) - 2021/01/23 13:53:09 ET
Table 'Shura III' 6-max Seat #3 is the button
Seat 1: ShaunMM ($9.73 in chips) 
Seat 2: Manon4ik ($10 in chips) 
Seat 3: Oleg032 ($10 in chips) 
Seat 4: pussy del777 ($14.03 in chips) 
Seat 5: sólyom333 ($10.88 in chips) 
Seat 6: namemattbark ($9.85 in chips) 
pussy del777: posts small blind $0.05
sólyom333: posts big blind $0.10
*** HOLE CARDS ***
namemattbark: folds 
ShaunMM: folds 
Manon4ik: folds 
Oleg032: folds 
pussy del777: calls $0.05
sólyom333: raises $0.25 to $0.35
pussy del777: calls $0.25
*** FLOP *** [Kh 7d As]
pussy del777: checks 
sólyom333: bets $0.28
pussy del777: folds 
Uncalled bet ($0.28) returned to sólyom333
sólyom333 collected $0.67 from pot
sólyom333: doesn't show hand 
*** SUMMARY ***
Total pot $0.70 | Rake $0.03 
Board [Kh 7d As]
Seat 1: ShaunMM folded before Flop (didn't bet)
Seat 2: Manon4ik folded before Flop (didn't bet)
Seat 3: Oleg032 (button) folded before Flop (didn't bet)
Seat 4: pussy del777 (small blind) folded on the Flop
Seat 5: sólyom333 (big blind) collected ($0.67)
Seat 6: namemattbark folded before Flop (didn't bet)



PokerStars Hand #222964877168:  Hold'em No Limit ($0.05/$0.10 USD) - 2021/01/23 13:53:41 ET
Table 'Shura III' 6-max Seat #4 is the button
Seat 1: ShaunMM ($9.73 in chips) 
Seat 2: Manon4ik ($10 in chips) 
Seat 3: Oleg032 ($10 in chips) 
Seat 4: pussy del777 ($13.68 in chips) 
Seat 5: sólyom333 ($11.20 in chips) 
Seat 6: namemattbark ($9.85 in chips) 
sólyom333: posts small blind $0.05
namemattbark: posts big blind $0.10
*** HOLE CARDS ***
ShaunMM: folds 
Manon4ik: raises $0.15 to $0.25
Oleg032: folds 
pussy del777: folds 
sólyom333: folds 
namemattbark: folds 
Uncalled bet ($0.15) returned to Manon4ik
Manon4ik collected $0.25 from pot
Manon4ik: doesn't show hand 
*** SUMMARY ***
Total pot $0.25 | Rake $0 
Seat 1: ShaunMM folded before Flop (didn't bet)
Seat 2: Manon4ik collected ($0.25)
Seat 3: Oleg032 folded before Flop (didn't bet)
Seat 4: pussy del777 (button) folded before Flop (didn't bet)
Seat 5: sólyom333 (small blind) folded before Flop
Seat 6: namemattbark (big blind) folded before Flop



PokerStars Hand #222964893436:  Hold'em No Limit ($0.05/$0.10 USD) - 2021/01/23 13:54:03 ET
Table 'Shura III' 6-max Seat #5 is the button
Seat 1: ShaunMM ($9.73 in chips) 
Seat 2: Manon4ik ($10.15 in chips) 
Seat 3: Oleg032 ($10 in chips) 
Seat 4: pussy del777 ($13.68 in chips) 
Seat 5: sólyom333 ($11.15 in chips) 
Seat 6: namemattbark ($9.75 in chips) 
namemattbark: posts small blind $0.05
ShaunMM: posts big blind $0.10
*** HOLE CARDS ***
Manon4ik: folds 
Oleg032: raises $0.15 to $0.25
pussy del777: folds 
sólyom333: folds 
namemattbark: folds 
ShaunMM: calls $0.15
*** FLOP *** [5h 7h 6c]
ShaunMM: checks 
Oleg032: bets $0.40
ShaunMM: calls $0.40
*** TURN *** [5h 7h 6c] [Kh]
ShaunMM: checks 
Oleg032: bets $0.65
ShaunMM: calls $0.65
*** RIVER *** [5h 7h 6c Kh] [4h]
ShaunMM: checks 
Oleg032: checks 
*** SHOW DOWN ***
ShaunMM: shows [9h Ac] (a flush, King high)
Oleg032: mucks hand 
ShaunMM collected $2.53 from pot
*** SUMMARY ***
Total pot $2.65 | Rake $0.12 
Board [5h 7h 6c Kh 4h]
Seat 1: ShaunMM (big blind) showed [9h Ac] and won ($2.53) with a flush, King high
Seat 2: Manon4ik folded before Flop (didn't bet)
Seat 3: Oleg032 mucked
Seat 4: pussy del777 folded before Flop (didn't bet)
Seat 5: sólyom333 (button) folded before Flop (didn't bet)
Seat 6: namemattbark (small blind) folded before Flop



PokerStars Hand #222964925330:  Hold'em No Limit ($0.05/$0.10 USD) - 2021/01/23 13:54:45 ET
Table 'Shura III' 6-max Seat #6 is the button
Seat 1: ShaunMM ($10.96 in chips) 
Seat 2: Manon4ik ($10.15 in chips) 
Seat 3: Oleg032 ($10 in chips) 
Seat 4: pussy del777 ($13.68 in chips) 
Seat 5: sólyom333 ($11.15 in chips) 
Seat 6: namemattbark ($9.70 in chips) 
ShaunMM: posts small blind $0.05
Manon4ik: posts big blind $0.10
*** HOLE CARDS ***
Oleg032: folds 
pussy del777: folds 
sólyom333: folds 
namemattbark: raises $0.13 to $0.23
ShaunMM: folds 
Manon4ik: raises $0.77 to $1
namemattbark: calls $0.77
*** FLOP *** [2s 9c 5s]
Manon4ik: checks 
namemattbark: checks 
*** TURN *** [2s 9c 5s] [8d]
Manon4ik: checks 
namemattbark: bets $1.08
Manon4ik: folds 
Uncalled bet ($1.08) returned to namemattbark
namemattbark collected $1.96 from pot
namemattbark: doesn't show hand 
*** SUMMARY ***
Total pot $2.05 | Rake $0.09 
Board [2s 9c 5s 8d]
Seat 1: ShaunMM (small blind) folded before Flop
Seat 2: Manon4ik (big blind) folded on the Turn
Seat 3: Oleg032 folded before Flop (didn't bet)
Seat 4: pussy del777 folded before Flop (didn't bet)
Seat 5: sólyom333 folded before Flop (didn't bet)
Seat 6: namemattbark (button) collected ($1.96)



PokerStars Hand #222964972505:  Hold'em No Limit ($0.05/$0.10 USD) - 2021/01/23 13:56:10 ET
Table 'Shura III' 6-max Seat #1 is the button
Seat 1: ShaunMM ($10.91 in chips) 
Seat 2: Manon4ik ($10 in chips) 
Seat 3: Oleg032 ($10 in chips) 
Seat 4: pussy del777 ($13.68 in chips) 
Seat 5: sólyom333 ($11.15 in chips) 
Seat 6: namemattbark ($10.66 in chips) 
Manon4ik: posts small blind $0.05
Oleg032: posts big blind $0.10
*** HOLE CARDS ***
pussy del777: calls $0.10
sólyom333: raises $0.20 to $0.30
namemattbark: folds 
ShaunMM: folds 
Manon4ik: folds 
Oleg032: folds 
pussy del777: calls $0.20
*** FLOP *** [2c 8h 3s]
pussy del777: checks 
sólyom333: bets $0.30
pussy del777: calls $0.30
*** TURN *** [2c 8h 3s] [5h]
pussy del777: checks 
sólyom333: bets $0.86
pussy del777: raises $2.34 to $3.20
sólyom333: folds 
Uncalled bet ($2.34) returned to pussy del777
pussy del777 collected $2.93 from pot
pussy del777: doesn't show hand 
*** SUMMARY ***
Total pot $3.07 | Rake $0.14 
Board [2c 8h 3s 5h]
Seat 1: ShaunMM (button) folded before Flop (didn't bet)
Seat 2: Manon4ik (small blind) folded before Flop
Seat 3: Oleg032 (big blind) folded before Flop
Seat 4: pussy del777 collected ($2.93)
Seat 5: sólyom333 folded on the Turn
Seat 6: namemattbark folded before Flop (didn't bet)



PokerStars Hand #222965011774:  Hold'em No Limit ($0.05/$0.10 USD) - 2021/01/23 13:57:31 ET
Table 'Shura III' 6-max Seat #2 is the button
Seat 1: ShaunMM ($10.91 in chips) 
Seat 2: Manon4ik ($10 in chips) 
Seat 3: Oleg032 ($10 in chips) 
Seat 4: pussy del777 ($15.15 in chips) 
Seat 5: sólyom333 ($9.69 in chips) 
Seat 6: namemattbark ($10.66 in chips) 
Oleg032: posts small blind $0.05
pussy del777: posts big blind $0.10
*** HOLE CARDS ***
sólyom333: folds 
namemattbark: folds 
ShaunMM: raises $0.20 to $0.30
Manon4ik: folds 
Oleg032: folds 
pussy del777: calls $0.20
*** FLOP *** [Tc 8d 4c]
pussy del777: checks 
ShaunMM: bets $0.30
pussy del777: calls $0.30
*** TURN *** [Tc 8d 4c] [2c]
pussy del777: checks 
ShaunMM: checks 
*** RIVER *** [Tc 8d 4c 2c] [Th]
pussy del777: bets $0.40
ShaunMM: folds 
Uncalled bet ($0.40) returned to pussy del777
pussy del777 collected $1.19 from pot
pussy del777: doesn't show hand 
*** SUMMARY ***
Total pot $1.25 | Rake $0.06 
Board [Tc 8d 4c 2c Th]
Seat 1: ShaunMM folded on the River
Seat 2: Manon4ik (button) folded before Flop (didn't bet)
Seat 3: Oleg032 (small blind) folded before Flop
Seat 4: pussy del777 (big blind) collected ($1.19)
Seat 5: sólyom333 folded before Flop (didn't bet)
Seat 6: namemattbark folded before Flop (didn't bet)



PokerStars Hand #222965037877:  Hold'em No Limit ($0.05/$0.10 USD) - 2021/01/23 13:58:24 ET
Table 'Shura III' 6-max Seat #3 is the button
Seat 1: ShaunMM ($10.31 in chips) 
Seat 2: Manon4ik ($10 in chips) 
Seat 3: Oleg032 ($10 in chips) 
Seat 4: pussy del777 ($15.74 in chips) 
Seat 5: sólyom333 ($9.69 in chips) 
Seat 6: namemattbark ($10.66 in chips) 
pussy del777: posts small blind $0.05
sólyom333: posts big blind $0.10
*** HOLE CARDS ***
namemattbark: folds 
ShaunMM: folds 
Manon4ik: folds 
Oleg032: raises $0.15 to $0.25
pussy del777: calls $0.20
sólyom333: folds 
*** FLOP *** [Jd Kd Ah]
pussy del777: checks 
Oleg032: bets $0.19
pussy del777: calls $0.19
*** TURN *** [Jd Kd Ah] [As]
pussy del777: checks 
Oleg032: checks 
*** RIVER *** [Jd Kd Ah As] [7s]
pussy del777: checks 
Oleg032: bets $0.71
pussy del777: folds 
Uncalled bet ($0.71) returned to Oleg032
Oleg032 collected $0.94 from pot
Oleg032: doesn't show hand 
*** SUMMARY ***
Total pot $0.98 | Rake $0.04 
Board [Jd Kd Ah As 7s]
Seat 1: ShaunMM folded before Flop (didn't bet)
Seat 2: Manon4ik folded before Flop (didn't bet)
Seat 3: Oleg032 (button) collected ($0.94)
Seat 4: pussy del777 (small blind) folded on the River
Seat 5: sólyom333 (big blind) folded before Flop
Seat 6: namemattbark folded before Flop (didn't bet)



PokerStars Hand #222965076458:  Hold'em No Limit ($0.05/$0.10 USD) - 2021/01/23 13:59:43 ET
Table 'Shura III' 6-max Seat #4 is the button
Seat 1: ShaunMM ($10.31 in chips) 
Seat 2: Manon4ik ($10 in chips) 
Seat 3: Oleg032 ($10.50 in chips) 
Seat 4: pussy del777 ($15.30 in chips) 
Seat 5: sólyom333 ($9.59 in chips) 
Seat 6: namemattbark ($10.66 in chips) 
sólyom333: posts small blind $0.05
namemattbark: posts big blind $0.10
*** HOLE CARDS ***
ShaunMM: raises $0.20 to $0.30
Manon4ik: folds 
Oleg032: calls $0.30
pussy del777: folds 
sólyom333: raises $0.85 to $1.15
namemattbark: folds 
ShaunMM: calls $0.85
Oleg032: folds 
*** FLOP *** [6d Kd Ad]
sólyom333: checks 
ShaunMM: bets $0.90
sólyom333: folds 
Uncalled bet ($0.90) returned to ShaunMM
pussy del777 leaves the table
ShaunMM collected $2.58 from pot
ShaunMM: doesn't show hand 
*** SUMMARY ***
Total pot $2.70 | Rake $0.12 
Board [6d Kd Ad]
Seat 1: ShaunMM collected ($2.58)
Seat 2: Manon4ik folded before Flop (didn't bet)
Seat 3: Oleg032 folded before Flop
Seat 4: pussy del777 (button) folded before Flop (didn't bet)
Seat 5: sólyom333 (small blind) folded on the Flop
Seat 6: namemattbark (big blind) folded before Flop



PokerStars Hand #222965105320:  Hold'em No Limit ($0.05/$0.10 USD) - 2021/01/23 14:00:37 ET
Table 'Shura III' 6-max Seat #5 is the button
Seat 1: ShaunMM ($11.74 in chips) 
Seat 2: Manon4ik ($10 in chips) 
Seat 3: Oleg032 ($10.20 in chips) 
Seat 5: sólyom333 ($10 in chips) 
Seat 6: namemattbark ($10.56 in chips) 
namemattbark: posts small blind $0.05
ShaunMM: posts big blind $0.10
*** HOLE CARDS ***
Manon4ik: folds 
Oleg032: folds 
sólyom333: folds 
namemattbark: folds 
Uncalled bet ($0.05) returned to ShaunMM
ShaunMM collected $0.10 from pot
ShaunMM: doesn't show hand 
*** SUMMARY ***
Total pot $0.10 | Rake $0 
Seat 1: ShaunMM (big blind) collected ($0.10)
Seat 2: Manon4ik folded before Flop (didn't bet)
Seat 3: Oleg032 folded before Flop (didn't bet)
Seat 5: sólyom333 (button) folded before Flop (didn't bet)
Seat 6: namemattbark (small blind) folded before Flop



PokerStars Hand #222965114123:  Hold'em No Limit ($0.05/$0.10 USD) - 2021/01/23 14:00:53 ET
Table 'Shura III' 6-max Seat #6 is the button
Seat 1: ShaunMM ($11.79 in chips) 
Seat 2: Manon4ik ($10 in chips) 
Seat 3: Oleg032 ($10.20 in chips) 
Seat 5: sólyom333 ($10 in chips) 
Seat 6: namemattbark ($10.51 in chips) 
ShaunMM: posts small blind $0.05
Manon4ik: posts big blind $0.10
*** HOLE CARDS ***
Oleg032: folds 
sólyom333: raises $0.18 to $0.28
namemattbark: folds 
LBA_UNO joins the table at seat #4 
ShaunMM: calls $0.23
Manon4ik: folds 
*** FLOP *** [9h Ad 5h]
ShaunMM: checks 
sólyom333: bets $0.26
ShaunMM: calls $0.26
*** TURN *** [9h Ad 5h] [5d]
ShaunMM: checks 
sólyom333: bets $0.75
ShaunMM: calls $0.75
*** RIVER *** [9h Ad 5h 5d] [6c]
ShaunMM: checks 
sólyom333: bets $1.71
ShaunMM: folds 
Uncalled bet ($1.71) returned to sólyom333
sólyom333 collected $2.56 from pot
sólyom333: doesn't show hand 
*** SUMMARY ***
Total pot $2.68 | Rake $0.12 
Board [9h Ad 5h 5d 6c]
Seat 1: ShaunMM (small blind) folded on the River
Seat 2: Manon4ik (big blind) folded before Flop
Seat 3: Oleg032 folded before Flop (didn't bet)
Seat 5: sólyom333 collected ($2.56)
Seat 6: namemattbark (button) folded before Flop (didn't bet)



PokerStars Hand #222965150356:  Hold'em No Limit ($0.05/$0.10 USD) - 2021/01/23 14:01:48 ET
Table 'Shura III' 6-max Seat #1 is the button
Seat 1: ShaunMM ($10.50 in chips) 
Seat 2: Manon4ik ($10 in chips) 
Seat 3: Oleg032 ($10.20 in chips) 
Seat 5: sólyom333 ($11.27 in chips) 
Seat 6: namemattbark ($10.51 in chips) 
Manon4ik: posts small blind $0.05
Oleg032: posts big blind $0.10
LBA_UNO: sits out 
*** HOLE CARDS ***
sólyom333: raises $0.18 to $0.28
namemattbark: folds 
ShaunMM: calls $0.28
Manon4ik: calls $0.23
Oleg032: folds 
*** FLOP *** [8s 9c Qs]
Manon4ik: checks 
sólyom333: checks 
ShaunMM: bets $0.60
Manon4ik: folds 
sólyom333: folds 
Uncalled bet ($0.60) returned to ShaunMM
ShaunMM collected $0.90 from pot
ShaunMM: doesn't show hand 
*** SUMMARY ***
Total pot $0.94 | Rake $0.04 
Board [8s 9c Qs]
Seat 1: ShaunMM (button) collected ($0.90)
Seat 2: Manon4ik (small blind) folded on the Flop
Seat 3: Oleg032 (big blind) folded before Flop
Seat 5: sólyom333 folded on the Flop
Seat 6: namemattbark folded before Flop (didn't bet)



PokerStars Hand #222965195033:  Hold'em No Limit ($0.05/$0.10 USD) - 2021/01/23 14:02:38 ET
Table 'Shura III' 6-max Seat #2 is the button
Seat 1: ShaunMM ($11.12 in chips) 
Seat 2: Manon4ik ($10 in chips) 
Seat 3: Oleg032 ($10.10 in chips) 
Seat 4: LBA_UNO ($10 in chips) 
Seat 5: sólyom333 ($10.99 in chips) 
Seat 6: namemattbark ($10.51 in chips) 
Oleg032: posts small blind $0.05
LBA_UNO: posts big blind $0.10
*** HOLE CARDS ***
sólyom333: folds 
namemattbark: raises $0.13 to $0.23
ShaunMM: calls $0.23
Manon4ik: folds 
Oleg032: folds 
LBA_UNO: folds 
*** FLOP *** [7s Ac 3d]
namemattbark: bets $0.32
ShaunMM: folds 
Uncalled bet ($0.32) returned to namemattbark
namemattbark collected $0.58 from pot
namemattbark: doesn't show hand 
*** SUMMARY ***
Total pot $0.61 | Rake $0.03 
Board [7s Ac 3d]
Seat 1: ShaunMM folded on the Flop
Seat 2: Manon4ik (button) folded before Flop (didn't bet)
Seat 3: Oleg032 (small blind) folded before Flop
Seat 4: LBA_UNO (big blind) folded before Flop
Seat 5: sólyom333 folded before Flop (didn't bet)
Seat 6: namemattbark collected ($0.58)



PokerStars Hand #222965217594:  Hold'em No Limit ($0.05/$0.10 USD) - 2021/01/23 14:03:07 ET
Table 'Shura III' 6-max Seat #3 is the button
Seat 1: ShaunMM ($10.89 in chips) 
Seat 2: Manon4ik ($10 in chips) 
Seat 3: Oleg032 ($10.05 in chips) 
Seat 4: LBA_UNO ($10 in chips) 
Seat 5: sólyom333 ($10.99 in chips) 
Seat 6: namemattbark ($10.86 in chips) 
LBA_UNO: posts small blind $0.05
sólyom333: posts big blind $0.10
*** HOLE CARDS ***
namemattbark: folds 
ShaunMM: folds 
Manon4ik has timed out
Manon4ik: folds 
Oleg032: folds 
LBA_UNO: raises $0.20 to $0.30
sólyom333: folds 
Uncalled bet ($0.20) returned to LBA_UNO
LBA_UNO collected $0.20 from pot
LBA_UNO: doesn't show hand 
*** SUMMARY ***
Total pot $0.20 | Rake $0 
Seat 1: ShaunMM folded before Flop (didn't bet)
Seat 2: Manon4ik folded before Flop (didn't bet)
Seat 3: Oleg032 (button) folded before Flop (didn't bet)
Seat 4: LBA_UNO (small blind) collected ($0.20)
Seat 5: sólyom333 (big blind) folded before Flop
Seat 6: namemattbark folded before Flop (didn't bet)



PokerStars Hand #222965238274:  Hold'em No Limit ($0.05/$0.10 USD) - 2021/01/23 14:03:34 ET
Table 'Shura III' 6-max Seat #4 is the button
Seat 1: ShaunMM ($10.89 in chips) 
Seat 2: Manon4ik ($10 in chips) 
Seat 3: Oleg032 ($10.05 in chips) 
Seat 4: LBA_UNO ($10.10 in chips) 
Seat 5: sólyom333 ($10.89 in chips) 
Seat 6: namemattbark ($10.86 in chips) 
sólyom333: posts small blind $0.05
namemattbark: posts big blind $0.10
*** HOLE CARDS ***
ShaunMM: folds 
Manon4ik: folds 
Oleg032: folds 
LBA_UNO: raises $0.14 to $0.24
sólyom333: folds 
namemattbark: folds 
Uncalled bet ($0.14) returned to LBA_UNO
LBA_UNO collected $0.25 from pot
LBA_UNO: doesn't show hand 
*** SUMMARY ***
Total pot $0.25 | Rake $0 
Seat 1: ShaunMM folded before Flop (didn't bet)
Seat 2: Manon4ik folded before Flop (didn't bet)
Seat 3: Oleg032 folded before Flop (didn't bet)
Seat 4: LBA_UNO (button) collected ($0.25)
Seat 5: sólyom333 (small blind) folded before Flop
Seat 6: namemattbark (big blind) folded before Flop



PokerStars Hand #222965246703:  Hold'em No Limit ($0.05/$0.10 USD) - 2021/01/23 14:03:44 ET
Table 'Shura III' 6-max Seat #5 is the button
Seat 2: Manon4ik ($10 in chips) 
Seat 3: Oleg032 ($10.05 in chips) 
Seat 4: LBA_UNO ($10.25 in chips) 
Seat 5: sólyom333 ($10.84 in chips) 
Seat 6: namemattbark ($10.76 in chips) 
namemattbark: posts small blind $0.05
Manon4ik: posts big blind $0.10
*** HOLE CARDS ***
ShaunMM leaves the table
Oleg032: folds 
LBA_UNO: raises $0.20 to $0.30
Marder1388 joins the table at seat #1 
sólyom333: folds 
namemattbark: folds 
Manon4ik: folds 
Uncalled bet ($0.20) returned to LBA_UNO
LBA_UNO collected $0.25 from pot
LBA_UNO: doesn't show hand 
*** SUMMARY ***
Total pot $0.25 | Rake $0 
Seat 2: Manon4ik (big blind) folded before Flop
Seat 3: Oleg032 folded before Flop (didn't bet)
Seat 4: LBA_UNO collected ($0.25)
Seat 5: sólyom333 (button) folded before Flop (didn't bet)
Seat 6: namemattbark (small blind) folded before Flop



PokerStars Hand #222965255501:  Hold'em No Limit ($0.05/$0.10 USD) - 2021/01/23 14:03:55 ET
Table 'Shura III' 6-max Seat #6 is the button
Seat 2: Manon4ik ($10 in chips) 
Seat 3: Oleg032 ($10.05 in chips) 
Seat 4: LBA_UNO ($10.40 in chips) 
Seat 5: sólyom333 ($10.84 in chips) 
Seat 6: namemattbark ($10.71 in chips) 
Manon4ik: posts small blind $0.05
Oleg032: posts big blind $0.10
*** HOLE CARDS ***
LBA_UNO: raises $0.20 to $0.30
sólyom333: folds 
namemattbark: folds 
Manon4ik: folds 
Oleg032: folds 
Uncalled bet ($0.20) returned to LBA_UNO
LBA_UNO collected $0.25 from pot
LBA_UNO: doesn't show hand 
*** SUMMARY ***
Total pot $0.25 | Rake $0 
Seat 2: Manon4ik (small blind) folded before Flop
Seat 3: Oleg032 (big blind) folded before Flop
Seat 4: LBA_UNO collected ($0.25)
Seat 5: sólyom333 folded before Flop (didn't bet)
Seat 6: namemattbark (button) folded before Flop (didn't bet)



PokerStars Hand #222965261778:  Hold'em No Limit ($0.05/$0.10 USD) - 2021/01/23 14:04:04 ET
Table 'Shura III' 6-max Seat #2 is the button
Seat 1: Marder1388 ($10 in chips) 
Seat 2: Manon4ik ($10 in chips) 
Seat 3: Oleg032 ($10 in chips) 
Seat 4: LBA_UNO ($10.55 in chips) 
Seat 5: sólyom333 ($10.84 in chips) 
Seat 6: namemattbark ($10.71 in chips) 
Oleg032: posts small blind $0.05
LBA_UNO: posts big blind $0.10
Marder1388: posts big blind $0.10
*** HOLE CARDS ***
sólyom333: folds 
namemattbark: folds 
Marder1388: checks 
Manon4ik: folds 
Oleg032: folds 
LBA_UNO: raises $0.40 to $0.50
Marder1388: calls $0.40
*** FLOP *** [5s Jh Qd]
LBA_UNO: checks 
Marder1388: checks 
*** TURN *** [5s Jh Qd] [2h]
LBA_UNO: bets $0.33
Marder1388: calls $0.33
*** RIVER *** [5s Jh Qd 2h] [Js]
LBA_UNO: bets $1.22
Marder1388: folds 
Uncalled bet ($1.22) returned to LBA_UNO
LBA_UNO collected $1.63 from pot
LBA_UNO: doesn't show hand 
*** SUMMARY ***
Total pot $1.71 | Rake $0.08 
Board [5s Jh Qd 2h Js]
Seat 1: Marder1388 folded on the River
Seat 2: Manon4ik (button) folded before Flop (didn't bet)
Seat 3: Oleg032 (small blind) folded before Flop
Seat 4: LBA_UNO (big blind) collected ($1.63)
Seat 5: sólyom333 folded before Flop (didn't bet)
Seat 6: namemattbark folded before Flop (didn't bet)



PokerStars Hand #222965288933:  Hold'em No Limit ($0.05/$0.10 USD) - 2021/01/23 14:04:38 ET
Table 'Shura III' 6-max Seat #3 is the button
Seat 1: Marder1388 ($9.17 in chips) 
Seat 2: Manon4ik ($10 in chips) 
Seat 3: Oleg032 ($10 in chips) 
Seat 4: LBA_UNO ($11.35 in chips) 
Seat 5: sólyom333 ($10.84 in chips) 
Seat 6: namemattbark ($10.71 in chips) 
LBA_UNO: posts small blind $0.05
sólyom333: posts big blind $0.10
*** HOLE CARDS ***
namemattbark: folds 
Marder1388: calls $0.10
Manon4ik: folds 
Oleg032: folds 
LBA_UNO: folds 
sólyom333: checks 
*** FLOP *** [6c Td Qs]
sólyom333: bets $0.21
Marder1388: calls $0.21
*** TURN *** [6c Td Qs] [7s]
sólyom333: checks 
Marder1388: checks 
*** RIVER *** [6c Td Qs 7s] [Tc]
sólyom333: checks 
Marder1388: bets $0.32
sólyom333: calls $0.32
*** SHOW DOWN ***
Marder1388: shows [Qh 4c] (two pair, Queens and Tens)
sólyom333: mucks hand 
Marder1388 collected $1.25 from pot
*** SUMMARY ***
Total pot $1.31 | Rake $0.06 
Board [6c Td Qs 7s Tc]
Seat 1: Marder1388 showed [Qh 4c] and won ($1.25) with two pair, Queens and Tens
Seat 2: Manon4ik folded before Flop (didn't bet)
Seat 3: Oleg032 (button) folded before Flop (didn't bet)
Seat 4: LBA_UNO (small blind) folded before Flop
Seat 5: sólyom333 (big blind) mucked
Seat 6: namemattbark folded before Flop (didn't bet)



PokerStars Hand #222965320292:  Hold'em No Limit ($0.05/$0.10 USD) - 2021/01/23 14:05:17 ET
Table 'Shura III' 6-max Seat #4 is the button
Seat 1: Marder1388 ($9.79 in chips) 
Seat 2: Manon4ik ($10 in chips) 
Seat 3: Oleg032 ($10 in chips) 
Seat 4: LBA_UNO ($11.30 in chips) 
Seat 5: sólyom333 ($10.21 in chips) 
Seat 6: namemattbark ($10.71 in chips) 
sólyom333: posts small blind $0.05
namemattbark: posts big blind $0.10
*** HOLE CARDS ***
Marder1388: folds 
Manon4ik: folds 
Oleg032: folds 
LBA_UNO: folds 
sólyom333: raises $0.20 to $0.30
namemattbark: calls $0.20
*** FLOP *** [Th 4h 6d]
sólyom333: checks 
namemattbark: checks 
*** TURN *** [Th 4h 6d] [8s]
sólyom333: checks 
namemattbark: checks 
*** RIVER *** [Th 4h 6d 8s] [Kc]
sólyom333: checks 
namemattbark: bets $0.43
sólyom333: folds 
Uncalled bet ($0.43) returned to namemattbark
namemattbark collected $0.57 from pot
namemattbark: doesn't show hand 
*** SUMMARY ***
Total pot $0.60 | Rake $0.03 
Board [Th 4h 6d 8s Kc]
Seat 1: Marder1388 folded before Flop (didn't bet)
Seat 2: Manon4ik folded before Flop (didn't bet)
Seat 3: Oleg032 folded before Flop (didn't bet)
Seat 4: LBA_UNO (button) folded before Flop (didn't bet)
Seat 5: sólyom333 (small blind) folded on the River
Seat 6: namemattbark (big blind) collected ($0.57)



PokerStars Hand #222965347967:  Hold'em No Limit ($0.05/$0.10 USD) - 2021/01/23 14:05:53 ET
Table 'Shura III' 6-max Seat #5 is the button
Seat 1: Marder1388 ($9.79 in chips) 
Seat 2: Manon4ik ($10 in chips) 
Seat 3: Oleg032 ($10 in chips) 
Seat 4: LBA_UNO ($11.30 in chips) 
Seat 5: sólyom333 ($9.91 in chips) 
Seat 6: namemattbark ($10.98 in chips) 
namemattbark: posts small blind $0.05
Marder1388: posts big blind $0.10
*** HOLE CARDS ***
Manon4ik: folds 
Oleg032: raises $0.15 to $0.25
LBA_UNO: folds 
sólyom333: folds 
namemattbark: folds 
Marder1388: calls $0.15
*** FLOP *** [6h Js 4s]
Marder1388: checks 
Oleg032: checks 
*** TURN *** [6h Js 4s] [2h]
Marder1388: bets $0.27
Oleg032: calls $0.27
*** RIVER *** [6h Js 4s 2h] [Ah]
Marder1388: checks 
Oleg032: checks 
*** SHOW DOWN ***
Marder1388: shows [Kd Jd] (a pair of Jacks)
Oleg032: mucks hand 
Marder1388 collected $1.04 from pot
*** SUMMARY ***
Total pot $1.09 | Rake $0.05 
Board [6h Js 4s 2h Ah]
Seat 1: Marder1388 (big blind) showed [Kd Jd] and won ($1.04) with a pair of Jacks
Seat 2: Manon4ik folded before Flop (didn't bet)
Seat 3: Oleg032 mucked
Seat 4: LBA_UNO folded before Flop (didn't bet)
Seat 5: sólyom333 (button) folded before Flop (didn't bet)
Seat 6: namemattbark (small blind) folded before Flop



PokerStars Hand #222965388723:  Hold'em No Limit ($0.05/$0.10 USD) - 2021/01/23 14:06:44 ET
Table 'Shura III' 6-max Seat #6 is the button
Seat 1: Marder1388 ($10.31 in chips) 
Seat 2: Manon4ik ($10 in chips) 
Seat 3: Oleg032 ($10 in chips) 
Seat 4: LBA_UNO ($11.30 in chips) 
Seat 5: sólyom333 ($9.91 in chips) 
Seat 6: namemattbark ($10.93 in chips) 
Marder1388: posts small blind $0.05
Manon4ik: posts big blind $0.10
*** HOLE CARDS ***
Oleg032: folds 
LBA_UNO: folds 
sólyom333: folds 
namemattbark: folds 
Marder1388: calls $0.05
Manon4ik: checks 
*** FLOP *** [Qs 7s 9s]
Marder1388: bets $0.10
Manon4ik: folds 
Uncalled bet ($0.10) returned to Marder1388
Marder1388 collected $0.19 from pot
Marder1388: doesn't show hand 
*** SUMMARY ***
Total pot $0.20 | Rake $0.01 
Board [Qs 7s 9s]
Seat 1: Marder1388 (small blind) collected ($0.19)
Seat 2: Manon4ik (big blind) folded on the Flop
Seat 3: Oleg032 folded before Flop (didn't bet)
Seat 4: LBA_UNO folded before Flop (didn't bet)
Seat 5: sólyom333 folded before Flop (didn't bet)
Seat 6: namemattbark (button) folded before Flop (didn't bet)



PokerStars Hand #222965414151:  Hold'em No Limit ($0.05/$0.10 USD) - 2021/01/23 14:07:16 ET
Table 'Shura III' 6-max Seat #1 is the button
Seat 1: Marder1388 ($10.40 in chips) 
Seat 2: Manon4ik ($10 in chips) 
Seat 3: Oleg032 ($10 in chips) 
Seat 4: LBA_UNO ($11.30 in chips) 
Seat 5: sólyom333 ($9.91 in chips) 
Seat 6: namemattbark ($10.93 in chips) 
Manon4ik: posts small blind $0.05
Oleg032: posts big blind $0.10
*** HOLE CARDS ***
LBA_UNO: raises $0.20 to $0.30
sólyom333: folds 
namemattbark: folds 
Marder1388: calls $0.30
Manon4ik: folds 
Oleg032: folds 
*** FLOP *** [As 8s 4h]
LBA_UNO: bets $0.24
Marder1388: calls $0.24
*** TURN *** [As 8s 4h] [8h]
LBA_UNO: checks 
Marder1388: checks 
*** RIVER *** [As 8s 4h 8h] [Qh]
LBA_UNO: checks 
Marder1388: checks 
*** SHOW DOWN ***
LBA_UNO: shows [Jh Jc] (two pair, Jacks and Eights)
Marder1388: shows [Qs 5s] (two pair, Queens and Eights)
Marder1388 collected $1.17 from pot
*** SUMMARY ***
Total pot $1.23 | Rake $0.06 
Board [As 8s 4h 8h Qh]
Seat 1: Marder1388 (button) showed [Qs 5s] and won ($1.17) with two pair, Queens and Eights
Seat 2: Manon4ik (small blind) folded before Flop
Seat 3: Oleg032 (big blind) folded before Flop
Seat 4: LBA_UNO showed [Jh Jc] and lost with two pair, Jacks and Eights
Seat 5: sólyom333 folded before Flop (didn't bet)
Seat 6: namemattbark folded before Flop (didn't bet)



PokerStars Hand #222965439842:  Hold'em No Limit ($0.05/$0.10 USD) - 2021/01/23 14:07:48 ET
Table 'Shura III' 6-max Seat #2 is the button
Seat 1: Marder1388 ($11.03 in chips) 
Seat 2: Manon4ik ($10 in chips) 
Seat 3: Oleg032 ($10 in chips) 
Seat 4: LBA_UNO ($10.76 in chips) 
Seat 5: sólyom333 ($9.91 in chips) 
Seat 6: namemattbark ($10.93 in chips) 
Oleg032: posts small blind $0.05
LBA_UNO: posts big blind $0.10
*** HOLE CARDS ***
sólyom333: folds 
namemattbark: folds 
Marder1388: folds 
Manon4ik: folds 
Oleg032: raises $0.20 to $0.30
LBA_UNO: folds 
Uncalled bet ($0.20) returned to Oleg032
Oleg032 collected $0.20 from pot
Oleg032: doesn't show hand 
*** SUMMARY ***
Total pot $0.20 | Rake $0 
Seat 1: Marder1388 folded before Flop (didn't bet)
Seat 2: Manon4ik (button) folded before Flop (didn't bet)
Seat 3: Oleg032 (small blind) collected ($0.20)
Seat 4: LBA_UNO (big blind) folded before Flop
Seat 5: sólyom333 folded before Flop (didn't bet)
Seat 6: namemattbark folded before Flop (didn't bet)



PokerStars Hand #222965452554:  Hold'em No Limit ($0.05/$0.10 USD) - 2021/01/23 14:08:05 ET
Table 'Shura III' 6-max Seat #3 is the button
Seat 1: Marder1388 ($11.03 in chips) 
Seat 2: Manon4ik ($10 in chips) 
Seat 3: Oleg032 ($10.10 in chips) 
Seat 4: LBA_UNO ($10.66 in chips) 
Seat 5: sólyom333 ($9.91 in chips) 
Seat 6: namemattbark ($10.93 in chips) 
LBA_UNO: posts small blind $0.05
sólyom333: posts big blind $0.10
*** HOLE CARDS ***
namemattbark: folds 
Marder1388: raises $0.10 to $0.20
Manon4ik: folds 
Oleg032: folds 
LBA_UNO: folds 
sólyom333: folds 
Uncalled bet ($0.10) returned to Marder1388
Marder1388 collected $0.25 from pot
Marder1388: doesn't show hand 
*** SUMMARY ***
Total pot $0.25 | Rake $0 
Seat 1: Marder1388 collected ($0.25)
Seat 2: Manon4ik folded before Flop (didn't bet)
Seat 3: Oleg032 (button) folded before Flop (didn't bet)
Seat 4: LBA_UNO (small blind) folded before Flop
Seat 5: sólyom333 (big blind) folded before Flop
Seat 6: namemattbark folded before Flop (didn't bet)



PokerStars Hand #222965463628:  Hold'em No Limit ($0.05/$0.10 USD) - 2021/01/23 14:08:19 ET
Table 'Shura III' 6-max Seat #4 is the button
Seat 1: Marder1388 ($11.18 in chips) 
Seat 2: Manon4ik ($10 in chips) 
Seat 3: Oleg032 ($10.10 in chips) 
Seat 4: LBA_UNO ($10.61 in chips) 
Seat 5: sólyom333 ($9.81 in chips) 
Seat 6: namemattbark ($10.93 in chips) 
sólyom333: posts small blind $0.05
namemattbark: posts big blind $0.10
*** HOLE CARDS ***
Marder1388: folds 
Manon4ik has timed out
Manon4ik: folds 
Oleg032: raises $0.15 to $0.25
LBA_UNO: folds 
sólyom333: folds 
namemattbark: folds 
Uncalled bet ($0.15) returned to Oleg032
Oleg032 collected $0.25 from pot
Oleg032: doesn't show hand 
*** SUMMARY ***
Total pot $0.25 | Rake $0 
Seat 1: Marder1388 folded before Flop (didn't bet)
Seat 2: Manon4ik folded before Flop (didn't bet)
Seat 3: Oleg032 collected ($0.25)
Seat 4: LBA_UNO (button) folded before Flop (didn't bet)
Seat 5: sólyom333 (small blind) folded before Flop
Seat 6: namemattbark (big blind) folded before Flop



PokerStars Hand #222965480696:  Hold'em No Limit ($0.05/$0.10 USD) - 2021/01/23 14:08:40 ET
Table 'Shura III' 6-max Seat #5 is the button
Seat 1: Marder1388 ($11.18 in chips) 
Seat 2: Manon4ik ($10 in chips) 
Seat 3: Oleg032 ($10.25 in chips) 
Seat 4: LBA_UNO ($10.61 in chips) 
Seat 5: sólyom333 ($9.76 in chips) 
Seat 6: namemattbark ($10.83 in chips) 
namemattbark: posts small blind $0.05
Marder1388: posts big blind $0.10
*** HOLE CARDS ***
Manon4ik: raises $0.20 to $0.30
Oleg032: folds 
LBA_UNO: folds 
sólyom333: folds 
namemattbark: folds 
Marder1388: folds 
Uncalled bet ($0.20) returned to Manon4ik
Manon4ik collected $0.25 from pot
Manon4ik: doesn't show hand 
*** SUMMARY ***
Total pot $0.25 | Rake $0 
Seat 1: Marder1388 (big blind) folded before Flop
Seat 2: Manon4ik collected ($0.25)
Seat 3: Oleg032 folded before Flop (didn't bet)
Seat 4: LBA_UNO folded before Flop (didn't bet)
Seat 5: sólyom333 (button) folded before Flop (didn't bet)
Seat 6: namemattbark (small blind) folded before Flop



PokerStars Hand #222965489936:  Hold'em No Limit ($0.05/$0.10 USD) - 2021/01/23 14:08:51 ET
Table 'Shura III' 6-max Seat #6 is the button
Seat 1: Marder1388 ($11.08 in chips) 
Seat 2: Manon4ik ($10.15 in chips) 
Seat 3: Oleg032 ($10.25 in chips) 
Seat 4: LBA_UNO ($10.61 in chips) 
Seat 5: sólyom333 ($9.76 in chips) 
Seat 6: namemattbark ($10.78 in chips) 
Marder1388: posts small blind $0.05
Manon4ik: posts big blind $0.10
*** HOLE CARDS ***
Oleg032: folds 
LBA_UNO: folds 
sólyom333: raises $0.18 to $0.28
namemattbark: folds 
Marder1388: folds 
Manon4ik: calls $0.18
*** FLOP *** [2s 3c Kc]
Manon4ik: checks 
sólyom333: bets $0.24
Manon4ik: folds 
Uncalled bet ($0.24) returned to sólyom333
sólyom333 collected $0.58 from pot
sólyom333: doesn't show hand 
*** SUMMARY ***
Total pot $0.61 | Rake $0.03 
Board [2s 3c Kc]
Seat 1: Marder1388 (small blind) folded before Flop
Seat 2: Manon4ik (big blind) folded on the Flop
Seat 3: Oleg032 folded before Flop (didn't bet)
Seat 4: LBA_UNO folded before Flop (didn't bet)
Seat 5: sólyom333 collected ($0.58)
Seat 6: namemattbark (button) folded before Flop (didn't bet)



PokerStars Hand #222965525908:  Hold'em No Limit ($0.05/$0.10 USD) - 2021/01/23 14:09:37 ET
Table 'Shura III' 6-max Seat #1 is the button
Seat 1: Marder1388 ($11.03 in chips) 
Seat 2: Manon4ik ($10 in chips) 
Seat 3: Oleg032 ($10.25 in chips) 
Seat 4: LBA_UNO ($10.61 in chips) 
Seat 5: sólyom333 ($10.06 in chips) 
Seat 6: namemattbark ($10.78 in chips) 
Manon4ik: posts small blind $0.05
Oleg032: posts big blind $0.10
*** HOLE CARDS ***
LBA_UNO: raises $0.20 to $0.30
sólyom333: folds 
namemattbark: folds 
Marder1388: calls $0.30
Manon4ik: folds 
Oleg032: folds 
*** FLOP *** [5d 8s 3d]
LBA_UNO: checks 
Marder1388: bets $0.36
LBA_UNO: calls $0.36
*** TURN *** [5d 8s 3d] [Qs]
LBA_UNO: checks 
Marder1388: checks 
*** RIVER *** [5d 8s 3d Qs] [7d]
LBA_UNO: bets $1.05
Marder1388: folds 
Uncalled bet ($1.05) returned to LBA_UNO
LBA_UNO collected $1.40 from pot
LBA_UNO: doesn't show hand 
*** SUMMARY ***
Total pot $1.47 | Rake $0.07 
Board [5d 8s 3d Qs 7d]
Seat 1: Marder1388 (button) folded on the River
Seat 2: Manon4ik (small blind) folded before Flop
Seat 3: Oleg032 (big blind) folded before Flop
Seat 4: LBA_UNO collected ($1.40)
Seat 5: sólyom333 folded before Flop (didn't bet)
Seat 6: namemattbark folded before Flop (didn't bet)



PokerStars Hand #222965551034:  Hold'em No Limit ($0.05/$0.10 USD) - 2021/01/23 14:10:09 ET
Table 'Shura III' 6-max Seat #2 is the button
Seat 1: Marder1388 ($10.37 in chips) 
Seat 2: Manon4ik ($10 in chips) 
Seat 3: Oleg032 ($10.15 in chips) 
Seat 4: LBA_UNO ($11.35 in chips) 
Seat 5: sólyom333 ($10.06 in chips) 
Seat 6: namemattbark ($10.78 in chips) 
Oleg032: posts small blind $0.05
LBA_UNO: posts big blind $0.10
*** HOLE CARDS ***
sólyom333: folds 
namemattbark: raises $0.13 to $0.23
Marder1388 has timed out
Marder1388: folds 
Manon4ik: calls $0.23
Oleg032: folds 
LBA_UNO: folds 
*** FLOP *** [7s 8s 5c]
namemattbark: checks 
Manon4ik: checks 
*** TURN *** [7s 8s 5c] [Th]
namemattbark: bets $0.44
Manon4ik: folds 
Uncalled bet ($0.44) returned to namemattbark
namemattbark collected $0.58 from pot
namemattbark: doesn't show hand 
*** SUMMARY ***
Total pot $0.61 | Rake $0.03 
Board [7s 8s 5c Th]
Seat 1: Marder1388 folded before Flop (didn't bet)
Seat 2: Manon4ik (button) folded on the Turn
Seat 3: Oleg032 (small blind) folded before Flop
Seat 4: LBA_UNO (big blind) folded before Flop
Seat 5: sólyom333 folded before Flop (didn't bet)
Seat 6: namemattbark collected ($0.58)



PokerStars Hand #222965596956:  Hold'em No Limit ($0.05/$0.10 USD) - 2021/01/23 14:11:07 ET
Table 'Shura III' 6-max Seat #3 is the button
Seat 1: Marder1388 ($10.37 in chips) 
Seat 2: Manon4ik ($10 in chips) 
Seat 3: Oleg032 ($10.10 in chips) 
Seat 4: LBA_UNO ($11.25 in chips) 
Seat 5: sólyom333 ($10.06 in chips) 
Seat 6: namemattbark ($11.13 in chips) 
LBA_UNO: posts small blind $0.05
sólyom333: posts big blind $0.10
*** HOLE CARDS ***
namemattbark: raises $0.13 to $0.23
Marder1388: folds 
Manon4ik: folds 
Oleg032: raises $0.67 to $0.90
LBA_UNO: folds 
sólyom333: folds 
namemattbark: calls $0.67
*** FLOP *** [Js 4d 8h]
namemattbark: bets $1.02
Oleg032: calls $1.02
*** TURN *** [Js 4d 8h] [8d]
namemattbark: checks 
Oleg032: checks 
*** RIVER *** [Js 4d 8h 8d] [7s]
namemattbark: checks 
Oleg032: bets $1.26
namemattbark: calls $1.26
*** SHOW DOWN ***
Oleg032: shows [Kc Kh] (two pair, Kings and Eights)
namemattbark: mucks hand 
Oleg032 collected $6.22 from pot
*** SUMMARY ***
Total pot $6.51 | Rake $0.29 
Board [Js 4d 8h 8d 7s]
Seat 1: Marder1388 folded before Flop (didn't bet)
Seat 2: Manon4ik folded before Flop (didn't bet)
Seat 3: Oleg032 (button) showed [Kc Kh] and won ($6.22) with two pair, Kings and Eights
Seat 4: LBA_UNO (small blind) folded before Flop
Seat 5: sólyom333 (big blind) folded before Flop
Seat 6: namemattbark mucked



PokerStars Hand #222965629115:  Hold'em No Limit ($0.05/$0.10 USD) - 2021/01/23 14:11:48 ET
Table 'Shura III' 6-max Seat #4 is the button
Seat 1: Marder1388 ($10.37 in chips) 
Seat 2: Manon4ik ($10 in chips) 
Seat 3: Oleg032 ($13.14 in chips) 
Seat 4: LBA_UNO ($11.20 in chips) 
Seat 5: sólyom333 ($9.96 in chips) 
Seat 6: namemattbark ($7.95 in chips) 
sólyom333: posts small blind $0.05
namemattbark: posts big blind $0.10
*** HOLE CARDS ***
Marder1388: calls $0.10
Manon4ik: folds 
Oleg032: raises $0.15 to $0.25
LBA_UNO: folds 
sólyom333: folds 
namemattbark: calls $0.15
Marder1388: calls $0.15
*** FLOP *** [7s 4d Ac]
namemattbark: checks 
Marder1388: bets $0.38
Oleg032: folds 
namemattbark: folds 
Uncalled bet ($0.38) returned to Marder1388
Marder1388 collected $0.76 from pot
Marder1388: doesn't show hand 
*** SUMMARY ***
Total pot $0.80 | Rake $0.04 
Board [7s 4d Ac]
Seat 1: Marder1388 collected ($0.76)
Seat 2: Manon4ik folded before Flop (didn't bet)
Seat 3: Oleg032 folded on the Flop
Seat 4: LBA_UNO (button) folded before Flop (didn't bet)
Seat 5: sólyom333 (small blind) folded before Flop
Seat 6: namemattbark (big blind) folded on the Flop



PokerStars Hand #222965661943:  Hold'em No Limit ($0.05/$0.10 USD) - 2021/01/23 14:12:29 ET
Table 'Shura III' 6-max Seat #5 is the button
Seat 1: Marder1388 ($10.88 in chips) 
Seat 2: Manon4ik ($10 in chips) 
Seat 3: Oleg032 ($12.89 in chips) 
Seat 4: LBA_UNO ($11.20 in chips) 
Seat 5: sólyom333 ($9.91 in chips) 
Seat 6: namemattbark ($7.70 in chips) 
namemattbark: posts small blind $0.05
Marder1388: posts big blind $0.10
*** HOLE CARDS ***
Manon4ik: folds 
Oleg032: folds 
LBA_UNO: folds 
sólyom333: raises $0.12 to $0.22
namemattbark: folds 
Marder1388: folds 
Uncalled bet ($0.12) returned to sólyom333
sólyom333 collected $0.25 from pot
sólyom333: doesn't show hand 
*** SUMMARY ***
Total pot $0.25 | Rake $0 
Seat 1: Marder1388 (big blind) folded before Flop
Seat 2: Manon4ik folded before Flop (didn't bet)
Seat 3: Oleg032 folded before Flop (didn't bet)
Seat 4: LBA_UNO folded before Flop (didn't bet)
Seat 5: sólyom333 (button) collected ($0.25)
Seat 6: namemattbark (small blind) folded before Flop



PokerStars Hand #222965672029:  Hold'em No Limit ($0.05/$0.10 USD) - 2021/01/23 14:12:42 ET
Table 'Shura III' 6-max Seat #1 is the button
Seat 1: Marder1388 ($10.78 in chips) 
Seat 2: Manon4ik ($10 in chips) 
Seat 3: Oleg032 ($12.89 in chips) 
Seat 4: LBA_UNO ($11.20 in chips) 
Seat 5: sólyom333 ($10.06 in chips) 
Manon4ik: posts small blind $0.05
Oleg032: posts big blind $0.10
*** HOLE CARDS ***
LBA_UNO: folds 
sólyom333: folds 
Marder1388: folds 
Manon4ik: raises $0.15 to $0.25
Oleg032: calls $0.15
*** FLOP *** [9s Kc 6h]
Manon4ik: checks 
Oleg032: checks 
*** TURN *** [9s Kc 6h] [Qc]
Manon4ik: checks 
namemattbark leaves the table
Oleg032: checks 
*** RIVER *** [9s Kc 6h Qc] [9c]
louis2307 joins the table at seat #6 
Manon4ik: checks 
Oleg032: checks 
*** SHOW DOWN ***
Manon4ik: shows [Qs Ts] (two pair, Queens and Nines)
Oleg032: mucks hand 
Manon4ik collected $0.48 from pot
*** SUMMARY ***
Total pot $0.50 | Rake $0.02 
Board [9s Kc 6h Qc 9c]
Seat 1: Marder1388 (button) folded before Flop (didn't bet)
Seat 2: Manon4ik (small blind) showed [Qs Ts] and won ($0.48) with two pair, Queens and Nines
Seat 3: Oleg032 (big blind) mucked
Seat 4: LBA_UNO folded before Flop (didn't bet)
Seat 5: sólyom333 folded before Flop (didn't bet)



PokerStars Hand #222965715377:  Hold'em No Limit ($0.05/$0.10 USD) - 2021/01/23 14:13:37 ET
Table 'Shura III' 6-max Seat #2 is the button
Seat 1: Marder1388 ($10.78 in chips) 
Seat 2: Manon4ik ($10.23 in chips) 
Seat 3: Oleg032 ($12.64 in chips) 
Seat 5: sólyom333 ($10.06 in chips) 
Oleg032: posts small blind $0.05
LBA_UNO: is sitting out 
sólyom333: posts big blind $0.10
louis2307: sits out 
*** HOLE CARDS ***
Marder1388: calls $0.10
Manon4ik: folds 
Oleg032: folds 
sólyom333: checks 
*** FLOP *** [Js 2c Ks]
sólyom333: checks 
Marder1388: checks 
*** TURN *** [Js 2c Ks] [Ts]
sólyom333: bets $0.21
Marder1388: calls $0.21
*** RIVER *** [Js 2c Ks Ts] [8h]
sólyom333: checks 
Marder1388: checks 
*** SHOW DOWN ***
sólyom333: shows [5c Qc] (high card King)
Marder1388: shows [8c 9c] (a pair of Eights)
Marder1388 collected $0.64 from pot
*** SUMMARY ***
Total pot $0.67 | Rake $0.03 
Board [Js 2c Ks Ts 8h]
Seat 1: Marder1388 showed [8c 9c] and won ($0.64) with a pair of Eights
Seat 2: Manon4ik (button) folded before Flop (didn't bet)
Seat 3: Oleg032 (small blind) folded before Flop
Seat 5: sólyom333 (big blind) showed [5c Qc] and lost with high card King



PokerStars Hand #222965740589:  Hold'em No Limit ($0.05/$0.10 USD) - 2021/01/23 14:14:08 ET
Table 'Shura III' 6-max Seat #3 is the button
Seat 1: Marder1388 ($11.11 in chips) 
Seat 2: Manon4ik ($10.23 in chips) 
Seat 3: Oleg032 ($12.59 in chips) 
Seat 5: sólyom333 ($9.75 in chips) 
Seat 6: louis2307 ($10 in chips) 
sólyom333: posts small blind $0.05
louis2307: posts big blind $0.10
*** HOLE CARDS ***
Marder1388: folds 
Manon4ik: folds 
Oleg032: raises $0.15 to $0.25
sólyom333: folds 
louis2307: folds 
Uncalled bet ($0.15) returned to Oleg032
Oleg032 collected $0.25 from pot
Oleg032: doesn't show hand 
*** SUMMARY ***
Total pot $0.25 | Rake $0 
Seat 1: Marder1388 folded before Flop (didn't bet)
Seat 2: Manon4ik folded before Flop (didn't bet)
Seat 3: Oleg032 (button) collected ($0.25)
Seat 5: sólyom333 (small blind) folded before Flop
Seat 6: louis2307 (big blind) folded before Flop



PokerStars Hand #222965761098:  Hold'em No Limit ($0.05/$0.10 USD) - 2021/01/23 14:14:35 ET
Table 'Shura III' 6-max Seat #5 is the button
Seat 1: Marder1388 ($11.11 in chips) 
Seat 2: Manon4ik ($10.23 in chips) 
Seat 3: Oleg032 ($12.74 in chips) 
Seat 5: sólyom333 ($9.70 in chips) 
Seat 6: louis2307 ($10 in chips) 
louis2307: posts small blind $0.05
Marder1388: posts big blind $0.10
*** HOLE CARDS ***
Manon4ik: folds 
Oleg032: raises $0.15 to $0.25
sólyom333: folds 
louis2307: folds 
Marder1388: calls $0.15
*** FLOP *** [8s Tc 6h]
Marder1388: bets $0.27
Oleg032: calls $0.27
*** TURN *** [8s Tc 6h] [Jh]
Marder1388: bets $0.52
Oleg032: folds 
Uncalled bet ($0.52) returned to Marder1388
Marder1388 collected $1.04 from pot
Marder1388: doesn't show hand 
*** SUMMARY ***
Total pot $1.09 | Rake $0.05 
Board [8s Tc 6h Jh]
Seat 1: Marder1388 (big blind) collected ($1.04)
Seat 2: Manon4ik folded before Flop (didn't bet)
Seat 3: Oleg032 folded on the Turn
Seat 5: sólyom333 (button) folded before Flop (didn't bet)
Seat 6: louis2307 (small blind) folded before Flop



PokerStars Hand #222965803367:  Hold'em No Limit ($0.05/$0.10 USD) - 2021/01/23 14:15:28 ET
Table 'Shura III' 6-max Seat #6 is the button
Seat 1: Marder1388 ($11.63 in chips) 
Seat 2: Manon4ik ($10.23 in chips) 
Seat 3: Oleg032 ($12.22 in chips) 
Seat 5: sólyom333 ($9.70 in chips) 
Seat 6: louis2307 ($10 in chips) 
Marder1388: posts small blind $0.05
Manon4ik: posts big blind $0.10
LBA_UNO: sits out 
*** HOLE CARDS ***
Oleg032: folds 
sólyom333: folds 
louis2307: folds 
Marder1388: folds 
Uncalled bet ($0.05) returned to Manon4ik
Manon4ik collected $0.10 from pot
Manon4ik: doesn't show hand 
*** SUMMARY ***
Total pot $0.10 | Rake $0 
Seat 1: Marder1388 (small blind) folded before Flop
Seat 2: Manon4ik (big blind) collected ($0.10)
Seat 3: Oleg032 folded before Flop (didn't bet)
Seat 5: sólyom333 folded before Flop (didn't bet)
Seat 6: louis2307 (button) folded before Flop (didn't bet)



PokerStars Hand #222965818560:  Hold'em No Limit ($0.05/$0.10 USD) - 2021/01/23 14:15:47 ET
Table 'Shura III' 6-max Seat #1 is the button
Seat 1: Marder1388 ($11.58 in chips) 
Seat 2: Manon4ik ($10.28 in chips) 
Seat 3: Oleg032 ($12.22 in chips) 
Seat 5: sólyom333 ($9.70 in chips) 
Seat 6: louis2307 ($10 in chips) 
Manon4ik: posts small blind $0.05
Oleg032: posts big blind $0.10
LBA_UNO: sits out 
*** HOLE CARDS ***
sólyom333: folds 
louis2307: folds 
Marder1388: calls $0.10
Manon4ik: folds 
Oleg032: checks 
*** FLOP *** [2c Jh 4d]
Oleg032: checks 
Marder1388: checks 
*** TURN *** [2c Jh 4d] [Qd]
Oleg032: checks 
Marder1388: bets $0.12
Oleg032: folds 
Uncalled bet ($0.12) returned to Marder1388
Marder1388 collected $0.24 from pot
Marder1388: doesn't show hand 
*** SUMMARY ***
Total pot $0.25 | Rake $0.01 
Board [2c Jh 4d Qd]
Seat 1: Marder1388 (button) collected ($0.24)
Seat 2: Manon4ik (small blind) folded before Flop
Seat 3: Oleg032 (big blind) folded on the Turn
Seat 5: sólyom333 folded before Flop (didn't bet)
Seat 6: louis2307 folded before Flop (didn't bet)



PokerStars Hand #222965849451:  Hold'em No Limit ($0.05/$0.10 USD) - 2021/01/23 14:16:24 ET
Table 'Shura III' 6-max Seat #2 is the button
Seat 1: Marder1388 ($11.72 in chips) 
Seat 2: Manon4ik ($10.23 in chips) 
Seat 3: Oleg032 ($12.12 in chips) 
Seat 4: LBA_UNO ($11.20 in chips) 
Seat 5: sólyom333 ($9.70 in chips) 
Seat 6: louis2307 ($10 in chips) 
Oleg032: posts small blind $0.05
LBA_UNO: posts big blind $0.10
*** HOLE CARDS ***
sólyom333: folds 
louis2307: folds 
Marder1388: raises $0.20 to $0.30
Manon4ik: folds 
Oleg032: raises $0.65 to $0.95
LBA_UNO: folds 
Marder1388: calls $0.65
*** FLOP *** [Kh Ah Ks]
Oleg032: bets $0.96
Marder1388: calls $0.96
*** TURN *** [Kh Ah Ks] [5d]
Oleg032: bets $1.87
Marder1388: calls $1.87
*** RIVER *** [Kh Ah Ks 5d] [7d]
Oleg032: bets $3.66
Marder1388: folds 
Uncalled bet ($3.66) returned to Oleg032
Oleg032 collected $7.32 from pot
Oleg032: doesn't show hand 
*** SUMMARY ***
Total pot $7.66 | Rake $0.34 
Board [Kh Ah Ks 5d 7d]
Seat 1: Marder1388 folded on the River
Seat 2: Manon4ik (button) folded before Flop (didn't bet)
Seat 3: Oleg032 (small blind) collected ($7.32)
Seat 4: LBA_UNO (big blind) folded before Flop
Seat 5: sólyom333 folded before Flop (didn't bet)
Seat 6: louis2307 folded before Flop (didn't bet)



PokerStars Hand #222965894633:  Hold'em No Limit ($0.05/$0.10 USD) - 2021/01/23 14:17:20 ET
Table 'Shura III' 6-max Seat #3 is the button
Seat 1: Marder1388 ($7.94 in chips) 
Seat 2: Manon4ik ($10.23 in chips) 
Seat 3: Oleg032 ($15.66 in chips) 
Seat 4: LBA_UNO ($11.10 in chips) 
Seat 5: sólyom333 ($9.70 in chips) 
Seat 6: louis2307 ($10 in chips) 
LBA_UNO: posts small blind $0.05
sólyom333: posts big blind $0.10
*** HOLE CARDS ***
louis2307: folds 
Marder1388: calls $0.10
Manon4ik: raises $0.30 to $0.40
Oleg032: folds 
LBA_UNO: folds 
sólyom333: folds 
Marder1388: calls $0.30
*** FLOP *** [6d Jc 2c]
Marder1388: checks 
Manon4ik: checks 
*** TURN *** [6d Jc 2c] [Kc]
Marder1388: bets $0.46
Manon4ik: folds 
Uncalled bet ($0.46) returned to Marder1388
Marder1388 collected $0.91 from pot
Marder1388: doesn't show hand 
*** SUMMARY ***
Total pot $0.95 | Rake $0.04 
Board [6d Jc 2c Kc]
Seat 1: Marder1388 collected ($0.91)
Seat 2: Manon4ik folded on the Turn
Seat 3: Oleg032 (button) folded before Flop (didn't bet)
Seat 4: LBA_UNO (small blind) folded before Flop
Seat 5: sólyom333 (big blind) folded before Flop
Seat 6: louis2307 folded before Flop (didn't bet)



PokerStars Hand #222965949401:  Hold'em No Limit ($0.05/$0.10 USD) - 2021/01/23 14:18:30 ET
Table 'Shura III' 6-max Seat #4 is the button
Seat 1: Marder1388 ($8.45 in chips) 
Seat 2: Manon4ik ($10 in chips) 
Seat 3: Oleg032 ($15.66 in chips) 
Seat 4: LBA_UNO ($11.05 in chips) 
Seat 5: sólyom333 ($9.60 in chips) 
Seat 6: louis2307 ($10 in chips) 
sólyom333: posts small blind $0.05
louis2307: posts big blind $0.10
*** HOLE CARDS ***
Marder1388: calls $0.10
Manon4ik: folds 
Oleg032: folds 
LBA_UNO: raises $0.40 to $0.50
sólyom333: folds 
louis2307: folds 
Marder1388: folds 
Uncalled bet ($0.40) returned to LBA_UNO
LBA_UNO collected $0.35 from pot
LBA_UNO: doesn't show hand 
*** SUMMARY ***
Total pot $0.35 | Rake $0 
Seat 1: Marder1388 folded before Flop
Seat 2: Manon4ik folded before Flop (didn't bet)
Seat 3: Oleg032 folded before Flop (didn't bet)
Seat 4: LBA_UNO (button) collected ($0.35)
Seat 5: sólyom333 (small blind) folded before Flop
Seat 6: louis2307 (big blind) folded before Flop



PokerStars Hand #222965966845:  Hold'em No Limit ($0.05/$0.10 USD) - 2021/01/23 14:18:51 ET
Table 'Shura III' 6-max Seat #5 is the button
Seat 1: Marder1388 ($8.35 in chips) 
Seat 2: Manon4ik ($10 in chips) 
Seat 3: Oleg032 ($15.66 in chips) 
Seat 4: LBA_UNO ($11.30 in chips) 
Seat 5: sólyom333 ($9.55 in chips) 
Seat 6: louis2307 ($10 in chips) 
louis2307: posts small blind $0.05
Marder1388: posts big blind $0.10
*** HOLE CARDS ***
Manon4ik: folds 
Oleg032: folds 
LBA_UNO: folds 
sólyom333: folds 
louis2307: folds 
Uncalled bet ($0.05) returned to Marder1388
Marder1388 collected $0.10 from pot
Marder1388: doesn't show hand 
*** SUMMARY ***
Total pot $0.10 | Rake $0 
Seat 1: Marder1388 (big blind) collected ($0.10)
Seat 2: Manon4ik folded before Flop (didn't bet)
Seat 3: Oleg032 folded before Flop (didn't bet)
Seat 4: LBA_UNO folded before Flop (didn't bet)
Seat 5: sólyom333 (button) folded before Flop (didn't bet)
Seat 6: louis2307 (small blind) folded before Flop



PokerStars Hand #222965973453:  Hold'em No Limit ($0.05/$0.10 USD) - 2021/01/23 14:19:00 ET
Table 'Shura III' 6-max Seat #6 is the button
Seat 1: Marder1388 ($8.40 in chips) 
Seat 2: Manon4ik ($10 in chips) 
Seat 3: Oleg032 ($15.66 in chips) 
Seat 4: LBA_UNO ($11.30 in chips) 
Seat 5: sólyom333 ($9.55 in chips) 
Seat 6: louis2307 ($10 in chips) 
Marder1388: posts small blind $0.05
Manon4ik: posts big blind $0.10
*** HOLE CARDS ***
Oleg032: folds 
LBA_UNO: folds 
sólyom333: folds 
louis2307: folds 
Marder1388: calls $0.05
Manon4ik: raises $0.25 to $0.35
Marder1388: folds 
Uncalled bet ($0.25) returned to Manon4ik
Manon4ik collected $0.20 from pot
Manon4ik: doesn't show hand 
*** SUMMARY ***
Total pot $0.20 | Rake $0 
Seat 1: Marder1388 (small blind) folded before Flop
Seat 2: Manon4ik (big blind) collected ($0.20)
Seat 3: Oleg032 folded before Flop (didn't bet)
Seat 4: LBA_UNO folded before Flop (didn't bet)
Seat 5: sólyom333 folded before Flop (didn't bet)
Seat 6: louis2307 (button) folded before Flop (didn't bet)



PokerStars Hand #222965994969:  Hold'em No Limit ($0.05/$0.10 USD) - 2021/01/23 14:19:27 ET
Table 'Shura III' 6-max Seat #1 is the button
Seat 1: Marder1388 ($8.30 in chips) 
Seat 2: Manon4ik ($10.10 in chips) 
Seat 3: Oleg032 ($15.66 in chips) 
Seat 4: LBA_UNO ($11.30 in chips) 
Seat 5: sólyom333 ($9.55 in chips) 
Seat 6: louis2307 ($10 in chips) 
Manon4ik: posts small blind $0.05
Oleg032: posts big blind $0.10
*** HOLE CARDS ***
LBA_UNO: folds 
sólyom333: raises $0.18 to $0.28
louis2307: folds 
Marder1388: folds 
Manon4ik: calls $0.23
Oleg032: folds 
*** FLOP *** [9c Kh Tc]
Manon4ik: checks 
sólyom333: bets $0.26
louis2307 is disconnected 
Manon4ik: folds 
Uncalled bet ($0.26) returned to sólyom333
sólyom333 collected $0.63 from pot
sólyom333: doesn't show hand 
*** SUMMARY ***
Total pot $0.66 | Rake $0.03 
Board [9c Kh Tc]
Seat 1: Marder1388 (button) folded before Flop (didn't bet)
Seat 2: Manon4ik (small blind) folded on the Flop
Seat 3: Oleg032 (big blind) folded before Flop
Seat 4: LBA_UNO folded before Flop (didn't bet)
Seat 5: sólyom333 collected ($0.63)
Seat 6: louis2307 folded before Flop (didn't bet)



PokerStars Hand #222966027876:  Hold'em No Limit ($0.05/$0.10 USD) - 2021/01/23 14:20:09 ET
Table 'Shura III' 6-max Seat #2 is the button
Seat 1: Marder1388 ($8.30 in chips) 
Seat 2: Manon4ik ($10 in chips) 
Seat 3: Oleg032 ($15.56 in chips) 
Seat 4: LBA_UNO ($11.30 in chips) 
Seat 5: sólyom333 ($9.90 in chips) 
Seat 6: louis2307 ($10 in chips) 
Oleg032: posts small blind $0.05
LBA_UNO: posts big blind $0.10
*** HOLE CARDS ***
sólyom333: folds 
louis2307: raises $0.15 to $0.25
Marder1388: calls $0.25
Manon4ik: folds 
Oleg032: folds 
LBA_UNO: raises $1.15 to $1.40
louis2307: folds 
Marder1388: folds 
Uncalled bet ($1.15) returned to LBA_UNO
LBA_UNO collected $0.80 from pot
LBA_UNO: doesn't show hand 
*** SUMMARY ***
Total pot $0.80 | Rake $0 
Seat 1: Marder1388 folded before Flop
Seat 2: Manon4ik (button) folded before Flop (didn't bet)
Seat 3: Oleg032 (small blind) folded before Flop
Seat 4: LBA_UNO (big blind) collected ($0.80)
Seat 5: sólyom333 folded before Flop (didn't bet)
Seat 6: louis2307 folded before Flop



PokerStars Hand #222966053261:  Hold'em No Limit ($0.05/$0.10 USD) - 2021/01/23 14:20:42 ET
Table 'Shura III' 6-max Seat #3 is the button
Seat 1: Marder1388 ($8.05 in chips) 
Seat 2: Manon4ik ($10 in chips) 
Seat 3: Oleg032 ($15.51 in chips) 
Seat 4: LBA_UNO ($11.85 in chips) 
Seat 5: sólyom333 ($9.90 in chips) 
Seat 6: louis2307 ($10 in chips) 
LBA_UNO: posts small blind $0.05
sólyom333: posts big blind $0.10
*** HOLE CARDS ***
louis2307: folds 
Marder1388: folds 
Manon4ik: folds 
Oleg032: raises $0.15 to $0.25
LBA_UNO: folds 
sólyom333: folds 
Uncalled bet ($0.15) returned to Oleg032
Oleg032 collected $0.25 from pot
Oleg032: doesn't show hand 
*** SUMMARY ***
Total pot $0.25 | Rake $0 
Seat 1: Marder1388 folded before Flop (didn't bet)
Seat 2: Manon4ik folded before Flop (didn't bet)
Seat 3: Oleg032 (button) collected ($0.25)
Seat 4: LBA_UNO (small blind) folded before Flop
Seat 5: sólyom333 (big blind) folded before Flop
Seat 6: louis2307 folded before Flop (didn't bet)



PokerStars Hand #222966072282:  Hold'em No Limit ($0.05/$0.10 USD) - 2021/01/23 14:21:06 ET
Table 'Shura III' 6-max Seat #4 is the button
Seat 1: Marder1388 ($8.05 in chips) 
Seat 2: Manon4ik ($10 in chips) 
Seat 3: Oleg032 ($15.66 in chips) 
Seat 4: LBA_UNO ($11.80 in chips) 
Seat 5: sólyom333 ($9.80 in chips) 
sólyom333: posts small blind $0.05
louis2307 is disconnected 
louis2307 has timed out while disconnected
louis2307: is sitting out 
Marder1388: posts big blind $0.10
*** HOLE CARDS ***
Manon4ik: folds 
Oleg032: raises $0.15 to $0.25
LBA_UNO: folds 
sólyom333: folds 
Marder1388: calls $0.15
*** FLOP *** [Ts Ks 9d]
Marder1388: bets $0.27
Oleg032: calls $0.27
*** TURN *** [Ts Ks 9d] [2s]
Marder1388: bets $0.52
Oleg032: calls $0.52
*** RIVER *** [Ts Ks 9d 2s] [Tc]
Marder1388: checks 
Oleg032: checks 
*** SHOW DOWN ***
Marder1388: shows [Ac 8c] (a pair of Tens)
Oleg032: shows [Kd Qh] (two pair, Kings and Tens)
Oleg032 collected $2.03 from pot
*** SUMMARY ***
Total pot $2.13 | Rake $0.10 
Board [Ts Ks 9d 2s Tc]
Seat 1: Marder1388 (big blind) showed [Ac 8c] and lost with a pair of Tens
Seat 2: Manon4ik folded before Flop (didn't bet)
Seat 3: Oleg032 showed [Kd Qh] and won ($2.03) with two pair, Kings and Tens
Seat 4: LBA_UNO (button) folded before Flop (didn't bet)
Seat 5: sólyom333 (small blind) folded before Flop



PokerStars Hand #222966113970:  Hold'em No Limit ($0.05/$0.10 USD) - 2021/01/23 14:21:55 ET
Table 'Shura III' 6-max Seat #5 is the button
Seat 1: Marder1388 ($7.01 in chips) 
Seat 2: Manon4ik ($10 in chips) 
Seat 3: Oleg032 ($16.65 in chips) 
Seat 4: LBA_UNO ($11.80 in chips) 
Seat 5: sólyom333 ($9.75 in chips) 
Marder1388: posts small blind $0.05
Manon4ik: posts big blind $0.10
*** HOLE CARDS ***
Oleg032: folds 
LBA_UNO: folds 
sólyom333: raises $0.12 to $0.22
Marder1388: raises $0.12 to $0.34
Manon4ik: folds 
sólyom333: calls $0.12
*** FLOP *** [8c 6h 2d]
Marder1388: bets $0.37
sólyom333: folds 
Uncalled bet ($0.37) returned to Marder1388
Marder1388 collected $0.74 from pot
Marder1388: doesn't show hand 
*** SUMMARY ***
Total pot $0.78 | Rake $0.04 
Board [8c 6h 2d]
Seat 1: Marder1388 (small blind) collected ($0.74)
Seat 2: Manon4ik (big blind) folded before Flop
Seat 3: Oleg032 folded before Flop (didn't bet)
Seat 4: LBA_UNO folded before Flop (didn't bet)
Seat 5: sólyom333 (button) folded on the Flop



PokerStars Hand #222966130032:  Hold'em No Limit ($0.05/$0.10 USD) - 2021/01/23 14:22:16 ET
Table 'Shura III' 6-max Seat #1 is the button
Seat 1: Marder1388 ($7.41 in chips) 
Seat 2: Manon4ik ($10 in chips) 
Seat 3: Oleg032 ($16.65 in chips) 
Seat 4: LBA_UNO ($11.80 in chips) 
Seat 5: sólyom333 ($9.41 in chips) 
Manon4ik: posts small blind $0.05
Oleg032: posts big blind $0.10
*** HOLE CARDS ***
LBA_UNO: folds 
sólyom333: folds 
Marder1388: folds 
Manon4ik: folds 
Uncalled bet ($0.05) returned to Oleg032
Oleg032 collected $0.10 from pot
Oleg032: doesn't show hand 
*** SUMMARY ***
Total pot $0.10 | Rake $0 
Seat 1: Marder1388 (button) folded before Flop (didn't bet)
Seat 2: Manon4ik (small blind) folded before Flop
Seat 3: Oleg032 (big blind) collected ($0.10)
Seat 4: LBA_UNO folded before Flop (didn't bet)
Seat 5: sólyom333 folded before Flop (didn't bet)



PokerStars Hand #222966133917:  Hold'em No Limit ($0.05/$0.10 USD) - 2021/01/23 14:22:21 ET
Table 'Shura III' 6-max Seat #2 is the button
Seat 1: Marder1388 ($7.41 in chips) 
Seat 2: Manon4ik ($10 in chips) 
Seat 3: Oleg032 ($16.70 in chips) 
Seat 4: LBA_UNO ($11.80 in chips) 
Seat 5: sólyom333 ($9.41 in chips) 
Oleg032: posts small blind $0.05
LBA_UNO: posts big blind $0.10
*** HOLE CARDS ***
sólyom333: raises $0.18 to $0.28
Marder1388: calls $0.28
Manon4ik: folds 
Oleg032: folds 
LBA_UNO: calls $0.18
*** FLOP *** [2h 6s 9s]
LBA_UNO: checks 
sólyom333: checks 
Marder1388: checks 
*** TURN *** [2h 6s 9s] [5s]
LBA_UNO: checks 
sólyom333: checks 
Marder1388: bets $0.43
LBA_UNO: folds 
sólyom333: folds 
Uncalled bet ($0.43) returned to Marder1388
Marder1388 collected $0.85 from pot
Marder1388: doesn't show hand 
*** SUMMARY ***
Total pot $0.89 | Rake $0.04 
Board [2h 6s 9s 5s]
Seat 1: Marder1388 collected ($0.85)
Seat 2: Manon4ik (button) folded before Flop (didn't bet)
Seat 3: Oleg032 (small blind) folded before Flop
Seat 4: LBA_UNO (big blind) folded on the Turn
Seat 5: sólyom333 folded on the Turn



PokerStars Hand #222966156185:  Hold'em No Limit ($0.05/$0.10 USD) - 2021/01/23 14:22:49 ET
Table 'Shura III' 6-max Seat #3 is the button
Seat 1: Marder1388 ($7.98 in chips) 
Seat 2: Manon4ik ($10 in chips) 
Seat 3: Oleg032 ($16.65 in chips) 
Seat 4: LBA_UNO ($11.52 in chips) 
Seat 5: sólyom333 ($9.13 in chips) 
LBA_UNO: posts small blind $0.05
sólyom333: posts big blind $0.10
*** HOLE CARDS ***
Marder1388: folds 
Manon4ik: folds 
Oleg032: raises $0.15 to $0.25
LBA_UNO: folds 
sólyom333: folds 
Uncalled bet ($0.15) returned to Oleg032
Oleg032 collected $0.25 from pot
Oleg032: doesn't show hand 
*** SUMMARY ***
Total pot $0.25 | Rake $0 
Seat 1: Marder1388 folded before Flop (didn't bet)
Seat 2: Manon4ik folded before Flop (didn't bet)
Seat 3: Oleg032 (button) collected ($0.25)
Seat 4: LBA_UNO (small blind) folded before Flop
Seat 5: sólyom333 (big blind) folded before Flop



PokerStars Hand #222966165918:  Hold'em No Limit ($0.05/$0.10 USD) - 2021/01/23 14:23:01 ET
Table 'Shura III' 6-max Seat #4 is the button
Seat 1: Marder1388 ($7.98 in chips) 
Seat 2: Manon4ik ($10 in chips) 
Seat 3: Oleg032 ($16.80 in chips) 
Seat 4: LBA_UNO ($11.47 in chips) 
Seat 5: sólyom333 ($9.03 in chips) 
sólyom333: posts small blind $0.05
Marder1388: posts big blind $0.10
*** HOLE CARDS ***
Manon4ik: folds 
Oleg032: folds 
LBA_UNO: raises $0.14 to $0.24
sólyom333: folds 
Marder1388: folds 
Uncalled bet ($0.14) returned to LBA_UNO
LBA_UNO collected $0.25 from pot
LBA_UNO: doesn't show hand 
*** SUMMARY ***
Total pot $0.25 | Rake $0 
Seat 1: Marder1388 (big blind) folded before Flop
Seat 2: Manon4ik folded before Flop (didn't bet)
Seat 3: Oleg032 folded before Flop (didn't bet)
Seat 4: LBA_UNO (button) collected ($0.25)
Seat 5: sólyom333 (small blind) folded before Flop



PokerStars Hand #222966173328:  Hold'em No Limit ($0.05/$0.10 USD) - 2021/01/23 14:23:11 ET
Table 'Shura III' 6-max Seat #5 is the button
Seat 1: Marder1388 ($7.88 in chips) 
Seat 2: Manon4ik ($10 in chips) 
Seat 3: Oleg032 ($16.80 in chips) 
Seat 4: LBA_UNO ($11.62 in chips) 
Seat 5: sólyom333 ($10 in chips) 
Marder1388: posts small blind $0.05
Manon4ik: posts big blind $0.10
*** HOLE CARDS ***
Oleg032: folds 
LBA_UNO: folds 
sólyom333: raises $0.12 to $0.22
Marder1388: calls $0.17
Manon4ik: folds 
*** FLOP *** [Ad Qh 8s]
Marder1388: checks 
sólyom333: bets $0.22
Marder1388: folds 
Uncalled bet ($0.22) returned to sólyom333
sólyom333 collected $0.52 from pot
sólyom333: doesn't show hand 
louis2307 is disconnected 
*** SUMMARY ***
Total pot $0.54 | Rake $0.02 
Board [Ad Qh 8s]
Seat 1: Marder1388 (small blind) folded on the Flop
Seat 2: Manon4ik (big blind) folded before Flop
Seat 3: Oleg032 folded before Flop (didn't bet)
Seat 4: LBA_UNO folded before Flop (didn't bet)
Seat 5: sólyom333 (button) collected ($0.52)



PokerStars Hand #222966197058:  Hold'em No Limit ($0.05/$0.10 USD) - 2021/01/23 14:23:41 ET
Table 'Shura III' 6-max Seat #1 is the button
Seat 1: Marder1388 ($7.66 in chips) 
Seat 2: Manon4ik ($10 in chips) 
Seat 3: Oleg032 ($16.80 in chips) 
Seat 4: LBA_UNO ($11.62 in chips) 
Seat 5: sólyom333 ($10.30 in chips) 
Manon4ik: posts small blind $0.05
Oleg032: posts big blind $0.10
*** HOLE CARDS ***
LBA_UNO: folds 
sólyom333: folds 
Marder1388: calls $0.10
Manon4ik: folds 
Oleg032: checks 
*** FLOP *** [4h 9s 9d]
Oleg032: checks 
Marder1388: checks 
*** TURN *** [4h 9s 9d] [4s]
Oleg032: checks 
Marder1388: checks 
*** RIVER *** [4h 9s 9d 4s] [Kd]
Oleg032: checks 
Marder1388: checks 
*** SHOW DOWN ***
Oleg032: shows [Ad 3h] (two pair, Nines and Fours)
Marder1388: mucks hand 
Oleg032 collected $0.24 from pot
*** SUMMARY ***
Total pot $0.25 | Rake $0.01 
Board [4h 9s 9d 4s Kd]
Seat 1: Marder1388 (button) mucked
Seat 2: Manon4ik (small blind) folded before Flop
Seat 3: Oleg032 (big blind) showed [Ad 3h] and won ($0.24) with two pair, Nines and Fours
Seat 4: LBA_UNO folded before Flop (didn't bet)
Seat 5: sólyom333 folded before Flop (didn't bet)



PokerStars Hand #222966230229:  Hold'em No Limit ($0.05/$0.10 USD) - 2021/01/23 14:24:24 ET
Table 'Shura III' 6-max Seat #2 is the button
Seat 1: Marder1388 ($7.56 in chips) 
Seat 2: Manon4ik ($10 in chips) 
Seat 3: Oleg032 ($16.94 in chips) 
Seat 4: LBA_UNO ($11.62 in chips) 
Seat 5: sólyom333 ($10.30 in chips) 
Oleg032: posts small blind $0.05
LBA_UNO: posts big blind $0.10
*** HOLE CARDS ***
sólyom333: folds 
Marder1388: calls $0.10
Manon4ik: folds 
Oleg032: folds 
LBA_UNO: checks 
*** FLOP *** [4s 5h Ah]
LBA_UNO: checks 
Marder1388: bets $0.12
LBA_UNO: folds 
Uncalled bet ($0.12) returned to Marder1388
Marder1388 collected $0.24 from pot
Marder1388: doesn't show hand 
*** SUMMARY ***
Total pot $0.25 | Rake $0.01 
Board [4s 5h Ah]
Seat 1: Marder1388 collected ($0.24)
Seat 2: Manon4ik (button) folded before Flop (didn't bet)
Seat 3: Oleg032 (small blind) folded before Flop
Seat 4: LBA_UNO (big blind) folded on the Flop
Seat 5: sólyom333 folded before Flop (didn't bet)



PokerStars Hand #222966244503:  Hold'em No Limit ($0.05/$0.10 USD) - 2021/01/23 14:24:42 ET
Table 'Shura III' 6-max Seat #3 is the button
Seat 1: Marder1388 ($7.70 in chips) 
Seat 2: Manon4ik ($10 in chips) 
Seat 3: Oleg032 ($16.89 in chips) 
Seat 4: LBA_UNO ($11.52 in chips) 
Seat 5: sólyom333 ($10.30 in chips) 
LBA_UNO: posts small blind $0.05
sólyom333: posts big blind $0.10
*** HOLE CARDS ***
louis2307 is disconnected 
Marder1388: calls $0.10
Manon4ik: folds 
Oleg032: folds 
LBA_UNO: folds 
sólyom333: checks 
*** FLOP *** [6s 2d 7s]
sólyom333: bets $0.21
Marder1388: calls $0.21
*** TURN *** [6s 2d 7s] [Qh]
sólyom333: bets $0.56
Marder1388: calls $0.56
*** RIVER *** [6s 2d 7s Qh] [As]
sólyom333: bets $1.14
Marder1388: folds 
Uncalled bet ($1.14) returned to sólyom333
sólyom333 collected $1.71 from pot
sólyom333: doesn't show hand 
*** SUMMARY ***
Total pot $1.79 | Rake $0.08 
Board [6s 2d 7s Qh As]
Seat 1: Marder1388 folded on the River
Seat 2: Manon4ik folded before Flop (didn't bet)
Seat 3: Oleg032 (button) folded before Flop (didn't bet)
Seat 4: LBA_UNO (small blind) folded before Flop
Seat 5: sólyom333 (big blind) collected ($1.71)



PokerStars Hand #222966275866:  Hold'em No Limit ($0.05/$0.10 USD) - 2021/01/23 14:25:22 ET
Table 'Shura III' 6-max Seat #4 is the button
Seat 1: Marder1388 ($6.83 in chips) 
Seat 2: Manon4ik ($10 in chips) 
Seat 3: Oleg032 ($16.89 in chips) 
Seat 4: LBA_UNO ($11.47 in chips) 
Seat 5: sólyom333 ($11.14 in chips) 
sólyom333: posts small blind $0.05
Marder1388: posts big blind $0.10
*** HOLE CARDS ***
Manon4ik: folds 
Oleg032: folds 
LBA_UNO: folds 
sólyom333: raises $0.20 to $0.30
Marder1388: folds 
Uncalled bet ($0.20) returned to sólyom333
sólyom333 collected $0.20 from pot
sólyom333: doesn't show hand 
*** SUMMARY ***
Total pot $0.20 | Rake $0 
Seat 1: Marder1388 (big blind) folded before Flop
Seat 2: Manon4ik folded before Flop (didn't bet)
Seat 3: Oleg032 folded before Flop (didn't bet)
Seat 4: LBA_UNO (button) folded before Flop (didn't bet)
Seat 5: sólyom333 (small blind) collected ($0.20)



PokerStars Hand #222966285613:  Hold'em No Limit ($0.05/$0.10 USD) - 2021/01/23 14:25:34 ET
Table 'Shura III' 6-max Seat #5 is the button
Seat 1: Marder1388 ($6.73 in chips) 
Seat 2: Manon4ik ($10 in chips) 
Seat 3: Oleg032 ($16.89 in chips) 
Seat 4: LBA_UNO ($11.47 in chips) 
Seat 5: sólyom333 ($11.24 in chips) 
Marder1388: posts small blind $0.05
Manon4ik: posts big blind $0.10
*** HOLE CARDS ***
Oleg032: folds 
LBA_UNO: raises $0.20 to $0.30
sólyom333: folds 
Marder1388: folds 
Manon4ik: folds 
Uncalled bet ($0.20) returned to LBA_UNO
LBA_UNO collected $0.25 from pot
LBA_UNO: doesn't show hand 
*** SUMMARY ***
Total pot $0.25 | Rake $0 
Seat 1: Marder1388 (small blind) folded before Flop
Seat 2: Manon4ik (big blind) folded before Flop
Seat 3: Oleg032 folded before Flop (didn't bet)
Seat 4: LBA_UNO collected ($0.25)
Seat 5: sólyom333 (button) folded before Flop (didn't bet)



PokerStars Hand #222966298168:  Hold'em No Limit ($0.05/$0.10 USD) - 2021/01/23 14:25:51 ET
Table 'Shura III' 6-max Seat #1 is the button
Seat 1: Marder1388 ($6.68 in chips) 
Seat 2: Manon4ik ($10 in chips) 
Seat 3: Oleg032 ($16.89 in chips) 
Seat 4: LBA_UNO ($11.62 in chips) 
Seat 5: sólyom333 ($11.24 in chips) 
Manon4ik: posts small blind $0.05
Oleg032: posts big blind $0.10
*** HOLE CARDS ***
LBA_UNO: raises $0.20 to $0.30
sólyom333: folds 
Marder1388: folds 
Manon4ik: folds 
Oleg032: calls $0.20
*** FLOP *** [3h Tc 8d]
Oleg032: checks 
LBA_UNO: checks 
*** TURN *** [3h Tc 8d] [Jd]
Oleg032: checks 
LBA_UNO: bets $0.20
Oleg032: calls $0.20
*** RIVER *** [3h Tc 8d Jd] [2s]
Oleg032: checks 
LBA_UNO: bets $0.90
Oleg032: folds 
Uncalled bet ($0.90) returned to LBA_UNO
LBA_UNO collected $1 from pot
LBA_UNO: doesn't show hand 
*** SUMMARY ***
Total pot $1.05 | Rake $0.05 
Board [3h Tc 8d Jd 2s]
Seat 1: Marder1388 (button) folded before Flop (didn't bet)
Seat 2: Manon4ik (small blind) folded before Flop
Seat 3: Oleg032 (big blind) folded on the River
Seat 4: LBA_UNO collected ($1)
Seat 5: sólyom333 folded before Flop (didn't bet)



PokerStars Hand #222966332946:  Hold'em No Limit ($0.05/$0.10 USD) - 2021/01/23 14:26:36 ET
Table 'Shura III' 6-max Seat #2 is the button
Seat 1: Marder1388 ($6.68 in chips) 
Seat 2: Manon4ik ($10 in chips) 
Seat 3: Oleg032 ($16.39 in chips) 
Seat 4: LBA_UNO ($12.12 in chips) 
Seat 5: sólyom333 ($11.24 in chips) 
Oleg032: posts small blind $0.05
LBA_UNO: posts big blind $0.10
*** HOLE CARDS ***
sólyom333: folds 
Marder1388: raises $0.10 to $0.20
Manon4ik: folds 
Oleg032: folds 
LBA_UNO: folds 
Uncalled bet ($0.10) returned to Marder1388
Marder1388 collected $0.25 from pot
Marder1388: doesn't show hand 
*** SUMMARY ***
Total pot $0.25 | Rake $0 
Seat 1: Marder1388 collected ($0.25)
Seat 2: Manon4ik (button) folded before Flop (didn't bet)
Seat 3: Oleg032 (small blind) folded before Flop
Seat 4: LBA_UNO (big blind) folded before Flop
Seat 5: sólyom333 folded before Flop (didn't bet)



PokerStars Hand #222966339850:  Hold'em No Limit ($0.05/$0.10 USD) - 2021/01/23 14:26:45 ET
Table 'Shura III' 6-max Seat #3 is the button
Seat 1: Marder1388 ($6.83 in chips) 
Seat 2: Manon4ik ($10 in chips) 
Seat 3: Oleg032 ($16.34 in chips) 
Seat 4: LBA_UNO ($12.02 in chips) 
Seat 5: sólyom333 ($11.24 in chips) 
LBA_UNO: posts small blind $0.05
sólyom333: posts big blind $0.10
*** HOLE CARDS ***
Marder1388: raises $0.20 to $0.30
Manon4ik: calls $0.30
Oleg032: folds 
LBA_UNO: folds 
sólyom333: folds 
*** FLOP *** [4s 6c 9c]
Marder1388: bets $0.36
Manon4ik: calls $0.36
*** TURN *** [4s 6c 9c] [8h]
Marder1388: bets $0.70
Manon4ik: folds 
Uncalled bet ($0.70) returned to Marder1388
Marder1388 collected $1.40 from pot
Marder1388: doesn't show hand 
*** SUMMARY ***
Total pot $1.47 | Rake $0.07 
Board [4s 6c 9c 8h]
Seat 1: Marder1388 collected ($1.40)
Seat 2: Manon4ik folded on the Turn
Seat 3: Oleg032 (button) folded before Flop (didn't bet)
Seat 4: LBA_UNO (small blind) folded before Flop
Seat 5: sólyom333 (big blind) folded before Flop



PokerStars Hand #222966384885:  Hold'em No Limit ($0.05/$0.10 USD) - 2021/01/23 14:27:36 ET
Table 'Shura III' 6-max Seat #4 is the button
Seat 1: Marder1388 ($7.57 in chips) 
Seat 2: Manon4ik ($10 in chips) 
Seat 3: Oleg032 ($16.34 in chips) 
Seat 4: LBA_UNO ($11.97 in chips) 
Seat 5: sólyom333 ($11.14 in chips) 
sólyom333: posts small blind $0.05
Marder1388: posts big blind $0.10
*** HOLE CARDS ***
Manon4ik: folds 
Oleg032: folds 
LBA_UNO: raises $0.14 to $0.24
sólyom333: folds 
Marder1388: calls $0.14
*** FLOP *** [4s 2h 3c]
Marder1388: checks 
LBA_UNO: checks 
*** TURN *** [4s 2h 3c] [9s]
Marder1388: checks 
LBA_UNO: bets $0.38
Marder1388: calls $0.38
*** RIVER *** [4s 2h 3c 9s] [Qh]
Marder1388: bets $0.62
LBA_UNO: folds 
Uncalled bet ($0.62) returned to Marder1388
Marder1388 collected $1.23 from pot
louis2307 was removed from the table for failing to post
louis2307 leaves the table
Marder1388: doesn't show hand 
*** SUMMARY ***
Total pot $1.29 | Rake $0.06 
Board [4s 2h 3c 9s Qh]
Seat 1: Marder1388 (big blind) collected ($1.23)
Seat 2: Manon4ik folded before Flop (didn't bet)
Seat 3: Oleg032 folded before Flop (didn't bet)
Seat 4: LBA_UNO (button) folded on the River
Seat 5: sólyom333 (small blind) folded before Flop



PokerStars Hand #222966431044:  Hold'em No Limit ($0.05/$0.10 USD) - 2021/01/23 14:28:35 ET
Table 'Shura III' 6-max Seat #5 is the button
Seat 1: Marder1388 ($8.18 in chips) 
Seat 2: Manon4ik ($10 in chips) 
Seat 3: Oleg032 ($16.34 in chips) 
Seat 4: LBA_UNO ($11.35 in chips) 
Seat 5: sólyom333 ($11.09 in chips) 
Marder1388: posts small blind $0.05
Manon4ik: posts big blind $0.10
*** HOLE CARDS ***
Oleg032: folds 
LBA_UNO: folds 
sólyom333: folds 
Pokertom143 joins the table at seat #6 
Marder1388: calls $0.05
Manon4ik: checks 
*** FLOP *** [7d 7s Ks]
Marder1388: bets $0.20
Manon4ik: folds 
Uncalled bet ($0.20) returned to Marder1388
Marder1388 collected $0.19 from pot
Marder1388: doesn't show hand 
*** SUMMARY ***
Total pot $0.20 | Rake $0.01 
Board [7d 7s Ks]
Seat 1: Marder1388 (small blind) collected ($0.19)
Seat 2: Manon4ik (big blind) folded on the Flop
Seat 3: Oleg032 folded before Flop (didn't bet)
Seat 4: LBA_UNO folded before Flop (didn't bet)
Seat 5: sólyom333 (button) folded before Flop (didn't bet)



PokerStars Hand #222966447495:  Hold'em No Limit ($0.05/$0.10 USD) - 2021/01/23 14:28:57 ET
Table 'Shura III' 6-max Seat #1 is the button
Seat 1: Marder1388 ($8.27 in chips) 
Seat 2: Manon4ik ($10 in chips) 
Seat 3: Oleg032 ($16.34 in chips) 
Seat 4: LBA_UNO ($11.35 in chips) 
Seat 5: sólyom333 ($11.09 in chips) 
Manon4ik: posts small blind $0.05
Oleg032: posts big blind $0.10
Pokertom143: sits out 
*** HOLE CARDS ***
LBA_UNO: raises $0.20 to $0.30
sólyom333: folds 
Marder1388: folds 
Manon4ik: folds 
Oleg032: folds 
Uncalled bet ($0.20) returned to LBA_UNO
LBA_UNO collected $0.25 from pot
LBA_UNO: doesn't show hand 
*** SUMMARY ***
Total pot $0.25 | Rake $0 
Seat 1: Marder1388 (button) folded before Flop (didn't bet)
Seat 2: Manon4ik (small blind) folded before Flop
Seat 3: Oleg032 (big blind) folded before Flop
Seat 4: LBA_UNO collected ($0.25)
Seat 5: sólyom333 folded before Flop (didn't bet)



PokerStars Hand #222966454490:  Hold'em No Limit ($0.05/$0.10 USD) - 2021/01/23 14:29:06 ET
Table 'Shura III' 6-max Seat #2 is the button
Seat 1: Marder1388 ($8.27 in chips) 
Seat 2: Manon4ik ($10 in chips) 
Seat 3: Oleg032 ($16.24 in chips) 
Seat 4: LBA_UNO ($11.50 in chips) 
Seat 5: sólyom333 ($11.09 in chips) 
Oleg032: posts small blind $0.05
LBA_UNO: posts big blind $0.10
Pokertom143: sits out 
*** HOLE CARDS ***
sólyom333: folds 
Marder1388: calls $0.10
Manon4ik: folds 
Oleg032: calls $0.05
LBA_UNO: checks 
*** FLOP *** [4c Jd Kc]
Oleg032: checks 
LBA_UNO: checks 
Marder1388: checks 
*** TURN *** [4c Jd Kc] [6h]
Oleg032: checks 
LBA_UNO: bets $0.22
Marder1388: calls $0.22
Oleg032: folds 
*** RIVER *** [4c Jd Kc 6h] [7d]
LBA_UNO: bets $0.53
Marder1388: folds 
Uncalled bet ($0.53) returned to LBA_UNO
LBA_UNO collected $0.71 from pot
LBA_UNO: doesn't show hand 
*** SUMMARY ***
Total pot $0.74 | Rake $0.03 
Board [4c Jd Kc 6h 7d]
Seat 1: Marder1388 folded on the River
Seat 2: Manon4ik (button) folded before Flop (didn't bet)
Seat 3: Oleg032 (small blind) folded on the Turn
Seat 4: LBA_UNO (big blind) collected ($0.71)
Seat 5: sólyom333 folded before Flop (didn't bet)



PokerStars Hand #222966504682:  Hold'em No Limit ($0.05/$0.10 USD) - 2021/01/23 14:30:00 ET
Table 'Shura III' 6-max Seat #3 is the button
Seat 1: Marder1388 ($7.95 in chips) 
Seat 2: Manon4ik ($10 in chips) 
Seat 3: Oleg032 ($16.14 in chips) 
Seat 4: LBA_UNO ($11.89 in chips) 
Seat 5: sólyom333 ($11.09 in chips) 
LBA_UNO: posts small blind $0.05
sólyom333: posts big blind $0.10
Pokertom143: sits out 
*** HOLE CARDS ***
Marder1388: calls $0.10
Manon4ik: folds 
Oleg032: raises $0.15 to $0.25
LBA_UNO: folds 
sólyom333: folds 
Marder1388: calls $0.15
*** FLOP *** [6h 5s Ac]
Marder1388: bets $0.31
Oleg032: calls $0.31
*** TURN *** [6h 5s Ac] [3s]
Marder1388: bets $0.61
Oleg032: folds 
Uncalled bet ($0.61) returned to Marder1388
Marder1388 collected $1.21 from pot
Marder1388: doesn't show hand 
*** SUMMARY ***
Total pot $1.27 | Rake $0.06 
Board [6h 5s Ac 3s]
Seat 1: Marder1388 collected ($1.21)
Seat 2: Manon4ik folded before Flop (didn't bet)
Seat 3: Oleg032 (button) folded on the Turn
Seat 4: LBA_UNO (small blind) folded before Flop
Seat 5: sólyom333 (big blind) folded before Flop



PokerStars Hand #222966552717:  Hold'em No Limit ($0.05/$0.10 USD) - 2021/01/23 14:31:00 ET
Table 'Shura III' 6-max Seat #4 is the button
Seat 1: Marder1388 ($8.60 in chips) 
Seat 2: Manon4ik ($10 in chips) 
Seat 3: Oleg032 ($15.58 in chips) 
Seat 4: LBA_UNO ($11.84 in chips) 
Seat 5: sólyom333 ($10.99 in chips) 
Seat 6: Pokertom143 ($10 in chips) 
sólyom333: posts small blind $0.05
Pokertom143: posts big blind $0.10
*** HOLE CARDS ***
Marder1388: folds 
Manon4ik: folds 
Oleg032: folds 
LBA_UNO: folds 
sólyom333: folds 
Uncalled bet ($0.05) returned to Pokertom143
Pokertom143 collected $0.10 from pot
*** SUMMARY ***
Total pot $0.10 | Rake $0 
Seat 1: Marder1388 folded before Flop (didn't bet)
Seat 2: Manon4ik folded before Flop (didn't bet)
Seat 3: Oleg032 folded before Flop (didn't bet)
Seat 4: LBA_UNO (button) folded before Flop (didn't bet)
Seat 5: sólyom333 (small blind) folded before Flop
Seat 6: Pokertom143 (big blind) collected ($0.10)



PokerStars Hand #222966560531:  Hold'em No Limit ($0.05/$0.10 USD) - 2021/01/23 14:31:10 ET
Table 'Shura III' 6-max Seat #5 is the button
Seat 1: Marder1388 ($8.60 in chips) 
Seat 2: Manon4ik ($10 in chips) 
Seat 3: Oleg032 ($15.58 in chips) 
Seat 4: LBA_UNO ($11.84 in chips) 
Seat 5: sólyom333 ($10.94 in chips) 
Seat 6: Pokertom143 ($10.05 in chips) 
Pokertom143: posts small blind $0.05
Marder1388: posts big blind $0.10
*** HOLE CARDS ***
Manon4ik: folds 
Oleg032: folds 
LBA_UNO: folds 
sólyom333: raises $0.12 to $0.22
Pokertom143: calls $0.17
Marder1388: folds 
*** FLOP *** [3c Tc 3h]
Pokertom143: bets $0.52
sólyom333: raises $0.88 to $1.40
Pokertom143: calls $0.88
*** TURN *** [3c Tc 3h] [5h]
Pokertom143: checks 
sólyom333: bets $2.13
Pokertom143: folds 
Uncalled bet ($2.13) returned to sólyom333
sólyom333 collected $3.19 from pot
sólyom333: doesn't show hand 
*** SUMMARY ***
Total pot $3.34 | Rake $0.15 
Board [3c Tc 3h 5h]
Seat 1: Marder1388 (big blind) folded before Flop
Seat 2: Manon4ik folded before Flop (didn't bet)
Seat 3: Oleg032 folded before Flop (didn't bet)
Seat 4: LBA_UNO folded before Flop (didn't bet)
Seat 5: sólyom333 (button) collected ($3.19)
Seat 6: Pokertom143 (small blind) folded on the Turn



PokerStars Hand #222966616544:  Hold'em No Limit ($0.05/$0.10 USD) - 2021/01/23 14:32:21 ET
Table 'Shura III' 6-max Seat #6 is the button
Seat 1: Marder1388 ($8.50 in chips) 
Seat 2: Manon4ik ($10 in chips) 
Seat 3: Oleg032 ($15.58 in chips) 
Seat 4: LBA_UNO ($11.84 in chips) 
Seat 5: sólyom333 ($12.51 in chips) 
Seat 6: Pokertom143 ($8.43 in chips) 
Marder1388: posts small blind $0.05
Manon4ik: posts big blind $0.10
*** HOLE CARDS ***
Oleg032: folds 
LBA_UNO: folds 
sólyom333: folds 
Pokertom143: folds 
Marder1388: folds 
Uncalled bet ($0.05) returned to Manon4ik
Manon4ik collected $0.10 from pot
Manon4ik: doesn't show hand 
*** SUMMARY ***
Total pot $0.10 | Rake $0 
Seat 1: Marder1388 (small blind) folded before Flop
Seat 2: Manon4ik (big blind) collected ($0.10)
Seat 3: Oleg032 folded before Flop (didn't bet)
Seat 4: LBA_UNO folded before Flop (didn't bet)
Seat 5: sólyom333 folded before Flop (didn't bet)
Seat 6: Pokertom143 (button) folded before Flop (didn't bet)



PokerStars Hand #222966623747:  Hold'em No Limit ($0.05/$0.10 USD) - 2021/01/23 14:32:31 ET
Table 'Shura III' 6-max Seat #1 is the button
Seat 1: Marder1388 ($8.45 in chips) 
Seat 2: Manon4ik ($10.05 in chips) 
Seat 3: Oleg032 ($15.58 in chips) 
Seat 4: LBA_UNO ($11.84 in chips) 
Seat 5: sólyom333 ($12.51 in chips) 
Seat 6: Pokertom143 ($8.43 in chips) 
Manon4ik: posts small blind $0.05
Oleg032: posts big blind $0.10
*** HOLE CARDS ***
LBA_UNO: folds 
sólyom333: folds 
Pokertom143: raises $0.20 to $0.30
Marder1388: calls $0.30
Manon4ik: folds 
Oleg032: folds 
*** FLOP *** [3c Qc 8c]
Pokertom143: bets $0.72
Marder1388: calls $0.72
*** TURN *** [3c Qc 8c] [Ts]
Pokertom143: bets $1.05
Marder1388: calls $1.05
*** RIVER *** [3c Qc 8c Ts] [9d]
Pokertom143: bets $2.05
Marder1388: calls $2.05
*** SHOW DOWN ***
Pokertom143: shows [As Jh] (a straight, Eight to Queen)
Marder1388: mucks hand 
Pokertom143 collected $8.01 from pot
*** SUMMARY ***
Total pot $8.39 | Rake $0.38 
Board [3c Qc 8c Ts 9d]
Seat 1: Marder1388 (button) mucked
Seat 2: Manon4ik (small blind) folded before Flop
Seat 3: Oleg032 (big blind) folded before Flop
Seat 4: LBA_UNO folded before Flop (didn't bet)
Seat 5: sólyom333 folded before Flop (didn't bet)
Seat 6: Pokertom143 showed [As Jh] and won ($8.01) with a straight, Eight to Queen



PokerStars Hand #222966665394:  Hold'em No Limit ($0.05/$0.10 USD) - 2021/01/23 14:33:24 ET
Table 'Shura III' 6-max Seat #2 is the button
Seat 1: Marder1388 ($4.33 in chips) 
Seat 2: Manon4ik ($10 in chips) 
Seat 3: Oleg032 ($15.48 in chips) 
Seat 4: LBA_UNO ($11.84 in chips) 
Seat 5: sólyom333 ($12.51 in chips) 
Seat 6: Pokertom143 ($12.32 in chips) 
Oleg032: posts small blind $0.05
LBA_UNO: posts big blind $0.10
*** HOLE CARDS ***
sólyom333: folds 
Pokertom143: raises $0.20 to $0.30
Marder1388: folds 
Manon4ik: folds 
Oleg032: folds 
LBA_UNO: folds 
Uncalled bet ($0.20) returned to Pokertom143
Pokertom143 collected $0.25 from pot
*** SUMMARY ***
Total pot $0.25 | Rake $0 
Seat 1: Marder1388 folded before Flop (didn't bet)
Seat 2: Manon4ik (button) folded before Flop (didn't bet)
Seat 3: Oleg032 (small blind) folded before Flop
Seat 4: LBA_UNO (big blind) folded before Flop
Seat 5: sólyom333 folded before Flop (didn't bet)
Seat 6: Pokertom143 collected ($0.25)



PokerStars Hand #222966675437:  Hold'em No Limit ($0.05/$0.10 USD) - 2021/01/23 14:33:36 ET
Table 'Shura III' 6-max Seat #3 is the button
Seat 1: Marder1388 ($4.33 in chips) 
Seat 2: Manon4ik ($10 in chips) 
Seat 3: Oleg032 ($15.43 in chips) 
Seat 4: LBA_UNO ($11.74 in chips) 
Seat 5: sólyom333 ($12.51 in chips) 
Seat 6: Pokertom143 ($12.47 in chips) 
LBA_UNO: posts small blind $0.05
sólyom333: posts big blind $0.10
*** HOLE CARDS ***
Pokertom143: folds 
Marder1388: calls $0.10
Manon4ik: folds 
Oleg032: raises $0.15 to $0.25
LBA_UNO: folds 
sólyom333: folds 
Marder1388: calls $0.15
*** FLOP *** [7h 5s Td]
Marder1388: checks 
Oleg032: checks 
*** TURN *** [7h 5s Td] [9c]
Marder1388: checks 
Oleg032: bets $0.20
Marder1388: calls $0.20
*** RIVER *** [7h 5s Td 9c] [3h]
Marder1388: checks 
Oleg032: checks 
*** SHOW DOWN ***
Marder1388: shows [3s 4s] (a pair of Threes)
Oleg032: mucks hand 
Marder1388 collected $1 from pot
*** SUMMARY ***
Total pot $1.05 | Rake $0.05 
Board [7h 5s Td 9c 3h]
Seat 1: Marder1388 showed [3s 4s] and won ($1) with a pair of Threes
Seat 2: Manon4ik folded before Flop (didn't bet)
Seat 3: Oleg032 (button) mucked
Seat 4: LBA_UNO (small blind) folded before Flop
Seat 5: sólyom333 (big blind) folded before Flop
Seat 6: Pokertom143 folded before Flop (didn't bet)



PokerStars Hand #222966714816:  Hold'em No Limit ($0.05/$0.10 USD) - 2021/01/23 14:34:27 ET
Table 'Shura III' 6-max Seat #4 is the button
Seat 1: Marder1388 ($4.88 in chips) 
Seat 2: Manon4ik ($10 in chips) 
Seat 3: Oleg032 ($14.98 in chips) 
Seat 4: LBA_UNO ($11.69 in chips) 
Seat 5: sólyom333 ($12.41 in chips) 
Seat 6: Pokertom143 ($12.47 in chips) 
sólyom333: posts small blind $0.05
Pokertom143: posts big blind $0.10
*** HOLE CARDS ***
Marder1388: calls $0.10
Manon4ik: calls $0.10
Oleg032: folds 
LBA_UNO: folds 
sólyom333: folds 
Pokertom143: checks 
*** FLOP *** [4c Qd Td]
Pokertom143: checks 
Marder1388: checks 
Manon4ik: checks 
*** TURN *** [4c Qd Td] [8h]
Pokertom143: checks 
Marder1388: bets $0.17
Manon4ik: folds 
Pokertom143: folds 
Uncalled bet ($0.17) returned to Marder1388
Marder1388 collected $0.33 from pot
Marder1388: doesn't show hand 
*** SUMMARY ***
Total pot $0.35 | Rake $0.02 
Board [4c Qd Td 8h]
Seat 1: Marder1388 collected ($0.33)
Seat 2: Manon4ik folded on the Turn
Seat 3: Oleg032 folded before Flop (didn't bet)
Seat 4: LBA_UNO (button) folded before Flop (didn't bet)
Seat 5: sólyom333 (small blind) folded before Flop
Seat 6: Pokertom143 (big blind) folded on the Turn



PokerStars Hand #222966745228:  Hold'em No Limit ($0.05/$0.10 USD) - 2021/01/23 14:35:06 ET
Table 'Shura III' 6-max Seat #5 is the button
Seat 1: Marder1388 ($5.11 in chips) 
Seat 2: Manon4ik ($10 in chips) 
Seat 3: Oleg032 ($14.98 in chips) 
Seat 4: LBA_UNO ($11.69 in chips) 
Seat 5: sólyom333 ($12.36 in chips) 
Seat 6: Pokertom143 ($12.37 in chips) 
Pokertom143: posts small blind $0.05
Marder1388: posts big blind $0.10
*** HOLE CARDS ***
Manon4ik: folds 
Oleg032: folds 
LBA_UNO: folds 
sólyom333: raises $0.12 to $0.22
Pokertom143: folds 
Marder1388: calls $0.12
*** FLOP *** [Kh Jd 9h]
Marder1388: checks 
sólyom333: bets $0.20
Marder1388: calls $0.20
*** TURN *** [Kh Jd 9h] [As]
Marder1388: checks 
sólyom333: checks 
*** RIVER *** [Kh Jd 9h As] [2d]
Marder1388: checks 
sólyom333: checks 
*** SHOW DOWN ***
Marder1388: shows [3c 3d] (a pair of Threes)
sólyom333: shows [5s 5h] (a pair of Fives)
sólyom333 collected $0.85 from pot
*** SUMMARY ***
Total pot $0.89 | Rake $0.04 
Board [Kh Jd 9h As 2d]
Seat 1: Marder1388 (big blind) showed [3c 3d] and lost with a pair of Threes
Seat 2: Manon4ik folded before Flop (didn't bet)
Seat 3: Oleg032 folded before Flop (didn't bet)
Seat 4: LBA_UNO folded before Flop (didn't bet)
Seat 5: sólyom333 (button) showed [5s 5h] and won ($0.85) with a pair of Fives
Seat 6: Pokertom143 (small blind) folded before Flop



PokerStars Hand #222966776242:  Hold'em No Limit ($0.05/$0.10 USD) - 2021/01/23 14:35:46 ET
Table 'Shura III' 6-max Seat #6 is the button
Seat 1: Marder1388 ($4.69 in chips) 
Seat 2: Manon4ik ($10 in chips) 
Seat 3: Oleg032 ($14.98 in chips) 
Seat 4: LBA_UNO ($11.69 in chips) 
Seat 5: sólyom333 ($12.79 in chips) 
Seat 6: Pokertom143 ($12.32 in chips) 
Marder1388: posts small blind $0.05
Manon4ik: posts big blind $0.10
*** HOLE CARDS ***
Oleg032: folds 
LBA_UNO: folds 
sólyom333: folds 
Pokertom143: folds 
Marder1388: folds 
Uncalled bet ($0.05) returned to Manon4ik
Manon4ik collected $0.10 from pot
Manon4ik: doesn't show hand 
*** SUMMARY ***
Total pot $0.10 | Rake $0 
Seat 1: Marder1388 (small blind) folded before Flop
Seat 2: Manon4ik (big blind) collected ($0.10)
Seat 3: Oleg032 folded before Flop (didn't bet)
Seat 4: LBA_UNO folded before Flop (didn't bet)
Seat 5: sólyom333 folded before Flop (didn't bet)
Seat 6: Pokertom143 (button) folded before Flop (didn't bet)



PokerStars Hand #222966786361:  Hold'em No Limit ($0.05/$0.10 USD) - 2021/01/23 14:35:58 ET
Table 'Shura III' 6-max Seat #1 is the button
Seat 1: Marder1388 ($4.64 in chips) 
Seat 2: Manon4ik ($10.05 in chips) 
Seat 3: Oleg032 ($14.98 in chips) 
Seat 4: LBA_UNO ($11.69 in chips) 
Seat 5: sólyom333 ($12.79 in chips) 
Seat 6: Pokertom143 ($12.32 in chips) 
Manon4ik: posts small blind $0.05
Oleg032: posts big blind $0.10
*** HOLE CARDS ***
LBA_UNO: folds 
sólyom333: raises $0.18 to $0.28
Pokertom143: folds 
Marder1388: calls $0.28
Manon4ik: folds 
Oleg032: folds 
*** FLOP *** [3s 5h 9d]
sólyom333: bets $0.29
Marder1388: calls $0.29
*** TURN *** [3s 5h 9d] [4d]
sólyom333: bets $0.82
Marder1388: folds 
Uncalled bet ($0.82) returned to sólyom333
sólyom333 collected $1.23 from pot
sólyom333: doesn't show hand 
*** SUMMARY ***
Total pot $1.29 | Rake $0.06 
Board [3s 5h 9d 4d]
Seat 1: Marder1388 (button) folded on the Turn
Seat 2: Manon4ik (small blind) folded before Flop
Seat 3: Oleg032 (big blind) folded before Flop
Seat 4: LBA_UNO folded before Flop (didn't bet)
Seat 5: sólyom333 collected ($1.23)
Seat 6: Pokertom143 folded before Flop (didn't bet)



PokerStars Hand #222966806470:  Hold'em No Limit ($0.05/$0.10 USD) - 2021/01/23 14:36:24 ET
Table 'Shura III' 6-max Seat #2 is the button
Seat 1: Marder1388 ($4.07 in chips) 
Seat 2: Manon4ik ($10 in chips) 
Seat 3: Oleg032 ($14.88 in chips) 
Seat 4: LBA_UNO ($11.69 in chips) 
Seat 5: sólyom333 ($13.45 in chips) 
Seat 6: Pokertom143 ($12.32 in chips) 
Oleg032: posts small blind $0.05
LBA_UNO: posts big blind $0.10
*** HOLE CARDS ***
sólyom333: folds 
Pokertom143: folds 
Marder1388: calls $0.10
Manon4ik: folds 
Oleg032: calls $0.05
LBA_UNO: raises $0.50 to $0.60
Marder1388: calls $0.50
Oleg032: folds 
*** FLOP *** [9h Tc 9d]
LBA_UNO: checks 
Marder1388: bets $0.62
LBA_UNO: raises $2.88 to $3.50
Marder1388: folds 
Uncalled bet ($2.88) returned to LBA_UNO
LBA_UNO collected $2.43 from pot
LBA_UNO: doesn't show hand 
*** SUMMARY ***
Total pot $2.54 | Rake $0.11 
Board [9h Tc 9d]
Seat 1: Marder1388 folded on the Flop
Seat 2: Manon4ik (button) folded before Flop (didn't bet)
Seat 3: Oleg032 (small blind) folded before Flop
Seat 4: LBA_UNO (big blind) collected ($2.43)
Seat 5: sólyom333 folded before Flop (didn't bet)
Seat 6: Pokertom143 folded before Flop (didn't bet)



PokerStars Hand #222966832018:  Hold'em No Limit ($0.05/$0.10 USD) - 2021/01/23 14:36:56 ET
Table 'Shura III' 6-max Seat #3 is the button
Seat 1: Marder1388 ($2.85 in chips) 
Seat 2: Manon4ik ($10 in chips) 
Seat 3: Oleg032 ($14.78 in chips) 
Seat 4: LBA_UNO ($12.90 in chips) 
Seat 5: sólyom333 ($13.45 in chips) 
Seat 6: Pokertom143 ($12.32 in chips) 
LBA_UNO: posts small blind $0.05
sólyom333: posts big blind $0.10
*** HOLE CARDS ***
Pokertom143: folds 
Marder1388: calls $0.10
Manon4ik: folds 
Oleg032: folds 
LBA_UNO: folds 
sólyom333: checks 
*** FLOP *** [4s 4c Js]
sólyom333: bets $0.21
Marder1388: folds 
Uncalled bet ($0.21) returned to sólyom333
sólyom333 collected $0.24 from pot
sólyom333: doesn't show hand 
*** SUMMARY ***
Total pot $0.25 | Rake $0.01 
Board [4s 4c Js]
Seat 1: Marder1388 folded on the Flop
Seat 2: Manon4ik folded before Flop (didn't bet)
Seat 3: Oleg032 (button) folded before Flop (didn't bet)
Seat 4: LBA_UNO (small blind) folded before Flop
Seat 5: sólyom333 (big blind) collected ($0.24)
Seat 6: Pokertom143 folded before Flop (didn't bet)



PokerStars Hand #222966845988:  Hold'em No Limit ($0.05/$0.10 USD) - 2021/01/23 14:37:14 ET
Table 'Shura III' 6-max Seat #4 is the button
Seat 1: Marder1388 ($2.75 in chips) 
Seat 2: Manon4ik ($10 in chips) 
Seat 3: Oleg032 ($14.78 in chips) 
Seat 4: LBA_UNO ($12.85 in chips) 
Seat 5: sólyom333 ($13.59 in chips) 
Seat 6: Pokertom143 ($12.32 in chips) 
sólyom333: posts small blind $0.05
Pokertom143: posts big blind $0.10
*** HOLE CARDS ***
Marder1388: calls $0.10
Manon4ik: folds 
Oleg032: raises $0.15 to $0.25
LBA_UNO: folds 
sólyom333: folds 
Pokertom143: folds 
Marder1388: calls $0.15
*** FLOP *** [Qh 6s 3d]
Marder1388: bets $0.31
Oleg032: calls $0.31
*** TURN *** [Qh 6s 3d] [3h]
Marder1388: bets $0.61
Oleg032: folds 
Uncalled bet ($0.61) returned to Marder1388
Marder1388 collected $1.21 from pot
Marder1388: doesn't show hand 
*** SUMMARY ***
Total pot $1.27 | Rake $0.06 
Board [Qh 6s 3d 3h]
Seat 1: Marder1388 collected ($1.21)
Seat 2: Manon4ik folded before Flop (didn't bet)
Seat 3: Oleg032 folded on the Turn
Seat 4: LBA_UNO (button) folded before Flop (didn't bet)
Seat 5: sólyom333 (small blind) folded before Flop
Seat 6: Pokertom143 (big blind) folded before Flop



PokerStars Hand #222966869451:  Hold'em No Limit ($0.05/$0.10 USD) - 2021/01/23 14:37:44 ET
Table 'Shura III' 6-max Seat #5 is the button
Seat 1: Marder1388 ($3.40 in chips) 
Seat 2: Manon4ik ($10 in chips) 
Seat 3: Oleg032 ($14.22 in chips) 
Seat 4: LBA_UNO ($12.85 in chips) 
Seat 5: sólyom333 ($13.54 in chips) 
Seat 6: Pokertom143 ($12.22 in chips) 
Pokertom143: posts small blind $0.05
Marder1388: posts big blind $0.10
*** HOLE CARDS ***
Manon4ik: folds 
Oleg032: folds 
LBA_UNO: folds 
sólyom333: raises $0.12 to $0.22
Pokertom143: folds 
Marder1388: folds 
Uncalled bet ($0.12) returned to sólyom333
sólyom333 collected $0.25 from pot
sólyom333: doesn't show hand 
*** SUMMARY ***
Total pot $0.25 | Rake $0 
Seat 1: Marder1388 (big blind) folded before Flop
Seat 2: Manon4ik folded before Flop (didn't bet)
Seat 3: Oleg032 folded before Flop (didn't bet)
Seat 4: LBA_UNO folded before Flop (didn't bet)
Seat 5: sólyom333 (button) collected ($0.25)
Seat 6: Pokertom143 (small blind) folded before Flop



PokerStars Hand #222966879202:  Hold'em No Limit ($0.05/$0.10 USD) - 2021/01/23 14:37:57 ET
Table 'Shura III' 6-max Seat #6 is the button
Seat 1: Marder1388 ($3.30 in chips) 
Seat 2: Manon4ik ($10 in chips) 
Seat 3: Oleg032 ($14.22 in chips) 
Seat 4: LBA_UNO ($12.85 in chips) 
Seat 5: sólyom333 ($13.69 in chips) 
Seat 6: Pokertom143 ($12.17 in chips) 
Marder1388: posts small blind $0.05
Manon4ik: posts big blind $0.10
*** HOLE CARDS ***
Oleg032: raises $0.15 to $0.25
LBA_UNO: folds 
sólyom333: folds 
Pokertom143: folds 
Marder1388: raises $0.15 to $0.40
Manon4ik: folds 
Oleg032: raises $0.90 to $1.30
Marder1388: raises $2 to $3.30 and is all-in
Oleg032: calls $2
*** FLOP *** [Kc As 2h]
*** TURN *** [Kc As 2h] [3c]
*** RIVER *** [Kc As 2h 3c] [Js]
*** SHOW DOWN ***
Marder1388: shows [Ts Th] (a pair of Tens)
Oleg032: shows [Ac Qh] (a pair of Aces)
Oleg032 collected $6.40 from pot
*** SUMMARY ***
Total pot $6.70 | Rake $0.30 
Board [Kc As 2h 3c Js]
Seat 1: Marder1388 (small blind) showed [Ts Th] and lost with a pair of Tens
Seat 2: Manon4ik (big blind) folded before Flop
Seat 3: Oleg032 showed [Ac Qh] and won ($6.40) with a pair of Aces
Seat 4: LBA_UNO folded before Flop (didn't bet)
Seat 5: sólyom333 folded before Flop (didn't bet)
Seat 6: Pokertom143 (button) folded before Flop (didn't bet)



PokerStars Hand #222966905099:  Hold'em No Limit ($0.05/$0.10 USD) - 2021/01/23 14:38:30 ET
Table 'Shura III' 6-max Seat #2 is the button
Seat 2: Manon4ik ($10 in chips) 
Seat 3: Oleg032 ($17.32 in chips) 
Seat 4: LBA_UNO ($12.85 in chips) 
Seat 5: sólyom333 ($13.69 in chips) 
Seat 6: Pokertom143 ($12.17 in chips) 
Oleg032: posts small blind $0.05
LBA_UNO: posts big blind $0.10
*** HOLE CARDS ***
sólyom333: folds 
Pokertom143: folds 
Manon4ik: folds 
Oleg032: folds 
Uncalled bet ($0.05) returned to LBA_UNO
LBA_UNO collected $0.10 from pot
LBA_UNO: doesn't show hand 
*** SUMMARY ***
Total pot $0.10 | Rake $0 
Seat 2: Manon4ik (button) folded before Flop (didn't bet)
Seat 3: Oleg032 (small blind) folded before Flop
Seat 4: LBA_UNO (big blind) collected ($0.10)
Seat 5: sólyom333 folded before Flop (didn't bet)
Seat 6: Pokertom143 folded before Flop (didn't bet)



PokerStars Hand #222966910364:  Hold'em No Limit ($0.05/$0.10 USD) - 2021/01/23 14:38:36 ET
Table 'Shura III' 6-max Seat #3 is the button
Seat 2: Manon4ik ($10 in chips) 
Seat 3: Oleg032 ($17.27 in chips) 
Seat 4: LBA_UNO ($12.90 in chips) 
Seat 5: sólyom333 ($13.69 in chips) 
Seat 6: Pokertom143 ($12.17 in chips) 
LBA_UNO: posts small blind $0.05
sólyom333: posts big blind $0.10
*** HOLE CARDS ***
Marder1388 leaves the table
Pokertom143: folds 
Manon4ik: folds 
Oleg032: raises $0.15 to $0.25
LBA_UNO: folds 
sólyom333: folds 
Uncalled bet ($0.15) returned to Oleg032
Oleg032 collected $0.25 from pot
Oleg032: doesn't show hand 
*** SUMMARY ***
Total pot $0.25 | Rake $0 
Seat 2: Manon4ik folded before Flop (didn't bet)
Seat 3: Oleg032 (button) collected ($0.25)
Seat 4: LBA_UNO (small blind) folded before Flop
Seat 5: sólyom333 (big blind) folded before Flop
Seat 6: Pokertom143 folded before Flop (didn't bet)



PokerStars Hand #222966918582:  Hold'em No Limit ($0.05/$0.10 USD) - 2021/01/23 14:38:47 ET
Table 'Shura III' 6-max Seat #4 is the button
Seat 2: Manon4ik ($10 in chips) 
Seat 3: Oleg032 ($17.42 in chips) 
Seat 4: LBA_UNO ($12.85 in chips) 
Seat 5: sólyom333 ($13.59 in chips) 
Seat 6: Pokertom143 ($12.17 in chips) 
sólyom333: posts small blind $0.05
Pokertom143: posts big blind $0.10
*** HOLE CARDS ***
Manon4ik: folds 
Oleg032: raises $0.15 to $0.25
Prigaty joins the table at seat #1 
LBA_UNO: folds 
sólyom333: folds 
Pokertom143: folds 
Uncalled bet ($0.15) returned to Oleg032
Oleg032 collected $0.25 from pot
Oleg032: doesn't show hand 
*** SUMMARY ***
Total pot $0.25 | Rake $0 
Seat 2: Manon4ik folded before Flop (didn't bet)
Seat 3: Oleg032 collected ($0.25)
Seat 4: LBA_UNO (button) folded before Flop (didn't bet)
Seat 5: sólyom333 (small blind) folded before Flop
Seat 6: Pokertom143 (big blind) folded before Flop



PokerStars Hand #222966929659:  Hold'em No Limit ($0.05/$0.10 USD) - 2021/01/23 14:39:01 ET
Table 'Shura III' 6-max Seat #5 is the button
Seat 1: Prigaty ($10 in chips) 
Seat 2: Manon4ik ($10 in chips) 
Seat 3: Oleg032 ($17.57 in chips) 
Seat 4: LBA_UNO ($12.85 in chips) 
Seat 5: sólyom333 ($13.54 in chips) 
Seat 6: Pokertom143 ($12.07 in chips) 
Pokertom143: posts small blind $0.05
Prigaty: posts big blind $0.10
*** HOLE CARDS ***
Manon4ik: folds 
Oleg032: folds 
LBA_UNO: folds 
sólyom333: raises $0.12 to $0.22
Pokertom143: folds 
Oleg032 leaves the table
Prigaty: folds 
Uncalled bet ($0.12) returned to sólyom333
sólyom333 collected $0.25 from pot
sólyom333: doesn't show hand 
odonro joins the table at seat #3 
*** SUMMARY ***
Total pot $0.25 | Rake $0 
Seat 1: Prigaty (big blind) folded before Flop
Seat 2: Manon4ik folded before Flop (didn't bet)
Seat 3: Oleg032 folded before Flop (didn't bet)
Seat 4: LBA_UNO folded before Flop (didn't bet)
Seat 5: sólyom333 (button) collected ($0.25)
Seat 6: Pokertom143 (small blind) folded before Flop



PokerStars Hand #222966950898:  Hold'em No Limit ($0.05/$0.10 USD) - 2021/01/23 14:39:28 ET
Table 'Shura III' 6-max Seat #6 is the button
Seat 1: Prigaty ($10 in chips) 
Seat 3: odonro ($10 in chips) 
Seat 4: LBA_UNO ($12.85 in chips) 
Seat 5: sólyom333 ($13.69 in chips) 
Seat 6: Pokertom143 ($12.02 in chips) 
Prigaty: posts small blind $0.05
Manon4ik: is sitting out 
odonro is connected 
odonro: posts big blind $0.10
*** HOLE CARDS ***
LBA_UNO: folds 
sólyom333: folds 
Pokertom143: folds 
Prigaty: folds 
Uncalled bet ($0.05) returned to odonro
odonro collected $0.10 from pot
odonro: doesn't show hand 
*** SUMMARY ***
Total pot $0.10 | Rake $0 
Seat 1: Prigaty (small blind) folded before Flop
Seat 3: odonro (big blind) collected ($0.10)
Seat 4: LBA_UNO folded before Flop (didn't bet)
Seat 5: sólyom333 folded before Flop (didn't bet)
Seat 6: Pokertom143 (button) folded before Flop (didn't bet)



PokerStars Hand #222966962117:  Hold'em No Limit ($0.05/$0.10 USD) - 2021/01/23 14:39:43 ET
Table 'Shura III' 6-max Seat #1 is the button
Seat 1: Prigaty ($10 in chips) 
Seat 3: odonro ($10.05 in chips) 
Seat 4: LBA_UNO ($12.85 in chips) 
Seat 5: sólyom333 ($13.69 in chips) 
Seat 6: Pokertom143 ($12.02 in chips) 
odonro: posts small blind $0.05
LBA_UNO: posts big blind $0.10
*** HOLE CARDS ***
sólyom333: folds 
Pokertom143: folds 
Prigaty: raises $0.15 to $0.25
odonro: folds 
LBA_UNO: folds 
Uncalled bet ($0.15) returned to Prigaty
Prigaty collected $0.25 from pot
Prigaty: doesn't show hand 
*** SUMMARY ***
Total pot $0.25 | Rake $0 
Seat 1: Prigaty (button) collected ($0.25)
Seat 3: odonro (small blind) folded before Flop
Seat 4: LBA_UNO (big blind) folded before Flop
Seat 5: sólyom333 folded before Flop (didn't bet)
Seat 6: Pokertom143 folded before Flop (didn't bet)



PokerStars Hand #222966972346:  Hold'em No Limit ($0.05/$0.10 USD) - 2021/01/23 14:39:56 ET
Table 'Shura III' 6-max Seat #3 is the button
Seat 1: Prigaty ($10.15 in chips) 
Seat 3: odonro ($10 in chips) 
Seat 4: LBA_UNO ($12.75 in chips) 
Seat 5: sólyom333 ($13.69 in chips) 
Seat 6: Pokertom143 ($12.02 in chips) 
LBA_UNO: posts small blind $0.05
sólyom333: posts big blind $0.10
*** HOLE CARDS ***
Pokertom143: folds 
Prigaty: folds 
odonro: folds 
LBA_UNO: raises $0.20 to $0.30
sólyom333: raises $0.58 to $0.88
LBA_UNO: calls $0.58
*** FLOP *** [5h 6d 5d]
LBA_UNO: checks 
sólyom333: bets $0.71
LBA_UNO: raises $1.39 to $2.10
sólyom333: folds 
Uncalled bet ($1.39) returned to LBA_UNO
LBA_UNO collected $3.04 from pot
LBA_UNO: doesn't show hand 
*** SUMMARY ***
Total pot $3.18 | Rake $0.14 
Board [5h 6d 5d]
Seat 1: Prigaty folded before Flop (didn't bet)
Seat 3: odonro (button) folded before Flop (didn't bet)
Seat 4: LBA_UNO (small blind) collected ($3.04)
Seat 5: sólyom333 (big blind) folded on the Flop
Seat 6: Pokertom143 folded before Flop (didn't bet)



PokerStars Hand #222967002946:  Hold'em No Limit ($0.05/$0.10 USD) - 2021/01/23 14:40:35 ET
Table 'Shura III' 6-max Seat #4 is the button
Seat 1: Prigaty ($10.15 in chips) 
Seat 3: odonro ($10 in chips) 
Seat 4: LBA_UNO ($14.20 in chips) 
Seat 5: sólyom333 ($12.10 in chips) 
Seat 6: Pokertom143 ($12.02 in chips) 
sólyom333: posts small blind $0.05
Pokertom143: posts big blind $0.10
Manon4ik: sits out 
*** HOLE CARDS ***
Prigaty: folds 
odonro: calls $0.10
LBA_UNO: folds 
sólyom333: folds 
Pokertom143: raises $0.40 to $0.50
odonro: calls $0.40
*** FLOP *** [2c Tc Qs]
Pokertom143: bets $1
odonro: folds 
Uncalled bet ($1) returned to Pokertom143
Pokertom143 collected $1 from pot
*** SUMMARY ***
Total pot $1.05 | Rake $0.05 
Board [2c Tc Qs]
Seat 1: Prigaty folded before Flop (didn't bet)
Seat 3: odonro folded on the Flop
Seat 4: LBA_UNO (button) folded before Flop (didn't bet)
Seat 5: sólyom333 (small blind) folded before Flop
Seat 6: Pokertom143 (big blind) collected ($1)



PokerStars Hand #222967019562:  Hold'em No Limit ($0.05/$0.10 USD) - 2021/01/23 14:40:56 ET
Table 'Shura III' 6-max Seat #5 is the button
Seat 1: Prigaty ($10.15 in chips) 
Seat 3: odonro ($9.50 in chips) 
Seat 4: LBA_UNO ($14.20 in chips) 
Seat 5: sólyom333 ($12.05 in chips) 
Seat 6: Pokertom143 ($12.52 in chips) 
Pokertom143: posts small blind $0.05
Prigaty: posts big blind $0.10
Manon4ik: sits out 
*** HOLE CARDS ***
odonro: folds 
LBA_UNO: folds 
sólyom333: folds 
Pokertom143: raises $0.20 to $0.30
Prigaty: raises $0.70 to $1
Pokertom143: folds 
Uncalled bet ($0.70) returned to Prigaty
Prigaty collected $0.60 from pot
Prigaty: doesn't show hand 
*** SUMMARY ***
Total pot $0.60 | Rake $0 
Seat 1: Prigaty (big blind) collected ($0.60)
Seat 3: odonro folded before Flop (didn't bet)
Seat 4: LBA_UNO folded before Flop (didn't bet)
Seat 5: sólyom333 (button) folded before Flop (didn't bet)
Seat 6: Pokertom143 (small blind) folded before Flop



PokerStars Hand #222967042575:  Hold'em No Limit ($0.05/$0.10 USD) - 2021/01/23 14:41:25 ET
Table 'Shura III' 6-max Seat #6 is the button
Seat 1: Prigaty ($10.45 in chips) 
Seat 2: Manon4ik ($10 in chips) 
Seat 3: odonro ($9.50 in chips) 
Seat 4: LBA_UNO ($14.20 in chips) 
Seat 5: sólyom333 ($12.05 in chips) 
Seat 6: Pokertom143 ($12.22 in chips) 
Prigaty: posts small blind $0.05
Manon4ik: posts big blind $0.10
*** HOLE CARDS ***
odonro: calls $0.10
LBA_UNO: folds 
sólyom333: folds 
Pokertom143: calls $0.10
Prigaty: folds 
Manon4ik: checks 
*** FLOP *** [3c 4h 8c]
Manon4ik: checks 
odonro: checks 
Pokertom143: checks 
*** TURN *** [3c 4h 8c] [Qs]
Manon4ik: bets $0.33
odonro: folds 
Pokertom143: folds 
Uncalled bet ($0.33) returned to Manon4ik
Manon4ik collected $0.33 from pot
Manon4ik: doesn't show hand 
*** SUMMARY ***
Total pot $0.35 | Rake $0.02 
Board [3c 4h 8c Qs]
Seat 1: Prigaty (small blind) folded before Flop
Seat 2: Manon4ik (big blind) collected ($0.33)
Seat 3: odonro folded on the Turn
Seat 4: LBA_UNO folded before Flop (didn't bet)
Seat 5: sólyom333 folded before Flop (didn't bet)
Seat 6: Pokertom143 (button) folded on the Turn



PokerStars Hand #222967068624:  Hold'em No Limit ($0.05/$0.10 USD) - 2021/01/23 14:41:59 ET
Table 'Shura III' 6-max Seat #1 is the button
Seat 1: Prigaty ($10.40 in chips) 
Seat 2: Manon4ik ($10.23 in chips) 
Seat 3: odonro ($9.40 in chips) 
Seat 4: LBA_UNO ($14.20 in chips) 
Seat 5: sólyom333 ($12.05 in chips) 
Seat 6: Pokertom143 ($12.12 in chips) 
Manon4ik: posts small blind $0.05
odonro: posts big blind $0.10
*** HOLE CARDS ***
LBA_UNO: folds 
sólyom333: folds 
Pokertom143: raises $0.20 to $0.30
Prigaty: folds 
Manon4ik: folds 
odonro: calls $0.20
*** FLOP *** [Qs Ts 6c]
odonro: checks 
Pokertom143: checks 
*** TURN *** [Qs Ts 6c] [8h]
odonro: checks 
Pokertom143: checks 
*** RIVER *** [Qs Ts 6c 8h] [Th]
odonro: checks 
Pokertom143: checks 
*** SHOW DOWN ***
odonro: shows [7s 7c] (two pair, Tens and Sevens)
Pokertom143: mucks hand 
odonro collected $0.62 from pot
*** SUMMARY ***
Total pot $0.65 | Rake $0.03 
Board [Qs Ts 6c 8h Th]
Seat 1: Prigaty (button) folded before Flop (didn't bet)
Seat 2: Manon4ik (small blind) folded before Flop
Seat 3: odonro (big blind) showed [7s 7c] and won ($0.62) with two pair, Tens and Sevens
Seat 4: LBA_UNO folded before Flop (didn't bet)
Seat 5: sólyom333 folded before Flop (didn't bet)
Seat 6: Pokertom143 mucked



PokerStars Hand #222967090667:  Hold'em No Limit ($0.05/$0.10 USD) - 2021/01/23 14:42:27 ET
Table 'Shura III' 6-max Seat #2 is the button
Seat 1: Prigaty ($10.40 in chips) 
Seat 2: Manon4ik ($10.18 in chips) 
Seat 3: odonro ($9.72 in chips) 
Seat 4: LBA_UNO ($14.20 in chips) 
Seat 5: sólyom333 ($12.05 in chips) 
Seat 6: Pokertom143 ($11.82 in chips) 
odonro: posts small blind $0.05
LBA_UNO: posts big blind $0.10
*** HOLE CARDS ***
sólyom333: raises $0.18 to $0.28
Pokertom143: folds 
Prigaty: folds 
Manon4ik: folds 
odonro: calls $0.23
LBA_UNO: folds 
*** FLOP *** [Ac 9s 9d]
odonro: bets $0.63
sólyom333: calls $0.63
*** TURN *** [Ac 9s 9d] [7h]
odonro: bets $0.91
sólyom333: calls $0.91
*** RIVER *** [Ac 9s 9d 7h] [Qc]
odonro: bets $1.78
sólyom333: calls $1.78
*** SHOW DOWN ***
odonro: shows [3d Ad] (two pair, Aces and Nines)
sólyom333: shows [2h Ah] (two pair, Aces and Nines)
odonro collected $3.49 from pot
sólyom333 collected $3.48 from pot
*** SUMMARY ***
Total pot $7.30 | Rake $0.33 
Board [Ac 9s 9d 7h Qc]
Seat 1: Prigaty folded before Flop (didn't bet)
Seat 2: Manon4ik (button) folded before Flop (didn't bet)
Seat 3: odonro (small blind) showed [3d Ad] and won ($3.49) with two pair, Aces and Nines
Seat 4: LBA_UNO (big blind) folded before Flop
Seat 5: sólyom333 showed [2h Ah] and won ($3.48) with two pair, Aces and Nines
Seat 6: Pokertom143 folded before Flop (didn't bet)



PokerStars Hand #222967120152:  Hold'em No Limit ($0.05/$0.10 USD) - 2021/01/23 14:43:05 ET
Table 'Shura III' 6-max Seat #3 is the button
Seat 1: Prigaty ($10.40 in chips) 
Seat 2: Manon4ik ($10.18 in chips) 
Seat 3: odonro ($9.61 in chips) 
Seat 4: LBA_UNO ($14.10 in chips) 
Seat 5: sólyom333 ($11.93 in chips) 
Seat 6: Pokertom143 ($11.82 in chips) 
LBA_UNO: posts small blind $0.05
sólyom333: posts big blind $0.10
*** HOLE CARDS ***
Pokertom143: folds 
Prigaty: folds 
Manon4ik: folds 
odonro: calls $0.10
LBA_UNO: folds 
sólyom333: checks 
*** FLOP *** [Qh Qs 4h]
sólyom333: checks 
odonro: checks 
*** TURN *** [Qh Qs 4h] [Qd]
sólyom333: bets $0.21
odonro: calls $0.21
*** RIVER *** [Qh Qs 4h Qd] [Ts]
sólyom333: bets $0.43
odonro: folds 
Uncalled bet ($0.43) returned to sólyom333
sólyom333 collected $0.64 from pot
sólyom333: doesn't show hand 
*** SUMMARY ***
Total pot $0.67 | Rake $0.03 
Board [Qh Qs 4h Qd Ts]
Seat 1: Prigaty folded before Flop (didn't bet)
Seat 2: Manon4ik folded before Flop (didn't bet)
Seat 3: odonro (button) folded on the River
Seat 4: LBA_UNO (small blind) folded before Flop
Seat 5: sólyom333 (big blind) collected ($0.64)
Seat 6: Pokertom143 folded before Flop (didn't bet)



PokerStars Hand #222967138142:  Hold'em No Limit ($0.05/$0.10 USD) - 2021/01/23 14:43:28 ET
Table 'Shura III' 6-max Seat #4 is the button
Seat 1: Prigaty ($10.40 in chips) 
Seat 2: Manon4ik ($10.18 in chips) 
Seat 3: odonro ($9.30 in chips) 
Seat 4: LBA_UNO ($14.05 in chips) 
Seat 5: sólyom333 ($12.26 in chips) 
Seat 6: Pokertom143 ($11.82 in chips) 
sólyom333: posts small blind $0.05
Pokertom143: posts big blind $0.10
*** HOLE CARDS ***
Prigaty: folds 
Manon4ik: raises $0.20 to $0.30
odonro: raises $0.75 to $1.05
LBA_UNO: folds 
sólyom333: folds 
Pokertom143: folds 
Manon4ik: calls $0.75
*** FLOP *** [9d 8c 7c]
Manon4ik: checks 
odonro: bets $2.25
Manon4ik: folds 
Uncalled bet ($2.25) returned to odonro
odonro collected $2.15 from pot
odonro: doesn't show hand 
*** SUMMARY ***
Total pot $2.25 | Rake $0.10 
Board [9d 8c 7c]
Seat 1: Prigaty folded before Flop (didn't bet)
Seat 2: Manon4ik folded on the Flop
Seat 3: odonro collected ($2.15)
Seat 4: LBA_UNO (button) folded before Flop (didn't bet)
Seat 5: sólyom333 (small blind) folded before Flop
Seat 6: Pokertom143 (big blind) folded before Flop



PokerStars Hand #222967184932:  Hold'em No Limit ($0.05/$0.10 USD) - 2021/01/23 14:44:28 ET
Table 'Shura III' 6-max Seat #5 is the button
Seat 2: Manon4ik ($10 in chips) 
Seat 3: odonro ($10.40 in chips) 
Seat 4: LBA_UNO ($14.05 in chips) 
Seat 5: sólyom333 ($12.21 in chips) 
Seat 6: Pokertom143 ($11.72 in chips) 
Pokertom143: posts small blind $0.05
Prigaty: is sitting out 
Manon4ik: posts big blind $0.10
*** HOLE CARDS ***
odonro: folds 
LBA_UNO: folds 
sólyom333: raises $0.12 to $0.22
Pokertom143: folds 
Prigaty leaves the table
Manon4ik: folds 
Uncalled bet ($0.12) returned to sólyom333
sólyom333 collected $0.25 from pot
sólyom333: doesn't show hand 
*** SUMMARY ***
Total pot $0.25 | Rake $0 
Seat 2: Manon4ik (big blind) folded before Flop
Seat 3: odonro folded before Flop (didn't bet)
Seat 4: LBA_UNO folded before Flop (didn't bet)
Seat 5: sólyom333 (button) collected ($0.25)
Seat 6: Pokertom143 (small blind) folded before Flop



PokerStars Hand #222967198011:  Hold'em No Limit ($0.05/$0.10 USD) - 2021/01/23 14:44:44 ET
Table 'Shura III' 6-max Seat #6 is the button
Seat 2: Manon4ik ($10 in chips) 
Seat 3: odonro ($10.40 in chips) 
Seat 4: LBA_UNO ($14.05 in chips) 
Seat 5: sólyom333 ($12.36 in chips) 
Seat 6: Pokertom143 ($11.67 in chips) 
Manon4ik: posts small blind $0.05
odonro: posts big blind $0.10
*** HOLE CARDS ***
LBA_UNO: folds 
sólyom333: raises $0.18 to $0.28
Pokertom143: folds 
Manon4ik: folds 
odonro: calls $0.18
*** FLOP *** [2h Jc 5d]
odonro: checks 
LBA_UNO leaves the table
sólyom333: bets $0.24
odonro: folds 
Uncalled bet ($0.24) returned to sólyom333
sólyom333 collected $0.58 from pot
sólyom333: doesn't show hand 
*** SUMMARY ***
Total pot $0.61 | Rake $0.03 
Board [2h Jc 5d]
Seat 2: Manon4ik (small blind) folded before Flop
Seat 3: odonro (big blind) folded on the Flop
Seat 4: LBA_UNO folded before Flop (didn't bet)
Seat 5: sólyom333 collected ($0.58)
Seat 6: Pokertom143 (button) folded before Flop (didn't bet)



PokerStars Hand #222967215649:  Hold'em No Limit ($0.05/$0.10 USD) - 2021/01/23 14:45:07 ET
Table 'Shura III' 6-max Seat #2 is the button
Seat 2: Manon4ik ($10 in chips) 
Seat 3: odonro ($10.12 in chips) 
Seat 5: sólyom333 ($12.66 in chips) 
Seat 6: Pokertom143 ($11.67 in chips) 
odonro: posts small blind $0.05
sólyom333: posts big blind $0.10
*** HOLE CARDS ***
Cheetham2020 joins the table at seat #1 
xSkokEx joins the table at seat #4 
Pokertom143: folds 
Manon4ik has timed out
Manon4ik: folds 
odonro: folds 
Uncalled bet ($0.05) returned to sólyom333
sólyom333 collected $0.10 from pot
sólyom333: doesn't show hand 
*** SUMMARY ***
Total pot $0.10 | Rake $0 
Seat 2: Manon4ik (button) folded before Flop (didn't bet)
Seat 3: odonro (small blind) folded before Flop
Seat 5: sólyom333 (big blind) collected ($0.10)
Seat 6: Pokertom143 folded before Flop (didn't bet)



PokerStars Hand #222967231082:  Hold'em No Limit ($0.05/$0.10 USD) - 2021/01/23 14:45:27 ET
Table 'Shura III' 6-max Seat #3 is the button
Seat 1: Cheetham2020 ($8 in chips) 
Seat 2: Manon4ik ($10 in chips) 
Seat 3: odonro ($10.07 in chips) 
Seat 5: sólyom333 ($12.71 in chips) 
Seat 6: Pokertom143 ($11.67 in chips) 
sólyom333: posts small blind $0.05
Pokertom143: posts big blind $0.10
Cheetham2020: posts big blind $0.10
*** HOLE CARDS ***
Cheetham2020: checks 
Manon4ik: calls $0.10
odonro: folds 
sólyom333: calls $0.05
Pokertom143: checks 
*** FLOP *** [8d Ac 5h]
sólyom333: checks 
Pokertom143: bets $0.38
Cheetham2020: calls $0.38
Manon4ik: calls $0.38
sólyom333: folds 
*** TURN *** [8d Ac 5h] [3s]
Pokertom143: bets $0.74
Cheetham2020: calls $0.74
Manon4ik: raises $1.96 to $2.70
Pokertom143: folds 
Cheetham2020: folds 
Uncalled bet ($1.96) returned to Manon4ik
Manon4ik collected $3.59 from pot
Manon4ik: doesn't show hand 
*** SUMMARY ***
Total pot $3.76 | Rake $0.17 
Board [8d Ac 5h 3s]
Seat 1: Cheetham2020 folded on the Turn
Seat 2: Manon4ik collected ($3.59)
Seat 3: odonro (button) folded before Flop (didn't bet)
Seat 5: sólyom333 (small blind) folded on the Flop
Seat 6: Pokertom143 (big blind) folded on the Turn



PokerStars Hand #222967288795:  Hold'em No Limit ($0.05/$0.10 USD) - 2021/01/23 14:46:41 ET
Table 'Shura III' 6-max Seat #5 is the button
Seat 1: Cheetham2020 ($6.78 in chips) 
Seat 2: Manon4ik ($12.37 in chips) 
Seat 3: odonro ($10.07 in chips) 
Seat 5: sólyom333 ($12.61 in chips) 
Seat 6: Pokertom143 ($10.45 in chips) 
Pokertom143: posts small blind $0.05
Cheetham2020: posts big blind $0.10
xSkokEx: sits out 
*** HOLE CARDS ***
Manon4ik: folds 
odonro: folds 
sólyom333: folds 
Pokertom143: calls $0.05
Cheetham2020: checks 
*** FLOP *** [9h 3h Kh]
Pokertom143: bets $0.30
Cheetham2020: raises $0.30 to $0.60
Pokertom143: calls $0.30
*** TURN *** [9h 3h Kh] [9c]
Pokertom143: checks 
Cheetham2020: checks 
*** RIVER *** [9h 3h Kh 9c] [2d]
Pokertom143: bets $0.80
Cheetham2020: folds 
Uncalled bet ($0.80) returned to Pokertom143
Pokertom143 collected $1.34 from pot
*** SUMMARY ***
Total pot $1.40 | Rake $0.06 
Board [9h 3h Kh 9c 2d]
Seat 1: Cheetham2020 (big blind) folded on the River
Seat 2: Manon4ik folded before Flop (didn't bet)
Seat 3: odonro folded before Flop (didn't bet)
Seat 5: sólyom333 (button) folded before Flop (didn't bet)
Seat 6: Pokertom143 (small blind) collected ($1.34)



PokerStars Hand #222967331019:  Hold'em No Limit ($0.05/$0.10 USD) - 2021/01/23 14:47:36 ET
Table 'Shura III' 6-max Seat #6 is the button
Seat 1: Cheetham2020 ($6.08 in chips) 
Seat 2: Manon4ik ($12.37 in chips) 
Seat 3: odonro ($10.07 in chips) 
Seat 5: sólyom333 ($12.61 in chips) 
Seat 6: Pokertom143 ($11.09 in chips) 
Cheetham2020: posts small blind $0.05
Manon4ik: posts big blind $0.10
xSkokEx: sits out 
*** HOLE CARDS ***
odonro: calls $0.10
sólyom333: raises $0.20 to $0.30
Pokertom143: calls $0.30
Cheetham2020: calls $0.25
Manon4ik: calls $0.20
odonro: calls $0.20
*** FLOP *** [Kc Kh Ts]
Cheetham2020: checks 
Manon4ik: checks 
odonro: checks 
sólyom333: checks 
Pokertom143: bets $1.43
Cheetham2020: calls $1.43
Manon4ik: folds 
odonro: folds 
sólyom333: folds 
*** TURN *** [Kc Kh Ts] [6h]
Cheetham2020: checks 
Pokertom143: bets $4.40
Cheetham2020: folds 
Uncalled bet ($4.40) returned to Pokertom143
Pokertom143 collected $4.16 from pot
*** SUMMARY ***
Total pot $4.36 | Rake $0.20 
Board [Kc Kh Ts 6h]
Seat 1: Cheetham2020 (small blind) folded on the Turn
Seat 2: Manon4ik (big blind) folded on the Flop
Seat 3: odonro folded on the Flop
Seat 5: sólyom333 folded on the Flop
Seat 6: Pokertom143 (button) collected ($4.16)



PokerStars Hand #222967386399:  Hold'em No Limit ($0.05/$0.10 USD) - 2021/01/23 14:48:47 ET
Table 'Shura III' 6-max Seat #1 is the button
Seat 1: Cheetham2020 ($4.35 in chips) 
Seat 2: Manon4ik ($12.07 in chips) 
Seat 3: odonro ($9.77 in chips) 
Seat 5: sólyom333 ($12.31 in chips) 
Seat 6: Pokertom143 ($13.52 in chips) 
Manon4ik: posts small blind $0.05
odonro: posts big blind $0.10
xSkokEx: sits out 
*** HOLE CARDS ***
sólyom333: raises $0.18 to $0.28
Pokertom143: folds 
Cheetham2020: calls $0.28
Manon4ik: raises $1.07 to $1.35
odonro: folds 
sólyom333: folds 
Cheetham2020: calls $1.07
*** FLOP *** [6d 5d 6h]
Manon4ik: bets $3
Cheetham2020: calls $3 and is all-in
Manon4ik has timed out
*** TURN *** [6d 5d 6h] [3s]
*** RIVER *** [6d 5d 6h 3s] [Qs]
*** SHOW DOWN ***
Manon4ik: shows [Ad Ks] (a pair of Sixes)
Cheetham2020: shows [4d 7d] (a straight, Three to Seven)
Cheetham2020 collected $8.67 from pot
*** SUMMARY ***
Total pot $9.08 | Rake $0.41 
Board [6d 5d 6h 3s Qs]
Seat 1: Cheetham2020 (button) showed [4d 7d] and won ($8.67) with a straight, Three to Seven
Seat 2: Manon4ik (small blind) showed [Ad Ks] and lost with a pair of Sixes
Seat 3: odonro (big blind) folded before Flop
Seat 5: sólyom333 folded before Flop
Seat 6: Pokertom143 folded before Flop (didn't bet)



PokerStars Hand #222967429266:  Hold'em No Limit ($0.05/$0.10 USD) - 2021/01/23 14:49:43 ET
Table 'Shura III' 6-max Seat #2 is the button
Seat 1: Cheetham2020 ($8.67 in chips) 
Seat 2: Manon4ik ($10 in chips) 
Seat 3: odonro ($9.67 in chips) 
Seat 4: xSkokEx ($10 in chips) 
Seat 5: sólyom333 ($12.03 in chips) 
Seat 6: Pokertom143 ($13.52 in chips) 
odonro: posts small blind $0.05
xSkokEx: posts big blind $0.10
*** HOLE CARDS ***
sólyom333: raises $0.18 to $0.28
Pokertom143: folds 
Cheetham2020: folds 
Manon4ik: folds 
odonro: folds 
xSkokEx: folds 
Uncalled bet ($0.18) returned to sólyom333
sólyom333 collected $0.25 from pot
sólyom333: doesn't show hand 
*** SUMMARY ***
Total pot $0.25 | Rake $0 
Seat 1: Cheetham2020 folded before Flop (didn't bet)
Seat 2: Manon4ik (button) folded before Flop (didn't bet)
Seat 3: odonro (small blind) folded before Flop
Seat 4: xSkokEx (big blind) folded before Flop
Seat 5: sólyom333 collected ($0.25)
Seat 6: Pokertom143 folded before Flop (didn't bet)



PokerStars Hand #222967440619:  Hold'em No Limit ($0.05/$0.10 USD) - 2021/01/23 14:49:57 ET
Table 'Shura III' 6-max Seat #3 is the button
Seat 1: Cheetham2020 ($8.67 in chips) 
Seat 2: Manon4ik ($10 in chips) 
Seat 3: odonro ($9.62 in chips) 
Seat 4: xSkokEx ($10 in chips) 
Seat 5: sólyom333 ($12.18 in chips) 
Seat 6: Pokertom143 ($13.52 in chips) 
xSkokEx: posts small blind $0.05
sólyom333: posts big blind $0.10
*** HOLE CARDS ***
Pokertom143: raises $0.20 to $0.30
Cheetham2020: calls $0.30
Manon4ik: folds 
odonro is disconnected 
odonro has timed out while disconnected
odonro: folds 
xSkokEx: folds 
sólyom333: calls $0.20
*** FLOP *** [Qc 5d 8h]
sólyom333: checks 
Pokertom143: bets $0.91
Cheetham2020: folds 
sólyom333: folds 
Uncalled bet ($0.91) returned to Pokertom143
Pokertom143 collected $0.91 from pot
*** SUMMARY ***
Total pot $0.95 | Rake $0.04 
Board [Qc 5d 8h]
Seat 1: Cheetham2020 folded on the Flop
Seat 2: Manon4ik folded before Flop (didn't bet)
Seat 3: odonro (button) folded before Flop (didn't bet)
Seat 4: xSkokEx (small blind) folded before Flop
Seat 5: sólyom333 (big blind) folded on the Flop
Seat 6: Pokertom143 collected ($0.91)



PokerStars Hand #222967483673:  Hold'em No Limit ($0.05/$0.10 USD) - 2021/01/23 14:50:53 ET
Table 'Shura III' 6-max Seat #4 is the button
Seat 1: Cheetham2020 ($8.37 in chips) 
Seat 2: Manon4ik ($10 in chips) 
Seat 4: xSkokEx ($10 in chips) 
Seat 5: sólyom333 ($11.88 in chips) 
Seat 6: Pokertom143 ($14.13 in chips) 
sólyom333: posts small blind $0.05
Pokertom143: posts big blind $0.10
*** HOLE CARDS ***
Cheetham2020: calls $0.10
Manon4ik: folds 
xSkokEx: folds 
sólyom333: raises $0.35 to $0.45
Pokertom143: folds 
Cheetham2020: calls $0.35
*** FLOP *** [2d 9c 7h]
sólyom333: checks 
Cheetham2020: checks 
*** TURN *** [2d 9c 7h] [Td]
sólyom333: bets $0.64
Cheetham2020: calls $0.64
*** RIVER *** [2d 9c 7h Td] [Qs]
sólyom333: bets $1.45
Cheetham2020: folds 
Uncalled bet ($1.45) returned to sólyom333
sólyom333 collected $2.18 from pot
sólyom333: doesn't show hand 
*** SUMMARY ***
Total pot $2.28 | Rake $0.10 
Board [2d 9c 7h Td Qs]
Seat 1: Cheetham2020 folded on the River
Seat 2: Manon4ik folded before Flop (didn't bet)
Seat 4: xSkokEx (button) folded before Flop (didn't bet)
Seat 5: sólyom333 (small blind) collected ($2.18)
Seat 6: Pokertom143 (big blind) folded before Flop



PokerStars Hand #222967536264:  Hold'em No Limit ($0.05/$0.10 USD) - 2021/01/23 14:52:02 ET
Table 'Shura III' 6-max Seat #5 is the button
Seat 1: Cheetham2020 ($7.28 in chips) 
Seat 2: Manon4ik ($10 in chips) 
Seat 3: odonro ($9.62 in chips) 
Seat 4: xSkokEx ($10 in chips) 
Seat 5: sólyom333 ($12.97 in chips) 
Seat 6: Pokertom143 ($14.03 in chips) 
Pokertom143: posts small blind $0.05
Cheetham2020: posts big blind $0.10
*** HOLE CARDS ***
Manon4ik: folds 
odonro: folds 
xSkokEx: folds 
sólyom333: raises $0.12 to $0.22
Pokertom143: folds 
Cheetham2020: calls $0.12
*** FLOP *** [4c Td Kh]
Cheetham2020: bets $0.40
sólyom333: calls $0.40
*** TURN *** [4c Td Kh] [3h]
Cheetham2020: checks 
sólyom333: checks 
*** RIVER *** [4c Td Kh 3h] [Ah]
Cheetham2020: bets $1.80
sólyom333: folds 
Uncalled bet ($1.80) returned to Cheetham2020
Cheetham2020 collected $1.23 from pot
Cheetham2020: doesn't show hand 
*** SUMMARY ***
Total pot $1.29 | Rake $0.06 
Board [4c Td Kh 3h Ah]
Seat 1: Cheetham2020 (big blind) collected ($1.23)
Seat 2: Manon4ik folded before Flop (didn't bet)
Seat 3: odonro folded before Flop (didn't bet)
Seat 4: xSkokEx folded before Flop (didn't bet)
Seat 5: sólyom333 (button) folded on the River
Seat 6: Pokertom143 (small blind) folded before Flop



PokerStars Hand #222967576935:  Hold'em No Limit ($0.05/$0.10 USD) - 2021/01/23 14:52:54 ET
Table 'Shura III' 6-max Seat #6 is the button
Seat 1: Cheetham2020 ($7.89 in chips) 
Seat 2: Manon4ik ($10 in chips) 
Seat 3: odonro ($9.62 in chips) 
Seat 4: xSkokEx ($10 in chips) 
Seat 5: sólyom333 ($12.35 in chips) 
Seat 6: Pokertom143 ($13.98 in chips) 
Cheetham2020: posts small blind $0.05
Manon4ik: posts big blind $0.10
*** HOLE CARDS ***
odonro: folds 
xSkokEx: folds 
sólyom333: folds 
Pokertom143: folds 
Cheetham2020: folds 
Uncalled bet ($0.05) returned to Manon4ik
Manon4ik collected $0.10 from pot
Manon4ik: doesn't show hand 
*** SUMMARY ***
Total pot $0.10 | Rake $0 
Seat 1: Cheetham2020 (small blind) folded before Flop
Seat 2: Manon4ik (big blind) collected ($0.10)
Seat 3: odonro folded before Flop (didn't bet)
Seat 4: xSkokEx folded before Flop (didn't bet)
Seat 5: sólyom333 folded before Flop (didn't bet)
Seat 6: Pokertom143 (button) folded before Flop (didn't bet)



PokerStars Hand #222967600561:  Hold'em No Limit ($0.05/$0.10 USD) - 2021/01/23 14:53:25 ET
Table 'Shura III' 6-max Seat #1 is the button
Seat 1: Cheetham2020 ($7.84 in chips) 
Seat 2: Manon4ik ($10.05 in chips) 
Seat 3: odonro ($9.62 in chips) 
Seat 4: xSkokEx ($10 in chips) 
Seat 5: sólyom333 ($12.35 in chips) 
Seat 6: Pokertom143 ($13.98 in chips) 
Manon4ik: posts small blind $0.05
odonro: posts big blind $0.10
*** HOLE CARDS ***
xSkokEx: folds 
sólyom333: folds 
Pokertom143: folds 
Cheetham2020 has timed out
Cheetham2020: folds 
Manon4ik: folds 
Uncalled bet ($0.05) returned to odonro
odonro collected $0.10 from pot
odonro: doesn't show hand 
*** SUMMARY ***
Total pot $0.10 | Rake $0 
Seat 1: Cheetham2020 (button) folded before Flop (didn't bet)
Seat 2: Manon4ik (small blind) folded before Flop
Seat 3: odonro (big blind) collected ($0.10)
Seat 4: xSkokEx folded before Flop (didn't bet)
Seat 5: sólyom333 folded before Flop (didn't bet)
Seat 6: Pokertom143 folded before Flop (didn't bet)



PokerStars Hand #222967620767:  Hold'em No Limit ($0.05/$0.10 USD) - 2021/01/23 14:53:43 ET
Table 'Shura III' 6-max Seat #2 is the button
Seat 2: Manon4ik ($10 in chips) 
Seat 3: odonro ($9.67 in chips) 
Seat 4: xSkokEx ($10 in chips) 
Seat 5: sólyom333 ($12.35 in chips) 
Seat 6: Pokertom143 ($13.98 in chips) 
odonro: posts small blind $0.05
xSkokEx: posts big blind $0.10
*** HOLE CARDS ***
sólyom333: folds 
Pokertom143: folds 
Manon4ik: folds 
odonro: raises $0.20 to $0.30
xSkokEx: folds 
Uncalled bet ($0.20) returned to odonro
odonro collected $0.20 from pot
odonro: doesn't show hand 
*** SUMMARY ***
Total pot $0.20 | Rake $0 
Seat 2: Manon4ik (button) folded before Flop (didn't bet)
Seat 3: odonro (small blind) collected ($0.20)
Seat 4: xSkokEx (big blind) folded before Flop
Seat 5: sólyom333 folded before Flop (didn't bet)
Seat 6: Pokertom143 folded before Flop (didn't bet)



PokerStars Hand #222967631443:  Hold'em No Limit ($0.05/$0.10 USD) - 2021/01/23 14:53:57 ET
Table 'Shura III' 6-max Seat #3 is the button
Seat 1: Cheetham2020 ($7.84 in chips) 
Seat 2: Manon4ik ($10 in chips) 
Seat 3: odonro ($9.77 in chips) 
Seat 4: xSkokEx ($10 in chips) 
Seat 5: sólyom333 ($12.35 in chips) 
Seat 6: Pokertom143 ($13.98 in chips) 
xSkokEx: posts small blind $0.05
sólyom333: posts big blind $0.10
*** HOLE CARDS ***
Pokertom143: folds 
Cheetham2020: raises $0.10 to $0.20
Manon4ik: raises $0.40 to $0.60
odonro: calls $0.60
xSkokEx: folds 
sólyom333: folds 
Cheetham2020: calls $0.40
*** FLOP *** [6h 7s 7h]
Cheetham2020: checks 
Manon4ik: checks 
odonro: checks 
*** TURN *** [6h 7s 7h] [As]
Cheetham2020: checks 
Manon4ik: checks 
odonro: checks 
*** RIVER *** [6h 7s 7h As] [Ad]
Cheetham2020: checks 
Manon4ik: checks 
odonro: checks 
*** SHOW DOWN ***
Cheetham2020: shows [Qd 8c] (two pair, Aces and Sevens)
Manon4ik: mucks hand 
odonro: mucks hand 
Cheetham2020 collected $1.86 from pot
*** SUMMARY ***
Total pot $1.95 | Rake $0.09 
Board [6h 7s 7h As Ad]
Seat 1: Cheetham2020 showed [Qd 8c] and won ($1.86) with two pair, Aces and Sevens
Seat 2: Manon4ik mucked
Seat 3: odonro (button) mucked
Seat 4: xSkokEx (small blind) folded before Flop
Seat 5: sólyom333 (big blind) folded before Flop
Seat 6: Pokertom143 folded before Flop (didn't bet)



PokerStars Hand #222967689538:  Hold'em No Limit ($0.05/$0.10 USD) - 2021/01/23 14:55:14 ET
Table 'Shura III' 6-max Seat #4 is the button
Seat 1: Cheetham2020 ($9.10 in chips) 
Seat 2: Manon4ik ($10 in chips) 
Seat 3: odonro ($9.17 in chips) 
Seat 4: xSkokEx ($10 in chips) 
Seat 5: sólyom333 ($12.25 in chips) 
Seat 6: Pokertom143 ($13.98 in chips) 
sólyom333: posts small blind $0.05
Pokertom143: posts big blind $0.10
*** HOLE CARDS ***
Cheetham2020 has timed out
Cheetham2020: folds 
Manon4ik: raises $0.15 to $0.25
odonro: calls $0.25
xSkokEx: folds 
sólyom333: folds 
Pokertom143: calls $0.15
*** FLOP *** [6c Tc 7c]
Pokertom143: checks 
Manon4ik: checks 
odonro: bets $0.76
Pokertom143: folds 
Manon4ik: folds 
Uncalled bet ($0.76) returned to odonro
odonro collected $0.76 from pot
odonro: doesn't show hand 
*** SUMMARY ***
Total pot $0.80 | Rake $0.04 
Board [6c Tc 7c]
Seat 1: Cheetham2020 folded before Flop (didn't bet)
Seat 2: Manon4ik folded on the Flop
Seat 3: odonro collected ($0.76)
Seat 4: xSkokEx (button) folded before Flop (didn't bet)
Seat 5: sólyom333 (small blind) folded before Flop
Seat 6: Pokertom143 (big blind) folded on the Flop



PokerStars Hand #222967712552:  Hold'em No Limit ($0.05/$0.10 USD) - 2021/01/23 14:55:58 ET
Table 'Shura III' 6-max Seat #5 is the button
Seat 1: Cheetham2020 ($9.10 in chips) 
Seat 2: Manon4ik ($10 in chips) 
Seat 3: odonro ($9.68 in chips) 
Seat 4: xSkokEx ($10 in chips) 
Seat 5: sólyom333 ($12.20 in chips) 
Seat 6: Pokertom143 ($13.73 in chips) 
Pokertom143: posts small blind $0.05
Cheetham2020: posts big blind $0.10
*** HOLE CARDS ***
Manon4ik: folds 
odonro: folds 
xSkokEx: folds 
sólyom333: raises $0.12 to $0.22
Pokertom143: folds 
Cheetham2020: calls $0.12
*** FLOP *** [Ac Jh 6d]
Cheetham2020: bets $0.47
sólyom333: folds 
Uncalled bet ($0.47) returned to Cheetham2020
Cheetham2020 collected $0.47 from pot
Cheetham2020: doesn't show hand 
*** SUMMARY ***
Total pot $0.49 | Rake $0.02 
Board [Ac Jh 6d]
Seat 1: Cheetham2020 (big blind) collected ($0.47)
Seat 2: Manon4ik folded before Flop (didn't bet)
Seat 3: odonro folded before Flop (didn't bet)
Seat 4: xSkokEx folded before Flop (didn't bet)
Seat 5: sólyom333 (button) folded on the Flop
Seat 6: Pokertom143 (small blind) folded before Flop



PokerStars Hand #222967723558:  Hold'em No Limit ($0.05/$0.10 USD) - 2021/01/23 14:56:19 ET
Table 'Shura III' 6-max Seat #6 is the button
Seat 1: Cheetham2020 ($9.35 in chips) 
Seat 2: Manon4ik ($10 in chips) 
Seat 3: odonro ($9.68 in chips) 
Seat 4: xSkokEx ($10 in chips) 
Seat 5: sólyom333 ($11.98 in chips) 
Seat 6: Pokertom143 ($13.68 in chips) 
Cheetham2020: posts small blind $0.05
Manon4ik: posts big blind $0.10
*** HOLE CARDS ***
odonro: folds 
xSkokEx: folds 
sólyom333: folds 
Pokertom143: folds 
Cheetham2020: calls $0.05
Manon4ik: checks 
*** FLOP *** [6d 3d Ac]
Cheetham2020: bets $0.10
Manon4ik: calls $0.10
*** TURN *** [6d 3d Ac] [9c]
Cheetham2020: checks 
Manon4ik: checks 
*** RIVER *** [6d 3d Ac 9c] [9d]
Cheetham2020: bets $0.90
Manon4ik: folds 
Uncalled bet ($0.90) returned to Cheetham2020
Cheetham2020 collected $0.38 from pot
Cheetham2020: doesn't show hand 
*** SUMMARY ***
Total pot $0.40 | Rake $0.02 
Board [6d 3d Ac 9c 9d]
Seat 1: Cheetham2020 (small blind) collected ($0.38)
Seat 2: Manon4ik (big blind) folded on the River
Seat 3: odonro folded before Flop (didn't bet)
Seat 4: xSkokEx folded before Flop (didn't bet)
Seat 5: sólyom333 folded before Flop (didn't bet)
Seat 6: Pokertom143 (button) folded before Flop (didn't bet)



PokerStars Hand #222967759158:  Hold'em No Limit ($0.05/$0.10 USD) - 2021/01/23 14:57:25 ET
Table 'Shura III' 6-max Seat #1 is the button
Seat 1: Cheetham2020 ($9.53 in chips) 
Seat 2: Manon4ik ($10 in chips) 
Seat 3: odonro ($9.68 in chips) 
Seat 4: xSkokEx ($10 in chips) 
Seat 5: sólyom333 ($11.98 in chips) 
Seat 6: Pokertom143 ($13.68 in chips) 
Manon4ik: posts small blind $0.05
odonro: posts big blind $0.10
*** HOLE CARDS ***
xSkokEx: folds 
sólyom333: folds 
Pokertom143: folds 
Cheetham2020: calls $0.10
Manon4ik: calls $0.05
odonro: checks 
*** FLOP *** [Ah 5h 2s]
Manon4ik: checks 
odonro: checks 
Cheetham2020: checks 
*** TURN *** [Ah 5h 2s] [5c]
Manon4ik: checks 
odonro: checks 
Cheetham2020: checks 
*** RIVER *** [Ah 5h 2s 5c] [8c]
Manon4ik: checks 
odonro: bets $0.29
Cheetham2020: calls $0.29
Manon4ik: folds 
*** SHOW DOWN ***
odonro: shows [Jh 8d] (two pair, Eights and Fives)
Cheetham2020: mucks hand 
odonro collected $0.84 from pot
*** SUMMARY ***
Total pot $0.88 | Rake $0.04 
Board [Ah 5h 2s 5c 8c]
Seat 1: Cheetham2020 (button) mucked
Seat 2: Manon4ik (small blind) folded on the River
Seat 3: odonro (big blind) showed [Jh 8d] and won ($0.84) with two pair, Eights and Fives
Seat 4: xSkokEx folded before Flop (didn't bet)
Seat 5: sólyom333 folded before Flop (didn't bet)
Seat 6: Pokertom143 folded before Flop (didn't bet)



PokerStars Hand #222967792332:  Hold'em No Limit ($0.05/$0.10 USD) - 2021/01/23 14:58:27 ET
Table 'Shura III' 6-max Seat #2 is the button
Seat 1: Cheetham2020 ($9.14 in chips) 
Seat 2: Manon4ik ($10 in chips) 
Seat 3: odonro ($10.13 in chips) 
Seat 4: xSkokEx ($10 in chips) 
Seat 5: sólyom333 ($11.98 in chips) 
Seat 6: Pokertom143 ($13.68 in chips) 
odonro: posts small blind $0.05
xSkokEx: posts big blind $0.10
*** HOLE CARDS ***
sólyom333: folds 
Pokertom143: raises $0.20 to $0.30
Cheetham2020: calls $0.30
Manon4ik: folds 
odonro: folds 
xSkokEx: calls $0.20
*** FLOP *** [2h 6h 8c]
xSkokEx: checks 
Pokertom143: checks 
Cheetham2020: checks 
*** TURN *** [2h 6h 8c] [Ah]
xSkokEx: checks 
Pokertom143: bets $0.40
Cheetham2020 has timed out
Cheetham2020: folds 
xSkokEx: folds 
Uncalled bet ($0.40) returned to Pokertom143
Pokertom143 collected $0.91 from pot
*** SUMMARY ***
Total pot $0.95 | Rake $0.04 
Board [2h 6h 8c Ah]
Seat 1: Cheetham2020 folded on the Turn
Seat 2: Manon4ik (button) folded before Flop (didn't bet)
Seat 3: odonro (small blind) folded before Flop
Seat 4: xSkokEx (big blind) folded on the Turn
Seat 5: sólyom333 folded before Flop (didn't bet)
Seat 6: Pokertom143 collected ($0.91)



PokerStars Hand #222967841464:  Hold'em No Limit ($0.05/$0.10 USD) - 2021/01/23 14:59:59 ET
Table 'Shura III' 6-max Seat #3 is the button
Seat 1: Cheetham2020 ($8.84 in chips) 
Seat 2: Manon4ik ($10 in chips) 
Seat 3: odonro ($10.08 in chips) 
Seat 4: xSkokEx ($10 in chips) 
Seat 5: sólyom333 ($11.98 in chips) 
Seat 6: Pokertom143 ($14.29 in chips) 
xSkokEx: posts small blind $0.05
sólyom333: posts big blind $0.10
*** HOLE CARDS ***
Pokertom143: folds 
Cheetham2020: calls $0.10
Manon4ik: folds 
odonro: folds 
xSkokEx: folds 
sólyom333: checks 
*** FLOP *** [5h 8d 5c]
sólyom333: bets $0.21
Cheetham2020: calls $0.21
*** TURN *** [5h 8d 5c] [Jd]
sólyom333: bets $0.56
Cheetham2020: calls $0.56
*** RIVER *** [5h 8d 5c Jd] [7h]
sólyom333: bets $1.14
Cheetham2020: calls $1.14
*** SHOW DOWN ***
sólyom333: shows [5s 4h] (three of a kind, Fives)
Cheetham2020: mucks hand 
sólyom333 collected $3.89 from pot
*** SUMMARY ***
Total pot $4.07 | Rake $0.18 
Board [5h 8d 5c Jd 7h]
Seat 1: Cheetham2020 mucked
Seat 2: Manon4ik folded before Flop (didn't bet)
Seat 3: odonro (button) folded before Flop (didn't bet)
Seat 4: xSkokEx (small blind) folded before Flop
Seat 5: sólyom333 (big blind) showed [5s 4h] and won ($3.89) with three of a kind, Fives
Seat 6: Pokertom143 folded before Flop (didn't bet)



PokerStars Hand #222967867080:  Hold'em No Limit ($0.05/$0.10 USD) - 2021/01/23 15:00:43 ET
Table 'Shura III' 6-max Seat #4 is the button
Seat 1: Cheetham2020 ($6.83 in chips) 
Seat 2: Manon4ik ($10 in chips) 
Seat 3: odonro ($10.08 in chips) 
Seat 4: xSkokEx ($10 in chips) 
Seat 5: sólyom333 ($13.86 in chips) 
Seat 6: Pokertom143 ($14.29 in chips) 
sólyom333: posts small blind $0.05
Pokertom143: posts big blind $0.10
*** HOLE CARDS ***
Cheetham2020: folds 
Manon4ik: folds 
odonro: folds 
xSkokEx: raises $0.15 to $0.25
sólyom333: folds 
Pokertom143: folds 
Uncalled bet ($0.15) returned to xSkokEx
xSkokEx collected $0.25 from pot
xSkokEx: doesn't show hand 
*** SUMMARY ***
Total pot $0.25 | Rake $0 
Seat 1: Cheetham2020 folded before Flop (didn't bet)
Seat 2: Manon4ik folded before Flop (didn't bet)
Seat 3: odonro folded before Flop (didn't bet)
Seat 4: xSkokEx (button) collected ($0.25)
Seat 5: sólyom333 (small blind) folded before Flop
Seat 6: Pokertom143 (big blind) folded before Flop



PokerStars Hand #222967882691:  Hold'em No Limit ($0.05/$0.10 USD) - 2021/01/23 15:01:08 ET
Table 'Shura III' 6-max Seat #5 is the button
Seat 1: Cheetham2020 ($6.83 in chips) 
Seat 2: Manon4ik ($10 in chips) 
Seat 3: odonro ($10.08 in chips) 
Seat 4: xSkokEx ($10.15 in chips) 
Seat 5: sólyom333 ($13.81 in chips) 
Seat 6: Pokertom143 ($14.19 in chips) 
Pokertom143: posts small blind $0.05
Cheetham2020: posts big blind $0.10
*** HOLE CARDS ***
Manon4ik: folds 
odonro: folds 
xSkokEx: folds 
sólyom333: raises $0.12 to $0.22
Pokertom143: folds 
Cheetham2020: calls $0.12
*** FLOP *** [Ks Jd Ac]
Cheetham2020: checks 
sólyom333: checks 
*** TURN *** [Ks Jd Ac] [2c]
Cheetham2020: checks 
sólyom333: bets $0.31
Cheetham2020: folds 
Uncalled bet ($0.31) returned to sólyom333
sólyom333 collected $0.47 from pot
sólyom333: doesn't show hand 
*** SUMMARY ***
Total pot $0.49 | Rake $0.02 
Board [Ks Jd Ac 2c]
Seat 1: Cheetham2020 (big blind) folded on the Turn
Seat 2: Manon4ik folded before Flop (didn't bet)
Seat 3: odonro folded before Flop (didn't bet)
Seat 4: xSkokEx folded before Flop (didn't bet)
Seat 5: sólyom333 (button) collected ($0.47)
Seat 6: Pokertom143 (small blind) folded before Flop



PokerStars Hand #222967924278:  Hold'em No Limit ($0.05/$0.10 USD) - 2021/01/23 15:01:56 ET
Table 'Shura III' 6-max Seat #6 is the button
Seat 1: Cheetham2020 ($6.61 in chips) 
Seat 2: Manon4ik ($10 in chips) 
Seat 3: odonro ($10.08 in chips) 
Seat 4: xSkokEx ($10.15 in chips) 
Seat 5: sólyom333 ($14.06 in chips) 
Seat 6: Pokertom143 ($14.14 in chips) 
Cheetham2020: posts small blind $0.05
Manon4ik: posts big blind $0.10
*** HOLE CARDS ***
odonro: folds 
xSkokEx: folds 
sólyom333: raises $0.18 to $0.28
Pokertom143: calls $0.28
Cheetham2020: folds 
Manon4ik: folds 
*** FLOP *** [4h 3h Tc]
sólyom333: bets $0.29
Pokertom143: calls $0.29
*** TURN *** [4h 3h Tc] [5c]
sólyom333: checks 
Pokertom143: bets $1.23
sólyom333: folds 
Uncalled bet ($1.23) returned to Pokertom143
Pokertom143 collected $1.23 from pot
*** SUMMARY ***
Total pot $1.29 | Rake $0.06 
Board [4h 3h Tc 5c]
Seat 1: Cheetham2020 (small blind) folded before Flop
Seat 2: Manon4ik (big blind) folded before Flop
Seat 3: odonro folded before Flop (didn't bet)
Seat 4: xSkokEx folded before Flop (didn't bet)
Seat 5: sólyom333 folded on the Turn
Seat 6: Pokertom143 (button) collected ($1.23)



PokerStars Hand #222967974724:  Hold'em No Limit ($0.05/$0.10 USD) - 2021/01/23 15:03:00 ET
Table 'Shura III' 6-max Seat #1 is the button
Seat 1: Cheetham2020 ($6.56 in chips) 
Seat 2: Manon4ik ($10 in chips) 
Seat 3: odonro ($10.08 in chips) 
Seat 4: xSkokEx ($10.15 in chips) 
Seat 5: sólyom333 ($13.49 in chips) 
Seat 6: Pokertom143 ($14.80 in chips) 
Manon4ik: posts small blind $0.05
odonro: posts big blind $0.10
*** HOLE CARDS ***
xSkokEx: raises $0.15 to $0.25
sólyom333: folds 
Pokertom143: folds 
Cheetham2020: calls $0.25
Manon4ik: calls $0.20
odonro: folds 
*** FLOP *** [Qh Kh Ad]
Manon4ik: checks 
xSkokEx: checks 
Cheetham2020: checks 
*** TURN *** [Qh Kh Ad] [4d]
Manon4ik: checks 
xSkokEx: checks 
Cheetham2020: checks 
*** RIVER *** [Qh Kh Ad 4d] [8s]
Manon4ik: checks 
xSkokEx: checks 
Cheetham2020: checks 
*** SHOW DOWN ***
Manon4ik: shows [Th Tc] (a pair of Tens)
xSkokEx: mucks hand 
Cheetham2020: shows [Td Ac] (a pair of Aces)
Cheetham2020 collected $0.81 from pot
*** SUMMARY ***
Total pot $0.85 | Rake $0.04 
Board [Qh Kh Ad 4d 8s]
Seat 1: Cheetham2020 (button) showed [Td Ac] and won ($0.81) with a pair of Aces
Seat 2: Manon4ik (small blind) showed [Th Tc] and lost with a pair of Tens
Seat 3: odonro (big blind) folded before Flop
Seat 4: xSkokEx mucked
Seat 5: sólyom333 folded before Flop (didn't bet)
Seat 6: Pokertom143 folded before Flop (didn't bet)



PokerStars Hand #222968027234:  Hold'em No Limit ($0.05/$0.10 USD) - 2021/01/23 15:04:05 ET
Table 'Shura III' 6-max Seat #2 is the button
Seat 1: Cheetham2020 ($7.12 in chips) 
Seat 2: Manon4ik ($10 in chips) 
Seat 3: odonro ($9.98 in chips) 
Seat 4: xSkokEx ($10 in chips) 
Seat 5: sólyom333 ($13.49 in chips) 
Seat 6: Pokertom143 ($14.80 in chips) 
odonro: posts small blind $0.05
xSkokEx: posts big blind $0.10
*** HOLE CARDS ***
sólyom333: folds 
Pokertom143: folds 
Cheetham2020 has timed out
Cheetham2020: folds 
Manon4ik: folds 
odonro: folds 
Uncalled bet ($0.05) returned to xSkokEx
xSkokEx collected $0.10 from pot
xSkokEx: doesn't show hand 
*** SUMMARY ***
Total pot $0.10 | Rake $0 
Seat 1: Cheetham2020 folded before Flop (didn't bet)
Seat 2: Manon4ik (button) folded before Flop (didn't bet)
Seat 3: odonro (small blind) folded before Flop
Seat 4: xSkokEx (big blind) collected ($0.10)
Seat 5: sólyom333 folded before Flop (didn't bet)
Seat 6: Pokertom143 folded before Flop (didn't bet)



PokerStars Hand #222968041581:  Hold'em No Limit ($0.05/$0.10 USD) - 2021/01/23 15:04:23 ET
Table 'Shura III' 6-max Seat #3 is the button
Seat 1: Cheetham2020 ($7.12 in chips) 
Seat 2: Manon4ik ($10 in chips) 
Seat 3: odonro ($9.93 in chips) 
Seat 4: xSkokEx ($10.05 in chips) 
Seat 5: sólyom333 ($13.49 in chips) 
Seat 6: Pokertom143 ($14.80 in chips) 
xSkokEx: posts small blind $0.05
sólyom333: posts big blind $0.10
*** HOLE CARDS ***
Pokertom143: folds 
Cheetham2020: calls $0.10
Manon4ik: raises $0.35 to $0.45
odonro: calls $0.45
xSkokEx: folds 
sólyom333: calls $0.35
Cheetham2020: calls $0.35
*** FLOP *** [4s Jd Qd]
sólyom333: checks 
Cheetham2020: checks 
Manon4ik: bets $1.30
odonro: calls $1.30
sólyom333: folds 
Cheetham2020: calls $1.30
*** TURN *** [4s Jd Qd] [9c]
Cheetham2020: checks 
Manon4ik: bets $5.40
odonro: raises $2.78 to $8.18 and is all-in
Cheetham2020: folds 
Manon4ik: calls $2.78
*** RIVER *** [4s Jd Qd 9c] [Th]
*** SHOW DOWN ***
Manon4ik: shows [Ad Ac] (a pair of Aces)
odonro: shows [9d 8d] (a straight, Eight to Queen)
odonro collected $21.12 from pot
Manon4ik cashed out the hand for $13.32 | Cash Out Fee $0.13
*** SUMMARY ***
Total pot $22.11 | Rake $0.99 
Board [4s Jd Qd 9c Th]
Seat 1: Cheetham2020 folded on the Turn
Seat 2: Manon4ik showed [Ad Ac] and lost with a pair of Aces (cashed out).
Seat 3: odonro (button) showed [9d 8d] and won ($21.12) with a straight, Eight to Queen
Seat 4: xSkokEx (small blind) folded before Flop
Seat 5: sólyom333 (big blind) folded on the Flop
Seat 6: Pokertom143 folded before Flop (didn't bet)



PokerStars Hand #222968134957:  Hold'em No Limit ($0.05/$0.10 USD) - 2021/01/23 15:06:15 ET
Table 'Shura III' 6-max Seat #4 is the button
Seat 1: Cheetham2020 ($5.37 in chips) 
Seat 2: Manon4ik ($13.39 in chips) 
Seat 3: odonro ($21.12 in chips) 
Seat 4: xSkokEx ($10 in chips) 
Seat 5: sólyom333 ($13.04 in chips) 
Seat 6: Pokertom143 ($14.80 in chips) 
sólyom333: posts small blind $0.05
Pokertom143: posts big blind $0.10
*** HOLE CARDS ***
Cheetham2020: calls $0.10
Manon4ik: folds 
odonro: folds 
xSkokEx: folds 
sólyom333: calls $0.05
Pokertom143: checks 
*** FLOP *** [Td 4c Ks]
sólyom333: checks 
Pokertom143: checks 
Cheetham2020: checks 
*** TURN *** [Td 4c Ks] [As]
sólyom333: checks 
Pokertom143: checks 
Cheetham2020: checks 
*** RIVER *** [Td 4c Ks As] [7c]
sólyom333: checks 
Pokertom143: bets $0.29
Cheetham2020: folds 
sólyom333: folds 
Uncalled bet ($0.29) returned to Pokertom143
Pokertom143 collected $0.29 from pot
*** SUMMARY ***
Total pot $0.30 | Rake $0.01 
Board [Td 4c Ks As 7c]
Seat 1: Cheetham2020 folded on the River
Seat 2: Manon4ik folded before Flop (didn't bet)
Seat 3: odonro folded before Flop (didn't bet)
Seat 4: xSkokEx (button) folded before Flop (didn't bet)
Seat 5: sólyom333 (small blind) folded on the River
Seat 6: Pokertom143 (big blind) collected ($0.29)



PokerStars Hand #222968166625:  Hold'em No Limit ($0.05/$0.10 USD) - 2021/01/23 15:06:53 ET
Table 'Shura III' 6-max Seat #5 is the button
Seat 1: Cheetham2020 ($5.27 in chips) 
Seat 2: Manon4ik ($13.39 in chips) 
Seat 3: odonro ($21.12 in chips) 
Seat 4: xSkokEx ($10 in chips) 
Seat 5: sólyom333 ($12.94 in chips) 
Seat 6: Pokertom143 ($14.99 in chips) 
Pokertom143: posts small blind $0.05
Cheetham2020: posts big blind $0.10
*** HOLE CARDS ***
Manon4ik: raises $0.15 to $0.25
odonro: calls $0.25
xSkokEx: folds 
sólyom333: calls $0.25
Pokertom143: folds 
Cheetham2020: calls $0.15
*** FLOP *** [3d 7c 7s]
Cheetham2020: bets $1
Manon4ik: folds 
odonro: folds 
sólyom333: folds 
Uncalled bet ($1) returned to Cheetham2020
Cheetham2020 collected $1 from pot
Cheetham2020: doesn't show hand 
*** SUMMARY ***
Total pot $1.05 | Rake $0.05 
Board [3d 7c 7s]
Seat 1: Cheetham2020 (big blind) collected ($1)
Seat 2: Manon4ik folded on the Flop
Seat 3: odonro folded on the Flop
Seat 4: xSkokEx folded before Flop (didn't bet)
Seat 5: sólyom333 (button) folded on the Flop
Seat 6: Pokertom143 (small blind) folded before Flop



PokerStars Hand #222968195564:  Hold'em No Limit ($0.05/$0.10 USD) - 2021/01/23 15:07:27 ET
Table 'Shura III' 6-max Seat #6 is the button
Seat 1: Cheetham2020 ($6.02 in chips) 
Seat 2: Manon4ik ($13.14 in chips) 
Seat 3: odonro ($20.87 in chips) 
Seat 4: xSkokEx ($10 in chips) 
Seat 5: sólyom333 ($12.69 in chips) 
Seat 6: Pokertom143 ($14.94 in chips) 
Cheetham2020: posts small blind $0.05
Manon4ik: posts big blind $0.10
*** HOLE CARDS ***
odonro: calls $0.10
xSkokEx: folds 
sólyom333: folds 
Pokertom143: folds 
Cheetham2020: folds 
Manon4ik: checks 
*** FLOP *** [Ac 5d 8c]
Manon4ik: checks 
odonro: bets $0.24
Manon4ik: folds 
Uncalled bet ($0.24) returned to odonro
odonro collected $0.24 from pot
odonro: doesn't show hand 
*** SUMMARY ***
Total pot $0.25 | Rake $0.01 
Board [Ac 5d 8c]
Seat 1: Cheetham2020 (small blind) folded before Flop
Seat 2: Manon4ik (big blind) folded on the Flop
Seat 3: odonro collected ($0.24)
Seat 4: xSkokEx folded before Flop (didn't bet)
Seat 5: sólyom333 folded before Flop (didn't bet)
Seat 6: Pokertom143 (button) folded before Flop (didn't bet)



PokerStars Hand #222968222255:  Hold'em No Limit ($0.05/$0.10 USD) - 2021/01/23 15:07:59 ET
Table 'Shura III' 6-max Seat #2 is the button
Seat 2: Manon4ik ($13.04 in chips) 
Seat 3: odonro ($21.01 in chips) 
Seat 4: xSkokEx ($10 in chips) 
Seat 5: sólyom333 ($12.69 in chips) 
Seat 6: Pokertom143 ($14.94 in chips) 
odonro: posts small blind $0.05
xSkokEx: posts big blind $0.10
*** HOLE CARDS ***
sólyom333: raises $0.18 to $0.28
Pokertom143: folds 
Manon4ik: folds 
odonro: folds 
xSkokEx: folds 
Uncalled bet ($0.18) returned to sólyom333
sólyom333 collected $0.25 from pot
sólyom333: doesn't show hand 
*** SUMMARY ***
Total pot $0.25 | Rake $0 
Seat 2: Manon4ik (button) folded before Flop (didn't bet)
Seat 3: odonro (small blind) folded before Flop
Seat 4: xSkokEx (big blind) folded before Flop
Seat 5: sólyom333 collected ($0.25)
Seat 6: Pokertom143 folded before Flop (didn't bet)



PokerStars Hand #222968230457:  Hold'em No Limit ($0.05/$0.10 USD) - 2021/01/23 15:08:09 ET
Table 'Shura III' 6-max Seat #3 is the button
Seat 2: Manon4ik ($13.04 in chips) 
Seat 3: odonro ($20.96 in chips) 
Seat 4: xSkokEx ($10 in chips) 
Seat 5: sólyom333 ($12.84 in chips) 
Seat 6: Pokertom143 ($14.94 in chips) 
xSkokEx: posts small blind $0.05
sólyom333: posts big blind $0.10
*** HOLE CARDS ***
Pokertom143: folds 
Manon4ik: folds 
odonro: folds 
xSkokEx: raises $0.20 to $0.30
sólyom333: folds 
Uncalled bet ($0.20) returned to xSkokEx
xSkokEx collected $0.20 from pot
xSkokEx: doesn't show hand 
*** SUMMARY ***
Total pot $0.20 | Rake $0 
Seat 2: Manon4ik folded before Flop (didn't bet)
Seat 3: odonro (button) folded before Flop (didn't bet)
Seat 4: xSkokEx (small blind) collected ($0.20)
Seat 5: sólyom333 (big blind) folded before Flop
Seat 6: Pokertom143 folded before Flop (didn't bet)



PokerStars Hand #222968252834:  Hold'em No Limit ($0.05/$0.10 USD) - 2021/01/23 15:08:36 ET
Table 'Shura III' 6-max Seat #4 is the button
Seat 2: Manon4ik ($13.04 in chips) 
Seat 3: odonro ($20.96 in chips) 
Seat 4: xSkokEx ($10.10 in chips) 
Seat 5: sólyom333 ($12.74 in chips) 
Seat 6: Pokertom143 ($14.94 in chips) 
sólyom333: posts small blind $0.05
Pokertom143: posts big blind $0.10
*** HOLE CARDS ***
Manon4ik: folds 
odonro: calls $0.10
xSkokEx: folds 
sólyom333: folds 
Pokertom143: checks 
*** FLOP *** [Kd 7c Ks]
Pokertom143: checks 
odonro: checks 
*** TURN *** [Kd 7c Ks] [2s]
Pokertom143: bets $0.24
odonro: folds 
Uncalled bet ($0.24) returned to Pokertom143
Pokertom143 collected $0.24 from pot
*** SUMMARY ***
Total pot $0.25 | Rake $0.01 
Board [Kd 7c Ks 2s]
Seat 2: Manon4ik folded before Flop (didn't bet)
Seat 3: odonro folded on the Turn
Seat 4: xSkokEx (button) folded before Flop (didn't bet)
Seat 5: sólyom333 (small blind) folded before Flop
Seat 6: Pokertom143 (big blind) collected ($0.24)



PokerStars Hand #222968274701:  Hold'em No Limit ($0.05/$0.10 USD) - 2021/01/23 15:09:02 ET
Table 'Shura III' 6-max Seat #5 is the button
Seat 2: Manon4ik ($13.04 in chips) 
Seat 3: odonro ($20.86 in chips) 
Seat 4: xSkokEx ($10.10 in chips) 
Seat 5: sólyom333 ($12.69 in chips) 
Seat 6: Pokertom143 ($15.08 in chips) 
Pokertom143: posts small blind $0.05
Manon4ik: posts big blind $0.10
*** HOLE CARDS ***
odonro: folds 
xSkokEx: folds 
sólyom333: folds 
Pokertom143: calls $0.05
Manon4ik: raises $0.30 to $0.40
Pokertom143: calls $0.30
*** FLOP *** [4c 2h 3d]
Pokertom143: checks 
Manon4ik: bets $0.50
Pokertom143: calls $0.50
*** TURN *** [4c 2h 3d] [Js]
Pokertom143: checks 
Manon4ik: bets $1.20
Pokertom143: folds 
Uncalled bet ($1.20) returned to Manon4ik
Manon4ik collected $1.72 from pot
Manon4ik: doesn't show hand 
*** SUMMARY ***
Total pot $1.80 | Rake $0.08 
Board [4c 2h 3d Js]
Seat 2: Manon4ik (big blind) collected ($1.72)
Seat 3: odonro folded before Flop (didn't bet)
Seat 4: xSkokEx folded before Flop (didn't bet)
Seat 5: sólyom333 (button) folded before Flop (didn't bet)
Seat 6: Pokertom143 (small blind) folded on the Turn



PokerStars Hand #222968331824:  Hold'em No Limit ($0.05/$0.10 USD) - 2021/01/23 15:10:10 ET
Table 'Shura III' 6-max Seat #6 is the button
Seat 2: Manon4ik ($13.86 in chips) 
Seat 3: odonro ($20.86 in chips) 
Seat 4: xSkokEx ($10.10 in chips) 
Seat 5: sólyom333 ($12.69 in chips) 
Seat 6: Pokertom143 ($14.18 in chips) 
Manon4ik: posts small blind $0.05
odonro: posts big blind $0.10
*** HOLE CARDS ***
xSkokEx: folds 
sólyom333: folds 
Pokertom143: raises $0.25 to $0.35
Manon4ik: folds 
odonro: raises $0.55 to $0.90
Pokertom143: calls $0.55
*** FLOP *** [2h 3c Ad]
odonro: bets $1.77
Pokertom143: calls $1.77
*** TURN *** [2h 3c Ad] [Kd]
odonro: bets $5.15
Pokertom143: folds 
Uncalled bet ($5.15) returned to odonro
odonro collected $5.15 from pot
odonro: doesn't show hand 
*** SUMMARY ***
Total pot $5.39 | Rake $0.24 
Board [2h 3c Ad Kd]
Seat 2: Manon4ik (small blind) folded before Flop
Seat 3: odonro (big blind) collected ($5.15)
Seat 4: xSkokEx folded before Flop (didn't bet)
Seat 5: sólyom333 folded before Flop (didn't bet)
Seat 6: Pokertom143 (button) folded on the Turn



PokerStars Hand #222968375476:  Hold'em No Limit ($0.05/$0.10 USD) - 2021/01/23 15:11:02 ET
Table 'Shura III' 6-max Seat #2 is the button
Seat 1: Cheetham2020 ($5.97 in chips) 
Seat 2: Manon4ik ($13.81 in chips) 
Seat 3: odonro ($23.34 in chips) 
Seat 4: xSkokEx ($10.10 in chips) 
Seat 5: sólyom333 ($12.69 in chips) 
Seat 6: Pokertom143 ($11.51 in chips) 
odonro: posts small blind $0.05
xSkokEx: posts big blind $0.10
Cheetham2020: posts small & big blinds $0.15
*** HOLE CARDS ***
sólyom333: folds 
Pokertom143: folds 
Cheetham2020: checks 
Manon4ik: folds 
odonro: folds 
xSkokEx: checks 
*** FLOP *** [4s Td Th]
xSkokEx: checks 
Cheetham2020: checks 
*** TURN *** [4s Td Th] [3s]
xSkokEx: checks 
Cheetham2020: checks 
*** RIVER *** [4s Td Th 3s] [4d]
xSkokEx: checks 
Cheetham2020: bets $0.10
xSkokEx: folds 
Uncalled bet ($0.10) returned to Cheetham2020
Cheetham2020 collected $0.29 from pot
Cheetham2020: doesn't show hand 
*** SUMMARY ***
Total pot $0.30 | Rake $0.01 
Board [4s Td Th 3s 4d]
Seat 1: Cheetham2020 collected ($0.29)
Seat 2: Manon4ik (button) folded before Flop (didn't bet)
Seat 3: odonro (small blind) folded before Flop
Seat 4: xSkokEx (big blind) folded on the River
Seat 5: sólyom333 folded before Flop (didn't bet)
Seat 6: Pokertom143 folded before Flop (didn't bet)



PokerStars Hand #222968412865:  Hold'em No Limit ($0.05/$0.10 USD) - 2021/01/23 15:11:46 ET
Table 'Shura III' 6-max Seat #3 is the button
Seat 1: Cheetham2020 ($6.11 in chips) 
Seat 2: Manon4ik ($13.81 in chips) 
Seat 3: odonro ($23.29 in chips) 
Seat 4: xSkokEx ($10 in chips) 
Seat 5: sólyom333 ($12.69 in chips) 
Seat 6: Pokertom143 ($11.51 in chips) 
xSkokEx: posts small blind $0.05
sólyom333: posts big blind $0.10
*** HOLE CARDS ***
Pokertom143: folds 
Cheetham2020: calls $0.10
Manon4ik: folds 
odonro: calls $0.10
xSkokEx: raises $0.40 to $0.50
sólyom333: calls $0.40
Cheetham2020: calls $0.40
odonro: calls $0.40
*** FLOP *** [7c Jd 3s]
xSkokEx: checks 
sólyom333: bets $0.80
Cheetham2020 has timed out
Cheetham2020: folds 
odonro: folds 
xSkokEx: folds 
Uncalled bet ($0.80) returned to sólyom333
sólyom333 collected $1.91 from pot
sólyom333: doesn't show hand 
*** SUMMARY ***
Total pot $2 | Rake $0.09 
Board [7c Jd 3s]
Seat 1: Cheetham2020 folded on the Flop
Seat 2: Manon4ik folded before Flop (didn't bet)
Seat 3: odonro (button) folded on the Flop
Seat 4: xSkokEx (small blind) folded on the Flop
Seat 5: sólyom333 (big blind) collected ($1.91)
Seat 6: Pokertom143 folded before Flop (didn't bet)



PokerStars Hand #222968470709:  Hold'em No Limit ($0.05/$0.10 USD) - 2021/01/23 15:12:47 ET
Table 'Shura III' 6-max Seat #4 is the button
Seat 1: Cheetham2020 ($5.61 in chips) 
Seat 2: Manon4ik ($13.81 in chips) 
Seat 3: odonro ($22.79 in chips) 
Seat 4: xSkokEx ($10 in chips) 
Seat 5: sólyom333 ($14.10 in chips) 
Seat 6: Pokertom143 ($11.51 in chips) 
sólyom333: posts small blind $0.05
Pokertom143: posts big blind $0.10
*** HOLE CARDS ***
Cheetham2020 has timed out
Cheetham2020: folds 
Manon4ik: folds 
odonro: folds 
xSkokEx: raises $0.10 to $0.20
sólyom333: folds 
Pokertom143: calls $0.10
*** FLOP *** [Js Ad 6s]
Pokertom143: checks 
xSkokEx: bets $0.22
Pokertom143: calls $0.22
*** TURN *** [Js Ad 6s] [6h]
Pokertom143: checks 
xSkokEx: bets $0.57
Pokertom143: calls $0.57
*** RIVER *** [Js Ad 6s 6h] [4h]
Pokertom143: bets $2
xSkokEx: folds 
Uncalled bet ($2) returned to Pokertom143
Pokertom143 collected $1.94 from pot
*** SUMMARY ***
Total pot $2.03 | Rake $0.09 
Board [Js Ad 6s 6h 4h]
Seat 1: Cheetham2020 folded before Flop (didn't bet)
Seat 2: Manon4ik folded before Flop (didn't bet)
Seat 3: odonro folded before Flop (didn't bet)
Seat 4: xSkokEx (button) folded on the River
Seat 5: sólyom333 (small blind) folded before Flop
Seat 6: Pokertom143 (big blind) collected ($1.94)



PokerStars Hand #222968512144:  Hold'em No Limit ($0.05/$0.10 USD) - 2021/01/23 15:13:36 ET
Table 'Shura III' 6-max Seat #5 is the button
Seat 1: Cheetham2020 ($5.61 in chips) 
Seat 2: Manon4ik ($13.81 in chips) 
Seat 3: odonro ($22.79 in chips) 
Seat 4: xSkokEx ($10 in chips) 
Seat 5: sólyom333 ($14.05 in chips) 
Seat 6: Pokertom143 ($12.46 in chips) 
Pokertom143: posts small blind $0.05
Cheetham2020: posts big blind $0.10
*** HOLE CARDS ***
Manon4ik has timed out
Manon4ik: folds 
odonro: calls $0.10
xSkokEx: folds 
sólyom333: raises $0.18 to $0.28
Pokertom143: calls $0.23
Cheetham2020: calls $0.18
odonro: calls $0.18
*** FLOP *** [5s 2c 9c]
Pokertom143: checks 
Cheetham2020: checks 
odonro: checks 
sólyom333: checks 
*** TURN *** [5s 2c 9c] [Ad]
Pokertom143: checks 
Cheetham2020: checks 
odonro: checks 
sólyom333: checks 
*** RIVER *** [5s 2c 9c Ad] [2s]
Pokertom143: checks 
Cheetham2020: checks 
odonro: checks 
sólyom333: bets $0.45
Pokertom143: calls $0.45
Cheetham2020 has timed out
Cheetham2020: folds 
odonro: folds 
*** SHOW DOWN ***
sólyom333: shows [8c Ah] (two pair, Aces and Deuces)
Pokertom143: mucks hand 
sólyom333 collected $1.93 from pot
*** SUMMARY ***
Total pot $2.02 | Rake $0.09 
Board [5s 2c 9c Ad 2s]
Seat 1: Cheetham2020 (big blind) folded on the River
Seat 2: Manon4ik folded before Flop (didn't bet)
Seat 3: odonro folded on the River
Seat 4: xSkokEx folded before Flop (didn't bet)
Seat 5: sólyom333 (button) showed [8c Ah] and won ($1.93) with two pair, Aces and Deuces
Seat 6: Pokertom143 (small blind) mucked



PokerStars Hand #222968603620:  Hold'em No Limit ($0.05/$0.10 USD) - 2021/01/23 15:15:25 ET
Table 'Shura III' 6-max Seat #6 is the button
Seat 1: Cheetham2020 ($5.33 in chips) 
Seat 2: Manon4ik ($13.81 in chips) 
Seat 3: odonro ($22.51 in chips) 
Seat 4: xSkokEx ($10 in chips) 
Seat 5: sólyom333 ($15.25 in chips) 
Seat 6: Pokertom143 ($11.73 in chips) 
Cheetham2020: posts small blind $0.05
Manon4ik: posts big blind $0.10
*** HOLE CARDS ***
odonro has timed out
odonro: folds 
xSkokEx: folds 
sólyom333: folds 
Pokertom143: folds 
Cheetham2020: calls $0.05
Manon4ik: checks 
*** FLOP *** [2c 5c 3c]
Cheetham2020: checks 
Manon4ik: checks 
*** TURN *** [2c 5c 3c] [Jd]
Cheetham2020: checks 
Manon4ik: checks 
*** RIVER *** [2c 5c 3c Jd] [Ah]
Cheetham2020: checks 
Manon4ik: checks 
*** SHOW DOWN ***
Cheetham2020: shows [4s 7d] (a straight, Ace to Five)
Manon4ik: mucks hand 
Cheetham2020 collected $0.19 from pot
*** SUMMARY ***
Total pot $0.20 | Rake $0.01 
Board [2c 5c 3c Jd Ah]
Seat 1: Cheetham2020 (small blind) showed [4s 7d] and won ($0.19) with a straight, Ace to Five
Seat 2: Manon4ik (big blind) mucked
Seat 3: odonro folded before Flop (didn't bet)
Seat 4: xSkokEx folded before Flop (didn't bet)
Seat 5: sólyom333 folded before Flop (didn't bet)
Seat 6: Pokertom143 (button) folded before Flop (didn't bet)



PokerStars Hand #222968674606:  Hold'em No Limit ($0.05/$0.10 USD) - 2021/01/23 15:16:48 ET
Table 'Shura III' 6-max Seat #1 is the button
Seat 1: Cheetham2020 ($5.42 in chips) 
Seat 2: Manon4ik ($13.71 in chips) 
Seat 3: odonro ($22.51 in chips) 
Seat 4: xSkokEx ($10 in chips) 
Seat 5: sólyom333 ($15.25 in chips) 
Seat 6: Pokertom143 ($11.73 in chips) 
Manon4ik: posts small blind $0.05
odonro: posts big blind $0.10
*** HOLE CARDS ***
xSkokEx: folds 
sólyom333: folds 
Pokertom143: folds 
Cheetham2020 has timed out
Cheetham2020: folds 
Manon4ik: folds 
Uncalled bet ($0.05) returned to odonro
odonro collected $0.10 from pot
odonro: doesn't show hand 
*** SUMMARY ***
Total pot $0.10 | Rake $0 
Seat 1: Cheetham2020 (button) folded before Flop (didn't bet)
Seat 2: Manon4ik (small blind) folded before Flop
Seat 3: odonro (big blind) collected ($0.10)
Seat 4: xSkokEx folded before Flop (didn't bet)
Seat 5: sólyom333 folded before Flop (didn't bet)
Seat 6: Pokertom143 folded before Flop (didn't bet)



PokerStars Hand #222968692820:  Hold'em No Limit ($0.05/$0.10 USD) - 2021/01/23 15:17:10 ET
Table 'Shura III' 6-max Seat #2 is the button
Seat 2: Manon4ik ($13.66 in chips) 
Seat 3: odonro ($22.56 in chips) 
Seat 4: xSkokEx ($10 in chips) 
Seat 5: sólyom333 ($15.25 in chips) 
Seat 6: Pokertom143 ($11.73 in chips) 
odonro: posts small blind $0.05
xSkokEx: posts big blind $0.10
*** HOLE CARDS ***
sólyom333: folds 
Pokertom143: folds 
Manon4ik: folds 
odonro: folds 
Uncalled bet ($0.05) returned to xSkokEx
xSkokEx collected $0.10 from pot
xSkokEx: doesn't show hand 
*** SUMMARY ***
Total pot $0.10 | Rake $0 
Seat 2: Manon4ik (button) folded before Flop (didn't bet)
Seat 3: odonro (small blind) folded before Flop
Seat 4: xSkokEx (big blind) collected ($0.10)
Seat 5: sólyom333 folded before Flop (didn't bet)
Seat 6: Pokertom143 folded before Flop (didn't bet)



PokerStars Hand #222968700439:  Hold'em No Limit ($0.05/$0.10 USD) - 2021/01/23 15:17:19 ET
Table 'Shura III' 6-max Seat #3 is the button
Seat 2: Manon4ik ($13.66 in chips) 
Seat 3: odonro ($22.51 in chips) 
Seat 4: xSkokEx ($10.05 in chips) 
Seat 5: sólyom333 ($15.25 in chips) 
Seat 6: Pokertom143 ($11.73 in chips) 
xSkokEx: posts small blind $0.05
sólyom333: posts big blind $0.10
*** HOLE CARDS ***
Pokertom143: folds 
Manon4ik: folds 
odonro: folds 
xSkokEx: folds 
Uncalled bet ($0.05) returned to sólyom333
sólyom333 collected $0.10 from pot
sólyom333: doesn't show hand 
*** SUMMARY ***
Total pot $0.10 | Rake $0 
Seat 2: Manon4ik folded before Flop (didn't bet)
Seat 3: odonro (button) folded before Flop (didn't bet)
Seat 4: xSkokEx (small blind) folded before Flop
Seat 5: sólyom333 (big blind) collected ($0.10)
Seat 6: Pokertom143 folded before Flop (didn't bet)



PokerStars Hand #222968712423:  Hold'em No Limit ($0.05/$0.10 USD) - 2021/01/23 15:17:32 ET
Table 'Shura III' 6-max Seat #4 is the button
Seat 1: Cheetham2020 ($5.42 in chips) 
Seat 2: Manon4ik ($13.66 in chips) 
Seat 3: odonro ($22.51 in chips) 
Seat 4: xSkokEx ($10 in chips) 
Seat 5: sólyom333 ($15.30 in chips) 
Seat 6: Pokertom143 ($11.73 in chips) 
sólyom333: posts small blind $0.05
Pokertom143: posts big blind $0.10
*** HOLE CARDS ***
Cheetham2020: raises $0.10 to $0.20
Manon4ik: folds 
odonro: folds 
xSkokEx: folds 
sólyom333: folds 
Pokertom143: calls $0.10
*** FLOP *** [5h 4s 8d]
Pokertom143: checks 
Cheetham2020: checks 
*** TURN *** [5h 4s 8d] [2c]
Pokertom143: bets $0.43
Cheetham2020: calls $0.43
*** RIVER *** [5h 4s 8d 2c] [Qs]
Pokertom143: bets $0.63
Cheetham2020 has timed out
Cheetham2020: folds 
Uncalled bet ($0.63) returned to Pokertom143
Pokertom143 collected $1.25 from pot
*** SUMMARY ***
Total pot $1.31 | Rake $0.06 
Board [5h 4s 8d 2c Qs]
Seat 1: Cheetham2020 folded on the River
Seat 2: Manon4ik folded before Flop (didn't bet)
Seat 3: odonro folded before Flop (didn't bet)
Seat 4: xSkokEx (button) folded before Flop (didn't bet)
Seat 5: sólyom333 (small blind) folded before Flop
Seat 6: Pokertom143 (big blind) collected ($1.25)



PokerStars Hand #222968767334:  Hold'em No Limit ($0.05/$0.10 USD) - 2021/01/23 15:18:37 ET
Table 'Shura III' 6-max Seat #5 is the button
Seat 1: Cheetham2020 ($4.79 in chips) 
Seat 2: Manon4ik ($13.66 in chips) 
Seat 3: odonro ($22.51 in chips) 
Seat 4: xSkokEx ($10 in chips) 
Seat 5: sólyom333 ($15.25 in chips) 
Seat 6: Pokertom143 ($12.35 in chips) 
Pokertom143: posts small blind $0.05
Cheetham2020: posts big blind $0.10
*** HOLE CARDS ***
Manon4ik: folds 
odonro: folds 
xSkokEx: raises $0.15 to $0.25
sólyom333: folds 
Pokertom143: calls $0.20
Cheetham2020: folds 
*** FLOP *** [Ts 4h 4d]
Pokertom143: checks 
xSkokEx: bets $0.19
Pokertom143: raises $0.51 to $0.70
xSkokEx: folds 
Uncalled bet ($0.51) returned to Pokertom143
Pokertom143 collected $0.94 from pot
*** SUMMARY ***
Total pot $0.98 | Rake $0.04 
Board [Ts 4h 4d]
Seat 1: Cheetham2020 (big blind) folded before Flop
Seat 2: Manon4ik folded before Flop (didn't bet)
Seat 3: odonro folded before Flop (didn't bet)
Seat 4: xSkokEx folded on the Flop
Seat 5: sólyom333 (button) folded before Flop (didn't bet)
Seat 6: Pokertom143 (small blind) collected ($0.94)



PokerStars Hand #222968809224:  Hold'em No Limit ($0.05/$0.10 USD) - 2021/01/23 15:19:26 ET
Table 'Shura III' 6-max Seat #6 is the button
Seat 1: Cheetham2020 ($4.69 in chips) 
Seat 2: Manon4ik ($13.66 in chips) 
Seat 3: odonro ($22.51 in chips) 
Seat 4: xSkokEx ($10 in chips) 
Seat 5: sólyom333 ($15.25 in chips) 
Seat 6: Pokertom143 ($12.85 in chips) 
Cheetham2020: posts small blind $0.05
Manon4ik: posts big blind $0.10
*** HOLE CARDS ***
odonro: folds 
xSkokEx: raises $0.20 to $0.30
sólyom333: folds 
Pokertom143: folds 
Cheetham2020: raises $0.20 to $0.50
Manon4ik: folds 
xSkokEx: raises $9.50 to $10 and is all-in
Cheetham2020: calls $4.19 and is all-in
Uncalled bet ($5.31) returned to xSkokEx
*** FLOP *** [9h 6h 4s]
*** TURN *** [9h 6h 4s] [4c]
*** RIVER *** [9h 6h 4s 4c] [Th]
*** SHOW DOWN ***
Cheetham2020: shows [Kh 7h] (a flush, King high)
xSkokEx: shows [Ks Ah] (a pair of Fours)
Cheetham2020 collected $9.05 from pot
*** SUMMARY ***
Total pot $9.48 | Rake $0.43 
Board [9h 6h 4s 4c Th]
Seat 1: Cheetham2020 (small blind) showed [Kh 7h] and won ($9.05) with a flush, King high
Seat 2: Manon4ik (big blind) folded before Flop
Seat 3: odonro folded before Flop (didn't bet)
Seat 4: xSkokEx showed [Ks Ah] and lost with a pair of Fours
Seat 5: sólyom333 folded before Flop (didn't bet)
Seat 6: Pokertom143 (button) folded before Flop (didn't bet)



PokerStars Hand #222968843948:  Hold'em No Limit ($0.05/$0.10 USD) - 2021/01/23 15:20:07 ET
Table 'Shura III' 6-max Seat #1 is the button
Seat 1: Cheetham2020 ($9.05 in chips) 
Seat 2: Manon4ik ($13.56 in chips) 
Seat 3: odonro ($22.51 in chips) 
Seat 4: xSkokEx ($10 in chips) 
Seat 5: sólyom333 ($15.25 in chips) 
Seat 6: Pokertom143 ($12.85 in chips) 
Manon4ik: posts small blind $0.05
odonro: posts big blind $0.10
*** HOLE CARDS ***
xSkokEx: raises $0.15 to $0.25
sólyom333: folds 
Pokertom143: folds 
Cheetham2020: folds 
Manon4ik: folds 
odonro: calls $0.15
*** FLOP *** [8c Ah Ks]
odonro: checks 
xSkokEx: bets $0.27
odonro: calls $0.27
*** TURN *** [8c Ah Ks] [4s]
odonro: checks 
xSkokEx: checks 
*** RIVER *** [8c Ah Ks 4s] [7c]
odonro: bets $1.04
xSkokEx: folds 
Uncalled bet ($1.04) returned to odonro
odonro collected $1.04 from pot
odonro: doesn't show hand 
*** SUMMARY ***
Total pot $1.09 | Rake $0.05 
Board [8c Ah Ks 4s 7c]
Seat 1: Cheetham2020 (button) folded before Flop (didn't bet)
Seat 2: Manon4ik (small blind) folded before Flop
Seat 3: odonro (big blind) collected ($1.04)
Seat 4: xSkokEx folded on the River
Seat 5: sólyom333 folded before Flop (didn't bet)
Seat 6: Pokertom143 folded before Flop (didn't bet)



PokerStars Hand #222968887874:  Hold'em No Limit ($0.05/$0.10 USD) - 2021/01/23 15:20:58 ET
Table 'Shura III' 6-max Seat #2 is the button
Seat 1: Cheetham2020 ($9.05 in chips) 
Seat 2: Manon4ik ($13.51 in chips) 
Seat 3: odonro ($23.03 in chips) 
Seat 4: xSkokEx ($10 in chips) 
Seat 5: sólyom333 ($15.25 in chips) 
Seat 6: Pokertom143 ($12.85 in chips) 
odonro: posts small blind $0.05
xSkokEx: posts big blind $0.10
*** HOLE CARDS ***
sólyom333: folds 
Pokertom143: raises $0.20 to $0.30
Cheetham2020: calls $0.30
Manon4ik: calls $0.30
odonro: folds 
xSkokEx: folds 
*** FLOP *** [5d 8s Qc]
Pokertom143: bets $0.50
Cheetham2020: folds 
Manon4ik: calls $0.50
*** TURN *** [5d 8s Qc] [4s]
Pokertom143: bets $1
Manon4ik: folds 
Uncalled bet ($1) returned to Pokertom143
Pokertom143 collected $1.96 from pot
*** SUMMARY ***
Total pot $2.05 | Rake $0.09 
Board [5d 8s Qc 4s]
Seat 1: Cheetham2020 folded on the Flop
Seat 2: Manon4ik (button) folded on the Turn
Seat 3: odonro (small blind) folded before Flop
Seat 4: xSkokEx (big blind) folded before Flop
Seat 5: sólyom333 folded before Flop (didn't bet)
Seat 6: Pokertom143 collected ($1.96)



PokerStars Hand #222968961570:  Hold'em No Limit ($0.05/$0.10 USD) - 2021/01/23 15:22:23 ET
Table 'Shura III' 6-max Seat #4 is the button
Seat 1: Cheetham2020 ($8.75 in chips) 
Seat 2: Manon4ik ($12.71 in chips) 
Seat 4: xSkokEx ($10 in chips) 
Seat 5: sólyom333 ($15.25 in chips) 
sólyom333: posts small blind $0.05
Pokertom143: is sitting out 
Cheetham2020: posts big blind $0.10
*** HOLE CARDS ***
Manon4ik: folds 
xSkokEx: raises $0.20 to $0.30
sólyom333: folds 
Cheetham2020: calls $0.20
*** FLOP *** [Jh Kd Qc]
Pokertom143 leaves the table
Cheetham2020: checks 
xSkokEx: bets $0.31
maltsevig joins the table at seat #6 
Cheetham2020: folds 
Uncalled bet ($0.31) returned to xSkokEx
xSkokEx collected $0.62 from pot
xSkokEx: doesn't show hand 
*** SUMMARY ***
Total pot $0.65 | Rake $0.03 
Board [Jh Kd Qc]
Seat 1: Cheetham2020 (big blind) folded on the Flop
Seat 2: Manon4ik folded before Flop (didn't bet)
Seat 4: xSkokEx (button) collected ($0.62)
Seat 5: sólyom333 (small blind) folded before Flop



PokerStars Hand #222968982693:  Hold'em No Limit ($0.05/$0.10 USD) - 2021/01/23 15:22:47 ET
Table 'Shura III' 6-max Seat #5 is the button
Seat 1: Cheetham2020 ($8.45 in chips) 
Seat 2: Manon4ik ($12.71 in chips) 
Seat 4: xSkokEx ($10.32 in chips) 
Seat 5: sólyom333 ($15.20 in chips) 
Cheetham2020: posts small blind $0.05
Manon4ik: posts big blind $0.10
*** HOLE CARDS ***
xSkokEx: folds 
odonro is disconnected 
sólyom333: folds 
Cheetham2020: calls $0.05
Manon4ik: checks 
*** FLOP *** [9c 4h Jc]
Cheetham2020: checks 
Manon4ik: checks 
*** TURN *** [9c 4h Jc] [Jh]
Cheetham2020 has timed out
Cheetham2020: checks 
Manon4ik: checks 
*** RIVER *** [9c 4h Jc Jh] [Td]
Cheetham2020: checks 
Manon4ik: checks 
*** SHOW DOWN ***
Cheetham2020: shows [6h Qd] (a pair of Jacks)
Manon4ik: mucks hand 
Cheetham2020 collected $0.19 from pot
*** SUMMARY ***
Total pot $0.20 | Rake $0.01 
Board [9c 4h Jc Jh Td]
Seat 1: Cheetham2020 (small blind) showed [6h Qd] and won ($0.19) with a pair of Jacks
Seat 2: Manon4ik (big blind) mucked
Seat 4: xSkokEx folded before Flop (didn't bet)
Seat 5: sólyom333 (button) folded before Flop (didn't bet)



PokerStars Hand #222969043030:  Hold'em No Limit ($0.05/$0.10 USD) - 2021/01/23 15:23:57 ET
Table 'Shura III' 6-max Seat #1 is the button
Seat 1: Cheetham2020 ($8.54 in chips) 
Seat 2: Manon4ik ($12.61 in chips) 
Seat 3: odonro ($22.98 in chips) 
Seat 4: xSkokEx ($10.32 in chips) 
Seat 5: sólyom333 ($15.20 in chips) 
Manon4ik: posts small blind $0.05
odonro: posts big blind $0.10
maltsevig: sits out 
*** HOLE CARDS ***
xSkokEx: raises $0.15 to $0.25
sólyom333: calls $0.25
Cheetham2020 has timed out
Cheetham2020: folds 
Manon4ik: folds 
odonro: folds 
*** FLOP *** [2c 4s Jd]
xSkokEx: bets $0.31
sólyom333: calls $0.31
*** TURN *** [2c 4s Jd] [Qs]
xSkokEx: bets $0.61
sólyom333: folds 
Uncalled bet ($0.61) returned to xSkokEx
xSkokEx collected $1.21 from pot
xSkokEx: doesn't show hand 
*** SUMMARY ***
Total pot $1.27 | Rake $0.06 
Board [2c 4s Jd Qs]
Seat 1: Cheetham2020 (button) folded before Flop (didn't bet)
Seat 2: Manon4ik (small blind) folded before Flop
Seat 3: odonro (big blind) folded before Flop
Seat 4: xSkokEx collected ($1.21)
Seat 5: sólyom333 folded on the Turn



PokerStars Hand #222969081563:  Hold'em No Limit ($0.05/$0.10 USD) - 2021/01/23 15:24:42 ET
Table 'Shura III' 6-max Seat #2 is the button
Seat 1: Cheetham2020 ($8.54 in chips) 
Seat 2: Manon4ik ($12.56 in chips) 
Seat 3: odonro ($22.88 in chips) 
Seat 4: xSkokEx ($10.97 in chips) 
Seat 5: sólyom333 ($14.64 in chips) 
odonro: posts small blind $0.05
xSkokEx: posts big blind $0.10
maltsevig: sits out 
*** HOLE CARDS ***
sólyom333: folds 
Cheetham2020 has timed out
Cheetham2020: folds 
Manon4ik: raises $0.15 to $0.25
odonro: calls $0.20
xSkokEx: folds 
*** FLOP *** [Kd 2c 8d]
odonro: checks 
Manon4ik: checks 
*** TURN *** [Kd 2c 8d] [7d]
odonro: checks 
Manon4ik: checks 
*** RIVER *** [Kd 2c 8d 7d] [Ad]
odonro: checks 
Manon4ik: checks 
*** SHOW DOWN ***
odonro: shows [Tc 6c] (high card Ace)
Manon4ik: shows [Ac 5s] (a pair of Aces)
Manon4ik collected $0.57 from pot
*** SUMMARY ***
Total pot $0.60 | Rake $0.03 
Board [Kd 2c 8d 7d Ad]
Seat 1: Cheetham2020 folded before Flop (didn't bet)
Seat 2: Manon4ik (button) showed [Ac 5s] and won ($0.57) with a pair of Aces
Seat 3: odonro (small blind) showed [Tc 6c] and lost with high card Ace
Seat 4: xSkokEx (big blind) folded before Flop
Seat 5: sólyom333 folded before Flop (didn't bet)



PokerStars Hand #222969124033:  Hold'em No Limit ($0.05/$0.10 USD) - 2021/01/23 15:25:32 ET
Table 'Shura III' 6-max Seat #3 is the button
Seat 2: Manon4ik ($12.88 in chips) 
Seat 3: odonro ($22.63 in chips) 
Seat 4: xSkokEx ($10.87 in chips) 
Seat 5: sólyom333 ($14.64 in chips) 
xSkokEx: posts small blind $0.05
sólyom333: posts big blind $0.10
maltsevig: sits out 
*** HOLE CARDS ***
Manon4ik: raises $0.15 to $0.25
odonro: folds 
xSkokEx: folds 
sólyom333: folds 
Uncalled bet ($0.15) returned to Manon4ik
Manon4ik collected $0.25 from pot
Manon4ik: doesn't show hand 
*** SUMMARY ***
Total pot $0.25 | Rake $0 
Seat 2: Manon4ik collected ($0.25)
Seat 3: odonro (button) folded before Flop (didn't bet)
Seat 4: xSkokEx (small blind) folded before Flop
Seat 5: sólyom333 (big blind) folded before Flop



PokerStars Hand #222969134991:  Hold'em No Limit ($0.05/$0.10 USD) - 2021/01/23 15:25:44 ET
Table 'Shura III' 6-max Seat #4 is the button
Seat 2: Manon4ik ($13.03 in chips) 
Seat 3: odonro ($22.63 in chips) 
Seat 4: xSkokEx ($10.82 in chips) 
Seat 5: sólyom333 ($14.54 in chips) 
Seat 6: maltsevig ($10 in chips) 
sólyom333: posts small blind $0.05
maltsevig: posts big blind $0.10
*** HOLE CARDS ***
Manon4ik: folds 
odonro: raises $0.10 to $0.20
xSkokEx: calls $0.20
sólyom333: folds 
maltsevig: calls $0.10
*** FLOP *** [3s 9h 7d]
maltsevig: checks 
odonro: bets $0.62
xSkokEx: folds 
maltsevig: folds 
Uncalled bet ($0.62) returned to odonro
odonro collected $0.62 from pot
odonro: doesn't show hand 
*** SUMMARY ***
Total pot $0.65 | Rake $0.03 
Board [3s 9h 7d]
Seat 2: Manon4ik folded before Flop (didn't bet)
Seat 3: odonro collected ($0.62)
Seat 4: xSkokEx (button) folded on the Flop
Seat 5: sólyom333 (small blind) folded before Flop
Seat 6: maltsevig (big blind) folded on the Flop



PokerStars Hand #222969161995:  Hold'em No Limit ($0.05/$0.10 USD) - 2021/01/23 15:26:16 ET
Table 'Shura III' 6-max Seat #5 is the button
Seat 2: Manon4ik ($13.03 in chips) 
Seat 3: odonro ($23.05 in chips) 
Seat 4: xSkokEx ($10.62 in chips) 
Seat 5: sólyom333 ($14.49 in chips) 
Seat 6: maltsevig ($10 in chips) 
maltsevig: posts small blind $0.05
Manon4ik: posts big blind $0.10
*** HOLE CARDS ***
odonro: calls $0.10
xSkokEx: folds 
sólyom333: raises $0.18 to $0.28
maltsevig: folds 
Manon4ik: folds 
odonro: calls $0.18
*** FLOP *** [6d 3h Jc]
odonro: checks 
sólyom333: bets $0.29
odonro: folds 
Uncalled bet ($0.29) returned to sólyom333
sólyom333 collected $0.68 from pot
sólyom333: doesn't show hand 
*** SUMMARY ***
Total pot $0.71 | Rake $0.03 
Board [6d 3h Jc]
Seat 2: Manon4ik (big blind) folded before Flop
Seat 3: odonro folded on the Flop
Seat 4: xSkokEx folded before Flop (didn't bet)
Seat 5: sólyom333 (button) collected ($0.68)
Seat 6: maltsevig (small blind) folded before Flop



PokerStars Hand #222969199250:  Hold'em No Limit ($0.05/$0.10 USD) - 2021/01/23 15:27:00 ET
Table 'Shura III' 6-max Seat #6 is the button
Seat 2: Manon4ik ($12.93 in chips) 
Seat 3: odonro ($22.77 in chips) 
Seat 4: xSkokEx ($10.62 in chips) 
Seat 5: sólyom333 ($14.89 in chips) 
Seat 6: maltsevig ($10 in chips) 
Manon4ik: posts small blind $0.05
odonro: posts big blind $0.10
*** HOLE CARDS ***
xSkokEx: raises $0.15 to $0.25
sólyom333: folds 
maltsevig: folds 
Manon4ik: folds 
odonro: folds 
Uncalled bet ($0.15) returned to xSkokEx
xSkokEx collected $0.25 from pot
xSkokEx: doesn't show hand 
*** SUMMARY ***
Total pot $0.25 | Rake $0 
Seat 2: Manon4ik (small blind) folded before Flop
Seat 3: odonro (big blind) folded before Flop
Seat 4: xSkokEx collected ($0.25)
Seat 5: sólyom333 folded before Flop (didn't bet)
Seat 6: maltsevig (button) folded before Flop (didn't bet)



PokerStars Hand #222969209040:  Hold'em No Limit ($0.05/$0.10 USD) - 2021/01/23 15:27:11 ET
Table 'Shura III' 6-max Seat #2 is the button
Seat 1: Cheetham2020 ($8.54 in chips) 
Seat 2: Manon4ik ($12.88 in chips) 
Seat 3: odonro ($22.67 in chips) 
Seat 4: xSkokEx ($10.77 in chips) 
Seat 5: sólyom333 ($14.89 in chips) 
Seat 6: maltsevig ($10 in chips) 
odonro: posts small blind $0.05
xSkokEx: posts big blind $0.10
Cheetham2020: posts small & big blinds $0.15
*** HOLE CARDS ***
sólyom333: folds 
maltsevig: folds 
Cheetham2020: raises $0.10 to $0.20
Manon4ik: folds 
odonro: folds 
xSkokEx: raises $0.50 to $0.70
Cheetham2020: calls $0.50
*** FLOP *** [3h 9c Td]
xSkokEx: bets $0.47
Cheetham2020: calls $0.47
*** TURN *** [3h 9c Td] [Qh]
xSkokEx: bets $1.56
Cheetham2020 has timed out
Cheetham2020: folds 
Uncalled bet ($1.56) returned to xSkokEx
xSkokEx collected $2.33 from pot
xSkokEx: doesn't show hand 
*** SUMMARY ***
Total pot $2.44 | Rake $0.11 
Board [3h 9c Td Qh]
Seat 1: Cheetham2020 folded on the Turn
Seat 2: Manon4ik (button) folded before Flop (didn't bet)
Seat 3: odonro (small blind) folded before Flop
Seat 4: xSkokEx (big blind) collected ($2.33)
Seat 5: sólyom333 folded before Flop (didn't bet)
Seat 6: maltsevig folded before Flop (didn't bet)



PokerStars Hand #222969275872:  Hold'em No Limit ($0.05/$0.10 USD) - 2021/01/23 15:28:29 ET
Table 'Shura III' 6-max Seat #3 is the button
Seat 2: Manon4ik ($12.88 in chips) 
Seat 3: odonro ($22.62 in chips) 
Seat 4: xSkokEx ($11.93 in chips) 
Seat 5: sólyom333 ($14.89 in chips) 
Seat 6: maltsevig ($10 in chips) 
xSkokEx: posts small blind $0.05
sólyom333: posts big blind $0.10
*** HOLE CARDS ***
maltsevig: folds 
Manon4ik: folds 
odonro: folds 
xSkokEx: folds 
Uncalled bet ($0.05) returned to sólyom333
sólyom333 collected $0.10 from pot
sólyom333: doesn't show hand 
*** SUMMARY ***
Total pot $0.10 | Rake $0 
Seat 2: Manon4ik folded before Flop (didn't bet)
Seat 3: odonro (button) folded before Flop (didn't bet)
Seat 4: xSkokEx (small blind) folded before Flop
Seat 5: sólyom333 (big blind) collected ($0.10)
Seat 6: maltsevig folded before Flop (didn't bet)



PokerStars Hand #222969284399:  Hold'em No Limit ($0.05/$0.10 USD) - 2021/01/23 15:28:39 ET
Table 'Shura III' 6-max Seat #4 is the button
Seat 1: Cheetham2020 ($7.32 in chips) 
Seat 2: Manon4ik ($12.88 in chips) 
Seat 3: odonro ($22.62 in chips) 
Seat 4: xSkokEx ($11.88 in chips) 
Seat 5: sólyom333 ($14.94 in chips) 
Seat 6: maltsevig ($10 in chips) 
sólyom333: posts small blind $0.05
maltsevig: posts big blind $0.10
*** HOLE CARDS ***
Cheetham2020: calls $0.10
Manon4ik: folds 
odonro has timed out
odonro: folds 
xSkokEx: raises $0.30 to $0.40
sólyom333: folds 
maltsevig: folds 
Cheetham2020: calls $0.30
*** FLOP *** [6s 7s 9c]
Cheetham2020: checks 
xSkokEx: bets $0.30
Cheetham2020 has timed out
Cheetham2020: folds 
Uncalled bet ($0.30) returned to xSkokEx
xSkokEx collected $0.91 from pot
xSkokEx: doesn't show hand 
*** SUMMARY ***
Total pot $0.95 | Rake $0.04 
Board [6s 7s 9c]
Seat 1: Cheetham2020 folded on the Flop
Seat 2: Manon4ik folded before Flop (didn't bet)
Seat 3: odonro folded before Flop (didn't bet)
Seat 4: xSkokEx (button) collected ($0.91)
Seat 5: sólyom333 (small blind) folded before Flop
Seat 6: maltsevig (big blind) folded before Flop



PokerStars Hand #222969337235:  Hold'em No Limit ($0.05/$0.10 USD) - 2021/01/23 15:29:40 ET
Table 'Shura III' 6-max Seat #5 is the button
Seat 2: Manon4ik ($12.88 in chips) 
Seat 3: odonro ($22.62 in chips) 
Seat 4: xSkokEx ($12.39 in chips) 
Seat 5: sólyom333 ($14.89 in chips) 
Seat 6: maltsevig ($10 in chips) 
maltsevig: posts small blind $0.05
Manon4ik: posts big blind $0.10
*** HOLE CARDS ***
odonro: folds 
xSkokEx: folds 
sólyom333: raises $0.12 to $0.22
maltsevig: folds 
Manon4ik: folds 
Uncalled bet ($0.12) returned to sólyom333
sólyom333 collected $0.25 from pot
sólyom333: doesn't show hand 
*** SUMMARY ***
Total pot $0.25 | Rake $0 
Seat 2: Manon4ik (big blind) folded before Flop
Seat 3: odonro folded before Flop (didn't bet)
Seat 4: xSkokEx folded before Flop (didn't bet)
Seat 5: sólyom333 (button) collected ($0.25)
Seat 6: maltsevig (small blind) folded before Flop



PokerStars Hand #222969363081:  Hold'em No Limit ($0.05/$0.10 USD) - 2021/01/23 15:30:10 ET
Table 'Shura III' 6-max Seat #6 is the button
Seat 2: Manon4ik ($12.78 in chips) 
Seat 3: odonro ($22.62 in chips) 
Seat 4: xSkokEx ($12.39 in chips) 
Seat 5: sólyom333 ($15.04 in chips) 
Seat 6: maltsevig ($10 in chips) 
Manon4ik: posts small blind $0.05
odonro: posts big blind $0.10
*** HOLE CARDS ***
xSkokEx: folds 
sólyom333: raises $0.18 to $0.28
maltsevig: folds 
Manon4ik: folds 
odonro: folds 
Uncalled bet ($0.18) returned to sólyom333
sólyom333 collected $0.25 from pot
sólyom333: doesn't show hand 
*** SUMMARY ***
Total pot $0.25 | Rake $0 
Seat 2: Manon4ik (small blind) folded before Flop
Seat 3: odonro (big blind) folded before Flop
Seat 4: xSkokEx folded before Flop (didn't bet)
Seat 5: sólyom333 collected ($0.25)
Seat 6: maltsevig (button) folded before Flop (didn't bet)



PokerStars Hand #222969379044:  Hold'em No Limit ($0.05/$0.10 USD) - 2021/01/23 15:30:28 ET
Table 'Shura III' 6-max Seat #2 is the button
Seat 1: Cheetham2020 ($6.92 in chips) 
Seat 2: Manon4ik ($12.73 in chips) 
Seat 3: odonro ($22.52 in chips) 
Seat 4: xSkokEx ($12.39 in chips) 
Seat 5: sólyom333 ($15.19 in chips) 
Seat 6: maltsevig ($10 in chips) 
odonro: posts small blind $0.05
xSkokEx: posts big blind $0.10
Cheetham2020: posts small & big blinds $0.15
*** HOLE CARDS ***
sólyom333: folds 
maltsevig: raises $0.40 to $0.50
Cheetham2020: raises $0.40 to $0.90
Manon4ik: folds 
odonro: folds 
xSkokEx: folds 
maltsevig: calls $0.40
*** FLOP *** [Tc 9s Jd]
maltsevig: checks 
Cheetham2020: bets $1.91
maltsevig: folds 
Uncalled bet ($1.91) returned to Cheetham2020
Cheetham2020 collected $1.91 from pot
Cheetham2020: doesn't show hand 
*** SUMMARY ***
Total pot $2 | Rake $0.09 
Board [Tc 9s Jd]
Seat 1: Cheetham2020 collected ($1.91)
Seat 2: Manon4ik (button) folded before Flop (didn't bet)
Seat 3: odonro (small blind) folded before Flop
Seat 4: xSkokEx (big blind) folded before Flop
Seat 5: sólyom333 folded before Flop (didn't bet)
Seat 6: maltsevig folded on the Flop



PokerStars Hand #222969430589:  Hold'em No Limit ($0.05/$0.10 USD) - 2021/01/23 15:31:15 ET
Table 'Shura III' 6-max Seat #3 is the button
Seat 1: Cheetham2020 ($7.88 in chips) 
Seat 2: Manon4ik ($12.73 in chips) 
Seat 3: odonro ($22.47 in chips) 
Seat 4: xSkokEx ($12.29 in chips) 
Seat 5: sólyom333 ($15.19 in chips) 
Seat 6: maltsevig ($10 in chips) 
xSkokEx: posts small blind $0.05
sólyom333: posts big blind $0.10
*** HOLE CARDS ***
maltsevig: raises $0.20 to $0.30
Cheetham2020: raises $0.20 to $0.50
Manon4ik: folds 
odonro: folds 
xSkokEx: folds 
sólyom333: folds 
maltsevig: calls $0.20
*** FLOP *** [Qh 3d Ad]
maltsevig: checks 
Cheetham2020 has timed out
Cheetham2020: checks 
*** TURN *** [Qh 3d Ad] [7d]
maltsevig: bets $0.50
Cheetham2020: folds 
Uncalled bet ($0.50) returned to maltsevig
maltsevig collected $1.10 from pot
maltsevig: doesn't show hand 
*** SUMMARY ***
Total pot $1.15 | Rake $0.05 
Board [Qh 3d Ad 7d]
Seat 1: Cheetham2020 folded on the Turn
Seat 2: Manon4ik folded before Flop (didn't bet)
Seat 3: odonro (button) folded before Flop (didn't bet)
Seat 4: xSkokEx (small blind) folded before Flop
Seat 5: sólyom333 (big blind) folded before Flop
Seat 6: maltsevig collected ($1.10)



PokerStars Hand #222969481272:  Hold'em No Limit ($0.05/$0.10 USD) - 2021/01/23 15:32:14 ET
Table 'Shura III' 6-max Seat #4 is the button
Seat 1: Cheetham2020 ($7.38 in chips) 
Seat 2: Manon4ik ($12.73 in chips) 
Seat 4: xSkokEx ($12.24 in chips) 
Seat 5: sólyom333 ($15.09 in chips) 
Seat 6: maltsevig ($10.60 in chips) 
sólyom333: posts small blind $0.05
maltsevig: posts big blind $0.10
*** HOLE CARDS ***
Cheetham2020: raises $0.10 to $0.20
Manon4ik: folds 
xSkokEx: folds 
sólyom333: calls $0.15
maltsevig: folds 
*** FLOP *** [Td 5s Ts]
sólyom333: checks 
Cheetham2020: checks 
*** TURN *** [Td 5s Ts] [Kc]
sólyom333: bets $0.32
Cheetham2020 has timed out
Cheetham2020: folds 
Uncalled bet ($0.32) returned to sólyom333
sólyom333 collected $0.48 from pot
sólyom333: doesn't show hand 
*** SUMMARY ***
Total pot $0.50 | Rake $0.02 
Board [Td 5s Ts Kc]
Seat 1: Cheetham2020 folded on the Turn
Seat 2: Manon4ik folded before Flop (didn't bet)
Seat 4: xSkokEx (button) folded before Flop (didn't bet)
Seat 5: sólyom333 (small blind) collected ($0.48)
Seat 6: maltsevig (big blind) folded before Flop



PokerStars Hand #222969519401:  Hold'em No Limit ($0.05/$0.10 USD) - 2021/01/23 15:32:58 ET
Table 'Shura III' 6-max Seat #5 is the button
Seat 2: Manon4ik ($12.73 in chips) 
Seat 4: xSkokEx ($12.24 in chips) 
Seat 5: sólyom333 ($15.37 in chips) 
Seat 6: maltsevig ($10.50 in chips) 
maltsevig: posts small blind $0.05
Manon4ik: posts big blind $0.10
*** HOLE CARDS ***
xSkokEx: folds 
sólyom333: raises $0.12 to $0.22
maltsevig: folds 
Manon4ik: folds 
Uncalled bet ($0.12) returned to sólyom333
sólyom333 collected $0.25 from pot
sólyom333: doesn't show hand 
*** SUMMARY ***
Total pot $0.25 | Rake $0 
Seat 2: Manon4ik (big blind) folded before Flop
Seat 4: xSkokEx folded before Flop (didn't bet)
Seat 5: sólyom333 (button) collected ($0.25)
Seat 6: maltsevig (small blind) folded before Flop



PokerStars Hand #222969530653:  Hold'em No Limit ($0.05/$0.10 USD) - 2021/01/23 15:33:11 ET
Table 'Shura III' 6-max Seat #6 is the button
Seat 2: Manon4ik ($12.63 in chips) 
Seat 3: odonro ($22.47 in chips) 
Seat 4: xSkokEx ($12.24 in chips) 
Seat 5: sólyom333 ($15.52 in chips) 
Seat 6: maltsevig ($10.45 in chips) 
Manon4ik: posts small blind $0.05
odonro: posts big blind $0.10
*** HOLE CARDS ***
xSkokEx: folds 
sólyom333: raises $0.18 to $0.28
xSkokEx leaves the table
maltsevig: calls $0.28
Manon4ik: folds 
odonro is disconnected 
odonro has timed out while disconnected
odonro: folds 
*** FLOP *** [Td 6d Ts]
sólyom333: bets $0.29
maltsevig: calls $0.29
*** TURN *** [Td 6d Ts] [4s]
sólyom333: checks 
maltsevig: bets $0.80
sólyom333: folds 
Uncalled bet ($0.80) returned to maltsevig
maltsevig collected $1.23 from pot
maltsevig: doesn't show hand 
*** SUMMARY ***
Total pot $1.29 | Rake $0.06 
Board [Td 6d Ts 4s]
Seat 2: Manon4ik (small blind) folded before Flop
Seat 3: odonro (big blind) folded before Flop
Seat 4: xSkokEx folded before Flop (didn't bet)
Seat 5: sólyom333 folded on the Turn
Seat 6: maltsevig (button) collected ($1.23)



PokerStars Hand #222969611727:  Hold'em No Limit ($0.05/$0.10 USD) - 2021/01/23 15:34:46 ET
Table 'Shura III' 6-max Seat #2 is the button
Seat 1: Cheetham2020 ($7.18 in chips) 
Seat 2: Manon4ik ($12.58 in chips) 
Seat 3: odonro ($22.37 in chips) 
Seat 5: sólyom333 ($14.95 in chips) 
Seat 6: maltsevig ($11.11 in chips) 
odonro: posts small blind $0.05
sólyom333: posts big blind $0.10
Cheetham2020: posts small & big blinds $0.15
*** HOLE CARDS ***
maltsevig: raises $0.40 to $0.50
Cheetham2020: calls $0.40
Manon4ik: folds 
odonro: folds 
sólyom333: folds 
*** FLOP *** [3h Jd 9c]
maltsevig: bets $0.46
Cheetham2020 has timed out
Cheetham2020: folds 
Uncalled bet ($0.46) returned to maltsevig
maltsevig collected $1.15 from pot
maltsevig: doesn't show hand 
Neaishqs8787 joins the table at seat #4 
*** SUMMARY ***
Total pot $1.20 | Rake $0.05 
Board [3h Jd 9c]
Seat 1: Cheetham2020 folded on the Flop
Seat 2: Manon4ik (button) folded before Flop (didn't bet)
Seat 3: odonro (small blind) folded before Flop
Seat 5: sólyom333 (big blind) folded before Flop
Seat 6: maltsevig collected ($1.15)



PokerStars Hand #222969645382:  Hold'em No Limit ($0.05/$0.10 USD) - 2021/01/23 15:35:23 ET
Table 'Shura III' 6-max Seat #3 is the button
Seat 1: Cheetham2020 ($6.63 in chips) 
Seat 2: Manon4ik ($12.58 in chips) 
Seat 3: odonro ($22.32 in chips) 
Seat 5: sólyom333 ($14.85 in chips) 
Seat 6: maltsevig ($11.76 in chips) 
sólyom333: posts small blind $0.05
maltsevig: posts big blind $0.10
*** HOLE CARDS ***
Cheetham2020 has timed out
Cheetham2020: folds 
Manon4ik: raises $0.15 to $0.25
odonro: folds 
sólyom333: raises $0.65 to $0.90
maltsevig: folds 
Manon4ik: folds 
Uncalled bet ($0.65) returned to sólyom333
sólyom333 collected $0.60 from pot
sólyom333: doesn't show hand 
*** SUMMARY ***
Total pot $0.60 | Rake $0 
Seat 1: Cheetham2020 folded before Flop (didn't bet)
Seat 2: Manon4ik folded before Flop
Seat 3: odonro (button) folded before Flop (didn't bet)
Seat 5: sólyom333 (small blind) collected ($0.60)
Seat 6: maltsevig (big blind) folded before Flop



PokerStars Hand #222969667968:  Hold'em No Limit ($0.05/$0.10 USD) - 2021/01/23 15:35:49 ET
Table 'Shura III' 6-max Seat #5 is the button
Seat 1: Cheetham2020 ($10 in chips) 
Seat 2: Manon4ik ($12.33 in chips) 
Seat 3: odonro ($22.32 in chips) 
Seat 5: sólyom333 ($15.20 in chips) 
Seat 6: maltsevig ($11.66 in chips) 
maltsevig: posts small blind $0.05
Cheetham2020: posts big blind $0.10
Neaishqs8787: sits out 
*** HOLE CARDS ***
Manon4ik: raises $0.20 to $0.30
odonro: calls $0.30
sólyom333: folds 
maltsevig: folds 
Cheetham2020: calls $0.20
*** FLOP *** [Td 4s 7h]
Cheetham2020: checks 
Manon4ik: checks 
odonro: bets $0.91
Cheetham2020: calls $0.91
Manon4ik: raises $1.99 to $2.90
odonro: folds 
Cheetham2020: folds 
Uncalled bet ($1.99) returned to Manon4ik
Manon4ik collected $3.51 from pot
Manon4ik: doesn't show hand 
*** SUMMARY ***
Total pot $3.68 | Rake $0.17 
Board [Td 4s 7h]
Seat 1: Cheetham2020 (big blind) folded on the Flop
Seat 2: Manon4ik collected ($3.51)
Seat 3: odonro folded on the Flop
Seat 5: sólyom333 (button) folded before Flop (didn't bet)
Seat 6: maltsevig (small blind) folded before Flop



PokerStars Hand #222969722970:  Hold'em No Limit ($0.05/$0.10 USD) - 2021/01/23 15:36:54 ET
Table 'Shura III' 6-max Seat #6 is the button
Seat 1: Cheetham2020 ($8.79 in chips) 
Seat 2: Manon4ik ($14.63 in chips) 
Seat 3: odonro ($21.11 in chips) 
Seat 5: sólyom333 ($15.20 in chips) 
Seat 6: maltsevig ($11.61 in chips) 
Cheetham2020: posts small blind $0.05
Manon4ik: posts big blind $0.10
Neaishqs8787: sits out 
*** HOLE CARDS ***
odonro: raises $0.10 to $0.20
sólyom333: folds 
maltsevig: folds 
Cheetham2020: folds 
Manon4ik: folds 
Uncalled bet ($0.10) returned to odonro
odonro collected $0.25 from pot
odonro: doesn't show hand 
*** SUMMARY ***
Total pot $0.25 | Rake $0 
Seat 1: Cheetham2020 (small blind) folded before Flop
Seat 2: Manon4ik (big blind) folded before Flop
Seat 3: odonro collected ($0.25)
Seat 5: sólyom333 folded before Flop (didn't bet)
Seat 6: maltsevig (button) folded before Flop (didn't bet)



PokerStars Hand #222969737142:  Hold'em No Limit ($0.05/$0.10 USD) - 2021/01/23 15:37:11 ET
Table 'Shura III' 6-max Seat #1 is the button
Seat 1: Cheetham2020 ($8.74 in chips) 
Seat 2: Manon4ik ($14.53 in chips) 
Seat 3: odonro ($21.26 in chips) 
Seat 5: sólyom333 ($15.20 in chips) 
Seat 6: maltsevig ($11.61 in chips) 
Manon4ik: posts small blind $0.05
odonro: posts big blind $0.10
Neaishqs8787: sits out 
*** HOLE CARDS ***
sólyom333: folds 
maltsevig: folds 
Cheetham2020: raises $0.10 to $0.20
Manon4ik: folds 
odonro: folds 
Uncalled bet ($0.10) returned to Cheetham2020
Cheetham2020 collected $0.25 from pot
Cheetham2020: doesn't show hand 
*** SUMMARY ***
Total pot $0.25 | Rake $0 
Seat 1: Cheetham2020 (button) collected ($0.25)
Seat 2: Manon4ik (small blind) folded before Flop
Seat 3: odonro (big blind) folded before Flop
Seat 5: sólyom333 folded before Flop (didn't bet)
Seat 6: maltsevig folded before Flop (didn't bet)



PokerStars Hand #222969750752:  Hold'em No Limit ($0.05/$0.10 USD) - 2021/01/23 15:37:27 ET
Table 'Shura III' 6-max Seat #2 is the button
Seat 1: Cheetham2020 ($8.89 in chips) 
Seat 2: Manon4ik ($14.48 in chips) 
Seat 3: odonro ($21.16 in chips) 
Seat 4: Neaishqs8787 ($10 in chips) 
Seat 5: sólyom333 ($15.20 in chips) 
Seat 6: maltsevig ($11.61 in chips) 
odonro: posts small blind $0.05
Neaishqs8787: posts big blind $0.10
*** HOLE CARDS ***
sólyom333: folds 
maltsevig: folds 
Cheetham2020 has timed out
Cheetham2020: folds 
Manon4ik: folds 
odonro: calls $0.05
Neaishqs8787: checks 
*** FLOP *** [8s Js 2h]
odonro: bets $0.19
Neaishqs8787: raises $0.19 to $0.38
odonro: calls $0.19
*** TURN *** [8s Js 2h] [3d]
odonro: checks 
Neaishqs8787: bets $0.92
odonro: calls $0.92
*** RIVER *** [8s Js 2h 3d] [Ts]
odonro: bets $2.67
Neaishqs8787: calls $2.67
*** SHOW DOWN ***
odonro: shows [7s 6s] (a flush, Jack high)
Neaishqs8787: mucks hand 
odonro collected $7.77 from pot
*** SUMMARY ***
Total pot $8.14 | Rake $0.37 
Board [8s Js 2h 3d Ts]
Seat 1: Cheetham2020 folded before Flop (didn't bet)
Seat 2: Manon4ik (button) folded before Flop (didn't bet)
Seat 3: odonro (small blind) showed [7s 6s] and won ($7.77) with a flush, Jack high
Seat 4: Neaishqs8787 (big blind) mucked
Seat 5: sólyom333 folded before Flop (didn't bet)
Seat 6: maltsevig folded before Flop (didn't bet)



PokerStars Hand #222969792150:  Hold'em No Limit ($0.05/$0.10 USD) - 2021/01/23 15:38:15 ET
Table 'Shura III' 6-max Seat #3 is the button
Seat 1: Cheetham2020 ($8.89 in chips) 
Seat 2: Manon4ik ($14.48 in chips) 
Seat 3: odonro ($24.86 in chips) 
Seat 4: Neaishqs8787 ($5.93 in chips) 
Seat 5: sólyom333 ($15.20 in chips) 
Seat 6: maltsevig ($11.61 in chips) 
Neaishqs8787: posts small blind $0.05
sólyom333: posts big blind $0.10
*** HOLE CARDS ***
maltsevig: folds 
Cheetham2020 has timed out
Cheetham2020: folds 
Manon4ik: folds 
odonro: folds 
Neaishqs8787: calls $0.05
sólyom333: checks 
*** FLOP *** [Th Ks Qh]
Neaishqs8787: bets $0.19
sólyom333: calls $0.19
*** TURN *** [Th Ks Qh] [4d]
Neaishqs8787: bets $0.55
sólyom333: calls $0.55
*** RIVER *** [Th Ks Qh 4d] [5s]
Neaishqs8787: bets $1.60
sólyom333: folds 
Uncalled bet ($1.60) returned to Neaishqs8787
Neaishqs8787 collected $1.60 from pot
Neaishqs8787: doesn't show hand 
*** SUMMARY ***
Total pot $1.68 | Rake $0.08 
Board [Th Ks Qh 4d 5s]
Seat 1: Cheetham2020 folded before Flop (didn't bet)
Seat 2: Manon4ik folded before Flop (didn't bet)
Seat 3: odonro (button) folded before Flop (didn't bet)
Seat 4: Neaishqs8787 (small blind) collected ($1.60)
Seat 5: sólyom333 (big blind) folded on the River
Seat 6: maltsevig folded before Flop (didn't bet)



PokerStars Hand #222969838601:  Hold'em No Limit ($0.05/$0.10 USD) - 2021/01/23 15:39:02 ET
Table 'Shura III' 6-max Seat #4 is the button
Seat 2: Manon4ik ($14.48 in chips) 
Seat 3: odonro ($24.86 in chips) 
Seat 4: Neaishqs8787 ($6.69 in chips) 
Seat 5: sólyom333 ($14.36 in chips) 
Seat 6: maltsevig ($11.61 in chips) 
sólyom333: posts small blind $0.05
maltsevig: posts big blind $0.10
*** HOLE CARDS ***
Manon4ik: folds 
odonro: folds 
Neaishqs8787: calls $0.10
sólyom333: folds 
maltsevig: checks 
*** FLOP *** [6h 9h 9d]
maltsevig: checks 
Neaishqs8787: checks 
*** TURN *** [6h 9h 9d] [4c]
maltsevig: checks 
Neaishqs8787: checks 
*** RIVER *** [6h 9h 9d 4c] [3s]
maltsevig: checks 
Neaishqs8787: bets $0.24
maltsevig: calls $0.24
*** SHOW DOWN ***
Neaishqs8787: shows [Qc Kh] (a pair of Nines)
maltsevig: shows [4s Kd] (two pair, Nines and Fours)
maltsevig collected $0.70 from pot
*** SUMMARY ***
Total pot $0.73 | Rake $0.03 
Board [6h 9h 9d 4c 3s]
Seat 2: Manon4ik folded before Flop (didn't bet)
Seat 3: odonro folded before Flop (didn't bet)
Seat 4: Neaishqs8787 (button) showed [Qc Kh] and lost with a pair of Nines
Seat 5: sólyom333 (small blind) folded before Flop
Seat 6: maltsevig (big blind) showed [4s Kd] and won ($0.70) with two pair, Nines and Fours



PokerStars Hand #222969863303:  Hold'em No Limit ($0.05/$0.10 USD) - 2021/01/23 15:39:31 ET
Table 'Shura III' 6-max Seat #5 is the button
Seat 2: Manon4ik ($14.48 in chips) 
Seat 3: odonro ($24.86 in chips) 
Seat 4: Neaishqs8787 ($6.35 in chips) 
Seat 5: sólyom333 ($14.31 in chips) 
Seat 6: maltsevig ($11.97 in chips) 
maltsevig: posts small blind $0.05
Manon4ik: posts big blind $0.10
*** HOLE CARDS ***
odonro: folds 
Neaishqs8787: calls $0.10
sólyom333: folds 
maltsevig: folds 
Manon4ik: checks 
*** FLOP *** [2d 2h 9d]
Manon4ik: checks 
Neaishqs8787: checks 
*** TURN *** [2d 2h 9d] [6s]
Manon4ik: checks 
Neaishqs8787: checks 
*** RIVER *** [2d 2h 9d 6s] [4h]
Manon4ik: checks 
Neaishqs8787: bets $0.24
Manon4ik: folds 
Uncalled bet ($0.24) returned to Neaishqs8787
Neaishqs8787 collected $0.24 from pot
Neaishqs8787: doesn't show hand 
*** SUMMARY ***
Total pot $0.25 | Rake $0.01 
Board [2d 2h 9d 6s 4h]
Seat 2: Manon4ik (big blind) folded on the River
Seat 3: odonro folded before Flop (didn't bet)
Seat 4: Neaishqs8787 collected ($0.24)
Seat 5: sólyom333 (button) folded before Flop (didn't bet)
Seat 6: maltsevig (small blind) folded before Flop



PokerStars Hand #222969886665:  Hold'em No Limit ($0.05/$0.10 USD) - 2021/01/23 15:39:59 ET
Table 'Shura III' 6-max Seat #6 is the button
Seat 2: Manon4ik ($14.38 in chips) 
Seat 3: odonro ($24.86 in chips) 
Seat 4: Neaishqs8787 ($6.49 in chips) 
Seat 5: sólyom333 ($14.31 in chips) 
Seat 6: maltsevig ($11.92 in chips) 
Manon4ik: posts small blind $0.05
odonro: posts big blind $0.10
*** HOLE CARDS ***
Neaishqs8787: calls $0.10
sólyom333: raises $0.20 to $0.30
maltsevig: folds 
Manon4ik: folds 
odonro: calls $0.20
Neaishqs8787: calls $0.20
*** FLOP *** [Js 8c 6h]
odonro: checks 
Neaishqs8787: checks 
sólyom333: bets $0.38
odonro: folds 
Neaishqs8787: calls $0.38
*** TURN *** [Js 8c 6h] [Qs]
Neaishqs8787: checks 
sólyom333: bets $1.09
Neaishqs8787: folds 
Uncalled bet ($1.09) returned to sólyom333
sólyom333 collected $1.63 from pot
sólyom333: doesn't show hand 
*** SUMMARY ***
Total pot $1.71 | Rake $0.08 
Board [Js 8c 6h Qs]
Seat 2: Manon4ik (small blind) folded before Flop
Seat 3: odonro (big blind) folded on the Flop
Seat 4: Neaishqs8787 folded on the Turn
Seat 5: sólyom333 collected ($1.63)
Seat 6: maltsevig (button) folded before Flop (didn't bet)



PokerStars Hand #222969913747:  Hold'em No Limit ($0.05/$0.10 USD) - 2021/01/23 15:40:31 ET
Table 'Shura III' 6-max Seat #2 is the button
Seat 1: Cheetham2020 ($8.89 in chips) 
Seat 2: Manon4ik ($14.33 in chips) 
Seat 3: odonro ($24.56 in chips) 
Seat 4: Neaishqs8787 ($5.81 in chips) 
Seat 5: sólyom333 ($15.26 in chips) 
Seat 6: maltsevig ($11.92 in chips) 
odonro: posts small blind $0.05
Neaishqs8787: posts big blind $0.10
Cheetham2020: posts small & big blinds $0.15
*** HOLE CARDS ***
sólyom333: folds 
maltsevig: folds 
Cheetham2020: checks 
Manon4ik: folds 
odonro: raises $0.20 to $0.30
Neaishqs8787: calls $0.20
Cheetham2020: raises $0.20 to $0.50
odonro: calls $0.20
Neaishqs8787: calls $0.20
*** FLOP *** [Jd 7d 9c]
odonro: checks 
Neaishqs8787: bets $1.48
Cheetham2020: raises $1.48 to $2.96
odonro: folds 
Neaishqs8787: calls $1.48
*** TURN *** [Jd 7d 9c] [Jh]
Neaishqs8787: bets $2.35 and is all-in
Cheetham2020: calls $2.35
*** RIVER *** [Jd 7d 9c Jh] [9s]
*** SHOW DOWN ***
Neaishqs8787: shows [Td Ad] (two pair, Jacks and Nines)
Cheetham2020: shows [Ah Ac] (two pair, Aces and Jacks)
Cheetham2020 collected $11.62 from pot
*** SUMMARY ***
Total pot $12.17 | Rake $0.55 
Board [Jd 7d 9c Jh 9s]
Seat 1: Cheetham2020 showed [Ah Ac] and won ($11.62) with two pair, Aces and Jacks
Seat 2: Manon4ik (button) folded before Flop (didn't bet)
Seat 3: odonro (small blind) folded on the Flop
Seat 4: Neaishqs8787 (big blind) showed [Td Ad] and lost with two pair, Jacks and Nines
Seat 5: sólyom333 folded before Flop (didn't bet)
Seat 6: maltsevig folded before Flop (didn't bet)



PokerStars Hand #222969972328:  Hold'em No Limit ($0.05/$0.10 USD) - 2021/01/23 15:41:40 ET
Table 'Shura III' 6-max Seat #3 is the button
Seat 1: Cheetham2020 ($14.65 in chips) 
Seat 2: Manon4ik ($14.33 in chips) 
Seat 3: odonro ($24.06 in chips) 
Seat 5: sólyom333 ($15.26 in chips) 
Seat 6: maltsevig ($11.92 in chips) 
sólyom333: posts small blind $0.05
maltsevig: posts big blind $0.10
*** HOLE CARDS ***
Cheetham2020: calls $0.10
Manon4ik: folds 
odonro: folds 
sólyom333: raises $0.35 to $0.45
maltsevig: folds 
Cheetham2020: calls $0.35
*** FLOP *** [8s 6h Kc]
sólyom333: bets $0.40
Cheetham2020: calls $0.40
*** TURN *** [8s 6h Kc] [2h]
sólyom333: checks 
Cheetham2020: checks 
*** RIVER *** [8s 6h Kc 2h] [2s]
sólyom333: checks 
Cheetham2020: checks 
*** SHOW DOWN ***
sólyom333: shows [7h 7s] (two pair, Sevens and Deuces)
Cheetham2020: mucks hand 
sólyom333 collected $1.72 from pot
*** SUMMARY ***
Total pot $1.80 | Rake $0.08 
Board [8s 6h Kc 2h 2s]
Seat 1: Cheetham2020 mucked
Seat 2: Manon4ik folded before Flop (didn't bet)
Seat 3: odonro (button) folded before Flop (didn't bet)
Seat 5: sólyom333 (small blind) showed [7h 7s] and won ($1.72) with two pair, Sevens and Deuces
Seat 6: maltsevig (big blind) folded before Flop



PokerStars Hand #222970028424:  Hold'em No Limit ($0.05/$0.10 USD) - 2021/01/23 15:42:47 ET
Table 'Shura III' 6-max Seat #5 is the button
Seat 1: Cheetham2020 ($13.80 in chips) 
Seat 2: Manon4ik ($14.33 in chips) 
Seat 3: odonro ($24.06 in chips) 
Seat 4: Neaishqs8787 ($10 in chips) 
Seat 5: sólyom333 ($16.13 in chips) 
Seat 6: maltsevig ($11.82 in chips) 
maltsevig: posts small blind $0.05
Cheetham2020: posts big blind $0.10
Neaishqs8787: posts small blind $0.05
*** HOLE CARDS ***
Manon4ik: raises $0.25 to $0.35
odonro: folds 
Neaishqs8787: calls $0.35
sólyom333: folds 
maltsevig: calls $0.30
Cheetham2020: calls $0.25
*** FLOP *** [4d 9d 6h]
maltsevig: checks 
Cheetham2020: checks 
Manon4ik: checks 
Neaishqs8787: checks 
*** TURN *** [4d 9d 6h] [Kd]
maltsevig: checks 
Cheetham2020 has timed out
Cheetham2020: checks 
Manon4ik: checks 
Neaishqs8787: checks 
*** RIVER *** [4d 9d 6h Kd] [9s]
maltsevig: checks 
Cheetham2020: checks 
Manon4ik: checks 
Neaishqs8787: checks 
*** SHOW DOWN ***
maltsevig: shows [Jd Js] (two pair, Jacks and Nines)
Cheetham2020: mucks hand 
Manon4ik: mucks hand 
Neaishqs8787: mucks hand 
maltsevig collected $1.38 from pot
*** SUMMARY ***
Total pot $1.45 | Rake $0.07 
Board [4d 9d 6h Kd 9s]
Seat 1: Cheetham2020 (big blind) mucked
Seat 2: Manon4ik mucked
Seat 3: odonro folded before Flop (didn't bet)
Seat 4: Neaishqs8787 mucked
Seat 5: sólyom333 (button) folded before Flop (didn't bet)
Seat 6: maltsevig (small blind) showed [Jd Js] and won ($1.38) with two pair, Jacks and Nines



PokerStars Hand #222970097399:  Hold'em No Limit ($0.05/$0.10 USD) - 2021/01/23 15:44:09 ET
Table 'Shura III' 6-max Seat #6 is the button
Seat 1: Cheetham2020 ($13.45 in chips) 
Seat 2: Manon4ik ($13.98 in chips) 
Seat 3: odonro ($24.06 in chips) 
Seat 4: Neaishqs8787 ($9.60 in chips) 
Seat 5: sólyom333 ($16.13 in chips) 
Seat 6: maltsevig ($12.85 in chips) 
Cheetham2020: posts small blind $0.05
Manon4ik: posts big blind $0.10
*** HOLE CARDS ***
odonro: calls $0.10
Neaishqs8787: calls $0.10
sólyom333: calls $0.10
maltsevig: folds 
Cheetham2020: calls $0.05
Manon4ik: checks 
*** FLOP *** [9s 4c 9d]
Cheetham2020: checks 
Manon4ik: checks 
odonro: checks 
Neaishqs8787: checks 
sólyom333: checks 
*** TURN *** [9s 4c 9d] [Qh]
Cheetham2020: checks 
Manon4ik: checks 
odonro: checks 
Neaishqs8787: checks 
sólyom333: checks 
*** RIVER *** [9s 4c 9d Qh] [3s]
Cheetham2020 has timed out
Cheetham2020: checks 
Manon4ik: checks 
odonro: checks 
Neaishqs8787: checks 
sólyom333: checks 
*** SHOW DOWN ***
Cheetham2020: shows [3c 2s] (two pair, Nines and Threes)
Manon4ik: shows [3d 6d] (two pair, Nines and Threes)
odonro: mucks hand 
Neaishqs8787: mucks hand 
sólyom333: mucks hand 
Cheetham2020 collected $0.24 from pot
Manon4ik collected $0.24 from pot
*** SUMMARY ***
Total pot $0.50 | Rake $0.02 
Board [9s 4c 9d Qh 3s]
Seat 1: Cheetham2020 (small blind) showed [3c 2s] and won ($0.24) with two pair, Nines and Threes
Seat 2: Manon4ik (big blind) showed [3d 6d] and won ($0.24) with two pair, Nines and Threes
Seat 3: odonro mucked
Seat 4: Neaishqs8787 mucked
Seat 5: sólyom333 mucked
Seat 6: maltsevig (button) folded before Flop (didn't bet)



PokerStars Hand #222970173810:  Hold'em No Limit ($0.05/$0.10 USD) - 2021/01/23 15:45:40 ET
Table 'Shura III' 6-max Seat #1 is the button
Seat 1: Cheetham2020 ($13.59 in chips) 
Seat 2: Manon4ik ($14.12 in chips) 
Seat 3: odonro ($23.96 in chips) 
Seat 4: Neaishqs8787 ($9.50 in chips) 
Seat 5: sólyom333 ($16.03 in chips) 
Seat 6: maltsevig ($12.85 in chips) 
Manon4ik: posts small blind $0.05
odonro: posts big blind $0.10
*** HOLE CARDS ***
Neaishqs8787: calls $0.10
sólyom333: folds 
maltsevig: raises $0.30 to $0.40
Cheetham2020 has timed out
Cheetham2020: folds 
Manon4ik: folds 
odonro: folds 
Neaishqs8787: calls $0.30
*** FLOP *** [Jc Td Jh]
Neaishqs8787: checks 
maltsevig: bets $0.36
Neaishqs8787: calls $0.36
*** TURN *** [Jc Td Jh] [5s]
Neaishqs8787: checks 
maltsevig: checks 
*** RIVER *** [Jc Td Jh 5s] [6c]
Neaishqs8787: checks 
maltsevig: checks 
*** SHOW DOWN ***
Neaishqs8787: shows [Kd 9s] (a pair of Jacks)
maltsevig: shows [Ad Qd] (a pair of Jacks - Ace kicker)
maltsevig collected $1.59 from pot
*** SUMMARY ***
Total pot $1.67 | Rake $0.08 
Board [Jc Td Jh 5s 6c]
Seat 1: Cheetham2020 (button) folded before Flop (didn't bet)
Seat 2: Manon4ik (small blind) folded before Flop
Seat 3: odonro (big blind) folded before Flop
Seat 4: Neaishqs8787 showed [Kd 9s] and lost with a pair of Jacks
Seat 5: sólyom333 folded before Flop (didn't bet)
Seat 6: maltsevig showed [Ad Qd] and won ($1.59) with a pair of Jacks



PokerStars Hand #222970227632:  Hold'em No Limit ($0.05/$0.10 USD) - 2021/01/23 15:46:44 ET
Table 'Shura III' 6-max Seat #2 is the button
Seat 1: Cheetham2020 ($13.59 in chips) 
Seat 2: Manon4ik ($14.07 in chips) 
Seat 3: odonro ($23.86 in chips) 
Seat 4: Neaishqs8787 ($8.74 in chips) 
Seat 5: sólyom333 ($16.03 in chips) 
Seat 6: maltsevig ($13.68 in chips) 
odonro: posts small blind $0.05
Neaishqs8787: posts big blind $0.10
*** HOLE CARDS ***
sólyom333: folds 
maltsevig: folds 
Cheetham2020 has timed out
Cheetham2020: folds 
Manon4ik: raises $0.15 to $0.25
odonro: folds 
Neaishqs8787: calls $0.15
*** FLOP *** [3h 2h 3d]
Neaishqs8787: checks 
Manon4ik: bets $0.27
Neaishqs8787: calls $0.27
*** TURN *** [3h 2h 3d] [9c]
Neaishqs8787: checks 
Manon4ik: bets $0.50
Neaishqs8787: raises $0.50 to $1
Manon4ik: folds 
Uncalled bet ($0.50) returned to Neaishqs8787
Neaishqs8787 collected $2 from pot
Neaishqs8787: doesn't show hand 
*** SUMMARY ***
Total pot $2.09 | Rake $0.09 
Board [3h 2h 3d 9c]
Seat 1: Cheetham2020 folded before Flop (didn't bet)
Seat 2: Manon4ik (button) folded on the Turn
Seat 3: odonro (small blind) folded before Flop
Seat 4: Neaishqs8787 (big blind) collected ($2)
Seat 5: sólyom333 folded before Flop (didn't bet)
Seat 6: maltsevig folded before Flop (didn't bet)



PokerStars Hand #222970281889:  Hold'em No Limit ($0.05/$0.10 USD) - 2021/01/23 15:47:49 ET
Table 'Shura III' 6-max Seat #3 is the button
Seat 2: Manon4ik ($13.05 in chips) 
Seat 3: odonro ($23.81 in chips) 
Seat 4: Neaishqs8787 ($9.72 in chips) 
Seat 5: sólyom333 ($16.03 in chips) 
Seat 6: maltsevig ($13.68 in chips) 
Neaishqs8787: posts small blind $0.05
sólyom333: posts big blind $0.10
*** HOLE CARDS ***
maltsevig: folds 
Manon4ik: raises $0.15 to $0.25
odonro: folds 
Neaishqs8787: calls $0.20
sólyom333: calls $0.15
*** FLOP *** [4d 3c 2h]
Neaishqs8787: checks 
sólyom333: checks 
Manon4ik: checks 
*** TURN *** [4d 3c 2h] [As]
Neaishqs8787: bets $0.72
sólyom333: folds 
Manon4ik: folds 
Uncalled bet ($0.72) returned to Neaishqs8787
Neaishqs8787 collected $0.72 from pot
Neaishqs8787: doesn't show hand 
*** SUMMARY ***
Total pot $0.75 | Rake $0.03 
Board [4d 3c 2h As]
Seat 2: Manon4ik folded on the Turn
Seat 3: odonro (button) folded before Flop (didn't bet)
Seat 4: Neaishqs8787 (small blind) collected ($0.72)
Seat 5: sólyom333 (big blind) folded on the Turn
Seat 6: maltsevig folded before Flop (didn't bet)



PokerStars Hand #222970321766:  Hold'em No Limit ($0.05/$0.10 USD) - 2021/01/23 15:48:37 ET
Table 'Shura III' 6-max Seat #4 is the button
Seat 1: Cheetham2020 ($13.59 in chips) 
Seat 2: Manon4ik ($12.80 in chips) 
Seat 3: odonro ($23.81 in chips) 
Seat 4: Neaishqs8787 ($10.19 in chips) 
Seat 5: sólyom333 ($15.78 in chips) 
Seat 6: maltsevig ($13.68 in chips) 
sólyom333: posts small blind $0.05
maltsevig: posts big blind $0.10
*** HOLE CARDS ***
Cheetham2020: raises $0.10 to $0.20
Manon4ik: folds 
odonro: folds 
Neaishqs8787: calls $0.20
sólyom333: folds 
maltsevig: folds 
*** FLOP *** [5d Qh 3c]
Cheetham2020: checks 
Neaishqs8787: checks 
*** TURN *** [5d Qh 3c] [Kd]
Cheetham2020 has timed out
Cheetham2020: checks 
Neaishqs8787: checks 
*** RIVER *** [5d Qh 3c Kd] [Ks]
Cheetham2020: checks 
Neaishqs8787: checks 
*** SHOW DOWN ***
Cheetham2020: shows [6s 5s] (two pair, Kings and Fives)
Neaishqs8787: mucks hand 
Cheetham2020 collected $0.53 from pot
*** SUMMARY ***
Total pot $0.55 | Rake $0.02 
Board [5d Qh 3c Kd Ks]
Seat 1: Cheetham2020 showed [6s 5s] and won ($0.53) with two pair, Kings and Fives
Seat 2: Manon4ik folded before Flop (didn't bet)
Seat 3: odonro folded before Flop (didn't bet)
Seat 4: Neaishqs8787 (button) mucked
Seat 5: sólyom333 (small blind) folded before Flop
Seat 6: maltsevig (big blind) folded before Flop



PokerStars Hand #222970363212:  Hold'em No Limit ($0.05/$0.10 USD) - 2021/01/23 15:49:27 ET
Table 'Shura III' 6-max Seat #5 is the button
Seat 1: Cheetham2020 ($13.92 in chips) 
Seat 2: Manon4ik ($12.80 in chips) 
Seat 3: odonro ($23.81 in chips) 
Seat 4: Neaishqs8787 ($9.99 in chips) 
Seat 5: sólyom333 ($15.73 in chips) 
Seat 6: maltsevig ($13.58 in chips) 
maltsevig: posts small blind $0.05
Cheetham2020: posts big blind $0.10
*** HOLE CARDS ***
Manon4ik: folds 
odonro: raises $0.25 to $0.35
Neaishqs8787: calls $0.35
sólyom333: folds 
maltsevig: calls $0.30
Cheetham2020: calls $0.25
*** FLOP *** [Qs 6c Ah]
maltsevig: checks 
Cheetham2020: checks 
odonro: bets $1.34
Neaishqs8787: calls $1.34
maltsevig: folds 
Cheetham2020: folds 
*** TURN *** [Qs 6c Ah] [2c]
odonro: checks 
Neaishqs8787: bets $3.90
odonro: folds 
Uncalled bet ($3.90) returned to Neaishqs8787
Neaishqs8787 collected $3.90 from pot
Neaishqs8787: doesn't show hand 
*** SUMMARY ***
Total pot $4.08 | Rake $0.18 
Board [Qs 6c Ah 2c]
Seat 1: Cheetham2020 (big blind) folded on the Flop
Seat 2: Manon4ik folded before Flop (didn't bet)
Seat 3: odonro folded on the Turn
Seat 4: Neaishqs8787 collected ($3.90)
Seat 5: sólyom333 (button) folded before Flop (didn't bet)
Seat 6: maltsevig (small blind) folded on the Flop



PokerStars Hand #222970424634:  Hold'em No Limit ($0.05/$0.10 USD) - 2021/01/23 15:50:41 ET
Table 'Shura III' 6-max Seat #6 is the button
Seat 1: Cheetham2020 ($13.57 in chips) 
Seat 2: Manon4ik ($12.80 in chips) 
Seat 3: odonro ($22.12 in chips) 
Seat 4: Neaishqs8787 ($12.20 in chips) 
Seat 5: sólyom333 ($15.73 in chips) 
Seat 6: maltsevig ($13.23 in chips) 
Cheetham2020: posts small blind $0.05
Manon4ik: posts big blind $0.10
*** HOLE CARDS ***
odonro: folds 
Neaishqs8787: calls $0.10
sólyom333: raises $0.20 to $0.30
maltsevig: folds 
Cheetham2020: calls $0.25
Manon4ik: folds 
Neaishqs8787: folds 
*** FLOP *** [7d Th 4s]
Cheetham2020 has timed out
Cheetham2020: checks 
sólyom333: bets $0.32
Cheetham2020: calls $0.32
*** TURN *** [7d Th 4s] [5h]
Cheetham2020: checks 
sólyom333: checks 
*** RIVER *** [7d Th 4s 5h] [Ts]
Cheetham2020: checks 
sólyom333: checks 
*** SHOW DOWN ***
Cheetham2020: shows [4h Kc] (two pair, Tens and Fours)
sólyom333: mucks hand 
Cheetham2020 collected $1.38 from pot
*** SUMMARY ***
Total pot $1.44 | Rake $0.06 
Board [7d Th 4s 5h Ts]
Seat 1: Cheetham2020 (small blind) showed [4h Kc] and won ($1.38) with two pair, Tens and Fours
Seat 2: Manon4ik (big blind) folded before Flop
Seat 3: odonro folded before Flop (didn't bet)
Seat 4: Neaishqs8787 folded before Flop
Seat 5: sólyom333 mucked
Seat 6: maltsevig (button) folded before Flop (didn't bet)



PokerStars Hand #222970490624:  Hold'em No Limit ($0.05/$0.10 USD) - 2021/01/23 15:51:59 ET
Table 'Shura III' 6-max Seat #1 is the button
Seat 1: Cheetham2020 ($14.33 in chips) 
Seat 2: Manon4ik ($12.70 in chips) 
Seat 3: odonro ($22.12 in chips) 
Seat 4: Neaishqs8787 ($12.10 in chips) 
Seat 5: sólyom333 ($15.11 in chips) 
Seat 6: maltsevig ($13.23 in chips) 
Manon4ik: posts small blind $0.05
odonro: posts big blind $0.10
*** HOLE CARDS ***
Neaishqs8787: calls $0.10
sólyom333: folds 
maltsevig: folds 
Cheetham2020: calls $0.10
Manon4ik: folds 
odonro: checks 
*** FLOP *** [Kh Ad 9s]
odonro: checks 
Neaishqs8787: checks 
Cheetham2020: checks 
*** TURN *** [Kh Ad 9s] [8d]
odonro: checks 
Neaishqs8787: checks 
Cheetham2020 has timed out
Cheetham2020: checks 
*** RIVER *** [Kh Ad 9s 8d] [2d]
odonro: checks 
Neaishqs8787: checks 
Cheetham2020: checks 
*** SHOW DOWN ***
odonro: shows [6c 3s] (high card Ace)
Neaishqs8787: shows [Jh 6s] (high card Ace - King+Jack kicker)
Cheetham2020: shows [3c Jc] (high card Ace)
Neaishqs8787 collected $0.17 from pot
Cheetham2020 collected $0.16 from pot
*** SUMMARY ***
Total pot $0.35 | Rake $0.02 
Board [Kh Ad 9s 8d 2d]
Seat 1: Cheetham2020 (button) showed [3c Jc] and won ($0.16) with high card Ace
Seat 2: Manon4ik (small blind) folded before Flop
Seat 3: odonro (big blind) showed [6c 3s] and lost with high card Ace
Seat 4: Neaishqs8787 showed [Jh 6s] and won ($0.17) with high card Ace
Seat 5: sólyom333 folded before Flop (didn't bet)
Seat 6: maltsevig folded before Flop (didn't bet)



PokerStars Hand #222970553918:  Hold'em No Limit ($0.05/$0.10 USD) - 2021/01/23 15:53:15 ET
Table 'Shura III' 6-max Seat #2 is the button
Seat 1: Cheetham2020 ($14.39 in chips) 
Seat 2: Manon4ik ($12.65 in chips) 
Seat 3: odonro ($22.02 in chips) 
Seat 4: Neaishqs8787 ($12.17 in chips) 
Seat 5: sólyom333 ($15.11 in chips) 
Seat 6: maltsevig ($13.23 in chips) 
odonro: posts small blind $0.05
Neaishqs8787: posts big blind $0.10
*** HOLE CARDS ***
sólyom333: folds 
maltsevig: folds 
Cheetham2020: raises $0.10 to $0.20
Manon4ik: folds 
odonro: calls $0.15
Neaishqs8787: calls $0.10
*** FLOP *** [5c Qc 6d]
odonro: bets $0.57
Neaishqs8787: calls $0.57
Cheetham2020: raises $0.57 to $1.14
odonro: folds 
Neaishqs8787: calls $0.57
*** TURN *** [5c Qc 6d] [Tc]
Neaishqs8787: checks 
Cheetham2020 has timed out
Cheetham2020: checks 
*** RIVER *** [5c Qc 6d Tc] [Jc]
Neaishqs8787: checks 
Cheetham2020: checks 
*** SHOW DOWN ***
Neaishqs8787: shows [5d 8h] (a pair of Fives)
Cheetham2020: shows [Td Kh] (a pair of Tens)
Cheetham2020 collected $3.29 from pot
*** SUMMARY ***
Total pot $3.45 | Rake $0.16 
Board [5c Qc 6d Tc Jc]
Seat 1: Cheetham2020 showed [Td Kh] and won ($3.29) with a pair of Tens
Seat 2: Manon4ik (button) folded before Flop (didn't bet)
Seat 3: odonro (small blind) folded on the Flop
Seat 4: Neaishqs8787 (big blind) showed [5d 8h] and lost with a pair of Fives
Seat 5: sólyom333 folded before Flop (didn't bet)
Seat 6: maltsevig folded before Flop (didn't bet)



PokerStars Hand #222970608949:  Hold'em No Limit ($0.05/$0.10 USD) - 2021/01/23 15:54:22 ET
Table 'Shura III' 6-max Seat #3 is the button
Seat 1: Cheetham2020 ($16.34 in chips) 
Seat 2: Manon4ik ($12.65 in chips) 
Seat 3: odonro ($21.25 in chips) 
Seat 4: Neaishqs8787 ($10.83 in chips) 
Seat 5: sólyom333 ($15.11 in chips) 
Seat 6: maltsevig ($13.23 in chips) 
Neaishqs8787: posts small blind $0.05
sólyom333: posts big blind $0.10
*** HOLE CARDS ***
maltsevig: folds 
Cheetham2020: calls $0.10
Manon4ik: folds 
odonro has timed out
odonro: folds 
Neaishqs8787: calls $0.05
sólyom333: checks 
*** FLOP *** [8h 4s Qs]
Neaishqs8787: checks 
sólyom333: bets $0.26
Cheetham2020: calls $0.26
Neaishqs8787: folds 
*** TURN *** [8h 4s Qs] [Ah]
sólyom333: bets $0.52
Cheetham2020: calls $0.52
*** RIVER *** [8h 4s Qs Ah] [7d]
sólyom333: bets $1.19
Cheetham2020: folds 
Uncalled bet ($1.19) returned to sólyom333
sólyom333 collected $1.78 from pot
sólyom333: doesn't show hand 
*** SUMMARY ***
Total pot $1.86 | Rake $0.08 
Board [8h 4s Qs Ah 7d]
Seat 1: Cheetham2020 folded on the River
Seat 2: Manon4ik folded before Flop (didn't bet)
Seat 3: odonro (button) folded before Flop (didn't bet)
Seat 4: Neaishqs8787 (small blind) folded on the Flop
Seat 5: sólyom333 (big blind) collected ($1.78)
Seat 6: maltsevig folded before Flop (didn't bet)



PokerStars Hand #222970658825:  Hold'em No Limit ($0.05/$0.10 USD) - 2021/01/23 15:55:28 ET
Table 'Shura III' 6-max Seat #4 is the button
Seat 1: Cheetham2020 ($15.46 in chips) 
Seat 2: Manon4ik ($12.65 in chips) 
Seat 3: odonro ($21.25 in chips) 
Seat 4: Neaishqs8787 ($10.73 in chips) 
Seat 5: sólyom333 ($16.01 in chips) 
Seat 6: maltsevig ($13.23 in chips) 
sólyom333: posts small blind $0.05
maltsevig: posts big blind $0.10
*** HOLE CARDS ***
Cheetham2020: calls $0.10
Manon4ik: raises $0.30 to $0.40
odonro: calls $0.40
Neaishqs8787: folds 
sólyom333: calls $0.35
maltsevig: calls $0.30
Cheetham2020: calls $0.30
*** FLOP *** [Ts 2h Ks]
sólyom333: checks 
maltsevig: checks 
Cheetham2020 has timed out
Cheetham2020: checks 
Manon4ik: checks 
odonro: checks 
*** TURN *** [Ts 2h Ks] [Th]
sólyom333: checks 
maltsevig: checks 
Cheetham2020 has timed out
Cheetham2020: checks 
Manon4ik: checks 
odonro: checks 
*** RIVER *** [Ts 2h Ks Th] [3s]
sólyom333: checks 
maltsevig: checks 
Cheetham2020: checks 
Manon4ik: checks 
odonro: checks 
*** SHOW DOWN ***
sólyom333: shows [8h 5h] (a pair of Tens)
maltsevig: shows [7c 7h] (two pair, Tens and Sevens)
Cheetham2020: mucks hand 
Manon4ik: mucks hand 
odonro: mucks hand 
maltsevig collected $1.91 from pot
*** SUMMARY ***
Total pot $2 | Rake $0.09 
Board [Ts 2h Ks Th 3s]
Seat 1: Cheetham2020 mucked
Seat 2: Manon4ik mucked
Seat 3: odonro mucked
Seat 4: Neaishqs8787 (button) folded before Flop (didn't bet)
Seat 5: sólyom333 (small blind) showed [8h 5h] and lost with a pair of Tens
Seat 6: maltsevig (big blind) showed [7c 7h] and won ($1.91) with two pair, Tens and Sevens



PokerStars Hand #222970721268:  Hold'em No Limit ($0.05/$0.10 USD) - 2021/01/23 15:57:10 ET
Table 'Shura III' 6-max Seat #5 is the button
Seat 1: Cheetham2020 ($15.06 in chips) 
Seat 2: Manon4ik ($12.25 in chips) 
Seat 3: odonro ($20.85 in chips) 
Seat 4: Neaishqs8787 ($10.73 in chips) 
Seat 5: sólyom333 ($15.61 in chips) 
Seat 6: maltsevig ($14.74 in chips) 
maltsevig: posts small blind $0.05
Cheetham2020: posts big blind $0.10
*** HOLE CARDS ***
Manon4ik: folds 
odonro: folds 
Neaishqs8787: calls $0.10
sólyom333: raises $0.18 to $0.28
maltsevig: folds 
Cheetham2020: calls $0.18
Neaishqs8787: calls $0.18
*** FLOP *** [7s 9s 7c]
Cheetham2020 has timed out
Cheetham2020: checks 
Neaishqs8787: bets $0.85
sólyom333: calls $0.85
Cheetham2020: calls $0.85
*** TURN *** [7s 9s 7c] [6c]
Cheetham2020: checks 
Neaishqs8787: bets $3.29
sólyom333: folds 
Cheetham2020: folds 
Uncalled bet ($3.29) returned to Neaishqs8787
Neaishqs8787 collected $3.29 from pot
Neaishqs8787: doesn't show hand 
*** SUMMARY ***
Total pot $3.44 | Rake $0.15 
Board [7s 9s 7c 6c]
Seat 1: Cheetham2020 (big blind) folded on the Turn
Seat 2: Manon4ik folded before Flop (didn't bet)
Seat 3: odonro folded before Flop (didn't bet)
Seat 4: Neaishqs8787 collected ($3.29)
Seat 5: sólyom333 (button) folded on the Turn
Seat 6: maltsevig (small blind) folded before Flop



PokerStars Hand #222970787938:  Hold'em No Limit ($0.05/$0.10 USD) - 2021/01/23 15:59:07 ET
Table 'Shura III' 6-max Seat #6 is the button
Seat 1: Cheetham2020 ($13.93 in chips) 
Seat 2: Manon4ik ($12.25 in chips) 
Seat 3: odonro ($20.85 in chips) 
Seat 4: Neaishqs8787 ($12.89 in chips) 
Seat 5: sólyom333 ($14.48 in chips) 
Seat 6: maltsevig ($14.69 in chips) 
Cheetham2020: posts small blind $0.05
Manon4ik: posts big blind $0.10
*** HOLE CARDS ***
odonro: folds 
Neaishqs8787: calls $0.10
sólyom333: folds 
maltsevig: folds 
Cheetham2020: calls $0.05
Manon4ik: checks 
*** FLOP *** [6c 2h Jd]
Cheetham2020 has timed out
Cheetham2020: checks 
Manon4ik: checks 
Neaishqs8787: checks 
*** TURN *** [6c 2h Jd] [7s]
Cheetham2020: checks 
Manon4ik: checks 
Neaishqs8787: checks 
*** RIVER *** [6c 2h Jd 7s] [Ks]
Cheetham2020: checks 
Manon4ik: checks 
Neaishqs8787: checks 
*** SHOW DOWN ***
Cheetham2020: shows [8h 6h] (a pair of Sixes)
Manon4ik: mucks hand 
Neaishqs8787: mucks hand 
Cheetham2020 collected $0.29 from pot
*** SUMMARY ***
Total pot $0.30 | Rake $0.01 
Board [6c 2h Jd 7s Ks]
Seat 1: Cheetham2020 (small blind) showed [8h 6h] and won ($0.29) with a pair of Sixes
Seat 2: Manon4ik (big blind) mucked
Seat 3: odonro folded before Flop (didn't bet)
Seat 4: Neaishqs8787 mucked
Seat 5: sólyom333 folded before Flop (didn't bet)
Seat 6: maltsevig (button) folded before Flop (didn't bet)



PokerStars Hand #222970827400:  Hold'em No Limit ($0.05/$0.10 USD) - 2021/01/23 16:00:15 ET
Table 'Shura III' 6-max Seat #1 is the button
Seat 1: Cheetham2020 ($14.12 in chips) 
Seat 2: Manon4ik ($12.15 in chips) 
Seat 3: odonro ($20.85 in chips) 
Seat 4: Neaishqs8787 ($12.79 in chips) 
Seat 5: sólyom333 ($14.48 in chips) 
Seat 6: maltsevig ($14.69 in chips) 
Manon4ik: posts small blind $0.05
odonro: posts big blind $0.10
*** HOLE CARDS ***
Neaishqs8787: calls $0.10
sólyom333: folds 
maltsevig: folds 
Cheetham2020 has timed out
Cheetham2020: folds 
Manon4ik: calls $0.05
odonro: checks 
*** FLOP *** [3d Js Tc]
Manon4ik: checks 
odonro: bets $0.29
Neaishqs8787: calls $0.29
Manon4ik: folds 
*** TURN *** [3d Js Tc] [Th]
odonro: checks 
Neaishqs8787: checks 
*** RIVER *** [3d Js Tc Th] [Ks]
odonro: bets $0.84
Neaishqs8787: folds 
Uncalled bet ($0.84) returned to odonro
odonro collected $0.84 from pot
odonro: doesn't show hand 
*** SUMMARY ***
Total pot $0.88 | Rake $0.04 
Board [3d Js Tc Th Ks]
Seat 1: Cheetham2020 (button) folded before Flop (didn't bet)
Seat 2: Manon4ik (small blind) folded on the Flop
Seat 3: odonro (big blind) collected ($0.84)
Seat 4: Neaishqs8787 folded on the River
Seat 5: sólyom333 folded before Flop (didn't bet)
Seat 6: maltsevig folded before Flop (didn't bet)



PokerStars Hand #222970855711:  Hold'em No Limit ($0.05/$0.10 USD) - 2021/01/23 16:01:00 ET
Table 'Shura III' 6-max Seat #2 is the button
Seat 1: Cheetham2020 ($14.12 in chips) 
Seat 2: Manon4ik ($12.05 in chips) 
Seat 3: odonro ($21.30 in chips) 
Seat 4: Neaishqs8787 ($12.40 in chips) 
Seat 5: sólyom333 ($14.48 in chips) 
Seat 6: maltsevig ($14.69 in chips) 
odonro: posts small blind $0.05
Neaishqs8787: posts big blind $0.10
*** HOLE CARDS ***
sólyom333: raises $0.18 to $0.28
maltsevig: folds 
Cheetham2020 has timed out
Cheetham2020: folds 
Manon4ik: folds 
odonro: folds 
Neaishqs8787: calls $0.18
*** FLOP *** [7c 9s 4d]
Neaishqs8787: checks 
sólyom333: checks 
*** TURN *** [7c 9s 4d] [6s]
Neaishqs8787: checks 
sólyom333: bets $0.39
Neaishqs8787: folds 
Uncalled bet ($0.39) returned to sólyom333
sólyom333 collected $0.58 from pot
sólyom333: doesn't show hand 
*** SUMMARY ***
Total pot $0.61 | Rake $0.03 
Board [7c 9s 4d 6s]
Seat 1: Cheetham2020 folded before Flop (didn't bet)
Seat 2: Manon4ik (button) folded before Flop (didn't bet)
Seat 3: odonro (small blind) folded before Flop
Seat 4: Neaishqs8787 (big blind) folded on the Turn
Seat 5: sólyom333 collected ($0.58)
Seat 6: maltsevig folded before Flop (didn't bet)



PokerStars Hand #222970879814:  Hold'em No Limit ($0.05/$0.10 USD) - 2021/01/23 16:01:34 ET
Table 'Shura III' 6-max Seat #3 is the button
Seat 1: Cheetham2020 ($14.12 in chips) 
Seat 2: Manon4ik ($12.05 in chips) 
Seat 3: odonro ($21.25 in chips) 
Seat 4: Neaishqs8787 ($12.12 in chips) 
Seat 5: sólyom333 ($14.78 in chips) 
Seat 6: maltsevig ($14.69 in chips) 
Neaishqs8787: posts small blind $0.05
sólyom333: posts big blind $0.10
*** HOLE CARDS ***
maltsevig: raises $0.20 to $0.30
Cheetham2020: raises $0.20 to $0.50
Manon4ik: folds 
odonro: folds 
Neaishqs8787: calls $0.45
sólyom333: folds 
maltsevig: calls $0.20
*** FLOP *** [3h Th 7h]
Neaishqs8787: checks 
maltsevig: checks 
Cheetham2020: bets $1.20
Neaishqs8787: folds 
maltsevig: folds 
Uncalled bet ($1.20) returned to Cheetham2020
Cheetham2020 collected $1.53 from pot
Cheetham2020: doesn't show hand 
*** SUMMARY ***
Total pot $1.60 | Rake $0.07 
Board [3h Th 7h]
Seat 1: Cheetham2020 collected ($1.53)
Seat 2: Manon4ik folded before Flop (didn't bet)
Seat 3: odonro (button) folded before Flop (didn't bet)
Seat 4: Neaishqs8787 (small blind) folded on the Flop
Seat 5: sólyom333 (big blind) folded before Flop
Seat 6: maltsevig folded on the Flop



PokerStars Hand #222970912310:  Hold'em No Limit ($0.05/$0.10 USD) - 2021/01/23 16:02:17 ET
Table 'Shura III' 6-max Seat #4 is the button
Seat 1: Cheetham2020 ($15.15 in chips) 
Seat 2: Manon4ik ($12.05 in chips) 
Seat 3: odonro ($21.25 in chips) 
Seat 4: Neaishqs8787 ($11.62 in chips) 
Seat 5: sólyom333 ($14.68 in chips) 
Seat 6: maltsevig ($14.19 in chips) 
sólyom333: posts small blind $0.05
maltsevig: posts big blind $0.10
*** HOLE CARDS ***
Cheetham2020 has timed out
Cheetham2020: folds 
Manon4ik: folds 
odonro: calls $0.10
Neaishqs8787: calls $0.10
sólyom333: folds 
maltsevig: checks 
*** FLOP *** [5c 4s Ah]
maltsevig: checks 
odonro: checks 
Neaishqs8787: checks 
*** TURN *** [5c 4s Ah] [Ts]
maltsevig: checks 
odonro: checks 
Neaishqs8787: checks 
*** RIVER *** [5c 4s Ah Ts] [Qc]
maltsevig: checks 
odonro: checks 
Neaishqs8787: checks 
*** SHOW DOWN ***
maltsevig: shows [8c 4h] (a pair of Fours)
odonro: shows [Qs 9c] (a pair of Queens)
Neaishqs8787: mucks hand 
odonro collected $0.33 from pot
*** SUMMARY ***
Total pot $0.35 | Rake $0.02 
Board [5c 4s Ah Ts Qc]
Seat 1: Cheetham2020 folded before Flop (didn't bet)
Seat 2: Manon4ik folded before Flop (didn't bet)
Seat 3: odonro showed [Qs 9c] and won ($0.33) with a pair of Queens
Seat 4: Neaishqs8787 (button) mucked
Seat 5: sólyom333 (small blind) folded before Flop
Seat 6: maltsevig (big blind) showed [8c 4h] and lost with a pair of Fours



PokerStars Hand #222970947868:  Hold'em No Limit ($0.05/$0.10 USD) - 2021/01/23 16:03:02 ET
Table 'Shura III' 6-max Seat #5 is the button
Seat 1: Cheetham2020 ($15.15 in chips) 
Seat 2: Manon4ik ($12.05 in chips) 
Seat 3: odonro ($21.48 in chips) 
Seat 4: Neaishqs8787 ($11.52 in chips) 
Seat 5: sólyom333 ($14.63 in chips) 
Seat 6: maltsevig ($14.09 in chips) 
maltsevig: posts small blind $0.05
Cheetham2020: posts big blind $0.10
*** HOLE CARDS ***
Manon4ik: folds 
odonro: raises $0.25 to $0.35
Neaishqs8787: calls $0.35
sólyom333: folds 
maltsevig: raises $1.25 to $1.60
Cheetham2020: folds 
odonro: calls $1.25
Neaishqs8787: calls $1.25
*** FLOP *** [7s 2h 8d]
maltsevig: bets $1.87
odonro: folds 
Neaishqs8787: raises $4.21 to $6.08
maltsevig: raises $6.41 to $12.49 and is all-in
Neaishqs8787: calls $3.84 and is all-in
Uncalled bet ($2.57) returned to maltsevig
*** TURN *** [7s 2h 8d] [9h]
*** RIVER *** [7s 2h 8d 9h] [Qd]
*** SHOW DOWN ***
maltsevig: shows [Kc Kh] (a pair of Kings)
Neaishqs8787: shows [9d 6h] (a pair of Nines)
maltsevig collected $23.63 from pot
*** SUMMARY ***
Total pot $24.74 | Rake $1.11 
Board [7s 2h 8d 9h Qd]
Seat 1: Cheetham2020 (big blind) folded before Flop
Seat 2: Manon4ik folded before Flop (didn't bet)
Seat 3: odonro folded on the Flop
Seat 4: Neaishqs8787 showed [9d 6h] and lost with a pair of Nines
Seat 5: sólyom333 (button) folded before Flop (didn't bet)
Seat 6: maltsevig (small blind) showed [Kc Kh] and won ($23.63) with a pair of Kings



PokerStars Hand #222971014601:  Hold'em No Limit ($0.05/$0.10 USD) - 2021/01/23 16:04:23 ET
Table 'Shura III' 6-max Seat #6 is the button
Seat 1: Cheetham2020 ($15.05 in chips) 
Seat 2: Manon4ik ($12.05 in chips) 
Seat 3: odonro ($19.88 in chips) 
Seat 5: sólyom333 ($14.63 in chips) 
Seat 6: maltsevig ($26.20 in chips) 
Cheetham2020: posts small blind $0.05
Manon4ik: posts big blind $0.10
*** HOLE CARDS ***
odonro: raises $0.25 to $0.35
sólyom333: folds 
maltsevig: folds 
Cheetham2020: folds 
Manon4ik: folds 
Uncalled bet ($0.25) returned to odonro
odonro collected $0.25 from pot
odonro: doesn't show hand 
*** SUMMARY ***
Total pot $0.25 | Rake $0 
Seat 1: Cheetham2020 (small blind) folded before Flop
Seat 2: Manon4ik (big blind) folded before Flop
Seat 3: odonro collected ($0.25)
Seat 5: sólyom333 folded before Flop (didn't bet)
Seat 6: maltsevig (button) folded before Flop (didn't bet)



PokerStars Hand #222971034637:  Hold'em No Limit ($0.05/$0.10 USD) - 2021/01/23 16:04:47 ET
Table 'Shura III' 6-max Seat #1 is the button
Seat 1: Cheetham2020 ($15 in chips) 
Seat 2: Manon4ik ($11.95 in chips) 
Seat 3: odonro ($20.03 in chips) 
Seat 4: Neaishqs8787 ($10 in chips) 
Seat 5: sólyom333 ($14.63 in chips) 
Seat 6: maltsevig ($26.20 in chips) 
Manon4ik: posts small blind $0.05
odonro: posts big blind $0.10
*** HOLE CARDS ***
Neaishqs8787: calls $0.10
sólyom333: raises $0.20 to $0.30
maltsevig: folds 
Cheetham2020 has timed out
Cheetham2020: folds 
Manon4ik: folds 
odonro: calls $0.20
Neaishqs8787: calls $0.20
*** FLOP *** [As 8h Qd]
odonro: checks 
Neaishqs8787: checks 
sólyom333: bets $0.38
odonro: folds 
Neaishqs8787: folds 
Uncalled bet ($0.38) returned to sólyom333
sólyom333 collected $0.91 from pot
sólyom333: doesn't show hand 
*** SUMMARY ***
Total pot $0.95 | Rake $0.04 
Board [As 8h Qd]
Seat 1: Cheetham2020 (button) folded before Flop (didn't bet)
Seat 2: Manon4ik (small blind) folded before Flop
Seat 3: odonro (big blind) folded on the Flop
Seat 4: Neaishqs8787 folded on the Flop
Seat 5: sólyom333 collected ($0.91)
Seat 6: maltsevig folded before Flop (didn't bet)



PokerStars Hand #222971080914:  Hold'em No Limit ($0.05/$0.10 USD) - 2021/01/23 16:05:42 ET
Table 'Shura III' 6-max Seat #2 is the button
Seat 1: Cheetham2020 ($15 in chips) 
Seat 2: Manon4ik ($11.90 in chips) 
Seat 3: odonro ($19.73 in chips) 
Seat 4: Neaishqs8787 ($9.70 in chips) 
Seat 5: sólyom333 ($15.24 in chips) 
Seat 6: maltsevig ($26.20 in chips) 
odonro: posts small blind $0.05
Neaishqs8787: posts big blind $0.10
*** HOLE CARDS ***
sólyom333: raises $0.18 to $0.28
maltsevig: folds 
Cheetham2020: calls $0.28
Manon4ik: folds 
odonro: calls $0.23
Neaishqs8787: calls $0.18
*** FLOP *** [6s Ah 7d]
odonro: checks 
Neaishqs8787: checks 
sólyom333: bets $0.45
Cheetham2020: calls $0.45
odonro: folds 
Neaishqs8787: calls $0.45
*** TURN *** [6s Ah 7d] [5d]
Neaishqs8787: checks 
sólyom333: bets $1.57
Cheetham2020: calls $1.57
Neaishqs8787: folds 
*** RIVER *** [6s Ah 7d 5d] [9s]
sólyom333: checks 
Cheetham2020: checks 
*** SHOW DOWN ***
sólyom333: shows [Ts Ad] (a pair of Aces)
Cheetham2020: shows [8h Qd] (a straight, Five to Nine)
Cheetham2020 collected $5.36 from pot
*** SUMMARY ***
Total pot $5.61 | Rake $0.25 
Board [6s Ah 7d 5d 9s]
Seat 1: Cheetham2020 showed [8h Qd] and won ($5.36) with a straight, Five to Nine
Seat 2: Manon4ik (button) folded before Flop (didn't bet)
Seat 3: odonro (small blind) folded on the Flop
Seat 4: Neaishqs8787 (big blind) folded on the Turn
Seat 5: sólyom333 showed [Ts Ad] and lost with a pair of Aces
Seat 6: maltsevig folded before Flop (didn't bet)



PokerStars Hand #222971158114:  Hold'em No Limit ($0.05/$0.10 USD) - 2021/01/23 16:07:15 ET
Table 'Shura III' 6-max Seat #3 is the button
Seat 1: Cheetham2020 ($18.06 in chips) 
Seat 2: Manon4ik ($11.90 in chips) 
Seat 3: odonro ($19.45 in chips) 
Seat 4: Neaishqs8787 ($8.97 in chips) 
Seat 5: sólyom333 ($12.94 in chips) 
Seat 6: maltsevig ($26.20 in chips) 
Neaishqs8787: posts small blind $0.05
sólyom333: posts big blind $0.10
*** HOLE CARDS ***
maltsevig: raises $0.20 to $0.30
Cheetham2020 has timed out
Cheetham2020: folds 
Manon4ik: folds 
odonro: folds 
Neaishqs8787: calls $0.25
sólyom333: raises $0.85 to $1.15
maltsevig: calls $0.85
Neaishqs8787: calls $0.85
*** FLOP *** [2d 2c Td]
Neaishqs8787: bets $3.29
sólyom333: folds 
maltsevig: folds 
Uncalled bet ($3.29) returned to Neaishqs8787
Neaishqs8787 collected $3.29 from pot
Neaishqs8787: doesn't show hand 
*** SUMMARY ***
Total pot $3.45 | Rake $0.16 
Board [2d 2c Td]
Seat 1: Cheetham2020 folded before Flop (didn't bet)
Seat 2: Manon4ik folded before Flop (didn't bet)
Seat 3: odonro (button) folded before Flop (didn't bet)
Seat 4: Neaishqs8787 (small blind) collected ($3.29)
Seat 5: sólyom333 (big blind) folded on the Flop
Seat 6: maltsevig folded on the Flop



PokerStars Hand #222971209242:  Hold'em No Limit ($0.05/$0.10 USD) - 2021/01/23 16:08:16 ET
Table 'Shura III' 6-max Seat #4 is the button
Seat 2: Manon4ik ($11.90 in chips) 
Seat 3: odonro ($19.45 in chips) 
Seat 4: Neaishqs8787 ($11.11 in chips) 
Seat 5: sólyom333 ($11.79 in chips) 
Seat 6: maltsevig ($25.05 in chips) 
sólyom333: posts small blind $0.05
maltsevig: posts big blind $0.10
*** HOLE CARDS ***
Manon4ik: folds 
odonro: raises $0.10 to $0.20
Neaishqs8787: calls $0.20
sólyom333: calls $0.15
maltsevig: raises $1.20 to $1.40
odonro: calls $1.20
Neaishqs8787: calls $1.20
sólyom333: folds 
*** FLOP *** [7h Td 9d]
maltsevig: checks 
odonro: bets $4.20
Neaishqs8787: raises $4.20 to $8.40
maltsevig: folds 
odonro: raises $4.20 to $12.60
Neaishqs8787: calls $1.31 and is all-in
Uncalled bet ($2.89) returned to odonro
*** TURN *** [7h Td 9d] [2h]
*** RIVER *** [7h Td 9d 2h] [8d]
*** SHOW DOWN ***
odonro: shows [7d Ad] (a flush, Ace high)
Neaishqs8787: shows [8h 7s] (two pair, Eights and Sevens)
odonro collected $22.75 from pot
*** SUMMARY ***
Total pot $23.82 | Rake $1.07 
Board [7h Td 9d 2h 8d]
Seat 2: Manon4ik folded before Flop (didn't bet)
Seat 3: odonro showed [7d Ad] and won ($22.75) with a flush, Ace high
Seat 4: Neaishqs8787 (button) showed [8h 7s] and lost with two pair, Eights and Sevens
Seat 5: sólyom333 (small blind) folded before Flop
Seat 6: maltsevig (big blind) folded on the Flop



PokerStars Hand #222971242516:  Hold'em No Limit ($0.05/$0.10 USD) - 2021/01/23 16:08:56 ET
Table 'Shura III' 6-max Seat #5 is the button
Seat 2: Manon4ik ($11.90 in chips) 
Seat 3: odonro ($31.09 in chips) 
Seat 5: sólyom333 ($11.59 in chips) 
Seat 6: maltsevig ($23.65 in chips) 
maltsevig: posts small blind $0.05
Manon4ik: posts big blind $0.10
*** HOLE CARDS ***
odonro: calls $0.10
sólyom333: raises $0.18 to $0.28
maltsevig: folds 
Manon4ik: folds 
odonro: calls $0.18
*** FLOP *** [2s 4d 8s]
odonro: checks 
Neaishqs8787 leaves the table
sólyom333: bets $0.29
odonro: calls $0.29
*** TURN *** [2s 4d 8s] [6s]
odonro: checks 
sólyom333: checks 
*** RIVER *** [2s 4d 8s 6s] [7s]
odonro: bets $1.23
sólyom333: folds 
Uncalled bet ($1.23) returned to odonro
odonro collected $1.23 from pot
odonro: doesn't show hand 
and 07335 joins the table at seat #4 
*** SUMMARY ***
Total pot $1.29 | Rake $0.06 
Board [2s 4d 8s 6s 7s]
Seat 2: Manon4ik (big blind) folded before Flop
Seat 3: odonro collected ($1.23)
Seat 5: sólyom333 (button) folded on the River
Seat 6: maltsevig (small blind) folded before Flop



PokerStars Hand #222971271204:  Hold'em No Limit ($0.05/$0.10 USD) - 2021/01/23 16:09:31 ET
Table 'Shura III' 6-max Seat #6 is the button
Seat 2: Manon4ik ($11.80 in chips) 
Seat 3: odonro ($31.75 in chips) 
Seat 5: sólyom333 ($11.02 in chips) 
Seat 6: maltsevig ($23.60 in chips) 
Manon4ik: posts small blind $0.05
odonro: posts big blind $0.10
and 07335: sits out 
*** HOLE CARDS ***
sólyom333: folds 
maltsevig: raises $0.10 to $0.20
Manon4ik: calls $0.15
odonro: calls $0.10
*** FLOP *** [Jc Qh Kd]
Manon4ik: checks 
odonro: checks 
maltsevig: checks 
*** TURN *** [Jc Qh Kd] [Ad]
Manon4ik: checks 
odonro: checks 
maltsevig: bets $0.37
Manon4ik: folds 
odonro: folds 
Uncalled bet ($0.37) returned to maltsevig
maltsevig collected $0.57 from pot
maltsevig: doesn't show hand 
*** SUMMARY ***
Total pot $0.60 | Rake $0.03 
Board [Jc Qh Kd Ad]
Seat 2: Manon4ik (small blind) folded on the Turn
Seat 3: odonro (big blind) folded on the Turn
Seat 5: sólyom333 folded before Flop (didn't bet)
Seat 6: maltsevig (button) collected ($0.57)



PokerStars Hand #222971299452:  Hold'em No Limit ($0.05/$0.10 USD) - 2021/01/23 16:10:05 ET
Table 'Shura III' 6-max Seat #2 is the button
Seat 1: Cheetham2020 ($18.06 in chips) 
Seat 2: Manon4ik ($11.60 in chips) 
Seat 3: odonro ($31.55 in chips) 
Seat 4: and 07335 ($10 in chips) 
Seat 5: sólyom333 ($11.02 in chips) 
Seat 6: maltsevig ($23.97 in chips) 
odonro: posts small blind $0.05
and 07335: posts big blind $0.10
Cheetham2020: posts small & big blinds $0.15
*** HOLE CARDS ***
sólyom333: raises $0.25 to $0.35
maltsevig: folds 
Cheetham2020: raises $0.25 to $0.60
Manon4ik: folds 
odonro: folds 
and 07335: folds 
sólyom333: calls $0.25
*** FLOP *** [7h Kd Kc]
sólyom333: checks 
Cheetham2020: checks 
*** TURN *** [7h Kd Kc] [4d]
sólyom333: bets $0.89
Cheetham2020: calls $0.89
*** RIVER *** [7h Kd Kc 4d] [6h]
sólyom333: bets $2.03
Cheetham2020: folds 
Uncalled bet ($2.03) returned to sólyom333
sólyom333 collected $3.04 from pot
sólyom333: doesn't show hand 
*** SUMMARY ***
Total pot $3.18 | Rake $0.14 
Board [7h Kd Kc 4d 6h]
Seat 1: Cheetham2020 folded on the River
Seat 2: Manon4ik (button) folded before Flop (didn't bet)
Seat 3: odonro (small blind) folded before Flop
Seat 4: and 07335 (big blind) folded before Flop
Seat 5: sólyom333 collected ($3.04)
Seat 6: maltsevig folded before Flop (didn't bet)



PokerStars Hand #222971342919:  Hold'em No Limit ($0.05/$0.10 USD) - 2021/01/23 16:10:56 ET
Table 'Shura III' 6-max Seat #3 is the button
Seat 1: Cheetham2020 ($16.52 in chips) 
Seat 2: Manon4ik ($11.60 in chips) 
Seat 3: odonro ($31.50 in chips) 
Seat 4: and 07335 ($10 in chips) 
Seat 5: sólyom333 ($12.57 in chips) 
Seat 6: maltsevig ($23.97 in chips) 
and 07335: posts small blind $0.05
sólyom333: posts big blind $0.10
*** HOLE CARDS ***
maltsevig: raises $0.20 to $0.30
Cheetham2020: folds 
Manon4ik: folds 
odonro: calls $0.30
and 07335: folds 
sólyom333: folds 
*** FLOP *** [6s 8s Tc]
maltsevig: checks 
odonro: bets $0.72
maltsevig: folds 
Uncalled bet ($0.72) returned to odonro
odonro collected $0.72 from pot
odonro: doesn't show hand 
*** SUMMARY ***
Total pot $0.75 | Rake $0.03 
Board [6s 8s Tc]
Seat 1: Cheetham2020 folded before Flop (didn't bet)
Seat 2: Manon4ik folded before Flop (didn't bet)
Seat 3: odonro (button) collected ($0.72)
Seat 4: and 07335 (small blind) folded before Flop
Seat 5: sólyom333 (big blind) folded before Flop
Seat 6: maltsevig folded on the Flop



PokerStars Hand #222971364743:  Hold'em No Limit ($0.05/$0.10 USD) - 2021/01/23 16:11:23 ET
Table 'Shura III' 6-max Seat #4 is the button
Seat 1: Cheetham2020 ($16.52 in chips) 
Seat 2: Manon4ik ($11.60 in chips) 
Seat 3: odonro ($31.92 in chips) 
Seat 4: and 07335 ($10 in chips) 
Seat 5: sólyom333 ($12.47 in chips) 
Seat 6: maltsevig ($23.67 in chips) 
sólyom333: posts small blind $0.05
maltsevig: posts big blind $0.10
*** HOLE CARDS ***
Cheetham2020 has timed out
Cheetham2020: folds 
Manon4ik: folds 
odonro: calls $0.10
and 07335: folds 
sólyom333: raises $0.35 to $0.45
maltsevig: folds 
odonro: calls $0.35
*** FLOP *** [4d As 7h]
sólyom333: bets $0.40
odonro: folds 
Uncalled bet ($0.40) returned to sólyom333
sólyom333 collected $0.96 from pot
sólyom333: doesn't show hand 
*** SUMMARY ***
Total pot $1 | Rake $0.04 
Board [4d As 7h]
Seat 1: Cheetham2020 folded before Flop (didn't bet)
Seat 2: Manon4ik folded before Flop (didn't bet)
Seat 3: odonro folded on the Flop
Seat 4: and 07335 (button) folded before Flop (didn't bet)
Seat 5: sólyom333 (small blind) collected ($0.96)
Seat 6: maltsevig (big blind) folded before Flop



PokerStars Hand #222971386313:  Hold'em No Limit ($0.05/$0.10 USD) - 2021/01/23 16:11:49 ET
Table 'Shura III' 6-max Seat #5 is the button
Seat 1: Cheetham2020 ($16.52 in chips) 
Seat 2: Manon4ik ($11.60 in chips) 
Seat 3: odonro ($31.47 in chips) 
Seat 4: and 07335 ($10 in chips) 
Seat 5: sólyom333 ($12.98 in chips) 
Seat 6: maltsevig ($23.57 in chips) 
maltsevig: posts small blind $0.05
Cheetham2020: posts big blind $0.10
*** HOLE CARDS ***
Manon4ik: folds 
odonro: folds 
and 07335: folds 
sólyom333: folds 
maltsevig: raises $0.20 to $0.30
Cheetham2020: folds 
Uncalled bet ($0.20) returned to maltsevig
maltsevig collected $0.20 from pot
maltsevig: doesn't show hand 
*** SUMMARY ***
Total pot $0.20 | Rake $0 
Seat 1: Cheetham2020 (big blind) folded before Flop
Seat 2: Manon4ik folded before Flop (didn't bet)
Seat 3: odonro folded before Flop (didn't bet)
Seat 4: and 07335 folded before Flop (didn't bet)
Seat 5: sólyom333 (button) folded before Flop (didn't bet)
Seat 6: maltsevig (small blind) collected ($0.20)



PokerStars Hand #222971406835:  Hold'em No Limit ($0.05/$0.10 USD) - 2021/01/23 16:12:14 ET
Table 'Shura III' 6-max Seat #6 is the button
Seat 1: Cheetham2020 ($16.42 in chips) 
Seat 2: Manon4ik ($11.60 in chips) 
Seat 3: odonro ($31.47 in chips) 
Seat 4: and 07335 ($10 in chips) 
Seat 5: sólyom333 ($12.98 in chips) 
Seat 6: maltsevig ($23.67 in chips) 
Cheetham2020: posts small blind $0.05
Manon4ik: posts big blind $0.10
*** HOLE CARDS ***
odonro: calls $0.10
and 07335: folds 
sólyom333: raises $0.20 to $0.30
maltsevig: folds 
Cheetham2020: calls $0.25
Manon4ik: folds 
odonro: calls $0.20
*** FLOP *** [Ac Th Kh]
Cheetham2020 has timed out
Cheetham2020: checks 
odonro: checks 
sólyom333: checks 
*** TURN *** [Ac Th Kh] [6d]
Cheetham2020 has timed out
Cheetham2020: checks 
odonro: checks 
sólyom333: checks 
*** RIVER *** [Ac Th Kh 6d] [4s]
Cheetham2020: checks 
odonro: checks 
sólyom333: checks 
*** SHOW DOWN ***
Cheetham2020: shows [9s 9c] (a pair of Nines)
odonro: mucks hand 
sólyom333: mucks hand 
Cheetham2020 collected $0.96 from pot
*** SUMMARY ***
Total pot $1 | Rake $0.04 
Board [Ac Th Kh 6d 4s]
Seat 1: Cheetham2020 (small blind) showed [9s 9c] and won ($0.96) with a pair of Nines
Seat 2: Manon4ik (big blind) folded before Flop
Seat 3: odonro mucked
Seat 4: and 07335 folded before Flop (didn't bet)
Seat 5: sólyom333 mucked
Seat 6: maltsevig (button) folded before Flop (didn't bet)



PokerStars Hand #222971479232:  Hold'em No Limit ($0.05/$0.10 USD) - 2021/01/23 16:13:32 ET
Table 'Shura III' 6-max Seat #1 is the button
Seat 1: Cheetham2020 ($17.08 in chips) 
Seat 2: Manon4ik ($11.50 in chips) 
Seat 4: and 07335 ($10 in chips) 
Seat 5: sólyom333 ($12.68 in chips) 
Seat 6: maltsevig ($23.67 in chips) 
Manon4ik: posts small blind $0.05
odonro: is sitting out 
and 07335: posts big blind $0.10
*** HOLE CARDS ***
sólyom333: folds 
maltsevig: folds 
Cheetham2020 has timed out
Cheetham2020: folds 
Manon4ik: folds 
Uncalled bet ($0.05) returned to and 07335
and 07335 collected $0.10 from pot
and 07335: doesn't show hand 
*** SUMMARY ***
Total pot $0.10 | Rake $0 
Seat 1: Cheetham2020 (button) folded before Flop (didn't bet)
Seat 2: Manon4ik (small blind) folded before Flop
Seat 4: and 07335 (big blind) collected ($0.10)
Seat 5: sólyom333 folded before Flop (didn't bet)
Seat 6: maltsevig folded before Flop (didn't bet)



PokerStars Hand #222971493884:  Hold'em No Limit ($0.05/$0.10 USD) - 2021/01/23 16:13:50 ET
Table 'Shura III' 6-max Seat #2 is the button
Seat 1: Cheetham2020 ($17.08 in chips) 
Seat 2: Manon4ik ($11.45 in chips) 
Seat 4: and 07335 ($10.05 in chips) 
Seat 5: sólyom333 ($12.68 in chips) 
Seat 6: maltsevig ($23.67 in chips) 
and 07335: posts small blind $0.05
sólyom333: posts big blind $0.10
*** HOLE CARDS ***
maltsevig: folds 
Cheetham2020: calls $0.10
Manon4ik: raises $0.25 to $0.35
and 07335: folds 
sólyom333: folds 
odonro is disconnected 
Cheetham2020: calls $0.25
*** FLOP *** [Ac 6s Ad]
Cheetham2020 has timed out
Cheetham2020: checks 
Manon4ik: checks 
*** TURN *** [Ac 6s Ad] [Tc]
Cheetham2020 has timed out
Cheetham2020: checks 
Manon4ik: checks 
*** RIVER *** [Ac 6s Ad Tc] [Kc]
Cheetham2020: checks 
Manon4ik: checks 
*** SHOW DOWN ***
Cheetham2020: shows [Ts 7c] (two pair, Aces and Tens)
Manon4ik: mucks hand 
Cheetham2020 collected $0.81 from pot
*** SUMMARY ***
Total pot $0.85 | Rake $0.04 
Board [Ac 6s Ad Tc Kc]
Seat 1: Cheetham2020 showed [Ts 7c] and won ($0.81) with two pair, Aces and Tens
Seat 2: Manon4ik (button) mucked
Seat 4: and 07335 (small blind) folded before Flop
Seat 5: sólyom333 (big blind) folded before Flop
Seat 6: maltsevig folded before Flop (didn't bet)



PokerStars Hand #222971561997:  Hold'em No Limit ($0.05/$0.10 USD) - 2021/01/23 16:15:12 ET
Table 'Shura III' 6-max Seat #4 is the button
Seat 1: Cheetham2020 ($17.54 in chips) 
Seat 2: Manon4ik ($11.10 in chips) 
Seat 4: and 07335 ($10 in chips) 
Seat 5: sólyom333 ($12.58 in chips) 
Seat 6: maltsevig ($23.67 in chips) 
sólyom333: posts small blind $0.05
maltsevig: posts big blind $0.10
*** HOLE CARDS ***
Cheetham2020 has timed out
Cheetham2020: folds 
Manon4ik: folds 
and 07335: folds 
sólyom333: raises $0.20 to $0.30
maltsevig: calls $0.20
*** FLOP *** [3s 5d 2s]
sólyom333: checks 
maltsevig: bets $0.37
sólyom333: calls $0.37
*** TURN *** [3s 5d 2s] [Qc]
sólyom333: checks 
maltsevig: bets $0.83
sólyom333: folds 
Uncalled bet ($0.83) returned to maltsevig
maltsevig collected $1.28 from pot
maltsevig: doesn't show hand 
*** SUMMARY ***
Total pot $1.34 | Rake $0.06 
Board [3s 5d 2s Qc]
Seat 1: Cheetham2020 folded before Flop (didn't bet)
Seat 2: Manon4ik folded before Flop (didn't bet)
Seat 4: and 07335 (button) folded before Flop (didn't bet)
Seat 5: sólyom333 (small blind) folded on the Turn
Seat 6: maltsevig (big blind) collected ($1.28)



PokerStars Hand #222971595504:  Hold'em No Limit ($0.05/$0.10 USD) - 2021/01/23 16:15:51 ET
Table 'Shura III' 6-max Seat #5 is the button
Seat 1: Cheetham2020 ($17.54 in chips) 
Seat 2: Manon4ik ($11.10 in chips) 
Seat 3: odonro ($31.17 in chips) 
Seat 4: and 07335 ($10 in chips) 
Seat 5: sólyom333 ($11.91 in chips) 
Seat 6: maltsevig ($24.28 in chips) 
maltsevig: posts small blind $0.05
Cheetham2020: posts big blind $0.10
odonro: posts small & big blinds $0.15
*** HOLE CARDS ***
Manon4ik: folds 
odonro: checks 
and 07335: folds 
sólyom333: folds 
maltsevig: folds 
Cheetham2020 has timed out
Cheetham2020: checks 
*** FLOP *** [5d 8c Qc]
Cheetham2020: checks 
odonro: checks 
*** TURN *** [5d 8c Qc] [6s]
Cheetham2020: checks 
odonro: bets $0.29
Cheetham2020: folds 
Uncalled bet ($0.29) returned to odonro
odonro collected $0.29 from pot
odonro: doesn't show hand 
*** SUMMARY ***
Total pot $0.30 | Rake $0.01 
Board [5d 8c Qc 6s]
Seat 1: Cheetham2020 (big blind) folded on the Turn
Seat 2: Manon4ik folded before Flop (didn't bet)
Seat 3: odonro collected ($0.29)
Seat 4: and 07335 folded before Flop (didn't bet)
Seat 5: sólyom333 (button) folded before Flop (didn't bet)
Seat 6: maltsevig (small blind) folded before Flop



PokerStars Hand #222971635564:  Hold'em No Limit ($0.05/$0.10 USD) - 2021/01/23 16:16:37 ET
Table 'Shura III' 6-max Seat #6 is the button
Seat 1: Cheetham2020 ($17.44 in chips) 
Seat 2: Manon4ik ($11.10 in chips) 
Seat 3: odonro ($31.31 in chips) 
Seat 4: and 07335 ($10 in chips) 
Seat 5: sólyom333 ($11.91 in chips) 
Seat 6: maltsevig ($24.23 in chips) 
Cheetham2020: posts small blind $0.05
Manon4ik: posts big blind $0.10
*** HOLE CARDS ***
odonro: folds 
and 07335: folds 
sólyom333: folds 
maltsevig: folds 
Cheetham2020 has timed out
Cheetham2020: folds 
Uncalled bet ($0.05) returned to Manon4ik
Manon4ik collected $0.10 from pot
Manon4ik: doesn't show hand 
*** SUMMARY ***
Total pot $0.10 | Rake $0 
Seat 1: Cheetham2020 (small blind) folded before Flop
Seat 2: Manon4ik (big blind) collected ($0.10)
Seat 3: odonro folded before Flop (didn't bet)
Seat 4: and 07335 folded before Flop (didn't bet)
Seat 5: sólyom333 folded before Flop (didn't bet)
Seat 6: maltsevig (button) folded before Flop (didn't bet)



PokerStars Hand #222971652397:  Hold'em No Limit ($0.05/$0.10 USD) - 2021/01/23 16:16:57 ET
Table 'Shura III' 6-max Seat #2 is the button
Seat 2: Manon4ik ($11.15 in chips) 
Seat 3: odonro ($31.31 in chips) 
Seat 4: and 07335 ($10 in chips) 
Seat 5: sólyom333 ($11.91 in chips) 
Seat 6: maltsevig ($24.23 in chips) 
odonro: posts small blind $0.05
and 07335: posts big blind $0.10
*** HOLE CARDS ***
sólyom333: folds 
maltsevig: raises $0.20 to $0.30
Manon4ik: folds 
odonro: folds 
and 07335: folds 
Uncalled bet ($0.20) returned to maltsevig
maltsevig collected $0.25 from pot
maltsevig: doesn't show hand 
*** SUMMARY ***
Total pot $0.25 | Rake $0 
Seat 2: Manon4ik (button) folded before Flop (didn't bet)
Seat 3: odonro (small blind) folded before Flop
Seat 4: and 07335 (big blind) folded before Flop
Seat 5: sólyom333 folded before Flop (didn't bet)
Seat 6: maltsevig collected ($0.25)



PokerStars Hand #222971662594:  Hold'em No Limit ($0.05/$0.10 USD) - 2021/01/23 16:17:09 ET
Table 'Shura III' 6-max Seat #3 is the button
Seat 2: Manon4ik ($11.15 in chips) 
Seat 3: odonro ($31.26 in chips) 
Seat 4: and 07335 ($10 in chips) 
Seat 5: sólyom333 ($11.91 in chips) 
Seat 6: maltsevig ($24.38 in chips) 
and 07335: posts small blind $0.05
sólyom333: posts big blind $0.10
*** HOLE CARDS ***
maltsevig: folds 
Manon4ik: folds 
odonro: calls $0.10
and 07335: folds 
sólyom333: raises $0.35 to $0.45
odonro: calls $0.35
*** FLOP *** [7c 8h 8c]
sólyom333: checks 
odonro: bets $0.91
sólyom333: folds 
Uncalled bet ($0.91) returned to odonro
odonro collected $0.91 from pot
odonro: doesn't show hand 
*** SUMMARY ***
Total pot $0.95 | Rake $0.04 
Board [7c 8h 8c]
Seat 2: Manon4ik folded before Flop (didn't bet)
Seat 3: odonro (button) collected ($0.91)
Seat 4: and 07335 (small blind) folded before Flop
Seat 5: sólyom333 (big blind) folded on the Flop
Seat 6: maltsevig folded before Flop (didn't bet)



PokerStars Hand #222971684687:  Hold'em No Limit ($0.05/$0.10 USD) - 2021/01/23 16:17:34 ET
Table 'Shura III' 6-max Seat #4 is the button
Seat 2: Manon4ik ($11.15 in chips) 
Seat 3: odonro ($31.72 in chips) 
Seat 4: and 07335 ($10 in chips) 
Seat 5: sólyom333 ($11.46 in chips) 
Seat 6: maltsevig ($24.38 in chips) 
sólyom333: posts small blind $0.05
maltsevig: posts big blind $0.10
*** HOLE CARDS ***
Manon4ik: folds 
odonro: folds 
and 07335: folds 
sólyom333: folds 
Uncalled bet ($0.05) returned to maltsevig
maltsevig collected $0.10 from pot
maltsevig: doesn't show hand 
*** SUMMARY ***
Total pot $0.10 | Rake $0 
Seat 2: Manon4ik folded before Flop (didn't bet)
Seat 3: odonro folded before Flop (didn't bet)
Seat 4: and 07335 (button) folded before Flop (didn't bet)
Seat 5: sólyom333 (small blind) folded before Flop
Seat 6: maltsevig (big blind) collected ($0.10)



PokerStars Hand #222971703928:  Hold'em No Limit ($0.05/$0.10 USD) - 2021/01/23 16:17:57 ET
Table 'Shura III' 6-max Seat #5 is the button
Seat 3: odonro ($31.72 in chips) 
Seat 4: and 07335 ($10 in chips) 
Seat 5: sólyom333 ($11.41 in chips) 
Seat 6: maltsevig ($24.43 in chips) 
maltsevig: posts small blind $0.05
Manon4ik: is sitting out 
odonro: posts big blind $0.10
*** HOLE CARDS ***
and 07335: folds 
sólyom333: folds 
maltsevig: folds 
Uncalled bet ($0.05) returned to odonro
odonro collected $0.10 from pot
odonro: doesn't show hand 
*** SUMMARY ***
Total pot $0.10 | Rake $0 
Seat 3: odonro (big blind) collected ($0.10)
Seat 4: and 07335 folded before Flop (didn't bet)
Seat 5: sólyom333 (button) folded before Flop (didn't bet)
Seat 6: maltsevig (small blind) folded before Flop



PokerStars Hand #222971719277:  Hold'em No Limit ($0.05/$0.10 USD) - 2021/01/23 16:18:14 ET
Table 'Shura III' 6-max Seat #6 is the button
Seat 3: odonro ($31.77 in chips) 
Seat 4: and 07335 ($10 in chips) 
Seat 5: sólyom333 ($11.41 in chips) 
Seat 6: maltsevig ($24.38 in chips) 
odonro: posts small blind $0.05
and 07335: posts big blind $0.10
*** HOLE CARDS ***
sólyom333: raises $0.18 to $0.28
maltsevig: folds 
odonro: folds 
and 07335: folds 
Uncalled bet ($0.18) returned to sólyom333
sólyom333 collected $0.25 from pot
sólyom333: doesn't show hand 
*** SUMMARY ***
Total pot $0.25 | Rake $0 
Seat 3: odonro (small blind) folded before Flop
Seat 4: and 07335 (big blind) folded before Flop
Seat 5: sólyom333 collected ($0.25)
Seat 6: maltsevig (button) folded before Flop (didn't bet)



PokerStars Hand #222971742438:  Hold'em No Limit ($0.05/$0.10 USD) - 2021/01/23 16:18:41 ET
Table 'Shura III' 6-max Seat #3 is the button
Seat 3: odonro ($31.72 in chips) 
Seat 4: and 07335 ($10 in chips) 
Seat 5: sólyom333 ($11.56 in chips) 
Seat 6: maltsevig ($24.38 in chips) 
and 07335: posts small blind $0.05
sólyom333: posts big blind $0.10
*** HOLE CARDS ***
maltsevig: folds 
odonro: folds 
and 07335: raises $0.15 to $0.25
sólyom333: folds 
Uncalled bet ($0.15) returned to and 07335
and 07335 collected $0.20 from pot
and 07335: doesn't show hand 
*** SUMMARY ***
Total pot $0.20 | Rake $0 
Seat 3: odonro (button) folded before Flop (didn't bet)
Seat 4: and 07335 (small blind) collected ($0.20)
Seat 5: sólyom333 (big blind) folded before Flop
Seat 6: maltsevig folded before Flop (didn't bet)



PokerStars Hand #222971751936:  Hold'em No Limit ($0.05/$0.10 USD) - 2021/01/23 16:18:52 ET
Table 'Shura III' 6-max Seat #4 is the button
Seat 3: odonro ($31.72 in chips) 
Seat 4: and 07335 ($10.10 in chips) 
Seat 5: sólyom333 ($11.46 in chips) 
Seat 6: maltsevig ($24.38 in chips) 
sólyom333: posts small blind $0.05
maltsevig: posts big blind $0.10
*** HOLE CARDS ***
odonro: raises $0.10 to $0.20
and 07335: folds 
sólyom333: folds 
maltsevig: calls $0.10
*** FLOP *** [Tc 4d Kh]
maltsevig: checks 
odonro: bets $0.43
maltsevig: folds 
Uncalled bet ($0.43) returned to odonro
odonro collected $0.43 from pot
odonro: doesn't show hand 
*** SUMMARY ***
Total pot $0.45 | Rake $0.02 
Board [Tc 4d Kh]
Seat 3: odonro collected ($0.43)
Seat 4: and 07335 (button) folded before Flop (didn't bet)
Seat 5: sólyom333 (small blind) folded before Flop
Seat 6: maltsevig (big blind) folded on the Flop



PokerStars Hand #222971770971:  Hold'em No Limit ($0.05/$0.10 USD) - 2021/01/23 16:19:14 ET
Table 'Shura III' 6-max Seat #5 is the button
Seat 3: odonro ($31.95 in chips) 
Seat 4: and 07335 ($10.10 in chips) 
Seat 5: sólyom333 ($11.41 in chips) 
Seat 6: maltsevig ($24.18 in chips) 
maltsevig: posts small blind $0.05
odonro: posts big blind $0.10
*** HOLE CARDS ***
and 07335: folds 
sólyom333: folds 
maltsevig: raises $0.20 to $0.30
odonro: folds 
Uncalled bet ($0.20) returned to maltsevig
maltsevig collected $0.20 from pot
maltsevig: doesn't show hand 
*** SUMMARY ***
Total pot $0.20 | Rake $0 
Seat 3: odonro (big blind) folded before Flop
Seat 4: and 07335 folded before Flop (didn't bet)
Seat 5: sólyom333 (button) folded before Flop (didn't bet)
Seat 6: maltsevig (small blind) collected ($0.20)



PokerStars Hand #222971785703:  Hold'em No Limit ($0.05/$0.10 USD) - 2021/01/23 16:19:31 ET
Table 'Shura III' 6-max Seat #6 is the button
Seat 3: odonro ($31.85 in chips) 
Seat 4: and 07335 ($10.10 in chips) 
Seat 5: sólyom333 ($11.41 in chips) 
Seat 6: maltsevig ($24.28 in chips) 
odonro: posts small blind $0.05
and 07335: posts big blind $0.10
*** HOLE CARDS ***
sólyom333: folds 
maltsevig: raises $0.10 to $0.20
odonro: folds 
and 07335: folds 
Uncalled bet ($0.10) returned to maltsevig
maltsevig collected $0.25 from pot
maltsevig: doesn't show hand 
*** SUMMARY ***
Total pot $0.25 | Rake $0 
Seat 3: odonro (small blind) folded before Flop
Seat 4: and 07335 (big blind) folded before Flop
Seat 5: sólyom333 folded before Flop (didn't bet)
Seat 6: maltsevig (button) collected ($0.25)



PokerStars Hand #222971802903:  Hold'em No Limit ($0.05/$0.10 USD) - 2021/01/23 16:19:51 ET
Table 'Shura III' 6-max Seat #3 is the button
Seat 3: odonro ($31.80 in chips) 
Seat 4: and 07335 ($10 in chips) 
Seat 5: sólyom333 ($11.41 in chips) 
Seat 6: maltsevig ($24.43 in chips) 
and 07335: posts small blind $0.05
sólyom333: posts big blind $0.10
*** HOLE CARDS ***
maltsevig: folds 
odonro: folds 
and 07335: folds 
Uncalled bet ($0.05) returned to sólyom333
sólyom333 collected $0.10 from pot
sólyom333: doesn't show hand 
*** SUMMARY ***
Total pot $0.10 | Rake $0 
Seat 3: odonro (button) folded before Flop (didn't bet)
Seat 4: and 07335 (small blind) folded before Flop
Seat 5: sólyom333 (big blind) collected ($0.10)
Seat 6: maltsevig folded before Flop (didn't bet)



PokerStars Hand #222971814687:  Hold'em No Limit ($0.05/$0.10 USD) - 2021/01/23 16:20:05 ET
Table 'Shura III' 6-max Seat #4 is the button
Seat 3: odonro ($31.80 in chips) 
Seat 4: and 07335 ($10 in chips) 
Seat 5: sólyom333 ($11.46 in chips) 
Seat 6: maltsevig ($24.43 in chips) 
sólyom333: posts small blind $0.05
maltsevig: posts big blind $0.10
*** HOLE CARDS ***
odonro: calls $0.10
and 07335: folds 
sólyom333: folds 
maltsevig: checks 
*** FLOP *** [3h 2c 7c]
maltsevig: checks 
odonro: checks 
*** TURN *** [3h 2c 7c] [Qs]
maltsevig: checks 
odonro: checks 
*** RIVER *** [3h 2c 7c Qs] [6d]
maltsevig: bets $0.16
odonro: calls $0.16
*** SHOW DOWN ***
maltsevig: shows [Jd 9h] (high card Queen)
odonro: shows [Ac 5s] (high card Ace)
odonro collected $0.54 from pot
*** SUMMARY ***
Total pot $0.57 | Rake $0.03 
Board [3h 2c 7c Qs 6d]
Seat 3: odonro showed [Ac 5s] and won ($0.54) with high card Ace
Seat 4: and 07335 (button) folded before Flop (didn't bet)
Seat 5: sólyom333 (small blind) folded before Flop
Seat 6: maltsevig (big blind) showed [Jd 9h] and lost with high card Queen



PokerStars Hand #222971846811:  Hold'em No Limit ($0.05/$0.10 USD) - 2021/01/23 16:20:42 ET
Table 'Shura III' 6-max Seat #5 is the button
Seat 3: odonro ($32.08 in chips) 
Seat 4: and 07335 ($10 in chips) 
Seat 5: sólyom333 ($11.41 in chips) 
Seat 6: maltsevig ($24.17 in chips) 
maltsevig: posts small blind $0.05
odonro: posts big blind $0.10
*** HOLE CARDS ***
and 07335: folds 
sólyom333: folds 
maltsevig: folds 
Uncalled bet ($0.05) returned to odonro
odonro collected $0.10 from pot
odonro: doesn't show hand 
*** SUMMARY ***
Total pot $0.10 | Rake $0 
Seat 3: odonro (big blind) collected ($0.10)
Seat 4: and 07335 folded before Flop (didn't bet)
Seat 5: sólyom333 (button) folded before Flop (didn't bet)
Seat 6: maltsevig (small blind) folded before Flop



PokerStars Hand #222971855193:  Hold'em No Limit ($0.05/$0.10 USD) - 2021/01/23 16:20:52 ET
Table 'Shura III' 6-max Seat #6 is the button
Seat 3: odonro ($32.13 in chips) 
Seat 4: and 07335 ($10 in chips) 
Seat 5: sólyom333 ($11.41 in chips) 
Seat 6: maltsevig ($24.12 in chips) 
odonro: posts small blind $0.05
and 07335: posts big blind $0.10
*** HOLE CARDS ***
sólyom333: folds 
maltsevig: folds 
odonro: folds 
Uncalled bet ($0.05) returned to and 07335
and 07335 collected $0.10 from pot
and 07335: doesn't show hand 
*** SUMMARY ***
Total pot $0.10 | Rake $0 
Seat 3: odonro (small blind) folded before Flop
Seat 4: and 07335 (big blind) collected ($0.10)
Seat 5: sólyom333 folded before Flop (didn't bet)
Seat 6: maltsevig (button) folded before Flop (didn't bet)



PokerStars Hand #222971860513:  Hold'em No Limit ($0.05/$0.10 USD) - 2021/01/23 16:20:58 ET
Table 'Shura III' 6-max Seat #3 is the button
Seat 3: odonro ($32.08 in chips) 
Seat 4: and 07335 ($10.05 in chips) 
Seat 5: sólyom333 ($11.41 in chips) 
Seat 6: maltsevig ($24.12 in chips) 
and 07335: posts small blind $0.05
sólyom333: posts big blind $0.10
*** HOLE CARDS ***
maltsevig: folds 
odonro: folds 
and 07335: raises $0.15 to $0.25
sólyom333: folds 
Uncalled bet ($0.15) returned to and 07335
and 07335 collected $0.20 from pot
and 07335: doesn't show hand 
*** SUMMARY ***
Total pot $0.20 | Rake $0 
Seat 3: odonro (button) folded before Flop (didn't bet)
Seat 4: and 07335 (small blind) collected ($0.20)
Seat 5: sólyom333 (big blind) folded before Flop
Seat 6: maltsevig folded before Flop (didn't bet)



PokerStars Hand #222971873694:  Hold'em No Limit ($0.05/$0.10 USD) - 2021/01/23 16:21:14 ET
Table 'Shura III' 6-max Seat #4 is the button
Seat 3: odonro ($32.08 in chips) 
Seat 4: and 07335 ($10.15 in chips) 
Seat 5: sólyom333 ($11.31 in chips) 
Seat 6: maltsevig ($24.12 in chips) 
sólyom333: posts small blind $0.05
maltsevig: posts big blind $0.10
*** HOLE CARDS ***
odonro: calls $0.10
and 07335: folds 
sólyom333: folds 
maltsevig: checks 
*** FLOP *** [7h Ah 3d]
maltsevig: bets $0.16
odonro: folds 
Uncalled bet ($0.16) returned to maltsevig
maltsevig collected $0.24 from pot
maltsevig: doesn't show hand 
*** SUMMARY ***
Total pot $0.25 | Rake $0.01 
Board [7h Ah 3d]
Seat 3: odonro folded on the Flop
Seat 4: and 07335 (button) folded before Flop (didn't bet)
Seat 5: sólyom333 (small blind) folded before Flop
Seat 6: maltsevig (big blind) collected ($0.24)



PokerStars Hand #222971892047:  Hold'em No Limit ($0.05/$0.10 USD) - 2021/01/23 16:21:35 ET
Table 'Shura III' 6-max Seat #5 is the button
Seat 3: odonro ($31.98 in chips) 
Seat 4: and 07335 ($10.15 in chips) 
Seat 5: sólyom333 ($11.26 in chips) 
Seat 6: maltsevig ($24.26 in chips) 
maltsevig: posts small blind $0.05
odonro: posts big blind $0.10
*** HOLE CARDS ***
and 07335: folds 
sólyom333: raises $0.12 to $0.22
maltsevig: folds 
odonro: folds 
Uncalled bet ($0.12) returned to sólyom333
sólyom333 collected $0.25 from pot
Cheetham2020 was removed from the table for failing to post
Cheetham2020 leaves the table
Manon4ik was removed from the table for failing to post
Manon4ik leaves the table
sólyom333: doesn't show hand 
*** SUMMARY ***
Total pot $0.25 | Rake $0 
Seat 3: odonro (big blind) folded before Flop
Seat 4: and 07335 folded before Flop (didn't bet)
Seat 5: sólyom333 (button) collected ($0.25)
Seat 6: maltsevig (small blind) folded before Flop



PokerStars Hand #222971902427:  Hold'em No Limit ($0.05/$0.10 USD) - 2021/01/23 16:21:47 ET
Table 'Shura III' 6-max Seat #6 is the button
Seat 3: odonro ($31.88 in chips) 
Seat 4: and 07335 ($10.15 in chips) 
Seat 5: sólyom333 ($11.41 in chips) 
Seat 6: maltsevig ($24.21 in chips) 
odonro: posts small blind $0.05
and 07335: posts big blind $0.10
*** HOLE CARDS ***
sólyom333: folds 
larson090 joins the table at seat #2 
maltsevig: raises $0.10 to $0.20
odonro: folds 
and 07335: folds 
Uncalled bet ($0.10) returned to maltsevig
maltsevig collected $0.25 from pot
maltsevig: doesn't show hand 
*** SUMMARY ***
Total pot $0.25 | Rake $0 
Seat 3: odonro (small blind) folded before Flop
Seat 4: and 07335 (big blind) folded before Flop
Seat 5: sólyom333 folded before Flop (didn't bet)
Seat 6: maltsevig (button) collected ($0.25)



PokerStars Hand #222971914918:  Hold'em No Limit ($0.05/$0.10 USD) - 2021/01/23 16:22:02 ET
Table 'Shura III' 6-max Seat #3 is the button
Seat 3: odonro ($31.83 in chips) 
Seat 4: and 07335 ($10.05 in chips) 
Seat 5: sólyom333 ($11.41 in chips) 
Seat 6: maltsevig ($24.36 in chips) 
and 07335: posts small blind $0.05
sólyom333: posts big blind $0.10
larson090: sits out 
*** HOLE CARDS ***
maltsevig: folds 
odonro: raises $0.25 to $0.35
and 07335: folds 
sólyom333: folds 
Uncalled bet ($0.25) returned to odonro
odonro collected $0.25 from pot
odonro: doesn't show hand 
*** SUMMARY ***
Total pot $0.25 | Rake $0 
Seat 3: odonro (button) collected ($0.25)
Seat 4: and 07335 (small blind) folded before Flop
Seat 5: sólyom333 (big blind) folded before Flop
Seat 6: maltsevig folded before Flop (didn't bet)



PokerStars Hand #222971926794:  Hold'em No Limit ($0.05/$0.10 USD) - 2021/01/23 16:22:15 ET
Table 'Shura III' 6-max Seat #4 is the button
Seat 3: odonro ($31.98 in chips) 
Seat 4: and 07335 ($10 in chips) 
Seat 5: sólyom333 ($11.31 in chips) 
Seat 6: maltsevig ($24.36 in chips) 
sólyom333: posts small blind $0.05
maltsevig: posts big blind $0.10
larson090: sits out 
*** HOLE CARDS ***
Cheetham2020 joins the table at seat #1 
odonro: calls $0.10
and 07335: folds 
sólyom333: raises $0.35 to $0.45
maltsevig: folds 
odonro: calls $0.35
*** FLOP *** [7d 2d 5d]
sólyom333: bets $0.40
odonro: folds 
Uncalled bet ($0.40) returned to sólyom333
sólyom333 collected $0.96 from pot
sólyom333: doesn't show hand 
*** SUMMARY ***
Total pot $1 | Rake $0.04 
Board [7d 2d 5d]
Seat 3: odonro folded on the Flop
Seat 4: and 07335 (button) folded before Flop (didn't bet)
Seat 5: sólyom333 (small blind) collected ($0.96)
Seat 6: maltsevig (big blind) folded before Flop



PokerStars Hand #222971955106:  Hold'em No Limit ($0.05/$0.10 USD) - 2021/01/23 16:22:49 ET
Table 'Shura III' 6-max Seat #5 is the button
Seat 1: Cheetham2020 ($17.39 in chips) 
Seat 3: odonro ($31.53 in chips) 
Seat 4: and 07335 ($10 in chips) 
Seat 5: sólyom333 ($11.82 in chips) 
Seat 6: maltsevig ($24.26 in chips) 
maltsevig: posts small blind $0.05
Cheetham2020: posts big blind $0.10
larson090: sits out 
*** HOLE CARDS ***
odonro: folds 
and 07335: raises $0.15 to $0.25
sólyom333: raises $0.63 to $0.88
maltsevig: folds 
Cheetham2020 has timed out
Cheetham2020: folds 
and 07335: folds 
Uncalled bet ($0.63) returned to sólyom333
sólyom333 collected $0.65 from pot
sólyom333: doesn't show hand 
*** SUMMARY ***
Total pot $0.65 | Rake $0 
Seat 1: Cheetham2020 (big blind) folded before Flop
Seat 3: odonro folded before Flop (didn't bet)
Seat 4: and 07335 folded before Flop
Seat 5: sólyom333 (button) collected ($0.65)
Seat 6: maltsevig (small blind) folded before Flop



PokerStars Hand #222972002254:  Hold'em No Limit ($0.05/$0.10 USD) - 2021/01/23 16:23:35 ET
Table 'Shura III' 6-max Seat #6 is the button
Seat 1: Cheetham2020 ($17.29 in chips) 
Seat 2: larson090 ($10 in chips) 
Seat 3: odonro ($31.53 in chips) 
Seat 4: and 07335 ($10 in chips) 
Seat 5: sólyom333 ($12.22 in chips) 
Seat 6: maltsevig ($24.21 in chips) 
Cheetham2020: posts small blind $0.05
larson090: posts big blind $0.10
*** HOLE CARDS ***
odonro: folds 
and 07335: folds 
sólyom333: raises $0.18 to $0.28
maltsevig: folds 
Cheetham2020: calls $0.23
larson090: folds 
*** FLOP *** [8h 7d Qs]
Cheetham2020: bets $0.80
sólyom333: calls $0.80
*** TURN *** [8h 7d Qs] [6c]
Cheetham2020: checks 
sólyom333: bets $1.75
Cheetham2020: calls $1.75
*** RIVER *** [8h 7d Qs 6c] [7s]
Cheetham2020: checks 
sólyom333: bets $3.15
Cheetham2020: calls $3.15
*** SHOW DOWN ***
sólyom333: shows [8c 7c] (a full house, Sevens full of Eights)
Cheetham2020: mucks hand 
sólyom333 collected $11.52 from pot
*** SUMMARY ***
Total pot $12.06 | Rake $0.54 
Board [8h 7d Qs 6c 7s]
Seat 1: Cheetham2020 (small blind) mucked
Seat 2: larson090 (big blind) folded before Flop
Seat 3: odonro folded before Flop (didn't bet)
Seat 4: and 07335 folded before Flop (didn't bet)
Seat 5: sólyom333 showed [8c 7c] and won ($11.52) with a full house, Sevens full of Eights
Seat 6: maltsevig (button) folded before Flop (didn't bet)



PokerStars Hand #222972074030:  Hold'em No Limit ($0.05/$0.10 USD) - 2021/01/23 16:25:00 ET
Table 'Shura III' 6-max Seat #1 is the button
Seat 1: Cheetham2020 ($11.31 in chips) 
Seat 2: larson090 ($10 in chips) 
Seat 3: odonro ($31.53 in chips) 
Seat 4: and 07335 ($10 in chips) 
Seat 5: sólyom333 ($17.76 in chips) 
Seat 6: maltsevig ($24.21 in chips) 
larson090: posts small blind $0.05
odonro: posts big blind $0.10
*** HOLE CARDS ***
and 07335: folds 
sólyom333: folds 
maltsevig: folds 
Cheetham2020: calls $0.10
larson090: folds 
odonro: checks 
*** FLOP *** [Qh 8h 7s]
odonro: bets $0.24
Cheetham2020: calls $0.24
*** TURN *** [Qh 8h 7s] [3h]
odonro: checks 
Cheetham2020: checks 
*** RIVER *** [Qh 8h 7s 3h] [Ks]
odonro: bets $0.70
Cheetham2020: calls $0.70
*** SHOW DOWN ***
odonro: shows [8c Ac] (a pair of Eights)
Cheetham2020: mucks hand 
odonro collected $2.03 from pot
*** SUMMARY ***
Total pot $2.13 | Rake $0.10 
Board [Qh 8h 7s 3h Ks]
Seat 1: Cheetham2020 (button) mucked
Seat 2: larson090 (small blind) folded before Flop
Seat 3: odonro (big blind) showed [8c Ac] and won ($2.03) with a pair of Eights
Seat 4: and 07335 folded before Flop (didn't bet)
Seat 5: sólyom333 folded before Flop (didn't bet)
Seat 6: maltsevig folded before Flop (didn't bet)



PokerStars Hand #222972112386:  Hold'em No Limit ($0.05/$0.10 USD) - 2021/01/23 16:25:45 ET
Table 'Shura III' 6-max Seat #2 is the button
Seat 1: Cheetham2020 ($10.27 in chips) 
Seat 2: larson090 ($10 in chips) 
Seat 3: odonro ($32.52 in chips) 
Seat 4: and 07335 ($10 in chips) 
Seat 5: sólyom333 ($17.76 in chips) 
Seat 6: maltsevig ($24.21 in chips) 
odonro: posts small blind $0.05
and 07335: posts big blind $0.10
*** HOLE CARDS ***
sólyom333: folds 
maltsevig: folds 
Cheetham2020: calls $0.10
larson090: folds 
odonro: folds 
and 07335: checks 
*** FLOP *** [4h Qc 9s]
and 07335: checks 
Cheetham2020: checks 
*** TURN *** [4h Qc 9s] [Jc]
and 07335: checks 
Cheetham2020: bets $2
and 07335: folds 
Uncalled bet ($2) returned to Cheetham2020
Cheetham2020 collected $0.24 from pot
Cheetham2020: doesn't show hand 
*** SUMMARY ***
Total pot $0.25 | Rake $0.01 
Board [4h Qc 9s Jc]
Seat 1: Cheetham2020 collected ($0.24)
Seat 2: larson090 (button) folded before Flop (didn't bet)
Seat 3: odonro (small blind) folded before Flop
Seat 4: and 07335 (big blind) folded on the Turn
Seat 5: sólyom333 folded before Flop (didn't bet)
Seat 6: maltsevig folded before Flop (didn't bet)



PokerStars Hand #222972148340:  Hold'em No Limit ($0.05/$0.10 USD) - 2021/01/23 16:26:28 ET
Table 'Shura III' 6-max Seat #4 is the button
Seat 1: Cheetham2020 ($10.41 in chips) 
Seat 2: larson090 ($10 in chips) 
Seat 4: and 07335 ($10 in chips) 
Seat 5: sólyom333 ($17.76 in chips) 
Seat 6: maltsevig ($24.21 in chips) 
sólyom333: posts small blind $0.05
maltsevig: posts big blind $0.10
*** HOLE CARDS ***
Cheetham2020: folds 
larson090: folds 
and 07335: folds 
sólyom333: folds 
Uncalled bet ($0.05) returned to maltsevig
maltsevig collected $0.10 from pot
maltsevig: doesn't show hand 
*** SUMMARY ***
Total pot $0.10 | Rake $0 
Seat 1: Cheetham2020 folded before Flop (didn't bet)
Seat 2: larson090 folded before Flop (didn't bet)
Seat 4: and 07335 (button) folded before Flop (didn't bet)
Seat 5: sólyom333 (small blind) folded before Flop
Seat 6: maltsevig (big blind) collected ($0.10)



PokerStars Hand #222972155584:  Hold'em No Limit ($0.05/$0.10 USD) - 2021/01/23 16:26:36 ET
Table 'Shura III' 6-max Seat #5 is the button
Seat 2: larson090 ($10 in chips) 
Seat 4: and 07335 ($10 in chips) 
Seat 5: sólyom333 ($17.71 in chips) 
Seat 6: maltsevig ($24.26 in chips) 
maltsevig: posts small blind $0.05
larson090: posts big blind $0.10
*** HOLE CARDS ***
and 07335: folds 
sólyom333: raises $0.12 to $0.22
maltsevig: folds 
larson090: calls $0.12
*** FLOP *** [9d 6s Qh]
larson090: checks 
sólyom333: bets $0.20
maltsevig leaves the table
larson090: folds 
Uncalled bet ($0.20) returned to sólyom333
sólyom333 collected $0.47 from pot
sólyom333: doesn't show hand 
*** SUMMARY ***
Total pot $0.49 | Rake $0.02 
Board [9d 6s Qh]
Seat 2: larson090 (big blind) folded on the Flop
Seat 4: and 07335 folded before Flop (didn't bet)
Seat 5: sólyom333 (button) collected ($0.47)
Seat 6: maltsevig (small blind) folded before Flop



PokerStars Hand #222972201490:  Hold'em No Limit ($0.05/$0.10 USD) - 2021/01/23 16:27:30 ET
Table 'Shura III' 6-max Seat #2 is the button
Seat 2: larson090 ($10 in chips) 
Seat 4: and 07335 ($10 in chips) 
Seat 5: sólyom333 ($17.96 in chips) 
and 07335: posts small blind $0.05
sólyom333: posts big blind $0.10
*** HOLE CARDS ***
larson090: folds 
and 07335: raises $0.15 to $0.25
sólyom333: calls $0.15
*** FLOP *** [3d 9d Ts]
and 07335: checks 
sólyom333: checks 
*** TURN *** [3d 9d Ts] [7s]
and 07335: bets $0.30
sólyom333: calls $0.30
*** RIVER *** [3d 9d Ts 7s] [Th]
and 07335: checks 
sólyom333: bets $0.44
and 07335: folds 
Uncalled bet ($0.44) returned to sólyom333
sólyom333 collected $1.05 from pot
sólyom333: doesn't show hand 
*** SUMMARY ***
Total pot $1.10 | Rake $0.05 
Board [3d 9d Ts 7s Th]
Seat 2: larson090 (button) folded before Flop (didn't bet)
Seat 4: and 07335 (small blind) folded on the River
Seat 5: sólyom333 (big blind) collected ($1.05)



PokerStars Hand #222972249233:  Hold'em No Limit ($0.05/$0.10 USD) - 2021/01/23 16:28:26 ET
Table 'Shura III' 6-max Seat #4 is the button
Seat 2: larson090 ($10 in chips) 
Seat 4: and 07335 ($10 in chips) 
Seat 5: sólyom333 ($18.46 in chips) 
sólyom333: posts small blind $0.05
larson090: posts big blind $0.10
*** HOLE CARDS ***
and 07335: raises $0.15 to $0.25
sólyom333: folds 
larson090: folds 
Uncalled bet ($0.15) returned to and 07335
and 07335 collected $0.25 from pot
and 07335: doesn't show hand 
*** SUMMARY ***
Total pot $0.25 | Rake $0 
Seat 2: larson090 (big blind) folded before Flop
Seat 4: and 07335 (button) collected ($0.25)
Seat 5: sólyom333 (small blind) folded before Flop



PokerStars Hand #222972258460:  Hold'em No Limit ($0.05/$0.10 USD) - 2021/01/23 16:28:37 ET
Table 'Shura III' 6-max Seat #2 is the button
Seat 2: larson090 ($10 in chips) 
Seat 5: sólyom333 ($18.41 in chips) 
larson090: posts small blind $0.05
and 07335: is sitting out 
sólyom333: posts big blind $0.10
*** HOLE CARDS ***
larson090: raises $0.15 to $0.25
sólyom333: folds 
Uncalled bet ($0.15) returned to larson090
larson090 collected $0.20 from pot
larson090: doesn't show hand 
*** SUMMARY ***
Total pot $0.20 | Rake $0 
Seat 2: larson090 (button) (small blind) collected ($0.20)
Seat 5: sólyom333 (big blind) folded before Flop



PokerStars Hand #222972265043:  Hold'em No Limit ($0.05/$0.10 USD) - 2021/01/23 16:28:45 ET
Table 'Shura III' 6-max Seat #5 is the button
Seat 2: larson090 ($10.10 in chips) 
Seat 3: odonro ($32.47 in chips) 
Seat 5: sólyom333 ($18.31 in chips) 
larson090: posts small blind $0.05
odonro: posts big blind $0.10
*** HOLE CARDS ***
sólyom333: folds 
larson090: raises $0.15 to $0.25
odonro: folds 
Uncalled bet ($0.15) returned to larson090
larson090 collected $0.20 from pot
larson090: doesn't show hand 
*** SUMMARY ***
Total pot $0.20 | Rake $0 
Seat 2: larson090 (small blind) collected ($0.20)
Seat 3: odonro (big blind) folded before Flop
Seat 5: sólyom333 (button) folded before Flop (didn't bet)



PokerStars Hand #222972278047:  Hold'em No Limit ($0.05/$0.10 USD) - 2021/01/23 16:29:00 ET
Table 'Shura III' 6-max Seat #2 is the button
Seat 2: larson090 ($10.20 in chips) 
Seat 3: odonro ($32.37 in chips) 
Seat 5: sólyom333 ($18.31 in chips) 
odonro: posts small blind $0.05
sólyom333: posts big blind $0.10
*** HOLE CARDS ***
larson090: folds 
odonro: folds 
Uncalled bet ($0.05) returned to sólyom333
sólyom333 collected $0.10 from pot
sólyom333: doesn't show hand 
*** SUMMARY ***
Total pot $0.10 | Rake $0 
Seat 2: larson090 (button) folded before Flop (didn't bet)
Seat 3: odonro (small blind) folded before Flop
Seat 5: sólyom333 (big blind) collected ($0.10)



PokerStars Hand #222972287646:  Hold'em No Limit ($0.05/$0.10 USD) - 2021/01/23 16:29:12 ET
Table 'Shura III' 6-max Seat #5 is the button
Seat 3: odonro ($32.32 in chips) 
Seat 5: sólyom333 ($18.36 in chips) 
sólyom333: posts small blind $0.05
larson090: is sitting out 
odonro: posts big blind $0.10
*** HOLE CARDS ***
larson090 leaves the table
sólyom333: raises $0.25 to $0.35
odonro: folds 
Uncalled bet ($0.25) returned to sólyom333
sólyom333 collected $0.20 from pot
sólyom333: doesn't show hand 
*** SUMMARY ***
Total pot $0.20 | Rake $0 
Seat 3: odonro (big blind) folded before Flop
Seat 5: sólyom333 (button) (small blind) collected ($0.20)



PokerStars Hand #222972295471:  Hold'em No Limit ($0.05/$0.10 USD) - 2021/01/23 16:29:21 ET
Table 'Shura III' 6-max Seat #3 is the button
Seat 3: odonro ($32.22 in chips) 
Seat 5: sólyom333 ($18.46 in chips) 
odonro: posts small blind $0.05
sólyom333: posts big blind $0.10
*** HOLE CARDS ***
and 07335 leaves the table
odonro: folds 
Uncalled bet ($0.05) returned to sólyom333
odonro leaves the table
sólyom333 collected $0.10 from pot
sólyom333: doesn't show hand 
*** SUMMARY ***
Total pot $0.10 | Rake $0 
Seat 3: odonro (button) (small blind) folded before Flop
Seat 5: sólyom333 (big blind) collected ($0.10)



