PokerStars Hand #222949785880:  Hold'em No Limit ($0.05/$0.10 USD) - 2021/01/23 5:35:02 ET
Table 'Stephano III' 6-max Seat #1 is the button
Seat 1: TakMits ($10.15 in chips) 
Seat 2: Jonathan8765 ($6.96 in chips) 
Seat 3: praclovekzig ($6.75 in chips) 
Seat 4: xulfster ($12.90 in chips) 
Seat 5: 1920kbps ($10 in chips) 
Seat 6: ZSever 22 rus ($4.54 in chips) 
Jonathan8765: posts small blind $0.05
praclovekzig: posts big blind $0.10
*** HOLE CARDS ***
xulfster: folds 
1920kbps: folds 
ZSever 22 rus: raises $0.20 to $0.30
TakMits: folds 
Jonathan8765: folds 
praclovekzig: folds 
Uncalled bet ($0.20) returned to ZSever 22 rus
ZSever 22 rus collected $0.25 from pot
ZSever 22 rus: doesn't show hand 
*** SUMMARY ***
Total pot $0.25 | Rake $0 
Seat 1: TakMits (button) folded before Flop (didn't bet)
Seat 2: Jonathan8765 (small blind) folded before Flop
Seat 3: praclovekzig (big blind) folded before Flop
Seat 4: xulfster folded before Flop (didn't bet)
Seat 5: 1920kbps folded before Flop (didn't bet)
Seat 6: ZSever 22 rus collected ($0.25)



PokerStars Hand #222949793132:  Hold'em No Limit ($0.05/$0.10 USD) - 2021/01/23 5:35:25 ET
Table 'Stephano III' 6-max Seat #2 is the button
Seat 1: TakMits ($10.15 in chips) 
Seat 2: Jonathan8765 ($6.91 in chips) 
Seat 3: praclovekzig ($6.65 in chips) 
Seat 4: xulfster ($12.90 in chips) 
Seat 5: 1920kbps ($10 in chips) 
Seat 6: ZSever 22 rus ($4.69 in chips) 
praclovekzig: posts small blind $0.05
xulfster: posts big blind $0.10
*** HOLE CARDS ***
1920kbps: folds 
ZSever 22 rus: folds 
TakMits: folds 
Jonathan8765: raises $0.13 to $0.23
praclovekzig: folds 
xulfster: folds 
Uncalled bet ($0.13) returned to Jonathan8765
Jonathan8765 collected $0.25 from pot
Jonathan8765: doesn't show hand 
*** SUMMARY ***
Total pot $0.25 | Rake $0 
Seat 1: TakMits folded before Flop (didn't bet)
Seat 2: Jonathan8765 (button) collected ($0.25)
Seat 3: praclovekzig (small blind) folded before Flop
Seat 4: xulfster (big blind) folded before Flop
Seat 5: 1920kbps folded before Flop (didn't bet)
Seat 6: ZSever 22 rus folded before Flop (didn't bet)



PokerStars Hand #222949798188:  Hold'em No Limit ($0.05/$0.10 USD) - 2021/01/23 5:35:42 ET
Table 'Stephano III' 6-max Seat #3 is the button
Seat 1: TakMits ($10.15 in chips) 
Seat 2: Jonathan8765 ($7.06 in chips) 
Seat 3: praclovekzig ($6.60 in chips) 
Seat 4: xulfster ($12.80 in chips) 
Seat 5: 1920kbps ($10 in chips) 
Seat 6: ZSever 22 rus ($4.69 in chips) 
xulfster: posts small blind $0.05
1920kbps: posts big blind $0.10
*** HOLE CARDS ***
ZSever 22 rus: folds 
TakMits: raises $0.17 to $0.27
Jonathan8765: folds 
praclovekzig: folds 
xulfster: folds 
1920kbps: folds 
Uncalled bet ($0.17) returned to TakMits
TakMits collected $0.25 from pot
TakMits: doesn't show hand 
*** SUMMARY ***
Total pot $0.25 | Rake $0 
Seat 1: TakMits collected ($0.25)
Seat 2: Jonathan8765 folded before Flop (didn't bet)
Seat 3: praclovekzig (button) folded before Flop (didn't bet)
Seat 4: xulfster (small blind) folded before Flop
Seat 5: 1920kbps (big blind) folded before Flop
Seat 6: ZSever 22 rus folded before Flop (didn't bet)



PokerStars Hand #222949803242:  Hold'em No Limit ($0.05/$0.10 USD) - 2021/01/23 5:35:58 ET
Table 'Stephano III' 6-max Seat #4 is the button
Seat 1: TakMits ($10.30 in chips) 
Seat 2: Jonathan8765 ($7.06 in chips) 
Seat 3: praclovekzig ($6.60 in chips) 
Seat 4: xulfster ($12.75 in chips) 
Seat 5: 1920kbps ($10 in chips) 
Seat 6: ZSever 22 rus ($4.69 in chips) 
1920kbps: posts small blind $0.05
ZSever 22 rus: posts big blind $0.10
*** HOLE CARDS ***
TakMits: folds 
Jonathan8765: folds 
praclovekzig: folds 
xulfster: folds 
1920kbps: folds 
Uncalled bet ($0.05) returned to ZSever 22 rus
ZSever 22 rus collected $0.10 from pot
ZSever 22 rus: doesn't show hand 
*** SUMMARY ***
Total pot $0.10 | Rake $0 
Seat 1: TakMits folded before Flop (didn't bet)
Seat 2: Jonathan8765 folded before Flop (didn't bet)
Seat 3: praclovekzig folded before Flop (didn't bet)
Seat 4: xulfster (button) folded before Flop (didn't bet)
Seat 5: 1920kbps (small blind) folded before Flop
Seat 6: ZSever 22 rus (big blind) collected ($0.10)



PokerStars Hand #222949807038:  Hold'em No Limit ($0.05/$0.10 USD) - 2021/01/23 5:36:10 ET
Table 'Stephano III' 6-max Seat #5 is the button
Seat 1: TakMits ($10.30 in chips) 
Seat 2: Jonathan8765 ($7.06 in chips) 
Seat 3: praclovekzig ($6.60 in chips) 
Seat 4: xulfster ($12.75 in chips) 
Seat 5: 1920kbps ($10 in chips) 
Seat 6: ZSever 22 rus ($4.74 in chips) 
ZSever 22 rus: posts small blind $0.05
TakMits: posts big blind $0.10
*** HOLE CARDS ***
Jonathan8765: folds 
praclovekzig: raises $0.10 to $0.20
xulfster: folds 
1920kbps: folds 
ZSever 22 rus: calls $0.15
TakMits: folds 
*** FLOP *** [Td 2c Th]
ZSever 22 rus: checks 
praclovekzig: checks 
*** TURN *** [Td 2c Th] [8s]
ZSever 22 rus: checks 
praclovekzig: bets $0.10
ZSever 22 rus: calls $0.10
*** RIVER *** [Td 2c Th 8s] [5s]
ZSever 22 rus: checks 
praclovekzig: bets $1.90
ZSever 22 rus: folds 
Uncalled bet ($1.90) returned to praclovekzig
praclovekzig collected $0.67 from pot
praclovekzig: doesn't show hand 
*** SUMMARY ***
Total pot $0.70 | Rake $0.03 
Board [Td 2c Th 8s 5s]
Seat 1: TakMits (big blind) folded before Flop
Seat 2: Jonathan8765 folded before Flop (didn't bet)
Seat 3: praclovekzig collected ($0.67)
Seat 4: xulfster folded before Flop (didn't bet)
Seat 5: 1920kbps (button) folded before Flop (didn't bet)
Seat 6: ZSever 22 rus (small blind) folded on the River



PokerStars Hand #222949815685:  Hold'em No Limit ($0.05/$0.10 USD) - 2021/01/23 5:36:37 ET
Table 'Stephano III' 6-max Seat #6 is the button
Seat 1: TakMits ($10.20 in chips) 
Seat 2: Jonathan8765 ($7.06 in chips) 
Seat 3: praclovekzig ($6.97 in chips) 
Seat 4: xulfster ($12.75 in chips) 
Seat 5: 1920kbps ($10 in chips) 
Seat 6: ZSever 22 rus ($4.44 in chips) 
TakMits: posts small blind $0.05
Jonathan8765: posts big blind $0.10
*** HOLE CARDS ***
praclovekzig: folds 
xulfster: folds 
1920kbps: folds 
ZSever 22 rus: raises $4.34 to $4.44 and is all-in
TakMits: raises $5.76 to $10.20 and is all-in
Jonathan8765: calls $6.96 and is all-in
Uncalled bet ($3.14) returned to TakMits
*** FLOP *** [8h 6c Ah]
*** TURN *** [8h 6c Ah] [8d]
*** RIVER *** [8h 6c Ah 8d] [Qh]
*** SHOW DOWN ***
TakMits: shows [Ad Kc] (two pair, Aces and Eights)
Jonathan8765: shows [Kh Ks] (two pair, Kings and Eights)
TakMits collected $5 from side pot
ZSever 22 rus: shows [7h Kd] (a pair of Eights)
TakMits collected $12.72 from main pot
*** SUMMARY ***
Total pot $18.56 Main pot $12.72. Side pot $5. | Rake $0.84 
Board [8h 6c Ah 8d Qh]
Seat 1: TakMits (small blind) showed [Ad Kc] and won ($17.72) with two pair, Aces and Eights
Seat 2: Jonathan8765 (big blind) showed [Kh Ks] and lost with two pair, Kings and Eights
Seat 3: praclovekzig folded before Flop (didn't bet)
Seat 4: xulfster folded before Flop (didn't bet)
Seat 5: 1920kbps folded before Flop (didn't bet)
Seat 6: ZSever 22 rus (button) showed [7h Kd] and lost with a pair of Eights



PokerStars Hand #222949823516:  Hold'em No Limit ($0.05/$0.10 USD) - 2021/01/23 5:37:02 ET
Table 'Stephano III' 6-max Seat #1 is the button
Seat 1: TakMits ($20.86 in chips) 
Seat 3: praclovekzig ($6.97 in chips) 
Seat 5: 1920kbps ($10 in chips) 
praclovekzig: posts small blind $0.05
xulfster: is sitting out 
1920kbps: posts big blind $0.10
*** HOLE CARDS ***
TakMits: raises $0.12 to $0.22
praclovekzig: folds 
1920kbps: folds 
Uncalled bet ($0.12) returned to TakMits
TakMits collected $0.25 from pot
TakMits: doesn't show hand 
*** SUMMARY ***
Total pot $0.25 | Rake $0 
Seat 1: TakMits (button) collected ($0.25)
Seat 3: praclovekzig (small blind) folded before Flop
Seat 5: 1920kbps (big blind) folded before Flop



PokerStars Hand #222949826010:  Hold'em No Limit ($0.05/$0.10 USD) - 2021/01/23 5:37:10 ET
Table 'Stephano III' 6-max Seat #3 is the button
Seat 1: TakMits ($21.01 in chips) 
Seat 3: praclovekzig ($6.92 in chips) 
Seat 5: 1920kbps ($10 in chips) 
1920kbps: posts small blind $0.05
TakMits: posts big blind $0.10
Jonathan8765: sits out 
*** HOLE CARDS ***
praclovekzig: folds 
1920kbps: raises $0.20 to $0.30
TakMits: folds 
Uncalled bet ($0.20) returned to 1920kbps
1920kbps collected $0.20 from pot
ZSever 22 rus is disconnected 
*** SUMMARY ***
Total pot $0.20 | Rake $0 
Seat 1: TakMits (big blind) folded before Flop
Seat 3: praclovekzig (button) folded before Flop (didn't bet)
Seat 5: 1920kbps (small blind) collected ($0.20)



PokerStars Hand #222949827996:  Hold'em No Limit ($0.05/$0.10 USD) - 2021/01/23 5:37:16 ET
Table 'Stephano III' 6-max Seat #5 is the button
Seat 1: TakMits ($20.91 in chips) 
Seat 2: Jonathan8765 ($10 in chips) 
Seat 3: praclovekzig ($6.92 in chips) 
Seat 5: 1920kbps ($10.10 in chips) 
TakMits: posts small blind $0.05
Jonathan8765: posts big blind $0.10
*** HOLE CARDS ***
praclovekzig: folds 
1920kbps: folds 
TakMits: folds 
Uncalled bet ($0.05) returned to Jonathan8765
Jonathan8765 collected $0.10 from pot
Jonathan8765: doesn't show hand 
*** SUMMARY ***
Total pot $0.10 | Rake $0 
Seat 1: TakMits (small blind) folded before Flop
Seat 2: Jonathan8765 (big blind) collected ($0.10)
Seat 3: praclovekzig folded before Flop (didn't bet)
Seat 5: 1920kbps (button) folded before Flop (didn't bet)



PokerStars Hand #222949831736:  Hold'em No Limit ($0.05/$0.10 USD) - 2021/01/23 5:37:28 ET
Table 'Stephano III' 6-max Seat #1 is the button
Seat 1: TakMits ($20.86 in chips) 
Seat 2: Jonathan8765 ($10.05 in chips) 
Seat 3: praclovekzig ($6.92 in chips) 
Seat 5: 1920kbps ($10.10 in chips) 
Jonathan8765: posts small blind $0.05
praclovekzig: posts big blind $0.10
*** HOLE CARDS ***
1920kbps: raises $0.20 to $0.30
TakMits: folds 
Jonathan8765: folds 
praclovekzig: calls $0.20
*** FLOP *** [Kh 7c 4d]
praclovekzig: checks 
1920kbps: bets $0.40
praclovekzig: folds 
Uncalled bet ($0.40) returned to 1920kbps
1920kbps collected $0.62 from pot
*** SUMMARY ***
Total pot $0.65 | Rake $0.03 
Board [Kh 7c 4d]
Seat 1: TakMits (button) folded before Flop (didn't bet)
Seat 2: Jonathan8765 (small blind) folded before Flop
Seat 3: praclovekzig (big blind) folded on the Flop
Seat 5: 1920kbps collected ($0.62)



PokerStars Hand #222949840318:  Hold'em No Limit ($0.05/$0.10 USD) - 2021/01/23 5:37:55 ET
Table 'Stephano III' 6-max Seat #2 is the button
Seat 1: TakMits ($20.86 in chips) 
Seat 2: Jonathan8765 ($10 in chips) 
Seat 3: praclovekzig ($6.62 in chips) 
Seat 5: 1920kbps ($10.42 in chips) 
praclovekzig: posts small blind $0.05
1920kbps: posts big blind $0.10
*** HOLE CARDS ***
TakMits: folds 
Jonathan8765: folds 
praclovekzig: raises $0.20 to $0.30
1920kbps: folds 
Uncalled bet ($0.20) returned to praclovekzig
praclovekzig collected $0.20 from pot
praclovekzig: doesn't show hand 
*** SUMMARY ***
Total pot $0.20 | Rake $0 
Seat 1: TakMits folded before Flop (didn't bet)
Seat 2: Jonathan8765 (button) folded before Flop (didn't bet)
Seat 3: praclovekzig (small blind) collected ($0.20)
Seat 5: 1920kbps (big blind) folded before Flop



PokerStars Hand #222949843043:  Hold'em No Limit ($0.05/$0.10 USD) - 2021/01/23 5:38:04 ET
Table 'Stephano III' 6-max Seat #3 is the button
Seat 1: TakMits ($20.86 in chips) 
Seat 2: Jonathan8765 ($10 in chips) 
Seat 3: praclovekzig ($6.72 in chips) 
Seat 5: 1920kbps ($10.32 in chips) 
1920kbps: posts small blind $0.05
TakMits: posts big blind $0.10
*** HOLE CARDS ***
Jonathan8765: raises $0.13 to $0.23
praclovekzig: folds 
1920kbps: calls $0.18
TakMits: calls $0.13
*** FLOP *** [7d Td 3h]
1920kbps: checks 
TakMits: checks 
Jonathan8765: bets $0.22
1920kbps: folds 
TakMits: calls $0.22
*** TURN *** [7d Td 3h] [5c]
TakMits: checks 
Jonathan8765: checks 
*** RIVER *** [7d Td 3h 5c] [Jd]
TakMits: checks 
Jonathan8765: bets $0.40
TakMits: folds 
Uncalled bet ($0.40) returned to Jonathan8765
Jonathan8765 collected $1.08 from pot
Jonathan8765: doesn't show hand 
*** SUMMARY ***
Total pot $1.13 | Rake $0.05 
Board [7d Td 3h 5c Jd]
Seat 1: TakMits (big blind) folded on the River
Seat 2: Jonathan8765 collected ($1.08)
Seat 3: praclovekzig (button) folded before Flop (didn't bet)
Seat 5: 1920kbps (small blind) folded on the Flop



PokerStars Hand #222949853882:  Hold'em No Limit ($0.05/$0.10 USD) - 2021/01/23 5:38:38 ET
Table 'Stephano III' 6-max Seat #5 is the button
Seat 1: TakMits ($20.41 in chips) 
Seat 2: Jonathan8765 ($10.63 in chips) 
Seat 3: praclovekzig ($6.72 in chips) 
Seat 5: 1920kbps ($10.09 in chips) 
TakMits: posts small blind $0.05
Jonathan8765: posts big blind $0.10
*** HOLE CARDS ***
praclovekzig: folds 
1920kbps: folds 
TakMits: folds 
Uncalled bet ($0.05) returned to Jonathan8765
Jonathan8765 collected $0.10 from pot
Jonathan8765: doesn't show hand 
*** SUMMARY ***
Total pot $0.10 | Rake $0 
Seat 1: TakMits (small blind) folded before Flop
Seat 2: Jonathan8765 (big blind) collected ($0.10)
Seat 3: praclovekzig folded before Flop (didn't bet)
Seat 5: 1920kbps (button) folded before Flop (didn't bet)



PokerStars Hand #222949855367:  Hold'em No Limit ($0.05/$0.10 USD) - 2021/01/23 5:38:43 ET
Table 'Stephano III' 6-max Seat #1 is the button
Seat 1: TakMits ($20.36 in chips) 
Seat 2: Jonathan8765 ($10.68 in chips) 
Seat 3: praclovekzig ($6.72 in chips) 
Seat 5: 1920kbps ($10.09 in chips) 
Jonathan8765: posts small blind $0.05
praclovekzig: posts big blind $0.10
*** HOLE CARDS ***
1920kbps: folds 
TakMits: raises $0.12 to $0.22
Jonathan8765: folds 
praclovekzig: folds 
Uncalled bet ($0.12) returned to TakMits
TakMits collected $0.25 from pot
TakMits: doesn't show hand 
*** SUMMARY ***
Total pot $0.25 | Rake $0 
Seat 1: TakMits (button) collected ($0.25)
Seat 2: Jonathan8765 (small blind) folded before Flop
Seat 3: praclovekzig (big blind) folded before Flop
Seat 5: 1920kbps folded before Flop (didn't bet)



PokerStars Hand #222949857846:  Hold'em No Limit ($0.05/$0.10 USD) - 2021/01/23 5:38:51 ET
Table 'Stephano III' 6-max Seat #2 is the button
Seat 1: TakMits ($20.51 in chips) 
Seat 2: Jonathan8765 ($10.63 in chips) 
Seat 3: praclovekzig ($6.62 in chips) 
Seat 5: 1920kbps ($10.09 in chips) 
praclovekzig: posts small blind $0.05
1920kbps: posts big blind $0.10
*** HOLE CARDS ***
TakMits: folds 
Jonathan8765: folds 
praclovekzig: calls $0.05
1920kbps: checks 
*** FLOP *** [5s Qd Js]
praclovekzig: bets $0.10
1920kbps: calls $0.10
*** TURN *** [5s Qd Js] [3h]
praclovekzig: bets $0.20
1920kbps: calls $0.20
*** RIVER *** [5s Qd Js 3h] [Qs]
praclovekzig: bets $0.30
1920kbps: calls $0.30
*** SHOW DOWN ***
praclovekzig: shows [6c Jc] (two pair, Queens and Jacks)
1920kbps: mucks hand 
praclovekzig collected $1.34 from pot
*** SUMMARY ***
Total pot $1.40 | Rake $0.06 
Board [5s Qd Js 3h Qs]
Seat 1: TakMits folded before Flop (didn't bet)
Seat 2: Jonathan8765 (button) folded before Flop (didn't bet)
Seat 3: praclovekzig (small blind) showed [6c Jc] and won ($1.34) with two pair, Queens and Jacks
Seat 5: 1920kbps (big blind) mucked



PokerStars Hand #222949864597:  Hold'em No Limit ($0.05/$0.10 USD) - 2021/01/23 5:39:12 ET
Table 'Stephano III' 6-max Seat #3 is the button
Seat 1: TakMits ($20.51 in chips) 
Seat 2: Jonathan8765 ($10.63 in chips) 
Seat 3: praclovekzig ($7.26 in chips) 
Seat 5: 1920kbps ($10 in chips) 
1920kbps: posts small blind $0.05
TakMits: posts big blind $0.10
*** HOLE CARDS ***
Jonathan8765: folds 
praclovekzig: folds 
ZSever 22 rus leaves the table
1920kbps: raises $0.20 to $0.30
TakMits: folds 
Uncalled bet ($0.20) returned to 1920kbps
1920kbps collected $0.20 from pot
*** SUMMARY ***
Total pot $0.20 | Rake $0 
Seat 1: TakMits (big blind) folded before Flop
Seat 2: Jonathan8765 folded before Flop (didn't bet)
Seat 3: praclovekzig (button) folded before Flop (didn't bet)
Seat 5: 1920kbps (small blind) collected ($0.20)



PokerStars Hand #222949866931:  Hold'em No Limit ($0.05/$0.10 USD) - 2021/01/23 5:39:20 ET
Table 'Stephano III' 6-max Seat #5 is the button
Seat 1: TakMits ($20.41 in chips) 
Seat 2: Jonathan8765 ($10.63 in chips) 
Seat 3: praclovekzig ($7.26 in chips) 
Seat 5: 1920kbps ($10.10 in chips) 
TakMits: posts small blind $0.05
Jonathan8765: posts big blind $0.10
*** HOLE CARDS ***
praclovekzig: calls $0.10
1920kbps: folds 
TakMits: calls $0.05
Jonathan8765: checks 
*** FLOP *** [Qc 8c Ad]
TakMits: bets $0.15
Jonathan8765: calls $0.15
sttanlley joins the table at seat #6 
praclovekzig is connected 
praclovekzig: folds 
*** TURN *** [Qc 8c Ad] [4d]
TakMits: bets $0.17
Jonathan8765: calls $0.17
*** RIVER *** [Qc 8c Ad 4d] [9h]
TakMits: checks 
Jonathan8765: bets $0.65
TakMits: calls $0.65
*** SHOW DOWN ***
Jonathan8765: shows [4c Qs] (two pair, Queens and Fours)
TakMits: mucks hand 
Jonathan8765 collected $2.14 from pot
*** SUMMARY ***
Total pot $2.24 | Rake $0.10 
Board [Qc 8c Ad 4d 9h]
Seat 1: TakMits (small blind) mucked
Seat 2: Jonathan8765 (big blind) showed [4c Qs] and won ($2.14) with two pair, Queens and Fours
Seat 3: praclovekzig folded on the Flop
Seat 5: 1920kbps (button) folded before Flop (didn't bet)



PokerStars Hand #222949882201:  Hold'em No Limit ($0.05/$0.10 USD) - 2021/01/23 5:40:08 ET
Table 'Stephano III' 6-max Seat #1 is the button
Seat 1: TakMits ($19.34 in chips) 
Seat 2: Jonathan8765 ($11.70 in chips) 
Seat 3: praclovekzig ($7.16 in chips) 
Seat 5: 1920kbps ($10.10 in chips) 
Jonathan8765: posts small blind $0.05
praclovekzig: posts big blind $0.10
sttanlley: sits out 
*** HOLE CARDS ***
1920kbps: raises $0.20 to $0.30
TakMits: folds 
Jonathan8765: folds 
praclovekzig: calls $0.20
*** FLOP *** [7c 6d 4c]
praclovekzig: checks 
1920kbps: checks 
*** TURN *** [7c 6d 4c] [5s]
praclovekzig: bets $0.31
1920kbps: folds 
Uncalled bet ($0.31) returned to praclovekzig
praclovekzig collected $0.62 from pot
praclovekzig: doesn't show hand 
*** SUMMARY ***
Total pot $0.65 | Rake $0.03 
Board [7c 6d 4c 5s]
Seat 1: TakMits (button) folded before Flop (didn't bet)
Seat 2: Jonathan8765 (small blind) folded before Flop
Seat 3: praclovekzig (big blind) collected ($0.62)
Seat 5: 1920kbps folded on the Turn



PokerStars Hand #222949890146:  Hold'em No Limit ($0.05/$0.10 USD) - 2021/01/23 5:40:34 ET
Table 'Stephano III' 6-max Seat #2 is the button
Seat 1: TakMits ($19.34 in chips) 
Seat 2: Jonathan8765 ($11.65 in chips) 
Seat 3: praclovekzig ($7.48 in chips) 
Seat 5: 1920kbps ($10 in chips) 
praclovekzig: posts small blind $0.05
1920kbps: posts big blind $0.10
sttanlley: sits out 
*** HOLE CARDS ***
TakMits: raises $0.12 to $0.22
Jonathan8765: folds 
praclovekzig: calls $0.17
1920kbps: calls $0.12
*** FLOP *** [3h 5h 9s]
praclovekzig: bets $0.32
1920kbps: folds 
TakMits: folds 
Uncalled bet ($0.32) returned to praclovekzig
praclovekzig collected $0.63 from pot
xulfster was removed from the table for failing to post
xulfster leaves the table
praclovekzig: doesn't show hand 
*** SUMMARY ***
Total pot $0.66 | Rake $0.03 
Board [3h 5h 9s]
Seat 1: TakMits folded on the Flop
Seat 2: Jonathan8765 (button) folded before Flop (didn't bet)
Seat 3: praclovekzig (small blind) collected ($0.63)
Seat 5: 1920kbps (big blind) folded on the Flop



PokerStars Hand #222949894945:  Hold'em No Limit ($0.05/$0.10 USD) - 2021/01/23 5:40:50 ET
Table 'Stephano III' 6-max Seat #3 is the button
Seat 1: TakMits ($19.12 in chips) 
Seat 2: Jonathan8765 ($11.65 in chips) 
Seat 3: praclovekzig ($7.89 in chips) 
Seat 5: 1920kbps ($10 in chips) 
Seat 6: sttanlley ($10 in chips) 
1920kbps: posts small blind $0.05
sttanlley: posts big blind $0.10
*** HOLE CARDS ***
TakMits: folds 
Jonathan8765: raises $0.13 to $0.23
praclovekzig: folds 
1920kbps: folds 
sttanlley: folds 
Uncalled bet ($0.13) returned to Jonathan8765
Jonathan8765 collected $0.25 from pot
Jonathan8765: doesn't show hand 
*** SUMMARY ***
Total pot $0.25 | Rake $0 
Seat 1: TakMits folded before Flop (didn't bet)
Seat 2: Jonathan8765 collected ($0.25)
Seat 3: praclovekzig (button) folded before Flop (didn't bet)
Seat 5: 1920kbps (small blind) folded before Flop
Seat 6: sttanlley (big blind) folded before Flop



PokerStars Hand #222949897976:  Hold'em No Limit ($0.05/$0.10 USD) - 2021/01/23 5:40:59 ET
Table 'Stephano III' 6-max Seat #5 is the button
Seat 1: TakMits ($19.12 in chips) 
Seat 2: Jonathan8765 ($11.80 in chips) 
Seat 3: praclovekzig ($7.89 in chips) 
Seat 5: 1920kbps ($10 in chips) 
Seat 6: sttanlley ($10 in chips) 
sttanlley: posts small blind $0.05
TakMits: posts big blind $0.10
*** HOLE CARDS ***
Jonathan8765: folds 
praclovekzig: calls $0.10
1920kbps: calls $0.10
sttanlley: calls $0.05
TakMits: checks 
*** FLOP *** [8d 9s 6c]
Schengo90 joins the table at seat #4 
sttanlley: checks 
TakMits: checks 
praclovekzig: bets $0.38
1920kbps: folds 
sttanlley: folds 
TakMits: folds 
Uncalled bet ($0.38) returned to praclovekzig
praclovekzig collected $0.38 from pot
praclovekzig: doesn't show hand 
*** SUMMARY ***
Total pot $0.40 | Rake $0.02 
Board [8d 9s 6c]
Seat 1: TakMits (big blind) folded on the Flop
Seat 2: Jonathan8765 folded before Flop (didn't bet)
Seat 3: praclovekzig collected ($0.38)
Seat 5: 1920kbps (button) folded on the Flop
Seat 6: sttanlley (small blind) folded on the Flop



PokerStars Hand #222949909706:  Hold'em No Limit ($0.05/$0.10 USD) - 2021/01/23 5:41:37 ET
Table 'Stephano III' 6-max Seat #6 is the button
Seat 1: TakMits ($19.02 in chips) 
Seat 2: Jonathan8765 ($11.80 in chips) 
Seat 3: praclovekzig ($8.17 in chips) 
Seat 5: 1920kbps ($10 in chips) 
Seat 6: sttanlley ($10 in chips) 
TakMits: posts small blind $0.05
Jonathan8765: posts big blind $0.10
Schengo90: sits out 
*** HOLE CARDS ***
praclovekzig: folds 
1920kbps: folds 
sttanlley: raises $0.15 to $0.25
TakMits: folds 
Jonathan8765: calls $0.15
*** FLOP *** [Ks 6h 8h]
Jonathan8765: checks 
sttanlley: checks 
*** TURN *** [Ks 6h 8h] [Ts]
Jonathan8765: checks 
sttanlley: checks 
*** RIVER *** [Ks 6h 8h Ts] [7d]
Jonathan8765: bets $0.35
sttanlley: folds 
Uncalled bet ($0.35) returned to Jonathan8765
Jonathan8765 collected $0.53 from pot
Jonathan8765: doesn't show hand 
*** SUMMARY ***
Total pot $0.55 | Rake $0.02 
Board [Ks 6h 8h Ts 7d]
Seat 1: TakMits (small blind) folded before Flop
Seat 2: Jonathan8765 (big blind) collected ($0.53)
Seat 3: praclovekzig folded before Flop (didn't bet)
Seat 5: 1920kbps folded before Flop (didn't bet)
Seat 6: sttanlley (button) folded on the River



PokerStars Hand #222949923298:  Hold'em No Limit ($0.05/$0.10 USD) - 2021/01/23 5:42:21 ET
Table 'Stephano III' 6-max Seat #1 is the button
Seat 1: TakMits ($18.97 in chips) 
Seat 2: Jonathan8765 ($12.08 in chips) 
Seat 3: praclovekzig ($8.17 in chips) 
Seat 5: 1920kbps ($10 in chips) 
Seat 6: sttanlley ($10 in chips) 
Jonathan8765: posts small blind $0.05
praclovekzig: posts big blind $0.10
Schengo90: sits out 
*** HOLE CARDS ***
1920kbps: folds 
sttanlley: folds 
TakMits: raises $0.12 to $0.22
Jonathan8765: calls $0.17
praclovekzig: calls $0.12
*** FLOP *** [5s 6h 7d]
Jonathan8765: checks 
praclovekzig: bets $0.32
TakMits: calls $0.32
Jonathan8765: raises $0.55 to $0.87
praclovekzig: folds 
TakMits: calls $0.55
*** TURN *** [5s 6h 7d] [Js]
Schengo90 leaves the table
Jonathan8765: bets $2.10
0TheMouse0 joins the table at seat #4 
TakMits: folds 
Uncalled bet ($2.10) returned to Jonathan8765
Jonathan8765 collected $2.60 from pot
Jonathan8765: doesn't show hand 
*** SUMMARY ***
Total pot $2.72 | Rake $0.12 
Board [5s 6h 7d Js]
Seat 1: TakMits (button) folded on the Turn
Seat 2: Jonathan8765 (small blind) collected ($2.60)
Seat 3: praclovekzig (big blind) folded on the Flop
Seat 5: 1920kbps folded before Flop (didn't bet)
Seat 6: sttanlley folded before Flop (didn't bet)



PokerStars Hand #222949936640:  Hold'em No Limit ($0.05/$0.10 USD) - 2021/01/23 5:43:03 ET
Table 'Stephano III' 6-max Seat #2 is the button
Seat 1: TakMits ($17.88 in chips) 
Seat 2: Jonathan8765 ($13.59 in chips) 
Seat 3: praclovekzig ($7.63 in chips) 
Seat 4: 0TheMouse0 ($10 in chips) 
Seat 5: 1920kbps ($10 in chips) 
Seat 6: sttanlley ($10 in chips) 
praclovekzig: posts small blind $0.05
0TheMouse0: posts big blind $0.10
*** HOLE CARDS ***
1920kbps: folds 
sttanlley: folds 
TakMits: folds 
Jonathan8765: folds 
praclovekzig: calls $0.05
0TheMouse0: raises $0.30 to $0.40
praclovekzig: folds 
Uncalled bet ($0.30) returned to 0TheMouse0
0TheMouse0 collected $0.20 from pot
0TheMouse0: doesn't show hand 
*** SUMMARY ***
Total pot $0.20 | Rake $0 
Seat 1: TakMits folded before Flop (didn't bet)
Seat 2: Jonathan8765 (button) folded before Flop (didn't bet)
Seat 3: praclovekzig (small blind) folded before Flop
Seat 4: 0TheMouse0 (big blind) collected ($0.20)
Seat 5: 1920kbps folded before Flop (didn't bet)
Seat 6: sttanlley folded before Flop (didn't bet)



PokerStars Hand #222949941213:  Hold'em No Limit ($0.05/$0.10 USD) - 2021/01/23 5:43:18 ET
Table 'Stephano III' 6-max Seat #3 is the button
Seat 1: TakMits ($17.88 in chips) 
Seat 2: Jonathan8765 ($13.59 in chips) 
Seat 3: praclovekzig ($7.53 in chips) 
Seat 4: 0TheMouse0 ($10.10 in chips) 
Seat 5: 1920kbps ($10 in chips) 
Seat 6: sttanlley ($10 in chips) 
0TheMouse0: posts small blind $0.05
1920kbps: posts big blind $0.10
*** HOLE CARDS ***
sttanlley: folds 
TakMits: folds 
Jonathan8765: folds 
praclovekzig: raises $0.20 to $0.30
0TheMouse0: folds 
1920kbps: folds 
Uncalled bet ($0.20) returned to praclovekzig
praclovekzig collected $0.25 from pot
praclovekzig: doesn't show hand 
*** SUMMARY ***
Total pot $0.25 | Rake $0 
Seat 1: TakMits folded before Flop (didn't bet)
Seat 2: Jonathan8765 folded before Flop (didn't bet)
Seat 3: praclovekzig (button) collected ($0.25)
Seat 4: 0TheMouse0 (small blind) folded before Flop
Seat 5: 1920kbps (big blind) folded before Flop
Seat 6: sttanlley folded before Flop (didn't bet)



PokerStars Hand #222949944332:  Hold'em No Limit ($0.05/$0.10 USD) - 2021/01/23 5:43:28 ET
Table 'Stephano III' 6-max Seat #4 is the button
Seat 1: TakMits ($17.88 in chips) 
Seat 2: Jonathan8765 ($13.59 in chips) 
Seat 3: praclovekzig ($7.68 in chips) 
Seat 4: 0TheMouse0 ($10.05 in chips) 
Seat 5: 1920kbps ($10 in chips) 
Seat 6: sttanlley ($10 in chips) 
1920kbps: posts small blind $0.05
sttanlley: posts big blind $0.10
*** HOLE CARDS ***
TakMits: folds 
Jonathan8765: folds 
praclovekzig: folds 
0TheMouse0: raises $0.15 to $0.25
1920kbps: folds 
sttanlley: folds 
Uncalled bet ($0.15) returned to 0TheMouse0
0TheMouse0 collected $0.25 from pot
0TheMouse0: doesn't show hand 
*** SUMMARY ***
Total pot $0.25 | Rake $0 
Seat 1: TakMits folded before Flop (didn't bet)
Seat 2: Jonathan8765 folded before Flop (didn't bet)
Seat 3: praclovekzig folded before Flop (didn't bet)
Seat 4: 0TheMouse0 (button) collected ($0.25)
Seat 5: 1920kbps (small blind) folded before Flop
Seat 6: sttanlley (big blind) folded before Flop



PokerStars Hand #222949950607:  Hold'em No Limit ($0.05/$0.10 USD) - 2021/01/23 5:43:48 ET
Table 'Stephano III' 6-max Seat #5 is the button
Seat 1: TakMits ($17.88 in chips) 
Seat 2: Jonathan8765 ($13.59 in chips) 
Seat 3: praclovekzig ($7.68 in chips) 
Seat 4: 0TheMouse0 ($10.20 in chips) 
Seat 5: 1920kbps ($10 in chips) 
Seat 6: sttanlley ($10 in chips) 
sttanlley: posts small blind $0.05
TakMits: posts big blind $0.10
*** HOLE CARDS ***
Jonathan8765: raises $0.13 to $0.23
praclovekzig: folds 
0TheMouse0: folds 
1920kbps: calls $0.23
sttanlley: folds 
TakMits: folds 
*** FLOP *** [4s 2c 3h]
Jonathan8765: bets $0.38
1920kbps: calls $0.38
*** TURN *** [4s 2c 3h] [6h]
Jonathan8765: bets $0.70
1920kbps: calls $0.70
*** RIVER *** [4s 2c 3h 6h] [Kc]
Jonathan8765: checks 
1920kbps: checks 
*** SHOW DOWN ***
Jonathan8765: shows [8c 8s] (a pair of Eights)
1920kbps: mucks hand 
Jonathan8765 collected $2.65 from pot
*** SUMMARY ***
Total pot $2.77 | Rake $0.12 
Board [4s 2c 3h 6h Kc]
Seat 1: TakMits (big blind) folded before Flop
Seat 2: Jonathan8765 showed [8c 8s] and won ($2.65) with a pair of Eights
Seat 3: praclovekzig folded before Flop (didn't bet)
Seat 4: 0TheMouse0 folded before Flop (didn't bet)
Seat 5: 1920kbps (button) mucked
Seat 6: sttanlley (small blind) folded before Flop



PokerStars Hand #222949962138:  Hold'em No Limit ($0.05/$0.10 USD) - 2021/01/23 5:44:25 ET
Table 'Stephano III' 6-max Seat #6 is the button
Seat 1: TakMits ($17.78 in chips) 
Seat 2: Jonathan8765 ($14.93 in chips) 
Seat 3: praclovekzig ($7.68 in chips) 
Seat 4: 0TheMouse0 ($10.20 in chips) 
Seat 5: 1920kbps ($10 in chips) 
Seat 6: sttanlley ($10 in chips) 
TakMits: posts small blind $0.05
Jonathan8765: posts big blind $0.10
*** HOLE CARDS ***
praclovekzig: calls $0.10
0TheMouse0: folds 
1920kbps: folds 
sttanlley: folds 
TakMits: calls $0.05
Jonathan8765: checks 
*** FLOP *** [Ah Td 2d]
TakMits: checks 
Jonathan8765: checks 
praclovekzig: checks 
*** TURN *** [Ah Td 2d] [Ac]
TakMits: bets $0.15
Jonathan8765: calls $0.15
praclovekzig: folds 
*** RIVER *** [Ah Td 2d Ac] [3c]
TakMits: checks 
Jonathan8765: checks 
*** SHOW DOWN ***
TakMits: shows [Th 8c] (two pair, Aces and Tens)
Jonathan8765: mucks hand 
TakMits collected $0.57 from pot
*** SUMMARY ***
Total pot $0.60 | Rake $0.03 
Board [Ah Td 2d Ac 3c]
Seat 1: TakMits (small blind) showed [Th 8c] and won ($0.57) with two pair, Aces and Tens
Seat 2: Jonathan8765 (big blind) mucked
Seat 3: praclovekzig folded on the Turn
Seat 4: 0TheMouse0 folded before Flop (didn't bet)
Seat 5: 1920kbps folded before Flop (didn't bet)
Seat 6: sttanlley (button) folded before Flop (didn't bet)



PokerStars Hand #222949970769:  Hold'em No Limit ($0.05/$0.10 USD) - 2021/01/23 5:44:52 ET
Table 'Stephano III' 6-max Seat #1 is the button
Seat 1: TakMits ($18.10 in chips) 
Seat 2: Jonathan8765 ($14.68 in chips) 
Seat 3: praclovekzig ($7.58 in chips) 
Seat 4: 0TheMouse0 ($10.20 in chips) 
Seat 5: 1920kbps ($10 in chips) 
Seat 6: sttanlley ($10 in chips) 
Jonathan8765: posts small blind $0.05
praclovekzig: posts big blind $0.10
*** HOLE CARDS ***
0TheMouse0: folds 
1920kbps: raises $0.20 to $0.30
sttanlley: folds 
TakMits: folds 
Jonathan8765: calls $0.25
praclovekzig: folds 
*** FLOP *** [2c Kd 8s]
Jonathan8765: checks 
1920kbps: checks 
*** TURN *** [2c Kd 8s] [9h]
Jonathan8765: checks 
1920kbps: checks 
*** RIVER *** [2c Kd 8s 9h] [9c]
Jonathan8765: checks 
1920kbps: checks 
*** SHOW DOWN ***
Jonathan8765: shows [Ah Qd] (a pair of Nines)
1920kbps: mucks hand 
Jonathan8765 collected $0.67 from pot
*** SUMMARY ***
Total pot $0.70 | Rake $0.03 
Board [2c Kd 8s 9h 9c]
Seat 1: TakMits (button) folded before Flop (didn't bet)
Seat 2: Jonathan8765 (small blind) showed [Ah Qd] and won ($0.67) with a pair of Nines
Seat 3: praclovekzig (big blind) folded before Flop
Seat 4: 0TheMouse0 folded before Flop (didn't bet)
Seat 5: 1920kbps mucked
Seat 6: sttanlley folded before Flop (didn't bet)



PokerStars Hand #222949976966:  Hold'em No Limit ($0.05/$0.10 USD) - 2021/01/23 5:45:11 ET
Table 'Stephano III' 6-max Seat #2 is the button
Seat 1: TakMits ($18.10 in chips) 
Seat 2: Jonathan8765 ($15.05 in chips) 
Seat 3: praclovekzig ($7.48 in chips) 
Seat 4: 0TheMouse0 ($10.20 in chips) 
Seat 5: 1920kbps ($10 in chips) 
Seat 6: sttanlley ($10 in chips) 
praclovekzig: posts small blind $0.05
0TheMouse0: posts big blind $0.10
*** HOLE CARDS ***
1920kbps: folds 
sttanlley: folds 
TakMits: raises $0.12 to $0.22
Jonathan8765: folds 
praclovekzig: folds 
0TheMouse0: folds 
Uncalled bet ($0.12) returned to TakMits
TakMits collected $0.25 from pot
TakMits: doesn't show hand 
*** SUMMARY ***
Total pot $0.25 | Rake $0 
Seat 1: TakMits collected ($0.25)
Seat 2: Jonathan8765 (button) folded before Flop (didn't bet)
Seat 3: praclovekzig (small blind) folded before Flop
Seat 4: 0TheMouse0 (big blind) folded before Flop
Seat 5: 1920kbps folded before Flop (didn't bet)
Seat 6: sttanlley folded before Flop (didn't bet)



PokerStars Hand #222949981647:  Hold'em No Limit ($0.05/$0.10 USD) - 2021/01/23 5:45:26 ET
Table 'Stephano III' 6-max Seat #3 is the button
Seat 1: TakMits ($18.25 in chips) 
Seat 2: Jonathan8765 ($15.05 in chips) 
Seat 3: praclovekzig ($7.43 in chips) 
Seat 4: 0TheMouse0 ($10.10 in chips) 
Seat 5: 1920kbps ($10 in chips) 
Seat 6: sttanlley ($10 in chips) 
0TheMouse0: posts small blind $0.05
1920kbps: posts big blind $0.10
*** HOLE CARDS ***
sttanlley: raises $0.20 to $0.30
TakMits: folds 
Jonathan8765: folds 
praclovekzig: folds 
0TheMouse0: folds 
1920kbps: folds 
Uncalled bet ($0.20) returned to sttanlley
sttanlley collected $0.25 from pot
sttanlley: doesn't show hand 
*** SUMMARY ***
Total pot $0.25 | Rake $0 
Seat 1: TakMits folded before Flop (didn't bet)
Seat 2: Jonathan8765 folded before Flop (didn't bet)
Seat 3: praclovekzig (button) folded before Flop (didn't bet)
Seat 4: 0TheMouse0 (small blind) folded before Flop
Seat 5: 1920kbps (big blind) folded before Flop
Seat 6: sttanlley collected ($0.25)



PokerStars Hand #222949985525:  Hold'em No Limit ($0.05/$0.10 USD) - 2021/01/23 5:45:38 ET
Table 'Stephano III' 6-max Seat #4 is the button
Seat 1: TakMits ($18.25 in chips) 
Seat 2: Jonathan8765 ($15.05 in chips) 
Seat 3: praclovekzig ($7.43 in chips) 
Seat 4: 0TheMouse0 ($10.05 in chips) 
Seat 5: 1920kbps ($10 in chips) 
Seat 6: sttanlley ($10.15 in chips) 
1920kbps: posts small blind $0.05
sttanlley: posts big blind $0.10
*** HOLE CARDS ***
TakMits: folds 
Jonathan8765: raises $0.13 to $0.23
praclovekzig: folds 
0TheMouse0: folds 
1920kbps: folds 
sttanlley: folds 
Uncalled bet ($0.13) returned to Jonathan8765
Jonathan8765 collected $0.25 from pot
Jonathan8765: doesn't show hand 
praclovekzig leaves the table
*** SUMMARY ***
Total pot $0.25 | Rake $0 
Seat 1: TakMits folded before Flop (didn't bet)
Seat 2: Jonathan8765 collected ($0.25)
Seat 3: praclovekzig folded before Flop (didn't bet)
Seat 4: 0TheMouse0 (button) folded before Flop (didn't bet)
Seat 5: 1920kbps (small blind) folded before Flop
Seat 6: sttanlley (big blind) folded before Flop



PokerStars Hand #222949991144:  Hold'em No Limit ($0.05/$0.10 USD) - 2021/01/23 5:45:56 ET
Table 'Stephano III' 6-max Seat #5 is the button
Seat 1: TakMits ($18.25 in chips) 
Seat 2: Jonathan8765 ($15.20 in chips) 
Seat 4: 0TheMouse0 ($10.05 in chips) 
Seat 5: 1920kbps ($10 in chips) 
Seat 6: sttanlley ($10.05 in chips) 
sttanlley: posts small blind $0.05
TakMits: posts big blind $0.10
*** HOLE CARDS ***
Jonathan8765: folds 
0TheMouse0: folds 
VascoSerg joins the table at seat #3 
1920kbps: raises $0.15 to $0.25
sttanlley: folds 
TakMits: folds 
Uncalled bet ($0.15) returned to 1920kbps
1920kbps collected $0.25 from pot
*** SUMMARY ***
Total pot $0.25 | Rake $0 
Seat 1: TakMits (big blind) folded before Flop
Seat 2: Jonathan8765 folded before Flop (didn't bet)
Seat 4: 0TheMouse0 folded before Flop (didn't bet)
Seat 5: 1920kbps (button) collected ($0.25)
Seat 6: sttanlley (small blind) folded before Flop



PokerStars Hand #222949996014:  Hold'em No Limit ($0.05/$0.10 USD) - 2021/01/23 5:46:11 ET
Table 'Stephano III' 6-max Seat #6 is the button
Seat 1: TakMits ($18.15 in chips) 
Seat 2: Jonathan8765 ($15.20 in chips) 
Seat 4: 0TheMouse0 ($10.05 in chips) 
Seat 5: 1920kbps ($10.15 in chips) 
Seat 6: sttanlley ($10 in chips) 
TakMits: posts small blind $0.05
Jonathan8765: posts big blind $0.10
VascoSerg: sits out 
*** HOLE CARDS ***
0TheMouse0: raises $0.15 to $0.25
1920kbps: raises $0.75 to $1
sttanlley: folds 
TakMits: folds 
Jonathan8765: folds 
0TheMouse0: raises $9.05 to $10.05 and is all-in
1920kbps: calls $9.05
*** FLOP *** [Ts 4d 5d]
*** TURN *** [Ts 4d 5d] [4s]
*** RIVER *** [Ts 4d 5d 4s] [Qh]
*** SHOW DOWN ***
0TheMouse0: shows [Ah Kh] (a pair of Fours)
1920kbps: shows [Kd Kc] (two pair, Kings and Fours)
1920kbps collected $19.34 from pot
*** SUMMARY ***
Total pot $20.25 | Rake $0.91 
Board [Ts 4d 5d 4s Qh]
Seat 1: TakMits (small blind) folded before Flop
Seat 2: Jonathan8765 (big blind) folded before Flop
Seat 4: 0TheMouse0 showed [Ah Kh] and lost with a pair of Fours
Seat 5: 1920kbps showed [Kd Kc] and won ($19.34) with two pair, Kings and Fours
Seat 6: sttanlley (button) folded before Flop (didn't bet)



PokerStars Hand #222950005261:  Hold'em No Limit ($0.05/$0.10 USD) - 2021/01/23 5:46:41 ET
Table 'Stephano III' 6-max Seat #1 is the button
Seat 1: TakMits ($18.10 in chips) 
Seat 2: Jonathan8765 ($15.10 in chips) 
Seat 3: VascoSerg ($10 in chips) 
Seat 4: 0TheMouse0 ($10 in chips) 
Seat 5: 1920kbps ($19.44 in chips) 
Seat 6: sttanlley ($10 in chips) 
Jonathan8765: posts small blind $0.05
VascoSerg: posts big blind $0.10
*** HOLE CARDS ***
0TheMouse0: folds 
1920kbps: folds 
sttanlley: folds 
TakMits: folds 
Jonathan8765: folds 
Uncalled bet ($0.05) returned to VascoSerg
VascoSerg collected $0.10 from pot
VascoSerg: doesn't show hand 
*** SUMMARY ***
Total pot $0.10 | Rake $0 
Seat 1: TakMits (button) folded before Flop (didn't bet)
Seat 2: Jonathan8765 (small blind) folded before Flop
Seat 3: VascoSerg (big blind) collected ($0.10)
Seat 4: 0TheMouse0 folded before Flop (didn't bet)
Seat 5: 1920kbps folded before Flop (didn't bet)
Seat 6: sttanlley folded before Flop (didn't bet)



PokerStars Hand #222950008061:  Hold'em No Limit ($0.05/$0.10 USD) - 2021/01/23 5:46:50 ET
Table 'Stephano III' 6-max Seat #2 is the button
Seat 1: TakMits ($18.10 in chips) 
Seat 2: Jonathan8765 ($15.05 in chips) 
Seat 3: VascoSerg ($10.05 in chips) 
Seat 4: 0TheMouse0 ($10 in chips) 
Seat 5: 1920kbps ($19.44 in chips) 
Seat 6: sttanlley ($10 in chips) 
VascoSerg: posts small blind $0.05
0TheMouse0: posts big blind $0.10
*** HOLE CARDS ***
1920kbps: raises $0.20 to $0.30
sttanlley: calls $0.30
TakMits: folds 
Jonathan8765: folds 
VascoSerg: folds 
0TheMouse0: folds 
*** FLOP *** [9c Qc Tc]
1920kbps: checks 
sttanlley: checks 
*** TURN *** [9c Qc Tc] [5h]
1920kbps: checks 
sttanlley: bets $0.40
1920kbps: folds 
Uncalled bet ($0.40) returned to sttanlley
sttanlley collected $0.72 from pot
sttanlley: doesn't show hand 
*** SUMMARY ***
Total pot $0.75 | Rake $0.03 
Board [9c Qc Tc 5h]
Seat 1: TakMits folded before Flop (didn't bet)
Seat 2: Jonathan8765 (button) folded before Flop (didn't bet)
Seat 3: VascoSerg (small blind) folded before Flop
Seat 4: 0TheMouse0 (big blind) folded before Flop
Seat 5: 1920kbps folded on the Turn
Seat 6: sttanlley collected ($0.72)



PokerStars Hand #222950016130:  Hold'em No Limit ($0.05/$0.10 USD) - 2021/01/23 5:47:15 ET
Table 'Stephano III' 6-max Seat #3 is the button
Seat 1: TakMits ($18.10 in chips) 
Seat 2: Jonathan8765 ($15.05 in chips) 
Seat 3: VascoSerg ($10 in chips) 
Seat 4: 0TheMouse0 ($10 in chips) 
Seat 5: 1920kbps ($19.14 in chips) 
Seat 6: sttanlley ($10.42 in chips) 
0TheMouse0: posts small blind $0.05
1920kbps: posts big blind $0.10
*** HOLE CARDS ***
sttanlley: folds 
TakMits: folds 
Jonathan8765: folds 
VascoSerg: folds 
0TheMouse0: folds 
Uncalled bet ($0.05) returned to 1920kbps
1920kbps collected $0.10 from pot
*** SUMMARY ***
Total pot $0.10 | Rake $0 
Seat 1: TakMits folded before Flop (didn't bet)
Seat 2: Jonathan8765 folded before Flop (didn't bet)
Seat 3: VascoSerg (button) folded before Flop (didn't bet)
Seat 4: 0TheMouse0 (small blind) folded before Flop
Seat 5: 1920kbps (big blind) collected ($0.10)
Seat 6: sttanlley folded before Flop (didn't bet)



PokerStars Hand #222950020430:  Hold'em No Limit ($0.05/$0.10 USD) - 2021/01/23 5:47:29 ET
Table 'Stephano III' 6-max Seat #4 is the button
Seat 1: TakMits ($18.10 in chips) 
Seat 2: Jonathan8765 ($15.05 in chips) 
Seat 3: VascoSerg ($10 in chips) 
Seat 4: 0TheMouse0 ($10 in chips) 
Seat 5: 1920kbps ($19.19 in chips) 
Seat 6: sttanlley ($10.42 in chips) 
1920kbps: posts small blind $0.05
sttanlley: posts big blind $0.10
*** HOLE CARDS ***
TakMits: raises $0.17 to $0.27
Jonathan8765: folds 
VascoSerg: folds 
0TheMouse0: folds 
1920kbps: folds 
sttanlley: folds 
Uncalled bet ($0.17) returned to TakMits
TakMits collected $0.25 from pot
TakMits: doesn't show hand 
*** SUMMARY ***
Total pot $0.25 | Rake $0 
Seat 1: TakMits collected ($0.25)
Seat 2: Jonathan8765 folded before Flop (didn't bet)
Seat 3: VascoSerg folded before Flop (didn't bet)
Seat 4: 0TheMouse0 (button) folded before Flop (didn't bet)
Seat 5: 1920kbps (small blind) folded before Flop
Seat 6: sttanlley (big blind) folded before Flop



PokerStars Hand #222950023890:  Hold'em No Limit ($0.05/$0.10 USD) - 2021/01/23 5:47:40 ET
Table 'Stephano III' 6-max Seat #5 is the button
Seat 1: TakMits ($18.25 in chips) 
Seat 2: Jonathan8765 ($15.05 in chips) 
Seat 3: VascoSerg ($10 in chips) 
Seat 4: 0TheMouse0 ($10 in chips) 
Seat 5: 1920kbps ($19.14 in chips) 
Seat 6: sttanlley ($10.32 in chips) 
sttanlley: posts small blind $0.05
TakMits: posts big blind $0.10
*** HOLE CARDS ***
Jonathan8765: folds 
VascoSerg: folds 
0TheMouse0: folds 
1920kbps: raises $0.15 to $0.25
sttanlley: folds 
TakMits: folds 
Uncalled bet ($0.15) returned to 1920kbps
1920kbps collected $0.25 from pot
*** SUMMARY ***
Total pot $0.25 | Rake $0 
Seat 1: TakMits (big blind) folded before Flop
Seat 2: Jonathan8765 folded before Flop (didn't bet)
Seat 3: VascoSerg folded before Flop (didn't bet)
Seat 4: 0TheMouse0 folded before Flop (didn't bet)
Seat 5: 1920kbps (button) collected ($0.25)
Seat 6: sttanlley (small blind) folded before Flop



PokerStars Hand #222950027875:  Hold'em No Limit ($0.05/$0.10 USD) - 2021/01/23 5:47:52 ET
Table 'Stephano III' 6-max Seat #6 is the button
Seat 1: TakMits ($18.15 in chips) 
Seat 2: Jonathan8765 ($15.05 in chips) 
Seat 3: VascoSerg ($10 in chips) 
Seat 4: 0TheMouse0 ($10 in chips) 
Seat 5: 1920kbps ($19.29 in chips) 
Seat 6: sttanlley ($10.27 in chips) 
TakMits: posts small blind $0.05
Jonathan8765: posts big blind $0.10
*** HOLE CARDS ***
VascoSerg: folds 
0TheMouse0: folds 
1920kbps: raises $0.20 to $0.30
sttanlley: folds 
TakMits: folds 
Jonathan8765: calls $0.20
*** FLOP *** [Jd Tc Qc]
Jonathan8765: checks 
1920kbps: checks 
*** TURN *** [Jd Tc Qc] [8d]
Jonathan8765: bets $0.40
1920kbps: folds 
Uncalled bet ($0.40) returned to Jonathan8765
Jonathan8765 collected $0.62 from pot
Jonathan8765: doesn't show hand 
*** SUMMARY ***
Total pot $0.65 | Rake $0.03 
Board [Jd Tc Qc 8d]
Seat 1: TakMits (small blind) folded before Flop
Seat 2: Jonathan8765 (big blind) collected ($0.62)
Seat 3: VascoSerg folded before Flop (didn't bet)
Seat 4: 0TheMouse0 folded before Flop (didn't bet)
Seat 5: 1920kbps folded on the Turn
Seat 6: sttanlley (button) folded before Flop (didn't bet)



PokerStars Hand #222950035289:  Hold'em No Limit ($0.05/$0.10 USD) - 2021/01/23 5:48:15 ET
Table 'Stephano III' 6-max Seat #1 is the button
Seat 1: TakMits ($18.10 in chips) 
Seat 2: Jonathan8765 ($15.37 in chips) 
Seat 3: VascoSerg ($10 in chips) 
Seat 4: 0TheMouse0 ($10 in chips) 
Seat 5: 1920kbps ($18.99 in chips) 
Seat 6: sttanlley ($10.27 in chips) 
Jonathan8765: posts small blind $0.05
VascoSerg: posts big blind $0.10
*** HOLE CARDS ***
0TheMouse0: folds 
1920kbps: folds 
sttanlley: folds 
TakMits: folds 
Jonathan8765: raises $0.10 to $0.20
VascoSerg: folds 
Uncalled bet ($0.10) returned to Jonathan8765
Jonathan8765 collected $0.20 from pot
Jonathan8765: doesn't show hand 
*** SUMMARY ***
Total pot $0.20 | Rake $0 
Seat 1: TakMits (button) folded before Flop (didn't bet)
Seat 2: Jonathan8765 (small blind) collected ($0.20)
Seat 3: VascoSerg (big blind) folded before Flop
Seat 4: 0TheMouse0 folded before Flop (didn't bet)
Seat 5: 1920kbps folded before Flop (didn't bet)
Seat 6: sttanlley folded before Flop (didn't bet)



PokerStars Hand #222950039125:  Hold'em No Limit ($0.05/$0.10 USD) - 2021/01/23 5:48:28 ET
Table 'Stephano III' 6-max Seat #2 is the button
Seat 1: TakMits ($18.10 in chips) 
Seat 2: Jonathan8765 ($15.47 in chips) 
Seat 3: VascoSerg ($10 in chips) 
Seat 4: 0TheMouse0 ($10 in chips) 
Seat 5: 1920kbps ($18.99 in chips) 
Seat 6: sttanlley ($10.27 in chips) 
VascoSerg: posts small blind $0.05
0TheMouse0: posts big blind $0.10
*** HOLE CARDS ***
1920kbps: folds 
sttanlley: folds 
TakMits: folds 
Jonathan8765: folds 
VascoSerg: raises $0.20 to $0.30
0TheMouse0: folds 
Uncalled bet ($0.20) returned to VascoSerg
VascoSerg collected $0.20 from pot
VascoSerg: doesn't show hand 
*** SUMMARY ***
Total pot $0.20 | Rake $0 
Seat 1: TakMits folded before Flop (didn't bet)
Seat 2: Jonathan8765 (button) folded before Flop (didn't bet)
Seat 3: VascoSerg (small blind) collected ($0.20)
Seat 4: 0TheMouse0 (big blind) folded before Flop
Seat 5: 1920kbps folded before Flop (didn't bet)
Seat 6: sttanlley folded before Flop (didn't bet)



PokerStars Hand #222950043473:  Hold'em No Limit ($0.05/$0.10 USD) - 2021/01/23 5:48:41 ET
Table 'Stephano III' 6-max Seat #3 is the button
Seat 1: TakMits ($18.10 in chips) 
Seat 2: Jonathan8765 ($15.47 in chips) 
Seat 3: VascoSerg ($10.10 in chips) 
Seat 4: 0TheMouse0 ($10 in chips) 
Seat 5: 1920kbps ($18.99 in chips) 
Seat 6: sttanlley ($10.27 in chips) 
0TheMouse0: posts small blind $0.05
1920kbps: posts big blind $0.10
*** HOLE CARDS ***
sttanlley: folds 
TakMits: folds 
Jonathan8765: raises $0.13 to $0.23
VascoSerg: folds 
0TheMouse0: folds 
1920kbps: folds 
Uncalled bet ($0.13) returned to Jonathan8765
Jonathan8765 collected $0.25 from pot
Jonathan8765: doesn't show hand 
*** SUMMARY ***
Total pot $0.25 | Rake $0 
Seat 1: TakMits folded before Flop (didn't bet)
Seat 2: Jonathan8765 collected ($0.25)
Seat 3: VascoSerg (button) folded before Flop (didn't bet)
Seat 4: 0TheMouse0 (small blind) folded before Flop
Seat 5: 1920kbps (big blind) folded before Flop
Seat 6: sttanlley folded before Flop (didn't bet)



PokerStars Hand #222950049031:  Hold'em No Limit ($0.05/$0.10 USD) - 2021/01/23 5:48:59 ET
Table 'Stephano III' 6-max Seat #4 is the button
Seat 1: TakMits ($18.10 in chips) 
Seat 2: Jonathan8765 ($15.62 in chips) 
Seat 3: VascoSerg ($10.10 in chips) 
Seat 4: 0TheMouse0 ($10 in chips) 
Seat 5: 1920kbps ($18.89 in chips) 
Seat 6: sttanlley ($10.27 in chips) 
1920kbps: posts small blind $0.05
sttanlley: posts big blind $0.10
*** HOLE CARDS ***
TakMits: folds 
Jonathan8765: folds 
VascoSerg: folds 
0TheMouse0: raises $0.15 to $0.25
1920kbps: folds 
sttanlley: folds 
Uncalled bet ($0.15) returned to 0TheMouse0
0TheMouse0 collected $0.25 from pot
0TheMouse0: doesn't show hand 
*** SUMMARY ***
Total pot $0.25 | Rake $0 
Seat 1: TakMits folded before Flop (didn't bet)
Seat 2: Jonathan8765 folded before Flop (didn't bet)
Seat 3: VascoSerg folded before Flop (didn't bet)
Seat 4: 0TheMouse0 (button) collected ($0.25)
Seat 5: 1920kbps (small blind) folded before Flop
Seat 6: sttanlley (big blind) folded before Flop



PokerStars Hand #222950053822:  Hold'em No Limit ($0.05/$0.10 USD) - 2021/01/23 5:49:14 ET
Table 'Stephano III' 6-max Seat #5 is the button
Seat 1: TakMits ($18.10 in chips) 
Seat 2: Jonathan8765 ($15.62 in chips) 
Seat 3: VascoSerg ($10.10 in chips) 
Seat 4: 0TheMouse0 ($10.15 in chips) 
Seat 5: 1920kbps ($18.84 in chips) 
Seat 6: sttanlley ($10.17 in chips) 
sttanlley: posts small blind $0.05
TakMits: posts big blind $0.10
*** HOLE CARDS ***
Jonathan8765: raises $0.13 to $0.23
VascoSerg: folds 
0TheMouse0: folds 
1920kbps: folds 
sttanlley: folds 
TakMits: folds 
Uncalled bet ($0.13) returned to Jonathan8765
Jonathan8765 collected $0.25 from pot
Jonathan8765: doesn't show hand 
*** SUMMARY ***
Total pot $0.25 | Rake $0 
Seat 1: TakMits (big blind) folded before Flop
Seat 2: Jonathan8765 collected ($0.25)
Seat 3: VascoSerg folded before Flop (didn't bet)
Seat 4: 0TheMouse0 folded before Flop (didn't bet)
Seat 5: 1920kbps (button) folded before Flop (didn't bet)
Seat 6: sttanlley (small blind) folded before Flop



PokerStars Hand #222950060087:  Hold'em No Limit ($0.05/$0.10 USD) - 2021/01/23 5:49:34 ET
Table 'Stephano III' 6-max Seat #6 is the button
Seat 1: TakMits ($18 in chips) 
Seat 2: Jonathan8765 ($15.77 in chips) 
Seat 3: VascoSerg ($10.10 in chips) 
Seat 4: 0TheMouse0 ($10.15 in chips) 
Seat 5: 1920kbps ($18.84 in chips) 
Seat 6: sttanlley ($10.12 in chips) 
TakMits: posts small blind $0.05
Jonathan8765: posts big blind $0.10
*** HOLE CARDS ***
VascoSerg: raises $0.20 to $0.30
0TheMouse0: folds 
1920kbps: calls $0.30
sttanlley: folds 
TakMits: raises $1.40 to $1.70
Jonathan8765: folds 
VascoSerg: folds 
1920kbps: folds 
Uncalled bet ($1.40) returned to TakMits
TakMits collected $1 from pot
TakMits: doesn't show hand 
*** SUMMARY ***
Total pot $1 | Rake $0 
Seat 1: TakMits (small blind) collected ($1)
Seat 2: Jonathan8765 (big blind) folded before Flop
Seat 3: VascoSerg folded before Flop
Seat 4: 0TheMouse0 folded before Flop (didn't bet)
Seat 5: 1920kbps folded before Flop
Seat 6: sttanlley (button) folded before Flop (didn't bet)



PokerStars Hand #222950069841:  Hold'em No Limit ($0.05/$0.10 USD) - 2021/01/23 5:50:05 ET
Table 'Stephano III' 6-max Seat #1 is the button
Seat 1: TakMits ($18.70 in chips) 
Seat 2: Jonathan8765 ($15.67 in chips) 
Seat 4: 0TheMouse0 ($10.15 in chips) 
Seat 5: 1920kbps ($18.54 in chips) 
Seat 6: sttanlley ($10.12 in chips) 
Jonathan8765: posts small blind $0.05
VascoSerg: is sitting out 
0TheMouse0: posts big blind $0.10
*** HOLE CARDS ***
1920kbps: folds 
sttanlley: folds 
TakMits: raises $0.12 to $0.22
Jonathan8765: folds 
0TheMouse0: folds 
Uncalled bet ($0.12) returned to TakMits
TakMits collected $0.25 from pot
TakMits: doesn't show hand 
*** SUMMARY ***
Total pot $0.25 | Rake $0 
Seat 1: TakMits (button) collected ($0.25)
Seat 2: Jonathan8765 (small blind) folded before Flop
Seat 4: 0TheMouse0 (big blind) folded before Flop
Seat 5: 1920kbps folded before Flop (didn't bet)
Seat 6: sttanlley folded before Flop (didn't bet)



PokerStars Hand #222950074646:  Hold'em No Limit ($0.05/$0.10 USD) - 2021/01/23 5:50:20 ET
Table 'Stephano III' 6-max Seat #2 is the button
Seat 1: TakMits ($18.85 in chips) 
Seat 2: Jonathan8765 ($15.62 in chips) 
Seat 4: 0TheMouse0 ($10.05 in chips) 
Seat 5: 1920kbps ($18.54 in chips) 
Seat 6: sttanlley ($10.12 in chips) 
0TheMouse0: posts small blind $0.05
1920kbps: posts big blind $0.10
*** HOLE CARDS ***
sttanlley: folds 
TakMits: folds 
Jonathan8765: folds 
0TheMouse0: folds 
Uncalled bet ($0.05) returned to 1920kbps
1920kbps collected $0.10 from pot
*** SUMMARY ***
Total pot $0.10 | Rake $0 
Seat 1: TakMits folded before Flop (didn't bet)
Seat 2: Jonathan8765 (button) folded before Flop (didn't bet)
Seat 4: 0TheMouse0 (small blind) folded before Flop
Seat 5: 1920kbps (big blind) collected ($0.10)
Seat 6: sttanlley folded before Flop (didn't bet)



PokerStars Hand #222950077393:  Hold'em No Limit ($0.05/$0.10 USD) - 2021/01/23 5:50:29 ET
Table 'Stephano III' 6-max Seat #4 is the button
Seat 1: TakMits ($18.85 in chips) 
Seat 2: Jonathan8765 ($15.62 in chips) 
Seat 4: 0TheMouse0 ($10 in chips) 
Seat 5: 1920kbps ($18.59 in chips) 
Seat 6: sttanlley ($10.12 in chips) 
1920kbps: posts small blind $0.05
sttanlley: posts big blind $0.10
*** HOLE CARDS ***
VascoSerg leaves the table
TakMits: raises $0.17 to $0.27
Jonathan8765: calls $0.27
0TheMouse0: folds 
1920kbps: folds 
sttanlley: calls $0.17
*** FLOP *** [5d Ad 8d]
sttanlley: checks 
TakMits: checks 
Jonathan8765: checks 
*** TURN *** [5d Ad 8d] [6d]
sttanlley: checks 
TakMits: checks 
Jonathan8765: bets $0.30
sttanlley: folds 
TakMits: folds 
Uncalled bet ($0.30) returned to Jonathan8765
Jonathan8765 collected $0.82 from pot
Jonathan8765: doesn't show hand 
*** SUMMARY ***
Total pot $0.86 | Rake $0.04 
Board [5d Ad 8d 6d]
Seat 1: TakMits folded on the Turn
Seat 2: Jonathan8765 collected ($0.82)
Seat 4: 0TheMouse0 (button) folded before Flop (didn't bet)
Seat 5: 1920kbps (small blind) folded before Flop
Seat 6: sttanlley (big blind) folded on the Turn



PokerStars Hand #222950086627:  Hold'em No Limit ($0.05/$0.10 USD) - 2021/01/23 5:50:58 ET
Table 'Stephano III' 6-max Seat #5 is the button
Seat 2: Jonathan8765 ($16.17 in chips) 
Seat 4: 0TheMouse0 ($10 in chips) 
Seat 5: 1920kbps ($18.54 in chips) 
Seat 6: sttanlley ($10 in chips) 
sttanlley: posts small blind $0.05
TakMits: is sitting out 
Jonathan8765: posts big blind $0.10
*** HOLE CARDS ***
0TheMouse0: folds 
1920kbps: folds 
sttanlley: raises $0.15 to $0.25
Jonathan8765: folds 
Uncalled bet ($0.15) returned to sttanlley
sttanlley collected $0.20 from pot
sttanlley: doesn't show hand 
*** SUMMARY ***
Total pot $0.20 | Rake $0 
Seat 2: Jonathan8765 (big blind) folded before Flop
Seat 4: 0TheMouse0 folded before Flop (didn't bet)
Seat 5: 1920kbps (button) folded before Flop (didn't bet)
Seat 6: sttanlley (small blind) collected ($0.20)



PokerStars Hand #222950090276:  Hold'em No Limit ($0.05/$0.10 USD) - 2021/01/23 5:51:10 ET
Table 'Stephano III' 6-max Seat #6 is the button
Seat 2: Jonathan8765 ($16.07 in chips) 
Seat 4: 0TheMouse0 ($10 in chips) 
Seat 5: 1920kbps ($18.54 in chips) 
Seat 6: sttanlley ($10.10 in chips) 
Jonathan8765: posts small blind $0.05
0TheMouse0: posts big blind $0.10
*** HOLE CARDS ***
1920kbps: folds 
TakMits leaves the table
sttanlley: folds 
Jonathan8765: raises $0.10 to $0.20
0TheMouse0: folds 
Uncalled bet ($0.10) returned to Jonathan8765
Jonathan8765 collected $0.20 from pot
Jonathan8765: doesn't show hand 
*** SUMMARY ***
Total pot $0.20 | Rake $0 
Seat 2: Jonathan8765 (small blind) collected ($0.20)
Seat 4: 0TheMouse0 (big blind) folded before Flop
Seat 5: 1920kbps folded before Flop (didn't bet)
Seat 6: sttanlley (button) folded before Flop (didn't bet)



PokerStars Hand #222950094956:  Hold'em No Limit ($0.05/$0.10 USD) - 2021/01/23 5:51:24 ET
Table 'Stephano III' 6-max Seat #2 is the button
Seat 2: Jonathan8765 ($16.17 in chips) 
Seat 4: 0TheMouse0 ($10 in chips) 
Seat 5: 1920kbps ($18.54 in chips) 
Seat 6: sttanlley ($10.10 in chips) 
0TheMouse0: posts small blind $0.05
1920kbps: posts big blind $0.10
*** HOLE CARDS ***
sttanlley: folds 
Jonathan8765: folds 
sttanlley leaves the table
0TheMouse0: raises $0.20 to $0.30
1920kbps: folds 
Uncalled bet ($0.20) returned to 0TheMouse0
0TheMouse0 collected $0.20 from pot
0TheMouse0: doesn't show hand 
*** SUMMARY ***
Total pot $0.20 | Rake $0 
Seat 2: Jonathan8765 (button) folded before Flop (didn't bet)
Seat 4: 0TheMouse0 (small blind) collected ($0.20)
Seat 5: 1920kbps (big blind) folded before Flop
Seat 6: sttanlley folded before Flop (didn't bet)



PokerStars Hand #222950097335:  Hold'em No Limit ($0.05/$0.10 USD) - 2021/01/23 5:51:32 ET
Table 'Stephano III' 6-max Seat #4 is the button
Seat 2: Jonathan8765 ($16.17 in chips) 
Seat 4: 0TheMouse0 ($10.10 in chips) 
Seat 5: 1920kbps ($18.44 in chips) 
1920kbps: posts small blind $0.05
Jonathan8765: posts big blind $0.10
*** HOLE CARDS ***
0TheMouse0: folds 
1920kbps: folds 
Uncalled bet ($0.05) returned to Jonathan8765
Jonathan8765 collected $0.10 from pot
Jonathan8765: doesn't show hand 
*** SUMMARY ***
Total pot $0.10 | Rake $0 
Seat 2: Jonathan8765 (big blind) collected ($0.10)
Seat 4: 0TheMouse0 (button) folded before Flop (didn't bet)
Seat 5: 1920kbps (small blind) folded before Flop



PokerStars Hand #222950098684:  Hold'em No Limit ($0.05/$0.10 USD) - 2021/01/23 5:51:36 ET
Table 'Stephano III' 6-max Seat #5 is the button
Seat 2: Jonathan8765 ($16.22 in chips) 
Seat 4: 0TheMouse0 ($10.10 in chips) 
Seat 5: 1920kbps ($18.39 in chips) 
Jonathan8765: posts small blind $0.05
0TheMouse0: posts big blind $0.10
*** HOLE CARDS ***
1920kbps: raises $0.15 to $0.25
Jonathan8765: folds 
0TheMouse0: folds 
Uncalled bet ($0.15) returned to 1920kbps
1920kbps collected $0.25 from pot
*** SUMMARY ***
Total pot $0.25 | Rake $0 
Seat 2: Jonathan8765 (small blind) folded before Flop
Seat 4: 0TheMouse0 (big blind) folded before Flop
Seat 5: 1920kbps (button) collected ($0.25)



PokerStars Hand #222950100225:  Hold'em No Limit ($0.05/$0.10 USD) - 2021/01/23 5:51:41 ET
Table 'Stephano III' 6-max Seat #2 is the button
Seat 2: Jonathan8765 ($16.17 in chips) 
Seat 4: 0TheMouse0 ($10 in chips) 
Seat 5: 1920kbps ($18.54 in chips) 
0TheMouse0: posts small blind $0.05
1920kbps: posts big blind $0.10
*** HOLE CARDS ***
Jonathan8765: raises $0.13 to $0.23
0TheMouse0: folds 
1920kbps: calls $0.13
*** FLOP *** [Qs 4c 7d]
1920kbps: checks 
Jonathan8765: checks 
*** TURN *** [Qs 4c 7d] [5c]
1920kbps: checks 
Jonathan8765: checks 
*** RIVER *** [Qs 4c 7d 5c] [7s]
DemonSlayer123 joins the table at seat #1 
1920kbps: checks 
Jonathan8765: checks 
*** SHOW DOWN ***
1920kbps: shows [Kd 9d] (a pair of Sevens)
Jonathan8765: shows [Kc Th] (a pair of Sevens - King+Queen+Ten kicker)
Jonathan8765 collected $0.49 from pot
Assetgasse joins the table at seat #3 
*** SUMMARY ***
Total pot $0.51 | Rake $0.02 
Board [Qs 4c 7d 5c 7s]
Seat 2: Jonathan8765 (button) showed [Kc Th] and won ($0.49) with a pair of Sevens
Seat 4: 0TheMouse0 (small blind) folded before Flop
Seat 5: 1920kbps (big blind) showed [Kd 9d] and lost with a pair of Sevens



PokerStars Hand #222950108653:  Hold'em No Limit ($0.05/$0.10 USD) - 2021/01/23 5:52:08 ET
Table 'Stephano III' 6-max Seat #4 is the button
Seat 1: DemonSlayer123 ($9.67 in chips) 
Seat 2: Jonathan8765 ($16.43 in chips) 
Seat 4: 0TheMouse0 ($10 in chips) 
Seat 5: 1920kbps ($18.31 in chips) 
1920kbps: posts small blind $0.05
DemonSlayer123: posts big blind $0.10
Assetgasse: sits out 
*** HOLE CARDS ***
Jonathan8765: folds 
0TheMouse0: raises $0.15 to $0.25
1mohito1983 joins the table at seat #6 
1920kbps: raises $0.75 to $1
DemonSlayer123: calls $0.90
0TheMouse0: folds 
*** FLOP *** [Qd 8s Kd]
1920kbps: bets $7.10
DemonSlayer123: raises $1.57 to $8.67 and is all-in
1920kbps: calls $1.57
*** TURN *** [Qd 8s Kd] [Kh]
*** RIVER *** [Qd 8s Kd Kh] [Ad]
*** SHOW DOWN ***
1920kbps: shows [Jh Kc] (three of a kind, Kings)
DemonSlayer123: shows [As Qh] (two pair, Aces and Kings)
1920kbps collected $18.71 from pot
*** SUMMARY ***
Total pot $19.59 | Rake $0.88 
Board [Qd 8s Kd Kh Ad]
Seat 1: DemonSlayer123 (big blind) showed [As Qh] and lost with two pair, Aces and Kings
Seat 2: Jonathan8765 folded before Flop (didn't bet)
Seat 4: 0TheMouse0 (button) folded before Flop
Seat 5: 1920kbps (small blind) showed [Jh Kc] and won ($18.71) with three of a kind, Kings



PokerStars Hand #222950117695:  Hold'em No Limit ($0.05/$0.10 USD) - 2021/01/23 5:52:37 ET
Table 'Stephano III' 6-max Seat #5 is the button
Seat 2: Jonathan8765 ($16.43 in chips) 
Seat 3: Assetgasse ($10 in chips) 
Seat 4: 0TheMouse0 ($10 in chips) 
Seat 5: 1920kbps ($27.35 in chips) 
Jonathan8765: posts small blind $0.05
Assetgasse: posts big blind $0.10
*** HOLE CARDS ***
0TheMouse0: raises $0.15 to $0.25
1920kbps: folds 
DemonSlayer123 leaves the table
Jonathan8765: folds 
Assetgasse: folds 
Uncalled bet ($0.15) returned to 0TheMouse0
0TheMouse0 collected $0.25 from pot
0TheMouse0: doesn't show hand 
*** SUMMARY ***
Total pot $0.25 | Rake $0 
Seat 2: Jonathan8765 (small blind) folded before Flop
Seat 3: Assetgasse (big blind) folded before Flop
Seat 4: 0TheMouse0 collected ($0.25)
Seat 5: 1920kbps (button) folded before Flop (didn't bet)



PokerStars Hand #222950119874:  Hold'em No Limit ($0.05/$0.10 USD) - 2021/01/23 5:52:44 ET
Table 'Stephano III' 6-max Seat #2 is the button
Seat 2: Jonathan8765 ($16.38 in chips) 
Seat 3: Assetgasse ($10 in chips) 
Seat 5: 1920kbps ($27.35 in chips) 
Assetgasse: posts small blind $0.05
0TheMouse0: is sitting out 
1920kbps: posts big blind $0.10
1mohito1983: sits out 
*** HOLE CARDS ***
Jonathan8765: folds 
Assetgasse: folds 
Uncalled bet ($0.05) returned to 1920kbps
1920kbps collected $0.10 from pot
*** SUMMARY ***
Total pot $0.10 | Rake $0 
Seat 2: Jonathan8765 (button) folded before Flop (didn't bet)
Seat 3: Assetgasse (small blind) folded before Flop
Seat 5: 1920kbps (big blind) collected ($0.10)



PokerStars Hand #222950121602:  Hold'em No Limit ($0.05/$0.10 USD) - 2021/01/23 5:52:49 ET
Table 'Stephano III' 6-max Seat #3 is the button
Seat 2: Jonathan8765 ($16.38 in chips) 
Seat 3: Assetgasse ($10 in chips) 
Seat 5: 1920kbps ($27.40 in chips) 
Seat 6: 1mohito1983 ($10 in chips) 
1920kbps: posts small blind $0.05
1mohito1983: posts big blind $0.10
*** HOLE CARDS ***
Jonilein44 joins the table at seat #1 
Jonathan8765: raises $0.13 to $0.23
Assetgasse: folds 
1920kbps: folds 
1mohito1983: calls $0.13
*** FLOP *** [6c Tc Jd]
1mohito1983: checks 
Jonathan8765: bets $0.18
1mohito1983: calls $0.18
*** TURN *** [6c Tc Jd] [9c]
1mohito1983: checks 
Jonathan8765: bets $0.60
1mohito1983: calls $0.60
*** RIVER *** [6c Tc Jd 9c] [7d]
1mohito1983: checks 
Jonathan8765: checks 
*** SHOW DOWN ***
1mohito1983: shows [Ah Ts] (a pair of Tens)
Jonathan8765: shows [9s Jc] (two pair, Jacks and Nines)
Jonathan8765 collected $1.98 from pot
*** SUMMARY ***
Total pot $2.07 | Rake $0.09 
Board [6c Tc Jd 9c 7d]
Seat 2: Jonathan8765 showed [9s Jc] and won ($1.98) with two pair, Jacks and Nines
Seat 3: Assetgasse (button) folded before Flop (didn't bet)
Seat 5: 1920kbps (small blind) folded before Flop
Seat 6: 1mohito1983 (big blind) showed [Ah Ts] and lost with a pair of Tens



PokerStars Hand #222950136945:  Hold'em No Limit ($0.05/$0.10 USD) - 2021/01/23 5:53:38 ET
Table 'Stephano III' 6-max Seat #5 is the button
Seat 1: Jonilein44 ($8 in chips) 
Seat 2: Jonathan8765 ($17.35 in chips) 
Seat 3: Assetgasse ($10 in chips) 
Seat 5: 1920kbps ($27.35 in chips) 
Seat 6: 1mohito1983 ($8.99 in chips) 
1mohito1983: posts small blind $0.05
Jonilein44: posts big blind $0.10
0TheMouse0: sits out 
*** HOLE CARDS ***
Jonathan8765: folds 
Assetgasse: folds 
1920kbps: folds 
1mohito1983: folds 
Uncalled bet ($0.05) returned to Jonilein44
Jonilein44 collected $0.10 from pot
Jonilein44: doesn't show hand 
*** SUMMARY ***
Total pot $0.10 | Rake $0 
Seat 1: Jonilein44 (big blind) collected ($0.10)
Seat 2: Jonathan8765 folded before Flop (didn't bet)
Seat 3: Assetgasse folded before Flop (didn't bet)
Seat 5: 1920kbps (button) folded before Flop (didn't bet)
Seat 6: 1mohito1983 (small blind) folded before Flop



PokerStars Hand #222950138601:  Hold'em No Limit ($0.05/$0.10 USD) - 2021/01/23 5:53:43 ET
Table 'Stephano III' 6-max Seat #6 is the button
Seat 1: Jonilein44 ($8.05 in chips) 
Seat 2: Jonathan8765 ($17.35 in chips) 
Seat 3: Assetgasse ($10 in chips) 
Seat 5: 1920kbps ($27.35 in chips) 
Seat 6: 1mohito1983 ($8.94 in chips) 
Jonilein44: posts small blind $0.05
Jonathan8765: posts big blind $0.10
0TheMouse0: sits out 
*** HOLE CARDS ***
Assetgasse: folds 
1920kbps: raises $0.20 to $0.30
1mohito1983: calls $0.30
Jonilein44: folds 
Jonathan8765: folds 
*** FLOP *** [4s Td 3s]
1920kbps: bets $0.47
1mohito1983: calls $0.47
*** TURN *** [4s Td 3s] [Jd]
1920kbps: bets $1.05
1mohito1983: calls $1.05
*** RIVER *** [4s Td 3s Jd] [Jh]
1920kbps: checks 
1mohito1983: bets $2.10
1920kbps: calls $2.10
*** SHOW DOWN ***
1mohito1983: shows [Kd As] (a pair of Jacks)
1920kbps: shows [Kc Tc] (two pair, Jacks and Tens)
1920kbps collected $7.63 from pot
*** SUMMARY ***
Total pot $7.99 | Rake $0.36 
Board [4s Td 3s Jd Jh]
Seat 1: Jonilein44 (small blind) folded before Flop
Seat 2: Jonathan8765 (big blind) folded before Flop
Seat 3: Assetgasse folded before Flop (didn't bet)
Seat 5: 1920kbps showed [Kc Tc] and won ($7.63) with two pair, Jacks and Tens
Seat 6: 1mohito1983 (button) showed [Kd As] and lost with a pair of Jacks



PokerStars Hand #222950152514:  Hold'em No Limit ($0.05/$0.10 USD) - 2021/01/23 5:54:27 ET
Table 'Stephano III' 6-max Seat #1 is the button
Seat 1: Jonilein44 ($8 in chips) 
Seat 2: Jonathan8765 ($17.25 in chips) 
Seat 3: Assetgasse ($10 in chips) 
Seat 5: 1920kbps ($31.06 in chips) 
Seat 6: 1mohito1983 ($5.02 in chips) 
Jonathan8765: posts small blind $0.05
Assetgasse: posts big blind $0.10
0TheMouse0: sits out 
*** HOLE CARDS ***
1920kbps: folds 
1mohito1983: raises $0.30 to $0.40
Jonilein44: folds 
Jonathan8765: folds 
Assetgasse: folds 
Uncalled bet ($0.30) returned to 1mohito1983
1mohito1983 collected $0.25 from pot
1mohito1983: doesn't show hand 
*** SUMMARY ***
Total pot $0.25 | Rake $0 
Seat 1: Jonilein44 (button) folded before Flop (didn't bet)
Seat 2: Jonathan8765 (small blind) folded before Flop
Seat 3: Assetgasse (big blind) folded before Flop
Seat 5: 1920kbps folded before Flop (didn't bet)
Seat 6: 1mohito1983 collected ($0.25)



PokerStars Hand #222950156110:  Hold'em No Limit ($0.05/$0.10 USD) - 2021/01/23 5:54:38 ET
Table 'Stephano III' 6-max Seat #2 is the button
Seat 1: Jonilein44 ($8 in chips) 
Seat 2: Jonathan8765 ($17.20 in chips) 
Seat 3: Assetgasse ($10 in chips) 
Seat 4: 0TheMouse0 ($10.15 in chips) 
Seat 5: 1920kbps ($31.06 in chips) 
Seat 6: 1mohito1983 ($5.17 in chips) 
Assetgasse: posts small blind $0.05
0TheMouse0: posts big blind $0.10
*** HOLE CARDS ***
1920kbps: folds 
1mohito1983: raises $0.20 to $0.30
Jonilein44: folds 
Jonathan8765: folds 
Assetgasse: calls $0.25
0TheMouse0: folds 
*** FLOP *** [9h 3s 7d]
Assetgasse: checks 
1mohito1983: bets $0.60
Assetgasse: folds 
Uncalled bet ($0.60) returned to 1mohito1983
1mohito1983 collected $0.67 from pot
1mohito1983: doesn't show hand 
*** SUMMARY ***
Total pot $0.70 | Rake $0.03 
Board [9h 3s 7d]
Seat 1: Jonilein44 folded before Flop (didn't bet)
Seat 2: Jonathan8765 (button) folded before Flop (didn't bet)
Seat 3: Assetgasse (small blind) folded on the Flop
Seat 4: 0TheMouse0 (big blind) folded before Flop
Seat 5: 1920kbps folded before Flop (didn't bet)
Seat 6: 1mohito1983 collected ($0.67)



PokerStars Hand #222950167337:  Hold'em No Limit ($0.05/$0.10 USD) - 2021/01/23 5:55:15 ET
Table 'Stephano III' 6-max Seat #3 is the button
Seat 1: Jonilein44 ($8 in chips) 
Seat 2: Jonathan8765 ($17.20 in chips) 
Seat 3: Assetgasse ($10 in chips) 
Seat 4: 0TheMouse0 ($10.05 in chips) 
Seat 5: 1920kbps ($31.06 in chips) 
Seat 6: 1mohito1983 ($5.54 in chips) 
0TheMouse0: posts small blind $0.05
1920kbps: posts big blind $0.10
*** HOLE CARDS ***
1mohito1983: raises $0.20 to $0.30
Jonilein44: calls $0.30
Jonathan8765: calls $0.30
Assetgasse: folds 
0TheMouse0: folds 
1920kbps: folds 
*** FLOP *** [6d 3h Kd]
1mohito1983: bets $0.50
Jonilein44: folds 
Jonathan8765: calls $0.50
*** TURN *** [6d 3h Kd] [9d]
1mohito1983: bets $0.90
Jonathan8765: calls $0.90
*** RIVER *** [6d 3h Kd 9d] [Td]
1mohito1983: checks 
Jonathan8765: checks 
*** SHOW DOWN ***
1mohito1983: shows [Ac Kc] (a pair of Kings)
Jonathan8765: shows [9s 9c] (three of a kind, Nines)
Jonathan8765 collected $3.68 from pot
*** SUMMARY ***
Total pot $3.85 | Rake $0.17 
Board [6d 3h Kd 9d Td]
Seat 1: Jonilein44 folded on the Flop
Seat 2: Jonathan8765 showed [9s 9c] and won ($3.68) with three of a kind, Nines
Seat 3: Assetgasse (button) folded before Flop (didn't bet)
Seat 4: 0TheMouse0 (small blind) folded before Flop
Seat 5: 1920kbps (big blind) folded before Flop
Seat 6: 1mohito1983 showed [Ac Kc] and lost with a pair of Kings



PokerStars Hand #222950182057:  Hold'em No Limit ($0.05/$0.10 USD) - 2021/01/23 5:56:08 ET
Table 'Stephano III' 6-max Seat #4 is the button
Seat 1: Jonilein44 ($7.70 in chips) 
Seat 2: Jonathan8765 ($19.18 in chips) 
Seat 3: Assetgasse ($10 in chips) 
Seat 4: 0TheMouse0 ($10 in chips) 
Seat 5: 1920kbps ($30.96 in chips) 
Seat 6: 1mohito1983 ($3.84 in chips) 
1920kbps: posts small blind $0.05
1mohito1983: posts big blind $0.10
*** HOLE CARDS ***
Jonilein44: calls $0.10
Jonathan8765: folds 
Assetgasse: folds 
0TheMouse0: raises $0.40 to $0.50
1920kbps: folds 
1mohito1983: folds 
Jonilein44: folds 
Uncalled bet ($0.40) returned to 0TheMouse0
0TheMouse0 collected $0.35 from pot
0TheMouse0: doesn't show hand 
*** SUMMARY ***
Total pot $0.35 | Rake $0 
Seat 1: Jonilein44 folded before Flop
Seat 2: Jonathan8765 folded before Flop (didn't bet)
Seat 3: Assetgasse folded before Flop (didn't bet)
Seat 4: 0TheMouse0 (button) collected ($0.35)
Seat 5: 1920kbps (small blind) folded before Flop
Seat 6: 1mohito1983 (big blind) folded before Flop



PokerStars Hand #222950186377:  Hold'em No Limit ($0.05/$0.10 USD) - 2021/01/23 5:56:24 ET
Table 'Stephano III' 6-max Seat #5 is the button
Seat 1: Jonilein44 ($7.60 in chips) 
Seat 2: Jonathan8765 ($19.18 in chips) 
Seat 3: Assetgasse ($10 in chips) 
Seat 4: 0TheMouse0 ($10.25 in chips) 
Seat 5: 1920kbps ($30.91 in chips) 
Seat 6: 1mohito1983 ($3.74 in chips) 
1mohito1983: posts small blind $0.05
Jonilein44: posts big blind $0.10
*** HOLE CARDS ***
Jonathan8765: folds 
Assetgasse: folds 
0TheMouse0: folds 
1920kbps: folds 
1mohito1983: raises $0.10 to $0.20
Jonilein44: calls $0.10
*** FLOP *** [Kc 6s 3c]
1mohito1983: bets $0.30
Jonilein44: folds 
Uncalled bet ($0.30) returned to 1mohito1983
1mohito1983 collected $0.38 from pot
1mohito1983: doesn't show hand 
*** SUMMARY ***
Total pot $0.40 | Rake $0.02 
Board [Kc 6s 3c]
Seat 1: Jonilein44 (big blind) folded on the Flop
Seat 2: Jonathan8765 folded before Flop (didn't bet)
Seat 3: Assetgasse folded before Flop (didn't bet)
Seat 4: 0TheMouse0 folded before Flop (didn't bet)
Seat 5: 1920kbps (button) folded before Flop (didn't bet)
Seat 6: 1mohito1983 (small blind) collected ($0.38)



PokerStars Hand #222950191388:  Hold'em No Limit ($0.05/$0.10 USD) - 2021/01/23 5:56:42 ET
Table 'Stephano III' 6-max Seat #6 is the button
Seat 1: Jonilein44 ($7.40 in chips) 
Seat 2: Jonathan8765 ($19.18 in chips) 
Seat 3: Assetgasse ($10 in chips) 
Seat 4: 0TheMouse0 ($10.25 in chips) 
Seat 5: 1920kbps ($30.91 in chips) 
Seat 6: 1mohito1983 ($3.92 in chips) 
Jonilein44: posts small blind $0.05
Jonathan8765: posts big blind $0.10
*** HOLE CARDS ***
Assetgasse: folds 
0TheMouse0: folds 
1920kbps: raises $0.15 to $0.25
1mohito1983: calls $0.25
Jonilein44: calls $0.20
Jonathan8765: calls $0.15
*** FLOP *** [Kh 7c 6d]
Jonilein44: bets $0.30
Jonathan8765: calls $0.30
1920kbps: folds 
1mohito1983: calls $0.30
*** TURN *** [Kh 7c 6d] [Js]
Jonilein44: bets $0.40
Jonathan8765: folds 
1mohito1983: folds 
Uncalled bet ($0.40) returned to Jonilein44
Jonilein44 collected $1.81 from pot
Jonilein44: doesn't show hand 
*** SUMMARY ***
Total pot $1.90 | Rake $0.09 
Board [Kh 7c 6d Js]
Seat 1: Jonilein44 (small blind) collected ($1.81)
Seat 2: Jonathan8765 (big blind) folded on the Turn
Seat 3: Assetgasse folded before Flop (didn't bet)
Seat 4: 0TheMouse0 folded before Flop (didn't bet)
Seat 5: 1920kbps folded on the Flop
Seat 6: 1mohito1983 (button) folded on the Turn



PokerStars Hand #222950202307:  Hold'em No Limit ($0.05/$0.10 USD) - 2021/01/23 5:57:22 ET
Table 'Stephano III' 6-max Seat #1 is the button
Seat 1: Jonilein44 ($8.66 in chips) 
Seat 2: Jonathan8765 ($18.63 in chips) 
Seat 3: Assetgasse ($10 in chips) 
Seat 4: 0TheMouse0 ($10.25 in chips) 
Seat 5: 1920kbps ($30.66 in chips) 
Seat 6: 1mohito1983 ($3.37 in chips) 
Jonathan8765: posts small blind $0.05
Assetgasse: posts big blind $0.10
*** HOLE CARDS ***
0TheMouse0: folds 
1920kbps: raises $0.20 to $0.30
1mohito1983: folds 
Jonilein44: calls $0.30
Jonathan8765: folds 
Assetgasse: folds 
*** FLOP *** [8c 2d Kc]
1920kbps: checks 
Jonilein44: checks 
*** TURN *** [8c 2d Kc] [3c]
1920kbps: checks 
Jonilein44: checks 
*** RIVER *** [8c 2d Kc 3c] [8h]
1920kbps: checks 
Jonilein44: checks 
*** SHOW DOWN ***
1920kbps: shows [9h Ah] (a pair of Eights)
Jonilein44: mucks hand 
1920kbps collected $0.72 from pot
*** SUMMARY ***
Total pot $0.75 | Rake $0.03 
Board [8c 2d Kc 3c 8h]
Seat 1: Jonilein44 (button) mucked
Seat 2: Jonathan8765 (small blind) folded before Flop
Seat 3: Assetgasse (big blind) folded before Flop
Seat 4: 0TheMouse0 folded before Flop (didn't bet)
Seat 5: 1920kbps showed [9h Ah] and won ($0.72) with a pair of Eights
Seat 6: 1mohito1983 folded before Flop (didn't bet)



PokerStars Hand #222950208487:  Hold'em No Limit ($0.05/$0.10 USD) - 2021/01/23 5:57:45 ET
Table 'Stephano III' 6-max Seat #2 is the button
Seat 1: Jonilein44 ($8.36 in chips) 
Seat 2: Jonathan8765 ($18.58 in chips) 
Seat 3: Assetgasse ($10 in chips) 
Seat 4: 0TheMouse0 ($10.25 in chips) 
Seat 5: 1920kbps ($31.08 in chips) 
Seat 6: 1mohito1983 ($3.37 in chips) 
Assetgasse: posts small blind $0.05
0TheMouse0: posts big blind $0.10
*** HOLE CARDS ***
1920kbps: raises $0.20 to $0.30
1mohito1983: raises $0.40 to $0.70
Jonilein44: folds 
Jonathan8765: folds 
Assetgasse: folds 
0TheMouse0: folds 
1920kbps: folds 
Uncalled bet ($0.40) returned to 1mohito1983
1mohito1983 collected $0.75 from pot
1mohito1983: doesn't show hand 
*** SUMMARY ***
Total pot $0.75 | Rake $0 
Seat 1: Jonilein44 folded before Flop (didn't bet)
Seat 2: Jonathan8765 (button) folded before Flop (didn't bet)
Seat 3: Assetgasse (small blind) folded before Flop
Seat 4: 0TheMouse0 (big blind) folded before Flop
Seat 5: 1920kbps folded before Flop
Seat 6: 1mohito1983 collected ($0.75)



PokerStars Hand #222950212613:  Hold'em No Limit ($0.05/$0.10 USD) - 2021/01/23 5:57:59 ET
Table 'Stephano III' 6-max Seat #3 is the button
Seat 1: Jonilein44 ($8.36 in chips) 
Seat 2: Jonathan8765 ($18.58 in chips) 
Seat 3: Assetgasse ($10 in chips) 
Seat 4: 0TheMouse0 ($10.15 in chips) 
Seat 5: 1920kbps ($30.78 in chips) 
Seat 6: 1mohito1983 ($3.82 in chips) 
0TheMouse0: posts small blind $0.05
1920kbps: posts big blind $0.10
*** HOLE CARDS ***
1mohito1983: raises $0.10 to $0.20
Jonilein44: folds 
Jonathan8765: folds 
Assetgasse: folds 
0TheMouse0: folds 
1920kbps: folds 
Uncalled bet ($0.10) returned to 1mohito1983
1mohito1983 collected $0.25 from pot
1mohito1983: doesn't show hand 
*** SUMMARY ***
Total pot $0.25 | Rake $0 
Seat 1: Jonilein44 folded before Flop (didn't bet)
Seat 2: Jonathan8765 folded before Flop (didn't bet)
Seat 3: Assetgasse (button) folded before Flop (didn't bet)
Seat 4: 0TheMouse0 (small blind) folded before Flop
Seat 5: 1920kbps (big blind) folded before Flop
Seat 6: 1mohito1983 collected ($0.25)



PokerStars Hand #222950216045:  Hold'em No Limit ($0.05/$0.10 USD) - 2021/01/23 5:58:12 ET
Table 'Stephano III' 6-max Seat #4 is the button
Seat 1: Jonilein44 ($8.36 in chips) 
Seat 2: Jonathan8765 ($18.58 in chips) 
Seat 3: Assetgasse ($10 in chips) 
Seat 4: 0TheMouse0 ($10.10 in chips) 
Seat 5: 1920kbps ($30.68 in chips) 
Seat 6: 1mohito1983 ($3.97 in chips) 
1920kbps: posts small blind $0.05
1mohito1983: posts big blind $0.10
*** HOLE CARDS ***
Jonilein44: calls $0.10
Jonathan8765: folds 
Assetgasse: folds 
0TheMouse0: folds 
1920kbps: folds 
1mohito1983: checks 
*** FLOP *** [9s 4d Jh]
1mohito1983: checks 
Jonilein44: checks 
*** TURN *** [9s 4d Jh] [Ts]
1mohito1983: checks 
Jonilein44: checks 
*** RIVER *** [9s 4d Jh Ts] [7h]
1mohito1983: checks 
Jonilein44: checks 
*** SHOW DOWN ***
1mohito1983: shows [Ks 3c] (high card King)
Jonilein44: mucks hand 
1mohito1983 collected $0.24 from pot
*** SUMMARY ***
Total pot $0.25 | Rake $0.01 
Board [9s 4d Jh Ts 7h]
Seat 1: Jonilein44 mucked
Seat 2: Jonathan8765 folded before Flop (didn't bet)
Seat 3: Assetgasse folded before Flop (didn't bet)
Seat 4: 0TheMouse0 (button) folded before Flop (didn't bet)
Seat 5: 1920kbps (small blind) folded before Flop
Seat 6: 1mohito1983 (big blind) showed [Ks 3c] and won ($0.24) with high card King



PokerStars Hand #222950222741:  Hold'em No Limit ($0.05/$0.10 USD) - 2021/01/23 5:58:36 ET
Table 'Stephano III' 6-max Seat #5 is the button
Seat 1: Jonilein44 ($8.26 in chips) 
Seat 2: Jonathan8765 ($18.58 in chips) 
Seat 3: Assetgasse ($10 in chips) 
Seat 4: 0TheMouse0 ($10.10 in chips) 
Seat 5: 1920kbps ($30.63 in chips) 
Seat 6: 1mohito1983 ($4.11 in chips) 
1mohito1983: posts small blind $0.05
Jonilein44: posts big blind $0.10
*** HOLE CARDS ***
Jonathan8765: folds 
Assetgasse: folds 
0TheMouse0: raises $0.15 to $0.25
1920kbps: folds 
1mohito1983: folds 
Jonilein44: folds 
Uncalled bet ($0.15) returned to 0TheMouse0
0TheMouse0 collected $0.25 from pot
0TheMouse0: doesn't show hand 
*** SUMMARY ***
Total pot $0.25 | Rake $0 
Seat 1: Jonilein44 (big blind) folded before Flop
Seat 2: Jonathan8765 folded before Flop (didn't bet)
Seat 3: Assetgasse folded before Flop (didn't bet)
Seat 4: 0TheMouse0 collected ($0.25)
Seat 5: 1920kbps (button) folded before Flop (didn't bet)
Seat 6: 1mohito1983 (small blind) folded before Flop



PokerStars Hand #222950226811:  Hold'em No Limit ($0.05/$0.10 USD) - 2021/01/23 5:58:50 ET
Table 'Stephano III' 6-max Seat #6 is the button
Seat 1: Jonilein44 ($8.16 in chips) 
Seat 2: Jonathan8765 ($18.58 in chips) 
Seat 3: Assetgasse ($10 in chips) 
Seat 4: 0TheMouse0 ($10.25 in chips) 
Seat 5: 1920kbps ($30.63 in chips) 
Seat 6: 1mohito1983 ($4.06 in chips) 
Jonilein44: posts small blind $0.05
Jonathan8765: posts big blind $0.10
*** HOLE CARDS ***
Assetgasse: folds 
0TheMouse0: raises $0.15 to $0.25
1920kbps: calls $0.25
1mohito1983: calls $0.25
Jonilein44: calls $0.20
Jonathan8765: calls $0.15
*** FLOP *** [6d 7d Tc]
Jonilein44: bets $0.50
Jonathan8765: calls $0.50
0TheMouse0: calls $0.50
1920kbps: calls $0.50
1mohito1983: folds 
*** TURN *** [6d 7d Tc] [Qs]
Jonilein44: bets $0.40
Jonathan8765: calls $0.40
0TheMouse0: calls $0.40
1920kbps: folds 
*** RIVER *** [6d 7d Tc Qs] [6h]
Jonilein44: bets $0.40
Jonathan8765: calls $0.40
0TheMouse0: calls $0.40
*** SHOW DOWN ***
Jonilein44: shows [Th Ah] (two pair, Tens and Sixes)
Jonathan8765: shows [Qd 9d] (two pair, Queens and Sixes)
0TheMouse0: mucks hand 
Jonathan8765 collected $5.40 from pot
*** SUMMARY ***
Total pot $5.65 | Rake $0.25 
Board [6d 7d Tc Qs 6h]
Seat 1: Jonilein44 (small blind) showed [Th Ah] and lost with two pair, Tens and Sixes
Seat 2: Jonathan8765 (big blind) showed [Qd 9d] and won ($5.40) with two pair, Queens and Sixes
Seat 3: Assetgasse folded before Flop (didn't bet)
Seat 4: 0TheMouse0 mucked
Seat 5: 1920kbps folded on the Turn
Seat 6: 1mohito1983 (button) folded on the Flop



PokerStars Hand #222950242466:  Hold'em No Limit ($0.05/$0.10 USD) - 2021/01/23 5:59:47 ET
Table 'Stephano III' 6-max Seat #1 is the button
Seat 1: Jonilein44 ($6.61 in chips) 
Seat 2: Jonathan8765 ($22.43 in chips) 
Seat 3: Assetgasse ($10 in chips) 
Seat 4: 0TheMouse0 ($10 in chips) 
Seat 5: 1920kbps ($29.88 in chips) 
Seat 6: 1mohito1983 ($3.81 in chips) 
Jonathan8765: posts small blind $0.05
Assetgasse: posts big blind $0.10
*** HOLE CARDS ***
0TheMouse0: raises $0.20 to $0.30
1920kbps: folds 
1mohito1983: folds 
Jonilein44: calls $0.30
Jonathan8765: folds 
Assetgasse: folds 
*** FLOP *** [Ac Kc 2c]
0TheMouse0: checks 
Jonilein44: checks 
*** TURN *** [Ac Kc 2c] [8d]
0TheMouse0: bets $0.60
Jonilein44: calls $0.60
*** RIVER *** [Ac Kc 2c 8d] [3s]
0TheMouse0: bets $1.80
Jonilein44: calls $1.80
*** SHOW DOWN ***
0TheMouse0: shows [8c 8h] (three of a kind, Eights)
Jonilein44: mucks hand 
0TheMouse0 collected $5.30 from pot
*** SUMMARY ***
Total pot $5.55 | Rake $0.25 
Board [Ac Kc 2c 8d 3s]
Seat 1: Jonilein44 (button) mucked
Seat 2: Jonathan8765 (small blind) folded before Flop
Seat 3: Assetgasse (big blind) folded before Flop
Seat 4: 0TheMouse0 showed [8c 8h] and won ($5.30) with three of a kind, Eights
Seat 5: 1920kbps folded before Flop (didn't bet)
Seat 6: 1mohito1983 folded before Flop (didn't bet)



PokerStars Hand #222950250361:  Hold'em No Limit ($0.05/$0.10 USD) - 2021/01/23 6:00:15 ET
Table 'Stephano III' 6-max Seat #2 is the button
Seat 1: Jonilein44 ($3.91 in chips) 
Seat 2: Jonathan8765 ($22.38 in chips) 
Seat 3: Assetgasse ($10 in chips) 
Seat 4: 0TheMouse0 ($12.60 in chips) 
Seat 5: 1920kbps ($29.88 in chips) 
Seat 6: 1mohito1983 ($3.81 in chips) 
Assetgasse: posts small blind $0.05
0TheMouse0: posts big blind $0.10
*** HOLE CARDS ***
1920kbps: raises $0.20 to $0.30
1mohito1983: folds 
Jonilein44: calls $0.30
Jonathan8765: raises $0.75 to $1.05
Assetgasse: folds 
0TheMouse0: folds 
1920kbps: calls $0.75
Jonilein44: folds 
*** FLOP *** [3s Ks 6d]
Jonilein44 leaves the table
1920kbps: checks 
Lars Beukeboom joins the table at seat #1 
Jonathan8765: bets $0.80
1920kbps: folds 
Uncalled bet ($0.80) returned to Jonathan8765
Jonathan8765 collected $2.44 from pot
Jonathan8765: doesn't show hand 
*** SUMMARY ***
Total pot $2.55 | Rake $0.11 
Board [3s Ks 6d]
Seat 1: Jonilein44 folded before Flop
Seat 2: Jonathan8765 (button) collected ($2.44)
Seat 3: Assetgasse (small blind) folded before Flop
Seat 4: 0TheMouse0 (big blind) folded before Flop
Seat 5: 1920kbps folded on the Flop
Seat 6: 1mohito1983 folded before Flop (didn't bet)



PokerStars Hand #222950260632:  Hold'em No Limit ($0.05/$0.10 USD) - 2021/01/23 6:00:50 ET
Table 'Stephano III' 6-max Seat #3 is the button
Seat 2: Jonathan8765 ($23.77 in chips) 
Seat 3: Assetgasse ($10 in chips) 
Seat 4: 0TheMouse0 ($12.50 in chips) 
Seat 5: 1920kbps ($28.83 in chips) 
Seat 6: 1mohito1983 ($3.81 in chips) 
0TheMouse0: posts small blind $0.05
1920kbps: posts big blind $0.10
Lars Beukeboom: sits out 
*** HOLE CARDS ***
1mohito1983: folds 
Jonathan8765: raises $0.13 to $0.23
Assetgasse: folds 
0TheMouse0: folds 
1920kbps: folds 
Uncalled bet ($0.13) returned to Jonathan8765
Jonathan8765 collected $0.25 from pot
Jonathan8765: doesn't show hand 
*** SUMMARY ***
Total pot $0.25 | Rake $0 
Seat 2: Jonathan8765 collected ($0.25)
Seat 3: Assetgasse (button) folded before Flop (didn't bet)
Seat 4: 0TheMouse0 (small blind) folded before Flop
Seat 5: 1920kbps (big blind) folded before Flop
Seat 6: 1mohito1983 folded before Flop (didn't bet)



PokerStars Hand #222950263383:  Hold'em No Limit ($0.05/$0.10 USD) - 2021/01/23 6:00:59 ET
Table 'Stephano III' 6-max Seat #4 is the button
Seat 2: Jonathan8765 ($23.92 in chips) 
Seat 3: Assetgasse ($10 in chips) 
Seat 4: 0TheMouse0 ($12.45 in chips) 
Seat 5: 1920kbps ($28.73 in chips) 
Seat 6: 1mohito1983 ($3.81 in chips) 
1920kbps: posts small blind $0.05
1mohito1983: posts big blind $0.10
Lars Beukeboom: sits out 
*** HOLE CARDS ***
Jonathan8765: folds 
Assetgasse has timed out
Assetgasse: folds 
0TheMouse0: folds 
1920kbps: raises $0.20 to $0.30
1mohito1983: folds 
Uncalled bet ($0.20) returned to 1920kbps
1920kbps collected $0.20 from pot
*** SUMMARY ***
Total pot $0.20 | Rake $0 
Seat 2: Jonathan8765 folded before Flop (didn't bet)
Seat 3: Assetgasse folded before Flop (didn't bet)
Seat 4: 0TheMouse0 (button) folded before Flop (didn't bet)
Seat 5: 1920kbps (small blind) collected ($0.20)
Seat 6: 1mohito1983 (big blind) folded before Flop



PokerStars Hand #222950269511:  Hold'em No Limit ($0.05/$0.10 USD) - 2021/01/23 6:01:18 ET
Table 'Stephano III' 6-max Seat #5 is the button
Seat 1: Lars Beukeboom ($6 in chips) 
Seat 2: Jonathan8765 ($23.92 in chips) 
Seat 3: Assetgasse ($10 in chips) 
Seat 4: 0TheMouse0 ($12.45 in chips) 
Seat 5: 1920kbps ($28.83 in chips) 
Seat 6: 1mohito1983 ($3.71 in chips) 
1mohito1983: posts small blind $0.05
Lars Beukeboom: posts big blind $0.10
*** HOLE CARDS ***
Jonathan8765: folds 
Assetgasse has timed out
Assetgasse: folds 
0TheMouse0: folds 
1920kbps: raises $0.15 to $0.25
1mohito1983: folds 
Lars Beukeboom: calls $0.15
*** FLOP *** [5h 7s Qs]
Lars Beukeboom: checks 
1920kbps: checks 
*** TURN *** [5h 7s Qs] [4h]
Lars Beukeboom: checks 
1920kbps: checks 
*** RIVER *** [5h 7s Qs 4h] [8d]
Lars Beukeboom: checks 
1920kbps: checks 
*** SHOW DOWN ***
Lars Beukeboom: shows [Jd Tc] (high card Queen)
1920kbps: shows [Ts Kh] (high card King)
1920kbps collected $0.53 from pot
*** SUMMARY ***
Total pot $0.55 | Rake $0.02 
Board [5h 7s Qs 4h 8d]
Seat 1: Lars Beukeboom (big blind) showed [Jd Tc] and lost with high card Queen
Seat 2: Jonathan8765 folded before Flop (didn't bet)
Seat 3: Assetgasse folded before Flop (didn't bet)
Seat 4: 0TheMouse0 folded before Flop (didn't bet)
Seat 5: 1920kbps (button) showed [Ts Kh] and won ($0.53) with high card King
Seat 6: 1mohito1983 (small blind) folded before Flop



PokerStars Hand #222950281988:  Hold'em No Limit ($0.05/$0.10 USD) - 2021/01/23 6:01:57 ET
Table 'Stephano III' 6-max Seat #6 is the button
Seat 1: Lars Beukeboom ($5.75 in chips) 
Seat 2: Jonathan8765 ($23.92 in chips) 
Seat 3: Assetgasse ($10 in chips) 
Seat 4: 0TheMouse0 ($12.45 in chips) 
Seat 5: 1920kbps ($29.11 in chips) 
Seat 6: 1mohito1983 ($3.66 in chips) 
Lars Beukeboom: posts small blind $0.05
Jonathan8765: posts big blind $0.10
*** HOLE CARDS ***
Assetgasse: folds 
0TheMouse0: folds 
1920kbps: folds 
1mohito1983: raises $0.20 to $0.30
Lars Beukeboom: calls $0.25
Jonathan8765: folds 
*** FLOP *** [Ad 5h 2c]
Lars Beukeboom: checks 
1mohito1983: bets $0.40
Lars Beukeboom: calls $0.40
*** TURN *** [Ad 5h 2c] [9s]
Lars Beukeboom: checks 
1mohito1983: bets $0.90
Lars Beukeboom: folds 
Uncalled bet ($0.90) returned to 1mohito1983
1mohito1983 collected $1.43 from pot
1mohito1983: doesn't show hand 
*** SUMMARY ***
Total pot $1.50 | Rake $0.07 
Board [Ad 5h 2c 9s]
Seat 1: Lars Beukeboom (small blind) folded on the Turn
Seat 2: Jonathan8765 (big blind) folded before Flop
Seat 3: Assetgasse folded before Flop (didn't bet)
Seat 4: 0TheMouse0 folded before Flop (didn't bet)
Seat 5: 1920kbps folded before Flop (didn't bet)
Seat 6: 1mohito1983 (button) collected ($1.43)



PokerStars Hand #222950753839:  Hold'em No Limit ($0.05/$0.10 USD) - 2021/01/23 6:26:02 ET
Table 'Stephano III' 6-max Seat #5 is the button
Seat 1: Lars Beukeboom ($5.66 in chips) 
Seat 2: Chazfroggy98 ($10.32 in chips) 
Seat 3: Assetgasse ($14.84 in chips) 
Seat 4: 0TheMouse0 ($14.92 in chips) 
Seat 5: 1920kbps ($27.75 in chips) 
Seat 6: Dugipokers ($10 in chips) 
Dugipokers: posts small blind $0.05
Lars Beukeboom: posts big blind $0.10
*** HOLE CARDS ***
Chazfroggy98: folds 
Assetgasse: folds 
0TheMouse0: raises $0.15 to $0.25
1920kbps: folds 
Dugipokers: folds 
Lars Beukeboom: folds 
Uncalled bet ($0.15) returned to 0TheMouse0
0TheMouse0 collected $0.25 from pot
0TheMouse0: doesn't show hand 
*** SUMMARY ***
Total pot $0.25 | Rake $0 
Seat 1: Lars Beukeboom (big blind) folded before Flop
Seat 2: Chazfroggy98 folded before Flop (didn't bet)
Seat 3: Assetgasse folded before Flop (didn't bet)
Seat 4: 0TheMouse0 collected ($0.25)
Seat 5: 1920kbps (button) folded before Flop (didn't bet)
Seat 6: Dugipokers (small blind) folded before Flop



PokerStars Hand #222950761785:  Hold'em No Limit ($0.05/$0.10 USD) - 2021/01/23 6:26:27 ET
Table 'Stephano III' 6-max Seat #6 is the button
Seat 1: Lars Beukeboom ($5.56 in chips) 
Seat 2: Chazfroggy98 ($10.32 in chips) 
Seat 3: Assetgasse ($14.84 in chips) 
Seat 4: 0TheMouse0 ($15.07 in chips) 
Seat 5: 1920kbps ($27.75 in chips) 
Seat 6: Dugipokers ($10 in chips) 
Lars Beukeboom: posts small blind $0.05
Chazfroggy98: posts big blind $0.10
*** HOLE CARDS ***
Assetgasse: folds 
0TheMouse0: raises $0.15 to $0.25
1920kbps: folds 
Dugipokers: folds 
Lars Beukeboom: calls $0.20
Chazfroggy98: raises $0.75 to $1
0TheMouse0: folds 
Lars Beukeboom: calls $0.75
*** FLOP *** [9h Ts Ad]
Lars Beukeboom: checks 
Chazfroggy98: checks 
*** TURN *** [9h Ts Ad] [5c]
Lars Beukeboom: checks 
Chazfroggy98: bets $0.50
Lars Beukeboom: calls $0.50
*** RIVER *** [9h Ts Ad 5c] [Jh]
Lars Beukeboom: checks 
Chazfroggy98: checks 
*** SHOW DOWN ***
Lars Beukeboom: shows [5d 8d] (a pair of Fives)
Chazfroggy98: shows [Ks Kc] (a pair of Kings)
Chazfroggy98 collected $3.10 from pot
*** SUMMARY ***
Total pot $3.25 | Rake $0.15 
Board [9h Ts Ad 5c Jh]
Seat 1: Lars Beukeboom (small blind) showed [5d 8d] and lost with a pair of Fives
Seat 2: Chazfroggy98 (big blind) showed [Ks Kc] and won ($3.10) with a pair of Kings
Seat 3: Assetgasse folded before Flop (didn't bet)
Seat 4: 0TheMouse0 folded before Flop
Seat 5: 1920kbps folded before Flop (didn't bet)
Seat 6: Dugipokers (button) folded before Flop (didn't bet)



PokerStars Hand #222950777636:  Hold'em No Limit ($0.05/$0.10 USD) - 2021/01/23 6:27:14 ET
Table 'Stephano III' 6-max Seat #1 is the button
Seat 1: Lars Beukeboom ($4.06 in chips) 
Seat 2: Chazfroggy98 ($11.92 in chips) 
Seat 3: Assetgasse ($14.84 in chips) 
Seat 4: 0TheMouse0 ($14.82 in chips) 
Seat 5: 1920kbps ($27.75 in chips) 
Seat 6: Dugipokers ($10 in chips) 
Chazfroggy98: posts small blind $0.05
Assetgasse: posts big blind $0.10
*** HOLE CARDS ***
0TheMouse0: folds 
1920kbps: folds 
Dugipokers: folds 
Lars Beukeboom: calls $0.10
Chazfroggy98: calls $0.05
Assetgasse: checks 
*** FLOP *** [Kc 2h Jh]
Chazfroggy98: checks 
Assetgasse: checks 
Lars Beukeboom: checks 
*** TURN *** [Kc 2h Jh] [3s]
Chazfroggy98: bets $0.14
Assetgasse: folds 
Lars Beukeboom: raises $0.14 to $0.28
Chazfroggy98: calls $0.14
*** RIVER *** [Kc 2h Jh 3s] [8h]
Chazfroggy98: checks 
Lars Beukeboom: bets $3.68 and is all-in
Chazfroggy98: folds 
Uncalled bet ($3.68) returned to Lars Beukeboom
Lars Beukeboom collected $0.82 from pot
Lars Beukeboom: doesn't show hand 
*** SUMMARY ***
Total pot $0.86 | Rake $0.04 
Board [Kc 2h Jh 3s 8h]
Seat 1: Lars Beukeboom (button) collected ($0.82)
Seat 2: Chazfroggy98 (small blind) folded on the River
Seat 3: Assetgasse (big blind) folded on the Turn
Seat 4: 0TheMouse0 folded before Flop (didn't bet)
Seat 5: 1920kbps folded before Flop (didn't bet)
Seat 6: Dugipokers folded before Flop (didn't bet)



PokerStars Hand #222950794979:  Hold'em No Limit ($0.05/$0.10 USD) - 2021/01/23 6:28:06 ET
Table 'Stephano III' 6-max Seat #2 is the button
Seat 1: Lars Beukeboom ($4.50 in chips) 
Seat 2: Chazfroggy98 ($11.54 in chips) 
Seat 3: Assetgasse ($14.74 in chips) 
Seat 4: 0TheMouse0 ($14.82 in chips) 
Seat 5: 1920kbps ($27.75 in chips) 
Seat 6: Dugipokers ($10 in chips) 
Assetgasse: posts small blind $0.05
0TheMouse0: posts big blind $0.10
*** HOLE CARDS ***
1920kbps: folds 
Dugipokers: folds 
Lars Beukeboom: folds 
Chazfroggy98: calls $0.10
Assetgasse: folds 
0TheMouse0: checks 
*** FLOP *** [6s 4d 8h]
0TheMouse0: checks 
Chazfroggy98: checks 
*** TURN *** [6s 4d 8h] [As]
0TheMouse0: checks 
Chazfroggy98 is disconnected 
Chazfroggy98 has timed out while disconnected
Chazfroggy98: checks 
*** RIVER *** [6s 4d 8h As] [5c]
0TheMouse0: checks 
Chazfroggy98: bets $0.24
0TheMouse0: folds 
Uncalled bet ($0.24) returned to Chazfroggy98
Chazfroggy98 collected $0.24 from pot
Chazfroggy98: doesn't show hand 
*** SUMMARY ***
Total pot $0.25 | Rake $0.01 
Board [6s 4d 8h As 5c]
Seat 1: Lars Beukeboom folded before Flop (didn't bet)
Seat 2: Chazfroggy98 (button) collected ($0.24)
Seat 3: Assetgasse (small blind) folded before Flop
Seat 4: 0TheMouse0 (big blind) folded on the River
Seat 5: 1920kbps folded before Flop (didn't bet)
Seat 6: Dugipokers folded before Flop (didn't bet)



PokerStars Hand #222950819968:  Hold'em No Limit ($0.05/$0.10 USD) - 2021/01/23 6:29:21 ET
Table 'Stephano III' 6-max Seat #3 is the button
Seat 1: Lars Beukeboom ($4.50 in chips) 
Seat 2: Chazfroggy98 ($11.68 in chips) 
Seat 3: Assetgasse ($14.69 in chips) 
Seat 4: 0TheMouse0 ($14.72 in chips) 
Seat 5: 1920kbps ($27.75 in chips) 
Seat 6: Dugipokers ($10 in chips) 
0TheMouse0: posts small blind $0.05
1920kbps: posts big blind $0.10
*** HOLE CARDS ***
Dugipokers: folds 
Lars Beukeboom: calls $0.10
Chazfroggy98: calls $0.10
Assetgasse: raises $0.40 to $0.50
0TheMouse0: folds 
1920kbps: folds 
Lars Beukeboom: folds 
Chazfroggy98: calls $0.40
*** FLOP *** [Kd 7d 5c]
Chazfroggy98: bets $0.59
Assetgasse: calls $0.59
*** TURN *** [Kd 7d 5c] [Js]
Chazfroggy98: checks 
Assetgasse: checks 
*** RIVER *** [Kd 7d 5c Js] [Kh]
Chazfroggy98: bets $2.32
Assetgasse: calls $2.32
*** SHOW DOWN ***
Chazfroggy98: shows [Td Ad] (a pair of Kings)
Assetgasse: shows [7s As] (two pair, Kings and Sevens)
Assetgasse collected $6.75 from pot
*** SUMMARY ***
Total pot $7.07 | Rake $0.32 
Board [Kd 7d 5c Js Kh]
Seat 1: Lars Beukeboom folded before Flop
Seat 2: Chazfroggy98 showed [Td Ad] and lost with a pair of Kings
Seat 3: Assetgasse (button) showed [7s As] and won ($6.75) with two pair, Kings and Sevens
Seat 4: 0TheMouse0 (small blind) folded before Flop
Seat 5: 1920kbps (big blind) folded before Flop
Seat 6: Dugipokers folded before Flop (didn't bet)



PokerStars Hand #222950839474:  Hold'em No Limit ($0.05/$0.10 USD) - 2021/01/23 6:30:19 ET
Table 'Stephano III' 6-max Seat #4 is the button
Seat 1: Lars Beukeboom ($4.40 in chips) 
Seat 2: Chazfroggy98 ($8.27 in chips) 
Seat 3: Assetgasse ($18.03 in chips) 
Seat 4: 0TheMouse0 ($14.67 in chips) 
Seat 5: 1920kbps ($27.65 in chips) 
Seat 6: Dugipokers ($10 in chips) 
1920kbps: posts small blind $0.05
Dugipokers: posts big blind $0.10
*** HOLE CARDS ***
Lars Beukeboom: folds 
Chazfroggy98: folds 
Assetgasse: folds 
0TheMouse0: folds 
1920kbps: raises $0.20 to $0.30
Dugipokers: folds 
Uncalled bet ($0.20) returned to 1920kbps
1920kbps collected $0.20 from pot
*** SUMMARY ***
Total pot $0.20 | Rake $0 
Seat 1: Lars Beukeboom folded before Flop (didn't bet)
Seat 2: Chazfroggy98 folded before Flop (didn't bet)
Seat 3: Assetgasse folded before Flop (didn't bet)
Seat 4: 0TheMouse0 (button) folded before Flop (didn't bet)
Seat 5: 1920kbps (small blind) collected ($0.20)
Seat 6: Dugipokers (big blind) folded before Flop



PokerStars Hand #222950849762:  Hold'em No Limit ($0.05/$0.10 USD) - 2021/01/23 6:30:50 ET
Table 'Stephano III' 6-max Seat #5 is the button
Seat 1: Lars Beukeboom ($4.40 in chips) 
Seat 2: Chazfroggy98 ($8.27 in chips) 
Seat 3: Assetgasse ($18.03 in chips) 
Seat 4: 0TheMouse0 ($14.67 in chips) 
Seat 5: 1920kbps ($27.75 in chips) 
Seat 6: Dugipokers ($10 in chips) 
Dugipokers: posts small blind $0.05
Lars Beukeboom: posts big blind $0.10
*** HOLE CARDS ***
Chazfroggy98: folds 
Assetgasse: folds 
0TheMouse0: raises $0.15 to $0.25
1920kbps: folds 
Dugipokers: folds 
Lars Beukeboom: folds 
Uncalled bet ($0.15) returned to 0TheMouse0
0TheMouse0 collected $0.25 from pot
0TheMouse0: doesn't show hand 
*** SUMMARY ***
Total pot $0.25 | Rake $0 
Seat 1: Lars Beukeboom (big blind) folded before Flop
Seat 2: Chazfroggy98 folded before Flop (didn't bet)
Seat 3: Assetgasse folded before Flop (didn't bet)
Seat 4: 0TheMouse0 collected ($0.25)
Seat 5: 1920kbps (button) folded before Flop (didn't bet)
Seat 6: Dugipokers (small blind) folded before Flop



PokerStars Hand #222950857353:  Hold'em No Limit ($0.05/$0.10 USD) - 2021/01/23 6:31:13 ET
Table 'Stephano III' 6-max Seat #6 is the button
Seat 1: Lars Beukeboom ($4.30 in chips) 
Seat 2: Chazfroggy98 ($8.27 in chips) 
Seat 3: Assetgasse ($18.03 in chips) 
Seat 4: 0TheMouse0 ($14.82 in chips) 
Seat 5: 1920kbps ($27.75 in chips) 
Seat 6: Dugipokers ($10 in chips) 
Lars Beukeboom: posts small blind $0.05
Chazfroggy98: posts big blind $0.10
*** HOLE CARDS ***
Assetgasse: folds 
0TheMouse0: raises $0.15 to $0.25
1920kbps: folds 
Dugipokers: folds 
Lars Beukeboom: calls $0.20
Chazfroggy98: calls $0.15
*** FLOP *** [2c Kc Kh]
Lars Beukeboom: checks 
Chazfroggy98: bets $0.30
0TheMouse0: folds 
Lars Beukeboom: calls $0.30
*** TURN *** [2c Kc Kh] [Qd]
Lars Beukeboom: checks 
Chazfroggy98: checks 
*** RIVER *** [2c Kc Kh Qd] [9h]
Lars Beukeboom: bets $3.75 and is all-in
Chazfroggy98: folds 
Uncalled bet ($3.75) returned to Lars Beukeboom
Lars Beukeboom collected $1.29 from pot
Lars Beukeboom: doesn't show hand 
*** SUMMARY ***
Total pot $1.35 | Rake $0.06 
Board [2c Kc Kh Qd 9h]
Seat 1: Lars Beukeboom (small blind) collected ($1.29)
Seat 2: Chazfroggy98 (big blind) folded on the River
Seat 3: Assetgasse folded before Flop (didn't bet)
Seat 4: 0TheMouse0 folded on the Flop
Seat 5: 1920kbps folded before Flop (didn't bet)
Seat 6: Dugipokers (button) folded before Flop (didn't bet)



PokerStars Hand #222950870572:  Hold'em No Limit ($0.05/$0.10 USD) - 2021/01/23 6:31:52 ET
Table 'Stephano III' 6-max Seat #1 is the button
Seat 1: Lars Beukeboom ($5.04 in chips) 
Seat 2: Chazfroggy98 ($7.72 in chips) 
Seat 3: Assetgasse ($18.03 in chips) 
Seat 4: 0TheMouse0 ($14.57 in chips) 
Seat 5: 1920kbps ($27.75 in chips) 
Seat 6: Dugipokers ($10 in chips) 
Chazfroggy98: posts small blind $0.05
Assetgasse: posts big blind $0.10
*** HOLE CARDS ***
0TheMouse0: folds 
1920kbps: folds 
Dugipokers: folds 
Lars Beukeboom: calls $0.10
Chazfroggy98: calls $0.05
Assetgasse: checks 
*** FLOP *** [Td 6d Kh]
Chazfroggy98: checks 
Assetgasse: checks 
Lars Beukeboom: checks 
*** TURN *** [Td 6d Kh] [6s]
Chazfroggy98: bets $0.29
Assetgasse: folds 
Lars Beukeboom: folds 
Uncalled bet ($0.29) returned to Chazfroggy98
Chazfroggy98 collected $0.29 from pot
Chazfroggy98: doesn't show hand 
*** SUMMARY ***
Total pot $0.30 | Rake $0.01 
Board [Td 6d Kh 6s]
Seat 1: Lars Beukeboom (button) folded on the Turn
Seat 2: Chazfroggy98 (small blind) collected ($0.29)
Seat 3: Assetgasse (big blind) folded on the Turn
Seat 4: 0TheMouse0 folded before Flop (didn't bet)
Seat 5: 1920kbps folded before Flop (didn't bet)
Seat 6: Dugipokers folded before Flop (didn't bet)



PokerStars Hand #222950884299:  Hold'em No Limit ($0.05/$0.10 USD) - 2021/01/23 6:32:32 ET
Table 'Stephano III' 6-max Seat #2 is the button
Seat 1: Lars Beukeboom ($4.94 in chips) 
Seat 2: Chazfroggy98 ($7.91 in chips) 
Seat 3: Assetgasse ($17.93 in chips) 
Seat 4: 0TheMouse0 ($14.57 in chips) 
Seat 5: 1920kbps ($27.75 in chips) 
Seat 6: Dugipokers ($10 in chips) 
Assetgasse: posts small blind $0.05
0TheMouse0: posts big blind $0.10
*** HOLE CARDS ***
1920kbps: folds 
Dugipokers: folds 
Lars Beukeboom: calls $0.10
Chazfroggy98: calls $0.10
Assetgasse: folds 
0TheMouse0: checks 
*** FLOP *** [4s Qd 7s]
0TheMouse0: checks 
Lars Beukeboom: checks 
Chazfroggy98: checks 
*** TURN *** [4s Qd 7s] [8c]
0TheMouse0: checks 
Lars Beukeboom: checks 
Chazfroggy98: bets $0.16
0TheMouse0: folds 
Lars Beukeboom: calls $0.16
*** RIVER *** [4s Qd 7s 8c] [4c]
Lars Beukeboom: bets $0.64
Chazfroggy98: folds 
Uncalled bet ($0.64) returned to Lars Beukeboom
Lars Beukeboom collected $0.64 from pot
Lars Beukeboom: doesn't show hand 
*** SUMMARY ***
Total pot $0.67 | Rake $0.03 
Board [4s Qd 7s 8c 4c]
Seat 1: Lars Beukeboom collected ($0.64)
Seat 2: Chazfroggy98 (button) folded on the River
Seat 3: Assetgasse (small blind) folded before Flop
Seat 4: 0TheMouse0 (big blind) folded on the Turn
Seat 5: 1920kbps folded before Flop (didn't bet)
Seat 6: Dugipokers folded before Flop (didn't bet)



PokerStars Hand #222950904650:  Hold'em No Limit ($0.05/$0.10 USD) - 2021/01/23 6:33:33 ET
Table 'Stephano III' 6-max Seat #3 is the button
Seat 1: Lars Beukeboom ($5.32 in chips) 
Seat 2: Chazfroggy98 ($7.65 in chips) 
Seat 3: Assetgasse ($17.88 in chips) 
Seat 4: 0TheMouse0 ($14.47 in chips) 
Seat 5: 1920kbps ($27.75 in chips) 
Seat 6: Dugipokers ($10 in chips) 
0TheMouse0: posts small blind $0.05
1920kbps: posts big blind $0.10
*** HOLE CARDS ***
Dugipokers: raises $0.20 to $0.30
Lars Beukeboom: folds 
Chazfroggy98: folds 
Assetgasse: folds 
0TheMouse0: folds 
1920kbps: folds 
Uncalled bet ($0.20) returned to Dugipokers
Dugipokers collected $0.25 from pot
Dugipokers: doesn't show hand 
*** SUMMARY ***
Total pot $0.25 | Rake $0 
Seat 1: Lars Beukeboom folded before Flop (didn't bet)
Seat 2: Chazfroggy98 folded before Flop (didn't bet)
Seat 3: Assetgasse (button) folded before Flop (didn't bet)
Seat 4: 0TheMouse0 (small blind) folded before Flop
Seat 5: 1920kbps (big blind) folded before Flop
Seat 6: Dugipokers collected ($0.25)



PokerStars Hand #222950912602:  Hold'em No Limit ($0.05/$0.10 USD) - 2021/01/23 6:33:56 ET
Table 'Stephano III' 6-max Seat #4 is the button
Seat 1: Lars Beukeboom ($5.32 in chips) 
Seat 2: Chazfroggy98 ($7.65 in chips) 
Seat 3: Assetgasse ($17.88 in chips) 
Seat 4: 0TheMouse0 ($14.42 in chips) 
Seat 5: 1920kbps ($27.65 in chips) 
Seat 6: Dugipokers ($10.15 in chips) 
1920kbps: posts small blind $0.05
Dugipokers: posts big blind $0.10
*** HOLE CARDS ***
Lars Beukeboom: calls $0.10
Chazfroggy98 has timed out
Chazfroggy98: folds 
Assetgasse has timed out
Assetgasse: folds 
0TheMouse0: raises $0.40 to $0.50
1920kbps: folds 
Dugipokers: folds 
Lars Beukeboom: calls $0.40
*** FLOP *** [Ks 7c 6h]
Lars Beukeboom: checks 
0TheMouse0: bets $0.36
Chazfroggy98 leaves the table
Lars Beukeboom: folds 
Uncalled bet ($0.36) returned to 0TheMouse0
0TheMouse0 collected $1.10 from pot
0TheMouse0: doesn't show hand 
*** SUMMARY ***
Total pot $1.15 | Rake $0.05 
Board [Ks 7c 6h]
Seat 1: Lars Beukeboom folded on the Flop
Seat 2: Chazfroggy98 folded before Flop (didn't bet)
Seat 3: Assetgasse folded before Flop (didn't bet)
Seat 4: 0TheMouse0 (button) collected ($1.10)
Seat 5: 1920kbps (small blind) folded before Flop
Seat 6: Dugipokers (big blind) folded before Flop



PokerStars Hand #222950931067:  Hold'em No Limit ($0.05/$0.10 USD) - 2021/01/23 6:34:51 ET
Table 'Stephano III' 6-max Seat #5 is the button
Seat 1: Lars Beukeboom ($4.82 in chips) 
Seat 3: Assetgasse ($17.88 in chips) 
Seat 4: 0TheMouse0 ($15.02 in chips) 
Seat 5: 1920kbps ($27.60 in chips) 
Seat 6: Dugipokers ($10.05 in chips) 
Dugipokers: posts small blind $0.05
Lars Beukeboom: posts big blind $0.10
*** HOLE CARDS ***
Assetgasse: raises $0.20 to $0.30
0TheMouse0: folds 
1920kbps: raises $0.90 to $1.20
Dugipokers: folds 
Lars Beukeboom: folds 
Assetgasse: folds 
Uncalled bet ($0.90) returned to 1920kbps
1920kbps collected $0.75 from pot
*** SUMMARY ***
Total pot $0.75 | Rake $0 
Seat 1: Lars Beukeboom (big blind) folded before Flop
Seat 3: Assetgasse folded before Flop
Seat 4: 0TheMouse0 folded before Flop (didn't bet)
Seat 5: 1920kbps (button) collected ($0.75)
Seat 6: Dugipokers (small blind) folded before Flop



PokerStars Hand #222950935821:  Hold'em No Limit ($0.05/$0.10 USD) - 2021/01/23 6:35:05 ET
Table 'Stephano III' 6-max Seat #6 is the button
Seat 1: Lars Beukeboom ($4.72 in chips) 
Seat 3: Assetgasse ($17.58 in chips) 
Seat 4: 0TheMouse0 ($15.02 in chips) 
Seat 5: 1920kbps ($28.05 in chips) 
Seat 6: Dugipokers ($10 in chips) 
Lars Beukeboom: posts small blind $0.05
Assetgasse: posts big blind $0.10
*** HOLE CARDS ***
0TheMouse0: folds 
1920kbps: folds 
Dugipokers: folds 
Lars Beukeboom: folds 
Uncalled bet ($0.05) returned to Assetgasse
Assetgasse collected $0.10 from pot
Assetgasse: doesn't show hand 
*** SUMMARY ***
Total pot $0.10 | Rake $0 
Seat 1: Lars Beukeboom (small blind) folded before Flop
Seat 3: Assetgasse (big blind) collected ($0.10)
Seat 4: 0TheMouse0 folded before Flop (didn't bet)
Seat 5: 1920kbps folded before Flop (didn't bet)
Seat 6: Dugipokers (button) folded before Flop (didn't bet)



PokerStars Hand #222950938245:  Hold'em No Limit ($0.05/$0.10 USD) - 2021/01/23 6:35:13 ET
Table 'Stephano III' 6-max Seat #1 is the button
Seat 1: Lars Beukeboom ($4.67 in chips) 
Seat 3: Assetgasse ($17.63 in chips) 
Seat 6: Dugipokers ($10 in chips) 
Assetgasse: posts small blind $0.05
0TheMouse0: is sitting out 
1920kbps: is sitting out 
Dugipokers: posts big blind $0.10
*** HOLE CARDS ***
Lars Beukeboom: folds 
Assetgasse: folds 
Uncalled bet ($0.05) returned to Dugipokers
0TheMouse0 leaves the table
Dugipokers collected $0.10 from pot
Dugipokers: doesn't show hand 
1920kbps leaves the table
*** SUMMARY ***
Total pot $0.10 | Rake $0 
Seat 1: Lars Beukeboom (button) folded before Flop (didn't bet)
Seat 3: Assetgasse (small blind) folded before Flop
Seat 6: Dugipokers (big blind) collected ($0.10)



PokerStars Hand #222950939943:  Hold'em No Limit ($0.05/$0.10 USD) - 2021/01/23 6:35:18 ET
Table 'Stephano III' 6-max Seat #3 is the button
Seat 1: Lars Beukeboom ($4.67 in chips) 
Seat 3: Assetgasse ($17.58 in chips) 
Seat 6: Dugipokers ($10.05 in chips) 
Dugipokers: posts small blind $0.05
Lars Beukeboom: posts big blind $0.10
*** HOLE CARDS ***
Assetgasse: folds 
Assetgasse leaves the table
Dugipokers: folds 
Uncalled bet ($0.05) returned to Lars Beukeboom
Lars Beukeboom collected $0.10 from pot
Lars Beukeboom: doesn't show hand 
*** SUMMARY ***
Total pot $0.10 | Rake $0 
Seat 1: Lars Beukeboom (big blind) collected ($0.10)
Seat 3: Assetgasse (button) folded before Flop (didn't bet)
Seat 6: Dugipokers (small blind) folded before Flop



PokerStars Hand #222950943443:  Hold'em No Limit ($0.05/$0.10 USD) - 2021/01/23 6:35:28 ET
Table 'Stephano III' 6-max Seat #1 is the button
Seat 1: Lars Beukeboom ($4.72 in chips) 
Seat 6: Dugipokers ($10 in chips) 
Lars Beukeboom: posts small blind $0.05
Dugipokers: posts big blind $0.10
*** HOLE CARDS ***
Lars Beukeboom: calls $0.05
Assetgasse joins the table at seat #2 
platypus681 joins the table at seat #3 
Dugipokers: checks 
*** FLOP *** [9d 7h Ks]
Dugipokers: checks 
Quatrehuith joins the table at seat #4 
Lars Beukeboom: checks 
*** TURN *** [9d 7h Ks] [2d]
Dugipokers: checks 
Lars Beukeboom: checks 
*** RIVER *** [9d 7h Ks 2d] [Ts]
Dugipokers: checks 
Lars Beukeboom: bets $0.19
Dugipokers: folds 
Uncalled bet ($0.19) returned to Lars Beukeboom
Lars Beukeboom collected $0.19 from pot
Lars Beukeboom: doesn't show hand 
*** SUMMARY ***
Total pot $0.20 | Rake $0.01 
Board [9d 7h Ks 2d Ts]
Seat 1: Lars Beukeboom (button) (small blind) collected ($0.19)
Seat 6: Dugipokers (big blind) folded on the River



PokerStars Hand #222950954374:  Hold'em No Limit ($0.05/$0.10 USD) - 2021/01/23 6:36:01 ET
Table 'Stephano III' 6-max Seat #6 is the button
Seat 1: Lars Beukeboom ($4.81 in chips) 
Seat 2: Assetgasse ($17.58 in chips) 
Seat 6: Dugipokers ($10 in chips) 
Lars Beukeboom: posts small blind $0.05
Assetgasse: posts big blind $0.10
platypus681: sits out 
Quatrehuith: sits out 
*** HOLE CARDS ***
Dugipokers: raises $0.15 to $0.25
Lars Beukeboom: calls $0.20
Assetgasse: folds 
*** FLOP *** [9d 6h 4h]
Lars Beukeboom: checks 
Dugipokers: bets $0.29
Lars Beukeboom: folds 
Uncalled bet ($0.29) returned to Dugipokers
Dugipokers collected $0.57 from pot
Dugipokers: doesn't show hand 
*** SUMMARY ***
Total pot $0.60 | Rake $0.03 
Board [9d 6h 4h]
Seat 1: Lars Beukeboom (small blind) folded on the Flop
Seat 2: Assetgasse (big blind) folded before Flop
Seat 6: Dugipokers (button) collected ($0.57)



PokerStars Hand #222950961565:  Hold'em No Limit ($0.05/$0.10 USD) - 2021/01/23 6:36:22 ET
Table 'Stephano III' 6-max Seat #1 is the button
Seat 1: Lars Beukeboom ($4.56 in chips) 
Seat 2: Assetgasse ($17.48 in chips) 
Seat 3: platypus681 ($10 in chips) 
Seat 6: Dugipokers ($10.32 in chips) 
Assetgasse: posts small blind $0.05
platypus681: posts big blind $0.10
Quatrehuith: sits out 
*** HOLE CARDS ***
Dugipokers: raises $0.15 to $0.25
Lars Beukeboom: calls $0.25
Assetgasse: folds 
platypus681: folds 
*** FLOP *** [Td Jc 6c]
Dugipokers: checks 
Lars Beukeboom: checks 
*** TURN *** [Td Jc 6c] [8d]
Dugipokers: checks 
Lars Beukeboom: checks 
*** RIVER *** [Td Jc 6c 8d] [2c]
Dugipokers: checks 
Lars Beukeboom: checks 
*** SHOW DOWN ***
Dugipokers: shows [Ks 8s] (a pair of Eights)
Lars Beukeboom: mucks hand 
Dugipokers collected $0.62 from pot
*** SUMMARY ***
Total pot $0.65 | Rake $0.03 
Board [Td Jc 6c 8d 2c]
Seat 1: Lars Beukeboom (button) mucked
Seat 2: Assetgasse (small blind) folded before Flop
Seat 3: platypus681 (big blind) folded before Flop
Seat 6: Dugipokers showed [Ks 8s] and won ($0.62) with a pair of Eights



PokerStars Hand #222950971140:  Hold'em No Limit ($0.05/$0.10 USD) - 2021/01/23 6:36:51 ET
Table 'Stephano III' 6-max Seat #2 is the button
Seat 1: Lars Beukeboom ($4.31 in chips) 
Seat 2: Assetgasse ($17.43 in chips) 
Seat 3: platypus681 ($10 in chips) 
Seat 4: Quatrehuith ($10 in chips) 
Seat 6: Dugipokers ($10.69 in chips) 
platypus681: posts small blind $0.05
Quatrehuith: posts big blind $0.10
*** HOLE CARDS ***
Bambi'sAces joins the table at seat #5 
Dugipokers: raises $0.20 to $0.30
Lars Beukeboom: calls $0.30
Assetgasse: folds 
platypus681: folds 
Quatrehuith: folds 
*** FLOP *** [3c 6c Jd]
Dugipokers: bets $0.55
Lars Beukeboom: folds 
Uncalled bet ($0.55) returned to Dugipokers
Dugipokers collected $0.72 from pot
Dugipokers: doesn't show hand 
*** SUMMARY ***
Total pot $0.75 | Rake $0.03 
Board [3c 6c Jd]
Seat 1: Lars Beukeboom folded on the Flop
Seat 2: Assetgasse (button) folded before Flop (didn't bet)
Seat 3: platypus681 (small blind) folded before Flop
Seat 4: Quatrehuith (big blind) folded before Flop
Seat 6: Dugipokers collected ($0.72)



PokerStars Hand #222950984352:  Hold'em No Limit ($0.05/$0.10 USD) - 2021/01/23 6:37:30 ET
Table 'Stephano III' 6-max Seat #3 is the button
Seat 1: Lars Beukeboom ($4.01 in chips) 
Seat 2: Assetgasse ($17.43 in chips) 
Seat 3: platypus681 ($10 in chips) 
Seat 4: Quatrehuith ($10 in chips) 
Seat 5: Bambi'sAces ($8 in chips) 
Seat 6: Dugipokers ($11.11 in chips) 
Quatrehuith: posts small blind $0.05
Bambi'sAces: posts big blind $0.10
*** HOLE CARDS ***
Dugipokers: folds 
Lars Beukeboom: calls $0.10
Assetgasse: raises $0.30 to $0.40
platypus681: folds 
Quatrehuith: folds 
Bambi'sAces: folds 
Lars Beukeboom: calls $0.30
*** FLOP *** [Kh Tc Qs]
Lars Beukeboom: checks 
Assetgasse: bets $0.46
Lars Beukeboom: folds 
Uncalled bet ($0.46) returned to Assetgasse
Assetgasse collected $0.91 from pot
Assetgasse: doesn't show hand 
*** SUMMARY ***
Total pot $0.95 | Rake $0.04 
Board [Kh Tc Qs]
Seat 1: Lars Beukeboom folded on the Flop
Seat 2: Assetgasse collected ($0.91)
Seat 3: platypus681 (button) folded before Flop (didn't bet)
Seat 4: Quatrehuith (small blind) folded before Flop
Seat 5: Bambi'sAces (big blind) folded before Flop
Seat 6: Dugipokers folded before Flop (didn't bet)



PokerStars Hand #222950993901:  Hold'em No Limit ($0.05/$0.10 USD) - 2021/01/23 6:37:58 ET
Table 'Stephano III' 6-max Seat #4 is the button
Seat 1: Lars Beukeboom ($3.61 in chips) 
Seat 2: Assetgasse ($17.94 in chips) 
Seat 3: platypus681 ($10 in chips) 
Seat 4: Quatrehuith ($10 in chips) 
Seat 5: Bambi'sAces ($7.90 in chips) 
Seat 6: Dugipokers ($11.11 in chips) 
Bambi'sAces: posts small blind $0.05
Dugipokers: posts big blind $0.10
*** HOLE CARDS ***
Lars Beukeboom: calls $0.10
Assetgasse: raises $0.20 to $0.30
platypus681: folds 
Quatrehuith: folds 
Bambi'sAces: folds 
Dugipokers: calls $0.20
Lars Beukeboom: calls $0.20
*** FLOP *** [3c 7c Qd]
Dugipokers: checks 
Lars Beukeboom: checks 
Assetgasse: bets $0.60
Dugipokers: folds 
Lars Beukeboom: folds 
Uncalled bet ($0.60) returned to Assetgasse
Assetgasse collected $0.91 from pot
Assetgasse: doesn't show hand 
*** SUMMARY ***
Total pot $0.95 | Rake $0.04 
Board [3c 7c Qd]
Seat 1: Lars Beukeboom folded on the Flop
Seat 2: Assetgasse collected ($0.91)
Seat 3: platypus681 folded before Flop (didn't bet)
Seat 4: Quatrehuith (button) folded before Flop (didn't bet)
Seat 5: Bambi'sAces (small blind) folded before Flop
Seat 6: Dugipokers (big blind) folded on the Flop



PokerStars Hand #222951006460:  Hold'em No Limit ($0.05/$0.10 USD) - 2021/01/23 6:38:35 ET
Table 'Stephano III' 6-max Seat #5 is the button
Seat 1: Lars Beukeboom ($3.31 in chips) 
Seat 2: Assetgasse ($18.55 in chips) 
Seat 3: platypus681 ($10 in chips) 
Seat 4: Quatrehuith ($10 in chips) 
Seat 5: Bambi'sAces ($7.85 in chips) 
Seat 6: Dugipokers ($10.81 in chips) 
Dugipokers: posts small blind $0.05
Lars Beukeboom: posts big blind $0.10
*** HOLE CARDS ***
Assetgasse: raises $0.12 to $0.22
platypus681: folds 
Quatrehuith: folds 
Bambi'sAces: folds 
Dugipokers: folds 
Lars Beukeboom: folds 
Uncalled bet ($0.12) returned to Assetgasse
Assetgasse collected $0.25 from pot
Assetgasse: doesn't show hand 
*** SUMMARY ***
Total pot $0.25 | Rake $0 
Seat 1: Lars Beukeboom (big blind) folded before Flop
Seat 2: Assetgasse collected ($0.25)
Seat 3: platypus681 folded before Flop (didn't bet)
Seat 4: Quatrehuith folded before Flop (didn't bet)
Seat 5: Bambi'sAces (button) folded before Flop (didn't bet)
Seat 6: Dugipokers (small blind) folded before Flop



PokerStars Hand #222951013179:  Hold'em No Limit ($0.05/$0.10 USD) - 2021/01/23 6:38:55 ET
Table 'Stephano III' 6-max Seat #6 is the button
Seat 1: Lars Beukeboom ($3.21 in chips) 
Seat 2: Assetgasse ($18.70 in chips) 
Seat 3: platypus681 ($10 in chips) 
Seat 4: Quatrehuith ($10 in chips) 
Seat 5: Bambi'sAces ($7.85 in chips) 
Seat 6: Dugipokers ($10.76 in chips) 
Lars Beukeboom: posts small blind $0.05
Assetgasse: posts big blind $0.10
*** HOLE CARDS ***
platypus681: folds 
Quatrehuith: folds 
Bambi'sAces: raises $0.20 to $0.30
Dugipokers: folds 
Lars Beukeboom: folds 
Assetgasse: folds 
Uncalled bet ($0.20) returned to Bambi'sAces
Bambi'sAces collected $0.25 from pot
Bambi'sAces: doesn't show hand 
*** SUMMARY ***
Total pot $0.25 | Rake $0 
Seat 1: Lars Beukeboom (small blind) folded before Flop
Seat 2: Assetgasse (big blind) folded before Flop
Seat 3: platypus681 folded before Flop (didn't bet)
Seat 4: Quatrehuith folded before Flop (didn't bet)
Seat 5: Bambi'sAces collected ($0.25)
Seat 6: Dugipokers (button) folded before Flop (didn't bet)



PokerStars Hand #222951017395:  Hold'em No Limit ($0.05/$0.10 USD) - 2021/01/23 6:39:07 ET
Table 'Stephano III' 6-max Seat #1 is the button
Seat 1: Lars Beukeboom ($3.16 in chips) 
Seat 2: Assetgasse ($18.60 in chips) 
Seat 3: platypus681 ($10 in chips) 
Seat 4: Quatrehuith ($10 in chips) 
Seat 5: Bambi'sAces ($8 in chips) 
Seat 6: Dugipokers ($10.76 in chips) 
Assetgasse: posts small blind $0.05
platypus681: posts big blind $0.10
*** HOLE CARDS ***
Quatrehuith: folds 
Bambi'sAces: calls $0.10
Dugipokers: folds 
Lars Beukeboom: folds 
Assetgasse: folds 
platypus681: checks 
*** FLOP *** [8s 8h Qc]
platypus681: checks 
Bambi'sAces: bets $0.12
platypus681: calls $0.12
*** TURN *** [8s 8h Qc] [9c]
platypus681: checks 
Bambi'sAces: checks 
*** RIVER *** [8s 8h Qc 9c] [Js]
platypus681: checks 
Bambi'sAces: bets $0.47
platypus681: folds 
Uncalled bet ($0.47) returned to Bambi'sAces
Bambi'sAces collected $0.47 from pot
Bambi'sAces: doesn't show hand 
*** SUMMARY ***
Total pot $0.49 | Rake $0.02 
Board [8s 8h Qc 9c Js]
Seat 1: Lars Beukeboom (button) folded before Flop (didn't bet)
Seat 2: Assetgasse (small blind) folded before Flop
Seat 3: platypus681 (big blind) folded on the River
Seat 4: Quatrehuith folded before Flop (didn't bet)
Seat 5: Bambi'sAces collected ($0.47)
Seat 6: Dugipokers folded before Flop (didn't bet)



PokerStars Hand #222951040473:  Hold'em No Limit ($0.05/$0.10 USD) - 2021/01/23 6:40:15 ET
Table 'Stephano III' 6-max Seat #2 is the button
Seat 1: Lars Beukeboom ($3.16 in chips) 
Seat 2: Assetgasse ($18.55 in chips) 
Seat 3: platypus681 ($10 in chips) 
Seat 4: Quatrehuith ($10 in chips) 
Seat 5: Bambi'sAces ($8.25 in chips) 
Seat 6: Dugipokers ($10.76 in chips) 
platypus681: posts small blind $0.05
Quatrehuith: posts big blind $0.10
*** HOLE CARDS ***
Bambi'sAces: folds 
Dugipokers: raises $0.20 to $0.30
Lars Beukeboom: folds 
Assetgasse: folds 
platypus681: folds 
Quatrehuith: folds 
Uncalled bet ($0.20) returned to Dugipokers
Dugipokers collected $0.25 from pot
Dugipokers: doesn't show hand 
*** SUMMARY ***
Total pot $0.25 | Rake $0 
Seat 1: Lars Beukeboom folded before Flop (didn't bet)
Seat 2: Assetgasse (button) folded before Flop (didn't bet)
Seat 3: platypus681 (small blind) folded before Flop
Seat 4: Quatrehuith (big blind) folded before Flop
Seat 5: Bambi'sAces folded before Flop (didn't bet)
Seat 6: Dugipokers collected ($0.25)



PokerStars Hand #222951044100:  Hold'em No Limit ($0.05/$0.10 USD) - 2021/01/23 6:40:25 ET
Table 'Stephano III' 6-max Seat #3 is the button
Seat 1: Lars Beukeboom ($3.16 in chips) 
Seat 2: Assetgasse ($18.55 in chips) 
Seat 3: platypus681 ($10 in chips) 
Seat 4: Quatrehuith ($10 in chips) 
Seat 5: Bambi'sAces ($8.25 in chips) 
Seat 6: Dugipokers ($10.91 in chips) 
Quatrehuith: posts small blind $0.05
Bambi'sAces: posts big blind $0.10
*** HOLE CARDS ***
Dugipokers: folds 
Lars Beukeboom: calls $0.10
Assetgasse: raises $0.30 to $0.40
platypus681: folds 
Quatrehuith: folds 
Bambi'sAces: calls $0.30
Lars Beukeboom: calls $0.30
*** FLOP *** [4d 5d 3c]
Bambi'sAces: checks 
Lars Beukeboom: checks 
Assetgasse: checks 
*** TURN *** [4d 5d 3c] [9h]
Bambi'sAces: checks 
Lars Beukeboom: checks 
Assetgasse: checks 
*** RIVER *** [4d 5d 3c 9h] [5c]
Bambi'sAces: bets $1.19
Lars Beukeboom: folds 
Assetgasse: folds 
Uncalled bet ($1.19) returned to Bambi'sAces
Bambi'sAces collected $1.19 from pot
Bambi'sAces: doesn't show hand 
*** SUMMARY ***
Total pot $1.25 | Rake $0.06 
Board [4d 5d 3c 9h 5c]
Seat 1: Lars Beukeboom folded on the River
Seat 2: Assetgasse folded on the River
Seat 3: platypus681 (button) folded before Flop (didn't bet)
Seat 4: Quatrehuith (small blind) folded before Flop
Seat 5: Bambi'sAces (big blind) collected ($1.19)
Seat 6: Dugipokers folded before Flop (didn't bet)



PokerStars Hand #222951055558:  Hold'em No Limit ($0.05/$0.10 USD) - 2021/01/23 6:40:59 ET
Table 'Stephano III' 6-max Seat #4 is the button
Seat 1: Lars Beukeboom ($2.76 in chips) 
Seat 2: Assetgasse ($18.15 in chips) 
Seat 3: platypus681 ($10 in chips) 
Seat 4: Quatrehuith ($10 in chips) 
Seat 5: Bambi'sAces ($9.04 in chips) 
Seat 6: Dugipokers ($10.91 in chips) 
Bambi'sAces: posts small blind $0.05
Dugipokers: posts big blind $0.10
*** HOLE CARDS ***
Lars Beukeboom: calls $0.10
Assetgasse: folds 
platypus681: folds 
Quatrehuith: raises $0.30 to $0.40
Bambi'sAces: folds 
Dugipokers: folds 
Lars Beukeboom: calls $0.30
*** FLOP *** [2d Qd 7c]
Lars Beukeboom: bets $2.36 and is all-in
Quatrehuith: calls $2.36
*** TURN *** [2d Qd 7c] [8s]
*** RIVER *** [2d Qd 7c 8s] [Kh]
*** SHOW DOWN ***
Lars Beukeboom: shows [Qs 6d] (a pair of Queens)
Quatrehuith: shows [Ad Kc] (a pair of Kings)
Quatrehuith collected $5.41 from pot
*** SUMMARY ***
Total pot $5.67 | Rake $0.26 
Board [2d Qd 7c 8s Kh]
Seat 1: Lars Beukeboom showed [Qs 6d] and lost with a pair of Queens
Seat 2: Assetgasse folded before Flop (didn't bet)
Seat 3: platypus681 folded before Flop (didn't bet)
Seat 4: Quatrehuith (button) showed [Ad Kc] and won ($5.41) with a pair of Kings
Seat 5: Bambi'sAces (small blind) folded before Flop
Seat 6: Dugipokers (big blind) folded before Flop



PokerStars Hand #222951068852:  Hold'em No Limit ($0.05/$0.10 USD) - 2021/01/23 6:41:38 ET
Table 'Stephano III' 6-max Seat #5 is the button
Seat 3: platypus681 ($10 in chips) 
Seat 4: Quatrehuith ($12.65 in chips) 
Seat 5: Bambi'sAces ($8.99 in chips) 
Seat 6: Dugipokers ($10.81 in chips) 
Dugipokers: posts small blind $0.05
Assetgasse: is sitting out 
platypus681: posts big blind $0.10
*** HOLE CARDS ***
Quatrehuith: folds 
Bambi'sAces: folds 
Dugipokers: folds 
Uncalled bet ($0.05) returned to platypus681
platypus681 collected $0.10 from pot
platypus681: doesn't show hand 
*** SUMMARY ***
Total pot $0.10 | Rake $0 
Seat 3: platypus681 (big blind) collected ($0.10)
Seat 4: Quatrehuith folded before Flop (didn't bet)
Seat 5: Bambi'sAces (button) folded before Flop (didn't bet)
Seat 6: Dugipokers (small blind) folded before Flop



PokerStars Hand #222951074030:  Hold'em No Limit ($0.05/$0.10 USD) - 2021/01/23 6:41:53 ET
Table 'Stephano III' 6-max Seat #6 is the button
Seat 3: platypus681 ($10.05 in chips) 
Seat 4: Quatrehuith ($12.65 in chips) 
Seat 5: Bambi'sAces ($8.99 in chips) 
Seat 6: Dugipokers ($10.76 in chips) 
platypus681: posts small blind $0.05
Quatrehuith: posts big blind $0.10
*** HOLE CARDS ***
Bambi'sAces: folds 
Dugipokers: raises $0.15 to $0.25
Bambi'sAces leaves the table
platypus681: raises $0.75 to $1
Quatrehuith: folds 
Dugipokers: folds 
Uncalled bet ($0.75) returned to platypus681
Quatrehuith leaves the table
platypus681 collected $0.60 from pot
platypus681: doesn't show hand 
*** SUMMARY ***
Total pot $0.60 | Rake $0 
Seat 3: platypus681 (small blind) collected ($0.60)
Seat 4: Quatrehuith (big blind) folded before Flop
Seat 5: Bambi'sAces folded before Flop (didn't bet)
Seat 6: Dugipokers (button) folded before Flop



PokerStars Hand #222951081051:  Hold'em No Limit ($0.05/$0.10 USD) - 2021/01/23 6:42:14 ET
Table 'Stephano III' 6-max Seat #3 is the button
Seat 3: platypus681 ($10.40 in chips) 
Seat 6: Dugipokers ($10.51 in chips) 
platypus681: posts small blind $0.05
Dugipokers: posts big blind $0.10
*** HOLE CARDS ***
platypus681: raises $0.20 to $0.30
Dugipokers: calls $0.20
*** FLOP *** [7h 6s Jd]
Dugipokers: checks 
platypus681: bets $0.19
Dugipokers: calls $0.19
*** TURN *** [7h 6s Jd] [As]
Dugipokers: checks 
platypus681: bets $0.62
Dugipokers: calls $0.62
*** RIVER *** [7h 6s Jd As] [2h]
Dugipokers: checks 
platypus681: bets $1.95
sttanlley joins the table at seat #4 
Dugipokers: folds 
Uncalled bet ($1.95) returned to platypus681
platypus681 collected $2.12 from pot
platypus681: doesn't show hand 
sttanlley leaves the table
*** SUMMARY ***
Total pot $2.22 | Rake $0.10 
Board [7h 6s Jd As 2h]
Seat 3: platypus681 (button) (small blind) collected ($2.12)
Seat 6: Dugipokers (big blind) folded on the River



PokerStars Hand #222951111303:  Hold'em No Limit ($0.05/$0.10 USD) - 2021/01/23 6:43:42 ET
Table 'Stephano III' 6-max Seat #3 is the button
Seat 2: Assetgasse ($18.15 in chips) 
Seat 3: platypus681 ($11.41 in chips) 
Seat 6: Dugipokers ($10 in chips) 
Dugipokers: posts small blind $0.05
Assetgasse: posts big blind $0.10
*** HOLE CARDS ***
platypus681: raises $0.18 to $0.28
Dugipokers: folds 
Assetgasse: folds 
Uncalled bet ($0.18) returned to platypus681
platypus681 collected $0.25 from pot
platypus681: doesn't show hand 
*** SUMMARY ***
Total pot $0.25 | Rake $0 
Seat 2: Assetgasse (big blind) folded before Flop
Seat 3: platypus681 (button) collected ($0.25)
Seat 6: Dugipokers (small blind) folded before Flop



PokerStars Hand #222951114058:  Hold'em No Limit ($0.05/$0.10 USD) - 2021/01/23 6:43:51 ET
Table 'Stephano III' 6-max Seat #2 is the button
Seat 2: Assetgasse ($18.05 in chips) 
Seat 6: Dugipokers ($10 in chips) 
Assetgasse: posts small blind $0.05
platypus681: is sitting out 
Dugipokers: posts big blind $0.10
*** HOLE CARDS ***
platypus681 leaves the table
Assetgasse: folds 
Uncalled bet ($0.05) returned to Dugipokers
Dugipokers collected $0.10 from pot
Dugipokers: doesn't show hand 
*** SUMMARY ***
Total pot $0.10 | Rake $0 
Seat 2: Assetgasse (button) (small blind) folded before Flop
Seat 6: Dugipokers (big blind) collected ($0.10)



PokerStars Hand #222954223339:  Hold'em No Limit ($0.05/$0.10 USD) - 2021/01/23 8:56:10 ET
Table 'Stephano III' 6-max Seat #3 is the button
Seat 1: maxthebest99 ($20.69 in chips) 
Seat 3: xulfster ($10 in chips) 
Seat 4: eRRe_ssbm ($10 in chips) 
Seat 5: 3EBC96 ($12.91 in chips) 
Seat 6: sandra1189@ ($11.53 in chips) 
eRRe_ssbm: posts small blind $0.05
3EBC96: posts big blind $0.10
*** HOLE CARDS ***
sandra1189@: folds 
maxthebest99: calls $0.10
xulfster: folds 
eRRe_ssbm: folds 
3EBC96: checks 
*** FLOP *** [9c Tc 6c]
3EBC96: checks 
maxthebest99: bets $0.10
3EBC96: calls $0.10
*** TURN *** [9c Tc 6c] [2s]
3EBC96: checks 
maxthebest99: bets $0.20
3EBC96: folds 
Uncalled bet ($0.20) returned to maxthebest99
maxthebest99 collected $0.43 from pot
maxthebest99: doesn't show hand 
*** SUMMARY ***
Total pot $0.45 | Rake $0.02 
Board [9c Tc 6c 2s]
Seat 1: maxthebest99 collected ($0.43)
Seat 3: xulfster (button) folded before Flop (didn't bet)
Seat 4: eRRe_ssbm (small blind) folded before Flop
Seat 5: 3EBC96 (big blind) folded on the Turn
Seat 6: sandra1189@ folded before Flop (didn't bet)



PokerStars Hand #222954234524:  Hold'em No Limit ($0.05/$0.10 USD) - 2021/01/23 8:56:41 ET
Table 'Stephano III' 6-max Seat #4 is the button
Seat 1: maxthebest99 ($20.92 in chips) 
Seat 3: xulfster ($10 in chips) 
Seat 4: eRRe_ssbm ($10 in chips) 
Seat 5: 3EBC96 ($12.71 in chips) 
Seat 6: sandra1189@ ($11.53 in chips) 
3EBC96: posts small blind $0.05
sandra1189@: posts big blind $0.10
*** HOLE CARDS ***
maxthebest99: folds 
xulfster: raises $0.15 to $0.25
eRRe_ssbm: folds 
3EBC96: folds 
sandra1189@: folds 
Uncalled bet ($0.15) returned to xulfster
xulfster collected $0.25 from pot
*** SUMMARY ***
Total pot $0.25 | Rake $0 
Seat 1: maxthebest99 folded before Flop (didn't bet)
Seat 3: xulfster collected ($0.25)
Seat 4: eRRe_ssbm (button) folded before Flop (didn't bet)
Seat 5: 3EBC96 (small blind) folded before Flop
Seat 6: sandra1189@ (big blind) folded before Flop



PokerStars Hand #222954242542:  Hold'em No Limit ($0.05/$0.10 USD) - 2021/01/23 8:57:03 ET
Table 'Stephano III' 6-max Seat #5 is the button
Seat 1: maxthebest99 ($20.92 in chips) 
Seat 3: xulfster ($10.15 in chips) 
Seat 4: eRRe_ssbm ($10 in chips) 
Seat 5: 3EBC96 ($12.66 in chips) 
Seat 6: sandra1189@ ($11.43 in chips) 
sandra1189@: posts small blind $0.05
maxthebest99: posts big blind $0.10
*** HOLE CARDS ***
xulfster: folds 
eRRe_ssbm: folds 
3EBC96: raises $0.20 to $0.30
sandra1189@: folds 
maxthebest99: folds 
Uncalled bet ($0.20) returned to 3EBC96
3EBC96 collected $0.25 from pot
3EBC96: doesn't show hand 
*** SUMMARY ***
Total pot $0.25 | Rake $0 
Seat 1: maxthebest99 (big blind) folded before Flop
Seat 3: xulfster folded before Flop (didn't bet)
Seat 4: eRRe_ssbm folded before Flop (didn't bet)
Seat 5: 3EBC96 (button) collected ($0.25)
Seat 6: sandra1189@ (small blind) folded before Flop



PokerStars Hand #222954248244:  Hold'em No Limit ($0.05/$0.10 USD) - 2021/01/23 8:57:18 ET
Table 'Stephano III' 6-max Seat #6 is the button
Seat 1: maxthebest99 ($20.82 in chips) 
Seat 3: xulfster ($10.15 in chips) 
Seat 4: eRRe_ssbm ($10 in chips) 
Seat 5: 3EBC96 ($12.81 in chips) 
Seat 6: sandra1189@ ($11.38 in chips) 
maxthebest99: posts small blind $0.05
xulfster: posts big blind $0.10
*** HOLE CARDS ***
eRRe_ssbm: raises $0.20 to $0.30
3EBC96: folds 
sandra1189@: folds 
maxthebest99: folds 
xulfster: folds 
Uncalled bet ($0.20) returned to eRRe_ssbm
eRRe_ssbm collected $0.25 from pot
eRRe_ssbm: doesn't show hand 
*** SUMMARY ***
Total pot $0.25 | Rake $0 
Seat 1: maxthebest99 (small blind) folded before Flop
Seat 3: xulfster (big blind) folded before Flop
Seat 4: eRRe_ssbm collected ($0.25)
Seat 5: 3EBC96 folded before Flop (didn't bet)
Seat 6: sandra1189@ (button) folded before Flop (didn't bet)



PokerStars Hand #222954259940:  Hold'em No Limit ($0.05/$0.10 USD) - 2021/01/23 8:57:50 ET
Table 'Stephano III' 6-max Seat #1 is the button
Seat 1: maxthebest99 ($20.77 in chips) 
Seat 3: xulfster ($10.05 in chips) 
Seat 4: eRRe_ssbm ($10.15 in chips) 
Seat 5: 3EBC96 ($12.81 in chips) 
Seat 6: sandra1189@ ($11.38 in chips) 
xulfster: posts small blind $0.05
eRRe_ssbm: posts big blind $0.10
*** HOLE CARDS ***
3EBC96: folds 
sandra1189@: calls $0.10
maxthebest99: folds 
xulfster: folds 
eRRe_ssbm: checks 
*** FLOP *** [Td 6s 8d]
eRRe_ssbm: checks 
sandra1189@: checks 
*** TURN *** [Td 6s 8d] [Jd]
eRRe_ssbm: checks 
sandra1189@: bets $0.10
eRRe_ssbm: calls $0.10
*** RIVER *** [Td 6s 8d Jd] [Jc]
eRRe_ssbm: checks 
sandra1189@: checks 
*** SHOW DOWN ***
eRRe_ssbm: shows [8h Kh] (two pair, Jacks and Eights)
sandra1189@: mucks hand 
eRRe_ssbm collected $0.43 from pot
*** SUMMARY ***
Total pot $0.45 | Rake $0.02 
Board [Td 6s 8d Jd Jc]
Seat 1: maxthebest99 (button) folded before Flop (didn't bet)
Seat 3: xulfster (small blind) folded before Flop
Seat 4: eRRe_ssbm (big blind) showed [8h Kh] and won ($0.43) with two pair, Jacks and Eights
Seat 5: 3EBC96 folded before Flop (didn't bet)
Seat 6: sandra1189@ mucked



PokerStars Hand #222954281594:  Hold'em No Limit ($0.05/$0.10 USD) - 2021/01/23 8:58:50 ET
Table 'Stephano III' 6-max Seat #3 is the button
Seat 1: maxthebest99 ($20.77 in chips) 
Seat 3: xulfster ($10 in chips) 
Seat 4: eRRe_ssbm ($10.38 in chips) 
Seat 5: 3EBC96 ($12.81 in chips) 
Seat 6: sandra1189@ ($11.18 in chips) 
eRRe_ssbm: posts small blind $0.05
3EBC96: posts big blind $0.10
*** HOLE CARDS ***
sandra1189@: raises $0.10 to $0.20
maxthebest99: folds 
xulfster has timed out
xulfster: folds 
eRRe_ssbm: folds 
3EBC96: folds 
Uncalled bet ($0.10) returned to sandra1189@
sandra1189@ collected $0.25 from pot
sandra1189@: doesn't show hand 
*** SUMMARY ***
Total pot $0.25 | Rake $0 
Seat 1: maxthebest99 folded before Flop (didn't bet)
Seat 3: xulfster (button) folded before Flop (didn't bet)
Seat 4: eRRe_ssbm (small blind) folded before Flop
Seat 5: 3EBC96 (big blind) folded before Flop
Seat 6: sandra1189@ collected ($0.25)



PokerStars Hand #222954289979:  Hold'em No Limit ($0.05/$0.10 USD) - 2021/01/23 8:59:13 ET
Table 'Stephano III' 6-max Seat #4 is the button
Seat 1: maxthebest99 ($20.77 in chips) 
Seat 3: xulfster ($10 in chips) 
Seat 4: eRRe_ssbm ($10.33 in chips) 
Seat 5: 3EBC96 ($12.71 in chips) 
Seat 6: sandra1189@ ($11.33 in chips) 
3EBC96: posts small blind $0.05
sandra1189@: posts big blind $0.10
*** HOLE CARDS ***
maxthebest99: folds 
xulfster: folds 
eRRe_ssbm: folds 
3EBC96: folds 
Uncalled bet ($0.05) returned to sandra1189@
sandra1189@ collected $0.10 from pot
sandra1189@: doesn't show hand 
*** SUMMARY ***
Total pot $0.10 | Rake $0 
Seat 1: maxthebest99 folded before Flop (didn't bet)
Seat 3: xulfster folded before Flop (didn't bet)
Seat 4: eRRe_ssbm (button) folded before Flop (didn't bet)
Seat 5: 3EBC96 (small blind) folded before Flop
Seat 6: sandra1189@ (big blind) collected ($0.10)



PokerStars Hand #222954294044:  Hold'em No Limit ($0.05/$0.10 USD) - 2021/01/23 8:59:24 ET
Table 'Stephano III' 6-max Seat #5 is the button
Seat 1: maxthebest99 ($20.77 in chips) 
Seat 3: xulfster ($10 in chips) 
Seat 4: eRRe_ssbm ($10.33 in chips) 
Seat 5: 3EBC96 ($12.66 in chips) 
Seat 6: sandra1189@ ($11.38 in chips) 
sandra1189@: posts small blind $0.05
maxthebest99: posts big blind $0.10
*** HOLE CARDS ***
xulfster: folds 
eRRe_ssbm: folds 
3EBC96: raises $0.20 to $0.30
sandra1189@: calls $0.25
maxthebest99: folds 
*** FLOP *** [Qh 9d 7h]
sandra1189@: checks 
3EBC96: bets $0.34
sandra1189@: calls $0.34
*** TURN *** [Qh 9d 7h] [Ks]
sandra1189@: checks 
3EBC96: bets $0.99
sandra1189@: folds 
Uncalled bet ($0.99) returned to 3EBC96
3EBC96 collected $1.32 from pot
3EBC96: doesn't show hand 
*** SUMMARY ***
Total pot $1.38 | Rake $0.06 
Board [Qh 9d 7h Ks]
Seat 1: maxthebest99 (big blind) folded before Flop
Seat 3: xulfster folded before Flop (didn't bet)
Seat 4: eRRe_ssbm folded before Flop (didn't bet)
Seat 5: 3EBC96 (button) collected ($1.32)
Seat 6: sandra1189@ (small blind) folded on the Turn



PokerStars Hand #222954305565:  Hold'em No Limit ($0.05/$0.10 USD) - 2021/01/23 8:59:55 ET
Table 'Stephano III' 6-max Seat #6 is the button
Seat 1: maxthebest99 ($20.67 in chips) 
Seat 3: xulfster ($10 in chips) 
Seat 4: eRRe_ssbm ($10.33 in chips) 
Seat 5: 3EBC96 ($13.34 in chips) 
Seat 6: sandra1189@ ($10.74 in chips) 
maxthebest99: posts small blind $0.05
xulfster: posts big blind $0.10
*** HOLE CARDS ***
eRRe_ssbm: raises $0.20 to $0.30
3EBC96: raises $0.60 to $0.90
sandra1189@: folds 
maxthebest99: folds 
xulfster: folds 
eRRe_ssbm: folds 
Uncalled bet ($0.60) returned to 3EBC96
3EBC96 collected $0.75 from pot
3EBC96: doesn't show hand 
*** SUMMARY ***
Total pot $0.75 | Rake $0 
Seat 1: maxthebest99 (small blind) folded before Flop
Seat 3: xulfster (big blind) folded before Flop
Seat 4: eRRe_ssbm folded before Flop
Seat 5: 3EBC96 collected ($0.75)
Seat 6: sandra1189@ (button) folded before Flop (didn't bet)



PokerStars Hand #222954313804:  Hold'em No Limit ($0.05/$0.10 USD) - 2021/01/23 9:00:17 ET
Table 'Stephano III' 6-max Seat #1 is the button
Seat 1: maxthebest99 ($20.62 in chips) 
Seat 3: xulfster ($10 in chips) 
Seat 4: eRRe_ssbm ($10.03 in chips) 
Seat 5: 3EBC96 ($13.79 in chips) 
Seat 6: sandra1189@ ($10.74 in chips) 
xulfster: posts small blind $0.05
eRRe_ssbm: posts big blind $0.10
*** HOLE CARDS ***
3EBC96: folds 
sandra1189@: calls $0.10
maxthebest99: folds 
xulfster: folds 
eRRe_ssbm: checks 
*** FLOP *** [9d Qs Qc]
eRRe_ssbm: checks 
sandra1189@: checks 
*** TURN *** [9d Qs Qc] [9h]
eRRe_ssbm: bets $0.10
sandra1189@: folds 
Uncalled bet ($0.10) returned to eRRe_ssbm
eRRe_ssbm collected $0.24 from pot
eRRe_ssbm: doesn't show hand 
*** SUMMARY ***
Total pot $0.25 | Rake $0.01 
Board [9d Qs Qc 9h]
Seat 1: maxthebest99 (button) folded before Flop (didn't bet)
Seat 3: xulfster (small blind) folded before Flop
Seat 4: eRRe_ssbm (big blind) collected ($0.24)
Seat 5: 3EBC96 folded before Flop (didn't bet)
Seat 6: sandra1189@ folded on the Turn



PokerStars Hand #222954329810:  Hold'em No Limit ($0.05/$0.10 USD) - 2021/01/23 9:00:57 ET
Table 'Stephano III' 6-max Seat #3 is the button
Seat 1: maxthebest99 ($20.62 in chips) 
Seat 3: xulfster ($10 in chips) 
Seat 4: eRRe_ssbm ($10.17 in chips) 
Seat 5: 3EBC96 ($13.79 in chips) 
Seat 6: sandra1189@ ($10.64 in chips) 
eRRe_ssbm: posts small blind $0.05
3EBC96: posts big blind $0.10
*** HOLE CARDS ***
sandra1189@: calls $0.10
maxthebest99: folds 
xulfster: raises $0.30 to $0.40
eRRe_ssbm: raises $0.90 to $1.30
3EBC96: folds 
sandra1189@: folds 
xulfster: folds 
Uncalled bet ($0.90) returned to eRRe_ssbm
eRRe_ssbm collected $1 from pot
eRRe_ssbm: doesn't show hand 
*** SUMMARY ***
Total pot $1 | Rake $0 
Seat 1: maxthebest99 folded before Flop (didn't bet)
Seat 3: xulfster (button) folded before Flop
Seat 4: eRRe_ssbm (small blind) collected ($1)
Seat 5: 3EBC96 (big blind) folded before Flop
Seat 6: sandra1189@ folded before Flop



PokerStars Hand #222954348169:  Hold'em No Limit ($0.05/$0.10 USD) - 2021/01/23 9:01:32 ET
Table 'Stephano III' 6-max Seat #4 is the button
Seat 1: maxthebest99 ($20.62 in chips) 
Seat 3: xulfster ($10 in chips) 
Seat 4: eRRe_ssbm ($10.77 in chips) 
Seat 5: 3EBC96 ($13.69 in chips) 
Seat 6: sandra1189@ ($10.54 in chips) 
3EBC96: posts small blind $0.05
sandra1189@: posts big blind $0.10
*** HOLE CARDS ***
maxthebest99: folds 
xulfster: folds 
eRRe_ssbm: folds 
3EBC96: folds 
Uncalled bet ($0.05) returned to sandra1189@
sandra1189@ collected $0.10 from pot
sandra1189@: doesn't show hand 
*** SUMMARY ***
Total pot $0.10 | Rake $0 
Seat 1: maxthebest99 folded before Flop (didn't bet)
Seat 3: xulfster folded before Flop (didn't bet)
Seat 4: eRRe_ssbm (button) folded before Flop (didn't bet)
Seat 5: 3EBC96 (small blind) folded before Flop
Seat 6: sandra1189@ (big blind) collected ($0.10)



PokerStars Hand #222954355138:  Hold'em No Limit ($0.05/$0.10 USD) - 2021/01/23 9:01:48 ET
Table 'Stephano III' 6-max Seat #5 is the button
Seat 1: maxthebest99 ($20.62 in chips) 
Seat 3: xulfster ($10 in chips) 
Seat 4: eRRe_ssbm ($10.77 in chips) 
Seat 5: 3EBC96 ($13.64 in chips) 
Seat 6: sandra1189@ ($10.59 in chips) 
sandra1189@: posts small blind $0.05
maxthebest99: posts big blind $0.10
stylepointxoxo: sits out 
*** HOLE CARDS ***
xulfster: folds 
eRRe_ssbm: folds 
3EBC96: folds 
sandra1189@: raises $0.20 to $0.30
maxthebest99: folds 
Uncalled bet ($0.20) returned to sandra1189@
sandra1189@ collected $0.20 from pot
sandra1189@: doesn't show hand 
*** SUMMARY ***
Total pot $0.20 | Rake $0 
Seat 1: maxthebest99 (big blind) folded before Flop
Seat 3: xulfster folded before Flop (didn't bet)
Seat 4: eRRe_ssbm folded before Flop (didn't bet)
Seat 5: 3EBC96 (button) folded before Flop (didn't bet)
Seat 6: sandra1189@ (small blind) collected ($0.20)



PokerStars Hand #222954365285:  Hold'em No Limit ($0.05/$0.10 USD) - 2021/01/23 9:02:09 ET
Table 'Stephano III' 6-max Seat #6 is the button
Seat 1: maxthebest99 ($20.52 in chips) 
Seat 2: stylepointxoxo ($11.43 in chips) 
Seat 3: xulfster ($10 in chips) 
Seat 4: eRRe_ssbm ($10.77 in chips) 
Seat 5: 3EBC96 ($13.64 in chips) 
Seat 6: sandra1189@ ($10.69 in chips) 
maxthebest99: posts small blind $0.05
stylepointxoxo: posts big blind $0.10
*** HOLE CARDS ***
xulfster: folds 
eRRe_ssbm: folds 
3EBC96: folds 
sandra1189@: calls $0.10
maxthebest99: calls $0.05
stylepointxoxo: checks 
*** FLOP *** [Qc Th Ah]
maxthebest99: checks 
stylepointxoxo: bets $0.21
sandra1189@: calls $0.21
maxthebest99: folds 
*** TURN *** [Qc Th Ah] [Ad]
stylepointxoxo: bets $0.51
sandra1189@: folds 
Uncalled bet ($0.51) returned to stylepointxoxo
stylepointxoxo collected $0.69 from pot
stylepointxoxo: doesn't show hand 
*** SUMMARY ***
Total pot $0.72 | Rake $0.03 
Board [Qc Th Ah Ad]
Seat 1: maxthebest99 (small blind) folded on the Flop
Seat 2: stylepointxoxo (big blind) collected ($0.69)
Seat 3: xulfster folded before Flop (didn't bet)
Seat 4: eRRe_ssbm folded before Flop (didn't bet)
Seat 5: 3EBC96 folded before Flop (didn't bet)
Seat 6: sandra1189@ (button) folded on the Turn



PokerStars Hand #222954388687:  Hold'em No Limit ($0.05/$0.10 USD) - 2021/01/23 9:02:58 ET
Table 'Stephano III' 6-max Seat #1 is the button
Seat 1: maxthebest99 ($20.42 in chips) 
Seat 2: stylepointxoxo ($11.81 in chips) 
Seat 3: xulfster ($10 in chips) 
Seat 4: eRRe_ssbm ($10.77 in chips) 
Seat 5: 3EBC96 ($13.64 in chips) 
Seat 6: sandra1189@ ($10.38 in chips) 
stylepointxoxo: posts small blind $0.05
xulfster: posts big blind $0.10
*** HOLE CARDS ***
eRRe_ssbm: folds 
3EBC96: raises $0.20 to $0.30
sandra1189@: calls $0.30
maxthebest99: folds 
stylepointxoxo: raises $1.20 to $1.50
xulfster: folds 
3EBC96: folds 
sandra1189@: folds 
Uncalled bet ($1.20) returned to stylepointxoxo
stylepointxoxo collected $1 from pot
stylepointxoxo: doesn't show hand 
*** SUMMARY ***
Total pot $1 | Rake $0 
Seat 1: maxthebest99 (button) folded before Flop (didn't bet)
Seat 2: stylepointxoxo (small blind) collected ($1)
Seat 3: xulfster (big blind) folded before Flop
Seat 4: eRRe_ssbm folded before Flop (didn't bet)
Seat 5: 3EBC96 folded before Flop
Seat 6: sandra1189@ folded before Flop



PokerStars Hand #222954407581:  Hold'em No Limit ($0.05/$0.10 USD) - 2021/01/23 9:03:36 ET
Table 'Stephano III' 6-max Seat #2 is the button
Seat 1: maxthebest99 ($20.42 in chips) 
Seat 2: stylepointxoxo ($12.51 in chips) 
Seat 3: xulfster ($10 in chips) 
Seat 4: eRRe_ssbm ($10.77 in chips) 
Seat 5: 3EBC96 ($13.34 in chips) 
Seat 6: sandra1189@ ($10.08 in chips) 
xulfster: posts small blind $0.05
eRRe_ssbm: posts big blind $0.10
*** HOLE CARDS ***
3EBC96: raises $0.20 to $0.30
sandra1189@: folds 
maxthebest99: folds 
stylepointxoxo: raises $0.60 to $0.90
xulfster: folds 
eRRe_ssbm: folds 
3EBC96: folds 
Uncalled bet ($0.60) returned to stylepointxoxo
stylepointxoxo collected $0.75 from pot
stylepointxoxo: doesn't show hand 
*** SUMMARY ***
Total pot $0.75 | Rake $0 
Seat 1: maxthebest99 folded before Flop (didn't bet)
Seat 2: stylepointxoxo (button) collected ($0.75)
Seat 3: xulfster (small blind) folded before Flop
Seat 4: eRRe_ssbm (big blind) folded before Flop
Seat 5: 3EBC96 folded before Flop
Seat 6: sandra1189@ folded before Flop (didn't bet)



PokerStars Hand #222954414547:  Hold'em No Limit ($0.05/$0.10 USD) - 2021/01/23 9:03:51 ET
Table 'Stephano III' 6-max Seat #3 is the button
Seat 1: maxthebest99 ($20.42 in chips) 
Seat 2: stylepointxoxo ($12.96 in chips) 
Seat 3: xulfster ($10 in chips) 
Seat 4: eRRe_ssbm ($10.67 in chips) 
Seat 5: 3EBC96 ($13.04 in chips) 
Seat 6: sandra1189@ ($10.08 in chips) 
eRRe_ssbm: posts small blind $0.05
3EBC96: posts big blind $0.10
*** HOLE CARDS ***
sandra1189@: calls $0.10
maxthebest99: folds 
stylepointxoxo: folds 
xulfster: folds 
eRRe_ssbm: folds 
3EBC96: checks 
*** FLOP *** [7s Ad 4s]
3EBC96: checks 
sandra1189@: bets $0.10
3EBC96: calls $0.10
*** TURN *** [7s Ad 4s] [2d]
3EBC96: checks 
sandra1189@: checks 
*** RIVER *** [7s Ad 4s 2d] [4d]
3EBC96: checks 
sandra1189@: bets $0.10
3EBC96: calls $0.10
*** SHOW DOWN ***
sandra1189@: shows [Qh 8d] (a pair of Fours)
3EBC96: shows [7d Kh] (two pair, Sevens and Fours)
3EBC96 collected $0.62 from pot
*** SUMMARY ***
Total pot $0.65 | Rake $0.03 
Board [7s Ad 4s 2d 4d]
Seat 1: maxthebest99 folded before Flop (didn't bet)
Seat 2: stylepointxoxo folded before Flop (didn't bet)
Seat 3: xulfster (button) folded before Flop (didn't bet)
Seat 4: eRRe_ssbm (small blind) folded before Flop
Seat 5: 3EBC96 (big blind) showed [7d Kh] and won ($0.62) with two pair, Sevens and Fours
Seat 6: sandra1189@ showed [Qh 8d] and lost with a pair of Fours



PokerStars Hand #222954434114:  Hold'em No Limit ($0.05/$0.10 USD) - 2021/01/23 9:04:31 ET
Table 'Stephano III' 6-max Seat #4 is the button
Seat 1: maxthebest99 ($20.42 in chips) 
Seat 2: stylepointxoxo ($12.96 in chips) 
Seat 3: xulfster ($10 in chips) 
Seat 4: eRRe_ssbm ($10.62 in chips) 
Seat 5: 3EBC96 ($13.36 in chips) 
Seat 6: sandra1189@ ($9.78 in chips) 
3EBC96: posts small blind $0.05
sandra1189@: posts big blind $0.10
*** HOLE CARDS ***
maxthebest99: calls $0.10
stylepointxoxo: folds 
xulfster: folds 
eRRe_ssbm: folds 
3EBC96: folds 
sandra1189@: raises $0.20 to $0.30
maxthebest99: calls $0.20
*** FLOP *** [Qs Tc Jh]
sandra1189@: checks 
maxthebest99: bets $0.30
sandra1189@: folds 
Uncalled bet ($0.30) returned to maxthebest99
maxthebest99 collected $0.62 from pot
maxthebest99: doesn't show hand 
*** SUMMARY ***
Total pot $0.65 | Rake $0.03 
Board [Qs Tc Jh]
Seat 1: maxthebest99 collected ($0.62)
Seat 2: stylepointxoxo folded before Flop (didn't bet)
Seat 3: xulfster folded before Flop (didn't bet)
Seat 4: eRRe_ssbm (button) folded before Flop (didn't bet)
Seat 5: 3EBC96 (small blind) folded before Flop
Seat 6: sandra1189@ (big blind) folded on the Flop



PokerStars Hand #222954454482:  Hold'em No Limit ($0.05/$0.10 USD) - 2021/01/23 9:05:13 ET
Table 'Stephano III' 6-max Seat #5 is the button
Seat 1: maxthebest99 ($20.74 in chips) 
Seat 2: stylepointxoxo ($12.96 in chips) 
Seat 3: xulfster ($10 in chips) 
Seat 4: eRRe_ssbm ($10.62 in chips) 
Seat 5: 3EBC96 ($13.31 in chips) 
Seat 6: sandra1189@ ($9.48 in chips) 
sandra1189@: posts small blind $0.05
maxthebest99: posts big blind $0.10
*** HOLE CARDS ***
stylepointxoxo: folds 
xulfster: folds 
eRRe_ssbm: folds 
3EBC96: raises $0.20 to $0.30
sandra1189@: calls $0.25
maxthebest99: raises $1 to $1.30
3EBC96: folds 
sandra1189@: folds 
Uncalled bet ($1) returned to maxthebest99
maxthebest99 collected $0.90 from pot
maxthebest99: doesn't show hand 
*** SUMMARY ***
Total pot $0.90 | Rake $0 
Seat 1: maxthebest99 (big blind) collected ($0.90)
Seat 2: stylepointxoxo folded before Flop (didn't bet)
Seat 3: xulfster folded before Flop (didn't bet)
Seat 4: eRRe_ssbm folded before Flop (didn't bet)
Seat 5: 3EBC96 (button) folded before Flop
Seat 6: sandra1189@ (small blind) folded before Flop



PokerStars Hand #222954471562:  Hold'em No Limit ($0.05/$0.10 USD) - 2021/01/23 9:05:48 ET
Table 'Stephano III' 6-max Seat #6 is the button
Seat 1: maxthebest99 ($21.34 in chips) 
Seat 2: stylepointxoxo ($12.96 in chips) 
Seat 3: xulfster ($10 in chips) 
Seat 4: eRRe_ssbm ($10.62 in chips) 
Seat 5: 3EBC96 ($13.01 in chips) 
Seat 6: sandra1189@ ($9.18 in chips) 
maxthebest99: posts small blind $0.05
stylepointxoxo: posts big blind $0.10
*** HOLE CARDS ***
xulfster: folds 
eRRe_ssbm: folds 
3EBC96: folds 
sandra1189@: raises $0.10 to $0.20
maxthebest99: folds 
stylepointxoxo: folds 
Uncalled bet ($0.10) returned to sandra1189@
sandra1189@ collected $0.25 from pot
sandra1189@: doesn't show hand 
*** SUMMARY ***
Total pot $0.25 | Rake $0 
Seat 1: maxthebest99 (small blind) folded before Flop
Seat 2: stylepointxoxo (big blind) folded before Flop
Seat 3: xulfster folded before Flop (didn't bet)
Seat 4: eRRe_ssbm folded before Flop (didn't bet)
Seat 5: 3EBC96 folded before Flop (didn't bet)
Seat 6: sandra1189@ (button) collected ($0.25)



PokerStars Hand #222954483263:  Hold'em No Limit ($0.05/$0.10 USD) - 2021/01/23 9:06:12 ET
Table 'Stephano III' 6-max Seat #1 is the button
Seat 1: maxthebest99 ($21.29 in chips) 
Seat 2: stylepointxoxo ($12.86 in chips) 
Seat 3: xulfster ($10 in chips) 
Seat 4: eRRe_ssbm ($10.62 in chips) 
Seat 5: 3EBC96 ($13.01 in chips) 
Seat 6: sandra1189@ ($9.33 in chips) 
stylepointxoxo: posts small blind $0.05
xulfster: posts big blind $0.10
*** HOLE CARDS ***
eRRe_ssbm: folds 
3EBC96: folds 
sandra1189@: calls $0.10
maxthebest99: folds 
stylepointxoxo: folds 
xulfster: checks 
*** FLOP *** [Qd 7h Qc]
xulfster: checks 
sandra1189@: checks 
*** TURN *** [Qd 7h Qc] [8c]
xulfster: checks 
sandra1189@: checks 
*** RIVER *** [Qd 7h Qc 8c] [Ad]
xulfster: checks 
sandra1189@: checks 
*** SHOW DOWN ***
xulfster: shows [Th Js] (a pair of Queens)
sandra1189@: shows [Jd Kh] (a pair of Queens - Ace+King kicker)
sandra1189@ collected $0.24 from pot
*** SUMMARY ***
Total pot $0.25 | Rake $0.01 
Board [Qd 7h Qc 8c Ad]
Seat 1: maxthebest99 (button) folded before Flop (didn't bet)
Seat 2: stylepointxoxo (small blind) folded before Flop
Seat 3: xulfster (big blind) showed [Th Js] and lost with a pair of Queens
Seat 4: eRRe_ssbm folded before Flop (didn't bet)
Seat 5: 3EBC96 folded before Flop (didn't bet)
Seat 6: sandra1189@ showed [Jd Kh] and won ($0.24) with a pair of Queens



PokerStars Hand #222954507593:  Hold'em No Limit ($0.05/$0.10 USD) - 2021/01/23 9:07:01 ET
Table 'Stephano III' 6-max Seat #2 is the button
Seat 1: maxthebest99 ($21.29 in chips) 
Seat 2: stylepointxoxo ($12.81 in chips) 
Seat 3: xulfster ($10 in chips) 
Seat 4: eRRe_ssbm ($10.62 in chips) 
Seat 5: 3EBC96 ($13.01 in chips) 
Seat 6: sandra1189@ ($9.47 in chips) 
xulfster: posts small blind $0.05
eRRe_ssbm: posts big blind $0.10
*** HOLE CARDS ***
3EBC96: folds 
sandra1189@: raises $0.10 to $0.20
maxthebest99: folds 
stylepointxoxo: calls $0.20
xulfster: calls $0.15
eRRe_ssbm: folds 
*** FLOP *** [Ac 6s 2d]
xulfster: checks 
sandra1189@: bets $0.33
stylepointxoxo: folds 
xulfster: folds 
Uncalled bet ($0.33) returned to sandra1189@
sandra1189@ collected $0.67 from pot
sandra1189@: doesn't show hand 
*** SUMMARY ***
Total pot $0.70 | Rake $0.03 
Board [Ac 6s 2d]
Seat 1: maxthebest99 folded before Flop (didn't bet)
Seat 2: stylepointxoxo (button) folded on the Flop
Seat 3: xulfster (small blind) folded on the Flop
Seat 4: eRRe_ssbm (big blind) folded before Flop
Seat 5: 3EBC96 folded before Flop (didn't bet)
Seat 6: sandra1189@ collected ($0.67)



PokerStars Hand #222954525665:  Hold'em No Limit ($0.05/$0.10 USD) - 2021/01/23 9:07:38 ET
Table 'Stephano III' 6-max Seat #3 is the button
Seat 1: maxthebest99 ($21.29 in chips) 
Seat 2: stylepointxoxo ($12.61 in chips) 
Seat 3: xulfster ($10 in chips) 
Seat 4: eRRe_ssbm ($10.52 in chips) 
Seat 5: 3EBC96 ($13.01 in chips) 
Seat 6: sandra1189@ ($9.94 in chips) 
eRRe_ssbm: posts small blind $0.05
3EBC96: posts big blind $0.10
*** HOLE CARDS ***
sandra1189@: folds 
maxthebest99: folds 
stylepointxoxo: folds 
xulfster: folds 
eRRe_ssbm: folds 
Uncalled bet ($0.05) returned to 3EBC96
3EBC96 collected $0.10 from pot
3EBC96: doesn't show hand 
*** SUMMARY ***
Total pot $0.10 | Rake $0 
Seat 1: maxthebest99 folded before Flop (didn't bet)
Seat 2: stylepointxoxo folded before Flop (didn't bet)
Seat 3: xulfster (button) folded before Flop (didn't bet)
Seat 4: eRRe_ssbm (small blind) folded before Flop
Seat 5: 3EBC96 (big blind) collected ($0.10)
Seat 6: sandra1189@ folded before Flop (didn't bet)



PokerStars Hand #222954538749:  Hold'em No Limit ($0.05/$0.10 USD) - 2021/01/23 9:08:04 ET
Table 'Stephano III' 6-max Seat #4 is the button
Seat 1: maxthebest99 ($21.29 in chips) 
Seat 2: stylepointxoxo ($12.61 in chips) 
Seat 3: xulfster ($10 in chips) 
Seat 4: eRRe_ssbm ($10.47 in chips) 
Seat 5: 3EBC96 ($13.06 in chips) 
Seat 6: sandra1189@ ($9.94 in chips) 
3EBC96: posts small blind $0.05
sandra1189@: posts big blind $0.10
*** HOLE CARDS ***
maxthebest99: folds 
stylepointxoxo: folds 
xulfster: raises $0.15 to $0.25
eRRe_ssbm: folds 
3EBC96: folds 
sandra1189@: folds 
Uncalled bet ($0.15) returned to xulfster
xulfster collected $0.25 from pot
*** SUMMARY ***
Total pot $0.25 | Rake $0 
Seat 1: maxthebest99 folded before Flop (didn't bet)
Seat 2: stylepointxoxo folded before Flop (didn't bet)
Seat 3: xulfster collected ($0.25)
Seat 4: eRRe_ssbm (button) folded before Flop (didn't bet)
Seat 5: 3EBC96 (small blind) folded before Flop
Seat 6: sandra1189@ (big blind) folded before Flop



PokerStars Hand #222954556523:  Hold'em No Limit ($0.05/$0.10 USD) - 2021/01/23 9:08:40 ET
Table 'Stephano III' 6-max Seat #5 is the button
Seat 1: maxthebest99 ($21.29 in chips) 
Seat 2: stylepointxoxo ($12.61 in chips) 
Seat 3: xulfster ($10.15 in chips) 
Seat 4: eRRe_ssbm ($10.47 in chips) 
Seat 5: 3EBC96 ($13.01 in chips) 
Seat 6: sandra1189@ ($9.84 in chips) 
sandra1189@: posts small blind $0.05
maxthebest99: posts big blind $0.10
*** HOLE CARDS ***
stylepointxoxo has timed out
stylepointxoxo: folds 
xulfster: folds 
eRRe_ssbm: folds 
3EBC96: folds 
sandra1189@: calls $0.05
maxthebest99: raises $0.10 to $0.20
sandra1189@: calls $0.10
*** FLOP *** [6s 5s 7c]
sandra1189@: checks 
maxthebest99: bets $0.20
sandra1189@: calls $0.20
*** TURN *** [6s 5s 7c] [Ad]
sandra1189@: checks 
maxthebest99: bets $0.30
sandra1189@: calls $0.30
*** RIVER *** [6s 5s 7c Ad] [Js]
sandra1189@: checks 
maxthebest99: bets $0.30
sandra1189@: calls $0.30
*** SHOW DOWN ***
maxthebest99: shows [8h Jh] (a pair of Jacks)
sandra1189@: mucks hand 
maxthebest99 collected $1.91 from pot
*** SUMMARY ***
Total pot $2 | Rake $0.09 
Board [6s 5s 7c Ad Js]
Seat 1: maxthebest99 (big blind) showed [8h Jh] and won ($1.91) with a pair of Jacks
Seat 2: stylepointxoxo folded before Flop (didn't bet)
Seat 3: xulfster folded before Flop (didn't bet)
Seat 4: eRRe_ssbm folded before Flop (didn't bet)
Seat 5: 3EBC96 (button) folded before Flop (didn't bet)
Seat 6: sandra1189@ (small blind) mucked



PokerStars Hand #222954576930:  Hold'em No Limit ($0.05/$0.10 USD) - 2021/01/23 9:09:22 ET
Table 'Stephano III' 6-max Seat #6 is the button
Seat 1: maxthebest99 ($22.20 in chips) 
Seat 2: stylepointxoxo ($12.61 in chips) 
Seat 3: xulfster ($10.15 in chips) 
Seat 4: eRRe_ssbm ($10.47 in chips) 
Seat 5: 3EBC96 ($13.01 in chips) 
Seat 6: sandra1189@ ($8.84 in chips) 
maxthebest99: posts small blind $0.05
stylepointxoxo: posts big blind $0.10
*** HOLE CARDS ***
xulfster: folds 
eRRe_ssbm: folds 
3EBC96: folds 
sandra1189@: calls $0.10
maxthebest99: calls $0.05
stylepointxoxo: checks 
*** FLOP *** [4h Kc Td]
maxthebest99: checks 
stylepointxoxo: checks 
sandra1189@: checks 
*** TURN *** [4h Kc Td] [9h]
maxthebest99: bets $0.10
stylepointxoxo: folds 
sandra1189@: folds 
Uncalled bet ($0.10) returned to maxthebest99
maxthebest99 collected $0.29 from pot
maxthebest99: doesn't show hand 
*** SUMMARY ***
Total pot $0.30 | Rake $0.01 
Board [4h Kc Td 9h]
Seat 1: maxthebest99 (small blind) collected ($0.29)
Seat 2: stylepointxoxo (big blind) folded on the Turn
Seat 3: xulfster folded before Flop (didn't bet)
Seat 4: eRRe_ssbm folded before Flop (didn't bet)
Seat 5: 3EBC96 folded before Flop (didn't bet)
Seat 6: sandra1189@ (button) folded on the Turn



PokerStars Hand #222954598310:  Hold'em No Limit ($0.05/$0.10 USD) - 2021/01/23 9:10:05 ET
Table 'Stephano III' 6-max Seat #1 is the button
Seat 1: maxthebest99 ($22.39 in chips) 
Seat 2: stylepointxoxo ($12.51 in chips) 
Seat 3: xulfster ($10.15 in chips) 
Seat 4: eRRe_ssbm ($10.47 in chips) 
Seat 5: 3EBC96 ($13.01 in chips) 
Seat 6: sandra1189@ ($8.74 in chips) 
stylepointxoxo: posts small blind $0.05
xulfster: posts big blind $0.10
*** HOLE CARDS ***
eRRe_ssbm: folds 
3EBC96: folds 
sandra1189@: raises $0.25 to $0.35
maxthebest99: calls $0.35
stylepointxoxo: folds 
xulfster: folds 
*** FLOP *** [Ad 8s 2s]
sandra1189@: bets $0.40
maxthebest99: folds 
Uncalled bet ($0.40) returned to sandra1189@
sandra1189@ collected $0.81 from pot
sandra1189@: doesn't show hand 
*** SUMMARY ***
Total pot $0.85 | Rake $0.04 
Board [Ad 8s 2s]
Seat 1: maxthebest99 (button) folded on the Flop
Seat 2: stylepointxoxo (small blind) folded before Flop
Seat 3: xulfster (big blind) folded before Flop
Seat 4: eRRe_ssbm folded before Flop (didn't bet)
Seat 5: 3EBC96 folded before Flop (didn't bet)
Seat 6: sandra1189@ collected ($0.81)



PokerStars Hand #222954611579:  Hold'em No Limit ($0.05/$0.10 USD) - 2021/01/23 9:10:32 ET
Table 'Stephano III' 6-max Seat #2 is the button
Seat 1: maxthebest99 ($22.04 in chips) 
Seat 2: stylepointxoxo ($12.46 in chips) 
Seat 3: xulfster ($10.05 in chips) 
Seat 4: eRRe_ssbm ($10.47 in chips) 
Seat 5: 3EBC96 ($13.01 in chips) 
Seat 6: sandra1189@ ($9.20 in chips) 
xulfster: posts small blind $0.05
eRRe_ssbm: posts big blind $0.10
*** HOLE CARDS ***
3EBC96 has timed out
3EBC96: folds 
sandra1189@: folds 
maxthebest99: folds 
stylepointxoxo has timed out
stylepointxoxo: folds 
xulfster: folds 
Uncalled bet ($0.05) returned to eRRe_ssbm
eRRe_ssbm collected $0.10 from pot
eRRe_ssbm: doesn't show hand 
*** SUMMARY ***
Total pot $0.10 | Rake $0 
Seat 1: maxthebest99 folded before Flop (didn't bet)
Seat 2: stylepointxoxo (button) folded before Flop (didn't bet)
Seat 3: xulfster (small blind) folded before Flop
Seat 4: eRRe_ssbm (big blind) collected ($0.10)
Seat 5: 3EBC96 folded before Flop (didn't bet)
Seat 6: sandra1189@ folded before Flop (didn't bet)



PokerStars Hand #222954624833:  Hold'em No Limit ($0.05/$0.10 USD) - 2021/01/23 9:10:59 ET
Table 'Stephano III' 6-max Seat #3 is the button
Seat 1: maxthebest99 ($22.04 in chips) 
Seat 3: xulfster ($10 in chips) 
Seat 4: eRRe_ssbm ($10.52 in chips) 
Seat 5: 3EBC96 ($13.01 in chips) 
Seat 6: sandra1189@ ($9.20 in chips) 
eRRe_ssbm: posts small blind $0.05
3EBC96: posts big blind $0.10
*** HOLE CARDS ***
sandra1189@: calls $0.10
maxthebest99: folds 
xulfster: folds 
eRRe_ssbm: folds 
3EBC96: checks 
*** FLOP *** [2c 9s Ah]
3EBC96: checks 
sandra1189@: checks 
*** TURN *** [2c 9s Ah] [Qh]
3EBC96: checks 
sandra1189@: checks 
*** RIVER *** [2c 9s Ah Qh] [Kh]
3EBC96: checks 
sandra1189@: bets $0.24
3EBC96: folds 
Uncalled bet ($0.24) returned to sandra1189@
sandra1189@ collected $0.24 from pot
sandra1189@: doesn't show hand 
*** SUMMARY ***
Total pot $0.25 | Rake $0.01 
Board [2c 9s Ah Qh Kh]
Seat 1: maxthebest99 folded before Flop (didn't bet)
Seat 3: xulfster (button) folded before Flop (didn't bet)
Seat 4: eRRe_ssbm (small blind) folded before Flop
Seat 5: 3EBC96 (big blind) folded on the River
Seat 6: sandra1189@ collected ($0.24)



PokerStars Hand #222954643814:  Hold'em No Limit ($0.05/$0.10 USD) - 2021/01/23 9:11:37 ET
Table 'Stephano III' 6-max Seat #4 is the button
Seat 1: maxthebest99 ($22.04 in chips) 
Seat 2: stylepointxoxo ($12.46 in chips) 
Seat 3: xulfster ($10 in chips) 
Seat 4: eRRe_ssbm ($10.47 in chips) 
Seat 5: 3EBC96 ($12.91 in chips) 
Seat 6: sandra1189@ ($9.34 in chips) 
3EBC96: posts small blind $0.05
sandra1189@: posts big blind $0.10
*** HOLE CARDS ***
maxthebest99: folds 
stylepointxoxo: folds 
xulfster: raises $0.15 to $0.25
eRRe_ssbm: folds 
3EBC96: folds 
sandra1189@: folds 
Uncalled bet ($0.15) returned to xulfster
xulfster collected $0.25 from pot
*** SUMMARY ***
Total pot $0.25 | Rake $0 
Seat 1: maxthebest99 folded before Flop (didn't bet)
Seat 2: stylepointxoxo folded before Flop (didn't bet)
Seat 3: xulfster collected ($0.25)
Seat 4: eRRe_ssbm (button) folded before Flop (didn't bet)
Seat 5: 3EBC96 (small blind) folded before Flop
Seat 6: sandra1189@ (big blind) folded before Flop



PokerStars Hand #222954651411:  Hold'em No Limit ($0.05/$0.10 USD) - 2021/01/23 9:11:52 ET
Table 'Stephano III' 6-max Seat #5 is the button
Seat 1: maxthebest99 ($22.04 in chips) 
Seat 2: stylepointxoxo ($12.46 in chips) 
Seat 3: xulfster ($10.15 in chips) 
Seat 4: eRRe_ssbm ($10.47 in chips) 
Seat 5: 3EBC96 ($12.86 in chips) 
Seat 6: sandra1189@ ($9.24 in chips) 
sandra1189@: posts small blind $0.05
maxthebest99: posts big blind $0.10
*** HOLE CARDS ***
stylepointxoxo: folds 
xulfster: folds 
eRRe_ssbm: folds 
3EBC96: folds 
sandra1189@: calls $0.05
maxthebest99: checks 
*** FLOP *** [Td 3d 2s]
sandra1189@: bets $0.10
maxthebest99: folds 
Uncalled bet ($0.10) returned to sandra1189@
sandra1189@ collected $0.19 from pot
sandra1189@: doesn't show hand 
*** SUMMARY ***
Total pot $0.20 | Rake $0.01 
Board [Td 3d 2s]
Seat 1: maxthebest99 (big blind) folded on the Flop
Seat 2: stylepointxoxo folded before Flop (didn't bet)
Seat 3: xulfster folded before Flop (didn't bet)
Seat 4: eRRe_ssbm folded before Flop (didn't bet)
Seat 5: 3EBC96 (button) folded before Flop (didn't bet)
Seat 6: sandra1189@ (small blind) collected ($0.19)



PokerStars Hand #222954664794:  Hold'em No Limit ($0.05/$0.10 USD) - 2021/01/23 9:12:19 ET
Table 'Stephano III' 6-max Seat #6 is the button
Seat 1: maxthebest99 ($21.94 in chips) 
Seat 2: stylepointxoxo ($12.46 in chips) 
Seat 3: xulfster ($10.15 in chips) 
Seat 4: eRRe_ssbm ($10.47 in chips) 
Seat 5: 3EBC96 ($12.86 in chips) 
Seat 6: sandra1189@ ($9.33 in chips) 
maxthebest99: posts small blind $0.05
stylepointxoxo: posts big blind $0.10
*** HOLE CARDS ***
xulfster: folds 
eRRe_ssbm: folds 
3EBC96: folds 
sandra1189@: raises $0.25 to $0.35
maxthebest99: calls $0.30
stylepointxoxo: raises $1.25 to $1.60
sandra1189@: calls $1.25
maxthebest99: folds 
*** FLOP *** [5d 8s 7d]
stylepointxoxo: bets $1.40
sandra1189@: raises $6.19 to $7.59
stylepointxoxo: folds 
Uncalled bet ($6.19) returned to sandra1189@
sandra1189@ collected $6.06 from pot
sandra1189@: doesn't show hand 
*** SUMMARY ***
Total pot $6.35 | Rake $0.29 
Board [5d 8s 7d]
Seat 1: maxthebest99 (small blind) folded before Flop
Seat 2: stylepointxoxo (big blind) folded on the Flop
Seat 3: xulfster folded before Flop (didn't bet)
Seat 4: eRRe_ssbm folded before Flop (didn't bet)
Seat 5: 3EBC96 folded before Flop (didn't bet)
Seat 6: sandra1189@ (button) collected ($6.06)



PokerStars Hand #222954698144:  Hold'em No Limit ($0.05/$0.10 USD) - 2021/01/23 9:13:26 ET
Table 'Stephano III' 6-max Seat #1 is the button
Seat 1: maxthebest99 ($21.59 in chips) 
Seat 2: stylepointxoxo ($10 in chips) 
Seat 3: xulfster ($10.15 in chips) 
Seat 4: eRRe_ssbm ($10.47 in chips) 
Seat 5: 3EBC96 ($12.86 in chips) 
Seat 6: sandra1189@ ($12.39 in chips) 
stylepointxoxo: posts small blind $0.05
xulfster: posts big blind $0.10
*** HOLE CARDS ***
eRRe_ssbm: folds 
3EBC96: raises $0.20 to $0.30
sandra1189@: calls $0.30
maxthebest99: folds 
stylepointxoxo: folds 
xulfster: folds 
*** FLOP *** [6h 2d 6s]
3EBC96: checks 
sandra1189@: bets $0.72
3EBC96: folds 
Uncalled bet ($0.72) returned to sandra1189@
sandra1189@ collected $0.72 from pot
sandra1189@: doesn't show hand 
*** SUMMARY ***
Total pot $0.75 | Rake $0.03 
Board [6h 2d 6s]
Seat 1: maxthebest99 (button) folded before Flop (didn't bet)
Seat 2: stylepointxoxo (small blind) folded before Flop
Seat 3: xulfster (big blind) folded before Flop
Seat 4: eRRe_ssbm folded before Flop (didn't bet)
Seat 5: 3EBC96 folded on the Flop
Seat 6: sandra1189@ collected ($0.72)



PokerStars Hand #222954709074:  Hold'em No Limit ($0.05/$0.10 USD) - 2021/01/23 9:13:47 ET
Table 'Stephano III' 6-max Seat #2 is the button
Seat 1: maxthebest99 ($21.59 in chips) 
Seat 2: stylepointxoxo ($10 in chips) 
Seat 3: xulfster ($10.05 in chips) 
Seat 4: eRRe_ssbm ($10.47 in chips) 
Seat 5: 3EBC96 ($12.56 in chips) 
Seat 6: sandra1189@ ($12.81 in chips) 
xulfster: posts small blind $0.05
eRRe_ssbm: posts big blind $0.10
*** HOLE CARDS ***
3EBC96: folds 
sandra1189@: folds 
maxthebest99: folds 
stylepointxoxo: folds 
xulfster: raises $0.20 to $0.30
eRRe_ssbm: calls $0.20
*** FLOP *** [6c Jh Kh]
xulfster: checks 
eRRe_ssbm: bets $0.43
xulfster: calls $0.43
*** TURN *** [6c Jh Kh] [Qd]
xulfster: checks 
eRRe_ssbm: bets $0.95
xulfster: folds 
Uncalled bet ($0.95) returned to eRRe_ssbm
eRRe_ssbm collected $1.39 from pot
eRRe_ssbm: doesn't show hand 
*** SUMMARY ***
Total pot $1.46 | Rake $0.07 
Board [6c Jh Kh Qd]
Seat 1: maxthebest99 folded before Flop (didn't bet)
Seat 2: stylepointxoxo (button) folded before Flop (didn't bet)
Seat 3: xulfster (small blind) folded on the Turn
Seat 4: eRRe_ssbm (big blind) collected ($1.39)
Seat 5: 3EBC96 folded before Flop (didn't bet)
Seat 6: sandra1189@ folded before Flop (didn't bet)



PokerStars Hand #222954742115:  Hold'em No Limit ($0.05/$0.10 USD) - 2021/01/23 9:14:54 ET
Table 'Stephano III' 6-max Seat #3 is the button
Seat 1: maxthebest99 ($21.59 in chips) 
Seat 2: stylepointxoxo ($10 in chips) 
Seat 3: xulfster ($10 in chips) 
Seat 4: eRRe_ssbm ($11.13 in chips) 
Seat 5: 3EBC96 ($12.56 in chips) 
Seat 6: sandra1189@ ($12.81 in chips) 
eRRe_ssbm: posts small blind $0.05
3EBC96: posts big blind $0.10
*** HOLE CARDS ***
sandra1189@: calls $0.10
maxthebest99: raises $0.20 to $0.30
stylepointxoxo: folds 
xulfster: folds 
eRRe_ssbm: folds 
3EBC96: calls $0.20
sandra1189@: calls $0.20
*** FLOP *** [8c 4h 9d]
3EBC96: checks 
sandra1189@: checks 
maxthebest99: bets $0.30
3EBC96: calls $0.30
sandra1189@: folds 
*** TURN *** [8c 4h 9d] [Ts]
3EBC96: checks 
maxthebest99: bets $0.70
3EBC96: calls $0.70
*** RIVER *** [8c 4h 9d Ts] [Kh]
3EBC96: checks 
maxthebest99: bets $1.50
3EBC96: folds 
Uncalled bet ($1.50) returned to maxthebest99
maxthebest99 collected $2.82 from pot
maxthebest99: doesn't show hand 
*** SUMMARY ***
Total pot $2.95 | Rake $0.13 
Board [8c 4h 9d Ts Kh]
Seat 1: maxthebest99 collected ($2.82)
Seat 2: stylepointxoxo folded before Flop (didn't bet)
Seat 3: xulfster (button) folded before Flop (didn't bet)
Seat 4: eRRe_ssbm (small blind) folded before Flop
Seat 5: 3EBC96 (big blind) folded on the River
Seat 6: sandra1189@ folded on the Flop



PokerStars Hand #222954771033:  Hold'em No Limit ($0.05/$0.10 USD) - 2021/01/23 9:15:52 ET
Table 'Stephano III' 6-max Seat #4 is the button
Seat 1: maxthebest99 ($23.11 in chips) 
Seat 2: stylepointxoxo ($10 in chips) 
Seat 3: xulfster ($10 in chips) 
Seat 4: eRRe_ssbm ($11.08 in chips) 
Seat 5: 3EBC96 ($11.26 in chips) 
Seat 6: sandra1189@ ($12.51 in chips) 
3EBC96: posts small blind $0.05
sandra1189@: posts big blind $0.10
*** HOLE CARDS ***
maxthebest99: calls $0.10
stylepointxoxo: folds 
xulfster: folds 
eRRe_ssbm: folds 
3EBC96: folds 
sandra1189@: checks 
*** FLOP *** [Ac Qh 3s]
sandra1189@: checks 
maxthebest99: bets $0.10
sandra1189@: folds 
Uncalled bet ($0.10) returned to maxthebest99
maxthebest99 collected $0.24 from pot
maxthebest99: doesn't show hand 
*** SUMMARY ***
Total pot $0.25 | Rake $0.01 
Board [Ac Qh 3s]
Seat 1: maxthebest99 collected ($0.24)
Seat 2: stylepointxoxo folded before Flop (didn't bet)
Seat 3: xulfster folded before Flop (didn't bet)
Seat 4: eRRe_ssbm (button) folded before Flop (didn't bet)
Seat 5: 3EBC96 (small blind) folded before Flop
Seat 6: sandra1189@ (big blind) folded on the Flop



PokerStars Hand #222954781478:  Hold'em No Limit ($0.05/$0.10 USD) - 2021/01/23 9:16:13 ET
Table 'Stephano III' 6-max Seat #5 is the button
Seat 1: maxthebest99 ($23.25 in chips) 
Seat 2: stylepointxoxo ($10 in chips) 
Seat 3: xulfster ($10 in chips) 
Seat 4: eRRe_ssbm ($11.08 in chips) 
Seat 5: 3EBC96 ($11.21 in chips) 
Seat 6: sandra1189@ ($12.41 in chips) 
sandra1189@: posts small blind $0.05
maxthebest99: posts big blind $0.10
*** HOLE CARDS ***
stylepointxoxo: folds 
xulfster: folds 
eRRe_ssbm: folds 
3EBC96: folds 
sandra1189@: calls $0.05
maxthebest99: checks 
*** FLOP *** [9d Tc 4s]
sandra1189@: checks 
maxthebest99: bets $0.10
sandra1189@: folds 
Uncalled bet ($0.10) returned to maxthebest99
maxthebest99 collected $0.19 from pot
maxthebest99: doesn't show hand 
*** SUMMARY ***
Total pot $0.20 | Rake $0.01 
Board [9d Tc 4s]
Seat 1: maxthebest99 (big blind) collected ($0.19)
Seat 2: stylepointxoxo folded before Flop (didn't bet)
Seat 3: xulfster folded before Flop (didn't bet)
Seat 4: eRRe_ssbm folded before Flop (didn't bet)
Seat 5: 3EBC96 (button) folded before Flop (didn't bet)
Seat 6: sandra1189@ (small blind) folded on the Flop



PokerStars Hand #222954797915:  Hold'em No Limit ($0.05/$0.10 USD) - 2021/01/23 9:16:46 ET
Table 'Stephano III' 6-max Seat #6 is the button
Seat 1: maxthebest99 ($23.34 in chips) 
Seat 2: stylepointxoxo ($10 in chips) 
Seat 3: xulfster ($10 in chips) 
Seat 4: eRRe_ssbm ($11.08 in chips) 
Seat 5: 3EBC96 ($11.21 in chips) 
Seat 6: sandra1189@ ($12.31 in chips) 
maxthebest99: posts small blind $0.05
stylepointxoxo: posts big blind $0.10
*** HOLE CARDS ***
xulfster: raises $0.15 to $0.25
eRRe_ssbm: folds 
3EBC96: folds 
sandra1189@: folds 
maxthebest99: folds 
stylepointxoxo: folds 
Uncalled bet ($0.15) returned to xulfster
maxthebest99 leaves the table
xulfster collected $0.25 from pot
*** SUMMARY ***
Total pot $0.25 | Rake $0 
Seat 1: maxthebest99 (small blind) folded before Flop
Seat 2: stylepointxoxo (big blind) folded before Flop
Seat 3: xulfster collected ($0.25)
Seat 4: eRRe_ssbm folded before Flop (didn't bet)
Seat 5: 3EBC96 folded before Flop (didn't bet)
Seat 6: sandra1189@ (button) folded before Flop (didn't bet)



PokerStars Hand #222954813036:  Hold'em No Limit ($0.05/$0.10 USD) - 2021/01/23 9:17:16 ET
Table 'Stephano III' 6-max Seat #2 is the button
Seat 2: stylepointxoxo ($10 in chips) 
Seat 3: xulfster ($10.15 in chips) 
Seat 4: eRRe_ssbm ($11.08 in chips) 
Seat 6: sandra1189@ ($12.31 in chips) 
xulfster: posts small blind $0.05
eRRe_ssbm: posts big blind $0.10
*** HOLE CARDS ***
Rdalonso joins the table at seat #1 
sandra1189@: folds 
stylepointxoxo: raises $0.15 to $0.25
sandra1189@ leaves the table
ivan2772ms joins the table at seat #6 
xulfster: folds 
eRRe_ssbm: calls $0.15
*** FLOP *** [Th 2c 6c]
eRRe_ssbm: checks 
stylepointxoxo: bets $0.22
eRRe_ssbm: raises $0.73 to $0.95
stylepointxoxo: calls $0.73
*** TURN *** [Th 2c 6c] [As]
eRRe_ssbm: checks 
stylepointxoxo: checks 
*** RIVER *** [Th 2c 6c As] [5c]
eRRe_ssbm: bets $1.40
stylepointxoxo: folds 
Uncalled bet ($1.40) returned to eRRe_ssbm
eRRe_ssbm collected $2.34 from pot
eRRe_ssbm: doesn't show hand 
*** SUMMARY ***
Total pot $2.45 | Rake $0.11 
Board [Th 2c 6c As 5c]
Seat 2: stylepointxoxo (button) folded on the River
Seat 3: xulfster (small blind) folded before Flop
Seat 4: eRRe_ssbm (big blind) collected ($2.34)
Seat 6: sandra1189@ folded before Flop (didn't bet)



PokerStars Hand #222954852803:  Hold'em No Limit ($0.05/$0.10 USD) - 2021/01/23 9:18:36 ET
Table 'Stephano III' 6-max Seat #3 is the button
Seat 2: stylepointxoxo ($10 in chips) 
Seat 3: xulfster ($10.10 in chips) 
Seat 4: eRRe_ssbm ($12.22 in chips) 
Seat 6: ivan2772ms ($10 in chips) 
eRRe_ssbm: posts small blind $0.05
ivan2772ms: posts big blind $0.10
Rdalonso: sits out 
*** HOLE CARDS ***
stylepointxoxo: raises $0.15 to $0.25
xulfster: raises $0.55 to $0.80
eRRe_ssbm: folds 
ivan2772ms: folds 
stylepointxoxo: calls $0.55
*** FLOP *** [2s 9c 3s]
stylepointxoxo: checks 
xulfster: bets $0.84
Rdalonso leaves the table
stylepointxoxo: calls $0.84
*** TURN *** [2s 9c 3s] [Td]
stylepointxoxo: checks 
xulfster: checks 
*** RIVER *** [2s 9c 3s Td] [3d]
stylepointxoxo: checks 
xulfster: checks 
*** SHOW DOWN ***
stylepointxoxo: shows [Qd As] (a pair of Threes)
xulfster: shows [9d Ad] (two pair, Nines and Threes)
xulfster collected $3.28 from pot
*** SUMMARY ***
Total pot $3.43 | Rake $0.15 
Board [2s 9c 3s Td 3d]
Seat 2: stylepointxoxo showed [Qd As] and lost with a pair of Threes
Seat 3: xulfster (button) showed [9d Ad] and won ($3.28) with two pair, Nines and Threes
Seat 4: eRRe_ssbm (small blind) folded before Flop
Seat 6: ivan2772ms (big blind) folded before Flop



PokerStars Hand #222954879276:  Hold'em No Limit ($0.05/$0.10 USD) - 2021/01/23 9:19:29 ET
Table 'Stephano III' 6-max Seat #4 is the button
Seat 2: stylepointxoxo ($10 in chips) 
Seat 3: xulfster ($11.74 in chips) 
Seat 4: eRRe_ssbm ($12.17 in chips) 
Seat 6: ivan2772ms ($9.90 in chips) 
ivan2772ms: posts small blind $0.05
stylepointxoxo: posts big blind $0.10
*** HOLE CARDS ***
xulfster: folds 
eRRe_ssbm: raises $0.20 to $0.30
ivan2772ms: folds 
stylepointxoxo: folds 
Uncalled bet ($0.20) returned to eRRe_ssbm
nicucta joins the table at seat #1 
eRRe_ssbm collected $0.25 from pot
eRRe_ssbm: doesn't show hand 
*** SUMMARY ***
Total pot $0.25 | Rake $0 
Seat 2: stylepointxoxo (big blind) folded before Flop
Seat 3: xulfster folded before Flop (didn't bet)
Seat 4: eRRe_ssbm (button) collected ($0.25)
Seat 6: ivan2772ms (small blind) folded before Flop



PokerStars Hand #222954886248:  Hold'em No Limit ($0.05/$0.10 USD) - 2021/01/23 9:19:43 ET
Table 'Stephano III' 6-max Seat #6 is the button
Seat 2: stylepointxoxo ($10 in chips) 
Seat 3: xulfster ($11.74 in chips) 
Seat 4: eRRe_ssbm ($12.32 in chips) 
Seat 6: ivan2772ms ($9.85 in chips) 
stylepointxoxo: posts small blind $0.05
xulfster: posts big blind $0.10
*** HOLE CARDS ***
eRRe_ssbm: folds 
ivan2772ms: folds 
stylepointxoxo: folds 
Uncalled bet ($0.05) returned to xulfster
xulfster collected $0.10 from pot
*** SUMMARY ***
Total pot $0.10 | Rake $0 
Seat 2: stylepointxoxo (small blind) folded before Flop
Seat 3: xulfster (big blind) collected ($0.10)
Seat 4: eRRe_ssbm folded before Flop (didn't bet)
Seat 6: ivan2772ms (button) folded before Flop (didn't bet)



PokerStars Hand #222954892621:  Hold'em No Limit ($0.05/$0.10 USD) - 2021/01/23 9:19:56 ET
Table 'Stephano III' 6-max Seat #2 is the button
Seat 2: stylepointxoxo ($10 in chips) 
Seat 3: xulfster ($11.79 in chips) 
Seat 4: eRRe_ssbm ($12.32 in chips) 
Seat 6: ivan2772ms ($9.85 in chips) 
xulfster: posts small blind $0.05
eRRe_ssbm: posts big blind $0.10
nicucta: sits out 
*** HOLE CARDS ***
ivan2772ms: folds 
stylepointxoxo: raises $0.15 to $0.25
xulfster: folds 
eRRe_ssbm: folds 
Uncalled bet ($0.15) returned to stylepointxoxo
stylepointxoxo collected $0.25 from pot
stylepointxoxo: doesn't show hand 
*** SUMMARY ***
Total pot $0.25 | Rake $0 
Seat 2: stylepointxoxo (button) collected ($0.25)
Seat 3: xulfster (small blind) folded before Flop
Seat 4: eRRe_ssbm (big blind) folded before Flop
Seat 6: ivan2772ms folded before Flop (didn't bet)



PokerStars Hand #222954901046:  Hold'em No Limit ($0.05/$0.10 USD) - 2021/01/23 9:20:12 ET
Table 'Stephano III' 6-max Seat #3 is the button
Seat 2: stylepointxoxo ($10.15 in chips) 
Seat 3: xulfster ($11.74 in chips) 
Seat 4: eRRe_ssbm ($12.22 in chips) 
Seat 6: ivan2772ms ($9.85 in chips) 
eRRe_ssbm: posts small blind $0.05
ivan2772ms: posts big blind $0.10
nicucta: sits out 
*** HOLE CARDS ***
stylepointxoxo: raises $0.15 to $0.25
xulfster: folds 
eRRe_ssbm: folds 
ivan2772ms: calls $0.15
*** FLOP *** [6d Td 3s]
ivan2772ms: checks 
stylepointxoxo: bets $0.22
ivan2772ms: calls $0.22
*** TURN *** [6d Td 3s] [8d]
ivan2772ms: checks 
stylepointxoxo: bets $0.70
ivan2772ms: calls $0.70
*** RIVER *** [6d Td 3s 8d] [7c]
ivan2772ms: checks 
stylepointxoxo: checks 
*** SHOW DOWN ***
ivan2772ms: shows [Th As] (a pair of Tens)
stylepointxoxo: mucks hand 
ivan2772ms collected $2.28 from pot
*** SUMMARY ***
Total pot $2.39 | Rake $0.11 
Board [6d Td 3s 8d 7c]
Seat 2: stylepointxoxo mucked
Seat 3: xulfster (button) folded before Flop (didn't bet)
Seat 4: eRRe_ssbm (small blind) folded before Flop
Seat 6: ivan2772ms (big blind) showed [Th As] and won ($2.28) with a pair of Tens



PokerStars Hand #222954918657:  Hold'em No Limit ($0.05/$0.10 USD) - 2021/01/23 9:20:48 ET
Table 'Stephano III' 6-max Seat #4 is the button
Seat 1: nicucta ($10 in chips) 
Seat 2: stylepointxoxo ($10 in chips) 
Seat 3: xulfster ($11.74 in chips) 
Seat 4: eRRe_ssbm ($12.17 in chips) 
Seat 6: ivan2772ms ($10.96 in chips) 
ivan2772ms: posts small blind $0.05
nicucta: posts big blind $0.10
*** HOLE CARDS ***
stylepointxoxo: folds 
xulfster: raises $0.15 to $0.25
eRRe_ssbm: folds 
ivan2772ms: folds 
nicucta: folds 
Uncalled bet ($0.15) returned to xulfster
xulfster collected $0.25 from pot
*** SUMMARY ***
Total pot $0.25 | Rake $0 
Seat 1: nicucta (big blind) folded before Flop
Seat 2: stylepointxoxo folded before Flop (didn't bet)
Seat 3: xulfster collected ($0.25)
Seat 4: eRRe_ssbm (button) folded before Flop (didn't bet)
Seat 6: ivan2772ms (small blind) folded before Flop



PokerStars Hand #222954927907:  Hold'em No Limit ($0.05/$0.10 USD) - 2021/01/23 9:21:06 ET
Table 'Stephano III' 6-max Seat #6 is the button
Seat 1: nicucta ($9.90 in chips) 
Seat 2: stylepointxoxo ($10 in chips) 
Seat 3: xulfster ($11.89 in chips) 
Seat 4: eRRe_ssbm ($12.17 in chips) 
Seat 6: ivan2772ms ($10.91 in chips) 
nicucta: posts small blind $0.05
stylepointxoxo: posts big blind $0.10
*** HOLE CARDS ***
xulfster: folds 
eRRe_ssbm: folds 
ivan2772ms: raises $0.15 to $0.25
nicucta: folds 
stylepointxoxo: calls $0.15
*** FLOP *** [Ts 5c 6d]
stylepointxoxo: checks 
ivan2772ms: checks 
*** TURN *** [Ts 5c 6d] [3h]
stylepointxoxo: checks 
ivan2772ms: checks 
*** RIVER *** [Ts 5c 6d 3h] [9s]
stylepointxoxo: checks 
ivan2772ms: checks 
*** SHOW DOWN ***
stylepointxoxo: shows [Ac Js] (high card Ace)
ivan2772ms: mucks hand 
stylepointxoxo collected $0.53 from pot
*** SUMMARY ***
Total pot $0.55 | Rake $0.02 
Board [Ts 5c 6d 3h 9s]
Seat 1: nicucta (small blind) folded before Flop
Seat 2: stylepointxoxo (big blind) showed [Ac Js] and won ($0.53) with high card Ace
Seat 3: xulfster folded before Flop (didn't bet)
Seat 4: eRRe_ssbm folded before Flop (didn't bet)
Seat 6: ivan2772ms (button) mucked



PokerStars Hand #222954951258:  Hold'em No Limit ($0.05/$0.10 USD) - 2021/01/23 9:21:52 ET
Table 'Stephano III' 6-max Seat #1 is the button
Seat 1: nicucta ($9.85 in chips) 
Seat 2: stylepointxoxo ($10.28 in chips) 
Seat 4: eRRe_ssbm ($12.17 in chips) 
Seat 5: 3EBC96 ($11.21 in chips) 
Seat 6: ivan2772ms ($10.66 in chips) 
stylepointxoxo: posts small blind $0.05
xulfster: is sitting out 
eRRe_ssbm: posts big blind $0.10
3EBC96: posts small & big blinds $0.15
*** HOLE CARDS ***
xulfster leaves the table
3EBC96: checks 
ivan2772ms: folds 
Greentvdinne joins the table at seat #3 
nicucta: raises $0.40 to $0.50
stylepointxoxo: folds 
eRRe_ssbm: folds 
3EBC96: folds 
Uncalled bet ($0.40) returned to nicucta
nicucta collected $0.40 from pot
nicucta: doesn't show hand 
*** SUMMARY ***
Total pot $0.40 | Rake $0 
Seat 1: nicucta (button) collected ($0.40)
Seat 2: stylepointxoxo (small blind) folded before Flop
Seat 4: eRRe_ssbm (big blind) folded before Flop
Seat 5: 3EBC96 folded before Flop (didn't bet)
Seat 6: ivan2772ms folded before Flop (didn't bet)



PokerStars Hand #222954979827:  Hold'em No Limit ($0.05/$0.10 USD) - 2021/01/23 9:22:49 ET
Table 'Stephano III' 6-max Seat #2 is the button
Seat 1: nicucta ($10.15 in chips) 
Seat 2: stylepointxoxo ($10.23 in chips) 
Seat 4: eRRe_ssbm ($12.07 in chips) 
Seat 5: 3EBC96 ($11.06 in chips) 
Seat 6: ivan2772ms ($10.66 in chips) 
eRRe_ssbm: posts small blind $0.05
3EBC96: posts big blind $0.10
*** HOLE CARDS ***
ivan2772ms: folds 
nicucta: raises $0.10 to $0.20
stylepointxoxo: folds 
eRRe_ssbm: folds 
3EBC96: folds 
Uncalled bet ($0.10) returned to nicucta
nicucta collected $0.25 from pot
nicucta: doesn't show hand 
*** SUMMARY ***
Total pot $0.25 | Rake $0 
Seat 1: nicucta collected ($0.25)
Seat 2: stylepointxoxo (button) folded before Flop (didn't bet)
Seat 4: eRRe_ssbm (small blind) folded before Flop
Seat 5: 3EBC96 (big blind) folded before Flop
Seat 6: ivan2772ms folded before Flop (didn't bet)



PokerStars Hand #222954989484:  Hold'em No Limit ($0.05/$0.10 USD) - 2021/01/23 9:23:08 ET
Table 'Stephano III' 6-max Seat #4 is the button
Seat 1: nicucta ($10.30 in chips) 
Seat 2: stylepointxoxo ($10.23 in chips) 
Seat 4: eRRe_ssbm ($12.02 in chips) 
Seat 5: 3EBC96 ($10.96 in chips) 
Seat 6: ivan2772ms ($10.66 in chips) 
3EBC96: posts small blind $0.05
ivan2772ms: posts big blind $0.10
Greentvdinne: sits out 
*** HOLE CARDS ***
nicucta: calls $0.10
stylepointxoxo: folds 
eRRe_ssbm: folds 
3EBC96: folds 
ivan2772ms: checks 
*** FLOP *** [5s Qs Ad]
ivan2772ms: checks 
nicucta: checks 
*** TURN *** [5s Qs Ad] [Kd]
ivan2772ms: checks 
nicucta: bets $0.12
ivan2772ms: folds 
Uncalled bet ($0.12) returned to nicucta
nicucta collected $0.24 from pot
nicucta: doesn't show hand 
*** SUMMARY ***
Total pot $0.25 | Rake $0.01 
Board [5s Qs Ad Kd]
Seat 1: nicucta collected ($0.24)
Seat 2: stylepointxoxo folded before Flop (didn't bet)
Seat 4: eRRe_ssbm (button) folded before Flop (didn't bet)
Seat 5: 3EBC96 (small blind) folded before Flop
Seat 6: ivan2772ms (big blind) folded on the Turn



PokerStars Hand #222955004316:  Hold'em No Limit ($0.05/$0.10 USD) - 2021/01/23 9:23:38 ET
Table 'Stephano III' 6-max Seat #5 is the button
Seat 1: nicucta ($10.44 in chips) 
Seat 2: stylepointxoxo ($10.23 in chips) 
Seat 4: eRRe_ssbm ($12.02 in chips) 
Seat 5: 3EBC96 ($10.91 in chips) 
Seat 6: ivan2772ms ($10.56 in chips) 
ivan2772ms: posts small blind $0.05
nicucta: posts big blind $0.10
Greentvdinne: sits out 
*** HOLE CARDS ***
stylepointxoxo: folds 
eRRe_ssbm: raises $0.20 to $0.30
3EBC96: folds 
ivan2772ms: folds 
nicucta: folds 
Uncalled bet ($0.20) returned to eRRe_ssbm
eRRe_ssbm collected $0.25 from pot
eRRe_ssbm: doesn't show hand 
*** SUMMARY ***
Total pot $0.25 | Rake $0 
Seat 1: nicucta (big blind) folded before Flop
Seat 2: stylepointxoxo folded before Flop (didn't bet)
Seat 4: eRRe_ssbm collected ($0.25)
Seat 5: 3EBC96 (button) folded before Flop (didn't bet)
Seat 6: ivan2772ms (small blind) folded before Flop



PokerStars Hand #222955014489:  Hold'em No Limit ($0.05/$0.10 USD) - 2021/01/23 9:23:58 ET
Table 'Stephano III' 6-max Seat #6 is the button
Seat 1: nicucta ($10.34 in chips) 
Seat 2: stylepointxoxo ($10.23 in chips) 
Seat 4: eRRe_ssbm ($12.17 in chips) 
Seat 5: 3EBC96 ($10.91 in chips) 
Seat 6: ivan2772ms ($10.51 in chips) 
nicucta: posts small blind $0.05
stylepointxoxo: posts big blind $0.10
Greentvdinne: sits out 
*** HOLE CARDS ***
eRRe_ssbm: folds 
3EBC96: folds 
ivan2772ms: folds 
nicucta: folds 
Uncalled bet ($0.05) returned to stylepointxoxo
stylepointxoxo collected $0.10 from pot
stylepointxoxo: doesn't show hand 
*** SUMMARY ***
Total pot $0.10 | Rake $0 
Seat 1: nicucta (small blind) folded before Flop
Seat 2: stylepointxoxo (big blind) collected ($0.10)
Seat 4: eRRe_ssbm folded before Flop (didn't bet)
Seat 5: 3EBC96 folded before Flop (didn't bet)
Seat 6: ivan2772ms (button) folded before Flop (didn't bet)



PokerStars Hand #222955020975:  Hold'em No Limit ($0.05/$0.10 USD) - 2021/01/23 9:24:12 ET
Table 'Stephano III' 6-max Seat #1 is the button
Seat 1: nicucta ($10.29 in chips) 
Seat 2: stylepointxoxo ($10.28 in chips) 
Seat 3: Greentvdinne ($10 in chips) 
Seat 4: eRRe_ssbm ($12.17 in chips) 
Seat 5: 3EBC96 ($10.91 in chips) 
Seat 6: ivan2772ms ($10.51 in chips) 
stylepointxoxo: posts small blind $0.05
Greentvdinne: posts big blind $0.10
*** HOLE CARDS ***
eRRe_ssbm: folds 
3EBC96: folds 
ivan2772ms: folds 
nicucta: folds 
stylepointxoxo: folds 
Uncalled bet ($0.05) returned to Greentvdinne
Greentvdinne collected $0.10 from pot
Greentvdinne: doesn't show hand 
*** SUMMARY ***
Total pot $0.10 | Rake $0 
Seat 1: nicucta (button) folded before Flop (didn't bet)
Seat 2: stylepointxoxo (small blind) folded before Flop
Seat 3: Greentvdinne (big blind) collected ($0.10)
Seat 4: eRRe_ssbm folded before Flop (didn't bet)
Seat 5: 3EBC96 folded before Flop (didn't bet)
Seat 6: ivan2772ms folded before Flop (didn't bet)



PokerStars Hand #222955026834:  Hold'em No Limit ($0.05/$0.10 USD) - 2021/01/23 9:24:23 ET
Table 'Stephano III' 6-max Seat #2 is the button
Seat 1: nicucta ($10.29 in chips) 
Seat 2: stylepointxoxo ($10.23 in chips) 
Seat 3: Greentvdinne ($10.05 in chips) 
Seat 4: eRRe_ssbm ($12.17 in chips) 
Seat 5: 3EBC96 ($10.91 in chips) 
Seat 6: ivan2772ms ($10.51 in chips) 
Greentvdinne: posts small blind $0.05
eRRe_ssbm: posts big blind $0.10
*** HOLE CARDS ***
3EBC96: folds 
ivan2772ms: folds 
nicucta: folds 
stylepointxoxo: folds 
Greentvdinne: folds 
Uncalled bet ($0.05) returned to eRRe_ssbm
eRRe_ssbm collected $0.10 from pot
eRRe_ssbm: doesn't show hand 
*** SUMMARY ***
Total pot $0.10 | Rake $0 
Seat 1: nicucta folded before Flop (didn't bet)
Seat 2: stylepointxoxo (button) folded before Flop (didn't bet)
Seat 3: Greentvdinne (small blind) folded before Flop
Seat 4: eRRe_ssbm (big blind) collected ($0.10)
Seat 5: 3EBC96 folded before Flop (didn't bet)
Seat 6: ivan2772ms folded before Flop (didn't bet)



PokerStars Hand #222955033710:  Hold'em No Limit ($0.05/$0.10 USD) - 2021/01/23 9:24:37 ET
Table 'Stephano III' 6-max Seat #3 is the button
Seat 1: nicucta ($10.29 in chips) 
Seat 2: stylepointxoxo ($10.23 in chips) 
Seat 3: Greentvdinne ($10 in chips) 
Seat 4: eRRe_ssbm ($12.22 in chips) 
Seat 5: 3EBC96 ($10.91 in chips) 
Seat 6: ivan2772ms ($10.51 in chips) 
eRRe_ssbm: posts small blind $0.05
3EBC96: posts big blind $0.10
*** HOLE CARDS ***
ivan2772ms: folds 
nicucta: folds 
stylepointxoxo: raises $0.15 to $0.25
Greentvdinne: folds 
eRRe_ssbm: folds 
3EBC96: folds 
Uncalled bet ($0.15) returned to stylepointxoxo
stylepointxoxo collected $0.25 from pot
stylepointxoxo: doesn't show hand 
*** SUMMARY ***
Total pot $0.25 | Rake $0 
Seat 1: nicucta folded before Flop (didn't bet)
Seat 2: stylepointxoxo collected ($0.25)
Seat 3: Greentvdinne (button) folded before Flop (didn't bet)
Seat 4: eRRe_ssbm (small blind) folded before Flop
Seat 5: 3EBC96 (big blind) folded before Flop
Seat 6: ivan2772ms folded before Flop (didn't bet)



PokerStars Hand #222955041559:  Hold'em No Limit ($0.05/$0.10 USD) - 2021/01/23 9:24:53 ET
Table 'Stephano III' 6-max Seat #4 is the button
Seat 1: nicucta ($10.29 in chips) 
Seat 2: stylepointxoxo ($10.38 in chips) 
Seat 3: Greentvdinne ($10 in chips) 
Seat 4: eRRe_ssbm ($12.17 in chips) 
Seat 5: 3EBC96 ($10.81 in chips) 
Seat 6: ivan2772ms ($10.51 in chips) 
3EBC96: posts small blind $0.05
ivan2772ms: posts big blind $0.10
*** HOLE CARDS ***
nicucta: raises $0.10 to $0.20
stylepointxoxo: raises $0.50 to $0.70
Greentvdinne: folds 
eRRe_ssbm: folds 
3EBC96: folds 
ivan2772ms: folds 
nicucta: calls $0.50
*** FLOP *** [5s 3s 7s]
nicucta: checks 
stylepointxoxo: checks 
*** TURN *** [5s 3s 7s] [4c]
nicucta: bets $0.70
stylepointxoxo: calls $0.70
*** RIVER *** [5s 3s 7s 4c] [Qc]
nicucta: checks 
stylepointxoxo: bets $2.09
nicucta: folds 
Uncalled bet ($2.09) returned to stylepointxoxo
stylepointxoxo collected $2.82 from pot
stylepointxoxo: doesn't show hand 
*** SUMMARY ***
Total pot $2.95 | Rake $0.13 
Board [5s 3s 7s 4c Qc]
Seat 1: nicucta folded on the River
Seat 2: stylepointxoxo collected ($2.82)
Seat 3: Greentvdinne folded before Flop (didn't bet)
Seat 4: eRRe_ssbm (button) folded before Flop (didn't bet)
Seat 5: 3EBC96 (small blind) folded before Flop
Seat 6: ivan2772ms (big blind) folded before Flop



PokerStars Hand #222955058776:  Hold'em No Limit ($0.05/$0.10 USD) - 2021/01/23 9:25:28 ET
Table 'Stephano III' 6-max Seat #5 is the button
Seat 1: nicucta ($10 in chips) 
Seat 2: stylepointxoxo ($11.80 in chips) 
Seat 3: Greentvdinne ($10 in chips) 
Seat 4: eRRe_ssbm ($12.17 in chips) 
Seat 5: 3EBC96 ($10.76 in chips) 
Seat 6: ivan2772ms ($10.41 in chips) 
ivan2772ms: posts small blind $0.05
nicucta: posts big blind $0.10
*** HOLE CARDS ***
stylepointxoxo: raises $0.15 to $0.25
Greentvdinne: folds 
eRRe_ssbm: folds 
3EBC96: folds 
ivan2772ms: folds 
nicucta: calls $0.15
*** FLOP *** [Ts Ad As]
nicucta: checks 
stylepointxoxo: checks 
*** TURN *** [Ts Ad As] [6d]
nicucta: bets $0.27
stylepointxoxo: raises $0.43 to $0.70
nicucta: calls $0.43
*** RIVER *** [Ts Ad As 6d] [8c]
nicucta: checks 
stylepointxoxo: checks 
*** SHOW DOWN ***
nicucta: shows [Ah 5s] (three of a kind, Aces)
stylepointxoxo: mucks hand 
nicucta collected $1.86 from pot
*** SUMMARY ***
Total pot $1.95 | Rake $0.09 
Board [Ts Ad As 6d 8c]
Seat 1: nicucta (big blind) showed [Ah 5s] and won ($1.86) with three of a kind, Aces
Seat 2: stylepointxoxo mucked
Seat 3: Greentvdinne folded before Flop (didn't bet)
Seat 4: eRRe_ssbm folded before Flop (didn't bet)
Seat 5: 3EBC96 (button) folded before Flop (didn't bet)
Seat 6: ivan2772ms (small blind) folded before Flop



PokerStars Hand #222955074454:  Hold'em No Limit ($0.05/$0.10 USD) - 2021/01/23 9:26:00 ET
Table 'Stephano III' 6-max Seat #6 is the button
Seat 1: nicucta ($10.91 in chips) 
Seat 2: stylepointxoxo ($10.85 in chips) 
Seat 3: Greentvdinne ($10 in chips) 
Seat 4: eRRe_ssbm ($12.17 in chips) 
Seat 5: 3EBC96 ($10.76 in chips) 
Seat 6: ivan2772ms ($10.36 in chips) 
nicucta: posts small blind $0.05
stylepointxoxo: posts big blind $0.10
*** HOLE CARDS ***
Greentvdinne: calls $0.10
eRRe_ssbm: folds 
3EBC96: folds 
ivan2772ms: raises $0.35 to $0.45
nicucta: calls $0.40
stylepointxoxo: folds 
Greentvdinne: calls $0.35
*** FLOP *** [4d Kh 6h]
nicucta: checks 
Greentvdinne: checks 
ivan2772ms: bets $0.35
nicucta: raises $0.35 to $0.70
Greentvdinne: folds 
ivan2772ms: folds 
Uncalled bet ($0.35) returned to nicucta
nicucta collected $2.05 from pot
nicucta: doesn't show hand 
*** SUMMARY ***
Total pot $2.15 | Rake $0.10 
Board [4d Kh 6h]
Seat 1: nicucta (small blind) collected ($2.05)
Seat 2: stylepointxoxo (big blind) folded before Flop
Seat 3: Greentvdinne folded on the Flop
Seat 4: eRRe_ssbm folded before Flop (didn't bet)
Seat 5: 3EBC96 folded before Flop (didn't bet)
Seat 6: ivan2772ms (button) folded on the Flop



PokerStars Hand #222955092386:  Hold'em No Limit ($0.05/$0.10 USD) - 2021/01/23 9:26:36 ET
Table 'Stephano III' 6-max Seat #1 is the button
Seat 1: nicucta ($12.16 in chips) 
Seat 2: stylepointxoxo ($10.75 in chips) 
Seat 3: Greentvdinne ($9.55 in chips) 
Seat 4: eRRe_ssbm ($12.17 in chips) 
Seat 5: 3EBC96 ($10.76 in chips) 
Seat 6: ivan2772ms ($10 in chips) 
stylepointxoxo: posts small blind $0.05
Greentvdinne: posts big blind $0.10
*** HOLE CARDS ***
eRRe_ssbm: raises $0.20 to $0.30
3EBC96: folds 
ivan2772ms: folds 
nicucta: folds 
stylepointxoxo: folds 
Greentvdinne: folds 
Uncalled bet ($0.20) returned to eRRe_ssbm
eRRe_ssbm collected $0.25 from pot
eRRe_ssbm: doesn't show hand 
*** SUMMARY ***
Total pot $0.25 | Rake $0 
Seat 1: nicucta (button) folded before Flop (didn't bet)
Seat 2: stylepointxoxo (small blind) folded before Flop
Seat 3: Greentvdinne (big blind) folded before Flop
Seat 4: eRRe_ssbm collected ($0.25)
Seat 5: 3EBC96 folded before Flop (didn't bet)
Seat 6: ivan2772ms folded before Flop (didn't bet)



PokerStars Hand #222955102402:  Hold'em No Limit ($0.05/$0.10 USD) - 2021/01/23 9:26:57 ET
Table 'Stephano III' 6-max Seat #2 is the button
Seat 1: nicucta ($12.16 in chips) 
Seat 2: stylepointxoxo ($10.70 in chips) 
Seat 3: Greentvdinne ($9.45 in chips) 
Seat 4: eRRe_ssbm ($12.32 in chips) 
Seat 5: 3EBC96 ($10.76 in chips) 
Seat 6: ivan2772ms ($10 in chips) 
Greentvdinne: posts small blind $0.05
eRRe_ssbm: posts big blind $0.10
*** HOLE CARDS ***
3EBC96: folds 
ivan2772ms: raises $0.20 to $0.30
nicucta: folds 
stylepointxoxo: folds 
Greentvdinne: folds 
eRRe_ssbm: folds 
Uncalled bet ($0.20) returned to ivan2772ms
ivan2772ms collected $0.25 from pot
ivan2772ms: doesn't show hand 
*** SUMMARY ***
Total pot $0.25 | Rake $0 
Seat 1: nicucta folded before Flop (didn't bet)
Seat 2: stylepointxoxo (button) folded before Flop (didn't bet)
Seat 3: Greentvdinne (small blind) folded before Flop
Seat 4: eRRe_ssbm (big blind) folded before Flop
Seat 5: 3EBC96 folded before Flop (didn't bet)
Seat 6: ivan2772ms collected ($0.25)



PokerStars Hand #222955114378:  Hold'em No Limit ($0.05/$0.10 USD) - 2021/01/23 9:27:21 ET
Table 'Stephano III' 6-max Seat #3 is the button
Seat 1: nicucta ($12.16 in chips) 
Seat 2: stylepointxoxo ($10.70 in chips) 
Seat 3: Greentvdinne ($9.40 in chips) 
Seat 4: eRRe_ssbm ($12.22 in chips) 
Seat 5: 3EBC96 ($10.76 in chips) 
Seat 6: ivan2772ms ($10.15 in chips) 
eRRe_ssbm: posts small blind $0.05
3EBC96: posts big blind $0.10
*** HOLE CARDS ***
ivan2772ms: folds 
nicucta: folds 
stylepointxoxo: folds 
Greentvdinne: folds 
eRRe_ssbm: raises $0.20 to $0.30
3EBC96: folds 
Uncalled bet ($0.20) returned to eRRe_ssbm
eRRe_ssbm collected $0.20 from pot
eRRe_ssbm: doesn't show hand 
*** SUMMARY ***
Total pot $0.20 | Rake $0 
Seat 1: nicucta folded before Flop (didn't bet)
Seat 2: stylepointxoxo folded before Flop (didn't bet)
Seat 3: Greentvdinne (button) folded before Flop (didn't bet)
Seat 4: eRRe_ssbm (small blind) collected ($0.20)
Seat 5: 3EBC96 (big blind) folded before Flop
Seat 6: ivan2772ms folded before Flop (didn't bet)



PokerStars Hand #222955121083:  Hold'em No Limit ($0.05/$0.10 USD) - 2021/01/23 9:27:35 ET
Table 'Stephano III' 6-max Seat #4 is the button
Seat 1: nicucta ($12.16 in chips) 
Seat 2: stylepointxoxo ($10.70 in chips) 
Seat 3: Greentvdinne ($9.40 in chips) 
Seat 4: eRRe_ssbm ($12.32 in chips) 
Seat 5: 3EBC96 ($10.66 in chips) 
Seat 6: ivan2772ms ($10.15 in chips) 
3EBC96: posts small blind $0.05
ivan2772ms: posts big blind $0.10
*** HOLE CARDS ***
nicucta: calls $0.10
stylepointxoxo: folds 
Greentvdinne: folds 
eRRe_ssbm: folds 
3EBC96: folds 
ivan2772ms: checks 
*** FLOP *** [5c Qd 6h]
ivan2772ms: checks 
nicucta: bets $0.10
ivan2772ms: folds 
Uncalled bet ($0.10) returned to nicucta
nicucta collected $0.24 from pot
nicucta: doesn't show hand 
*** SUMMARY ***
Total pot $0.25 | Rake $0.01 
Board [5c Qd 6h]
Seat 1: nicucta collected ($0.24)
Seat 2: stylepointxoxo folded before Flop (didn't bet)
Seat 3: Greentvdinne folded before Flop (didn't bet)
Seat 4: eRRe_ssbm (button) folded before Flop (didn't bet)
Seat 5: 3EBC96 (small blind) folded before Flop
Seat 6: ivan2772ms (big blind) folded on the Flop



PokerStars Hand #222955140823:  Hold'em No Limit ($0.05/$0.10 USD) - 2021/01/23 9:28:01 ET
Table 'Stephano III' 6-max Seat #5 is the button
Seat 1: nicucta ($12.30 in chips) 
Seat 2: stylepointxoxo ($10.70 in chips) 
Seat 3: Greentvdinne ($9.40 in chips) 
Seat 4: eRRe_ssbm ($12.32 in chips) 
Seat 5: 3EBC96 ($10.61 in chips) 
Seat 6: ivan2772ms ($10.05 in chips) 
ivan2772ms: posts small blind $0.05
nicucta: posts big blind $0.10
*** HOLE CARDS ***
stylepointxoxo: raises $0.15 to $0.25
Greentvdinne: folds 
eRRe_ssbm: folds 
3EBC96: calls $0.25
ivan2772ms: folds 
nicucta: folds 
*** FLOP *** [Td 7d 5h]
stylepointxoxo: checks 
3EBC96: bets $0.20
stylepointxoxo: calls $0.20
*** TURN *** [Td 7d 5h] [Ad]
stylepointxoxo: checks 
3EBC96: checks 
*** RIVER *** [Td 7d 5h Ad] [Qc]
stylepointxoxo: bets $0.74
3EBC96: folds 
Uncalled bet ($0.74) returned to stylepointxoxo
stylepointxoxo collected $1 from pot
stylepointxoxo: doesn't show hand 
*** SUMMARY ***
Total pot $1.05 | Rake $0.05 
Board [Td 7d 5h Ad Qc]
Seat 1: nicucta (big blind) folded before Flop
Seat 2: stylepointxoxo collected ($1)
Seat 3: Greentvdinne folded before Flop (didn't bet)
Seat 4: eRRe_ssbm folded before Flop (didn't bet)
Seat 5: 3EBC96 (button) folded on the River
Seat 6: ivan2772ms (small blind) folded before Flop



PokerStars Hand #222955156988:  Hold'em No Limit ($0.05/$0.10 USD) - 2021/01/23 9:28:34 ET
Table 'Stephano III' 6-max Seat #6 is the button
Seat 1: nicucta ($12.20 in chips) 
Seat 2: stylepointxoxo ($11.25 in chips) 
Seat 3: Greentvdinne ($9.40 in chips) 
Seat 4: eRRe_ssbm ($12.32 in chips) 
Seat 5: 3EBC96 ($10.16 in chips) 
Seat 6: ivan2772ms ($10 in chips) 
nicucta: posts small blind $0.05
stylepointxoxo: posts big blind $0.10
*** HOLE CARDS ***
Greentvdinne: folds 
eRRe_ssbm: folds 
3EBC96: raises $0.20 to $0.30
ivan2772ms: folds 
nicucta: folds 
stylepointxoxo: calls $0.20
*** FLOP *** [Kc 8c 7c]
stylepointxoxo: checks 
3EBC96: checks 
*** TURN *** [Kc 8c 7c] [4c]
stylepointxoxo: checks 
3EBC96: checks 
*** RIVER *** [Kc 8c 7c 4c] [Qd]
stylepointxoxo: checks 
3EBC96: checks 
*** SHOW DOWN ***
stylepointxoxo: shows [5c 5d] (a flush, King high)
3EBC96: mucks hand 
stylepointxoxo collected $0.62 from pot
*** SUMMARY ***
Total pot $0.65 | Rake $0.03 
Board [Kc 8c 7c 4c Qd]
Seat 1: nicucta (small blind) folded before Flop
Seat 2: stylepointxoxo (big blind) showed [5c 5d] and won ($0.62) with a flush, King high
Seat 3: Greentvdinne folded before Flop (didn't bet)
Seat 4: eRRe_ssbm folded before Flop (didn't bet)
Seat 5: 3EBC96 mucked
Seat 6: ivan2772ms (button) folded before Flop (didn't bet)



PokerStars Hand #222955172003:  Hold'em No Limit ($0.05/$0.10 USD) - 2021/01/23 9:29:04 ET
Table 'Stephano III' 6-max Seat #1 is the button
Seat 1: nicucta ($12.15 in chips) 
Seat 2: stylepointxoxo ($11.57 in chips) 
Seat 3: Greentvdinne ($9.40 in chips) 
Seat 4: eRRe_ssbm ($12.32 in chips) 
Seat 5: 3EBC96 ($10 in chips) 
Seat 6: ivan2772ms ($10 in chips) 
stylepointxoxo: posts small blind $0.05
Greentvdinne: posts big blind $0.10
*** HOLE CARDS ***
eRRe_ssbm: raises $0.20 to $0.30
3EBC96: folds 
ivan2772ms: folds 
nicucta: folds 
stylepointxoxo: folds 
Greentvdinne: folds 
Uncalled bet ($0.20) returned to eRRe_ssbm
eRRe_ssbm collected $0.25 from pot
eRRe_ssbm: doesn't show hand 
*** SUMMARY ***
Total pot $0.25 | Rake $0 
Seat 1: nicucta (button) folded before Flop (didn't bet)
Seat 2: stylepointxoxo (small blind) folded before Flop
Seat 3: Greentvdinne (big blind) folded before Flop
Seat 4: eRRe_ssbm collected ($0.25)
Seat 5: 3EBC96 folded before Flop (didn't bet)
Seat 6: ivan2772ms folded before Flop (didn't bet)



PokerStars Hand #222955177019:  Hold'em No Limit ($0.05/$0.10 USD) - 2021/01/23 9:29:14 ET
Table 'Stephano III' 6-max Seat #2 is the button
Seat 1: nicucta ($12.15 in chips) 
Seat 2: stylepointxoxo ($11.52 in chips) 
Seat 3: Greentvdinne ($9.30 in chips) 
Seat 4: eRRe_ssbm ($12.47 in chips) 
Seat 5: 3EBC96 ($10 in chips) 
Seat 6: ivan2772ms ($10 in chips) 
Greentvdinne: posts small blind $0.05
eRRe_ssbm: posts big blind $0.10
*** HOLE CARDS ***
3EBC96: folds 
ivan2772ms: folds 
nicucta: raises $0.10 to $0.20
stylepointxoxo: calls $0.20
Greentvdinne: calls $0.15
eRRe_ssbm: folds 
*** FLOP *** [5d 4d 7c]
Greentvdinne: bets $0.40
nicucta: folds 
stylepointxoxo: raises $0.80 to $1.20
Greentvdinne: raises $1.30 to $2.50
stylepointxoxo: raises $8.82 to $11.32 and is all-in
Greentvdinne: calls $6.60 and is all-in
Uncalled bet ($2.22) returned to stylepointxoxo
*** TURN *** [5d 4d 7c] [Kc]
*** RIVER *** [5d 4d 7c Kc] [8c]
*** SHOW DOWN ***
Greentvdinne: shows [6d 9d] (a straight, Five to Nine)
stylepointxoxo: shows [5c 5h] (three of a kind, Fives)
Greentvdinne collected $18.05 from pot
*** SUMMARY ***
Total pot $18.90 | Rake $0.85 
Board [5d 4d 7c Kc 8c]
Seat 1: nicucta folded on the Flop
Seat 2: stylepointxoxo (button) showed [5c 5h] and lost with three of a kind, Fives
Seat 3: Greentvdinne (small blind) showed [6d 9d] and won ($18.05) with a straight, Five to Nine
Seat 4: eRRe_ssbm (big blind) folded before Flop
Seat 5: 3EBC96 folded before Flop (didn't bet)
Seat 6: ivan2772ms folded before Flop (didn't bet)



PokerStars Hand #222955210703:  Hold'em No Limit ($0.05/$0.10 USD) - 2021/01/23 9:30:21 ET
Table 'Stephano III' 6-max Seat #3 is the button
Seat 1: nicucta ($11.95 in chips) 
Seat 2: stylepointxoxo ($10 in chips) 
Seat 3: Greentvdinne ($18.05 in chips) 
Seat 4: eRRe_ssbm ($12.37 in chips) 
Seat 5: 3EBC96 ($10 in chips) 
Seat 6: ivan2772ms ($10 in chips) 
eRRe_ssbm: posts small blind $0.05
3EBC96: posts big blind $0.10
*** HOLE CARDS ***
ivan2772ms: folds 
nicucta: folds 
stylepointxoxo: raises $0.15 to $0.25
Greentvdinne: calls $0.25
eRRe_ssbm: folds 
3EBC96: folds 
*** FLOP *** [Kh 5h Ah]
stylepointxoxo: bets $0.30
Greentvdinne: calls $0.30
*** TURN *** [Kh 5h Ah] [5s]
stylepointxoxo: bets $0.88
Greentvdinne: folds 
Uncalled bet ($0.88) returned to stylepointxoxo
stylepointxoxo collected $1.19 from pot
stylepointxoxo: doesn't show hand 
*** SUMMARY ***
Total pot $1.25 | Rake $0.06 
Board [Kh 5h Ah 5s]
Seat 1: nicucta folded before Flop (didn't bet)
Seat 2: stylepointxoxo collected ($1.19)
Seat 3: Greentvdinne (button) folded on the Turn
Seat 4: eRRe_ssbm (small blind) folded before Flop
Seat 5: 3EBC96 (big blind) folded before Flop
Seat 6: ivan2772ms folded before Flop (didn't bet)



PokerStars Hand #222955225030:  Hold'em No Limit ($0.05/$0.10 USD) - 2021/01/23 9:30:50 ET
Table 'Stephano III' 6-max Seat #4 is the button
Seat 1: nicucta ($11.95 in chips) 
Seat 2: stylepointxoxo ($10.64 in chips) 
Seat 3: Greentvdinne ($17.50 in chips) 
Seat 4: eRRe_ssbm ($12.32 in chips) 
Seat 5: 3EBC96 ($10 in chips) 
Seat 6: ivan2772ms ($10 in chips) 
3EBC96: posts small blind $0.05
ivan2772ms: posts big blind $0.10
*** HOLE CARDS ***
nicucta: folds 
stylepointxoxo: raises $0.15 to $0.25
Greentvdinne: calls $0.25
eRRe_ssbm: folds 
3EBC96: folds 
ivan2772ms: folds 
*** FLOP *** [7c As 5d]
stylepointxoxo: checks 
Greentvdinne: checks 
*** TURN *** [7c As 5d] [Qc]
stylepointxoxo: bets $0.30
Greentvdinne: calls $0.30
*** RIVER *** [7c As 5d Qc] [Ac]
stylepointxoxo: bets $0.88
Greentvdinne: folds 
Uncalled bet ($0.88) returned to stylepointxoxo
stylepointxoxo collected $1.19 from pot
stylepointxoxo: doesn't show hand 
*** SUMMARY ***
Total pot $1.25 | Rake $0.06 
Board [7c As 5d Qc Ac]
Seat 1: nicucta folded before Flop (didn't bet)
Seat 2: stylepointxoxo collected ($1.19)
Seat 3: Greentvdinne folded on the River
Seat 4: eRRe_ssbm (button) folded before Flop (didn't bet)
Seat 5: 3EBC96 (small blind) folded before Flop
Seat 6: ivan2772ms (big blind) folded before Flop



PokerStars Hand #222955245702:  Hold'em No Limit ($0.05/$0.10 USD) - 2021/01/23 9:31:30 ET
Table 'Stephano III' 6-max Seat #5 is the button
Seat 1: nicucta ($11.95 in chips) 
Seat 2: stylepointxoxo ($11.28 in chips) 
Seat 3: Greentvdinne ($16.95 in chips) 
Seat 4: eRRe_ssbm ($12.32 in chips) 
Seat 5: 3EBC96 ($10 in chips) 
Seat 6: ivan2772ms ($9.90 in chips) 
ivan2772ms: posts small blind $0.05
nicucta: posts big blind $0.10
*** HOLE CARDS ***
stylepointxoxo: folds 
Greentvdinne: raises $0.20 to $0.30
eRRe_ssbm: folds 
3EBC96: folds 
ivan2772ms: folds 
nicucta: folds 
Uncalled bet ($0.20) returned to Greentvdinne
Greentvdinne collected $0.25 from pot
Greentvdinne: doesn't show hand 
*** SUMMARY ***
Total pot $0.25 | Rake $0 
Seat 1: nicucta (big blind) folded before Flop
Seat 2: stylepointxoxo folded before Flop (didn't bet)
Seat 3: Greentvdinne collected ($0.25)
Seat 4: eRRe_ssbm folded before Flop (didn't bet)
Seat 5: 3EBC96 (button) folded before Flop (didn't bet)
Seat 6: ivan2772ms (small blind) folded before Flop



PokerStars Hand #222955251224:  Hold'em No Limit ($0.05/$0.10 USD) - 2021/01/23 9:31:41 ET
Table 'Stephano III' 6-max Seat #6 is the button
Seat 1: nicucta ($11.85 in chips) 
Seat 2: stylepointxoxo ($11.28 in chips) 
Seat 3: Greentvdinne ($17.10 in chips) 
Seat 4: eRRe_ssbm ($12.32 in chips) 
Seat 5: 3EBC96 ($10 in chips) 
Seat 6: ivan2772ms ($9.85 in chips) 
nicucta: posts small blind $0.05
stylepointxoxo: posts big blind $0.10
*** HOLE CARDS ***
Greentvdinne: folds 
eRRe_ssbm: raises $0.20 to $0.30
3EBC96: folds 
ivan2772ms: raises $0.60 to $0.90
nicucta: folds 
stylepointxoxo: folds 
eRRe_ssbm: raises $1.40 to $2.30
ivan2772ms: folds 
Uncalled bet ($1.40) returned to eRRe_ssbm
eRRe_ssbm collected $1.95 from pot
eRRe_ssbm: doesn't show hand 
*** SUMMARY ***
Total pot $1.95 | Rake $0 
Seat 1: nicucta (small blind) folded before Flop
Seat 2: stylepointxoxo (big blind) folded before Flop
Seat 3: Greentvdinne folded before Flop (didn't bet)
Seat 4: eRRe_ssbm collected ($1.95)
Seat 5: 3EBC96 folded before Flop (didn't bet)
Seat 6: ivan2772ms (button) folded before Flop



PokerStars Hand #222955268059:  Hold'em No Limit ($0.05/$0.10 USD) - 2021/01/23 9:32:15 ET
Table 'Stephano III' 6-max Seat #1 is the button
Seat 1: nicucta ($11.80 in chips) 
Seat 2: stylepointxoxo ($11.18 in chips) 
Seat 3: Greentvdinne ($17.10 in chips) 
Seat 4: eRRe_ssbm ($13.37 in chips) 
Seat 5: 3EBC96 ($10 in chips) 
Seat 6: ivan2772ms ($10 in chips) 
stylepointxoxo: posts small blind $0.05
Greentvdinne: posts big blind $0.10
*** HOLE CARDS ***
eRRe_ssbm has timed out
eRRe_ssbm: folds 
3EBC96: folds 
ivan2772ms: folds 
nicucta: raises $0.10 to $0.20
stylepointxoxo: folds 
Greentvdinne: folds 
Uncalled bet ($0.10) returned to nicucta
nicucta collected $0.25 from pot
*** SUMMARY ***
Total pot $0.25 | Rake $0 
Seat 1: nicucta (button) collected ($0.25)
Seat 2: stylepointxoxo (small blind) folded before Flop
Seat 3: Greentvdinne (big blind) folded before Flop
Seat 4: eRRe_ssbm folded before Flop (didn't bet)
Seat 5: 3EBC96 folded before Flop (didn't bet)
Seat 6: ivan2772ms folded before Flop (didn't bet)



PokerStars Hand #222955479759:  Hold'em No Limit ($0.05/$0.10 USD) - 2021/01/23 9:39:16 ET
Table 'Stephano III' 6-max Seat #2 is the button
Seat 1: nicucta ($7.81 in chips) 
Seat 2: stylepointxoxo ($16.59 in chips) 
Seat 3: Greentvdinne ($21.05 in chips) 
Seat 4: eRRe_ssbm ($13.07 in chips) 
Seat 5: 3EBC96 ($10 in chips) 
Greentvdinne: posts small blind $0.05
eRRe_ssbm: posts big blind $0.10
Hollseg: sits out 
*** HOLE CARDS ***
3EBC96: raises $0.20 to $0.30
nicucta: folds 
stylepointxoxo: folds 
Greentvdinne: folds 
eRRe_ssbm: folds 
Uncalled bet ($0.20) returned to 3EBC96
3EBC96 collected $0.25 from pot
3EBC96: doesn't show hand 
*** SUMMARY ***
Total pot $0.25 | Rake $0 
Seat 1: nicucta folded before Flop (didn't bet)
Seat 2: stylepointxoxo (button) folded before Flop (didn't bet)
Seat 3: Greentvdinne (small blind) folded before Flop
Seat 4: eRRe_ssbm (big blind) folded before Flop
Seat 5: 3EBC96 collected ($0.25)



PokerStars Hand #222955486922:  Hold'em No Limit ($0.05/$0.10 USD) - 2021/01/23 9:39:30 ET
Table 'Stephano III' 6-max Seat #3 is the button
Seat 1: nicucta ($7.81 in chips) 
Seat 2: stylepointxoxo ($16.59 in chips) 
Seat 3: Greentvdinne ($21 in chips) 
Seat 4: eRRe_ssbm ($12.97 in chips) 
Seat 5: 3EBC96 ($10.15 in chips) 
eRRe_ssbm: posts small blind $0.05
3EBC96: posts big blind $0.10
Hollseg: sits out 
*** HOLE CARDS ***
nicucta: folds 
stylepointxoxo: folds 
Greentvdinne: calls $0.10
eRRe_ssbm: raises $0.35 to $0.45
3EBC96: calls $0.35
Greentvdinne: calls $0.35
*** FLOP *** [3s 8h 8s]
eRRe_ssbm: bets $0.40
3EBC96: calls $0.40
Greentvdinne: folds 
*** TURN *** [3s 8h 8s] [3h]
eRRe_ssbm: checks 
3EBC96: bets $2.60
eRRe_ssbm: folds 
Uncalled bet ($2.60) returned to 3EBC96
3EBC96 collected $2.05 from pot
3EBC96: doesn't show hand 
*** SUMMARY ***
Total pot $2.15 | Rake $0.10 
Board [3s 8h 8s 3h]
Seat 1: nicucta folded before Flop (didn't bet)
Seat 2: stylepointxoxo folded before Flop (didn't bet)
Seat 3: Greentvdinne (button) folded on the Flop
Seat 4: eRRe_ssbm (small blind) folded on the Turn
Seat 5: 3EBC96 (big blind) collected ($2.05)



PokerStars Hand #222955528454:  Hold'em No Limit ($0.05/$0.10 USD) - 2021/01/23 9:40:52 ET
Table 'Stephano III' 6-max Seat #4 is the button
Seat 1: nicucta ($7.81 in chips) 
Seat 2: stylepointxoxo ($16.59 in chips) 
Seat 3: Greentvdinne ($20.55 in chips) 
Seat 4: eRRe_ssbm ($12.12 in chips) 
Seat 5: 3EBC96 ($11.35 in chips) 
Seat 6: Hollseg ($10 in chips) 
3EBC96: posts small blind $0.05
Hollseg: posts big blind $0.10
*** HOLE CARDS ***
nicucta: folds 
stylepointxoxo: folds 
Greentvdinne: folds 
eRRe_ssbm: raises $0.20 to $0.30
3EBC96: folds 
Hollseg: folds 
Uncalled bet ($0.20) returned to eRRe_ssbm
eRRe_ssbm collected $0.25 from pot
eRRe_ssbm: doesn't show hand 
*** SUMMARY ***
Total pot $0.25 | Rake $0 
Seat 1: nicucta folded before Flop (didn't bet)
Seat 2: stylepointxoxo folded before Flop (didn't bet)
Seat 3: Greentvdinne folded before Flop (didn't bet)
Seat 4: eRRe_ssbm (button) collected ($0.25)
Seat 5: 3EBC96 (small blind) folded before Flop
Seat 6: Hollseg (big blind) folded before Flop



PokerStars Hand #222955536391:  Hold'em No Limit ($0.05/$0.10 USD) - 2021/01/23 9:41:08 ET
Table 'Stephano III' 6-max Seat #5 is the button
Seat 1: nicucta ($7.81 in chips) 
Seat 2: stylepointxoxo ($16.59 in chips) 
Seat 3: Greentvdinne ($20.55 in chips) 
Seat 4: eRRe_ssbm ($12.27 in chips) 
Seat 5: 3EBC96 ($11.30 in chips) 
Seat 6: Hollseg ($9.90 in chips) 
Hollseg: posts small blind $0.05
nicucta: posts big blind $0.10
*** HOLE CARDS ***
stylepointxoxo: folds 
Greentvdinne: folds 
eRRe_ssbm: folds 
3EBC96: folds 
Hollseg: folds 
Uncalled bet ($0.05) returned to nicucta
nicucta collected $0.10 from pot
nicucta: doesn't show hand 
*** SUMMARY ***
Total pot $0.10 | Rake $0 
Seat 1: nicucta (big blind) collected ($0.10)
Seat 2: stylepointxoxo folded before Flop (didn't bet)
Seat 3: Greentvdinne folded before Flop (didn't bet)
Seat 4: eRRe_ssbm folded before Flop (didn't bet)
Seat 5: 3EBC96 (button) folded before Flop (didn't bet)
Seat 6: Hollseg (small blind) folded before Flop



PokerStars Hand #222955540170:  Hold'em No Limit ($0.05/$0.10 USD) - 2021/01/23 9:41:15 ET
Table 'Stephano III' 6-max Seat #6 is the button
Seat 1: nicucta ($7.86 in chips) 
Seat 2: stylepointxoxo ($16.59 in chips) 
Seat 3: Greentvdinne ($20.55 in chips) 
Seat 4: eRRe_ssbm ($12.27 in chips) 
Seat 5: 3EBC96 ($11.30 in chips) 
Seat 6: Hollseg ($10 in chips) 
nicucta: posts small blind $0.05
stylepointxoxo: posts big blind $0.10
*** HOLE CARDS ***
Greentvdinne: calls $0.10
eRRe_ssbm: folds 
3EBC96: raises $0.30 to $0.40
Hollseg: folds 
nicucta: folds 
stylepointxoxo: folds 
Greentvdinne: calls $0.30
*** FLOP *** [9s Th Ks]
Greentvdinne: checks 
3EBC96: bets $0.50
Greentvdinne: calls $0.50
*** TURN *** [9s Th Ks] [9h]
Greentvdinne: bets $1
3EBC96: calls $1
*** RIVER *** [9s Th Ks 9h] [3h]
Greentvdinne: bets $1.90
3EBC96: calls $1.90
*** SHOW DOWN ***
Greentvdinne: shows [Ah 8h] (a flush, Ace high)
3EBC96: mucks hand 
Greentvdinne collected $7.40 from pot
*** SUMMARY ***
Total pot $7.75 | Rake $0.35 
Board [9s Th Ks 9h 3h]
Seat 1: nicucta (small blind) folded before Flop
Seat 2: stylepointxoxo (big blind) folded before Flop
Seat 3: Greentvdinne showed [Ah 8h] and won ($7.40) with a flush, Ace high
Seat 4: eRRe_ssbm folded before Flop (didn't bet)
Seat 5: 3EBC96 mucked
Seat 6: Hollseg (button) folded before Flop (didn't bet)



PokerStars Hand #222955569731:  Hold'em No Limit ($0.05/$0.10 USD) - 2021/01/23 9:42:14 ET
Table 'Stephano III' 6-max Seat #1 is the button
Seat 1: nicucta ($7.81 in chips) 
Seat 2: stylepointxoxo ($16.49 in chips) 
Seat 3: Greentvdinne ($24.15 in chips) 
Seat 4: eRRe_ssbm ($12.27 in chips) 
Seat 5: 3EBC96 ($10 in chips) 
Seat 6: Hollseg ($10 in chips) 
stylepointxoxo: posts small blind $0.05
Greentvdinne: posts big blind $0.10
*** HOLE CARDS ***
eRRe_ssbm: folds 
3EBC96: folds 
Hollseg: folds 
nicucta: raises $0.20 to $0.30
stylepointxoxo: raises $0.90 to $1.20
Greentvdinne: folds 
nicucta: raises $6.61 to $7.81 and is all-in
stylepointxoxo: folds 
Uncalled bet ($6.61) returned to nicucta
nicucta collected $2.50 from pot
nicucta: doesn't show hand 
*** SUMMARY ***
Total pot $2.50 | Rake $0 
Seat 1: nicucta (button) collected ($2.50)
Seat 2: stylepointxoxo (small blind) folded before Flop
Seat 3: Greentvdinne (big blind) folded before Flop
Seat 4: eRRe_ssbm folded before Flop (didn't bet)
Seat 5: 3EBC96 folded before Flop (didn't bet)
Seat 6: Hollseg folded before Flop (didn't bet)



PokerStars Hand #222953958633:  Hold'em No Limit ($0.05/$0.10 USD) - 2021/01/23 8:46:25 ET
Table 'Stephano III' 6-max Seat #3 is the button
Seat 1: maxthebest99 ($19.12 in chips) 
Seat 2: stylepointxoxo ($11.53 in chips) 
Seat 3: xulfster ($10 in chips) 
Seat 4: Basile014 ($11.74 in chips) 
Seat 5: 3EBC96 ($12.56 in chips) 
Seat 6: Edgarlucky ($10 in chips) 
Basile014: posts small blind $0.05
3EBC96: posts big blind $0.10
*** HOLE CARDS ***
Edgarlucky: folds 
maxthebest99: folds 
stylepointxoxo: folds 
xulfster: raises $0.15 to $0.25
Basile014: folds 
3EBC96: calls $0.15
*** FLOP *** [Ad 3c 7c]
3EBC96: checks 
xulfster: bets $0.17
3EBC96: folds 
Uncalled bet ($0.17) returned to xulfster
xulfster collected $0.53 from pot
*** SUMMARY ***
Total pot $0.55 | Rake $0.02 
Board [Ad 3c 7c]
Seat 1: maxthebest99 folded before Flop (didn't bet)
Seat 2: stylepointxoxo folded before Flop (didn't bet)
Seat 3: xulfster (button) collected ($0.53)
Seat 4: Basile014 (small blind) folded before Flop
Seat 5: 3EBC96 (big blind) folded on the Flop
Seat 6: Edgarlucky folded before Flop (didn't bet)



PokerStars Hand #222952733193:  Hold'em No Limit ($0.05/$0.10 USD) - 2021/01/23 7:58:16 ET
Table 'Stephano III' 6-max Seat #2 is the button
Seat 1: Burlica2013 ($10.38 in chips) 
Seat 2: packno ($9.75 in chips) 
Seat 3: vilemo20 ($10.05 in chips) 
Seat 4: SERG244 ($10 in chips) 
vilemo20: posts small blind $0.05
SERG244: posts big blind $0.10
*** HOLE CARDS ***
Burlica2013: folds 
packno: calls $0.10
vilemo20: calls $0.05
SERG244: checks 
*** FLOP *** [Ad 6d 2c]
Shauny670 joins the table at seat #5 
Astro439 joins the table at seat #6 
vilemo20: checks 
Astro439 leaves the table
SERG244: checks 
Edgarlucky joins the table at seat #6 
packno: checks 
*** TURN *** [Ad 6d 2c] [Td]
vilemo20: checks 
SERG244: checks 
packno: bets $0.10
vilemo20: folds 
SERG244: calls $0.10
*** RIVER *** [Ad 6d 2c Td] [8h]
SERG244: checks 
packno: checks 
*** SHOW DOWN ***
SERG244: shows [6s 7d] (a pair of Sixes)
packno: shows [9d Tc] (a pair of Tens)
packno collected $0.48 from pot
*** SUMMARY ***
Total pot $0.50 | Rake $0.02 
Board [Ad 6d 2c Td 8h]
Seat 1: Burlica2013 folded before Flop (didn't bet)
Seat 2: packno (button) showed [9d Tc] and won ($0.48) with a pair of Tens
Seat 3: vilemo20 (small blind) folded on the Turn
Seat 4: SERG244 (big blind) showed [6s 7d] and lost with a pair of Sixes



PokerStars Hand #222952753190:  Hold'em No Limit ($0.05/$0.10 USD) - 2021/01/23 7:59:17 ET
Table 'Stephano III' 6-max Seat #3 is the button
Seat 1: Burlica2013 ($10.38 in chips) 
Seat 2: packno ($10.03 in chips) 
Seat 3: vilemo20 ($10 in chips) 
Seat 4: SERG244 ($10 in chips) 
Seat 5: Shauny670 ($10 in chips) 
SERG244: posts small blind $0.05
Shauny670: posts big blind $0.10
Edgarlucky: sits out 
*** HOLE CARDS ***
Burlica2013: folds 
packno: calls $0.10
vilemo20: folds 
SERG244: folds 
Shauny670: checks 
*** FLOP *** [Tc 6h 9c]
Shauny670: checks 
packno: checks 
*** TURN *** [Tc 6h 9c] [4h]
Shauny670: bets $0.12
packno: raises $0.12 to $0.24
Shauny670: calls $0.12
*** RIVER *** [Tc 6h 9c 4h] [3h]
Shauny670: checks 
packno: bets $0.30
Shauny670: raises $0.65 to $0.95
packno: calls $0.65
*** SHOW DOWN ***
Shauny670: shows [Ah 5h] (a flush, Ace high)
packno: mucks hand 
Shauny670 collected $2.51 from pot
*** SUMMARY ***
Total pot $2.63 | Rake $0.12 
Board [Tc 6h 9c 4h 3h]
Seat 1: Burlica2013 folded before Flop (didn't bet)
Seat 2: packno mucked
Seat 3: vilemo20 (button) folded before Flop (didn't bet)
Seat 4: SERG244 (small blind) folded before Flop
Seat 5: Shauny670 (big blind) showed [Ah 5h] and won ($2.51) with a flush, Ace high



PokerStars Hand #222952772532:  Hold'em No Limit ($0.05/$0.10 USD) - 2021/01/23 8:00:15 ET
Table 'Stephano III' 6-max Seat #4 is the button
Seat 1: Burlica2013 ($10.38 in chips) 
Seat 2: packno ($8.74 in chips) 
Seat 3: vilemo20 ($10 in chips) 
Seat 4: SERG244 ($10 in chips) 
Seat 5: Shauny670 ($11.22 in chips) 
Seat 6: Edgarlucky ($10 in chips) 
Shauny670: posts small blind $0.05
Edgarlucky: posts big blind $0.10
*** HOLE CARDS ***
Burlica2013: folds 
packno: calls $0.10
vilemo20: folds 
SERG244: folds 
Shauny670: calls $0.05
Edgarlucky: checks 
*** FLOP *** [8h 2c 2d]
Shauny670: checks 
Edgarlucky: bets $0.14
packno: folds 
Shauny670: folds 
Uncalled bet ($0.14) returned to Edgarlucky
Edgarlucky collected $0.29 from pot
Edgarlucky: doesn't show hand 
*** SUMMARY ***
Total pot $0.30 | Rake $0.01 
Board [8h 2c 2d]
Seat 1: Burlica2013 folded before Flop (didn't bet)
Seat 2: packno folded on the Flop
Seat 3: vilemo20 folded before Flop (didn't bet)
Seat 4: SERG244 (button) folded before Flop (didn't bet)
Seat 5: Shauny670 (small blind) folded on the Flop
Seat 6: Edgarlucky (big blind) collected ($0.29)



PokerStars Hand #222952785148:  Hold'em No Limit ($0.05/$0.10 USD) - 2021/01/23 8:00:52 ET
Table 'Stephano III' 6-max Seat #5 is the button
Seat 1: Burlica2013 ($10.38 in chips) 
Seat 2: packno ($8.64 in chips) 
Seat 3: vilemo20 ($10 in chips) 
Seat 4: SERG244 ($10 in chips) 
Seat 5: Shauny670 ($11.12 in chips) 
Seat 6: Edgarlucky ($10.19 in chips) 
Edgarlucky: posts small blind $0.05
Burlica2013: posts big blind $0.10
*** HOLE CARDS ***
packno: calls $0.10
vilemo20: folds 
SERG244: folds 
Shauny670: folds 
Edgarlucky: folds 
Burlica2013: checks 
*** FLOP *** [Ks 8c Qc]
Burlica2013: checks 
packno: checks 
*** TURN *** [Ks 8c Qc] [4s]
Burlica2013: checks 
packno: bets $0.10
Burlica2013: folds 
Uncalled bet ($0.10) returned to packno
packno collected $0.24 from pot
packno: doesn't show hand 
*** SUMMARY ***
Total pot $0.25 | Rake $0.01 
Board [Ks 8c Qc 4s]
Seat 1: Burlica2013 (big blind) folded on the Turn
Seat 2: packno collected ($0.24)
Seat 3: vilemo20 folded before Flop (didn't bet)
Seat 4: SERG244 folded before Flop (didn't bet)
Seat 5: Shauny670 (button) folded before Flop (didn't bet)
Seat 6: Edgarlucky (small blind) folded before Flop



PokerStars Hand #222952799780:  Hold'em No Limit ($0.05/$0.10 USD) - 2021/01/23 8:01:31 ET
Table 'Stephano III' 6-max Seat #6 is the button
Seat 1: Burlica2013 ($10.28 in chips) 
Seat 2: packno ($8.78 in chips) 
Seat 3: vilemo20 ($10 in chips) 
Seat 4: SERG244 ($10 in chips) 
Seat 5: Shauny670 ($11.12 in chips) 
Seat 6: Edgarlucky ($10.14 in chips) 
Burlica2013: posts small blind $0.05
packno: posts big blind $0.10
*** HOLE CARDS ***
vilemo20: folds 
SERG244: folds 
Shauny670: raises $0.20 to $0.30
Edgarlucky: folds 
Burlica2013: folds 
packno: calls $0.20
*** FLOP *** [3d 7d 5h]
packno: bets $0.10
Shauny670: calls $0.10
*** TURN *** [3d 7d 5h] [4c]
packno: bets $0.30
Shauny670: calls $0.30
*** RIVER *** [3d 7d 5h 4c] [9c]
packno: bets $0.60
Shauny670: calls $0.60
*** SHOW DOWN ***
packno: shows [7s 4s] (two pair, Sevens and Fours)
Shauny670: mucks hand 
packno collected $2.53 from pot
*** SUMMARY ***
Total pot $2.65 | Rake $0.12 
Board [3d 7d 5h 4c 9c]
Seat 1: Burlica2013 (small blind) folded before Flop
Seat 2: packno (big blind) showed [7s 4s] and won ($2.53) with two pair, Sevens and Fours
Seat 3: vilemo20 folded before Flop (didn't bet)
Seat 4: SERG244 folded before Flop (didn't bet)
Seat 5: Shauny670 mucked
Seat 6: Edgarlucky (button) folded before Flop (didn't bet)



PokerStars Hand #222952811337:  Hold'em No Limit ($0.05/$0.10 USD) - 2021/01/23 8:02:01 ET
Table 'Stephano III' 6-max Seat #1 is the button
Seat 1: Burlica2013 ($10.23 in chips) 
Seat 2: packno ($10.01 in chips) 
Seat 3: vilemo20 ($10 in chips) 
Seat 4: SERG244 ($10 in chips) 
Seat 5: Shauny670 ($9.82 in chips) 
Seat 6: Edgarlucky ($10.14 in chips) 
packno: posts small blind $0.05
vilemo20: posts big blind $0.10
*** HOLE CARDS ***
SERG244: raises $0.16 to $0.26
Shauny670: folds 
Edgarlucky: folds 
Burlica2013: folds 
packno: folds 
vilemo20: folds 
Uncalled bet ($0.16) returned to SERG244
SERG244 collected $0.25 from pot
SERG244: doesn't show hand 
*** SUMMARY ***
Total pot $0.25 | Rake $0 
Seat 1: Burlica2013 (button) folded before Flop (didn't bet)
Seat 2: packno (small blind) folded before Flop
Seat 3: vilemo20 (big blind) folded before Flop
Seat 4: SERG244 collected ($0.25)
Seat 5: Shauny670 folded before Flop (didn't bet)
Seat 6: Edgarlucky folded before Flop (didn't bet)



PokerStars Hand #222952820855:  Hold'em No Limit ($0.05/$0.10 USD) - 2021/01/23 8:02:13 ET
Table 'Stephano III' 6-max Seat #2 is the button
Seat 1: Burlica2013 ($10.23 in chips) 
Seat 2: packno ($9.96 in chips) 
Seat 3: vilemo20 ($10 in chips) 
Seat 4: SERG244 ($10.15 in chips) 
Seat 5: Shauny670 ($9.82 in chips) 
Seat 6: Edgarlucky ($10.14 in chips) 
vilemo20: posts small blind $0.05
SERG244: posts big blind $0.10
*** HOLE CARDS ***
Shauny670: calls $0.10
Edgarlucky: folds 
Burlica2013: folds 
packno: calls $0.10
vilemo20: folds 
SERG244: checks 
*** FLOP *** [2c Ts 5h]
SERG244: checks 
Shauny670: checks 
packno: bets $0.20
SERG244: calls $0.20
Shauny670: calls $0.20
*** TURN *** [2c Ts 5h] [3h]
SERG244: checks 
Shauny670: checks 
packno: bets $0.30
SERG244: calls $0.30
Shauny670: folds 
*** RIVER *** [2c Ts 5h 3h] [Js]
SERG244: checks 
packno: checks 
*** SHOW DOWN ***
SERG244: shows [6c 5d] (a pair of Fives)
packno: shows [Qc Tc] (a pair of Tens)
packno collected $1.48 from pot
*** SUMMARY ***
Total pot $1.55 | Rake $0.07 
Board [2c Ts 5h 3h Js]
Seat 1: Burlica2013 folded before Flop (didn't bet)
Seat 2: packno (button) showed [Qc Tc] and won ($1.48) with a pair of Tens
Seat 3: vilemo20 (small blind) folded before Flop
Seat 4: SERG244 (big blind) showed [6c 5d] and lost with a pair of Fives
Seat 5: Shauny670 folded on the Turn
Seat 6: Edgarlucky folded before Flop (didn't bet)



PokerStars Hand #222952835072:  Hold'em No Limit ($0.05/$0.10 USD) - 2021/01/23 8:02:49 ET
Table 'Stephano III' 6-max Seat #3 is the button
Seat 1: Burlica2013 ($10.23 in chips) 
Seat 2: packno ($10.84 in chips) 
Seat 3: vilemo20 ($10 in chips) 
Seat 4: SERG244 ($10 in chips) 
Seat 5: Shauny670 ($9.52 in chips) 
Seat 6: Edgarlucky ($10.14 in chips) 
SERG244: posts small blind $0.05
Shauny670: posts big blind $0.10
*** HOLE CARDS ***
Edgarlucky: folds 
Burlica2013: raises $0.15 to $0.25
packno: folds 
vilemo20: folds 
SERG244: raises $0.68 to $0.93
Shauny670: folds 
Burlica2013: folds 
Uncalled bet ($0.68) returned to SERG244
SERG244 collected $0.60 from pot
SERG244: doesn't show hand 
*** SUMMARY ***
Total pot $0.60 | Rake $0 
Seat 1: Burlica2013 folded before Flop
Seat 2: packno folded before Flop (didn't bet)
Seat 3: vilemo20 (button) folded before Flop (didn't bet)
Seat 4: SERG244 (small blind) collected ($0.60)
Seat 5: Shauny670 (big blind) folded before Flop
Seat 6: Edgarlucky folded before Flop (didn't bet)



PokerStars Hand #222952843888:  Hold'em No Limit ($0.05/$0.10 USD) - 2021/01/23 8:03:12 ET
Table 'Stephano III' 6-max Seat #4 is the button
Seat 1: Burlica2013 ($10 in chips) 
Seat 2: packno ($10.84 in chips) 
Seat 3: vilemo20 ($10 in chips) 
Seat 4: SERG244 ($10.35 in chips) 
Seat 5: Shauny670 ($9.42 in chips) 
Seat 6: Edgarlucky ($10.14 in chips) 
Shauny670: posts small blind $0.05
Edgarlucky: posts big blind $0.10
*** HOLE CARDS ***
Burlica2013: folds 
packno: folds 
vilemo20: folds 
SERG244: folds 
Shauny670: calls $0.05
Edgarlucky: raises $0.30 to $0.40
Shauny670: folds 
Uncalled bet ($0.30) returned to Edgarlucky
Edgarlucky collected $0.20 from pot
Edgarlucky: doesn't show hand 
*** SUMMARY ***
Total pot $0.20 | Rake $0 
Seat 1: Burlica2013 folded before Flop (didn't bet)
Seat 2: packno folded before Flop (didn't bet)
Seat 3: vilemo20 folded before Flop (didn't bet)
Seat 4: SERG244 (button) folded before Flop (didn't bet)
Seat 5: Shauny670 (small blind) folded before Flop
Seat 6: Edgarlucky (big blind) collected ($0.20)



PokerStars Hand #222952849417:  Hold'em No Limit ($0.05/$0.10 USD) - 2021/01/23 8:03:26 ET
Table 'Stephano III' 6-max Seat #5 is the button
Seat 1: Burlica2013 ($10 in chips) 
Seat 2: packno ($10.84 in chips) 
Seat 3: vilemo20 ($10 in chips) 
Seat 4: SERG244 ($10.35 in chips) 
Seat 5: Shauny670 ($9.32 in chips) 
Seat 6: Edgarlucky ($10.24 in chips) 
Edgarlucky: posts small blind $0.05
Burlica2013: posts big blind $0.10
*** HOLE CARDS ***
packno: folds 
vilemo20: folds 
SERG244: raises $0.16 to $0.26
Shauny670: folds 
Edgarlucky: raises $0.79 to $1.05
Burlica2013: folds 
SERG244: folds 
Uncalled bet ($0.79) returned to Edgarlucky
Edgarlucky collected $0.62 from pot
Edgarlucky: doesn't show hand 
*** SUMMARY ***
Total pot $0.62 | Rake $0 
Seat 1: Burlica2013 (big blind) folded before Flop
Seat 2: packno folded before Flop (didn't bet)
Seat 3: vilemo20 folded before Flop (didn't bet)
Seat 4: SERG244 folded before Flop
Seat 5: Shauny670 (button) folded before Flop (didn't bet)
Seat 6: Edgarlucky (small blind) collected ($0.62)



PokerStars Hand #222952858491:  Hold'em No Limit ($0.05/$0.10 USD) - 2021/01/23 8:03:48 ET
Table 'Stephano III' 6-max Seat #6 is the button
Seat 1: Burlica2013 ($10 in chips) 
Seat 2: packno ($10.84 in chips) 
Seat 3: vilemo20 ($10 in chips) 
Seat 4: SERG244 ($10.09 in chips) 
Seat 5: Shauny670 ($9.32 in chips) 
Seat 6: Edgarlucky ($10.60 in chips) 
Burlica2013: posts small blind $0.05
packno: posts big blind $0.10
*** HOLE CARDS ***
vilemo20: folds 
SERG244: raises $0.16 to $0.26
Shauny670: folds 
Edgarlucky: folds 
Burlica2013: folds 
packno: folds 
Uncalled bet ($0.16) returned to SERG244
SERG244 collected $0.25 from pot
SERG244: doesn't show hand 
*** SUMMARY ***
Total pot $0.25 | Rake $0 
Seat 1: Burlica2013 (small blind) folded before Flop
Seat 2: packno (big blind) folded before Flop
Seat 3: vilemo20 folded before Flop (didn't bet)
Seat 4: SERG244 collected ($0.25)
Seat 5: Shauny670 folded before Flop (didn't bet)
Seat 6: Edgarlucky (button) folded before Flop (didn't bet)



PokerStars Hand #222952863220:  Hold'em No Limit ($0.05/$0.10 USD) - 2021/01/23 8:04:00 ET
Table 'Stephano III' 6-max Seat #1 is the button
Seat 1: Burlica2013 ($10 in chips) 
Seat 2: packno ($10.74 in chips) 
Seat 3: vilemo20 ($10 in chips) 
Seat 4: SERG244 ($10.24 in chips) 
Seat 5: Shauny670 ($9.32 in chips) 
Seat 6: Edgarlucky ($10.60 in chips) 
packno: posts small blind $0.05
vilemo20: posts big blind $0.10
*** HOLE CARDS ***
SERG244: raises $0.16 to $0.26
Shauny670: folds 
Edgarlucky: folds 
Burlica2013: folds 
packno: folds 
vilemo20: folds 
Uncalled bet ($0.16) returned to SERG244
SERG244 collected $0.25 from pot
SERG244: doesn't show hand 
*** SUMMARY ***
Total pot $0.25 | Rake $0 
Seat 1: Burlica2013 (button) folded before Flop (didn't bet)
Seat 2: packno (small blind) folded before Flop
Seat 3: vilemo20 (big blind) folded before Flop
Seat 4: SERG244 collected ($0.25)
Seat 5: Shauny670 folded before Flop (didn't bet)
Seat 6: Edgarlucky folded before Flop (didn't bet)



PokerStars Hand #222952871027:  Hold'em No Limit ($0.05/$0.10 USD) - 2021/01/23 8:04:20 ET
Table 'Stephano III' 6-max Seat #2 is the button
Seat 1: Burlica2013 ($10 in chips) 
Seat 2: packno ($10.69 in chips) 
Seat 3: vilemo20 ($10 in chips) 
Seat 4: SERG244 ($10.39 in chips) 
Seat 5: Shauny670 ($9.32 in chips) 
Seat 6: Edgarlucky ($10.60 in chips) 
vilemo20: posts small blind $0.05
SERG244: posts big blind $0.10
*** HOLE CARDS ***
Shauny670: folds 
Edgarlucky: folds 
Burlica2013: folds 
packno: calls $0.10
vilemo20: folds 
SERG244: checks 
*** FLOP *** [9d 6d 7d]
SERG244: checks 
packno: bets $0.20
SERG244: folds 
Uncalled bet ($0.20) returned to packno
packno collected $0.24 from pot
packno: doesn't show hand 
*** SUMMARY ***
Total pot $0.25 | Rake $0.01 
Board [9d 6d 7d]
Seat 1: Burlica2013 folded before Flop (didn't bet)
Seat 2: packno (button) collected ($0.24)
Seat 3: vilemo20 (small blind) folded before Flop
Seat 4: SERG244 (big blind) folded on the Flop
Seat 5: Shauny670 folded before Flop (didn't bet)
Seat 6: Edgarlucky folded before Flop (didn't bet)



PokerStars Hand #222952889267:  Hold'em No Limit ($0.05/$0.10 USD) - 2021/01/23 8:05:05 ET
Table 'Stephano III' 6-max Seat #3 is the button
Seat 1: Burlica2013 ($10 in chips) 
Seat 2: packno ($10.83 in chips) 
Seat 3: vilemo20 ($10 in chips) 
Seat 4: SERG244 ($10.29 in chips) 
Seat 5: Shauny670 ($9.32 in chips) 
Seat 6: Edgarlucky ($10.60 in chips) 
SERG244: posts small blind $0.05
Shauny670: posts big blind $0.10
*** HOLE CARDS ***
Edgarlucky: folds 
Burlica2013: raises $0.15 to $0.25
packno: calls $0.25
vilemo20: folds 
SERG244: folds 
Shauny670: calls $0.15
*** FLOP *** [3c Ah Ts]
Shauny670: checks 
Burlica2013: bets $0.38
packno: calls $0.38
Shauny670: folds 
*** TURN *** [3c Ah Ts] [3h]
Burlica2013: bets $0.75
packno: folds 
Uncalled bet ($0.75) returned to Burlica2013
Burlica2013 collected $1.49 from pot
*** SUMMARY ***
Total pot $1.56 | Rake $0.07 
Board [3c Ah Ts 3h]
Seat 1: Burlica2013 collected ($1.49)
Seat 2: packno folded on the Turn
Seat 3: vilemo20 (button) folded before Flop (didn't bet)
Seat 4: SERG244 (small blind) folded before Flop
Seat 5: Shauny670 (big blind) folded on the Flop
Seat 6: Edgarlucky folded before Flop (didn't bet)



PokerStars Hand #222952898193:  Hold'em No Limit ($0.05/$0.10 USD) - 2021/01/23 8:05:28 ET
Table 'Stephano III' 6-max Seat #4 is the button
Seat 1: Burlica2013 ($10.86 in chips) 
Seat 2: packno ($10.20 in chips) 
Seat 3: vilemo20 ($10 in chips) 
Seat 4: SERG244 ($10.24 in chips) 
Seat 5: Shauny670 ($9.07 in chips) 
Seat 6: Edgarlucky ($10.60 in chips) 
Shauny670: posts small blind $0.05
Edgarlucky: posts big blind $0.10
*** HOLE CARDS ***
Burlica2013: folds 
packno: calls $0.10
vilemo20: folds 
SERG244: raises $0.31 to $0.41
Shauny670: folds 
Edgarlucky: folds 
packno: calls $0.31
*** FLOP *** [7d 8c Ah]
packno: bets $0.30
SERG244: calls $0.30
*** TURN *** [7d 8c Ah] [6d]
packno: bets $0.70
SERG244: calls $0.70
*** RIVER *** [7d 8c Ah 6d] [Qc]
packno: checks 
SERG244: checks 
*** SHOW DOWN ***
packno: shows [9h Qh] (a pair of Queens)
SERG244: shows [Ad 9s] (a pair of Aces)
SERG244 collected $2.84 from pot
*** SUMMARY ***
Total pot $2.97 | Rake $0.13 
Board [7d 8c Ah 6d Qc]
Seat 1: Burlica2013 folded before Flop (didn't bet)
Seat 2: packno showed [9h Qh] and lost with a pair of Queens
Seat 3: vilemo20 folded before Flop (didn't bet)
Seat 4: SERG244 (button) showed [Ad 9s] and won ($2.84) with a pair of Aces
Seat 5: Shauny670 (small blind) folded before Flop
Seat 6: Edgarlucky (big blind) folded before Flop



PokerStars Hand #222952917417:  Hold'em No Limit ($0.05/$0.10 USD) - 2021/01/23 8:06:15 ET
Table 'Stephano III' 6-max Seat #5 is the button
Seat 1: Burlica2013 ($10.86 in chips) 
Seat 2: packno ($8.79 in chips) 
Seat 3: vilemo20 ($10 in chips) 
Seat 4: SERG244 ($11.67 in chips) 
Seat 5: Shauny670 ($9.02 in chips) 
Seat 6: Edgarlucky ($10.50 in chips) 
Edgarlucky: posts small blind $0.05
Burlica2013: posts big blind $0.10
*** HOLE CARDS ***
packno: folds 
vilemo20: folds 
SERG244: folds 
Shauny670: raises $0.10 to $0.20
Edgarlucky: calls $0.15
Burlica2013: calls $0.10
*** FLOP *** [Qh 4s 5h]
Edgarlucky: checks 
Burlica2013: checks 
Shauny670: bets $0.28
Edgarlucky: raises $0.62 to $0.90
Burlica2013: folds 
Shauny670: folds 
Uncalled bet ($0.62) returned to Edgarlucky
Edgarlucky collected $1.11 from pot
Edgarlucky: doesn't show hand 
*** SUMMARY ***
Total pot $1.16 | Rake $0.05 
Board [Qh 4s 5h]
Seat 1: Burlica2013 (big blind) folded on the Flop
Seat 2: packno folded before Flop (didn't bet)
Seat 3: vilemo20 folded before Flop (didn't bet)
Seat 4: SERG244 folded before Flop (didn't bet)
Seat 5: Shauny670 (button) folded on the Flop
Seat 6: Edgarlucky (small blind) collected ($1.11)



PokerStars Hand #222952934234:  Hold'em No Limit ($0.05/$0.10 USD) - 2021/01/23 8:06:57 ET
Table 'Stephano III' 6-max Seat #6 is the button
Seat 1: Burlica2013 ($10.66 in chips) 
Seat 2: packno ($8.79 in chips) 
Seat 3: vilemo20 ($10 in chips) 
Seat 4: SERG244 ($11.67 in chips) 
Seat 5: Shauny670 ($8.54 in chips) 
Seat 6: Edgarlucky ($11.13 in chips) 
Burlica2013: posts small blind $0.05
packno: posts big blind $0.10
*** HOLE CARDS ***
vilemo20: folds 
SERG244: folds 
Shauny670: folds 
Shauny670 leaves the table
Edgarlucky: folds 
Burlica2013: raises $0.15 to $0.25
packno: calls $0.15
*** FLOP *** [9d 8h Js]
3EBC96 joins the table at seat #5 
Burlica2013: checks 
packno: bets $0.30
Burlica2013: folds 
Uncalled bet ($0.30) returned to packno
packno collected $0.48 from pot
packno: doesn't show hand 
*** SUMMARY ***
Total pot $0.50 | Rake $0.02 
Board [9d 8h Js]
Seat 1: Burlica2013 (small blind) folded on the Flop
Seat 2: packno (big blind) collected ($0.48)
Seat 3: vilemo20 folded before Flop (didn't bet)
Seat 4: SERG244 folded before Flop (didn't bet)
Seat 5: Shauny670 folded before Flop (didn't bet)
Seat 6: Edgarlucky (button) folded before Flop (didn't bet)



PokerStars Hand #222952947466:  Hold'em No Limit ($0.05/$0.10 USD) - 2021/01/23 8:07:29 ET
Table 'Stephano III' 6-max Seat #1 is the button
Seat 1: Burlica2013 ($10.41 in chips) 
Seat 2: packno ($9.02 in chips) 
Seat 3: vilemo20 ($10 in chips) 
Seat 4: SERG244 ($11.67 in chips) 
Seat 6: Edgarlucky ($11.13 in chips) 
packno: posts small blind $0.05
vilemo20: posts big blind $0.10
3EBC96: sits out 
*** HOLE CARDS ***
SERG244: raises $0.16 to $0.26
Edgarlucky: folds 
Burlica2013: folds 
packno: calls $0.21
vilemo20: folds 
*** FLOP *** [Ad 7d 2h]
packno: checks 
SERG244: bets $0.30
packno: calls $0.30
*** TURN *** [Ad 7d 2h] [8d]
packno: bets $0.60
SERG244: folds 
Uncalled bet ($0.60) returned to packno
packno collected $1.17 from pot
packno: doesn't show hand 
*** SUMMARY ***
Total pot $1.22 | Rake $0.05 
Board [Ad 7d 2h 8d]
Seat 1: Burlica2013 (button) folded before Flop (didn't bet)
Seat 2: packno (small blind) collected ($1.17)
Seat 3: vilemo20 (big blind) folded before Flop
Seat 4: SERG244 folded on the Turn
Seat 6: Edgarlucky folded before Flop (didn't bet)



PokerStars Hand #222952963888:  Hold'em No Limit ($0.05/$0.10 USD) - 2021/01/23 8:08:10 ET
Table 'Stephano III' 6-max Seat #2 is the button
Seat 1: Burlica2013 ($10.41 in chips) 
Seat 2: packno ($9.63 in chips) 
Seat 3: vilemo20 ($10 in chips) 
Seat 4: SERG244 ($11.11 in chips) 
Seat 6: Edgarlucky ($11.13 in chips) 
vilemo20: posts small blind $0.05
SERG244: posts big blind $0.10
3EBC96: sits out 
*** HOLE CARDS ***
Edgarlucky: folds 
Burlica2013: folds 
packno: calls $0.10
vilemo20: calls $0.05
SERG244: checks 
*** FLOP *** [Kd Ad 3d]
vilemo20: checks 
SERG244: checks 
packno: bets $0.10
vilemo20: folds 
SERG244: folds 
Uncalled bet ($0.10) returned to packno
packno collected $0.29 from pot
packno: doesn't show hand 
*** SUMMARY ***
Total pot $0.30 | Rake $0.01 
Board [Kd Ad 3d]
Seat 1: Burlica2013 folded before Flop (didn't bet)
Seat 2: packno (button) collected ($0.29)
Seat 3: vilemo20 (small blind) folded on the Flop
Seat 4: SERG244 (big blind) folded on the Flop
Seat 6: Edgarlucky folded before Flop (didn't bet)



PokerStars Hand #222952981510:  Hold'em No Limit ($0.05/$0.10 USD) - 2021/01/23 8:08:53 ET
Table 'Stephano III' 6-max Seat #3 is the button
Seat 1: Burlica2013 ($10.41 in chips) 
Seat 2: packno ($9.82 in chips) 
Seat 3: vilemo20 ($10 in chips) 
Seat 4: SERG244 ($11.01 in chips) 
Seat 5: 3EBC96 ($10 in chips) 
Seat 6: Edgarlucky ($11.13 in chips) 
SERG244: posts small blind $0.05
3EBC96: posts big blind $0.10
*** HOLE CARDS ***
Edgarlucky: folds 
Burlica2013: raises $0.15 to $0.25
packno: calls $0.25
vilemo20: folds 
SERG244: folds 
3EBC96: folds 
*** FLOP *** [Jd Ks Kd]
Burlica2013: checks 
packno: bets $0.20
Burlica2013: calls $0.20
*** TURN *** [Jd Ks Kd] [3d]
Burlica2013: checks 
packno: bets $0.40
Burlica2013: calls $0.40
*** RIVER *** [Jd Ks Kd 3d] [Jh]
Burlica2013: checks 
packno: checks 
*** SHOW DOWN ***
Burlica2013: shows [Ad Ac] (two pair, Aces and Kings)
packno: mucks hand 
Burlica2013 collected $1.77 from pot
*** SUMMARY ***
Total pot $1.85 | Rake $0.08 
Board [Jd Ks Kd 3d Jh]
Seat 1: Burlica2013 showed [Ad Ac] and won ($1.77) with two pair, Aces and Kings
Seat 2: packno mucked
Seat 3: vilemo20 (button) folded before Flop (didn't bet)
Seat 4: SERG244 (small blind) folded before Flop
Seat 5: 3EBC96 (big blind) folded before Flop
Seat 6: Edgarlucky folded before Flop (didn't bet)



PokerStars Hand #222953000463:  Hold'em No Limit ($0.05/$0.10 USD) - 2021/01/23 8:09:39 ET
Table 'Stephano III' 6-max Seat #4 is the button
Seat 1: Burlica2013 ($11.33 in chips) 
Seat 2: packno ($8.97 in chips) 
Seat 3: vilemo20 ($10 in chips) 
Seat 4: SERG244 ($10.96 in chips) 
Seat 5: 3EBC96 ($10 in chips) 
Seat 6: Edgarlucky ($11.13 in chips) 
3EBC96: posts small blind $0.05
Edgarlucky: posts big blind $0.10
*** HOLE CARDS ***
Burlica2013: folds 
packno: calls $0.10
Burlica2013 leaves the table
vilemo20: folds 
Gahky joins the table at seat #1 
SERG244: folds 
3EBC96: folds 
Edgarlucky: checks 
*** FLOP *** [2d 2s 9s]
Edgarlucky: checks 
packno: checks 
*** TURN *** [2d 2s 9s] [9h]
Edgarlucky: checks 
packno: bets $0.10
Edgarlucky: folds 
Uncalled bet ($0.10) returned to packno
packno collected $0.24 from pot
packno: doesn't show hand 
*** SUMMARY ***
Total pot $0.25 | Rake $0.01 
Board [2d 2s 9s 9h]
Seat 1: Burlica2013 folded before Flop (didn't bet)
Seat 2: packno collected ($0.24)
Seat 3: vilemo20 folded before Flop (didn't bet)
Seat 4: SERG244 (button) folded before Flop (didn't bet)
Seat 5: 3EBC96 (small blind) folded before Flop
Seat 6: Edgarlucky (big blind) folded on the Turn



PokerStars Hand #222953015381:  Hold'em No Limit ($0.05/$0.10 USD) - 2021/01/23 8:10:16 ET
Table 'Stephano III' 6-max Seat #5 is the button
Seat 1: Gahky ($8 in chips) 
Seat 2: packno ($9.11 in chips) 
Seat 3: vilemo20 ($10 in chips) 
Seat 4: SERG244 ($10.96 in chips) 
Seat 5: 3EBC96 ($10 in chips) 
Seat 6: Edgarlucky ($11.03 in chips) 
Edgarlucky: posts small blind $0.05
Gahky: posts big blind $0.10
*** HOLE CARDS ***
packno: calls $0.10
vilemo20: folds 
SERG244: folds 
3EBC96: folds 
Edgarlucky: calls $0.05
Gahky: raises $0.20 to $0.30
packno: calls $0.20
Edgarlucky: folds 
*** FLOP *** [4d Ac 4s]
Gahky: bets $0.20
packno: folds 
Uncalled bet ($0.20) returned to Gahky
Gahky collected $0.67 from pot
Gahky: doesn't show hand 
*** SUMMARY ***
Total pot $0.70 | Rake $0.03 
Board [4d Ac 4s]
Seat 1: Gahky (big blind) collected ($0.67)
Seat 2: packno folded on the Flop
Seat 3: vilemo20 folded before Flop (didn't bet)
Seat 4: SERG244 folded before Flop (didn't bet)
Seat 5: 3EBC96 (button) folded before Flop (didn't bet)
Seat 6: Edgarlucky (small blind) folded before Flop



PokerStars Hand #222953030545:  Hold'em No Limit ($0.05/$0.10 USD) - 2021/01/23 8:10:53 ET
Table 'Stephano III' 6-max Seat #6 is the button
Seat 1: Gahky ($8.37 in chips) 
Seat 2: packno ($8.81 in chips) 
Seat 3: vilemo20 ($10 in chips) 
Seat 4: SERG244 ($10.96 in chips) 
Seat 6: Edgarlucky ($10.93 in chips) 
Gahky: posts small blind $0.05
packno: posts big blind $0.10
*** HOLE CARDS ***
vilemo20: folds 
SERG244: folds 
Edgarlucky: folds 
Gahky: calls $0.05
packno: checks 
*** FLOP *** [Jc 6c 3d]
Gahky: bets $0.20
packno: folds 
Uncalled bet ($0.20) returned to Gahky
Gahky collected $0.19 from pot
Gahky: doesn't show hand 
*** SUMMARY ***
Total pot $0.20 | Rake $0.01 
Board [Jc 6c 3d]
Seat 1: Gahky (small blind) collected ($0.19)
Seat 2: packno (big blind) folded on the Flop
Seat 3: vilemo20 folded before Flop (didn't bet)
Seat 4: SERG244 folded before Flop (didn't bet)
Seat 6: Edgarlucky (button) folded before Flop (didn't bet)



PokerStars Hand #222953042036:  Hold'em No Limit ($0.05/$0.10 USD) - 2021/01/23 8:11:22 ET
Table 'Stephano III' 6-max Seat #1 is the button
Seat 1: Gahky ($8.46 in chips) 
Seat 2: packno ($8.71 in chips) 
Seat 3: vilemo20 ($10 in chips) 
Seat 4: SERG244 ($10.96 in chips) 
Seat 6: Edgarlucky ($10.93 in chips) 
packno: posts small blind $0.05
vilemo20: posts big blind $0.10
*** HOLE CARDS ***
SERG244: folds 
Edgarlucky: raises $0.15 to $0.25
Gahky: calls $0.25
packno: calls $0.20
vilemo20: folds 
*** FLOP *** [Qs 8s 6s]
packno: bets $0.30
Edgarlucky: calls $0.30
Gahky: folds 
*** TURN *** [Qs 8s 6s] [5s]
packno: checks 
Edgarlucky: checks 
*** RIVER *** [Qs 8s 6s 5s] [4c]
packno: checks 
Edgarlucky: checks 
*** SHOW DOWN ***
packno: shows [9h 6d] (a pair of Sixes)
Edgarlucky: shows [Ah Qd] (a pair of Queens)
Edgarlucky collected $1.38 from pot
*** SUMMARY ***
Total pot $1.45 | Rake $0.07 
Board [Qs 8s 6s 5s 4c]
Seat 1: Gahky (button) folded on the Flop
Seat 2: packno (small blind) showed [9h 6d] and lost with a pair of Sixes
Seat 3: vilemo20 (big blind) folded before Flop
Seat 4: SERG244 folded before Flop (didn't bet)
Seat 6: Edgarlucky showed [Ah Qd] and won ($1.38) with a pair of Queens



PokerStars Hand #222953058247:  Hold'em No Limit ($0.05/$0.10 USD) - 2021/01/23 8:12:01 ET
Table 'Stephano III' 6-max Seat #2 is the button
Seat 1: Gahky ($8.21 in chips) 
Seat 2: packno ($8.16 in chips) 
Seat 3: vilemo20 ($10 in chips) 
Seat 4: SERG244 ($10.96 in chips) 
Seat 6: Edgarlucky ($11.76 in chips) 
vilemo20: posts small blind $0.05
SERG244: posts big blind $0.10
*** HOLE CARDS ***
Edgarlucky: folds 
Gahky: folds 
packno: folds 
vilemo20: folds 
Uncalled bet ($0.05) returned to SERG244
SERG244 collected $0.10 from pot
SERG244: doesn't show hand 
*** SUMMARY ***
Total pot $0.10 | Rake $0 
Seat 1: Gahky folded before Flop (didn't bet)
Seat 2: packno (button) folded before Flop (didn't bet)
Seat 3: vilemo20 (small blind) folded before Flop
Seat 4: SERG244 (big blind) collected ($0.10)
Seat 6: Edgarlucky folded before Flop (didn't bet)



PokerStars Hand #222953061887:  Hold'em No Limit ($0.05/$0.10 USD) - 2021/01/23 8:12:10 ET
Table 'Stephano III' 6-max Seat #3 is the button
Seat 1: Gahky ($8.21 in chips) 
Seat 2: packno ($8.16 in chips) 
Seat 3: vilemo20 ($10 in chips) 
Seat 4: SERG244 ($11.01 in chips) 
Seat 5: 3EBC96 ($10 in chips) 
Seat 6: Edgarlucky ($11.76 in chips) 
SERG244: posts small blind $0.05
3EBC96: posts big blind $0.10
*** HOLE CARDS ***
Edgarlucky: folds 
Gahky: calls $0.10
packno: calls $0.10
vilemo20: folds 
SERG244: folds 
3EBC96: checks 
*** FLOP *** [3c 8d Js]
3EBC96: checks 
Gahky: bets $0.30
packno: folds 
3EBC96: folds 
Uncalled bet ($0.30) returned to Gahky
Gahky collected $0.33 from pot
Gahky: doesn't show hand 
*** SUMMARY ***
Total pot $0.35 | Rake $0.02 
Board [3c 8d Js]
Seat 1: Gahky collected ($0.33)
Seat 2: packno folded on the Flop
Seat 3: vilemo20 (button) folded before Flop (didn't bet)
Seat 4: SERG244 (small blind) folded before Flop
Seat 5: 3EBC96 (big blind) folded on the Flop
Seat 6: Edgarlucky folded before Flop (didn't bet)



PokerStars Hand #222953074978:  Hold'em No Limit ($0.05/$0.10 USD) - 2021/01/23 8:12:42 ET
Table 'Stephano III' 6-max Seat #4 is the button
Seat 1: Gahky ($8.44 in chips) 
Seat 2: packno ($8.06 in chips) 
Seat 3: vilemo20 ($10 in chips) 
Seat 4: SERG244 ($10.96 in chips) 
Seat 5: 3EBC96 ($10 in chips) 
Seat 6: Edgarlucky ($11.76 in chips) 
3EBC96: posts small blind $0.05
Edgarlucky: posts big blind $0.10
*** HOLE CARDS ***
Gahky: raises $0.20 to $0.30
packno: folds 
vilemo20: folds 
SERG244: folds 
3EBC96: folds 
Edgarlucky: folds 
Uncalled bet ($0.20) returned to Gahky
Gahky collected $0.25 from pot
Gahky: doesn't show hand 
*** SUMMARY ***
Total pot $0.25 | Rake $0 
Seat 1: Gahky collected ($0.25)
Seat 2: packno folded before Flop (didn't bet)
Seat 3: vilemo20 folded before Flop (didn't bet)
Seat 4: SERG244 (button) folded before Flop (didn't bet)
Seat 5: 3EBC96 (small blind) folded before Flop
Seat 6: Edgarlucky (big blind) folded before Flop



PokerStars Hand #222953079616:  Hold'em No Limit ($0.05/$0.10 USD) - 2021/01/23 8:12:53 ET
Table 'Stephano III' 6-max Seat #5 is the button
Seat 1: Gahky ($8.59 in chips) 
Seat 2: packno ($8.06 in chips) 
Seat 3: vilemo20 ($10 in chips) 
Seat 4: SERG244 ($10.96 in chips) 
Seat 5: 3EBC96 ($10 in chips) 
Seat 6: Edgarlucky ($11.66 in chips) 
Edgarlucky: posts small blind $0.05
Gahky: posts big blind $0.10
*** HOLE CARDS ***
packno has timed out
packno: folds 
vilemo20: raises $0.20 to $0.30
SERG244: folds 
3EBC96: folds 
Edgarlucky: raises $0.75 to $1.05
Gahky: folds 
vilemo20: folds 
Uncalled bet ($0.75) returned to Edgarlucky
Edgarlucky collected $0.70 from pot
Edgarlucky: doesn't show hand 
*** SUMMARY ***
Total pot $0.70 | Rake $0 
Seat 1: Gahky (big blind) folded before Flop
Seat 2: packno folded before Flop (didn't bet)
Seat 3: vilemo20 folded before Flop
Seat 4: SERG244 folded before Flop (didn't bet)
Seat 5: 3EBC96 (button) folded before Flop (didn't bet)
Seat 6: Edgarlucky (small blind) collected ($0.70)



PokerStars Hand #222953100572:  Hold'em No Limit ($0.05/$0.10 USD) - 2021/01/23 8:13:44 ET
Table 'Stephano III' 6-max Seat #6 is the button
Seat 1: Gahky ($8.49 in chips) 
Seat 2: packno ($8.06 in chips) 
Seat 3: vilemo20 ($10 in chips) 
Seat 4: SERG244 ($10.96 in chips) 
Seat 5: 3EBC96 ($10 in chips) 
Seat 6: Edgarlucky ($12.06 in chips) 
Gahky: posts small blind $0.05
packno: posts big blind $0.10
*** HOLE CARDS ***
vilemo20: folds 
SERG244: folds 
3EBC96: raises $0.20 to $0.30
Edgarlucky: raises $0.60 to $0.90
Gahky: calls $0.85
packno: folds 
3EBC96: calls $0.60
*** FLOP *** [4d 6s Jc]
Gahky: bets $7.59 and is all-in
3EBC96: folds 
Edgarlucky: calls $7.59
*** TURN *** [4d 6s Jc] [5c]
*** RIVER *** [4d 6s Jc 5c] [2d]
*** SHOW DOWN ***
Gahky: shows [Tc Th] (a pair of Tens)
Edgarlucky: shows [Ad Jd] (a pair of Jacks)
Edgarlucky cashed out the hand for $15.63 | Cash Out Fee $0.16
*** SUMMARY ***
Total pot $17.98 | Rake $0.81 
Board [4d 6s Jc 5c 2d]
Seat 1: Gahky (small blind) showed [Tc Th] and lost with a pair of Tens
Seat 2: packno (big blind) folded before Flop
Seat 3: vilemo20 folded before Flop (didn't bet)
Seat 4: SERG244 folded before Flop (didn't bet)
Seat 5: 3EBC96 folded on the Flop
Seat 6: Edgarlucky (button) showed [Ad Jd] and won ($17.17) with a pair of Jacks (pot not awarded as player cashed out)



PokerStars Hand #222953120032:  Hold'em No Limit ($0.05/$0.10 USD) - 2021/01/23 8:14:31 ET
Table 'Stephano III' 6-max Seat #2 is the button
Seat 2: packno ($7.96 in chips) 
Seat 3: vilemo20 ($10 in chips) 
Seat 4: SERG244 ($10.96 in chips) 
Seat 5: 3EBC96 ($10 in chips) 
Seat 6: Edgarlucky ($19.20 in chips) 
vilemo20: posts small blind $0.05
SERG244: posts big blind $0.10
*** HOLE CARDS ***
3EBC96: folds 
Edgarlucky: folds 
packno: calls $0.10
vilemo20: calls $0.05
Gahky leaves the table
SERG244: checks 
*** FLOP *** [Kh Ks 4c]
vilemo20: checks 
SERG244: checks 
packno: bets $0.20
maxthebest99 joins the table at seat #1 
vilemo20: folds 
SERG244: folds 
Uncalled bet ($0.20) returned to packno
packno collected $0.29 from pot
packno: doesn't show hand 
*** SUMMARY ***
Total pot $0.30 | Rake $0.01 
Board [Kh Ks 4c]
Seat 2: packno (button) collected ($0.29)
Seat 3: vilemo20 (small blind) folded on the Flop
Seat 4: SERG244 (big blind) folded on the Flop
Seat 5: 3EBC96 folded before Flop (didn't bet)
Seat 6: Edgarlucky folded before Flop (didn't bet)



PokerStars Hand #222953131863:  Hold'em No Limit ($0.05/$0.10 USD) - 2021/01/23 8:15:00 ET
Table 'Stephano III' 6-max Seat #3 is the button
Seat 2: packno ($8.15 in chips) 
Seat 3: vilemo20 ($10 in chips) 
Seat 4: SERG244 ($10.86 in chips) 
Seat 5: 3EBC96 ($10 in chips) 
Seat 6: Edgarlucky ($19.20 in chips) 
SERG244: posts small blind $0.05
3EBC96: posts big blind $0.10
maxthebest99: sits out 
*** HOLE CARDS ***
Edgarlucky: folds 
packno: raises $0.10 to $0.20
vilemo20: calls $0.20
SERG244: folds 
3EBC96: calls $0.10
*** FLOP *** [7c Js 9h]
3EBC96: checks 
packno: bets $0.30
vilemo20: folds 
3EBC96: calls $0.30
*** TURN *** [7c Js 9h] [8d]
3EBC96: checks 
packno: bets $0.40
3EBC96: folds 
Uncalled bet ($0.40) returned to packno
packno collected $1.19 from pot
packno: doesn't show hand 
*** SUMMARY ***
Total pot $1.25 | Rake $0.06 
Board [7c Js 9h 8d]
Seat 2: packno collected ($1.19)
Seat 3: vilemo20 (button) folded on the Flop
Seat 4: SERG244 (small blind) folded before Flop
Seat 5: 3EBC96 (big blind) folded on the Turn
Seat 6: Edgarlucky folded before Flop (didn't bet)



PokerStars Hand #222953146368:  Hold'em No Limit ($0.05/$0.10 USD) - 2021/01/23 8:15:35 ET
Table 'Stephano III' 6-max Seat #4 is the button
Seat 2: packno ($8.84 in chips) 
Seat 3: vilemo20 ($10 in chips) 
Seat 4: SERG244 ($10.81 in chips) 
Seat 5: 3EBC96 ($10 in chips) 
Seat 6: Edgarlucky ($19.20 in chips) 
3EBC96: posts small blind $0.05
Edgarlucky: posts big blind $0.10
maxthebest99: sits out 
*** HOLE CARDS ***
packno: folds 
vilemo20: folds 
SERG244: folds 
3EBC96: folds 
Uncalled bet ($0.05) returned to Edgarlucky
Edgarlucky collected $0.10 from pot
Edgarlucky: doesn't show hand 
*** SUMMARY ***
Total pot $0.10 | Rake $0 
Seat 2: packno folded before Flop (didn't bet)
Seat 3: vilemo20 folded before Flop (didn't bet)
Seat 4: SERG244 (button) folded before Flop (didn't bet)
Seat 5: 3EBC96 (small blind) folded before Flop
Seat 6: Edgarlucky (big blind) collected ($0.10)



PokerStars Hand #222953150821:  Hold'em No Limit ($0.05/$0.10 USD) - 2021/01/23 8:15:46 ET
Table 'Stephano III' 6-max Seat #5 is the button
Seat 1: maxthebest99 ($6.95 in chips) 
Seat 2: packno ($8.84 in chips) 
Seat 3: vilemo20 ($10 in chips) 
Seat 4: SERG244 ($10.81 in chips) 
Seat 5: 3EBC96 ($10 in chips) 
Seat 6: Edgarlucky ($19.25 in chips) 
Edgarlucky: posts small blind $0.05
maxthebest99: posts big blind $0.10
*** HOLE CARDS ***
packno: folds 
vilemo20: raises $0.20 to $0.30
SERG244: folds 
3EBC96: folds 
Edgarlucky: folds 
maxthebest99: raises $0.30 to $0.60
vilemo20: calls $0.30
*** FLOP *** [Ks 2h 9h]
maxthebest99: bets $0.40
vilemo20: folds 
Uncalled bet ($0.40) returned to maxthebest99
maxthebest99 collected $1.19 from pot
maxthebest99: doesn't show hand 
*** SUMMARY ***
Total pot $1.25 | Rake $0.06 
Board [Ks 2h 9h]
Seat 1: maxthebest99 (big blind) collected ($1.19)
Seat 2: packno folded before Flop (didn't bet)
Seat 3: vilemo20 folded on the Flop
Seat 4: SERG244 folded before Flop (didn't bet)
Seat 5: 3EBC96 (button) folded before Flop (didn't bet)
Seat 6: Edgarlucky (small blind) folded before Flop



PokerStars Hand #222953164318:  Hold'em No Limit ($0.05/$0.10 USD) - 2021/01/23 8:16:19 ET
Table 'Stephano III' 6-max Seat #6 is the button
Seat 1: maxthebest99 ($7.54 in chips) 
Seat 2: packno ($8.84 in chips) 
Seat 3: vilemo20 ($10 in chips) 
Seat 4: SERG244 ($10.81 in chips) 
Seat 5: 3EBC96 ($10 in chips) 
Seat 6: Edgarlucky ($19.20 in chips) 
maxthebest99: posts small blind $0.05
packno: posts big blind $0.10
*** HOLE CARDS ***
vilemo20: folds 
SERG244: raises $0.16 to $0.26
3EBC96: folds 
Edgarlucky: raises $0.59 to $0.85
maxthebest99: folds 
packno: calls $0.75
SERG244: calls $0.59
*** FLOP *** [2c 2h Jd]
packno: checks 
SERG244: checks 
Edgarlucky: checks 
*** TURN *** [2c 2h Jd] [2d]
packno: bets $1
SERG244: raises $1.57 to $2.57
Edgarlucky: folds 
packno: folds 
Uncalled bet ($1.57) returned to SERG244
SERG244 collected $4.39 from pot
SERG244: doesn't show hand 
*** SUMMARY ***
Total pot $4.60 | Rake $0.21 
Board [2c 2h Jd 2d]
Seat 1: maxthebest99 (small blind) folded before Flop
Seat 2: packno (big blind) folded on the Turn
Seat 3: vilemo20 folded before Flop (didn't bet)
Seat 4: SERG244 collected ($4.39)
Seat 5: 3EBC96 folded before Flop (didn't bet)
Seat 6: Edgarlucky (button) folded on the Turn



PokerStars Hand #222953183861:  Hold'em No Limit ($0.05/$0.10 USD) - 2021/01/23 8:17:06 ET
Table 'Stephano III' 6-max Seat #1 is the button
Seat 1: maxthebest99 ($7.49 in chips) 
Seat 2: packno ($6.99 in chips) 
Seat 4: SERG244 ($13.35 in chips) 
Seat 5: 3EBC96 ($10 in chips) 
Seat 6: Edgarlucky ($18.35 in chips) 
packno: posts small blind $0.05
vilemo20: is sitting out 
SERG244: posts big blind $0.10
*** HOLE CARDS ***
3EBC96: folds 
Edgarlucky: folds 
maxthebest99: folds 
packno: raises $0.10 to $0.20
SERG244: raises $0.40 to $0.60
packno: calls $0.40
*** FLOP *** [Kd 2d 4h]
packno: bets $0.30
SERG244: calls $0.30
*** TURN *** [Kd 2d 4h] [7h]
packno: bets $0.80
SERG244: calls $0.80
*** RIVER *** [Kd 2d 4h 7h] [7s]
packno: bets $1.30
SERG244: raises $2.05 to $3.35
packno: folds 
Uncalled bet ($2.05) returned to SERG244
SERG244 collected $5.73 from pot
SERG244: doesn't show hand 
*** SUMMARY ***
Total pot $6 | Rake $0.27 
Board [Kd 2d 4h 7h 7s]
Seat 1: maxthebest99 (button) folded before Flop (didn't bet)
Seat 2: packno (small blind) folded on the River
Seat 4: SERG244 (big blind) collected ($5.73)
Seat 5: 3EBC96 folded before Flop (didn't bet)
Seat 6: Edgarlucky folded before Flop (didn't bet)



PokerStars Hand #222953202276:  Hold'em No Limit ($0.05/$0.10 USD) - 2021/01/23 8:17:49 ET
Table 'Stephano III' 6-max Seat #2 is the button
Seat 1: maxthebest99 ($7.49 in chips) 
Seat 2: packno ($3.99 in chips) 
Seat 4: SERG244 ($16.08 in chips) 
Seat 5: 3EBC96 ($10 in chips) 
Seat 6: Edgarlucky ($18.35 in chips) 
SERG244: posts small blind $0.05
3EBC96: posts big blind $0.10
*** HOLE CARDS ***
Edgarlucky: folds 
maxthebest99: folds 
packno: folds 
packno leaves the table
SERG244: folds 
Uncalled bet ($0.05) returned to 3EBC96
3EBC96 collected $0.10 from pot
3EBC96: doesn't show hand 
*** SUMMARY ***
Total pot $0.10 | Rake $0 
Seat 1: maxthebest99 folded before Flop (didn't bet)
Seat 2: packno (button) folded before Flop (didn't bet)
Seat 4: SERG244 (small blind) folded before Flop
Seat 5: 3EBC96 (big blind) collected ($0.10)
Seat 6: Edgarlucky folded before Flop (didn't bet)



PokerStars Hand #222953207561:  Hold'em No Limit ($0.05/$0.10 USD) - 2021/01/23 8:18:02 ET
Table 'Stephano III' 6-max Seat #4 is the button
Seat 1: maxthebest99 ($7.49 in chips) 
Seat 4: SERG244 ($16.03 in chips) 
Seat 5: 3EBC96 ($10.05 in chips) 
Seat 6: Edgarlucky ($18.35 in chips) 
3EBC96: posts small blind $0.05
Edgarlucky: posts big blind $0.10
*** HOLE CARDS ***
maxthebest99: folds 
SERG244: raises $0.16 to $0.26
3EBC96: folds 
stylepointxoxo joins the table at seat #2 
Edgarlucky: calls $0.16
*** FLOP *** [Qc Ks Qs]
Edgarlucky: checks 
SERG244: checks 
*** TURN *** [Qc Ks Qs] [Tc]
Edgarlucky: bets $0.27
SERG244: calls $0.27
*** RIVER *** [Qc Ks Qs Tc] [7c]
Edgarlucky: bets $0.53
SERG244: raises $0.74 to $1.27
Edgarlucky: folds 
Uncalled bet ($0.74) returned to SERG244
SERG244 collected $2.07 from pot
SERG244: doesn't show hand 
*** SUMMARY ***
Total pot $2.17 | Rake $0.10 
Board [Qc Ks Qs Tc 7c]
Seat 1: maxthebest99 folded before Flop (didn't bet)
Seat 4: SERG244 (button) collected ($2.07)
Seat 5: 3EBC96 (small blind) folded before Flop
Seat 6: Edgarlucky (big blind) folded on the River



PokerStars Hand #222953227485:  Hold'em No Limit ($0.05/$0.10 USD) - 2021/01/23 8:18:49 ET
Table 'Stephano III' 6-max Seat #5 is the button
Seat 1: maxthebest99 ($7.49 in chips) 
Seat 4: SERG244 ($17.04 in chips) 
Seat 5: 3EBC96 ($10 in chips) 
Seat 6: Edgarlucky ($17.29 in chips) 
Edgarlucky: posts small blind $0.05
maxthebest99: posts big blind $0.10
stylepointxoxo: sits out 
*** HOLE CARDS ***
SERG244: folds 
3EBC96: folds 
Edgarlucky: calls $0.05
maxthebest99: checks 
*** FLOP *** [4s Qc Qs]
Edgarlucky: bets $0.10
maxthebest99: calls $0.10
*** TURN *** [4s Qc Qs] [8c]
Edgarlucky: bets $0.30
maxthebest99: folds 
Uncalled bet ($0.30) returned to Edgarlucky
Edgarlucky collected $0.38 from pot
Edgarlucky: doesn't show hand 
*** SUMMARY ***
Total pot $0.40 | Rake $0.02 
Board [4s Qc Qs 8c]
Seat 1: maxthebest99 (big blind) folded on the Turn
Seat 4: SERG244 folded before Flop (didn't bet)
Seat 5: 3EBC96 (button) folded before Flop (didn't bet)
Seat 6: Edgarlucky (small blind) collected ($0.38)



PokerStars Hand #222953235462:  Hold'em No Limit ($0.05/$0.10 USD) - 2021/01/23 8:19:08 ET
Table 'Stephano III' 6-max Seat #6 is the button
Seat 1: maxthebest99 ($7.29 in chips) 
Seat 2: stylepointxoxo ($10 in chips) 
Seat 4: SERG244 ($17.04 in chips) 
Seat 5: 3EBC96 ($10 in chips) 
Seat 6: Edgarlucky ($17.47 in chips) 
maxthebest99: posts small blind $0.05
stylepointxoxo: posts big blind $0.10
*** HOLE CARDS ***
SERG244: raises $0.16 to $0.26
3EBC96: folds 
Edgarlucky: folds 
maxthebest99: folds 
stylepointxoxo: calls $0.16
*** FLOP *** [Qs 2h 2c]
stylepointxoxo: checks 
SERG244: bets $0.27
stylepointxoxo: calls $0.27
*** TURN *** [Qs 2h 2c] [2s]
stylepointxoxo: checks 
SERG244: checks 
*** RIVER *** [Qs 2h 2c 2s] [8d]
stylepointxoxo: checks 
SERG244: checks 
*** SHOW DOWN ***
stylepointxoxo: shows [7h Ah] (three of a kind, Deuces)
SERG244: shows [As Js] (three of a kind, Deuces)
stylepointxoxo collected $0.53 from pot
SERG244 collected $0.53 from pot
*** SUMMARY ***
Total pot $1.11 | Rake $0.05 
Board [Qs 2h 2c 2s 8d]
Seat 1: maxthebest99 (small blind) folded before Flop
Seat 2: stylepointxoxo (big blind) showed [7h Ah] and won ($0.53) with three of a kind, Deuces
Seat 4: SERG244 showed [As Js] and won ($0.53) with three of a kind, Deuces
Seat 5: 3EBC96 folded before Flop (didn't bet)
Seat 6: Edgarlucky (button) folded before Flop (didn't bet)



PokerStars Hand #222953250633:  Hold'em No Limit ($0.05/$0.10 USD) - 2021/01/23 8:19:45 ET
Table 'Stephano III' 6-max Seat #1 is the button
Seat 1: maxthebest99 ($7.24 in chips) 
Seat 2: stylepointxoxo ($10 in chips) 
Seat 5: 3EBC96 ($10 in chips) 
Seat 6: Edgarlucky ($17.47 in chips) 
stylepointxoxo: posts small blind $0.05
SERG244: is sitting out 
3EBC96: posts big blind $0.10
*** HOLE CARDS ***
Edgarlucky: folds 
maxthebest99: folds 
stylepointxoxo: folds 
Uncalled bet ($0.05) returned to 3EBC96
3EBC96 collected $0.10 from pot
3EBC96: doesn't show hand 
*** SUMMARY ***
Total pot $0.10 | Rake $0 
Seat 1: maxthebest99 (button) folded before Flop (didn't bet)
Seat 2: stylepointxoxo (small blind) folded before Flop
Seat 5: 3EBC96 (big blind) collected ($0.10)
Seat 6: Edgarlucky folded before Flop (didn't bet)



PokerStars Hand #222953254926:  Hold'em No Limit ($0.05/$0.10 USD) - 2021/01/23 8:19:55 ET
Table 'Stephano III' 6-max Seat #2 is the button
Seat 1: maxthebest99 ($7.24 in chips) 
Seat 2: stylepointxoxo ($10 in chips) 
Seat 5: 3EBC96 ($10.05 in chips) 
Seat 6: Edgarlucky ($17.47 in chips) 
3EBC96: posts small blind $0.05
Edgarlucky: posts big blind $0.10
*** HOLE CARDS ***
SERG244 leaves the table
maxthebest99: calls $0.10
stylepointxoxo: raises $0.15 to $0.25
Basile014 joins the table at seat #4 
3EBC96: folds 
Edgarlucky: folds 
maxthebest99: folds 
Uncalled bet ($0.15) returned to stylepointxoxo
stylepointxoxo collected $0.35 from pot
stylepointxoxo: doesn't show hand 
*** SUMMARY ***
Total pot $0.35 | Rake $0 
Seat 1: maxthebest99 folded before Flop
Seat 2: stylepointxoxo (button) collected ($0.35)
Seat 5: 3EBC96 (small blind) folded before Flop
Seat 6: Edgarlucky (big blind) folded before Flop



PokerStars Hand #222953262826:  Hold'em No Limit ($0.05/$0.10 USD) - 2021/01/23 8:20:13 ET
Table 'Stephano III' 6-max Seat #5 is the button
Seat 1: maxthebest99 ($7.14 in chips) 
Seat 2: stylepointxoxo ($10.25 in chips) 
Seat 4: Basile014 ($10 in chips) 
Seat 5: 3EBC96 ($10 in chips) 
Seat 6: Edgarlucky ($17.37 in chips) 
Edgarlucky: posts small blind $0.05
maxthebest99: posts big blind $0.10
Basile014: posts big blind $0.10
*** HOLE CARDS ***
stylepointxoxo: folds 
Basile014: checks 
3EBC96: folds 
Edgarlucky: folds 
maxthebest99: checks 
*** FLOP *** [Kd Ac 2d]
maxthebest99: checks 
Basile014: bets $0.10
maxthebest99: calls $0.10
*** TURN *** [Kd Ac 2d] [9d]
maxthebest99: checks 
Basile014: bets $0.10
maxthebest99: calls $0.10
*** RIVER *** [Kd Ac 2d 9d] [Th]
maxthebest99: checks 
Basile014: bets $0.90
maxthebest99: folds 
Uncalled bet ($0.90) returned to Basile014
Basile014 collected $0.62 from pot
Basile014: doesn't show hand 
*** SUMMARY ***
Total pot $0.65 | Rake $0.03 
Board [Kd Ac 2d 9d Th]
Seat 1: maxthebest99 (big blind) folded on the River
Seat 2: stylepointxoxo folded before Flop (didn't bet)
Seat 4: Basile014 collected ($0.62)
Seat 5: 3EBC96 (button) folded before Flop (didn't bet)
Seat 6: Edgarlucky (small blind) folded before Flop



PokerStars Hand #222953283457:  Hold'em No Limit ($0.05/$0.10 USD) - 2021/01/23 8:21:01 ET
Table 'Stephano III' 6-max Seat #6 is the button
Seat 1: maxthebest99 ($6.84 in chips) 
Seat 2: stylepointxoxo ($10.25 in chips) 
Seat 4: Basile014 ($10.32 in chips) 
Seat 5: 3EBC96 ($10 in chips) 
Seat 6: Edgarlucky ($17.32 in chips) 
maxthebest99: posts small blind $0.05
stylepointxoxo: posts big blind $0.10
*** HOLE CARDS ***
Basile014: calls $0.10
3EBC96: folds 
Edgarlucky: folds 
maxthebest99: calls $0.05
stylepointxoxo: checks 
*** FLOP *** [6h 6c Kd]
maxthebest99: checks 
stylepointxoxo: checks 
Basile014: checks 
*** TURN *** [6h 6c Kd] [6s]
maxthebest99: bets $0.20
stylepointxoxo: calls $0.20
Basile014: folds 
*** RIVER *** [6h 6c Kd 6s] [2c]
maxthebest99: bets $0.20
stylepointxoxo: calls $0.20
*** SHOW DOWN ***
maxthebest99: shows [As 8c] (three of a kind, Sixes)
stylepointxoxo: shows [Ks 9s] (a full house, Sixes full of Kings)
stylepointxoxo collected $1.05 from pot
*** SUMMARY ***
Total pot $1.10 | Rake $0.05 
Board [6h 6c Kd 6s 2c]
Seat 1: maxthebest99 (small blind) showed [As 8c] and lost with three of a kind, Sixes
Seat 2: stylepointxoxo (big blind) showed [Ks 9s] and won ($1.05) with a full house, Sixes full of Kings
Seat 4: Basile014 folded on the Turn
Seat 5: 3EBC96 folded before Flop (didn't bet)
Seat 6: Edgarlucky (button) folded before Flop (didn't bet)



PokerStars Hand #222953299948:  Hold'em No Limit ($0.05/$0.10 USD) - 2021/01/23 8:21:39 ET
Table 'Stephano III' 6-max Seat #1 is the button
Seat 1: maxthebest99 ($6.34 in chips) 
Seat 2: stylepointxoxo ($10.80 in chips) 
Seat 3: vilemo20 ($10 in chips) 
Seat 4: Basile014 ($10.22 in chips) 
Seat 5: 3EBC96 ($10 in chips) 
Seat 6: Edgarlucky ($17.32 in chips) 
stylepointxoxo: posts small blind $0.05
vilemo20: posts big blind $0.10
*** HOLE CARDS ***
Basile014: calls $0.10
3EBC96: folds 
Edgarlucky: folds 
maxthebest99: folds 
stylepointxoxo: folds 
vilemo20: checks 
*** FLOP *** [Ac 5c 8h]
vilemo20: checks 
Basile014: checks 
*** TURN *** [Ac 5c 8h] [Js]
vilemo20: checks 
Basile014: checks 
*** RIVER *** [Ac 5c 8h Js] [9c]
vilemo20: checks 
Basile014: bets $0.10
vilemo20: folds 
Uncalled bet ($0.10) returned to Basile014
Basile014 collected $0.24 from pot
Basile014: doesn't show hand 
*** SUMMARY ***
Total pot $0.25 | Rake $0.01 
Board [Ac 5c 8h Js 9c]
Seat 1: maxthebest99 (button) folded before Flop (didn't bet)
Seat 2: stylepointxoxo (small blind) folded before Flop
Seat 3: vilemo20 (big blind) folded on the River
Seat 4: Basile014 collected ($0.24)
Seat 5: 3EBC96 folded before Flop (didn't bet)
Seat 6: Edgarlucky folded before Flop (didn't bet)



PokerStars Hand #222953408262:  Hold'em No Limit ($0.05/$0.10 USD) - 2021/01/23 8:25:50 ET
Table 'Stephano III' 6-max Seat #3 is the button
Seat 1: maxthebest99 ($6.53 in chips) 
Seat 2: stylepointxoxo ($11.20 in chips) 
Seat 3: vilemo20 ($10 in chips) 
Seat 4: Basile014 ($11.06 in chips) 
Seat 5: 3EBC96 ($10 in chips) 
Seat 6: Edgarlucky ($17.31 in chips) 
Basile014: posts small blind $0.05
3EBC96: posts big blind $0.10
*** HOLE CARDS ***
Edgarlucky: folds 
maxthebest99: raises $0.10 to $0.20
stylepointxoxo: folds 
vilemo20: folds 
Basile014: folds 
3EBC96: calls $0.10
*** FLOP *** [Qd 5d 2s]
3EBC96: checks 
maxthebest99: bets $0.20
3EBC96: folds 
Uncalled bet ($0.20) returned to maxthebest99
maxthebest99 collected $0.43 from pot
maxthebest99: doesn't show hand 
*** SUMMARY ***
Total pot $0.45 | Rake $0.02 
Board [Qd 5d 2s]
Seat 1: maxthebest99 collected ($0.43)
Seat 2: stylepointxoxo folded before Flop (didn't bet)
Seat 3: vilemo20 (button) folded before Flop (didn't bet)
Seat 4: Basile014 (small blind) folded before Flop
Seat 5: 3EBC96 (big blind) folded on the Flop
Seat 6: Edgarlucky folded before Flop (didn't bet)



PokerStars Hand #222953418546:  Hold'em No Limit ($0.05/$0.10 USD) - 2021/01/23 8:26:14 ET
Table 'Stephano III' 6-max Seat #4 is the button
Seat 1: maxthebest99 ($6.76 in chips) 
Seat 2: stylepointxoxo ($11.20 in chips) 
Seat 3: vilemo20 ($10 in chips) 
Seat 4: Basile014 ($11.01 in chips) 
Seat 5: 3EBC96 ($10 in chips) 
Seat 6: Edgarlucky ($17.31 in chips) 
3EBC96: posts small blind $0.05
Edgarlucky: posts big blind $0.10
*** HOLE CARDS ***
maxthebest99: folds 
stylepointxoxo: raises $0.15 to $0.25
vilemo20: folds 
Basile014: raises $0.15 to $0.40
3EBC96: calls $0.35
Edgarlucky: folds 
stylepointxoxo: calls $0.15
*** FLOP *** [9h 3c 4s]
3EBC96: checks 
stylepointxoxo: bets $0.52
Basile014: raises $4.78 to $5.30
3EBC96: folds 
stylepointxoxo: folds 
Uncalled bet ($4.78) returned to Basile014
Basile014 collected $2.23 from pot
Basile014: doesn't show hand 
*** SUMMARY ***
Total pot $2.34 | Rake $0.11 
Board [9h 3c 4s]
Seat 1: maxthebest99 folded before Flop (didn't bet)
Seat 2: stylepointxoxo folded on the Flop
Seat 3: vilemo20 folded before Flop (didn't bet)
Seat 4: Basile014 (button) collected ($2.23)
Seat 5: 3EBC96 (small blind) folded on the Flop
Seat 6: Edgarlucky (big blind) folded before Flop



PokerStars Hand #222953445619:  Hold'em No Limit ($0.05/$0.10 USD) - 2021/01/23 8:27:17 ET
Table 'Stephano III' 6-max Seat #5 is the button
Seat 1: maxthebest99 ($6.76 in chips) 
Seat 2: stylepointxoxo ($10.28 in chips) 
Seat 3: vilemo20 ($10 in chips) 
Seat 4: Basile014 ($12.32 in chips) 
Seat 5: 3EBC96 ($10 in chips) 
Seat 6: Edgarlucky ($17.21 in chips) 
Edgarlucky: posts small blind $0.05
maxthebest99: posts big blind $0.10
*** HOLE CARDS ***
stylepointxoxo: folds 
vilemo20: raises $0.20 to $0.30
Basile014: calls $0.30
3EBC96: folds 
Edgarlucky: folds 
maxthebest99: folds 
*** FLOP *** [9c 8h Ac]
vilemo20: checks 
Basile014: bets $0.10
vilemo20: calls $0.10
*** TURN *** [9c 8h Ac] [Jc]
vilemo20: checks 
Basile014: bets $0.20
vilemo20: calls $0.20
*** RIVER *** [9c 8h Ac Jc] [8s]
vilemo20: checks 
Basile014: bets $0.50
vilemo20: folds 
Uncalled bet ($0.50) returned to Basile014
Basile014 collected $1.29 from pot
Basile014: doesn't show hand 
*** SUMMARY ***
Total pot $1.35 | Rake $0.06 
Board [9c 8h Ac Jc 8s]
Seat 1: maxthebest99 (big blind) folded before Flop
Seat 2: stylepointxoxo folded before Flop (didn't bet)
Seat 3: vilemo20 folded on the River
Seat 4: Basile014 collected ($1.29)
Seat 5: 3EBC96 (button) folded before Flop (didn't bet)
Seat 6: Edgarlucky (small blind) folded before Flop



PokerStars Hand #222953462945:  Hold'em No Limit ($0.05/$0.10 USD) - 2021/01/23 8:27:57 ET
Table 'Stephano III' 6-max Seat #6 is the button
Seat 1: maxthebest99 ($6.66 in chips) 
Seat 2: stylepointxoxo ($10.28 in chips) 
Seat 3: vilemo20 ($10 in chips) 
Seat 4: Basile014 ($13.01 in chips) 
Seat 5: 3EBC96 ($10 in chips) 
Seat 6: Edgarlucky ($17.16 in chips) 
maxthebest99: posts small blind $0.05
stylepointxoxo: posts big blind $0.10
*** HOLE CARDS ***
vilemo20: raises $0.20 to $0.30
Basile014: folds 
3EBC96: folds 
Edgarlucky: folds 
maxthebest99: folds 
stylepointxoxo: calls $0.20
*** FLOP *** [9s Qs 8c]
stylepointxoxo: checks 
vilemo20: bets $0.42
stylepointxoxo: calls $0.42
*** TURN *** [9s Qs 8c] [Td]
stylepointxoxo: checks 
vilemo20: checks 
*** RIVER *** [9s Qs 8c Td] [7d]
stylepointxoxo: checks 
vilemo20: checks 
*** SHOW DOWN ***
stylepointxoxo: shows [9c Ac] (a pair of Nines)
vilemo20: shows [Qc Ks] (a pair of Queens)
vilemo20 collected $1.42 from pot
*** SUMMARY ***
Total pot $1.49 | Rake $0.07 
Board [9s Qs 8c Td 7d]
Seat 1: maxthebest99 (small blind) folded before Flop
Seat 2: stylepointxoxo (big blind) showed [9c Ac] and lost with a pair of Nines
Seat 3: vilemo20 showed [Qc Ks] and won ($1.42) with a pair of Queens
Seat 4: Basile014 folded before Flop (didn't bet)
Seat 5: 3EBC96 folded before Flop (didn't bet)
Seat 6: Edgarlucky (button) folded before Flop (didn't bet)



PokerStars Hand #222953479429:  Hold'em No Limit ($0.05/$0.10 USD) - 2021/01/23 8:28:34 ET
Table 'Stephano III' 6-max Seat #1 is the button
Seat 1: maxthebest99 ($6.61 in chips) 
Seat 2: stylepointxoxo ($10 in chips) 
Seat 3: vilemo20 ($10.70 in chips) 
Seat 4: Basile014 ($13.01 in chips) 
Seat 5: 3EBC96 ($10 in chips) 
Seat 6: Edgarlucky ($17.16 in chips) 
stylepointxoxo: posts small blind $0.05
vilemo20: posts big blind $0.10
*** HOLE CARDS ***
Basile014: calls $0.10
3EBC96: folds 
Edgarlucky: folds 
maxthebest99: folds 
stylepointxoxo: raises $0.30 to $0.40
vilemo20: folds 
Basile014: folds 
Uncalled bet ($0.30) returned to stylepointxoxo
stylepointxoxo collected $0.30 from pot
stylepointxoxo: doesn't show hand 
*** SUMMARY ***
Total pot $0.30 | Rake $0 
Seat 1: maxthebest99 (button) folded before Flop (didn't bet)
Seat 2: stylepointxoxo (small blind) collected ($0.30)
Seat 3: vilemo20 (big blind) folded before Flop
Seat 4: Basile014 folded before Flop
Seat 5: 3EBC96 folded before Flop (didn't bet)
Seat 6: Edgarlucky folded before Flop (didn't bet)



PokerStars Hand #222953489325:  Hold'em No Limit ($0.05/$0.10 USD) - 2021/01/23 8:28:57 ET
Table 'Stephano III' 6-max Seat #2 is the button
Seat 1: maxthebest99 ($6.61 in chips) 
Seat 2: stylepointxoxo ($10.20 in chips) 
Seat 3: vilemo20 ($10.60 in chips) 
Seat 4: Basile014 ($12.91 in chips) 
Seat 5: 3EBC96 ($10 in chips) 
Seat 6: Edgarlucky ($17.16 in chips) 
vilemo20: posts small blind $0.05
Basile014: posts big blind $0.10
*** HOLE CARDS ***
3EBC96: folds 
Edgarlucky: raises $0.15 to $0.25
maxthebest99: folds 
stylepointxoxo: folds 
vilemo20: folds 
Basile014: folds 
Uncalled bet ($0.15) returned to Edgarlucky
Edgarlucky collected $0.25 from pot
Edgarlucky: doesn't show hand 
*** SUMMARY ***
Total pot $0.25 | Rake $0 
Seat 1: maxthebest99 folded before Flop (didn't bet)
Seat 2: stylepointxoxo (button) folded before Flop (didn't bet)
Seat 3: vilemo20 (small blind) folded before Flop
Seat 4: Basile014 (big blind) folded before Flop
Seat 5: 3EBC96 folded before Flop (didn't bet)
Seat 6: Edgarlucky collected ($0.25)



PokerStars Hand #222953496369:  Hold'em No Limit ($0.05/$0.10 USD) - 2021/01/23 8:29:13 ET
Table 'Stephano III' 6-max Seat #3 is the button
Seat 1: maxthebest99 ($6.61 in chips) 
Seat 2: stylepointxoxo ($10.20 in chips) 
Seat 3: vilemo20 ($10.55 in chips) 
Seat 4: Basile014 ($12.81 in chips) 
Seat 5: 3EBC96 ($10 in chips) 
Seat 6: Edgarlucky ($17.31 in chips) 
Basile014: posts small blind $0.05
3EBC96: posts big blind $0.10
*** HOLE CARDS ***
Edgarlucky: folds 
maxthebest99: folds 
stylepointxoxo: folds 
vilemo20: raises $0.15 to $0.25
Basile014: folds 
3EBC96: raises $0.75 to $1
vilemo20: folds 
Uncalled bet ($0.75) returned to 3EBC96
3EBC96 collected $0.55 from pot
3EBC96: doesn't show hand 
*** SUMMARY ***
Total pot $0.55 | Rake $0 
Seat 1: maxthebest99 folded before Flop (didn't bet)
Seat 2: stylepointxoxo folded before Flop (didn't bet)
Seat 3: vilemo20 (button) folded before Flop
Seat 4: Basile014 (small blind) folded before Flop
Seat 5: 3EBC96 (big blind) collected ($0.55)
Seat 6: Edgarlucky folded before Flop (didn't bet)



PokerStars Hand #222953508101:  Hold'em No Limit ($0.05/$0.10 USD) - 2021/01/23 8:29:40 ET
Table 'Stephano III' 6-max Seat #4 is the button
Seat 1: maxthebest99 ($6.61 in chips) 
Seat 2: stylepointxoxo ($10.20 in chips) 
Seat 3: vilemo20 ($10.30 in chips) 
Seat 4: Basile014 ($12.76 in chips) 
Seat 5: 3EBC96 ($10.30 in chips) 
Seat 6: Edgarlucky ($17.31 in chips) 
3EBC96: posts small blind $0.05
Edgarlucky: posts big blind $0.10
*** HOLE CARDS ***
maxthebest99: folds 
stylepointxoxo: raises $0.15 to $0.25
vilemo20: folds 
Basile014: folds 
3EBC96: folds 
Edgarlucky: folds 
Uncalled bet ($0.15) returned to stylepointxoxo
stylepointxoxo collected $0.25 from pot
stylepointxoxo: doesn't show hand 
*** SUMMARY ***
Total pot $0.25 | Rake $0 
Seat 1: maxthebest99 folded before Flop (didn't bet)
Seat 2: stylepointxoxo collected ($0.25)
Seat 3: vilemo20 folded before Flop (didn't bet)
Seat 4: Basile014 (button) folded before Flop (didn't bet)
Seat 5: 3EBC96 (small blind) folded before Flop
Seat 6: Edgarlucky (big blind) folded before Flop



PokerStars Hand #222953515927:  Hold'em No Limit ($0.05/$0.10 USD) - 2021/01/23 8:29:58 ET
Table 'Stephano III' 6-max Seat #5 is the button
Seat 1: maxthebest99 ($6.61 in chips) 
Seat 2: stylepointxoxo ($10.35 in chips) 
Seat 3: vilemo20 ($10.30 in chips) 
Seat 4: Basile014 ($12.76 in chips) 
Seat 5: 3EBC96 ($10.25 in chips) 
Seat 6: Edgarlucky ($17.21 in chips) 
Edgarlucky: posts small blind $0.05
maxthebest99: posts big blind $0.10
*** HOLE CARDS ***
stylepointxoxo: folds 
vilemo20: folds 
Basile014: folds 
3EBC96: folds 
Edgarlucky: folds 
Uncalled bet ($0.05) returned to maxthebest99
maxthebest99 collected $0.10 from pot
maxthebest99: doesn't show hand 
*** SUMMARY ***
Total pot $0.10 | Rake $0 
Seat 1: maxthebest99 (big blind) collected ($0.10)
Seat 2: stylepointxoxo folded before Flop (didn't bet)
Seat 3: vilemo20 folded before Flop (didn't bet)
Seat 4: Basile014 folded before Flop (didn't bet)
Seat 5: 3EBC96 (button) folded before Flop (didn't bet)
Seat 6: Edgarlucky (small blind) folded before Flop



PokerStars Hand #222953521348:  Hold'em No Limit ($0.05/$0.10 USD) - 2021/01/23 8:30:10 ET
Table 'Stephano III' 6-max Seat #6 is the button
Seat 1: maxthebest99 ($6.66 in chips) 
Seat 2: stylepointxoxo ($10.35 in chips) 
Seat 3: vilemo20 ($10.30 in chips) 
Seat 4: Basile014 ($12.76 in chips) 
Seat 5: 3EBC96 ($10.25 in chips) 
Seat 6: Edgarlucky ($17.16 in chips) 
maxthebest99: posts small blind $0.05
stylepointxoxo: posts big blind $0.10
*** HOLE CARDS ***
vilemo20: folds 
Basile014: folds 
3EBC96: folds 
Edgarlucky: raises $0.15 to $0.25
maxthebest99: calls $0.20
stylepointxoxo: folds 
*** FLOP *** [Kd Kc 8c]
maxthebest99: checks 
Edgarlucky: bets $0.19
maxthebest99: folds 
Uncalled bet ($0.19) returned to Edgarlucky
Edgarlucky collected $0.57 from pot
Edgarlucky: doesn't show hand 
*** SUMMARY ***
Total pot $0.60 | Rake $0.03 
Board [Kd Kc 8c]
Seat 1: maxthebest99 (small blind) folded on the Flop
Seat 2: stylepointxoxo (big blind) folded before Flop
Seat 3: vilemo20 folded before Flop (didn't bet)
Seat 4: Basile014 folded before Flop (didn't bet)
Seat 5: 3EBC96 folded before Flop (didn't bet)
Seat 6: Edgarlucky (button) collected ($0.57)



PokerStars Hand #222953531667:  Hold'em No Limit ($0.05/$0.10 USD) - 2021/01/23 8:30:33 ET
Table 'Stephano III' 6-max Seat #1 is the button
Seat 1: maxthebest99 ($6.41 in chips) 
Seat 2: stylepointxoxo ($10.25 in chips) 
Seat 3: vilemo20 ($10.30 in chips) 
Seat 4: Basile014 ($12.76 in chips) 
Seat 5: 3EBC96 ($10.25 in chips) 
Seat 6: Edgarlucky ($17.48 in chips) 
stylepointxoxo: posts small blind $0.05
vilemo20: posts big blind $0.10
*** HOLE CARDS ***
Basile014: calls $0.10
3EBC96: folds 
Edgarlucky: raises $0.30 to $0.40
maxthebest99: folds 
stylepointxoxo: folds 
vilemo20: folds 
Basile014: calls $0.30
*** FLOP *** [2c Js Ts]
Basile014: checks 
Edgarlucky: bets $0.70
Basile014: calls $0.70
*** TURN *** [2c Js Ts] [6d]
Basile014: checks 
Edgarlucky: bets $1.72
Basile014: calls $1.72
*** RIVER *** [2c Js Ts 6d] [2s]
Basile014: checks 
Edgarlucky: checks 
*** SHOW DOWN ***
Basile014: shows [Qh Qs] (two pair, Queens and Deuces)
Edgarlucky: mucks hand 
Basile014 collected $5.53 from pot
*** SUMMARY ***
Total pot $5.79 | Rake $0.26 
Board [2c Js Ts 6d 2s]
Seat 1: maxthebest99 (button) folded before Flop (didn't bet)
Seat 2: stylepointxoxo (small blind) folded before Flop
Seat 3: vilemo20 (big blind) folded before Flop
Seat 4: Basile014 showed [Qh Qs] and won ($5.53) with two pair, Queens and Deuces
Seat 5: 3EBC96 folded before Flop (didn't bet)
Seat 6: Edgarlucky mucked



PokerStars Hand #222953549888:  Hold'em No Limit ($0.05/$0.10 USD) - 2021/01/23 8:31:14 ET
Table 'Stephano III' 6-max Seat #2 is the button
Seat 1: maxthebest99 ($6.41 in chips) 
Seat 2: stylepointxoxo ($10.20 in chips) 
Seat 3: vilemo20 ($10.20 in chips) 
Seat 4: Basile014 ($15.47 in chips) 
Seat 6: Edgarlucky ($14.66 in chips) 
vilemo20: posts small blind $0.05
Basile014: posts big blind $0.10
*** HOLE CARDS ***
Edgarlucky: folds 
maxthebest99: folds 
stylepointxoxo: folds 
vilemo20: folds 
Uncalled bet ($0.05) returned to Basile014
Basile014 collected $0.10 from pot
Basile014: doesn't show hand 
*** SUMMARY ***
Total pot $0.10 | Rake $0 
Seat 1: maxthebest99 folded before Flop (didn't bet)
Seat 2: stylepointxoxo (button) folded before Flop (didn't bet)
Seat 3: vilemo20 (small blind) folded before Flop
Seat 4: Basile014 (big blind) collected ($0.10)
Seat 6: Edgarlucky folded before Flop (didn't bet)



PokerStars Hand #222953558051:  Hold'em No Limit ($0.05/$0.10 USD) - 2021/01/23 8:31:33 ET
Table 'Stephano III' 6-max Seat #3 is the button
Seat 1: maxthebest99 ($6.41 in chips) 
Seat 2: stylepointxoxo ($10.20 in chips) 
Seat 3: vilemo20 ($10.15 in chips) 
Seat 4: Basile014 ($15.52 in chips) 
Seat 6: Edgarlucky ($14.66 in chips) 
Basile014: posts small blind $0.05
Edgarlucky: posts big blind $0.10
*** HOLE CARDS ***
maxthebest99: calls $0.10
stylepointxoxo: raises $0.30 to $0.40
vilemo20: folds 
Basile014: folds 
Edgarlucky: folds 
maxthebest99: folds 
Uncalled bet ($0.30) returned to stylepointxoxo
stylepointxoxo collected $0.35 from pot
stylepointxoxo: doesn't show hand 
*** SUMMARY ***
Total pot $0.35 | Rake $0 
Seat 1: maxthebest99 folded before Flop
Seat 2: stylepointxoxo collected ($0.35)
Seat 3: vilemo20 (button) folded before Flop (didn't bet)
Seat 4: Basile014 (small blind) folded before Flop
Seat 6: Edgarlucky (big blind) folded before Flop



PokerStars Hand #222953567611:  Hold'em No Limit ($0.05/$0.10 USD) - 2021/01/23 8:31:54 ET
Table 'Stephano III' 6-max Seat #4 is the button
Seat 1: maxthebest99 ($6.31 in chips) 
Seat 2: stylepointxoxo ($10.45 in chips) 
Seat 3: vilemo20 ($10.15 in chips) 
Seat 4: Basile014 ($15.47 in chips) 
Seat 6: Edgarlucky ($14.56 in chips) 
Edgarlucky: posts small blind $0.05
maxthebest99: posts big blind $0.10
*** HOLE CARDS ***
stylepointxoxo: raises $0.15 to $0.25
vilemo20: folds 
Basile014: calls $0.25
Edgarlucky: folds 
maxthebest99: folds 
*** FLOP *** [Tc 7d Kd]
stylepointxoxo: bets $0.30
Basile014: calls $0.30
*** TURN *** [Tc 7d Kd] [2s]
stylepointxoxo: bets $0.88
Basile014: folds 
Uncalled bet ($0.88) returned to stylepointxoxo
stylepointxoxo collected $1.19 from pot
stylepointxoxo: doesn't show hand 
*** SUMMARY ***
Total pot $1.25 | Rake $0.06 
Board [Tc 7d Kd 2s]
Seat 1: maxthebest99 (big blind) folded before Flop
Seat 2: stylepointxoxo collected ($1.19)
Seat 3: vilemo20 folded before Flop (didn't bet)
Seat 4: Basile014 (button) folded on the Turn
Seat 6: Edgarlucky (small blind) folded before Flop



PokerStars Hand #222953582423:  Hold'em No Limit ($0.05/$0.10 USD) - 2021/01/23 8:32:27 ET
Table 'Stephano III' 6-max Seat #6 is the button
Seat 1: maxthebest99 ($6.21 in chips) 
Seat 2: stylepointxoxo ($11.09 in chips) 
Seat 3: vilemo20 ($10.15 in chips) 
Seat 4: Basile014 ($14.92 in chips) 
Seat 6: Edgarlucky ($14.51 in chips) 
maxthebest99: posts small blind $0.05
stylepointxoxo: posts big blind $0.10
3EBC96: sits out 
*** HOLE CARDS ***
vilemo20: folds 
Basile014: calls $0.10
Edgarlucky: folds 
maxthebest99: calls $0.05
stylepointxoxo: checks 
*** FLOP *** [6s 9h 9d]
maxthebest99: bets $0.20
stylepointxoxo: folds 
Basile014: folds 
Uncalled bet ($0.20) returned to maxthebest99
maxthebest99 collected $0.29 from pot
maxthebest99: doesn't show hand 
*** SUMMARY ***
Total pot $0.30 | Rake $0.01 
Board [6s 9h 9d]
Seat 1: maxthebest99 (small blind) collected ($0.29)
Seat 2: stylepointxoxo (big blind) folded on the Flop
Seat 3: vilemo20 folded before Flop (didn't bet)
Seat 4: Basile014 folded on the Flop
Seat 6: Edgarlucky (button) folded before Flop (didn't bet)



PokerStars Hand #222953591425:  Hold'em No Limit ($0.05/$0.10 USD) - 2021/01/23 8:32:48 ET
Table 'Stephano III' 6-max Seat #1 is the button
Seat 1: maxthebest99 ($6.40 in chips) 
Seat 2: stylepointxoxo ($10.99 in chips) 
Seat 3: vilemo20 ($10.15 in chips) 
Seat 4: Basile014 ($14.82 in chips) 
Seat 6: Edgarlucky ($14.51 in chips) 
stylepointxoxo: posts small blind $0.05
vilemo20: posts big blind $0.10
3EBC96: sits out 
*** HOLE CARDS ***
Basile014: calls $0.10
Edgarlucky: raises $0.30 to $0.40
maxthebest99: folds 
stylepointxoxo: folds 
vilemo20: folds 
Basile014: calls $0.30
*** FLOP *** [Qh 3c 7h]
Basile014: checks 
Edgarlucky: bets $0.30
Basile014: folds 
Uncalled bet ($0.30) returned to Edgarlucky
Edgarlucky collected $0.91 from pot
Edgarlucky: doesn't show hand 
*** SUMMARY ***
Total pot $0.95 | Rake $0.04 
Board [Qh 3c 7h]
Seat 1: maxthebest99 (button) folded before Flop (didn't bet)
Seat 2: stylepointxoxo (small blind) folded before Flop
Seat 3: vilemo20 (big blind) folded before Flop
Seat 4: Basile014 folded on the Flop
Seat 6: Edgarlucky collected ($0.91)



PokerStars Hand #222953601625:  Hold'em No Limit ($0.05/$0.10 USD) - 2021/01/23 8:33:11 ET
Table 'Stephano III' 6-max Seat #2 is the button
Seat 1: maxthebest99 ($6.40 in chips) 
Seat 2: stylepointxoxo ($10.94 in chips) 
Seat 3: vilemo20 ($10.05 in chips) 
Seat 4: Basile014 ($14.42 in chips) 
Seat 6: Edgarlucky ($15.02 in chips) 
vilemo20: posts small blind $0.05
Basile014: posts big blind $0.10
3EBC96: sits out 
*** HOLE CARDS ***
Edgarlucky: folds 
maxthebest99: calls $0.10
stylepointxoxo: folds 
vilemo20: folds 
Basile014: checks 
*** FLOP *** [8c 9d Th]
Basile014: checks 
maxthebest99: bets $0.20
Basile014: calls $0.20
*** TURN *** [8c 9d Th] [9c]
Basile014: checks 
maxthebest99: checks 
*** RIVER *** [8c 9d Th 9c] [3s]
Basile014: checks 
maxthebest99: checks 
*** SHOW DOWN ***
Basile014: shows [5d 7h] (a pair of Nines)
maxthebest99: shows [2s 2c] (two pair, Nines and Deuces)
maxthebest99 collected $0.62 from pot
*** SUMMARY ***
Total pot $0.65 | Rake $0.03 
Board [8c 9d Th 9c 3s]
Seat 1: maxthebest99 showed [2s 2c] and won ($0.62) with two pair, Nines and Deuces
Seat 2: stylepointxoxo (button) folded before Flop (didn't bet)
Seat 3: vilemo20 (small blind) folded before Flop
Seat 4: Basile014 (big blind) showed [5d 7h] and lost with a pair of Nines
Seat 6: Edgarlucky folded before Flop (didn't bet)



PokerStars Hand #222953614500:  Hold'em No Limit ($0.05/$0.10 USD) - 2021/01/23 8:33:40 ET
Table 'Stephano III' 6-max Seat #3 is the button
Seat 1: maxthebest99 ($6.72 in chips) 
Seat 2: stylepointxoxo ($10.94 in chips) 
Seat 3: vilemo20 ($10 in chips) 
Seat 4: Basile014 ($14.12 in chips) 
Seat 5: 3EBC96 ($10.25 in chips) 
Seat 6: Edgarlucky ($15.02 in chips) 
Basile014: posts small blind $0.05
3EBC96: posts big blind $0.10
*** HOLE CARDS ***
Edgarlucky: folds 
maxthebest99: folds 
stylepointxoxo: raises $0.15 to $0.25
vilemo20: folds 
Basile014: raises $0.15 to $0.40
3EBC96: calls $0.30
stylepointxoxo: calls $0.15
*** FLOP *** [Jh 7d Jc]
Basile014: bets $2.10
3EBC96: folds 
stylepointxoxo: folds 
Uncalled bet ($2.10) returned to Basile014
Basile014 collected $1.15 from pot
Basile014: doesn't show hand 
*** SUMMARY ***
Total pot $1.20 | Rake $0.05 
Board [Jh 7d Jc]
Seat 1: maxthebest99 folded before Flop (didn't bet)
Seat 2: stylepointxoxo folded on the Flop
Seat 3: vilemo20 (button) folded before Flop (didn't bet)
Seat 4: Basile014 (small blind) collected ($1.15)
Seat 5: 3EBC96 (big blind) folded on the Flop
Seat 6: Edgarlucky folded before Flop (didn't bet)



PokerStars Hand #222953635143:  Hold'em No Limit ($0.05/$0.10 USD) - 2021/01/23 8:34:26 ET
Table 'Stephano III' 6-max Seat #4 is the button
Seat 1: maxthebest99 ($6.72 in chips) 
Seat 2: stylepointxoxo ($10.54 in chips) 
Seat 3: vilemo20 ($10 in chips) 
Seat 4: Basile014 ($14.87 in chips) 
Seat 5: 3EBC96 ($10 in chips) 
Seat 6: Edgarlucky ($15.02 in chips) 
3EBC96: posts small blind $0.05
Edgarlucky: posts big blind $0.10
*** HOLE CARDS ***
maxthebest99: folds 
stylepointxoxo: folds 
vilemo20: folds 
Basile014: calls $0.10
3EBC96: folds 
Edgarlucky: raises $0.40 to $0.50
Basile014: folds 
Uncalled bet ($0.40) returned to Edgarlucky
Edgarlucky collected $0.25 from pot
Edgarlucky: doesn't show hand 
*** SUMMARY ***
Total pot $0.25 | Rake $0 
Seat 1: maxthebest99 folded before Flop (didn't bet)
Seat 2: stylepointxoxo folded before Flop (didn't bet)
Seat 3: vilemo20 folded before Flop (didn't bet)
Seat 4: Basile014 (button) folded before Flop
Seat 5: 3EBC96 (small blind) folded before Flop
Seat 6: Edgarlucky (big blind) collected ($0.25)



PokerStars Hand #222953645456:  Hold'em No Limit ($0.05/$0.10 USD) - 2021/01/23 8:34:48 ET
Table 'Stephano III' 6-max Seat #5 is the button
Seat 2: stylepointxoxo ($10.54 in chips) 
Seat 3: vilemo20 ($10 in chips) 
Seat 4: Basile014 ($14.77 in chips) 
Seat 5: 3EBC96 ($10 in chips) 
Seat 6: Edgarlucky ($15.17 in chips) 
Edgarlucky: posts small blind $0.05
maxthebest99 has timed out
maxthebest99: is sitting out 
stylepointxoxo: posts big blind $0.10
*** HOLE CARDS ***
vilemo20: folds 
Basile014: calls $0.10
3EBC96: folds 
Edgarlucky: folds 
maxthebest99 is disconnected 
stylepointxoxo: checks 
*** FLOP *** [Ts 9d 9c]
stylepointxoxo: checks 
Basile014: checks 
*** TURN *** [Ts 9d 9c] [5d]
stylepointxoxo: checks 
Basile014: checks 
*** RIVER *** [Ts 9d 9c 5d] [Ks]
stylepointxoxo: checks 
Basile014: bets $0.40
stylepointxoxo: folds 
Uncalled bet ($0.40) returned to Basile014
Basile014 collected $0.24 from pot
Basile014: doesn't show hand 
*** SUMMARY ***
Total pot $0.25 | Rake $0.01 
Board [Ts 9d 9c 5d Ks]
Seat 2: stylepointxoxo (big blind) folded on the River
Seat 3: vilemo20 folded before Flop (didn't bet)
Seat 4: Basile014 collected ($0.24)
Seat 5: 3EBC96 (button) folded before Flop (didn't bet)
Seat 6: Edgarlucky (small blind) folded before Flop



PokerStars Hand #222953672129:  Hold'em No Limit ($0.05/$0.10 USD) - 2021/01/23 8:35:49 ET
Table 'Stephano III' 6-max Seat #6 is the button
Seat 2: stylepointxoxo ($10.44 in chips) 
Seat 3: vilemo20 ($10 in chips) 
Seat 4: Basile014 ($14.91 in chips) 
Seat 5: 3EBC96 ($10 in chips) 
Seat 6: Edgarlucky ($15.12 in chips) 
stylepointxoxo: posts small blind $0.05
vilemo20: posts big blind $0.10
*** HOLE CARDS ***
Basile014: calls $0.10
3EBC96: folds 
Edgarlucky: calls $0.10
stylepointxoxo: raises $0.40 to $0.50
vilemo20: folds 
Basile014: folds 
Edgarlucky: folds 
Uncalled bet ($0.40) returned to stylepointxoxo
stylepointxoxo collected $0.40 from pot
stylepointxoxo: doesn't show hand 
*** SUMMARY ***
Total pot $0.40 | Rake $0 
Seat 2: stylepointxoxo (small blind) collected ($0.40)
Seat 3: vilemo20 (big blind) folded before Flop
Seat 4: Basile014 folded before Flop
Seat 5: 3EBC96 folded before Flop (didn't bet)
Seat 6: Edgarlucky (button) folded before Flop



PokerStars Hand #222953679607:  Hold'em No Limit ($0.05/$0.10 USD) - 2021/01/23 8:36:05 ET
Table 'Stephano III' 6-max Seat #2 is the button
Seat 2: stylepointxoxo ($10.74 in chips) 
Seat 3: vilemo20 ($10 in chips) 
Seat 4: Basile014 ($14.81 in chips) 
Seat 5: 3EBC96 ($10 in chips) 
Seat 6: Edgarlucky ($15.02 in chips) 
vilemo20: posts small blind $0.05
Basile014: posts big blind $0.10
maxthebest99: sits out 
*** HOLE CARDS ***
3EBC96: folds 
Edgarlucky: folds 
stylepointxoxo: raises $0.15 to $0.25
vilemo20: folds 
Basile014: calls $0.15
*** FLOP *** [2c Qh 7d]
Basile014: bets $0.30
stylepointxoxo: folds 
Uncalled bet ($0.30) returned to Basile014
Basile014 collected $0.53 from pot
Basile014: doesn't show hand 
*** SUMMARY ***
Total pot $0.55 | Rake $0.02 
Board [2c Qh 7d]
Seat 2: stylepointxoxo (button) folded on the Flop
Seat 3: vilemo20 (small blind) folded before Flop
Seat 4: Basile014 (big blind) collected ($0.53)
Seat 5: 3EBC96 folded before Flop (didn't bet)
Seat 6: Edgarlucky folded before Flop (didn't bet)



PokerStars Hand #222953689442:  Hold'em No Limit ($0.05/$0.10 USD) - 2021/01/23 8:36:28 ET
Table 'Stephano III' 6-max Seat #3 is the button
Seat 1: maxthebest99 ($6.72 in chips) 
Seat 2: stylepointxoxo ($10.49 in chips) 
Seat 3: vilemo20 ($10 in chips) 
Seat 4: Basile014 ($15.09 in chips) 
Seat 5: 3EBC96 ($10 in chips) 
Seat 6: Edgarlucky ($15.02 in chips) 
Basile014: posts small blind $0.05
3EBC96: posts big blind $0.10
maxthebest99: posts small & big blinds $0.15
*** HOLE CARDS ***
Edgarlucky: folds 
maxthebest99: checks 
stylepointxoxo has timed out
stylepointxoxo: folds 
vilemo20: raises $0.40 to $0.50
Basile014: folds 
3EBC96: folds 
maxthebest99: folds 
Uncalled bet ($0.40) returned to vilemo20
vilemo20 collected $0.40 from pot
vilemo20: doesn't show hand 
*** SUMMARY ***
Total pot $0.40 | Rake $0 
Seat 1: maxthebest99 folded before Flop (didn't bet)
Seat 2: stylepointxoxo folded before Flop (didn't bet)
Seat 3: vilemo20 (button) collected ($0.40)
Seat 4: Basile014 (small blind) folded before Flop
Seat 5: 3EBC96 (big blind) folded before Flop
Seat 6: Edgarlucky folded before Flop (didn't bet)



PokerStars Hand #222953703575:  Hold'em No Limit ($0.05/$0.10 USD) - 2021/01/23 8:37:00 ET
Table 'Stephano III' 6-max Seat #4 is the button
Seat 1: maxthebest99 ($6.57 in chips) 
Seat 2: stylepointxoxo ($10.49 in chips) 
Seat 3: vilemo20 ($10.30 in chips) 
Seat 4: Basile014 ($15.04 in chips) 
Seat 5: 3EBC96 ($10 in chips) 
Seat 6: Edgarlucky ($15.02 in chips) 
3EBC96: posts small blind $0.05
Edgarlucky: posts big blind $0.10
*** HOLE CARDS ***
maxthebest99: calls $0.10
stylepointxoxo has timed out
stylepointxoxo: folds 
vilemo20: raises $0.30 to $0.40
Basile014: calls $0.40
3EBC96: raises $1.20 to $1.60
Edgarlucky: folds 
maxthebest99: folds 
vilemo20: folds 
Basile014: folds 
Uncalled bet ($1.20) returned to 3EBC96
3EBC96 collected $1.40 from pot
3EBC96: doesn't show hand 
*** SUMMARY ***
Total pot $1.40 | Rake $0 
Seat 1: maxthebest99 folded before Flop
Seat 2: stylepointxoxo folded before Flop (didn't bet)
Seat 3: vilemo20 folded before Flop
Seat 4: Basile014 (button) folded before Flop
Seat 5: 3EBC96 (small blind) collected ($1.40)
Seat 6: Edgarlucky (big blind) folded before Flop



PokerStars Hand #222953723290:  Hold'em No Limit ($0.05/$0.10 USD) - 2021/01/23 8:37:44 ET
Table 'Stephano III' 6-max Seat #5 is the button
Seat 1: maxthebest99 ($6.47 in chips) 
Seat 2: stylepointxoxo ($10.49 in chips) 
Seat 3: vilemo20 ($10 in chips) 
Seat 4: Basile014 ($14.64 in chips) 
Seat 5: 3EBC96 ($11 in chips) 
Seat 6: Edgarlucky ($14.92 in chips) 
Edgarlucky: posts small blind $0.05
maxthebest99: posts big blind $0.10
*** HOLE CARDS ***
stylepointxoxo: folds 
vilemo20: folds 
Basile014: calls $0.10
3EBC96: folds 
Edgarlucky: raises $0.35 to $0.45
maxthebest99: raises $0.55 to $1
Basile014: calls $0.90
Edgarlucky: calls $0.55
*** FLOP *** [Qd 9c 4d]
Edgarlucky: checks 
maxthebest99: bets $5.47 and is all-in
Basile014: folds 
Edgarlucky: calls $5.47
*** TURN *** [Qd 9c 4d] [6d]
*** RIVER *** [Qd 9c 4d 6d] [5h]
*** SHOW DOWN ***
Edgarlucky: shows [Td Tc] (a pair of Tens)
maxthebest99: shows [Ad Ac] (a pair of Aces)
maxthebest99 collected $13.31 from pot
*** SUMMARY ***
Total pot $13.94 | Rake $0.63 
Board [Qd 9c 4d 6d 5h]
Seat 1: maxthebest99 (big blind) showed [Ad Ac] and won ($13.31) with a pair of Aces
Seat 2: stylepointxoxo folded before Flop (didn't bet)
Seat 3: vilemo20 folded before Flop (didn't bet)
Seat 4: Basile014 folded on the Flop
Seat 5: 3EBC96 (button) folded before Flop (didn't bet)
Seat 6: Edgarlucky (small blind) showed [Td Tc] and lost with a pair of Tens



PokerStars Hand #222953752068:  Hold'em No Limit ($0.05/$0.10 USD) - 2021/01/23 8:38:49 ET
Table 'Stephano III' 6-max Seat #6 is the button
Seat 1: maxthebest99 ($13.31 in chips) 
Seat 2: stylepointxoxo ($10.49 in chips) 
Seat 3: vilemo20 ($10 in chips) 
Seat 4: Basile014 ($13.64 in chips) 
Seat 5: 3EBC96 ($11 in chips) 
Seat 6: Edgarlucky ($10 in chips) 
maxthebest99: posts small blind $0.05
stylepointxoxo: posts big blind $0.10
*** HOLE CARDS ***
vilemo20: raises $0.20 to $0.30
Basile014: folds 
3EBC96: folds 
Edgarlucky: folds 
maxthebest99: calls $0.25
stylepointxoxo: folds 
*** FLOP *** [3h 6h 9h]
maxthebest99: checks 
vilemo20: bets $0.35
maxthebest99: calls $0.35
*** TURN *** [3h 6h 9h] [4h]
maxthebest99: checks 
vilemo20: checks 
*** RIVER *** [3h 6h 9h 4h] [Th]
maxthebest99: bets $0.60
vilemo20: folds 
Uncalled bet ($0.60) returned to maxthebest99
maxthebest99 collected $1.34 from pot
maxthebest99: doesn't show hand 
*** SUMMARY ***
Total pot $1.40 | Rake $0.06 
Board [3h 6h 9h 4h Th]
Seat 1: maxthebest99 (small blind) collected ($1.34)
Seat 2: stylepointxoxo (big blind) folded before Flop
Seat 3: vilemo20 folded on the River
Seat 4: Basile014 folded before Flop (didn't bet)
Seat 5: 3EBC96 folded before Flop (didn't bet)
Seat 6: Edgarlucky (button) folded before Flop (didn't bet)



PokerStars Hand #222953779952:  Hold'em No Limit ($0.05/$0.10 USD) - 2021/01/23 8:39:51 ET
Table 'Stephano III' 6-max Seat #1 is the button
Seat 1: maxthebest99 ($14 in chips) 
Seat 2: stylepointxoxo ($10.39 in chips) 
Seat 3: vilemo20 ($10 in chips) 
Seat 4: Basile014 ($13.64 in chips) 
Seat 5: 3EBC96 ($11 in chips) 
Seat 6: Edgarlucky ($10 in chips) 
stylepointxoxo: posts small blind $0.05
vilemo20: posts big blind $0.10
*** HOLE CARDS ***
Basile014: folds 
3EBC96: folds 
Edgarlucky: folds 
maxthebest99: folds 
stylepointxoxo: folds 
Uncalled bet ($0.05) returned to vilemo20
vilemo20 collected $0.10 from pot
vilemo20: doesn't show hand 
*** SUMMARY ***
Total pot $0.10 | Rake $0 
Seat 1: maxthebest99 (button) folded before Flop (didn't bet)
Seat 2: stylepointxoxo (small blind) folded before Flop
Seat 3: vilemo20 (big blind) collected ($0.10)
Seat 4: Basile014 folded before Flop (didn't bet)
Seat 5: 3EBC96 folded before Flop (didn't bet)
Seat 6: Edgarlucky folded before Flop (didn't bet)



PokerStars Hand #222953784506:  Hold'em No Limit ($0.05/$0.10 USD) - 2021/01/23 8:40:01 ET
Table 'Stephano III' 6-max Seat #2 is the button
Seat 1: maxthebest99 ($14 in chips) 
Seat 2: stylepointxoxo ($10.34 in chips) 
Seat 3: vilemo20 ($10.05 in chips) 
Seat 4: Basile014 ($13.64 in chips) 
Seat 5: 3EBC96 ($11 in chips) 
Seat 6: Edgarlucky ($10 in chips) 
vilemo20: posts small blind $0.05
Basile014: posts big blind $0.10
*** HOLE CARDS ***
3EBC96: raises $0.20 to $0.30
Edgarlucky: folds 
maxthebest99: calls $0.30
stylepointxoxo: folds 
vilemo20: folds 
Basile014: calls $0.20
*** FLOP *** [Qs Js 7d]
Basile014: checks 
3EBC96: checks 
maxthebest99: bets $0.20
Basile014: calls $0.20
3EBC96: calls $0.20
*** TURN *** [Qs Js 7d] [2d]
Basile014: checks 
3EBC96: checks 
maxthebest99: checks 
*** RIVER *** [Qs Js 7d 2d] [6h]
Basile014: checks 
3EBC96: checks 
maxthebest99: checks 
*** SHOW DOWN ***
Basile014: shows [7c Ts] (a pair of Sevens)
3EBC96: shows [Jd Ac] (a pair of Jacks)
maxthebest99: mucks hand 
3EBC96 collected $1.48 from pot
*** SUMMARY ***
Total pot $1.55 | Rake $0.07 
Board [Qs Js 7d 2d 6h]
Seat 1: maxthebest99 mucked
Seat 2: stylepointxoxo (button) folded before Flop (didn't bet)
Seat 3: vilemo20 (small blind) folded before Flop
Seat 4: Basile014 (big blind) showed [7c Ts] and lost with a pair of Sevens
Seat 5: 3EBC96 showed [Jd Ac] and won ($1.48) with a pair of Jacks
Seat 6: Edgarlucky folded before Flop (didn't bet)



PokerStars Hand #222953802457:  Hold'em No Limit ($0.05/$0.10 USD) - 2021/01/23 8:40:41 ET
Table 'Stephano III' 6-max Seat #3 is the button
Seat 1: maxthebest99 ($13.50 in chips) 
Seat 2: stylepointxoxo ($10.34 in chips) 
Seat 3: vilemo20 ($10 in chips) 
Seat 4: Basile014 ($13.14 in chips) 
Seat 5: 3EBC96 ($11.98 in chips) 
Seat 6: Edgarlucky ($10 in chips) 
Basile014: posts small blind $0.05
3EBC96: posts big blind $0.10
*** HOLE CARDS ***
Edgarlucky: folds 
maxthebest99: folds 
stylepointxoxo: folds 
vilemo20: folds 
Basile014: calls $0.05
3EBC96: checks 
*** FLOP *** [7d 9h 9s]
Basile014: checks 
3EBC96: bets $0.30
Basile014: folds 
Uncalled bet ($0.30) returned to 3EBC96
3EBC96 collected $0.19 from pot
3EBC96: doesn't show hand 
*** SUMMARY ***
Total pot $0.20 | Rake $0.01 
Board [7d 9h 9s]
Seat 1: maxthebest99 folded before Flop (didn't bet)
Seat 2: stylepointxoxo folded before Flop (didn't bet)
Seat 3: vilemo20 (button) folded before Flop (didn't bet)
Seat 4: Basile014 (small blind) folded on the Flop
Seat 5: 3EBC96 (big blind) collected ($0.19)
Seat 6: Edgarlucky folded before Flop (didn't bet)



PokerStars Hand #222953811614:  Hold'em No Limit ($0.05/$0.10 USD) - 2021/01/23 8:41:01 ET
Table 'Stephano III' 6-max Seat #4 is the button
Seat 1: maxthebest99 ($13.50 in chips) 
Seat 2: stylepointxoxo ($10.34 in chips) 
Seat 3: vilemo20 ($10 in chips) 
Seat 4: Basile014 ($13.04 in chips) 
Seat 5: 3EBC96 ($12.07 in chips) 
Seat 6: Edgarlucky ($10 in chips) 
3EBC96: posts small blind $0.05
Edgarlucky: posts big blind $0.10
*** HOLE CARDS ***
maxthebest99: folds 
stylepointxoxo: folds 
vilemo20: folds 
Basile014: folds 
3EBC96: folds 
Uncalled bet ($0.05) returned to Edgarlucky
Edgarlucky collected $0.10 from pot
Edgarlucky: doesn't show hand 
*** SUMMARY ***
Total pot $0.10 | Rake $0 
Seat 1: maxthebest99 folded before Flop (didn't bet)
Seat 2: stylepointxoxo folded before Flop (didn't bet)
Seat 3: vilemo20 folded before Flop (didn't bet)
Seat 4: Basile014 (button) folded before Flop (didn't bet)
Seat 5: 3EBC96 (small blind) folded before Flop
Seat 6: Edgarlucky (big blind) collected ($0.10)



PokerStars Hand #222953816284:  Hold'em No Limit ($0.05/$0.10 USD) - 2021/01/23 8:41:12 ET
Table 'Stephano III' 6-max Seat #5 is the button
Seat 1: maxthebest99 ($13.50 in chips) 
Seat 2: stylepointxoxo ($10.34 in chips) 
Seat 3: vilemo20 ($10 in chips) 
Seat 4: Basile014 ($13.04 in chips) 
Seat 5: 3EBC96 ($12.02 in chips) 
Seat 6: Edgarlucky ($10.05 in chips) 
Edgarlucky: posts small blind $0.05
maxthebest99: posts big blind $0.10
*** HOLE CARDS ***
stylepointxoxo: raises $0.15 to $0.25
vilemo20: folds 
Basile014: calls $0.25
3EBC96: folds 
Edgarlucky: folds 
maxthebest99: calls $0.15
*** FLOP *** [7h Ah 4c]
maxthebest99: checks 
stylepointxoxo: checks 
Basile014: checks 
*** TURN *** [7h Ah 4c] [6d]
maxthebest99: bets $0.20
stylepointxoxo: calls $0.20
Basile014: folds 
*** RIVER *** [7h Ah 4c 6d] [Ks]
maxthebest99: checks 
stylepointxoxo: bets $0.70
maxthebest99: folds 
Uncalled bet ($0.70) returned to stylepointxoxo
stylepointxoxo collected $1.15 from pot
stylepointxoxo: doesn't show hand 
*** SUMMARY ***
Total pot $1.20 | Rake $0.05 
Board [7h Ah 4c 6d Ks]
Seat 1: maxthebest99 (big blind) folded on the River
Seat 2: stylepointxoxo collected ($1.15)
Seat 3: vilemo20 folded before Flop (didn't bet)
Seat 4: Basile014 folded on the Turn
Seat 5: 3EBC96 (button) folded before Flop (didn't bet)
Seat 6: Edgarlucky (small blind) folded before Flop



PokerStars Hand #222953833859:  Hold'em No Limit ($0.05/$0.10 USD) - 2021/01/23 8:41:51 ET
Table 'Stephano III' 6-max Seat #6 is the button
Seat 1: maxthebest99 ($13.05 in chips) 
Seat 2: stylepointxoxo ($11.04 in chips) 
Seat 3: vilemo20 ($10 in chips) 
Seat 4: Basile014 ($12.79 in chips) 
Seat 5: 3EBC96 ($12.02 in chips) 
Seat 6: Edgarlucky ($10 in chips) 
maxthebest99: posts small blind $0.05
stylepointxoxo: posts big blind $0.10
*** HOLE CARDS ***
vilemo20: folds 
Basile014: folds 
vilemo20 leaves the table
3EBC96: folds 
Edgarlucky: folds 
maxthebest99: calls $0.05
stylepointxoxo: checks 
*** FLOP *** [Ad Jh 8c]
maxthebest99: bets $0.20
stylepointxoxo: folds 
Uncalled bet ($0.20) returned to maxthebest99
maxthebest99 collected $0.19 from pot
maxthebest99: doesn't show hand 
*** SUMMARY ***
Total pot $0.20 | Rake $0.01 
Board [Ad Jh 8c]
Seat 1: maxthebest99 (small blind) collected ($0.19)
Seat 2: stylepointxoxo (big blind) folded on the Flop
Seat 3: vilemo20 folded before Flop (didn't bet)
Seat 4: Basile014 folded before Flop (didn't bet)
Seat 5: 3EBC96 folded before Flop (didn't bet)
Seat 6: Edgarlucky (button) folded before Flop (didn't bet)



PokerStars Hand #222954015887:  Hold'em No Limit ($0.05/$0.10 USD) - 2021/01/23 8:48:32 ET
Table 'Stephano III' 6-max Seat #3 is the button
Seat 1: maxthebest99 ($18.82 in chips) 
Seat 2: stylepointxoxo ($11.68 in chips) 
Seat 3: xulfster ($10.28 in chips) 
Seat 5: 3EBC96 ($13.71 in chips) 
3EBC96: posts small blind $0.05
Edgarlucky: is sitting out 
maxthebest99: posts big blind $0.10
*** HOLE CARDS ***
Edgarlucky leaves the table
stylepointxoxo: folds 
xulfster: raises $0.15 to $0.25
3EBC96: folds 
maxthebest99: calls $0.15
*** FLOP *** [8c Kc 4h]
maxthebest99: checks 
xulfster: bets $0.17
eRRe_ssbm joins the table at seat #4 
maxthebest99: calls $0.17
*** TURN *** [8c Kc 4h] [6d]
maxthebest99: bets $0.30
xulfster: calls $0.30
*** RIVER *** [8c Kc 4h 6d] [Kh]
maxthebest99: bets $0.30
sandra1189@ joins the table at seat #6 
xulfster: folds 
Uncalled bet ($0.30) returned to maxthebest99
maxthebest99 collected $1.42 from pot
maxthebest99: doesn't show hand 
*** SUMMARY ***
Total pot $1.49 | Rake $0.07 
Board [8c Kc 4h 6d Kh]
Seat 1: maxthebest99 (big blind) collected ($1.42)
Seat 2: stylepointxoxo folded before Flop (didn't bet)
Seat 3: xulfster (button) folded on the River
Seat 5: 3EBC96 (small blind) folded before Flop



PokerStars Hand #222954041290:  Hold'em No Limit ($0.05/$0.10 USD) - 2021/01/23 8:49:27 ET
Table 'Stephano III' 6-max Seat #5 is the button
Seat 1: maxthebest99 ($19.52 in chips) 
Seat 2: stylepointxoxo ($11.68 in chips) 
Seat 3: xulfster ($10 in chips) 
Seat 5: 3EBC96 ($13.66 in chips) 
maxthebest99: posts small blind $0.05
stylepointxoxo: posts big blind $0.10
eRRe_ssbm: sits out 
*** HOLE CARDS ***
xulfster: raises $0.15 to $0.25
3EBC96: folds 
maxthebest99: folds 
stylepointxoxo: calls $0.15
*** FLOP *** [8c 9h Js]
stylepointxoxo: checks 
xulfster: checks 
*** TURN *** [8c 9h Js] [Td]
stylepointxoxo: bets $0.39
xulfster: calls $0.39
*** RIVER *** [8c 9h Js Td] [9c]
stylepointxoxo: checks 
xulfster: bets $1
stylepointxoxo: calls $1
*** SHOW DOWN ***
xulfster: shows [Ad Qd] (a straight, Eight to Queen)
stylepointxoxo: shows [9s Qs] (a straight, Eight to Queen)
stylepointxoxo collected $1.59 from pot
xulfster collected $1.59 from pot
*** SUMMARY ***
Total pot $3.33 | Rake $0.15 
Board [8c 9h Js Td 9c]
Seat 1: maxthebest99 (small blind) folded before Flop
Seat 2: stylepointxoxo (big blind) showed [9s Qs] and won ($1.59) with a straight, Eight to Queen
Seat 3: xulfster showed [Ad Qd] and won ($1.59) with a straight, Eight to Queen
Seat 5: 3EBC96 (button) folded before Flop (didn't bet)



PokerStars Hand #222954062847:  Hold'em No Limit ($0.05/$0.10 USD) - 2021/01/23 8:50:14 ET
Table 'Stephano III' 6-max Seat #1 is the button
Seat 1: maxthebest99 ($19.47 in chips) 
Seat 2: stylepointxoxo ($11.63 in chips) 
Seat 3: xulfster ($10 in chips) 
Seat 5: 3EBC96 ($13.66 in chips) 
Seat 6: sandra1189@ ($4.51 in chips) 
stylepointxoxo: posts small blind $0.05
xulfster: posts big blind $0.10
eRRe_ssbm: sits out 
sandra1189@: posts big blind $0.10
*** HOLE CARDS ***
3EBC96: folds 
sandra1189@: raises $0.10 to $0.20
maxthebest99: folds 
stylepointxoxo: folds 
xulfster: calls $0.10
*** FLOP *** [Td 4s 2s]
xulfster: checks 
sandra1189@: bets $0.43
xulfster: folds 
Uncalled bet ($0.43) returned to sandra1189@
sandra1189@ collected $0.43 from pot
sandra1189@: doesn't show hand 
*** SUMMARY ***
Total pot $0.45 | Rake $0.02 
Board [Td 4s 2s]
Seat 1: maxthebest99 (button) folded before Flop (didn't bet)
Seat 2: stylepointxoxo (small blind) folded before Flop
Seat 3: xulfster (big blind) folded on the Flop
Seat 5: 3EBC96 folded before Flop (didn't bet)
Seat 6: sandra1189@ collected ($0.43)



PokerStars Hand #222954072800:  Hold'em No Limit ($0.05/$0.10 USD) - 2021/01/23 8:50:36 ET
Table 'Stephano III' 6-max Seat #2 is the button
Seat 1: maxthebest99 ($19.47 in chips) 
Seat 2: stylepointxoxo ($11.58 in chips) 
Seat 3: xulfster ($10 in chips) 
Seat 4: eRRe_ssbm ($10 in chips) 
Seat 5: 3EBC96 ($13.66 in chips) 
Seat 6: sandra1189@ ($4.74 in chips) 
xulfster: posts small blind $0.05
eRRe_ssbm: posts big blind $0.10
*** HOLE CARDS ***
3EBC96: folds 
sandra1189@: folds 
maxthebest99: raises $0.20 to $0.30
stylepointxoxo: folds 
xulfster: raises $1 to $1.30
eRRe_ssbm: folds 
maxthebest99: calls $1
*** FLOP *** [2d 8s Js]
xulfster: bets $0.85
maxthebest99: calls $0.85
*** TURN *** [2d 8s Js] [6h]
xulfster: checks 
maxthebest99: bets $1
xulfster: calls $1
*** RIVER *** [2d 8s Js 6h] [Kc]
xulfster: bets $3.06
maxthebest99: raises $4.66 to $7.72
xulfster: folds 
Uncalled bet ($4.66) returned to maxthebest99
maxthebest99 collected $11.96 from pot
maxthebest99: doesn't show hand 
*** SUMMARY ***
Total pot $12.52 | Rake $0.56 
Board [2d 8s Js 6h Kc]
Seat 1: maxthebest99 collected ($11.96)
Seat 2: stylepointxoxo (button) folded before Flop (didn't bet)
Seat 3: xulfster (small blind) folded on the River
Seat 4: eRRe_ssbm (big blind) folded before Flop
Seat 5: 3EBC96 folded before Flop (didn't bet)
Seat 6: sandra1189@ folded before Flop (didn't bet)



PokerStars Hand #222954114069:  Hold'em No Limit ($0.05/$0.10 USD) - 2021/01/23 8:52:07 ET
Table 'Stephano III' 6-max Seat #3 is the button
Seat 1: maxthebest99 ($25.22 in chips) 
Seat 2: stylepointxoxo ($11.58 in chips) 
Seat 3: xulfster ($10 in chips) 
Seat 4: eRRe_ssbm ($10 in chips) 
Seat 5: 3EBC96 ($13.66 in chips) 
Seat 6: sandra1189@ ($4.74 in chips) 
eRRe_ssbm: posts small blind $0.05
3EBC96: posts big blind $0.10
*** HOLE CARDS ***
sandra1189@: raises $0.20 to $0.30
maxthebest99: raises $0.40 to $0.70
stylepointxoxo: folds 
xulfster: folds 
eRRe_ssbm: folds 
3EBC96: calls $0.60
sandra1189@: calls $0.40
*** FLOP *** [7h 7c 2c]
3EBC96: checks 
sandra1189@: checks 
maxthebest99: bets $1
3EBC96: folds 
sandra1189@: raises $3.04 to $4.04 and is all-in
maxthebest99: calls $3.04
*** TURN *** [7h 7c 2c] [Ts]
*** RIVER *** [7h 7c 2c Ts] [Jc]
*** SHOW DOWN ***
sandra1189@: shows [Tc 9c] (a flush, Jack high)
maxthebest99: shows [Kd Ks] (two pair, Kings and Sevens)
sandra1189@ collected $9.77 from pot
*** SUMMARY ***
Total pot $10.23 | Rake $0.46 
Board [7h 7c 2c Ts Jc]
Seat 1: maxthebest99 showed [Kd Ks] and lost with two pair, Kings and Sevens
Seat 2: stylepointxoxo folded before Flop (didn't bet)
Seat 3: xulfster (button) folded before Flop (didn't bet)
Seat 4: eRRe_ssbm (small blind) folded before Flop
Seat 5: 3EBC96 (big blind) folded on the Flop
Seat 6: sandra1189@ showed [Tc 9c] and won ($9.77) with a flush, Jack high



PokerStars Hand #222954135772:  Hold'em No Limit ($0.05/$0.10 USD) - 2021/01/23 8:52:54 ET
Table 'Stephano III' 6-max Seat #4 is the button
Seat 1: maxthebest99 ($20.48 in chips) 
Seat 2: stylepointxoxo ($11.58 in chips) 
Seat 3: xulfster ($10 in chips) 
Seat 4: eRRe_ssbm ($10 in chips) 
Seat 5: 3EBC96 ($12.96 in chips) 
Seat 6: sandra1189@ ($9.77 in chips) 
3EBC96: posts small blind $0.05
sandra1189@: posts big blind $0.10
*** HOLE CARDS ***
maxthebest99: folds 
stylepointxoxo: folds 
xulfster: raises $0.15 to $0.25
eRRe_ssbm: folds 
3EBC96: folds 
sandra1189@: calls $0.15
*** FLOP *** [3s 4h 5d]
sandra1189@: checks 
xulfster: bets $0.27
sandra1189@: calls $0.27
*** TURN *** [3s 4h 5d] [6c]
sandra1189@: checks 
xulfster: bets $0.52
sandra1189@: folds 
Uncalled bet ($0.52) returned to xulfster
xulfster collected $1.04 from pot
*** SUMMARY ***
Total pot $1.09 | Rake $0.05 
Board [3s 4h 5d 6c]
Seat 1: maxthebest99 folded before Flop (didn't bet)
Seat 2: stylepointxoxo folded before Flop (didn't bet)
Seat 3: xulfster collected ($1.04)
Seat 4: eRRe_ssbm (button) folded before Flop (didn't bet)
Seat 5: 3EBC96 (small blind) folded before Flop
Seat 6: sandra1189@ (big blind) folded on the Turn



PokerStars Hand #222954152285:  Hold'em No Limit ($0.05/$0.10 USD) - 2021/01/23 8:53:31 ET
Table 'Stephano III' 6-max Seat #5 is the button
Seat 1: maxthebest99 ($20.48 in chips) 
Seat 2: stylepointxoxo ($11.58 in chips) 
Seat 3: xulfster ($10.52 in chips) 
Seat 4: eRRe_ssbm ($10 in chips) 
Seat 5: 3EBC96 ($12.91 in chips) 
Seat 6: sandra1189@ ($9.25 in chips) 
sandra1189@: posts small blind $0.05
maxthebest99: posts big blind $0.10
*** HOLE CARDS ***
stylepointxoxo: folds 
xulfster: folds 
eRRe_ssbm: folds 
3EBC96: folds 
sandra1189@: raises $0.10 to $0.20
maxthebest99: calls $0.10
*** FLOP *** [6h 8h 5s]
sandra1189@: bets $0.19
maxthebest99: folds 
Uncalled bet ($0.19) returned to sandra1189@
sandra1189@ collected $0.38 from pot
sandra1189@: doesn't show hand 
*** SUMMARY ***
Total pot $0.40 | Rake $0.02 
Board [6h 8h 5s]
Seat 1: maxthebest99 (big blind) folded on the Flop
Seat 2: stylepointxoxo folded before Flop (didn't bet)
Seat 3: xulfster folded before Flop (didn't bet)
Seat 4: eRRe_ssbm folded before Flop (didn't bet)
Seat 5: 3EBC96 (button) folded before Flop (didn't bet)
Seat 6: sandra1189@ (small blind) collected ($0.38)



PokerStars Hand #222954159855:  Hold'em No Limit ($0.05/$0.10 USD) - 2021/01/23 8:53:47 ET
Table 'Stephano III' 6-max Seat #6 is the button
Seat 1: maxthebest99 ($20.28 in chips) 
Seat 2: stylepointxoxo ($11.58 in chips) 
Seat 3: xulfster ($10.52 in chips) 
Seat 4: eRRe_ssbm ($10 in chips) 
Seat 5: 3EBC96 ($12.91 in chips) 
Seat 6: sandra1189@ ($9.43 in chips) 
maxthebest99: posts small blind $0.05
stylepointxoxo: posts big blind $0.10
*** HOLE CARDS ***
xulfster: raises $0.15 to $0.25
eRRe_ssbm: folds 
3EBC96: folds 
sandra1189@: calls $0.25
maxthebest99: folds 
stylepointxoxo: folds 
*** FLOP *** [Jh 6d Tc]
xulfster: checks 
sandra1189@: checks 
*** TURN *** [Jh 6d Tc] [Ac]
xulfster: bets $0.50
sandra1189@: raises $1.62 to $2.12
xulfster: calls $1.62
*** RIVER *** [Jh 6d Tc Ac] [4s]
xulfster: checks 
sandra1189@: bets $4.67
xulfster: folds 
Uncalled bet ($4.67) returned to sandra1189@
sandra1189@ collected $4.67 from pot
sandra1189@: doesn't show hand 
*** SUMMARY ***
Total pot $4.89 | Rake $0.22 
Board [Jh 6d Tc Ac 4s]
Seat 1: maxthebest99 (small blind) folded before Flop
Seat 2: stylepointxoxo (big blind) folded before Flop
Seat 3: xulfster folded on the River
Seat 4: eRRe_ssbm folded before Flop (didn't bet)
Seat 5: 3EBC96 folded before Flop (didn't bet)
Seat 6: sandra1189@ (button) collected ($4.67)



PokerStars Hand #222954197681:  Hold'em No Limit ($0.05/$0.10 USD) - 2021/01/23 8:55:00 ET
Table 'Stephano III' 6-max Seat #1 is the button
Seat 1: maxthebest99 ($20.23 in chips) 
Seat 2: stylepointxoxo ($11.48 in chips) 
Seat 3: xulfster ($10 in chips) 
Seat 4: eRRe_ssbm ($10 in chips) 
Seat 5: 3EBC96 ($12.91 in chips) 
Seat 6: sandra1189@ ($11.73 in chips) 
stylepointxoxo: posts small blind $0.05
xulfster: posts big blind $0.10
*** HOLE CARDS ***
eRRe_ssbm: folds 
3EBC96: folds 
sandra1189@: calls $0.10
maxthebest99: calls $0.10
stylepointxoxo: calls $0.05
xulfster: checks 
*** FLOP *** [6s Js 4s]
stylepointxoxo: checks 
xulfster: checks 
sandra1189@: checks 
maxthebest99: bets $0.10
stylepointxoxo: calls $0.10
xulfster: folds 
sandra1189@: folds 
*** TURN *** [6s Js 4s] [Qd]
stylepointxoxo: checks 
maxthebest99: bets $0.20
stylepointxoxo: calls $0.20
*** RIVER *** [6s Js 4s Qd] [Td]
stylepointxoxo: checks 
maxthebest99: bets $0.20
stylepointxoxo: folds 
Uncalled bet ($0.20) returned to maxthebest99
maxthebest99 collected $0.96 from pot
maxthebest99: doesn't show hand 
*** SUMMARY ***
Total pot $1 | Rake $0.04 
Board [6s Js 4s Qd Td]
Seat 1: maxthebest99 (button) collected ($0.96)
Seat 2: stylepointxoxo (small blind) folded on the River
Seat 3: xulfster (big blind) folded on the Flop
Seat 4: eRRe_ssbm folded before Flop (didn't bet)
Seat 5: 3EBC96 folded before Flop (didn't bet)
Seat 6: sandra1189@ folded on the Flop



PokerStars Hand #222954216044:  Hold'em No Limit ($0.05/$0.10 USD) - 2021/01/23 8:55:49 ET
Table 'Stephano III' 6-max Seat #2 is the button
Seat 1: maxthebest99 ($20.79 in chips) 
Seat 2: stylepointxoxo ($11.08 in chips) 
Seat 3: xulfster ($10 in chips) 
Seat 4: eRRe_ssbm ($10 in chips) 
Seat 5: 3EBC96 ($12.91 in chips) 
Seat 6: sandra1189@ ($11.63 in chips) 
xulfster: posts small blind $0.05
eRRe_ssbm: posts big blind $0.10
*** HOLE CARDS ***
3EBC96: folds 
sandra1189@: calls $0.10
maxthebest99: calls $0.10
stylepointxoxo: raises $0.50 to $0.60
xulfster: folds 
eRRe_ssbm: folds 
sandra1189@: folds 
maxthebest99: folds 
Uncalled bet ($0.50) returned to stylepointxoxo
stylepointxoxo collected $0.45 from pot
stylepointxoxo: doesn't show hand 
*** SUMMARY ***
Total pot $0.45 | Rake $0 
Seat 1: maxthebest99 folded before Flop
Seat 2: stylepointxoxo (button) collected ($0.45)
Seat 3: xulfster (small blind) folded before Flop
Seat 4: eRRe_ssbm (big blind) folded before Flop
Seat 5: 3EBC96 folded before Flop (didn't bet)
Seat 6: sandra1189@ folded before Flop



PokerStars Hand #222955582108:  Hold'em No Limit ($0.05/$0.10 USD) - 2021/01/23 9:42:39 ET
Table 'Stephano III' 6-max Seat #2 is the button
Seat 1: nicucta ($10 in chips) 
Seat 2: stylepointxoxo ($15.29 in chips) 
Seat 3: Greentvdinne ($24.05 in chips) 
Seat 4: eRRe_ssbm ($12.27 in chips) 
Seat 5: 3EBC96 ($10 in chips) 
Seat 6: Hollseg ($10 in chips) 
Greentvdinne: posts small blind $0.05
eRRe_ssbm: posts big blind $0.10
*** HOLE CARDS ***
3EBC96: folds 
Hollseg: folds 
nicucta: folds 
stylepointxoxo: raises $0.15 to $0.25
Greentvdinne: folds 
eRRe_ssbm: calls $0.15
*** FLOP *** [8s Kd 8c]
eRRe_ssbm: checks 
stylepointxoxo: checks 
*** TURN *** [8s Kd 8c] [Qd]
eRRe_ssbm: checks 
stylepointxoxo: checks 
*** RIVER *** [8s Kd 8c Qd] [Ts]
eRRe_ssbm: bets $0.40
stylepointxoxo: folds 
Uncalled bet ($0.40) returned to eRRe_ssbm
eRRe_ssbm collected $0.53 from pot
eRRe_ssbm: doesn't show hand 
*** SUMMARY ***
Total pot $0.55 | Rake $0.02 
Board [8s Kd 8c Qd Ts]
Seat 1: nicucta folded before Flop (didn't bet)
Seat 2: stylepointxoxo (button) folded on the River
Seat 3: Greentvdinne (small blind) folded before Flop
Seat 4: eRRe_ssbm (big blind) collected ($0.53)
Seat 5: 3EBC96 folded before Flop (didn't bet)
Seat 6: Hollseg folded before Flop (didn't bet)



PokerStars Hand #222955609363:  Hold'em No Limit ($0.05/$0.10 USD) - 2021/01/23 9:43:33 ET
Table 'Stephano III' 6-max Seat #3 is the button
Seat 1: nicucta ($10 in chips) 
Seat 3: Greentvdinne ($24 in chips) 
Seat 4: eRRe_ssbm ($12.55 in chips) 
Seat 5: 3EBC96 ($10 in chips) 
Seat 6: Hollseg ($10 in chips) 
eRRe_ssbm: posts small blind $0.05
3EBC96: posts big blind $0.10
*** HOLE CARDS ***
Hollseg: folds 
nicucta: raises $0.10 to $0.20
Greentvdinne: folds 
eRRe_ssbm: folds 
3EBC96: calls $0.10
*** FLOP *** [Jh 3d Qd]
3EBC96: checks 
nicucta: bets $0.22
3EBC96: folds 
Uncalled bet ($0.22) returned to nicucta
nicucta collected $0.43 from pot
nicucta: doesn't show hand 
*** SUMMARY ***
Total pot $0.45 | Rake $0.02 
Board [Jh 3d Qd]
Seat 1: nicucta collected ($0.43)
Seat 3: Greentvdinne (button) folded before Flop (didn't bet)
Seat 4: eRRe_ssbm (small blind) folded before Flop
Seat 5: 3EBC96 (big blind) folded on the Flop
Seat 6: Hollseg folded before Flop (didn't bet)



PokerStars Hand #222955622747:  Hold'em No Limit ($0.05/$0.10 USD) - 2021/01/23 9:44:00 ET
Table 'Stephano III' 6-max Seat #4 is the button
Seat 1: nicucta ($10.23 in chips) 
Seat 3: Greentvdinne ($24 in chips) 
Seat 4: eRRe_ssbm ($12.50 in chips) 
Seat 5: 3EBC96 ($10 in chips) 
Seat 6: Hollseg ($10 in chips) 
3EBC96: posts small blind $0.05
Hollseg: posts big blind $0.10
*** HOLE CARDS ***
nicucta: folds 
Greentvdinne: folds 
eRRe_ssbm: raises $0.20 to $0.30
3EBC96: folds 
Hollseg: folds 
Uncalled bet ($0.20) returned to eRRe_ssbm
eRRe_ssbm collected $0.25 from pot
eRRe_ssbm: doesn't show hand 
*** SUMMARY ***
Total pot $0.25 | Rake $0 
Seat 1: nicucta folded before Flop (didn't bet)
Seat 3: Greentvdinne folded before Flop (didn't bet)
Seat 4: eRRe_ssbm (button) collected ($0.25)
Seat 5: 3EBC96 (small blind) folded before Flop
Seat 6: Hollseg (big blind) folded before Flop



PokerStars Hand #222955629586:  Hold'em No Limit ($0.05/$0.10 USD) - 2021/01/23 9:44:14 ET
Table 'Stephano III' 6-max Seat #5 is the button
Seat 1: nicucta ($10.23 in chips) 
Seat 3: Greentvdinne ($24 in chips) 
Seat 4: eRRe_ssbm ($12.65 in chips) 
Seat 5: 3EBC96 ($10 in chips) 
Seat 6: Hollseg ($9.90 in chips) 
Hollseg: posts small blind $0.05
nicucta: posts big blind $0.10
*** HOLE CARDS ***
Greentvdinne: calls $0.10
eRRe_ssbm: folds 
3EBC96: folds 
Hollseg: folds 
nicucta: checks 
*** FLOP *** [4s 3d Kh]
nicucta: checks 
Greentvdinne: checks 
*** TURN *** [4s 3d Kh] [2s]
nicucta: bets $0.12
Greentvdinne: folds 
Uncalled bet ($0.12) returned to nicucta
nicucta collected $0.24 from pot
nicucta: doesn't show hand 
*** SUMMARY ***
Total pot $0.25 | Rake $0.01 
Board [4s 3d Kh 2s]
Seat 1: nicucta (big blind) collected ($0.24)
Seat 3: Greentvdinne folded on the Turn
Seat 4: eRRe_ssbm folded before Flop (didn't bet)
Seat 5: 3EBC96 (button) folded before Flop (didn't bet)
Seat 6: Hollseg (small blind) folded before Flop



PokerStars Hand #222955646364:  Hold'em No Limit ($0.05/$0.10 USD) - 2021/01/23 9:44:48 ET
Table 'Stephano III' 6-max Seat #6 is the button
Seat 1: nicucta ($10.37 in chips) 
Seat 3: Greentvdinne ($23.90 in chips) 
Seat 4: eRRe_ssbm ($12.65 in chips) 
Seat 5: 3EBC96 ($10 in chips) 
Seat 6: Hollseg ($10 in chips) 
nicucta: posts small blind $0.05
Greentvdinne: posts big blind $0.10
*** HOLE CARDS ***
eRRe_ssbm: folds 
3EBC96: raises $0.20 to $0.30
Hollseg: folds 
nicucta: folds 
Greentvdinne: folds 
Uncalled bet ($0.20) returned to 3EBC96
3EBC96 collected $0.25 from pot
3EBC96: doesn't show hand 
*** SUMMARY ***
Total pot $0.25 | Rake $0 
Seat 1: nicucta (small blind) folded before Flop
Seat 3: Greentvdinne (big blind) folded before Flop
Seat 4: eRRe_ssbm folded before Flop (didn't bet)
Seat 5: 3EBC96 collected ($0.25)
Seat 6: Hollseg (button) folded before Flop (didn't bet)



PokerStars Hand #222955652604:  Hold'em No Limit ($0.05/$0.10 USD) - 2021/01/23 9:45:00 ET
Table 'Stephano III' 6-max Seat #1 is the button
Seat 1: nicucta ($10.32 in chips) 
Seat 3: Greentvdinne ($23.80 in chips) 
Seat 4: eRRe_ssbm ($12.65 in chips) 
Seat 5: 3EBC96 ($10.15 in chips) 
Seat 6: Hollseg ($10 in chips) 
Greentvdinne: posts small blind $0.05
eRRe_ssbm: posts big blind $0.10
*** HOLE CARDS ***
3EBC96: folds 
Hollseg: folds 
nicucta: raises $0.10 to $0.20
Greentvdinne: folds 
eRRe_ssbm: folds 
Uncalled bet ($0.10) returned to nicucta
nicucta collected $0.25 from pot
nicucta: doesn't show hand 
*** SUMMARY ***
Total pot $0.25 | Rake $0 
Seat 1: nicucta (button) collected ($0.25)
Seat 3: Greentvdinne (small blind) folded before Flop
Seat 4: eRRe_ssbm (big blind) folded before Flop
Seat 5: 3EBC96 folded before Flop (didn't bet)
Seat 6: Hollseg folded before Flop (didn't bet)



PokerStars Hand #222955666847:  Hold'em No Limit ($0.05/$0.10 USD) - 2021/01/23 9:45:28 ET
Table 'Stephano III' 6-max Seat #3 is the button
Seat 1: nicucta ($10.47 in chips) 
Seat 3: Greentvdinne ($23.75 in chips) 
Seat 4: eRRe_ssbm ($12.55 in chips) 
Seat 5: 3EBC96 ($10.15 in chips) 
Seat 6: Hollseg ($10 in chips) 
eRRe_ssbm: posts small blind $0.05
3EBC96: posts big blind $0.10
*** HOLE CARDS ***
Hollseg: folds 
nicucta: folds 
Greentvdinne: folds 
eRRe_ssbm: folds 
Uncalled bet ($0.05) returned to 3EBC96
3EBC96 collected $0.10 from pot
3EBC96: doesn't show hand 
*** SUMMARY ***
Total pot $0.10 | Rake $0 
Seat 1: nicucta folded before Flop (didn't bet)
Seat 3: Greentvdinne (button) folded before Flop (didn't bet)
Seat 4: eRRe_ssbm (small blind) folded before Flop
Seat 5: 3EBC96 (big blind) collected ($0.10)
Seat 6: Hollseg folded before Flop (didn't bet)



PokerStars Hand #222955672638:  Hold'em No Limit ($0.05/$0.10 USD) - 2021/01/23 9:45:39 ET
Table 'Stephano III' 6-max Seat #4 is the button
Seat 1: nicucta ($10.47 in chips) 
Seat 3: Greentvdinne ($23.75 in chips) 
Seat 4: eRRe_ssbm ($12.50 in chips) 
Seat 5: 3EBC96 ($10.20 in chips) 
Seat 6: Hollseg ($10 in chips) 
3EBC96: posts small blind $0.05
Hollseg: posts big blind $0.10
*** HOLE CARDS ***
nicucta: folds 
Greentvdinne: folds 
eRRe_ssbm: folds 
3EBC96: folds 
Uncalled bet ($0.05) returned to Hollseg
Hollseg collected $0.10 from pot
Hollseg: doesn't show hand 
*** SUMMARY ***
Total pot $0.10 | Rake $0 
Seat 1: nicucta folded before Flop (didn't bet)
Seat 3: Greentvdinne folded before Flop (didn't bet)
Seat 4: eRRe_ssbm (button) folded before Flop (didn't bet)
Seat 5: 3EBC96 (small blind) folded before Flop
Seat 6: Hollseg (big blind) collected ($0.10)



PokerStars Hand #222955678684:  Hold'em No Limit ($0.05/$0.10 USD) - 2021/01/23 9:45:51 ET
Table 'Stephano III' 6-max Seat #5 is the button
Seat 1: nicucta ($10.47 in chips) 
Seat 3: Greentvdinne ($23.75 in chips) 
Seat 4: eRRe_ssbm ($12.50 in chips) 
Seat 5: 3EBC96 ($10.15 in chips) 
Seat 6: Hollseg ($10.05 in chips) 
Hollseg: posts small blind $0.05
nicucta: posts big blind $0.10
*** HOLE CARDS ***
Greentvdinne: folds 
eRRe_ssbm: raises $0.20 to $0.30
3EBC96: folds 
Hollseg: raises $0.90 to $1.20
nicucta: folds 
eRRe_ssbm: folds 
Uncalled bet ($0.90) returned to Hollseg
Hollseg collected $0.70 from pot
Hollseg: doesn't show hand 
*** SUMMARY ***
Total pot $0.70 | Rake $0 
Seat 1: nicucta (big blind) folded before Flop
Seat 3: Greentvdinne folded before Flop (didn't bet)
Seat 4: eRRe_ssbm folded before Flop
Seat 5: 3EBC96 (button) folded before Flop (didn't bet)
Seat 6: Hollseg (small blind) collected ($0.70)



PokerStars Hand #222955690495:  Hold'em No Limit ($0.05/$0.10 USD) - 2021/01/23 9:46:15 ET
Table 'Stephano III' 6-max Seat #6 is the button
Seat 1: nicucta ($10.37 in chips) 
Seat 3: Greentvdinne ($23.75 in chips) 
Seat 4: eRRe_ssbm ($12.20 in chips) 
Seat 5: 3EBC96 ($10.15 in chips) 
Seat 6: Hollseg ($10.45 in chips) 
nicucta: posts small blind $0.05
Greentvdinne: posts big blind $0.10
*** HOLE CARDS ***
eRRe_ssbm: folds 
3EBC96: raises $0.20 to $0.30
Hollseg: folds 
nicucta: calls $0.25
Greentvdinne: calls $0.20
*** FLOP *** [8h Kh 2s]
nicucta: checks 
Greentvdinne: bets $0.50
3EBC96: calls $0.50
nicucta: folds 
*** TURN *** [8h Kh 2s] [7d]
Greentvdinne: bets $1
3EBC96: calls $1
*** RIVER *** [8h Kh 2s 7d] [Kd]
Greentvdinne: checks 
3EBC96: bets $3.70
Greentvdinne: folds 
Uncalled bet ($3.70) returned to 3EBC96
3EBC96 collected $3.72 from pot
3EBC96: doesn't show hand 
*** SUMMARY ***
Total pot $3.90 | Rake $0.18 
Board [8h Kh 2s 7d Kd]
Seat 1: nicucta (small blind) folded on the Flop
Seat 3: Greentvdinne (big blind) folded on the River
Seat 4: eRRe_ssbm folded before Flop (didn't bet)
Seat 5: 3EBC96 collected ($3.72)
Seat 6: Hollseg (button) folded before Flop (didn't bet)



PokerStars Hand #222955720437:  Hold'em No Limit ($0.05/$0.10 USD) - 2021/01/23 9:47:14 ET
Table 'Stephano III' 6-max Seat #1 is the button
Seat 1: nicucta ($10.07 in chips) 
Seat 3: Greentvdinne ($21.95 in chips) 
Seat 4: eRRe_ssbm ($12.20 in chips) 
Seat 5: 3EBC96 ($12.07 in chips) 
Seat 6: Hollseg ($10.45 in chips) 
Greentvdinne: posts small blind $0.05
eRRe_ssbm: posts big blind $0.10
*** HOLE CARDS ***
3EBC96: folds 
Hollseg: folds 
nicucta: folds 
Greentvdinne: folds 
Uncalled bet ($0.05) returned to eRRe_ssbm
eRRe_ssbm collected $0.10 from pot
eRRe_ssbm: doesn't show hand 
*** SUMMARY ***
Total pot $0.10 | Rake $0 
Seat 1: nicucta (button) folded before Flop (didn't bet)
Seat 3: Greentvdinne (small blind) folded before Flop
Seat 4: eRRe_ssbm (big blind) collected ($0.10)
Seat 5: 3EBC96 folded before Flop (didn't bet)
Seat 6: Hollseg folded before Flop (didn't bet)



PokerStars Hand #222955725541:  Hold'em No Limit ($0.05/$0.10 USD) - 2021/01/23 9:47:24 ET
Table 'Stephano III' 6-max Seat #3 is the button
Seat 1: nicucta ($10.07 in chips) 
Seat 3: Greentvdinne ($21.90 in chips) 
Seat 4: eRRe_ssbm ($12.25 in chips) 
Seat 5: 3EBC96 ($12.07 in chips) 
Seat 6: Hollseg ($10.45 in chips) 
eRRe_ssbm: posts small blind $0.05
3EBC96: posts big blind $0.10
*** HOLE CARDS ***
Hollseg: folds 
nicucta: raises $0.10 to $0.20
Greentvdinne: folds 
eRRe_ssbm: folds 
3EBC96: calls $0.10
*** FLOP *** [Th Jd 5c]
3EBC96: checks 
nicucta: bets $0.10
3EBC96: calls $0.10
*** TURN *** [Th Jd 5c] [3s]
3EBC96: checks 
nicucta: bets $0.40
3EBC96: folds 
Uncalled bet ($0.40) returned to nicucta
nicucta collected $0.62 from pot
nicucta: doesn't show hand 
*** SUMMARY ***
Total pot $0.65 | Rake $0.03 
Board [Th Jd 5c 3s]
Seat 1: nicucta collected ($0.62)
Seat 3: Greentvdinne (button) folded before Flop (didn't bet)
Seat 4: eRRe_ssbm (small blind) folded before Flop
Seat 5: 3EBC96 (big blind) folded on the Turn
Seat 6: Hollseg folded before Flop (didn't bet)



PokerStars Hand #222955735608:  Hold'em No Limit ($0.05/$0.10 USD) - 2021/01/23 9:47:43 ET
Table 'Stephano III' 6-max Seat #4 is the button
Seat 1: nicucta ($10.39 in chips) 
Seat 3: Greentvdinne ($21.90 in chips) 
Seat 4: eRRe_ssbm ($12.20 in chips) 
Seat 5: 3EBC96 ($11.77 in chips) 
3EBC96: posts small blind $0.05
Hollseg: is sitting out 
nicucta: posts big blind $0.10
*** HOLE CARDS ***
Greentvdinne: folds 
eRRe_ssbm: raises $0.20 to $0.30
Hollseg leaves the table
3EBC96: folds 
nicucta: folds 
Uncalled bet ($0.20) returned to eRRe_ssbm
eRRe_ssbm collected $0.25 from pot
eRRe_ssbm: doesn't show hand 
Poker_Axeman joins the table at seat #6 
*** SUMMARY ***
Total pot $0.25 | Rake $0 
Seat 1: nicucta (big blind) folded before Flop
Seat 3: Greentvdinne folded before Flop (didn't bet)
Seat 4: eRRe_ssbm (button) collected ($0.25)
Seat 5: 3EBC96 (small blind) folded before Flop



PokerStars Hand #222955742191:  Hold'em No Limit ($0.05/$0.10 USD) - 2021/01/23 9:47:56 ET
Table 'Stephano III' 6-max Seat #5 is the button
Seat 1: nicucta ($10.29 in chips) 
Seat 3: Greentvdinne ($21.90 in chips) 
Seat 4: eRRe_ssbm ($12.35 in chips) 
Seat 5: 3EBC96 ($11.72 in chips) 
nicucta: posts small blind $0.05
Greentvdinne: posts big blind $0.10
*** HOLE CARDS ***
eRRe_ssbm: folds 
3EBC96: folds 
nicucta: folds 
Uncalled bet ($0.05) returned to Greentvdinne
Greentvdinne collected $0.10 from pot
Greentvdinne: doesn't show hand 
*** SUMMARY ***
Total pot $0.10 | Rake $0 
Seat 1: nicucta (small blind) folded before Flop
Seat 3: Greentvdinne (big blind) collected ($0.10)
Seat 4: eRRe_ssbm folded before Flop (didn't bet)
Seat 5: 3EBC96 (button) folded before Flop (didn't bet)



PokerStars Hand #222955747026:  Hold'em No Limit ($0.05/$0.10 USD) - 2021/01/23 9:48:05 ET
Table 'Stephano III' 6-max Seat #1 is the button
Seat 1: nicucta ($10.24 in chips) 
Seat 3: Greentvdinne ($21.95 in chips) 
Seat 4: eRRe_ssbm ($12.35 in chips) 
Seat 5: 3EBC96 ($11.72 in chips) 
Greentvdinne: posts small blind $0.05
eRRe_ssbm: posts big blind $0.10
Poker_Axeman: sits out 
*** HOLE CARDS ***
3EBC96: folds 
nicucta: folds 
Greentvdinne: folds 
Uncalled bet ($0.05) returned to eRRe_ssbm
eRRe_ssbm collected $0.10 from pot
eRRe_ssbm: doesn't show hand 
*** SUMMARY ***
Total pot $0.10 | Rake $0 
Seat 1: nicucta (button) folded before Flop (didn't bet)
Seat 3: Greentvdinne (small blind) folded before Flop
Seat 4: eRRe_ssbm (big blind) collected ($0.10)
Seat 5: 3EBC96 folded before Flop (didn't bet)



PokerStars Hand #222955750248:  Hold'em No Limit ($0.05/$0.10 USD) - 2021/01/23 9:48:12 ET
Table 'Stephano III' 6-max Seat #3 is the button
Seat 1: nicucta ($10.24 in chips) 
Seat 3: Greentvdinne ($21.90 in chips) 
Seat 4: eRRe_ssbm ($12.40 in chips) 
Seat 5: 3EBC96 ($11.72 in chips) 
eRRe_ssbm: posts small blind $0.05
3EBC96: posts big blind $0.10
Poker_Axeman: sits out 
*** HOLE CARDS ***
nicucta: folds 
Greentvdinne: raises $0.25 to $0.35
eRRe_ssbm: folds 
3EBC96: folds 
Uncalled bet ($0.25) returned to Greentvdinne
Greentvdinne collected $0.25 from pot
Greentvdinne: doesn't show hand 
*** SUMMARY ***
Total pot $0.25 | Rake $0 
Seat 1: nicucta folded before Flop (didn't bet)
Seat 3: Greentvdinne (button) collected ($0.25)
Seat 4: eRRe_ssbm (small blind) folded before Flop
Seat 5: 3EBC96 (big blind) folded before Flop



PokerStars Hand #222955758010:  Hold'em No Limit ($0.05/$0.10 USD) - 2021/01/23 9:48:27 ET
Table 'Stephano III' 6-max Seat #4 is the button
Seat 1: nicucta ($10.24 in chips) 
Seat 3: Greentvdinne ($22.05 in chips) 
Seat 4: eRRe_ssbm ($12.35 in chips) 
Seat 5: 3EBC96 ($11.62 in chips) 
Seat 6: Poker_Axeman ($10 in chips) 
3EBC96: posts small blind $0.05
Poker_Axeman: posts big blind $0.10
*** HOLE CARDS ***
nicucta: folds 
Greentvdinne: calls $0.10
eRRe_ssbm: folds 
3EBC96: folds 
Poker_Axeman: checks 
*** FLOP *** [Ah 4c 6c]
Poker_Axeman: checks 
Greentvdinne: checks 
*** TURN *** [Ah 4c 6c] [8d]
Poker_Axeman: checks 
Greentvdinne: checks 
*** RIVER *** [Ah 4c 6c 8d] [8s]
Poker_Axeman: checks 
Greentvdinne: checks 
*** SHOW DOWN ***
Poker_Axeman: shows [Th 2h] (a pair of Eights)
Greentvdinne: shows [5c 5h] (two pair, Eights and Fives)
Greentvdinne collected $0.24 from pot
*** SUMMARY ***
Total pot $0.25 | Rake $0.01 
Board [Ah 4c 6c 8d 8s]
Seat 1: nicucta folded before Flop (didn't bet)
Seat 3: Greentvdinne showed [5c 5h] and won ($0.24) with two pair, Eights and Fives
Seat 4: eRRe_ssbm (button) folded before Flop (didn't bet)
Seat 5: 3EBC96 (small blind) folded before Flop
Seat 6: Poker_Axeman (big blind) showed [Th 2h] and lost with a pair of Eights



PokerStars Hand #222955778871:  Hold'em No Limit ($0.05/$0.10 USD) - 2021/01/23 9:49:07 ET
Table 'Stephano III' 6-max Seat #5 is the button
Seat 1: nicucta ($10.24 in chips) 
Seat 3: Greentvdinne ($22.19 in chips) 
Seat 4: eRRe_ssbm ($12.35 in chips) 
Seat 5: 3EBC96 ($11.57 in chips) 
Seat 6: Poker_Axeman ($10 in chips) 
Poker_Axeman: posts small blind $0.05
nicucta: posts big blind $0.10
*** HOLE CARDS ***
Greentvdinne: folds 
eRRe_ssbm: folds 
3EBC96: folds 
Poker_Axeman: folds 
Uncalled bet ($0.05) returned to nicucta
nicucta collected $0.10 from pot
nicucta: doesn't show hand 
*** SUMMARY ***
Total pot $0.10 | Rake $0 
Seat 1: nicucta (big blind) collected ($0.10)
Seat 3: Greentvdinne folded before Flop (didn't bet)
Seat 4: eRRe_ssbm folded before Flop (didn't bet)
Seat 5: 3EBC96 (button) folded before Flop (didn't bet)
Seat 6: Poker_Axeman (small blind) folded before Flop



PokerStars Hand #222955783516:  Hold'em No Limit ($0.05/$0.10 USD) - 2021/01/23 9:49:17 ET
Table 'Stephano III' 6-max Seat #6 is the button
Seat 1: nicucta ($10.29 in chips) 
Seat 3: Greentvdinne ($22.19 in chips) 
Seat 4: eRRe_ssbm ($12.35 in chips) 
Seat 5: 3EBC96 ($11.57 in chips) 
Seat 6: Poker_Axeman ($10 in chips) 
nicucta: posts small blind $0.05
Greentvdinne: posts big blind $0.10
*** HOLE CARDS ***
eRRe_ssbm: folds 
3EBC96: raises $0.20 to $0.30
Poker_Axeman: calls $0.30
nicucta: calls $0.25
Greentvdinne: calls $0.20
*** FLOP *** [Ts 5h 8s]
nicucta: checks 
Greentvdinne: checks 
3EBC96: bets $0.60
Poker_Axeman: folds 
nicucta: calls $0.60
Greentvdinne: calls $0.60
*** TURN *** [Ts 5h 8s] [Qc]
nicucta: checks 
Greentvdinne: checks 
3EBC96: bets $2.90
nicucta: folds 
Greentvdinne: calls $2.90
*** RIVER *** [Ts 5h 8s Qc] [Tc]
Greentvdinne: checks 
3EBC96: bets $7.77 and is all-in
Greentvdinne: folds 
Uncalled bet ($7.77) returned to 3EBC96
3EBC96 collected $8.40 from pot
stylepointxoxo was removed from the table for failing to post
stylepointxoxo leaves the table
3EBC96: doesn't show hand 
*** SUMMARY ***
Total pot $8.80 | Rake $0.40 
Board [Ts 5h 8s Qc Tc]
Seat 1: nicucta (small blind) folded on the Turn
Seat 3: Greentvdinne (big blind) folded on the River
Seat 4: eRRe_ssbm folded before Flop (didn't bet)
Seat 5: 3EBC96 collected ($8.40)
Seat 6: Poker_Axeman (button) folded on the Flop



PokerStars Hand #222955824557:  Hold'em No Limit ($0.05/$0.10 USD) - 2021/01/23 9:50:22 ET
Table 'Stephano III' 6-max Seat #1 is the button
Seat 1: nicucta ($10 in chips) 
Seat 3: Greentvdinne ($18.39 in chips) 
Seat 4: eRRe_ssbm ($12.35 in chips) 
Seat 5: 3EBC96 ($16.17 in chips) 
Seat 6: Poker_Axeman ($10 in chips) 
Greentvdinne: posts small blind $0.05
eRRe_ssbm: posts big blind $0.10
*** HOLE CARDS ***
3EBC96: folds 
Poker_Axeman: folds 
abnormal01 joins the table at seat #2 
abnormal01 leaves the table
nicucta has timed out
nicucta: folds 
Greentvdinne: raises $0.20 to $0.30
eRRe_ssbm: calls $0.20
*** FLOP *** [Js Ah Kh]
Greentvdinne: bets $0.30
Sergey_Bolos joins the table at seat #2 
eRRe_ssbm: calls $0.30
*** TURN *** [Js Ah Kh] [2c]
Greentvdinne: bets $1.20
eRRe_ssbm: calls $1.20
*** RIVER *** [Js Ah Kh 2c] [8h]
Greentvdinne: checks 
eRRe_ssbm: bets $1.14
Greentvdinne: calls $1.14
*** SHOW DOWN ***
eRRe_ssbm: shows [Jh 6h] (a flush, Ace high)
Greentvdinne: mucks hand 
eRRe_ssbm collected $5.62 from pot
*** SUMMARY ***
Total pot $5.88 | Rake $0.26 
Board [Js Ah Kh 2c 8h]
Seat 1: nicucta (button) folded before Flop (didn't bet)
Seat 3: Greentvdinne (small blind) mucked
Seat 4: eRRe_ssbm (big blind) showed [Jh 6h] and won ($5.62) with a flush, Ace high
Seat 5: 3EBC96 folded before Flop (didn't bet)
Seat 6: Poker_Axeman folded before Flop (didn't bet)



PokerStars Hand #222955863180:  Hold'em No Limit ($0.05/$0.10 USD) - 2021/01/23 9:51:38 ET
Table 'Stephano III' 6-max Seat #3 is the button
Seat 1: nicucta ($10 in chips) 
Seat 3: Greentvdinne ($15.45 in chips) 
Seat 4: eRRe_ssbm ($15.03 in chips) 
Seat 5: 3EBC96 ($16.17 in chips) 
Seat 6: Poker_Axeman ($10 in chips) 
eRRe_ssbm: posts small blind $0.05
3EBC96: posts big blind $0.10
Sergey_Bolos: sits out 
*** HOLE CARDS ***
Poker_Axeman: folds 
nicucta: calls $0.10
Greentvdinne: folds 
eRRe_ssbm: folds 
3EBC96: checks 
*** FLOP *** [Td Ad Qh]
3EBC96: checks 
nicucta: bets $0.20
3EBC96: calls $0.20
*** TURN *** [Td Ad Qh] [7c]
3EBC96: checks 
nicucta: bets $0.50
3EBC96: calls $0.50
*** RIVER *** [Td Ad Qh 7c] [5h]
3EBC96: checks 
nicucta: checks 
*** SHOW DOWN ***
3EBC96: shows [6d Ac] (a pair of Aces)
nicucta: shows [Ah 8s] (a pair of Aces - Queen+Ten+Eight kicker)
nicucta collected $1.58 from pot
*** SUMMARY ***
Total pot $1.65 | Rake $0.07 
Board [Td Ad Qh 7c 5h]
Seat 1: nicucta showed [Ah 8s] and won ($1.58) with a pair of Aces
Seat 3: Greentvdinne (button) folded before Flop (didn't bet)
Seat 4: eRRe_ssbm (small blind) folded before Flop
Seat 5: 3EBC96 (big blind) showed [6d Ac] and lost with a pair of Aces
Seat 6: Poker_Axeman folded before Flop (didn't bet)



PokerStars Hand #222955879150:  Hold'em No Limit ($0.05/$0.10 USD) - 2021/01/23 9:52:09 ET
Table 'Stephano III' 6-max Seat #4 is the button
Seat 1: nicucta ($10.78 in chips) 
Seat 3: Greentvdinne ($15.45 in chips) 
Seat 4: eRRe_ssbm ($14.98 in chips) 
Seat 5: 3EBC96 ($15.37 in chips) 
Seat 6: Poker_Axeman ($10 in chips) 
3EBC96: posts small blind $0.05
Poker_Axeman: posts big blind $0.10
Sergey_Bolos: sits out 
*** HOLE CARDS ***
nicucta: folds 
Greentvdinne: folds 
eRRe_ssbm: folds 
3EBC96: raises $0.20 to $0.30
Poker_Axeman: folds 
Uncalled bet ($0.20) returned to 3EBC96
3EBC96 collected $0.20 from pot
3EBC96: doesn't show hand 
*** SUMMARY ***
Total pot $0.20 | Rake $0 
Seat 1: nicucta folded before Flop (didn't bet)
Seat 3: Greentvdinne folded before Flop (didn't bet)
Seat 4: eRRe_ssbm (button) folded before Flop (didn't bet)
Seat 5: 3EBC96 (small blind) collected ($0.20)
Seat 6: Poker_Axeman (big blind) folded before Flop



PokerStars Hand #222955885287:  Hold'em No Limit ($0.05/$0.10 USD) - 2021/01/23 9:52:21 ET
Table 'Stephano III' 6-max Seat #5 is the button
Seat 1: nicucta ($10.78 in chips) 
Seat 3: Greentvdinne ($15.45 in chips) 
Seat 4: eRRe_ssbm ($14.98 in chips) 
Seat 5: 3EBC96 ($15.47 in chips) 
Seat 6: Poker_Axeman ($10 in chips) 
Poker_Axeman: posts small blind $0.05
nicucta: posts big blind $0.10
Sergey_Bolos: sits out 
*** HOLE CARDS ***
Greentvdinne: folds 
eRRe_ssbm: raises $0.20 to $0.30
3EBC96: folds 
Poker_Axeman: calls $0.25
nicucta: raises $0.90 to $1.20
eRRe_ssbm: calls $0.90
Poker_Axeman: folds 
*** FLOP *** [Kh Jc 6d]
nicucta: checks 
eRRe_ssbm: checks 
*** TURN *** [Kh Jc 6d] [7h]
nicucta: checks 
eRRe_ssbm: bets $1
nicucta: folds 
Uncalled bet ($1) returned to eRRe_ssbm
eRRe_ssbm collected $2.58 from pot
eRRe_ssbm: doesn't show hand 
*** SUMMARY ***
Total pot $2.70 | Rake $0.12 
Board [Kh Jc 6d 7h]
Seat 1: nicucta (big blind) folded on the Turn
Seat 3: Greentvdinne folded before Flop (didn't bet)
Seat 4: eRRe_ssbm collected ($2.58)
Seat 5: 3EBC96 (button) folded before Flop (didn't bet)
Seat 6: Poker_Axeman (small blind) folded before Flop



PokerStars Hand #222955916676:  Hold'em No Limit ($0.05/$0.10 USD) - 2021/01/23 9:53:23 ET
Table 'Stephano III' 6-max Seat #6 is the button
Seat 1: nicucta ($9.58 in chips) 
Seat 3: Greentvdinne ($15.45 in chips) 
Seat 4: eRRe_ssbm ($16.36 in chips) 
Seat 5: 3EBC96 ($15.47 in chips) 
Seat 6: Poker_Axeman ($10 in chips) 
nicucta: posts small blind $0.05
Sergey_Bolos has timed out
Sergey_Bolos: is sitting out 
Greentvdinne: posts big blind $0.10
*** HOLE CARDS ***
eRRe_ssbm: folds 
3EBC96: raises $0.20 to $0.30
Poker_Axeman: raises $0.60 to $0.90
nicucta: folds 
Greentvdinne: folds 
3EBC96: folds 
Uncalled bet ($0.60) returned to Poker_Axeman
Poker_Axeman collected $0.75 from pot
Poker_Axeman: doesn't show hand 
*** SUMMARY ***
Total pot $0.75 | Rake $0 
Seat 1: nicucta (small blind) folded before Flop
Seat 3: Greentvdinne (big blind) folded before Flop
Seat 4: eRRe_ssbm folded before Flop (didn't bet)
Seat 5: 3EBC96 folded before Flop
Seat 6: Poker_Axeman (button) collected ($0.75)



PokerStars Hand #222955933116:  Hold'em No Limit ($0.05/$0.10 USD) - 2021/01/23 9:53:55 ET
Table 'Stephano III' 6-max Seat #1 is the button
Seat 1: nicucta ($9.53 in chips) 
Seat 3: Greentvdinne ($15.35 in chips) 
Seat 4: eRRe_ssbm ($16.36 in chips) 
Seat 5: 3EBC96 ($15.17 in chips) 
Seat 6: Poker_Axeman ($10.45 in chips) 
Greentvdinne: posts small blind $0.05
eRRe_ssbm: posts big blind $0.10
*** HOLE CARDS ***
3EBC96: raises $0.20 to $0.30
Poker_Axeman: folds 
nicucta: folds 
Greentvdinne: calls $0.25
eRRe_ssbm: folds 
*** FLOP *** [Td As 9c]
Greentvdinne: checks 
3EBC96: bets $0.34
Greentvdinne: folds 
Uncalled bet ($0.34) returned to 3EBC96
3EBC96 collected $0.67 from pot
3EBC96: doesn't show hand 
*** SUMMARY ***
Total pot $0.70 | Rake $0.03 
Board [Td As 9c]
Seat 1: nicucta (button) folded before Flop (didn't bet)
Seat 3: Greentvdinne (small blind) folded on the Flop
Seat 4: eRRe_ssbm (big blind) folded before Flop
Seat 5: 3EBC96 collected ($0.67)
Seat 6: Poker_Axeman folded before Flop (didn't bet)



PokerStars Hand #222955944102:  Hold'em No Limit ($0.05/$0.10 USD) - 2021/01/23 9:54:17 ET
Table 'Stephano III' 6-max Seat #3 is the button
Seat 1: nicucta ($9.53 in chips) 
Seat 3: Greentvdinne ($15.05 in chips) 
Seat 4: eRRe_ssbm ($16.26 in chips) 
Seat 5: 3EBC96 ($15.54 in chips) 
Seat 6: Poker_Axeman ($10.45 in chips) 
eRRe_ssbm: posts small blind $0.05
3EBC96: posts big blind $0.10
*** HOLE CARDS ***
Poker_Axeman: folds 
nicucta: folds 
Greentvdinne: raises $0.25 to $0.35
eRRe_ssbm: folds 
3EBC96: raises $0.85 to $1.20
Greentvdinne: calls $0.85
*** FLOP *** [2h 5c 3d]
3EBC96: bets $1.80
Greentvdinne: folds 
Uncalled bet ($1.80) returned to 3EBC96
3EBC96 collected $2.34 from pot
3EBC96: doesn't show hand 
*** SUMMARY ***
Total pot $2.45 | Rake $0.11 
Board [2h 5c 3d]
Seat 1: nicucta folded before Flop (didn't bet)
Seat 3: Greentvdinne (button) folded on the Flop
Seat 4: eRRe_ssbm (small blind) folded before Flop
Seat 5: 3EBC96 (big blind) collected ($2.34)
Seat 6: Poker_Axeman folded before Flop (didn't bet)



PokerStars Hand #222955959227:  Hold'em No Limit ($0.05/$0.10 USD) - 2021/01/23 9:54:47 ET
Table 'Stephano III' 6-max Seat #4 is the button
Seat 1: nicucta ($10 in chips) 
Seat 3: Greentvdinne ($13.85 in chips) 
Seat 4: eRRe_ssbm ($16.21 in chips) 
Seat 5: 3EBC96 ($16.68 in chips) 
Seat 6: Poker_Axeman ($10.45 in chips) 
3EBC96: posts small blind $0.05
Poker_Axeman: posts big blind $0.10
*** HOLE CARDS ***
nicucta: calls $0.10
Greentvdinne: raises $0.20 to $0.30
eRRe_ssbm: calls $0.30
3EBC96: folds 
Poker_Axeman: folds 
nicucta: calls $0.20
*** FLOP *** [Ts Qc 7c]
nicucta: checks 
Greentvdinne: bets $0.50
eRRe_ssbm: calls $0.50
nicucta: folds 
*** TURN *** [Ts Qc 7c] [5s]
Greentvdinne: bets $2
eRRe_ssbm: folds 
Uncalled bet ($2) returned to Greentvdinne
Greentvdinne collected $1.96 from pot
Greentvdinne: doesn't show hand 
*** SUMMARY ***
Total pot $2.05 | Rake $0.09 
Board [Ts Qc 7c 5s]
Seat 1: nicucta folded on the Flop
Seat 3: Greentvdinne collected ($1.96)
Seat 4: eRRe_ssbm (button) folded on the Turn
Seat 5: 3EBC96 (small blind) folded before Flop
Seat 6: Poker_Axeman (big blind) folded before Flop



PokerStars Hand #222955988309:  Hold'em No Limit ($0.05/$0.10 USD) - 2021/01/23 9:55:54 ET
Table 'Stephano III' 6-max Seat #5 is the button
Seat 1: nicucta ($9.80 in chips) 
Seat 3: Greentvdinne ($15.01 in chips) 
Seat 4: eRRe_ssbm ($15.41 in chips) 
Seat 5: 3EBC96 ($16.63 in chips) 
Seat 6: Poker_Axeman ($10.35 in chips) 
Poker_Axeman: posts small blind $0.05
nicucta: posts big blind $0.10
*** HOLE CARDS ***
Greentvdinne: calls $0.10
eRRe_ssbm: folds 
3EBC96: folds 
Poker_Axeman: folds 
nicucta: checks 
*** FLOP *** [5c 6h 3c]
nicucta: checks 
Greentvdinne: bets $0.20
nicucta: calls $0.20
*** TURN *** [5c 6h 3c] [Jc]
nicucta: checks 
Greentvdinne: bets $0.40
nicucta: calls $0.40
*** RIVER *** [5c 6h 3c Jc] [5s]
nicucta: checks 
Greentvdinne: bets $0.70
nicucta: calls $0.70
*** SHOW DOWN ***
Greentvdinne: shows [3s 3h] (a full house, Threes full of Fives)
nicucta: mucks hand 
Greentvdinne collected $2.72 from pot
*** SUMMARY ***
Total pot $2.85 | Rake $0.13 
Board [5c 6h 3c Jc 5s]
Seat 1: nicucta (big blind) mucked
Seat 3: Greentvdinne showed [3s 3h] and won ($2.72) with a full house, Threes full of Fives
Seat 4: eRRe_ssbm folded before Flop (didn't bet)
Seat 5: 3EBC96 (button) folded before Flop (didn't bet)
Seat 6: Poker_Axeman (small blind) folded before Flop



PokerStars Hand #222956000968:  Hold'em No Limit ($0.05/$0.10 USD) - 2021/01/23 9:56:26 ET
Table 'Stephano III' 6-max Seat #6 is the button
Seat 1: nicucta ($8.90 in chips) 
Seat 3: Greentvdinne ($16.33 in chips) 
Seat 4: eRRe_ssbm ($15.41 in chips) 
Seat 5: 3EBC96 ($16.63 in chips) 
Seat 6: Poker_Axeman ($10.30 in chips) 
nicucta: posts small blind $0.05
Greentvdinne: posts big blind $0.10
*** HOLE CARDS ***
eRRe_ssbm: folds 
3EBC96: folds 
Poker_Axeman: raises $0.20 to $0.30
nicucta: folds 
Greentvdinne: folds 
Uncalled bet ($0.20) returned to Poker_Axeman
Poker_Axeman collected $0.25 from pot
Poker_Axeman: doesn't show hand 
*** SUMMARY ***
Total pot $0.25 | Rake $0 
Seat 1: nicucta (small blind) folded before Flop
Seat 3: Greentvdinne (big blind) folded before Flop
Seat 4: eRRe_ssbm folded before Flop (didn't bet)
Seat 5: 3EBC96 folded before Flop (didn't bet)
Seat 6: Poker_Axeman (button) collected ($0.25)



PokerStars Hand #222956004991:  Hold'em No Limit ($0.05/$0.10 USD) - 2021/01/23 9:56:36 ET
Table 'Stephano III' 6-max Seat #1 is the button
Seat 1: nicucta ($10 in chips) 
Seat 3: Greentvdinne ($16.23 in chips) 
Seat 4: eRRe_ssbm ($15.41 in chips) 
Seat 5: 3EBC96 ($16.63 in chips) 
Seat 6: Poker_Axeman ($10.45 in chips) 
Greentvdinne: posts small blind $0.05
eRRe_ssbm: posts big blind $0.10
*** HOLE CARDS ***
3EBC96: folds 
Poker_Axeman: folds 
nicucta: raises $0.10 to $0.20
Greentvdinne: folds 
eRRe_ssbm: folds 
Uncalled bet ($0.10) returned to nicucta
nicucta collected $0.25 from pot
nicucta: doesn't show hand 
*** SUMMARY ***
Total pot $0.25 | Rake $0 
Seat 1: nicucta (button) collected ($0.25)
Seat 3: Greentvdinne (small blind) folded before Flop
Seat 4: eRRe_ssbm (big blind) folded before Flop
Seat 5: 3EBC96 folded before Flop (didn't bet)
Seat 6: Poker_Axeman folded before Flop (didn't bet)



PokerStars Hand #222956012030:  Hold'em No Limit ($0.05/$0.10 USD) - 2021/01/23 9:56:53 ET
Table 'Stephano III' 6-max Seat #3 is the button
Seat 1: nicucta ($10.15 in chips) 
Seat 3: Greentvdinne ($16.18 in chips) 
Seat 4: eRRe_ssbm ($15.31 in chips) 
Seat 5: 3EBC96 ($16.63 in chips) 
Seat 6: Poker_Axeman ($10.45 in chips) 
eRRe_ssbm: posts small blind $0.05
3EBC96: posts big blind $0.10
*** HOLE CARDS ***
Sergey_Bolos is disconnected 
Poker_Axeman: raises $0.20 to $0.30
nicucta: folds 
Greentvdinne: folds 
eRRe_ssbm: folds 
3EBC96: folds 
Uncalled bet ($0.20) returned to Poker_Axeman
Poker_Axeman collected $0.25 from pot
Poker_Axeman: doesn't show hand 
*** SUMMARY ***
Total pot $0.25 | Rake $0 
Seat 1: nicucta folded before Flop (didn't bet)
Seat 3: Greentvdinne (button) folded before Flop (didn't bet)
Seat 4: eRRe_ssbm (small blind) folded before Flop
Seat 5: 3EBC96 (big blind) folded before Flop
Seat 6: Poker_Axeman collected ($0.25)



PokerStars Hand #222956020028:  Hold'em No Limit ($0.05/$0.10 USD) - 2021/01/23 9:57:13 ET
Table 'Stephano III' 6-max Seat #4 is the button
Seat 1: nicucta ($10.15 in chips) 
Seat 3: Greentvdinne ($16.18 in chips) 
Seat 4: eRRe_ssbm ($15.26 in chips) 
Seat 5: 3EBC96 ($16.53 in chips) 
Seat 6: Poker_Axeman ($10.60 in chips) 
3EBC96: posts small blind $0.05
Poker_Axeman: posts big blind $0.10
*** HOLE CARDS ***
nicucta: raises $0.20 to $0.30
Greentvdinne: folds 
eRRe_ssbm: folds 
3EBC96: folds 
Poker_Axeman: folds 
Uncalled bet ($0.20) returned to nicucta
nicucta collected $0.25 from pot
nicucta: doesn't show hand 
*** SUMMARY ***
Total pot $0.25 | Rake $0 
Seat 1: nicucta collected ($0.25)
Seat 3: Greentvdinne folded before Flop (didn't bet)
Seat 4: eRRe_ssbm (button) folded before Flop (didn't bet)
Seat 5: 3EBC96 (small blind) folded before Flop
Seat 6: Poker_Axeman (big blind) folded before Flop



PokerStars Hand #222956024584:  Hold'em No Limit ($0.05/$0.10 USD) - 2021/01/23 9:57:24 ET
Table 'Stephano III' 6-max Seat #5 is the button
Seat 3: Greentvdinne ($16.18 in chips) 
Seat 4: eRRe_ssbm ($15.26 in chips) 
Seat 5: 3EBC96 ($16.48 in chips) 
Seat 6: Poker_Axeman ($10.50 in chips) 
Poker_Axeman: posts small blind $0.05
Greentvdinne: posts big blind $0.10
*** HOLE CARDS ***
nicucta leaves the table
MRN888 joins the table at seat #1 
eRRe_ssbm: folds 
3EBC96: raises $0.20 to $0.30
Poker_Axeman: folds 
Greentvdinne: folds 
Uncalled bet ($0.20) returned to 3EBC96
3EBC96 collected $0.25 from pot
3EBC96: doesn't show hand 
*** SUMMARY ***
Total pot $0.25 | Rake $0 
Seat 3: Greentvdinne (big blind) folded before Flop
Seat 4: eRRe_ssbm folded before Flop (didn't bet)
Seat 5: 3EBC96 (button) collected ($0.25)
Seat 6: Poker_Axeman (small blind) folded before Flop



PokerStars Hand #222956031627:  Hold'em No Limit ($0.05/$0.10 USD) - 2021/01/23 9:57:42 ET
Table 'Stephano III' 6-max Seat #6 is the button
Seat 3: Greentvdinne ($16.08 in chips) 
Seat 4: eRRe_ssbm ($15.26 in chips) 
Seat 6: Poker_Axeman ($10.45 in chips) 
Greentvdinne: posts small blind $0.05
eRRe_ssbm: posts big blind $0.10
*** HOLE CARDS ***
Poker_Axeman: folds 
Greentvdinne: folds 
Uncalled bet ($0.05) returned to eRRe_ssbm
eRRe_ssbm collected $0.10 from pot
eRRe_ssbm: doesn't show hand 
*** SUMMARY ***
Total pot $0.10 | Rake $0 
Seat 3: Greentvdinne (small blind) folded before Flop
Seat 4: eRRe_ssbm (big blind) collected ($0.10)
Seat 6: Poker_Axeman (button) folded before Flop (didn't bet)



PokerStars Hand #222956034668:  Hold'em No Limit ($0.05/$0.10 USD) - 2021/01/23 9:57:49 ET
Table 'Stephano III' 6-max Seat #3 is the button
Seat 1: MRN888 ($4 in chips) 
Seat 3: Greentvdinne ($16.03 in chips) 
Seat 4: eRRe_ssbm ($15.31 in chips) 
3EBC96 leaves the table
eRRe_ssbm: posts small blind $0.05
Poker_Axeman: is sitting out 
MRN888: posts big blind $0.10
*** HOLE CARDS ***
Poker_Axeman leaves the table
Greentvdinne: raises $0.20 to $0.30
eRRe_ssbm: folds 
MRN888: calls $0.20
*** FLOP *** [6c 4s 4c]
Manic Jay joins the table at seat #5 
MRN888: bets $0.10
alVatroos joins the table at seat #6 
Greentvdinne: folds 
Uncalled bet ($0.10) returned to MRN888
MRN888 collected $0.62 from pot
MRN888: doesn't show hand 
*** SUMMARY ***
Total pot $0.65 | Rake $0.03 
Board [6c 4s 4c]
Seat 1: MRN888 (big blind) collected ($0.62)
Seat 3: Greentvdinne (button) folded on the Flop
Seat 4: eRRe_ssbm (small blind) folded before Flop



PokerStars Hand #222956042000:  Hold'em No Limit ($0.05/$0.10 USD) - 2021/01/23 9:58:07 ET
Table 'Stephano III' 6-max Seat #4 is the button
Seat 1: MRN888 ($4.32 in chips) 
Seat 3: Greentvdinne ($15.73 in chips) 
Seat 4: eRRe_ssbm ($15.26 in chips) 
MRN888: posts small blind $0.05
Greentvdinne: posts big blind $0.10
*** HOLE CARDS ***
eRRe_ssbm: folds 
MRN888: calls $0.05
Greentvdinne: checks 
*** FLOP *** [Jc 2c 4d]
MRN888: checks 
Greentvdinne: checks 
*** TURN *** [Jc 2c 4d] [4h]
MRN888: bets $0.10
Greentvdinne: folds 
Uncalled bet ($0.10) returned to MRN888
MRN888 collected $0.19 from pot
Sergey_Bolos was removed from the table for failing to post
Sergey_Bolos leaves the table
MRN888: doesn't show hand 
*** SUMMARY ***
Total pot $0.20 | Rake $0.01 
Board [Jc 2c 4d 4h]
Seat 1: MRN888 (small blind) collected ($0.19)
Seat 3: Greentvdinne (big blind) folded on the Turn
Seat 4: eRRe_ssbm (button) folded before Flop (didn't bet)



PokerStars Hand #222956047008:  Hold'em No Limit ($0.05/$0.10 USD) - 2021/01/23 9:58:20 ET
Table 'Stephano III' 6-max Seat #1 is the button
Seat 1: MRN888 ($4.41 in chips) 
Seat 3: Greentvdinne ($15.63 in chips) 
Seat 4: eRRe_ssbm ($15.26 in chips) 
Seat 5: Manic Jay ($4 in chips) 
Greentvdinne: posts small blind $0.05
eRRe_ssbm: posts big blind $0.10
Manic Jay: posts big blind $0.10
alVatroos: sits out 
*** HOLE CARDS ***
Manic Jay: checks 
MRN888: calls $0.10
Greentvdinne: calls $0.05
eRRe_ssbm: checks 
*** FLOP *** [3c Ah 5c]
Greentvdinne: bets $0.20
voadek12 joins the table at seat #2 
eRRe_ssbm: folds 
Manic Jay: folds 
MRN888: folds 
Uncalled bet ($0.20) returned to Greentvdinne
Greentvdinne collected $0.38 from pot
Greentvdinne: doesn't show hand 
*** SUMMARY ***
Total pot $0.40 | Rake $0.02 
Board [3c Ah 5c]
Seat 1: MRN888 (button) folded on the Flop
Seat 3: Greentvdinne (small blind) collected ($0.38)
Seat 4: eRRe_ssbm (big blind) folded on the Flop
Seat 5: Manic Jay folded on the Flop (didn't bet)



PokerStars Hand #222956054266:  Hold'em No Limit ($0.05/$0.10 USD) - 2021/01/23 9:58:39 ET
Table 'Stephano III' 6-max Seat #3 is the button
Seat 1: MRN888 ($4.31 in chips) 
Seat 2: voadek12 ($4 in chips) 
Seat 3: Greentvdinne ($15.91 in chips) 
Seat 4: eRRe_ssbm ($15.16 in chips) 
Seat 5: Manic Jay ($9.90 in chips) 
eRRe_ssbm: posts small blind $0.05
Manic Jay: posts big blind $0.10
alVatroos: sits out 
voadek12: posts big blind $0.10
*** HOLE CARDS ***
MRN888: calls $0.10
voadek12: checks 
Greentvdinne: folds 
eRRe_ssbm: raises $0.40 to $0.50
Manic Jay: calls $0.40
MRN888: calls $0.40
voadek12: folds 
*** FLOP *** [7s 5s 4s]
eRRe_ssbm: bets $0.35
Manic Jay: folds 
MRN888: calls $0.35
*** TURN *** [7s 5s 4s] [Jc]
eRRe_ssbm: bets $1.65
MRN888: folds 
Uncalled bet ($1.65) returned to eRRe_ssbm
eRRe_ssbm collected $2.20 from pot
eRRe_ssbm: doesn't show hand 
*** SUMMARY ***
Total pot $2.30 | Rake $0.10 
Board [7s 5s 4s Jc]
Seat 1: MRN888 folded on the Turn
Seat 2: voadek12 folded before Flop (didn't bet)
Seat 3: Greentvdinne (button) folded before Flop (didn't bet)
Seat 4: eRRe_ssbm (small blind) collected ($2.20)
Seat 5: Manic Jay (big blind) folded on the Flop



PokerStars Hand #222956071454:  Hold'em No Limit ($0.05/$0.10 USD) - 2021/01/23 9:59:21 ET
Table 'Stephano III' 6-max Seat #4 is the button
Seat 1: MRN888 ($3.46 in chips) 
Seat 2: voadek12 ($3.90 in chips) 
Seat 3: Greentvdinne ($15.91 in chips) 
Seat 4: eRRe_ssbm ($16.51 in chips) 
Seat 5: Manic Jay ($9.40 in chips) 
Seat 6: alVatroos ($10 in chips) 
Manic Jay: posts small blind $0.05
alVatroos: posts big blind $0.10
*** HOLE CARDS ***
MRN888: calls $0.10
voadek12: folds 
Greentvdinne: folds 
eRRe_ssbm: raises $0.30 to $0.40
Manic Jay: calls $0.35
alVatroos: folds 
MRN888: calls $0.30
*** FLOP *** [6s Ts 6h]
Manic Jay: checks 
MRN888: checks 
eRRe_ssbm: bets $0.40
Manic Jay: calls $0.40
MRN888: folds 
*** TURN *** [6s Ts 6h] [6c]
Manic Jay: checks 
eRRe_ssbm: bets $1.20
Manic Jay: calls $1.20
*** RIVER *** [6s Ts 6h 6c] [4h]
Manic Jay: checks 
eRRe_ssbm: bets $1.40
Manic Jay: calls $1.40
*** SHOW DOWN ***
eRRe_ssbm: shows [Tc Jc] (a full house, Sixes full of Tens)
Manic Jay: mucks hand 
eRRe_ssbm collected $6.97 from pot
*** SUMMARY ***
Total pot $7.30 | Rake $0.33 
Board [6s Ts 6h 6c 4h]
Seat 1: MRN888 folded on the Flop
Seat 2: voadek12 folded before Flop (didn't bet)
Seat 3: Greentvdinne folded before Flop (didn't bet)
Seat 4: eRRe_ssbm (button) showed [Tc Jc] and won ($6.97) with a full house, Sixes full of Tens
Seat 5: Manic Jay (small blind) mucked
Seat 6: alVatroos (big blind) folded before Flop



PokerStars Hand #222956091812:  Hold'em No Limit ($0.05/$0.10 USD) - 2021/01/23 10:00:11 ET
Table 'Stephano III' 6-max Seat #5 is the button
Seat 1: MRN888 ($3.06 in chips) 
Seat 2: voadek12 ($3.90 in chips) 
Seat 3: Greentvdinne ($15.91 in chips) 
Seat 4: eRRe_ssbm ($20.08 in chips) 
Seat 5: Manic Jay ($6 in chips) 
Seat 6: alVatroos ($10 in chips) 
alVatroos: posts small blind $0.05
MRN888: posts big blind $0.10
*** HOLE CARDS ***
voadek12: folds 
Greentvdinne: folds 
eRRe_ssbm: folds 
Manic Jay: calls $0.10
alVatroos: calls $0.05
MRN888: checks 
*** FLOP *** [Ad 6s 4h]
alVatroos: checks 
MRN888: checks 
Manic Jay: checks 
*** TURN *** [Ad 6s 4h] [Kd]
alVatroos: bets $0.17
MRN888: folds 
Manic Jay: folds 
Uncalled bet ($0.17) returned to alVatroos
alVatroos collected $0.29 from pot
alVatroos: doesn't show hand 
*** SUMMARY ***
Total pot $0.30 | Rake $0.01 
Board [Ad 6s 4h Kd]
Seat 1: MRN888 (big blind) folded on the Turn
Seat 2: voadek12 folded before Flop (didn't bet)
Seat 3: Greentvdinne folded before Flop (didn't bet)
Seat 4: eRRe_ssbm folded before Flop (didn't bet)
Seat 5: Manic Jay (button) folded on the Turn
Seat 6: alVatroos (small blind) collected ($0.29)



PokerStars Hand #222956103941:  Hold'em No Limit ($0.05/$0.10 USD) - 2021/01/23 10:00:39 ET
Table 'Stephano III' 6-max Seat #6 is the button
Seat 1: MRN888 ($2.96 in chips) 
Seat 2: voadek12 ($3.90 in chips) 
Seat 3: Greentvdinne ($15.91 in chips) 
Seat 4: eRRe_ssbm ($20.08 in chips) 
Seat 5: Manic Jay ($5.90 in chips) 
Seat 6: alVatroos ($10.19 in chips) 
MRN888: posts small blind $0.05
voadek12: posts big blind $0.10
*** HOLE CARDS ***
Greentvdinne: folds 
eRRe_ssbm: folds 
Manic Jay: folds 
alVatroos: raises $0.15 to $0.25
MRN888: calls $0.20
voadek12: folds 
*** FLOP *** [3d Kh 7h]
MRN888: bets $0.10
alVatroos: calls $0.10
*** TURN *** [3d Kh 7h] [2h]
MRN888: bets $0.10
alVatroos: raises $0.30 to $0.40
MRN888: calls $0.30
*** RIVER *** [3d Kh 7h 2h] [Jd]
MRN888: bets $0.10
alVatroos: folds 
Uncalled bet ($0.10) returned to MRN888
MRN888 collected $1.53 from pot
MRN888: doesn't show hand 
*** SUMMARY ***
Total pot $1.60 | Rake $0.07 
Board [3d Kh 7h 2h Jd]
Seat 1: MRN888 (small blind) collected ($1.53)
Seat 2: voadek12 (big blind) folded before Flop
Seat 3: Greentvdinne folded before Flop (didn't bet)
Seat 4: eRRe_ssbm folded before Flop (didn't bet)
Seat 5: Manic Jay folded before Flop (didn't bet)
Seat 6: alVatroos (button) folded on the River



PokerStars Hand #222956117799:  Hold'em No Limit ($0.05/$0.10 USD) - 2021/01/23 10:01:11 ET
Table 'Stephano III' 6-max Seat #1 is the button
Seat 1: MRN888 ($3.74 in chips) 
Seat 2: voadek12 ($3.80 in chips) 
Seat 3: Greentvdinne ($15.91 in chips) 
Seat 4: eRRe_ssbm ($20.08 in chips) 
Seat 5: Manic Jay ($10 in chips) 
Seat 6: alVatroos ($10 in chips) 
voadek12: posts small blind $0.05
Greentvdinne: posts big blind $0.10
*** HOLE CARDS ***
eRRe_ssbm: folds 
Manic Jay: raises $0.20 to $0.30
alVatroos: folds 
MRN888: calls $0.30
voadek12: calls $0.25
Greentvdinne: calls $0.20
*** FLOP *** [7h 4s 9s]
voadek12: checks 
Greentvdinne: checks 
Manic Jay: checks 
MRN888: bets $0.10
voadek12: calls $0.10
Greentvdinne: folds 
Manic Jay: calls $0.10
*** TURN *** [7h 4s 9s] [6h]
voadek12: checks 
Manic Jay: checks 
MRN888: bets $0.10
voadek12: calls $0.10
Manic Jay: calls $0.10
*** RIVER *** [7h 4s 9s 6h] [Ad]
voadek12: checks 
Manic Jay: checks 
MRN888: bets $0.86
voadek12: calls $0.86
Manic Jay: folds 
*** SHOW DOWN ***
MRN888: shows [5s 6c] (a pair of Sixes)
voadek12: shows [Jh 9h] (a pair of Nines)
voadek12 collected $3.36 from pot
*** SUMMARY ***
Total pot $3.52 | Rake $0.16 
Board [7h 4s 9s 6h Ad]
Seat 1: MRN888 (button) showed [5s 6c] and lost with a pair of Sixes
Seat 2: voadek12 (small blind) showed [Jh 9h] and won ($3.36) with a pair of Nines
Seat 3: Greentvdinne (big blind) folded on the Flop
Seat 4: eRRe_ssbm folded before Flop (didn't bet)
Seat 5: Manic Jay folded on the River
Seat 6: alVatroos folded before Flop (didn't bet)



PokerStars Hand #222956140921:  Hold'em No Limit ($0.05/$0.10 USD) - 2021/01/23 10:01:58 ET
Table 'Stephano III' 6-max Seat #2 is the button
Seat 1: MRN888 ($2.38 in chips) 
Seat 2: voadek12 ($5.80 in chips) 
Seat 3: Greentvdinne ($15.61 in chips) 
Seat 4: eRRe_ssbm ($20.08 in chips) 
Seat 5: Manic Jay ($9.50 in chips) 
Seat 6: alVatroos ($10 in chips) 
Greentvdinne: posts small blind $0.05
eRRe_ssbm: posts big blind $0.10
*** HOLE CARDS ***
Manic Jay: folds 
alVatroos: folds 
MRN888: calls $0.10
voadek12: folds 
Greentvdinne: folds 
eRRe_ssbm: checks 
*** FLOP *** [2s 8h 5h]
eRRe_ssbm: checks 
MRN888: bets $0.12
eRRe_ssbm: folds 
Uncalled bet ($0.12) returned to MRN888
MRN888 collected $0.24 from pot
MRN888: doesn't show hand 
*** SUMMARY ***
Total pot $0.25 | Rake $0.01 
Board [2s 8h 5h]
Seat 1: MRN888 collected ($0.24)
Seat 2: voadek12 (button) folded before Flop (didn't bet)
Seat 3: Greentvdinne (small blind) folded before Flop
Seat 4: eRRe_ssbm (big blind) folded on the Flop
Seat 5: Manic Jay folded before Flop (didn't bet)
Seat 6: alVatroos folded before Flop (didn't bet)



PokerStars Hand #222956158219:  Hold'em No Limit ($0.05/$0.10 USD) - 2021/01/23 10:02:33 ET
Table 'Stephano III' 6-max Seat #3 is the button
Seat 1: MRN888 ($7.38 in chips) 
Seat 2: voadek12 ($5.80 in chips) 
Seat 3: Greentvdinne ($15.56 in chips) 
Seat 4: eRRe_ssbm ($19.98 in chips) 
Seat 5: Manic Jay ($9.50 in chips) 
Seat 6: alVatroos ($10 in chips) 
eRRe_ssbm: posts small blind $0.05
Manic Jay: posts big blind $0.10
*** HOLE CARDS ***
alVatroos: raises $0.20 to $0.30
MRN888: calls $0.30
voadek12: calls $0.30
Greentvdinne: folds 
eRRe_ssbm: folds 
Manic Jay: calls $0.20
*** FLOP *** [3d Kc 8d]
Manic Jay: checks 
alVatroos: checks 
MRN888: bets $0.60
voadek12: folds 
Manic Jay: calls $0.60
alVatroos: folds 
*** TURN *** [3d Kc 8d] [5d]
Manic Jay: checks 
MRN888: bets $0.10
Manic Jay: calls $0.10
*** RIVER *** [3d Kc 8d 5d] [Ks]
Manic Jay: checks 
MRN888: bets $0.10
Manic Jay: calls $0.10
*** SHOW DOWN ***
MRN888: shows [Ah Qc] (a pair of Kings)
Manic Jay: shows [Qs Ad] (a pair of Kings)
Manic Jay collected $1.36 from pot
MRN888 collected $1.36 from pot
*** SUMMARY ***
Total pot $2.85 | Rake $0.13 
Board [3d Kc 8d 5d Ks]
Seat 1: MRN888 showed [Ah Qc] and won ($1.36) with a pair of Kings
Seat 2: voadek12 folded on the Flop
Seat 3: Greentvdinne (button) folded before Flop (didn't bet)
Seat 4: eRRe_ssbm (small blind) folded before Flop
Seat 5: Manic Jay (big blind) showed [Qs Ad] and won ($1.36) with a pair of Kings
Seat 6: alVatroos folded on the Flop



PokerStars Hand #222956178334:  Hold'em No Limit ($0.05/$0.10 USD) - 2021/01/23 10:03:12 ET
Table 'Stephano III' 6-max Seat #4 is the button
Seat 1: MRN888 ($7.64 in chips) 
Seat 2: voadek12 ($5.50 in chips) 
Seat 3: Greentvdinne ($15.56 in chips) 
Seat 4: eRRe_ssbm ($19.93 in chips) 
Seat 5: Manic Jay ($9.76 in chips) 
Seat 6: alVatroos ($10 in chips) 
Manic Jay: posts small blind $0.05
alVatroos: posts big blind $0.10
*** HOLE CARDS ***
MRN888: calls $0.10
voadek12: folds 
Greentvdinne: folds 
eRRe_ssbm: folds 
Manic Jay: folds 
alVatroos: checks 
*** FLOP *** [Qc 9s Js]
alVatroos: checks 
MRN888: bets $0.10
alVatroos: calls $0.10
*** TURN *** [Qc 9s Js] [3d]
alVatroos: checks 
MRN888: bets $0.43
alVatroos: calls $0.43
*** RIVER *** [Qc 9s Js 3d] [7s]
alVatroos: checks 
MRN888: bets $0.63
alVatroos: calls $0.63
*** SHOW DOWN ***
MRN888: shows [2h 8h] (high card Queen)
alVatroos: shows [4d Jc] (a pair of Jacks)
alVatroos collected $2.45 from pot
*** SUMMARY ***
Total pot $2.57 | Rake $0.12 
Board [Qc 9s Js 3d 7s]
Seat 1: MRN888 showed [2h 8h] and lost with high card Queen
Seat 2: voadek12 folded before Flop (didn't bet)
Seat 3: Greentvdinne folded before Flop (didn't bet)
Seat 4: eRRe_ssbm (button) folded before Flop (didn't bet)
Seat 5: Manic Jay (small blind) folded before Flop
Seat 6: alVatroos (big blind) showed [4d Jc] and won ($2.45) with a pair of Jacks



PokerStars Hand #222956208775:  Hold'em No Limit ($0.05/$0.10 USD) - 2021/01/23 10:03:59 ET
Table 'Stephano III' 6-max Seat #5 is the button
Seat 1: MRN888 ($6.38 in chips) 
Seat 2: voadek12 ($5.50 in chips) 
Seat 3: Greentvdinne ($15.56 in chips) 
Seat 4: eRRe_ssbm ($19.93 in chips) 
Seat 5: Manic Jay ($9.71 in chips) 
Seat 6: alVatroos ($11.19 in chips) 
alVatroos: posts small blind $0.05
MRN888: posts big blind $0.10
*** HOLE CARDS ***
voadek12: calls $0.10
Greentvdinne: folds 
eRRe_ssbm: folds 
Manic Jay: folds 
alVatroos: folds 
MRN888: raises $0.10 to $0.20
voadek12: raises $0.50 to $0.70
MRN888: raises $1.45 to $2.15
voadek12: raises $3.35 to $5.50 and is all-in
MRN888: calls $3.35
*** FLOP *** [6h Ks 3s]
*** TURN *** [6h Ks 3s] [2h]
*** RIVER *** [6h Ks 3s 2h] [Ad]
*** SHOW DOWN ***
MRN888: shows [Qc Qh] (a pair of Queens)
voadek12: shows [Ac 4c] (a pair of Aces)
voadek12 collected $10.55 from pot
*** SUMMARY ***
Total pot $11.05 | Rake $0.50 
Board [6h Ks 3s 2h Ad]
Seat 1: MRN888 (big blind) showed [Qc Qh] and lost with a pair of Queens
Seat 2: voadek12 showed [Ac 4c] and won ($10.55) with a pair of Aces
Seat 3: Greentvdinne folded before Flop (didn't bet)
Seat 4: eRRe_ssbm folded before Flop (didn't bet)
Seat 5: Manic Jay (button) folded before Flop (didn't bet)
Seat 6: alVatroos (small blind) folded before Flop



PokerStars Hand #222956228070:  Hold'em No Limit ($0.05/$0.10 USD) - 2021/01/23 10:04:36 ET
Table 'Stephano III' 6-max Seat #6 is the button
Seat 1: MRN888 ($0.88 in chips) 
Seat 2: voadek12 ($10.55 in chips) 
Seat 3: Greentvdinne ($15.56 in chips) 
Seat 4: eRRe_ssbm ($19.93 in chips) 
Seat 5: Manic Jay ($9.71 in chips) 
Seat 6: alVatroos ($11.14 in chips) 
MRN888: posts small blind $0.05
voadek12: posts big blind $0.10
*** HOLE CARDS ***
Greentvdinne: folds 
eRRe_ssbm: folds 
Manic Jay: folds 
alVatroos: raises $0.15 to $0.25
MRN888: calls $0.20
voadek12: folds 
*** FLOP *** [Kh Th 5c]
MRN888: checks 
alVatroos: bets $0.20
MRN888: calls $0.20
*** TURN *** [Kh Th 5c] [8d]
MRN888: checks 
alVatroos: checks 
*** RIVER *** [Kh Th 5c 8d] [5d]
MRN888: bets $0.43 and is all-in
alVatroos: calls $0.43
*** SHOW DOWN ***
MRN888: shows [8c 9d] (two pair, Eights and Fives)
alVatroos: shows [Qd Ah] (a pair of Fives)
MRN888 collected $1.78 from pot
*** SUMMARY ***
Total pot $1.86 | Rake $0.08 
Board [Kh Th 5c 8d 5d]
Seat 1: MRN888 (small blind) showed [8c 9d] and won ($1.78) with two pair, Eights and Fives
Seat 2: voadek12 (big blind) folded before Flop
Seat 3: Greentvdinne folded before Flop (didn't bet)
Seat 4: eRRe_ssbm folded before Flop (didn't bet)
Seat 5: Manic Jay folded before Flop (didn't bet)
Seat 6: alVatroos (button) showed [Qd Ah] and lost with a pair of Fives



PokerStars Hand #222956245802:  Hold'em No Limit ($0.05/$0.10 USD) - 2021/01/23 10:05:10 ET
Table 'Stephano III' 6-max Seat #1 is the button
Seat 1: MRN888 ($10 in chips) 
Seat 2: voadek12 ($10.45 in chips) 
Seat 3: Greentvdinne ($15.56 in chips) 
Seat 4: eRRe_ssbm ($19.93 in chips) 
Seat 5: Manic Jay ($9.71 in chips) 
Seat 6: alVatroos ($10.26 in chips) 
voadek12: posts small blind $0.05
Greentvdinne: posts big blind $0.10
*** HOLE CARDS ***
eRRe_ssbm: folds 
Manic Jay: folds 
alVatroos: folds 
MRN888: calls $0.10
voadek12: calls $0.05
Greentvdinne: raises $0.20 to $0.30
MRN888: calls $0.20
voadek12: calls $0.20
*** FLOP *** [Qc Ts Tc]
voadek12: checks 
Greentvdinne: bets $0.50
MRN888: raises $0.50 to $1
voadek12: folds 
Greentvdinne: folds 
Uncalled bet ($0.50) returned to MRN888
MRN888 collected $1.81 from pot
MRN888: doesn't show hand 
*** SUMMARY ***
Total pot $1.90 | Rake $0.09 
Board [Qc Ts Tc]
Seat 1: MRN888 (button) collected ($1.81)
Seat 2: voadek12 (small blind) folded on the Flop
Seat 3: Greentvdinne (big blind) folded on the Flop
Seat 4: eRRe_ssbm folded before Flop (didn't bet)
Seat 5: Manic Jay folded before Flop (didn't bet)
Seat 6: alVatroos folded before Flop (didn't bet)



PokerStars Hand #222956261201:  Hold'em No Limit ($0.05/$0.10 USD) - 2021/01/23 10:05:39 ET
Table 'Stephano III' 6-max Seat #2 is the button
Seat 1: MRN888 ($11.01 in chips) 
Seat 2: voadek12 ($10.15 in chips) 
Seat 3: Greentvdinne ($14.76 in chips) 
Seat 4: eRRe_ssbm ($19.93 in chips) 
Seat 5: Manic Jay ($9.71 in chips) 
Seat 6: alVatroos ($10.26 in chips) 
Greentvdinne: posts small blind $0.05
eRRe_ssbm: posts big blind $0.10
*** HOLE CARDS ***
Manic Jay: calls $0.10
alVatroos: folds 
MRN888: calls $0.10
voadek12: folds 
Greentvdinne: folds 
eRRe_ssbm: checks 
*** FLOP *** [Ah 5s Qc]
voadek12 leaves the table
eRRe_ssbm: checks 
Manic Jay: checks 
MRN888: checks 
*** TURN *** [Ah 5s Qc] [5h]
eRRe_ssbm: checks 
Igorzdanov541 joins the table at seat #2 
Manic Jay: bets $0.33
MRN888: calls $0.33
eRRe_ssbm: folds 
*** RIVER *** [Ah 5s Qc 5h] [2s]
Manic Jay: bets $0.96
MRN888: folds 
Uncalled bet ($0.96) returned to Manic Jay
Manic Jay collected $0.96 from pot
*** SUMMARY ***
Total pot $1.01 | Rake $0.05 
Board [Ah 5s Qc 5h 2s]
Seat 1: MRN888 folded on the River
Seat 2: voadek12 (button) folded before Flop (didn't bet)
Seat 3: Greentvdinne (small blind) folded before Flop
Seat 4: eRRe_ssbm (big blind) folded on the Turn
Seat 5: Manic Jay collected ($0.96)
Seat 6: alVatroos folded before Flop (didn't bet)



PokerStars Hand #222956282612:  Hold'em No Limit ($0.05/$0.10 USD) - 2021/01/23 10:06:20 ET
Table 'Stephano III' 6-max Seat #3 is the button
Seat 1: MRN888 ($10.58 in chips) 
Seat 2: Igorzdanov541 ($4 in chips) 
Seat 3: Greentvdinne ($14.71 in chips) 
Seat 4: eRRe_ssbm ($19.83 in chips) 
Seat 5: Manic Jay ($10.24 in chips) 
Seat 6: alVatroos ($10.26 in chips) 
eRRe_ssbm: posts small blind $0.05
Manic Jay: posts big blind $0.10
Igorzdanov541: posts big blind $0.10
*** HOLE CARDS ***
alVatroos: folds 
MRN888: calls $0.10
Igorzdanov541: checks 
Greentvdinne: calls $0.10
eRRe_ssbm: folds 
Manic Jay: checks 
*** FLOP *** [Td 3h 9h]
Manic Jay: checks 
MRN888: bets $0.10
Igorzdanov541: folds 
Greentvdinne: calls $0.10
Manic Jay: folds 
*** TURN *** [Td 3h 9h] [3s]
MRN888: checks 
Greentvdinne: bets $0.40
MRN888: calls $0.40
*** RIVER *** [Td 3h 9h 3s] [9c]
MRN888: bets $0.10
Greentvdinne: folds 
Uncalled bet ($0.10) returned to MRN888
MRN888 collected $1.38 from pot
MRN888: doesn't show hand 
*** SUMMARY ***
Total pot $1.45 | Rake $0.07 
Board [Td 3h 9h 3s 9c]
Seat 1: MRN888 collected ($1.38)
Seat 2: Igorzdanov541 folded on the Flop (didn't bet)
Seat 3: Greentvdinne (button) folded on the River
Seat 4: eRRe_ssbm (small blind) folded before Flop
Seat 5: Manic Jay (big blind) folded on the Flop
Seat 6: alVatroos folded before Flop (didn't bet)



PokerStars Hand #222956302266:  Hold'em No Limit ($0.05/$0.10 USD) - 2021/01/23 10:06:57 ET
Table 'Stephano III' 6-max Seat #4 is the button
Seat 1: MRN888 ($11.36 in chips) 
Seat 2: Igorzdanov541 ($3.90 in chips) 
Seat 3: Greentvdinne ($14.11 in chips) 
Seat 4: eRRe_ssbm ($19.78 in chips) 
Seat 5: Manic Jay ($10.14 in chips) 
Seat 6: alVatroos ($10.26 in chips) 
Manic Jay: posts small blind $0.05
alVatroos: posts big blind $0.10
*** HOLE CARDS ***
MRN888: raises $0.10 to $0.20
Igorzdanov541: calls $0.20
Greentvdinne: folds 
eRRe_ssbm: raises $0.90 to $1.10
Manic Jay: folds 
alVatroos: folds 
MRN888: raises $0.90 to $2
Igorzdanov541: folds 
eRRe_ssbm: folds 
Uncalled bet ($0.90) returned to MRN888
MRN888 collected $2.55 from pot
MRN888: doesn't show hand 
*** SUMMARY ***
Total pot $2.55 | Rake $0 
Seat 1: MRN888 collected ($2.55)
Seat 2: Igorzdanov541 folded before Flop
Seat 3: Greentvdinne folded before Flop (didn't bet)
Seat 4: eRRe_ssbm (button) folded before Flop
Seat 5: Manic Jay (small blind) folded before Flop
Seat 6: alVatroos (big blind) folded before Flop



PokerStars Hand #222956318755:  Hold'em No Limit ($0.05/$0.10 USD) - 2021/01/23 10:07:29 ET
Table 'Stephano III' 6-max Seat #5 is the button
Seat 1: MRN888 ($12.81 in chips) 
Seat 2: Igorzdanov541 ($3.70 in chips) 
Seat 3: Greentvdinne ($14.11 in chips) 
Seat 4: eRRe_ssbm ($18.68 in chips) 
Seat 5: Manic Jay ($10.09 in chips) 
Seat 6: alVatroos ($10.16 in chips) 
alVatroos: posts small blind $0.05
MRN888: posts big blind $0.10
*** HOLE CARDS ***
Igorzdanov541: folds 
Greentvdinne: folds 
eRRe_ssbm: folds 
Manic Jay: folds 
alVatroos: raises $0.10 to $0.20
MRN888: calls $0.10
*** FLOP *** [9s Kd 4h]
alVatroos: checks 
MRN888: bets $0.38
alVatroos: calls $0.38
*** TURN *** [9s Kd 4h] [7c]
alVatroos: checks 
MRN888: checks 
*** RIVER *** [9s Kd 4h 7c] [5s]
alVatroos: checks 
MRN888: bets $0.10
alVatroos: calls $0.10
*** SHOW DOWN ***
MRN888: shows [3h 7s] (a pair of Sevens)
alVatroos: mucks hand 
MRN888 collected $1.30 from pot
*** SUMMARY ***
Total pot $1.36 | Rake $0.06 
Board [9s Kd 4h 7c 5s]
Seat 1: MRN888 (big blind) showed [3h 7s] and won ($1.30) with a pair of Sevens
Seat 2: Igorzdanov541 folded before Flop (didn't bet)
Seat 3: Greentvdinne folded before Flop (didn't bet)
Seat 4: eRRe_ssbm folded before Flop (didn't bet)
Seat 5: Manic Jay (button) folded before Flop (didn't bet)
Seat 6: alVatroos (small blind) mucked



PokerStars Hand #222956337533:  Hold'em No Limit ($0.05/$0.10 USD) - 2021/01/23 10:08:05 ET
Table 'Stephano III' 6-max Seat #6 is the button
Seat 1: MRN888 ($13.43 in chips) 
Seat 2: Igorzdanov541 ($3.70 in chips) 
Seat 3: Greentvdinne ($14.11 in chips) 
Seat 4: eRRe_ssbm ($18.68 in chips) 
Seat 5: Manic Jay ($10.09 in chips) 
Seat 6: alVatroos ($10 in chips) 
MRN888: posts small blind $0.05
Igorzdanov541: posts big blind $0.10
*** HOLE CARDS ***
Greentvdinne: calls $0.10
eRRe_ssbm: folds 
Manic Jay: folds 
alVatroos: folds 
MRN888: raises $0.30 to $0.40
Igorzdanov541: calls $0.30
Greentvdinne: calls $0.30
*** FLOP *** [2s 2h 6h]
MRN888: bets $0.10
Igorzdanov541: raises $0.10 to $0.20
Greentvdinne: folds 
MRN888: calls $0.10
*** TURN *** [2s 2h 6h] [7h]
MRN888: checks 
Igorzdanov541: checks 
*** RIVER *** [2s 2h 6h 7h] [Tc]
MRN888: bets $0.10
Igorzdanov541: folds 
Uncalled bet ($0.10) returned to MRN888
MRN888 collected $1.53 from pot
MRN888: doesn't show hand 
*** SUMMARY ***
Total pot $1.60 | Rake $0.07 
Board [2s 2h 6h 7h Tc]
Seat 1: MRN888 (small blind) collected ($1.53)
Seat 2: Igorzdanov541 (big blind) folded on the River
Seat 3: Greentvdinne folded on the Flop
Seat 4: eRRe_ssbm folded before Flop (didn't bet)
Seat 5: Manic Jay folded before Flop (didn't bet)
Seat 6: alVatroos (button) folded before Flop (didn't bet)



PokerStars Hand #222956361923:  Hold'em No Limit ($0.05/$0.10 USD) - 2021/01/23 10:08:52 ET
Table 'Stephano III' 6-max Seat #1 is the button
Seat 1: MRN888 ($14.36 in chips) 
Seat 2: Igorzdanov541 ($3.10 in chips) 
Seat 3: Greentvdinne ($13.71 in chips) 
Seat 4: eRRe_ssbm ($18.68 in chips) 
Seat 5: Manic Jay ($10.09 in chips) 
Seat 6: alVatroos ($10 in chips) 
Igorzdanov541: posts small blind $0.05
Greentvdinne: posts big blind $0.10
*** HOLE CARDS ***
eRRe_ssbm: raises $0.20 to $0.30
Manic Jay: folds 
alVatroos: folds 
MRN888: calls $0.30
Igorzdanov541: raises $0.20 to $0.50
Greentvdinne: folds 
eRRe_ssbm: folds 
MRN888: raises $1.40 to $1.90
Igorzdanov541: raises $1.20 to $3.10 and is all-in
MRN888: calls $1.20
*** FLOP *** [8d 4d 8c]
*** TURN *** [8d 4d 8c] [Qc]
*** RIVER *** [8d 4d 8c Qc] [8h]
*** SHOW DOWN ***
Igorzdanov541: shows [2s As] (three of a kind, Eights)
MRN888: shows [Ts Qs] (a full house, Eights full of Queens)
MRN888 collected $6.30 from pot
*** SUMMARY ***
Total pot $6.60 | Rake $0.30 
Board [8d 4d 8c Qc 8h]
Seat 1: MRN888 (button) showed [Ts Qs] and won ($6.30) with a full house, Eights full of Queens
Seat 2: Igorzdanov541 (small blind) showed [2s As] and lost with three of a kind, Eights
Seat 3: Greentvdinne (big blind) folded before Flop
Seat 4: eRRe_ssbm folded before Flop
Seat 5: Manic Jay folded before Flop (didn't bet)
Seat 6: alVatroos folded before Flop (didn't bet)



PokerStars Hand #222956383883:  Hold'em No Limit ($0.05/$0.10 USD) - 2021/01/23 10:09:34 ET
Table 'Stephano III' 6-max Seat #3 is the button
Seat 1: MRN888 ($17.56 in chips) 
Seat 3: Greentvdinne ($13.61 in chips) 
Seat 4: eRRe_ssbm ($18.38 in chips) 
Seat 5: Manic Jay ($10.09 in chips) 
Seat 6: alVatroos ($10 in chips) 
eRRe_ssbm: posts small blind $0.05
Manic Jay: posts big blind $0.10
*** HOLE CARDS ***
alVatroos: folds 
MRN888: calls $0.10
Greentvdinne: folds 
eRRe_ssbm: folds 
Manic Jay: checks 
*** FLOP *** [6d 4s 9c]
Igorzdanov541 leaves the table
Manic Jay: checks 
MRN888: checks 
*** TURN *** [6d 4s 9c] [Tc]
Manic Jay: checks 
MRN888: checks 
*** RIVER *** [6d 4s 9c Tc] [8d]
Manic Jay: checks 
MRN888: bets $0.24
petrovichkag joins the table at seat #2 
Manic Jay: raises $0.56 to $0.80
MRN888: folds 
Uncalled bet ($0.56) returned to Manic Jay
Manic Jay collected $0.70 from pot
*** SUMMARY ***
Total pot $0.73 | Rake $0.03 
Board [6d 4s 9c Tc 8d]
Seat 1: MRN888 folded on the River
Seat 3: Greentvdinne (button) folded before Flop (didn't bet)
Seat 4: eRRe_ssbm (small blind) folded before Flop
Seat 5: Manic Jay (big blind) collected ($0.70)
Seat 6: alVatroos folded before Flop (didn't bet)



PokerStars Hand #222956399043:  Hold'em No Limit ($0.05/$0.10 USD) - 2021/01/23 10:10:03 ET
Table 'Stephano III' 6-max Seat #4 is the button
Seat 1: MRN888 ($17.22 in chips) 
Seat 3: Greentvdinne ($13.61 in chips) 
Seat 4: eRRe_ssbm ($18.33 in chips) 
Seat 5: Manic Jay ($10.45 in chips) 
Seat 6: alVatroos ($10 in chips) 
Manic Jay: posts small blind $0.05
alVatroos: posts big blind $0.10
petrovichkag: sits out 
*** HOLE CARDS ***
MRN888: raises $0.10 to $0.20
Greentvdinne: raises $0.10 to $0.30
eRRe_ssbm: folds 
Manic Jay: calls $0.25
alVatroos: calls $0.20
MRN888: raises $1.20 to $1.50
Greentvdinne: folds 
Manic Jay: calls $1.20
alVatroos: folds 
*** FLOP *** [Jc Ts Kh]
Manic Jay: checks 
MRN888: checks 
*** TURN *** [Jc Ts Kh] [9d]
Manic Jay: checks 
MRN888: checks 
*** RIVER *** [Jc Ts Kh 9d] [7h]
Manic Jay: bets $4.20
MRN888: raises $11.52 to $15.72 and is all-in
Manic Jay: calls $4.75 and is all-in
Uncalled bet ($6.77) returned to MRN888
*** SHOW DOWN ***
MRN888: shows [8h 8d] (a straight, Seven to Jack)
Manic Jay: shows [Ah 8s] (a straight, Seven to Jack)
Manic Jay collected $10.27 from pot
MRN888 collected $10.26 from pot
*** SUMMARY ***
Total pot $21.50 | Rake $0.97 
Board [Jc Ts Kh 9d 7h]
Seat 1: MRN888 showed [8h 8d] and won ($10.26) with a straight, Seven to Jack
Seat 3: Greentvdinne folded before Flop
Seat 4: eRRe_ssbm (button) folded before Flop (didn't bet)
Seat 5: Manic Jay (small blind) showed [Ah 8s] and won ($10.27) with a straight, Seven to Jack
Seat 6: alVatroos (big blind) folded before Flop



PokerStars Hand #222956426878:  Hold'em No Limit ($0.05/$0.10 USD) - 2021/01/23 10:10:56 ET
Table 'Stephano III' 6-max Seat #5 is the button
Seat 1: MRN888 ($17.03 in chips) 
Seat 3: Greentvdinne ($13.31 in chips) 
Seat 4: eRRe_ssbm ($18.33 in chips) 
Seat 5: Manic Jay ($10.27 in chips) 
Seat 6: alVatroos ($10 in chips) 
alVatroos: posts small blind $0.05
MRN888: posts big blind $0.10
petrovichkag: sits out 
*** HOLE CARDS ***
Greentvdinne: folds 
eRRe_ssbm: folds 
Manic Jay: folds 
alVatroos: raises $0.20 to $0.30
MRN888: calls $0.20
*** FLOP *** [8s Ac Kd]
alVatroos: checks 
MRN888: checks 
*** TURN *** [8s Ac Kd] [2c]
alVatroos: bets $0.34
MRN888: folds 
Uncalled bet ($0.34) returned to alVatroos
alVatroos collected $0.57 from pot
alVatroos: doesn't show hand 
*** SUMMARY ***
Total pot $0.60 | Rake $0.03 
Board [8s Ac Kd 2c]
Seat 1: MRN888 (big blind) folded on the Turn
Seat 3: Greentvdinne folded before Flop (didn't bet)
Seat 4: eRRe_ssbm folded before Flop (didn't bet)
Seat 5: Manic Jay (button) folded before Flop (didn't bet)
Seat 6: alVatroos (small blind) collected ($0.57)



PokerStars Hand #222956438086:  Hold'em No Limit ($0.05/$0.10 USD) - 2021/01/23 10:11:18 ET
Table 'Stephano III' 6-max Seat #6 is the button
Seat 1: MRN888 ($16.73 in chips) 
Seat 2: petrovichkag ($10 in chips) 
Seat 3: Greentvdinne ($13.31 in chips) 
Seat 4: eRRe_ssbm ($18.33 in chips) 
Seat 5: Manic Jay ($10.27 in chips) 
Seat 6: alVatroos ($10.27 in chips) 
MRN888: posts small blind $0.05
petrovichkag: posts big blind $0.10
*** HOLE CARDS ***
Greentvdinne: folds 
eRRe_ssbm: folds 
Manic Jay: raises $0.20 to $0.30
alVatroos: folds 
MRN888: folds 
petrovichkag: folds 
Uncalled bet ($0.20) returned to Manic Jay
Manic Jay collected $0.25 from pot
*** SUMMARY ***
Total pot $0.25 | Rake $0 
Seat 1: MRN888 (small blind) folded before Flop
Seat 2: petrovichkag (big blind) folded before Flop
Seat 3: Greentvdinne folded before Flop (didn't bet)
Seat 4: eRRe_ssbm folded before Flop (didn't bet)
Seat 5: Manic Jay collected ($0.25)
Seat 6: alVatroos (button) folded before Flop (didn't bet)



PokerStars Hand #222956442868:  Hold'em No Limit ($0.05/$0.10 USD) - 2021/01/23 10:11:26 ET
Table 'Stephano III' 6-max Seat #1 is the button
Seat 1: MRN888 ($16.68 in chips) 
Seat 2: petrovichkag ($10 in chips) 
Seat 3: Greentvdinne ($13.31 in chips) 
Seat 4: eRRe_ssbm ($18.33 in chips) 
Seat 5: Manic Jay ($10.42 in chips) 
Seat 6: alVatroos ($10.27 in chips) 
petrovichkag: posts small blind $0.05
Greentvdinne: posts big blind $0.10
*** HOLE CARDS ***
eRRe_ssbm: folds 
Manic Jay: folds 
alVatroos: raises $0.20 to $0.30
MRN888: folds 
petrovichkag: raises $0.90 to $1.20
Greentvdinne: folds 
alVatroos: folds 
Uncalled bet ($0.90) returned to petrovichkag
petrovichkag collected $0.70 from pot
petrovichkag: doesn't show hand 
*** SUMMARY ***
Total pot $0.70 | Rake $0 
Seat 1: MRN888 (button) folded before Flop (didn't bet)
Seat 2: petrovichkag (small blind) collected ($0.70)
Seat 3: Greentvdinne (big blind) folded before Flop
Seat 4: eRRe_ssbm folded before Flop (didn't bet)
Seat 5: Manic Jay folded before Flop (didn't bet)
Seat 6: alVatroos folded before Flop



PokerStars Hand #222956451682:  Hold'em No Limit ($0.05/$0.10 USD) - 2021/01/23 10:11:43 ET
Table 'Stephano III' 6-max Seat #2 is the button
Seat 1: MRN888 ($16.68 in chips) 
Seat 2: petrovichkag ($10.40 in chips) 
Seat 3: Greentvdinne ($13.21 in chips) 
Seat 4: eRRe_ssbm ($18.33 in chips) 
Seat 5: Manic Jay ($10.42 in chips) 
Seat 6: alVatroos ($10 in chips) 
Greentvdinne: posts small blind $0.05
eRRe_ssbm: posts big blind $0.10
*** HOLE CARDS ***
Manic Jay: calls $0.10
alVatroos: folds 
MRN888: calls $0.10
petrovichkag: folds 
Greentvdinne: folds 
eRRe_ssbm: checks 
*** FLOP *** [4d Qd 9d]
eRRe_ssbm: checks 
Manic Jay: checks 
MRN888: bets $0.33
eRRe_ssbm: calls $0.33
Manic Jay: folds 
*** TURN *** [4d Qd 9d] [Ks]
eRRe_ssbm: checks 
MRN888: checks 
*** RIVER *** [4d Qd 9d Ks] [Ad]
eRRe_ssbm: checks 
MRN888: bets $0.96
eRRe_ssbm: calls $0.96
*** SHOW DOWN ***
MRN888: shows [Jd 8s] (a flush, Ace high)
eRRe_ssbm: mucks hand 
MRN888 collected $2.80 from pot
*** SUMMARY ***
Total pot $2.93 | Rake $0.13 
Board [4d Qd 9d Ks Ad]
Seat 1: MRN888 showed [Jd 8s] and won ($2.80) with a flush, Ace high
Seat 2: petrovichkag (button) folded before Flop (didn't bet)
Seat 3: Greentvdinne (small blind) folded before Flop
Seat 4: eRRe_ssbm (big blind) mucked
Seat 5: Manic Jay folded on the Flop
Seat 6: alVatroos folded before Flop (didn't bet)



PokerStars Hand #222956480929:  Hold'em No Limit ($0.05/$0.10 USD) - 2021/01/23 10:12:38 ET
Table 'Stephano III' 6-max Seat #3 is the button
Seat 1: MRN888 ($18.09 in chips) 
Seat 2: petrovichkag ($10.40 in chips) 
Seat 3: Greentvdinne ($13.16 in chips) 
Seat 4: eRRe_ssbm ($16.94 in chips) 
Seat 5: Manic Jay ($10.32 in chips) 
Seat 6: alVatroos ($10 in chips) 
eRRe_ssbm: posts small blind $0.05
Manic Jay: posts big blind $0.10
*** HOLE CARDS ***
alVatroos: folds 
MRN888: calls $0.10
petrovichkag: raises $0.30 to $0.40
Greentvdinne: folds 
eRRe_ssbm: folds 
Manic Jay: calls $0.30
MRN888: calls $0.30
*** FLOP *** [5d Qh Kd]
Manic Jay: bets $0.60
MRN888: calls $0.60
petrovichkag: calls $0.60
*** TURN *** [5d Qh Kd] [8s]
Manic Jay: checks 
MRN888: bets $0.10
petrovichkag: raises $1.71 to $1.81
Manic Jay: folds 
MRN888: folds 
Uncalled bet ($1.71) returned to petrovichkag
petrovichkag collected $3.10 from pot
petrovichkag: doesn't show hand 
*** SUMMARY ***
Total pot $3.25 | Rake $0.15 
Board [5d Qh Kd 8s]
Seat 1: MRN888 folded on the Turn
Seat 2: petrovichkag collected ($3.10)
Seat 3: Greentvdinne (button) folded before Flop (didn't bet)
Seat 4: eRRe_ssbm (small blind) folded before Flop
Seat 5: Manic Jay (big blind) folded on the Turn
Seat 6: alVatroos folded before Flop (didn't bet)



PokerStars Hand #222956503211:  Hold'em No Limit ($0.05/$0.10 USD) - 2021/01/23 10:13:20 ET
Table 'Stephano III' 6-max Seat #4 is the button
Seat 1: MRN888 ($16.99 in chips) 
Seat 2: petrovichkag ($12.40 in chips) 
Seat 3: Greentvdinne ($13.16 in chips) 
Seat 4: eRRe_ssbm ($16.89 in chips) 
Seat 5: Manic Jay ($9.32 in chips) 
Seat 6: alVatroos ($10 in chips) 
Manic Jay: posts small blind $0.05
alVatroos: posts big blind $0.10
*** HOLE CARDS ***
MRN888: calls $0.10
petrovichkag: folds 
Greentvdinne: folds 
eRRe_ssbm: folds 
Manic Jay: calls $0.05
alVatroos: checks 
*** FLOP *** [Qh 8c 4h]
Manic Jay: checks 
alVatroos: checks 
MRN888: checks 
*** TURN *** [Qh 8c 4h] [Ah]
Manic Jay: checks 
alVatroos: checks 
MRN888: checks 
*** RIVER *** [Qh 8c 4h Ah] [Th]
Manic Jay: checks 
alVatroos: checks 
MRN888: bets $0.90
Manic Jay: folds 
alVatroos: folds 
Uncalled bet ($0.90) returned to MRN888
MRN888 collected $0.29 from pot
MRN888: doesn't show hand 
*** SUMMARY ***
Total pot $0.30 | Rake $0.01 
Board [Qh 8c 4h Ah Th]
Seat 1: MRN888 collected ($0.29)
Seat 2: petrovichkag folded before Flop (didn't bet)
Seat 3: Greentvdinne folded before Flop (didn't bet)
Seat 4: eRRe_ssbm (button) folded before Flop (didn't bet)
Seat 5: Manic Jay (small blind) folded on the River
Seat 6: alVatroos (big blind) folded on the River



PokerStars Hand #222956530934:  Hold'em No Limit ($0.05/$0.10 USD) - 2021/01/23 10:14:13 ET
Table 'Stephano III' 6-max Seat #5 is the button
Seat 1: MRN888 ($17.18 in chips) 
Seat 2: petrovichkag ($12.40 in chips) 
Seat 3: Greentvdinne ($13.16 in chips) 
Seat 4: eRRe_ssbm ($16.89 in chips) 
Seat 5: Manic Jay ($9.22 in chips) 
Seat 6: alVatroos ($10 in chips) 
alVatroos: posts small blind $0.05
MRN888: posts big blind $0.10
*** HOLE CARDS ***
petrovichkag: folds 
Greentvdinne: raises $0.25 to $0.35
eRRe_ssbm: folds 
Manic Jay: folds 
alVatroos: folds 
MRN888: folds 
Uncalled bet ($0.25) returned to Greentvdinne
MRN888 leaves the table
Greentvdinne collected $0.25 from pot
*** SUMMARY ***
Total pot $0.25 | Rake $0 
Seat 1: MRN888 (big blind) folded before Flop
Seat 2: petrovichkag folded before Flop (didn't bet)
Seat 3: Greentvdinne collected ($0.25)
Seat 4: eRRe_ssbm folded before Flop (didn't bet)
Seat 5: Manic Jay (button) folded before Flop (didn't bet)
Seat 6: alVatroos (small blind) folded before Flop



PokerStars Hand #222956536789:  Hold'em No Limit ($0.05/$0.10 USD) - 2021/01/23 10:14:24 ET
Table 'Stephano III' 6-max Seat #6 is the button
Seat 2: petrovichkag ($12.40 in chips) 
Seat 3: Greentvdinne ($13.31 in chips) 
Seat 4: eRRe_ssbm ($16.89 in chips) 
Seat 5: Manic Jay ($9.22 in chips) 
Seat 6: alVatroos ($10 in chips) 
petrovichkag: posts small blind $0.05
Greentvdinne: posts big blind $0.10
*** HOLE CARDS ***
Intimitatem joins the table at seat #1 
eRRe_ssbm: folds 
Manic Jay: raises $0.20 to $0.30
alVatroos: folds 
petrovichkag: folds 
Greentvdinne: folds 
Uncalled bet ($0.20) returned to Manic Jay
Manic Jay collected $0.25 from pot
*** SUMMARY ***
Total pot $0.25 | Rake $0 
Seat 2: petrovichkag (small blind) folded before Flop
Seat 3: Greentvdinne (big blind) folded before Flop
Seat 4: eRRe_ssbm folded before Flop (didn't bet)
Seat 5: Manic Jay collected ($0.25)
Seat 6: alVatroos (button) folded before Flop (didn't bet)



PokerStars Hand #222956545052:  Hold'em No Limit ($0.05/$0.10 USD) - 2021/01/23 10:14:39 ET
Table 'Stephano III' 6-max Seat #2 is the button
Seat 2: petrovichkag ($12.35 in chips) 
Seat 3: Greentvdinne ($13.21 in chips) 
Seat 4: eRRe_ssbm ($16.89 in chips) 
Seat 5: Manic Jay ($9.37 in chips) 
Seat 6: alVatroos ($10 in chips) 
Greentvdinne: posts small blind $0.05
eRRe_ssbm: posts big blind $0.10
Intimitatem: sits out 
*** HOLE CARDS ***
Manic Jay: raises $0.20 to $0.30
alVatroos: folds 
petrovichkag: folds 
Greentvdinne: folds 
eRRe_ssbm: calls $0.20
*** FLOP *** [4s 4h 6s]
eRRe_ssbm: checks 
Manic Jay: bets $0.31
eRRe_ssbm: calls $0.31
*** TURN *** [4s 4h 6s] [5h]
eRRe_ssbm: checks 
Manic Jay: checks 
*** RIVER *** [4s 4h 6s 5h] [Js]
eRRe_ssbm: bets $0.40
Manic Jay: calls $0.40
*** SHOW DOWN ***
eRRe_ssbm: shows [3d 3c] (two pair, Fours and Threes)
Manic Jay: shows [6d Ah] (two pair, Sixes and Fours)
Manic Jay collected $1.98 from pot
*** SUMMARY ***
Total pot $2.07 | Rake $0.09 
Board [4s 4h 6s 5h Js]
Seat 2: petrovichkag (button) folded before Flop (didn't bet)
Seat 3: Greentvdinne (small blind) folded before Flop
Seat 4: eRRe_ssbm (big blind) showed [3d 3c] and lost with two pair, Fours and Threes
Seat 5: Manic Jay showed [6d Ah] and won ($1.98) with two pair, Sixes and Fours
Seat 6: alVatroos folded before Flop (didn't bet)



PokerStars Hand #222956582487:  Hold'em No Limit ($0.05/$0.10 USD) - 2021/01/23 10:15:49 ET
Table 'Stephano III' 6-max Seat #3 is the button
Seat 2: petrovichkag ($12.35 in chips) 
Seat 3: Greentvdinne ($13.16 in chips) 
Seat 4: eRRe_ssbm ($15.88 in chips) 
Seat 5: Manic Jay ($10.34 in chips) 
Seat 6: alVatroos ($10 in chips) 
eRRe_ssbm: posts small blind $0.05
Manic Jay: posts big blind $0.10
Intimitatem: sits out 
*** HOLE CARDS ***
alVatroos: raises $0.20 to $0.30
petrovichkag: folds 
Greentvdinne: folds 
eRRe_ssbm: folds 
Manic Jay: raises $0.30 to $0.60
alVatroos: calls $0.30
*** FLOP *** [Th 4s Qc]
Manic Jay: checks 
alVatroos: bets $0.39
Manic Jay: folds 
Uncalled bet ($0.39) returned to alVatroos
alVatroos collected $1.19 from pot
alVatroos: doesn't show hand 
*** SUMMARY ***
Total pot $1.25 | Rake $0.06 
Board [Th 4s Qc]
Seat 2: petrovichkag folded before Flop (didn't bet)
Seat 3: Greentvdinne (button) folded before Flop (didn't bet)
Seat 4: eRRe_ssbm (small blind) folded before Flop
Seat 5: Manic Jay (big blind) folded on the Flop
Seat 6: alVatroos collected ($1.19)



PokerStars Hand #222956597281:  Hold'em No Limit ($0.05/$0.10 USD) - 2021/01/23 10:16:17 ET
Table 'Stephano III' 6-max Seat #4 is the button
Seat 2: petrovichkag ($12.35 in chips) 
Seat 3: Greentvdinne ($13.16 in chips) 
Seat 4: eRRe_ssbm ($15.83 in chips) 
Seat 5: Manic Jay ($9.74 in chips) 
Seat 6: alVatroos ($10.59 in chips) 
Manic Jay: posts small blind $0.05
alVatroos: posts big blind $0.10
Intimitatem: sits out 
*** HOLE CARDS ***
petrovichkag: folds 
Greentvdinne: folds 
eRRe_ssbm: raises $0.20 to $0.30
Manic Jay: folds 
alVatroos: folds 
Uncalled bet ($0.20) returned to eRRe_ssbm
eRRe_ssbm collected $0.25 from pot
eRRe_ssbm: doesn't show hand 
*** SUMMARY ***
Total pot $0.25 | Rake $0 
Seat 2: petrovichkag folded before Flop (didn't bet)
Seat 3: Greentvdinne folded before Flop (didn't bet)
Seat 4: eRRe_ssbm (button) collected ($0.25)
Seat 5: Manic Jay (small blind) folded before Flop
Seat 6: alVatroos (big blind) folded before Flop



PokerStars Hand #222956605158:  Hold'em No Limit ($0.05/$0.10 USD) - 2021/01/23 10:16:31 ET
Table 'Stephano III' 6-max Seat #5 is the button
Seat 1: Intimitatem ($10 in chips) 
Seat 2: petrovichkag ($12.35 in chips) 
Seat 3: Greentvdinne ($13.16 in chips) 
Seat 4: eRRe_ssbm ($15.98 in chips) 
Seat 5: Manic Jay ($9.69 in chips) 
Seat 6: alVatroos ($10.49 in chips) 
alVatroos: posts small blind $0.05
Intimitatem: posts big blind $0.10
*** HOLE CARDS ***
petrovichkag: folds 
Greentvdinne: folds 
eRRe_ssbm: folds 
Manic Jay: calls $0.10
alVatroos: folds 
Intimitatem: checks 
*** FLOP *** [Qs Qh 6c]
Intimitatem: checks 
Manic Jay: checks 
*** TURN *** [Qs Qh 6c] [3s]
Intimitatem: checks 
Manic Jay: checks 
*** RIVER *** [Qs Qh 6c 3s] [7s]
Intimitatem: checks 
Manic Jay: checks 
*** SHOW DOWN ***
Intimitatem: shows [2c Jd] (a pair of Queens)
Manic Jay: mucks hand 
Intimitatem collected $0.24 from pot
*** SUMMARY ***
Total pot $0.25 | Rake $0.01 
Board [Qs Qh 6c 3s 7s]
Seat 1: Intimitatem (big blind) showed [2c Jd] and won ($0.24) with a pair of Queens
Seat 2: petrovichkag folded before Flop (didn't bet)
Seat 3: Greentvdinne folded before Flop (didn't bet)
Seat 4: eRRe_ssbm folded before Flop (didn't bet)
Seat 5: Manic Jay (button) mucked
Seat 6: alVatroos (small blind) folded before Flop



PokerStars Hand #222956631452:  Hold'em No Limit ($0.05/$0.10 USD) - 2021/01/23 10:17:21 ET
Table 'Stephano III' 6-max Seat #6 is the button
Seat 1: Intimitatem ($10.14 in chips) 
Seat 2: petrovichkag ($12.35 in chips) 
Seat 3: Greentvdinne ($13.16 in chips) 
Seat 4: eRRe_ssbm ($15.98 in chips) 
Seat 5: Manic Jay ($9.59 in chips) 
Seat 6: alVatroos ($10.44 in chips) 
Intimitatem: posts small blind $0.05
petrovichkag: posts big blind $0.10
*** HOLE CARDS ***
Greentvdinne: folds 
eRRe_ssbm: folds 
Manic Jay: calls $0.10
alVatroos: calls $0.10
Intimitatem: folds 
petrovichkag: checks 
*** FLOP *** [9c Ac 9h]
petrovichkag: checks 
Manic Jay: bets $0.30
alVatroos: folds 
petrovichkag: folds 
Uncalled bet ($0.30) returned to Manic Jay
Manic Jay collected $0.33 from pot
*** SUMMARY ***
Total pot $0.35 | Rake $0.02 
Board [9c Ac 9h]
Seat 1: Intimitatem (small blind) folded before Flop
Seat 2: petrovichkag (big blind) folded on the Flop
Seat 3: Greentvdinne folded before Flop (didn't bet)
Seat 4: eRRe_ssbm folded before Flop (didn't bet)
Seat 5: Manic Jay collected ($0.33)
Seat 6: alVatroos (button) folded on the Flop



PokerStars Hand #222956641971:  Hold'em No Limit ($0.05/$0.10 USD) - 2021/01/23 10:17:40 ET
Table 'Stephano III' 6-max Seat #1 is the button
Seat 1: Intimitatem ($10.09 in chips) 
Seat 2: petrovichkag ($12.25 in chips) 
Seat 3: Greentvdinne ($13.16 in chips) 
Seat 4: eRRe_ssbm ($15.98 in chips) 
Seat 5: Manic Jay ($9.82 in chips) 
Seat 6: alVatroos ($10.34 in chips) 
petrovichkag: posts small blind $0.05
Greentvdinne: posts big blind $0.10
*** HOLE CARDS ***
eRRe_ssbm: folds 
Manic Jay: folds 
alVatroos: folds 
Intimitatem: folds 
petrovichkag: folds 
Uncalled bet ($0.05) returned to Greentvdinne
Greentvdinne collected $0.10 from pot
Greentvdinne: doesn't show hand 
*** SUMMARY ***
Total pot $0.10 | Rake $0 
Seat 1: Intimitatem (button) folded before Flop (didn't bet)
Seat 2: petrovichkag (small blind) folded before Flop
Seat 3: Greentvdinne (big blind) collected ($0.10)
Seat 4: eRRe_ssbm folded before Flop (didn't bet)
Seat 5: Manic Jay folded before Flop (didn't bet)
Seat 6: alVatroos folded before Flop (didn't bet)



PokerStars Hand #222956645770:  Hold'em No Limit ($0.05/$0.10 USD) - 2021/01/23 10:17:47 ET
Table 'Stephano III' 6-max Seat #2 is the button
Seat 1: Intimitatem ($10.09 in chips) 
Seat 2: petrovichkag ($12.20 in chips) 
Seat 3: Greentvdinne ($13.21 in chips) 
Seat 4: eRRe_ssbm ($15.98 in chips) 
Seat 5: Manic Jay ($9.82 in chips) 
Seat 6: alVatroos ($10.34 in chips) 
Greentvdinne: posts small blind $0.05
eRRe_ssbm: posts big blind $0.10
*** HOLE CARDS ***
Manic Jay: calls $0.10
alVatroos: folds 
Intimitatem: folds 
petrovichkag: folds 
Greentvdinne: calls $0.05
eRRe_ssbm: checks 
*** FLOP *** [4d 7s Ah]
Greentvdinne: checks 
eRRe_ssbm: checks 
Manic Jay: bets $0.29
Greentvdinne: folds 
eRRe_ssbm: folds 
Uncalled bet ($0.29) returned to Manic Jay
Manic Jay collected $0.29 from pot
*** SUMMARY ***
Total pot $0.30 | Rake $0.01 
Board [4d 7s Ah]
Seat 1: Intimitatem folded before Flop (didn't bet)
Seat 2: petrovichkag (button) folded before Flop (didn't bet)
Seat 3: Greentvdinne (small blind) folded on the Flop
Seat 4: eRRe_ssbm (big blind) folded on the Flop
Seat 5: Manic Jay collected ($0.29)
Seat 6: alVatroos folded before Flop (didn't bet)



PokerStars Hand #222956664510:  Hold'em No Limit ($0.05/$0.10 USD) - 2021/01/23 10:18:22 ET
Table 'Stephano III' 6-max Seat #3 is the button
Seat 1: Intimitatem ($10.09 in chips) 
Seat 2: petrovichkag ($12.20 in chips) 
Seat 3: Greentvdinne ($13.11 in chips) 
Seat 4: eRRe_ssbm ($15.88 in chips) 
Seat 5: Manic Jay ($10.01 in chips) 
Seat 6: alVatroos ($10.34 in chips) 
eRRe_ssbm: posts small blind $0.05
Manic Jay: posts big blind $0.10
*** HOLE CARDS ***
alVatroos: folds 
Intimitatem: folds 
petrovichkag: folds 
Greentvdinne: folds 
eRRe_ssbm: folds 
Uncalled bet ($0.05) returned to Manic Jay
Manic Jay collected $0.10 from pot
*** SUMMARY ***
Total pot $0.10 | Rake $0 
Seat 1: Intimitatem folded before Flop (didn't bet)
Seat 2: petrovichkag folded before Flop (didn't bet)
Seat 3: Greentvdinne (button) folded before Flop (didn't bet)
Seat 4: eRRe_ssbm (small blind) folded before Flop
Seat 5: Manic Jay (big blind) collected ($0.10)
Seat 6: alVatroos folded before Flop (didn't bet)



PokerStars Hand #222956673023:  Hold'em No Limit ($0.05/$0.10 USD) - 2021/01/23 10:18:38 ET
Table 'Stephano III' 6-max Seat #4 is the button
Seat 1: Intimitatem ($10.09 in chips) 
Seat 2: petrovichkag ($12.20 in chips) 
Seat 3: Greentvdinne ($13.11 in chips) 
Seat 4: eRRe_ssbm ($15.83 in chips) 
Seat 5: Manic Jay ($10.06 in chips) 
Seat 6: alVatroos ($10.34 in chips) 
Manic Jay: posts small blind $0.05
alVatroos: posts big blind $0.10
*** HOLE CARDS ***
Intimitatem: raises $0.12 to $0.22
petrovichkag: folds 
Greentvdinne: folds 
eRRe_ssbm: raises $0.68 to $0.90
Manic Jay: folds 
alVatroos: folds 
Intimitatem: folds 
Uncalled bet ($0.68) returned to eRRe_ssbm
eRRe_ssbm collected $0.59 from pot
eRRe_ssbm: doesn't show hand 
*** SUMMARY ***
Total pot $0.59 | Rake $0 
Seat 1: Intimitatem folded before Flop
Seat 2: petrovichkag folded before Flop (didn't bet)
Seat 3: Greentvdinne folded before Flop (didn't bet)
Seat 4: eRRe_ssbm (button) collected ($0.59)
Seat 5: Manic Jay (small blind) folded before Flop
Seat 6: alVatroos (big blind) folded before Flop



PokerStars Hand #222956682257:  Hold'em No Limit ($0.05/$0.10 USD) - 2021/01/23 10:18:55 ET
Table 'Stephano III' 6-max Seat #5 is the button
Seat 1: Intimitatem ($10 in chips) 
Seat 2: petrovichkag ($12.20 in chips) 
Seat 3: Greentvdinne ($13.11 in chips) 
Seat 4: eRRe_ssbm ($16.20 in chips) 
Seat 5: Manic Jay ($10.01 in chips) 
Seat 6: alVatroos ($10.24 in chips) 
alVatroos: posts small blind $0.05
Intimitatem: posts big blind $0.10
*** HOLE CARDS ***
petrovichkag: folds 
Greentvdinne: folds 
eRRe_ssbm: raises $0.20 to $0.30
Manic Jay: folds 
alVatroos: folds 
Intimitatem: calls $0.20
*** FLOP *** [7h Ah Jd]
Intimitatem: checks 
eRRe_ssbm: bets $0.20
Intimitatem: calls $0.20
*** TURN *** [7h Ah Jd] [7c]
Intimitatem: checks 
eRRe_ssbm: bets $0.75
Intimitatem: calls $0.75
*** RIVER *** [7h Ah Jd 7c] [2c]
Intimitatem: checks 
eRRe_ssbm: checks 
*** SHOW DOWN ***
Intimitatem: shows [Ad Qc] (two pair, Aces and Sevens)
eRRe_ssbm: mucks hand 
Intimitatem collected $2.44 from pot
*** SUMMARY ***
Total pot $2.55 | Rake $0.11 
Board [7h Ah Jd 7c 2c]
Seat 1: Intimitatem (big blind) showed [Ad Qc] and won ($2.44) with two pair, Aces and Sevens
Seat 2: petrovichkag folded before Flop (didn't bet)
Seat 3: Greentvdinne folded before Flop (didn't bet)
Seat 4: eRRe_ssbm mucked
Seat 5: Manic Jay (button) folded before Flop (didn't bet)
Seat 6: alVatroos (small blind) folded before Flop



PokerStars Hand #222956712095:  Hold'em No Limit ($0.05/$0.10 USD) - 2021/01/23 10:19:51 ET
Table 'Stephano III' 6-max Seat #6 is the button
Seat 1: Intimitatem ($11.19 in chips) 
Seat 2: petrovichkag ($12.20 in chips) 
Seat 3: Greentvdinne ($13.11 in chips) 
Seat 4: eRRe_ssbm ($14.95 in chips) 
Seat 5: Manic Jay ($10.01 in chips) 
Seat 6: alVatroos ($10.19 in chips) 
Intimitatem: posts small blind $0.05
petrovichkag: posts big blind $0.10
*** HOLE CARDS ***
Greentvdinne: calls $0.10
eRRe_ssbm: folds 
Manic Jay: raises $0.20 to $0.30
alVatroos: folds 
Intimitatem: calls $0.25
petrovichkag: folds 
Greentvdinne: calls $0.20
*** FLOP *** [Kh Ts Kd]
Intimitatem: checks 
Greentvdinne: checks 
Manic Jay: bets $0.48
Intimitatem: calls $0.48
Greentvdinne: folds 
*** TURN *** [Kh Ts Kd] [Jd]
Intimitatem: checks 
Manic Jay: checks 
*** RIVER *** [Kh Ts Kd Jd] [Jh]
Intimitatem: checks 
Manic Jay: bets $0.94
Intimitatem: folds 
Uncalled bet ($0.94) returned to Manic Jay
Manic Jay collected $1.87 from pot
*** SUMMARY ***
Total pot $1.96 | Rake $0.09 
Board [Kh Ts Kd Jd Jh]
Seat 1: Intimitatem (small blind) folded on the River
Seat 2: petrovichkag (big blind) folded before Flop
Seat 3: Greentvdinne folded on the Flop
Seat 4: eRRe_ssbm folded before Flop (didn't bet)
Seat 5: Manic Jay collected ($1.87)
Seat 6: alVatroos (button) folded before Flop (didn't bet)



PokerStars Hand #222956749450:  Hold'em No Limit ($0.05/$0.10 USD) - 2021/01/23 10:21:01 ET
Table 'Stephano III' 6-max Seat #1 is the button
Seat 1: Intimitatem ($10.41 in chips) 
Seat 2: petrovichkag ($12.10 in chips) 
Seat 3: Greentvdinne ($12.81 in chips) 
Seat 4: eRRe_ssbm ($14.95 in chips) 
Seat 5: Manic Jay ($11.10 in chips) 
Seat 6: alVatroos ($10.19 in chips) 
petrovichkag: posts small blind $0.05
Greentvdinne: posts big blind $0.10
*** HOLE CARDS ***
eRRe_ssbm: folds 
Manic Jay: folds 
alVatroos: raises $0.20 to $0.30
Intimitatem: folds 
petrovichkag: raises $0.90 to $1.20
Greentvdinne: folds 
alVatroos: folds 
Uncalled bet ($0.90) returned to petrovichkag
petrovichkag collected $0.70 from pot
petrovichkag: doesn't show hand 
*** SUMMARY ***
Total pot $0.70 | Rake $0 
Seat 1: Intimitatem (button) folded before Flop (didn't bet)
Seat 2: petrovichkag (small blind) collected ($0.70)
Seat 3: Greentvdinne (big blind) folded before Flop
Seat 4: eRRe_ssbm folded before Flop (didn't bet)
Seat 5: Manic Jay folded before Flop (didn't bet)
Seat 6: alVatroos folded before Flop



PokerStars Hand #222956757885:  Hold'em No Limit ($0.05/$0.10 USD) - 2021/01/23 10:21:16 ET
Table 'Stephano III' 6-max Seat #2 is the button
Seat 1: Intimitatem ($10.41 in chips) 
Seat 2: petrovichkag ($12.50 in chips) 
Seat 3: Greentvdinne ($12.71 in chips) 
Seat 4: eRRe_ssbm ($14.95 in chips) 
Seat 5: Manic Jay ($11.10 in chips) 
Seat 6: alVatroos ($10 in chips) 
Greentvdinne: posts small blind $0.05
eRRe_ssbm: posts big blind $0.10
*** HOLE CARDS ***
Manic Jay: folds 
alVatroos: folds 
Intimitatem: folds 
petrovichkag: folds 
Greentvdinne: calls $0.05
eRRe_ssbm: checks 
*** FLOP *** [6d 5h Qs]
Greentvdinne: checks 
eRRe_ssbm: checks 
*** TURN *** [6d 5h Qs] [9s]
Greentvdinne: bets $0.10
eRRe_ssbm: calls $0.10
*** RIVER *** [6d 5h Qs 9s] [Td]
Greentvdinne: checks 
eRRe_ssbm: checks 
*** SHOW DOWN ***
Greentvdinne: shows [6c Ad] (a pair of Sixes)
eRRe_ssbm: mucks hand 
Greentvdinne collected $0.38 from pot
*** SUMMARY ***
Total pot $0.40 | Rake $0.02 
Board [6d 5h Qs 9s Td]
Seat 1: Intimitatem folded before Flop (didn't bet)
Seat 2: petrovichkag (button) folded before Flop (didn't bet)
Seat 3: Greentvdinne (small blind) showed [6c Ad] and won ($0.38) with a pair of Sixes
Seat 4: eRRe_ssbm (big blind) mucked
Seat 5: Manic Jay folded before Flop (didn't bet)
Seat 6: alVatroos folded before Flop (didn't bet)



PokerStars Hand #222956777613:  Hold'em No Limit ($0.05/$0.10 USD) - 2021/01/23 10:21:53 ET
Table 'Stephano III' 6-max Seat #3 is the button
Seat 1: Intimitatem ($10.41 in chips) 
Seat 2: petrovichkag ($12.50 in chips) 
Seat 3: Greentvdinne ($12.89 in chips) 
Seat 4: eRRe_ssbm ($14.75 in chips) 
Seat 5: Manic Jay ($11.10 in chips) 
Seat 6: alVatroos ($10 in chips) 
eRRe_ssbm: posts small blind $0.05
Manic Jay: posts big blind $0.10
*** HOLE CARDS ***
alVatroos: folds 
Intimitatem: folds 
petrovichkag: folds 
Greentvdinne: folds 
eRRe_ssbm: folds 
Uncalled bet ($0.05) returned to Manic Jay
Manic Jay collected $0.10 from pot
*** SUMMARY ***
Total pot $0.10 | Rake $0 
Seat 1: Intimitatem folded before Flop (didn't bet)
Seat 2: petrovichkag folded before Flop (didn't bet)
Seat 3: Greentvdinne (button) folded before Flop (didn't bet)
Seat 4: eRRe_ssbm (small blind) folded before Flop
Seat 5: Manic Jay (big blind) collected ($0.10)
Seat 6: alVatroos folded before Flop (didn't bet)



PokerStars Hand #222956784540:  Hold'em No Limit ($0.05/$0.10 USD) - 2021/01/23 10:22:06 ET
Table 'Stephano III' 6-max Seat #4 is the button
Seat 1: Intimitatem ($10.41 in chips) 
Seat 2: petrovichkag ($12.50 in chips) 
Seat 3: Greentvdinne ($12.89 in chips) 
Seat 4: eRRe_ssbm ($14.70 in chips) 
Seat 5: Manic Jay ($11.15 in chips) 
Manic Jay: posts small blind $0.05
alVatroos: is sitting out 
Intimitatem: posts big blind $0.10
*** HOLE CARDS ***
petrovichkag: folds 
Greentvdinne: raises $0.20 to $0.30
eRRe_ssbm: folds 
Manic Jay: calls $0.25
Intimitatem: folds 
*** FLOP *** [Kd 9s Ah]
Manic Jay: bets $0.30
Greentvdinne: folds 
Uncalled bet ($0.30) returned to Manic Jay
Manic Jay collected $0.67 from pot
*** SUMMARY ***
Total pot $0.70 | Rake $0.03 
Board [Kd 9s Ah]
Seat 1: Intimitatem (big blind) folded before Flop
Seat 2: petrovichkag folded before Flop (didn't bet)
Seat 3: Greentvdinne folded on the Flop
Seat 4: eRRe_ssbm (button) folded before Flop (didn't bet)
Seat 5: Manic Jay (small blind) collected ($0.67)



PokerStars Hand #222956793062:  Hold'em No Limit ($0.05/$0.10 USD) - 2021/01/23 10:22:22 ET
Table 'Stephano III' 6-max Seat #5 is the button
Seat 1: Intimitatem ($10.31 in chips) 
Seat 2: petrovichkag ($12.50 in chips) 
Seat 3: Greentvdinne ($12.59 in chips) 
Seat 4: eRRe_ssbm ($14.70 in chips) 
Seat 5: Manic Jay ($11.52 in chips) 
Intimitatem: posts small blind $0.05
petrovichkag: posts big blind $0.10
*** HOLE CARDS ***
Greentvdinne: calls $0.10
eRRe_ssbm: folds 
Manic Jay: folds 
Intimitatem: folds 
petrovichkag: checks 
*** FLOP *** [9d 4d Ks]
petrovichkag: checks 
Greentvdinne: bets $0.12
petrovichkag: folds 
Uncalled bet ($0.12) returned to Greentvdinne
Greentvdinne collected $0.24 from pot
Greentvdinne: doesn't show hand 
*** SUMMARY ***
Total pot $0.25 | Rake $0.01 
Board [9d 4d Ks]
Seat 1: Intimitatem (small blind) folded before Flop
Seat 2: petrovichkag (big blind) folded on the Flop
Seat 3: Greentvdinne collected ($0.24)
Seat 4: eRRe_ssbm folded before Flop (didn't bet)
Seat 5: Manic Jay (button) folded before Flop (didn't bet)



PokerStars Hand #222956804586:  Hold'em No Limit ($0.05/$0.10 USD) - 2021/01/23 10:22:43 ET
Table 'Stephano III' 6-max Seat #1 is the button
Seat 1: Intimitatem ($10.26 in chips) 
Seat 2: petrovichkag ($12.40 in chips) 
Seat 3: Greentvdinne ($12.73 in chips) 
Seat 4: eRRe_ssbm ($14.70 in chips) 
Seat 5: Manic Jay ($11.52 in chips) 
petrovichkag: posts small blind $0.05
Greentvdinne: posts big blind $0.10
alVatroos: sits out 
*** HOLE CARDS ***
eRRe_ssbm: folds 
Manic Jay: calls $0.10
Intimitatem: folds 
petrovichkag: raises $0.30 to $0.40
Greentvdinne: folds 
Manic Jay: calls $0.30
*** FLOP *** [9d Ks 3d]
petrovichkag: bets $0.28
Manic Jay: calls $0.28
*** TURN *** [9d Ks 3d] [3c]
petrovichkag: checks 
Manic Jay: checks 
*** RIVER *** [9d Ks 3d 3c] [5h]
petrovichkag: checks 
Manic Jay: checks 
*** SHOW DOWN ***
petrovichkag: shows [7s As] (a pair of Threes)
Manic Jay: shows [6c 9c] (two pair, Nines and Threes)
Manic Jay collected $1.39 from pot
*** SUMMARY ***
Total pot $1.46 | Rake $0.07 
Board [9d Ks 3d 3c 5h]
Seat 1: Intimitatem (button) folded before Flop (didn't bet)
Seat 2: petrovichkag (small blind) showed [7s As] and lost with a pair of Threes
Seat 3: Greentvdinne (big blind) folded before Flop
Seat 4: eRRe_ssbm folded before Flop (didn't bet)
Seat 5: Manic Jay showed [6c 9c] and won ($1.39) with two pair, Nines and Threes



PokerStars Hand #222956821106:  Hold'em No Limit ($0.05/$0.10 USD) - 2021/01/23 10:23:14 ET
Table 'Stephano III' 6-max Seat #2 is the button
Seat 1: Intimitatem ($10.26 in chips) 
Seat 2: petrovichkag ($11.72 in chips) 
Seat 3: Greentvdinne ($12.63 in chips) 
Seat 4: eRRe_ssbm ($14.70 in chips) 
Seat 5: Manic Jay ($12.23 in chips) 
Greentvdinne: posts small blind $0.05
eRRe_ssbm: posts big blind $0.10
alVatroos: sits out 
*** HOLE CARDS ***
Manic Jay: folds 
Intimitatem: raises $0.12 to $0.22
petrovichkag: folds 
Greentvdinne: calls $0.17
eRRe_ssbm: folds 
*** FLOP *** [6d 7c 5c]
Greentvdinne: bets $0.30
Intimitatem: calls $0.30
*** TURN *** [6d 7c 5c] [2s]
Greentvdinne: bets $1
Intimitatem: folds 
Uncalled bet ($1) returned to Greentvdinne
Greentvdinne collected $1.09 from pot
Greentvdinne: doesn't show hand 
*** SUMMARY ***
Total pot $1.14 | Rake $0.05 
Board [6d 7c 5c 2s]
Seat 1: Intimitatem folded on the Turn
Seat 2: petrovichkag (button) folded before Flop (didn't bet)
Seat 3: Greentvdinne (small blind) collected ($1.09)
Seat 4: eRRe_ssbm (big blind) folded before Flop
Seat 5: Manic Jay folded before Flop (didn't bet)



PokerStars Hand #222956840296:  Hold'em No Limit ($0.05/$0.10 USD) - 2021/01/23 10:23:49 ET
Table 'Stephano III' 6-max Seat #3 is the button
Seat 1: Intimitatem ($10 in chips) 
Seat 2: petrovichkag ($11.72 in chips) 
Seat 3: Greentvdinne ($13.20 in chips) 
Seat 4: eRRe_ssbm ($14.60 in chips) 
Seat 5: Manic Jay ($12.23 in chips) 
eRRe_ssbm: posts small blind $0.05
Manic Jay: posts big blind $0.10
alVatroos: sits out 
*** HOLE CARDS ***
Intimitatem: folds 
petrovichkag: folds 
Greentvdinne: folds 
eRRe_ssbm: raises $0.20 to $0.30
Manic Jay: raises $0.60 to $0.90
eRRe_ssbm: folds 
Uncalled bet ($0.60) returned to Manic Jay
Manic Jay collected $0.60 from pot
*** SUMMARY ***
Total pot $0.60 | Rake $0 
Seat 1: Intimitatem folded before Flop (didn't bet)
Seat 2: petrovichkag folded before Flop (didn't bet)
Seat 3: Greentvdinne (button) folded before Flop (didn't bet)
Seat 4: eRRe_ssbm (small blind) folded before Flop
Seat 5: Manic Jay (big blind) collected ($0.60)



PokerStars Hand #222956849066:  Hold'em No Limit ($0.05/$0.10 USD) - 2021/01/23 10:24:05 ET
Table 'Stephano III' 6-max Seat #4 is the button
Seat 1: Intimitatem ($10 in chips) 
Seat 2: petrovichkag ($11.72 in chips) 
Seat 3: Greentvdinne ($13.20 in chips) 
Seat 4: eRRe_ssbm ($14.30 in chips) 
Seat 5: Manic Jay ($12.53 in chips) 
Seat 6: alVatroos ($10 in chips) 
Manic Jay: posts small blind $0.05
alVatroos: posts big blind $0.10
*** HOLE CARDS ***
Intimitatem: folds 
petrovichkag: raises $0.14 to $0.24
Greentvdinne: folds 
eRRe_ssbm: folds 
Manic Jay: calls $0.19
alVatroos: raises $1.16 to $1.40
petrovichkag: folds 
Manic Jay: folds 
Uncalled bet ($1.16) returned to alVatroos
alVatroos collected $0.72 from pot
alVatroos: doesn't show hand 
*** SUMMARY ***
Total pot $0.72 | Rake $0 
Seat 1: Intimitatem folded before Flop (didn't bet)
Seat 2: petrovichkag folded before Flop
Seat 3: Greentvdinne folded before Flop (didn't bet)
Seat 4: eRRe_ssbm (button) folded before Flop (didn't bet)
Seat 5: Manic Jay (small blind) folded before Flop
Seat 6: alVatroos (big blind) collected ($0.72)



PokerStars Hand #222956864595:  Hold'em No Limit ($0.05/$0.10 USD) - 2021/01/23 10:24:34 ET
Table 'Stephano III' 6-max Seat #5 is the button
Seat 1: Intimitatem ($10 in chips) 
Seat 2: petrovichkag ($11.48 in chips) 
Seat 3: Greentvdinne ($13.20 in chips) 
Seat 4: eRRe_ssbm ($14.30 in chips) 
Seat 5: Manic Jay ($12.29 in chips) 
Seat 6: alVatroos ($10.48 in chips) 
alVatroos: posts small blind $0.05
Intimitatem: posts big blind $0.10
*** HOLE CARDS ***
petrovichkag: folds 
Greentvdinne: folds 
eRRe_ssbm: raises $0.20 to $0.30
Manic Jay: folds 
alVatroos: folds 
Intimitatem: calls $0.20
*** FLOP *** [8d Jc 6c]
Intimitatem: checks 
eRRe_ssbm: bets $0.20
Intimitatem: calls $0.20
*** TURN *** [8d Jc 6c] [3c]
Intimitatem: checks 
eRRe_ssbm: checks 
*** RIVER *** [8d Jc 6c 3c] [5d]
Intimitatem: checks 
eRRe_ssbm: checks 
*** SHOW DOWN ***
Intimitatem: shows [Qc Ah] (high card Ace)
eRRe_ssbm: shows [Ad Qs] (high card Ace)
Intimitatem collected $0.50 from pot
eRRe_ssbm collected $0.50 from pot
*** SUMMARY ***
Total pot $1.05 | Rake $0.05 
Board [8d Jc 6c 3c 5d]
Seat 1: Intimitatem (big blind) showed [Qc Ah] and won ($0.50) with high card Ace
Seat 2: petrovichkag folded before Flop (didn't bet)
Seat 3: Greentvdinne folded before Flop (didn't bet)
Seat 4: eRRe_ssbm showed [Ad Qs] and won ($0.50) with high card Ace
Seat 5: Manic Jay (button) folded before Flop (didn't bet)
Seat 6: alVatroos (small blind) folded before Flop



PokerStars Hand #222956893480:  Hold'em No Limit ($0.05/$0.10 USD) - 2021/01/23 10:25:28 ET
Table 'Stephano III' 6-max Seat #6 is the button
Seat 1: Intimitatem ($10 in chips) 
Seat 2: petrovichkag ($11.48 in chips) 
Seat 3: Greentvdinne ($13.20 in chips) 
Seat 4: eRRe_ssbm ($14.30 in chips) 
Seat 5: Manic Jay ($12.29 in chips) 
Seat 6: alVatroos ($10.43 in chips) 
Intimitatem: posts small blind $0.05
petrovichkag: posts big blind $0.10
*** HOLE CARDS ***
Greentvdinne: folds 
eRRe_ssbm: folds 
Manic Jay: calls $0.10
alVatroos: folds 
Intimitatem: folds 
petrovichkag: checks 
*** FLOP *** [9d Qh 8s]
petrovichkag: checks 
Manic Jay: bets $0.30
petrovichkag: calls $0.30
*** TURN *** [9d Qh 8s] [4s]
petrovichkag: checks 
Manic Jay: bets $0.30
petrovichkag: calls $0.30
*** RIVER *** [9d Qh 8s 4s] [4c]
petrovichkag: checks 
Manic Jay: bets $0.30
petrovichkag: calls $0.30
*** SHOW DOWN ***
Manic Jay: shows [Th 9c] (two pair, Nines and Fours)
petrovichkag: shows [6s Qd] (two pair, Queens and Fours)
petrovichkag collected $1.96 from pot
*** SUMMARY ***
Total pot $2.05 | Rake $0.09 
Board [9d Qh 8s 4s 4c]
Seat 1: Intimitatem (small blind) folded before Flop
Seat 2: petrovichkag (big blind) showed [6s Qd] and won ($1.96) with two pair, Queens and Fours
Seat 3: Greentvdinne folded before Flop (didn't bet)
Seat 4: eRRe_ssbm folded before Flop (didn't bet)
Seat 5: Manic Jay showed [Th 9c] and lost with two pair, Nines and Fours
Seat 6: alVatroos (button) folded before Flop (didn't bet)



PokerStars Hand #222956909749:  Hold'em No Limit ($0.05/$0.10 USD) - 2021/01/23 10:25:58 ET
Table 'Stephano III' 6-max Seat #1 is the button
Seat 1: Intimitatem ($10 in chips) 
Seat 2: petrovichkag ($12.44 in chips) 
Seat 3: Greentvdinne ($13.20 in chips) 
Seat 4: eRRe_ssbm ($14.30 in chips) 
Seat 5: Manic Jay ($11.29 in chips) 
Seat 6: alVatroos ($10.43 in chips) 
petrovichkag: posts small blind $0.05
Greentvdinne: posts big blind $0.10
*** HOLE CARDS ***
eRRe_ssbm: folds 
Manic Jay: calls $0.10
alVatroos: calls $0.10
Intimitatem: folds 
petrovichkag: folds 
Greentvdinne: checks 
*** FLOP *** [7s Td Ah]
Greentvdinne: checks 
Manic Jay: checks 
alVatroos: checks 
*** TURN *** [7s Td Ah] [2s]
Greentvdinne: checks 
Manic Jay: checks 
alVatroos: checks 
*** RIVER *** [7s Td Ah 2s] [4c]
Greentvdinne: checks 
Manic Jay: checks 
alVatroos: checks 
*** SHOW DOWN ***
Greentvdinne: shows [7h Ks] (a pair of Sevens)
Manic Jay: mucks hand 
alVatroos: mucks hand 
Greentvdinne collected $0.33 from pot
*** SUMMARY ***
Total pot $0.35 | Rake $0.02 
Board [7s Td Ah 2s 4c]
Seat 1: Intimitatem (button) folded before Flop (didn't bet)
Seat 2: petrovichkag (small blind) folded before Flop
Seat 3: Greentvdinne (big blind) showed [7h Ks] and won ($0.33) with a pair of Sevens
Seat 4: eRRe_ssbm folded before Flop (didn't bet)
Seat 5: Manic Jay mucked
Seat 6: alVatroos mucked



PokerStars Hand #222956927747:  Hold'em No Limit ($0.05/$0.10 USD) - 2021/01/23 10:26:31 ET
Table 'Stephano III' 6-max Seat #2 is the button
Seat 1: Intimitatem ($10 in chips) 
Seat 2: petrovichkag ($12.39 in chips) 
Seat 3: Greentvdinne ($13.43 in chips) 
Seat 4: eRRe_ssbm ($14.30 in chips) 
Seat 5: Manic Jay ($11.19 in chips) 
Seat 6: alVatroos ($10.33 in chips) 
Greentvdinne: posts small blind $0.05
eRRe_ssbm: posts big blind $0.10
*** HOLE CARDS ***
Manic Jay: raises $0.20 to $0.30
alVatroos: folds 
Intimitatem: folds 
petrovichkag: folds 
Greentvdinne: calls $0.25
eRRe_ssbm: folds 
*** FLOP *** [Jd Ah Qs]
Greentvdinne: bets $0.50
Manic Jay: calls $0.50
*** TURN *** [Jd Ah Qs] [2c]
Greentvdinne: bets $0.81
Manic Jay: calls $0.81
*** RIVER *** [Jd Ah Qs 2c] [3h]
Greentvdinne: checks 
Manic Jay: checks 
*** SHOW DOWN ***
Greentvdinne: shows [Ad 6d] (a pair of Aces)
Manic Jay: mucks hand 
Greentvdinne collected $3.17 from pot
*** SUMMARY ***
Total pot $3.32 | Rake $0.15 
Board [Jd Ah Qs 2c 3h]
Seat 1: Intimitatem folded before Flop (didn't bet)
Seat 2: petrovichkag (button) folded before Flop (didn't bet)
Seat 3: Greentvdinne (small blind) showed [Ad 6d] and won ($3.17) with a pair of Aces
Seat 4: eRRe_ssbm (big blind) folded before Flop
Seat 5: Manic Jay mucked
Seat 6: alVatroos folded before Flop (didn't bet)



PokerStars Hand #222956947506:  Hold'em No Limit ($0.05/$0.10 USD) - 2021/01/23 10:27:07 ET
Table 'Stephano III' 6-max Seat #3 is the button
Seat 1: Intimitatem ($10 in chips) 
Seat 2: petrovichkag ($12.39 in chips) 
Seat 3: Greentvdinne ($14.99 in chips) 
Seat 4: eRRe_ssbm ($14.20 in chips) 
Seat 5: Manic Jay ($9.58 in chips) 
Seat 6: alVatroos ($10.33 in chips) 
eRRe_ssbm: posts small blind $0.05
Manic Jay: posts big blind $0.10
*** HOLE CARDS ***
alVatroos: folds 
Intimitatem: folds 
petrovichkag: raises $0.14 to $0.24
Greentvdinne: calls $0.24
eRRe_ssbm: folds 
Manic Jay: folds 
*** FLOP *** [6d 4c 5d]
petrovichkag: bets $0.20
Greentvdinne: folds 
Uncalled bet ($0.20) returned to petrovichkag
petrovichkag collected $0.60 from pot
petrovichkag: doesn't show hand 
*** SUMMARY ***
Total pot $0.63 | Rake $0.03 
Board [6d 4c 5d]
Seat 1: Intimitatem folded before Flop (didn't bet)
Seat 2: petrovichkag collected ($0.60)
Seat 3: Greentvdinne (button) folded on the Flop
Seat 4: eRRe_ssbm (small blind) folded before Flop
Seat 5: Manic Jay (big blind) folded before Flop
Seat 6: alVatroos folded before Flop (didn't bet)



PokerStars Hand #222956960554:  Hold'em No Limit ($0.05/$0.10 USD) - 2021/01/23 10:27:31 ET
Table 'Stephano III' 6-max Seat #4 is the button
Seat 1: Intimitatem ($10 in chips) 
Seat 2: petrovichkag ($12.75 in chips) 
Seat 3: Greentvdinne ($14.75 in chips) 
Seat 4: eRRe_ssbm ($14.15 in chips) 
Seat 5: Manic Jay ($9.48 in chips) 
Seat 6: alVatroos ($10.33 in chips) 
Manic Jay: posts small blind $0.05
alVatroos: posts big blind $0.10
*** HOLE CARDS ***
Intimitatem: folds 
petrovichkag: folds 
Greentvdinne: folds 
eRRe_ssbm: folds 
Manic Jay: calls $0.05
alVatroos: checks 
*** FLOP *** [Ac Qd 3s]
Manic Jay: checks 
alVatroos: bets $0.30
Manic Jay: folds 
Uncalled bet ($0.30) returned to alVatroos
alVatroos collected $0.19 from pot
alVatroos: doesn't show hand 
*** SUMMARY ***
Total pot $0.20 | Rake $0.01 
Board [Ac Qd 3s]
Seat 1: Intimitatem folded before Flop (didn't bet)
Seat 2: petrovichkag folded before Flop (didn't bet)
Seat 3: Greentvdinne folded before Flop (didn't bet)
Seat 4: eRRe_ssbm (button) folded before Flop (didn't bet)
Seat 5: Manic Jay (small blind) folded on the Flop
Seat 6: alVatroos (big blind) collected ($0.19)



PokerStars Hand #222956978604:  Hold'em No Limit ($0.05/$0.10 USD) - 2021/01/23 10:28:04 ET
Table 'Stephano III' 6-max Seat #5 is the button
Seat 1: Intimitatem ($10 in chips) 
Seat 2: petrovichkag ($12.75 in chips) 
Seat 3: Greentvdinne ($14.75 in chips) 
Seat 4: eRRe_ssbm ($14.15 in chips) 
Seat 5: Manic Jay ($9.38 in chips) 
Seat 6: alVatroos ($10.42 in chips) 
alVatroos: posts small blind $0.05
Intimitatem: posts big blind $0.10
*** HOLE CARDS ***
petrovichkag: folds 
Greentvdinne: folds 
eRRe_ssbm: folds 
Manic Jay: calls $0.10
alVatroos: calls $0.05
Intimitatem: checks 
*** FLOP *** [8h Ad 9d]
alVatroos: checks 
Intimitatem: checks 
Manic Jay: checks 
*** TURN *** [8h Ad 9d] [9c]
alVatroos: checks 
Intimitatem: checks 
Manic Jay: checks 
*** RIVER *** [8h Ad 9d 9c] [2h]
alVatroos: checks 
Intimitatem: checks 
Manic Jay: checks 
*** SHOW DOWN ***
alVatroos: shows [6c 8c] (two pair, Nines and Eights)
Intimitatem: shows [8d 3h] (two pair, Nines and Eights)
Manic Jay: mucks hand 
alVatroos collected $0.15 from pot
Intimitatem collected $0.14 from pot
*** SUMMARY ***
Total pot $0.30 | Rake $0.01 
Board [8h Ad 9d 9c 2h]
Seat 1: Intimitatem (big blind) showed [8d 3h] and won ($0.14) with two pair, Nines and Eights
Seat 2: petrovichkag folded before Flop (didn't bet)
Seat 3: Greentvdinne folded before Flop (didn't bet)
Seat 4: eRRe_ssbm folded before Flop (didn't bet)
Seat 5: Manic Jay (button) mucked
Seat 6: alVatroos (small blind) showed [6c 8c] and won ($0.15) with two pair, Nines and Eights



PokerStars Hand #222957000780:  Hold'em No Limit ($0.05/$0.10 USD) - 2021/01/23 10:28:44 ET
Table 'Stephano III' 6-max Seat #6 is the button
Seat 1: Intimitatem ($10.04 in chips) 
Seat 2: petrovichkag ($12.75 in chips) 
Seat 3: Greentvdinne ($14.75 in chips) 
Seat 4: eRRe_ssbm ($14.15 in chips) 
Seat 5: Manic Jay ($9.28 in chips) 
Seat 6: alVatroos ($10.47 in chips) 
Intimitatem: posts small blind $0.05
petrovichkag: posts big blind $0.10
*** HOLE CARDS ***
Greentvdinne: folds 
eRRe_ssbm: folds 
Manic Jay: folds 
alVatroos: folds 
Intimitatem: raises $0.25 to $0.35
petrovichkag: calls $0.25
*** FLOP *** [2s 3c Js]
Intimitatem: checks 
petrovichkag: bets $0.52
Intimitatem: folds 
Uncalled bet ($0.52) returned to petrovichkag
petrovichkag collected $0.67 from pot
petrovichkag: doesn't show hand 
*** SUMMARY ***
Total pot $0.70 | Rake $0.03 
Board [2s 3c Js]
Seat 1: Intimitatem (small blind) folded on the Flop
Seat 2: petrovichkag (big blind) collected ($0.67)
Seat 3: Greentvdinne folded before Flop (didn't bet)
Seat 4: eRRe_ssbm folded before Flop (didn't bet)
Seat 5: Manic Jay folded before Flop (didn't bet)
Seat 6: alVatroos (button) folded before Flop (didn't bet)



PokerStars Hand #222957018461:  Hold'em No Limit ($0.05/$0.10 USD) - 2021/01/23 10:29:17 ET
Table 'Stephano III' 6-max Seat #1 is the button
Seat 1: Intimitatem ($10 in chips) 
Seat 2: petrovichkag ($13.07 in chips) 
Seat 3: Greentvdinne ($14.75 in chips) 
Seat 4: eRRe_ssbm ($14.15 in chips) 
Seat 5: Manic Jay ($9.28 in chips) 
Seat 6: alVatroos ($10.47 in chips) 
petrovichkag: posts small blind $0.05
Greentvdinne: posts big blind $0.10
*** HOLE CARDS ***
eRRe_ssbm: folds 
Manic Jay: raises $0.20 to $0.30
alVatroos: folds 
Intimitatem: folds 
petrovichkag: folds 
Greentvdinne: calls $0.20
*** FLOP *** [Js Td Kc]
Greentvdinne: checks 
Manic Jay: checks 
*** TURN *** [Js Td Kc] [4h]
Greentvdinne: checks 
Manic Jay: checks 
*** RIVER *** [Js Td Kc 4h] [Qh]
Greentvdinne: checks 
Manic Jay: bets $0.62
Greentvdinne: calls $0.62
*** SHOW DOWN ***
Manic Jay: shows [8d Ah] (a straight, Ten to Ace)
Greentvdinne: mucks hand 
Manic Jay collected $1.80 from pot
*** SUMMARY ***
Total pot $1.89 | Rake $0.09 
Board [Js Td Kc 4h Qh]
Seat 1: Intimitatem (button) folded before Flop (didn't bet)
Seat 2: petrovichkag (small blind) folded before Flop
Seat 3: Greentvdinne (big blind) mucked
Seat 4: eRRe_ssbm folded before Flop (didn't bet)
Seat 5: Manic Jay showed [8d Ah] and won ($1.80) with a straight, Ten to Ace
Seat 6: alVatroos folded before Flop (didn't bet)



PokerStars Hand #222957043196:  Hold'em No Limit ($0.05/$0.10 USD) - 2021/01/23 10:30:03 ET
Table 'Stephano III' 6-max Seat #2 is the button
Seat 1: Intimitatem ($10 in chips) 
Seat 2: petrovichkag ($13.02 in chips) 
Seat 3: Greentvdinne ($13.83 in chips) 
Seat 4: eRRe_ssbm ($14.15 in chips) 
Seat 5: Manic Jay ($10.16 in chips) 
Seat 6: alVatroos ($10.47 in chips) 
Greentvdinne: posts small blind $0.05
eRRe_ssbm: posts big blind $0.10
*** HOLE CARDS ***
Manic Jay: folds 
alVatroos: folds 
Intimitatem: raises $0.12 to $0.22
petrovichkag: folds 
Greentvdinne: folds 
eRRe_ssbm: calls $0.12
*** FLOP *** [5d Jd 5c]
eRRe_ssbm: checks 
Intimitatem: bets $0.31
eRRe_ssbm: calls $0.31
*** TURN *** [5d Jd 5c] [8h]
eRRe_ssbm: checks 
Intimitatem: bets $0.71
eRRe_ssbm: calls $0.71
*** RIVER *** [5d Jd 5c 8h] [4h]
eRRe_ssbm: checks 
Intimitatem: checks 
*** SHOW DOWN ***
eRRe_ssbm: shows [Jc Kc] (two pair, Jacks and Fives)
Intimitatem: shows [Jh Kd] (two pair, Jacks and Fives)
eRRe_ssbm collected $1.21 from pot
Intimitatem collected $1.21 from pot
*** SUMMARY ***
Total pot $2.53 | Rake $0.11 
Board [5d Jd 5c 8h 4h]
Seat 1: Intimitatem showed [Jh Kd] and won ($1.21) with two pair, Jacks and Fives
Seat 2: petrovichkag (button) folded before Flop (didn't bet)
Seat 3: Greentvdinne (small blind) folded before Flop
Seat 4: eRRe_ssbm (big blind) showed [Jc Kc] and won ($1.21) with two pair, Jacks and Fives
Seat 5: Manic Jay folded before Flop (didn't bet)
Seat 6: alVatroos folded before Flop (didn't bet)



PokerStars Hand #222957081324:  Hold'em No Limit ($0.05/$0.10 USD) - 2021/01/23 10:31:00 ET
Table 'Stephano III' 6-max Seat #3 is the button
Seat 1: Intimitatem ($10 in chips) 
Seat 2: petrovichkag ($13.02 in chips) 
Seat 3: Greentvdinne ($13.78 in chips) 
Seat 4: eRRe_ssbm ($14.12 in chips) 
Seat 5: Manic Jay ($10.16 in chips) 
Seat 6: alVatroos ($10.47 in chips) 
eRRe_ssbm: posts small blind $0.05
Manic Jay: posts big blind $0.10
*** HOLE CARDS ***
alVatroos: raises $0.20 to $0.30
Intimitatem: folds 
petrovichkag: folds 
Greentvdinne: folds 
eRRe_ssbm: folds 
Manic Jay: folds 
Uncalled bet ($0.20) returned to alVatroos
alVatroos collected $0.25 from pot
alVatroos: doesn't show hand 
*** SUMMARY ***
Total pot $0.25 | Rake $0 
Seat 1: Intimitatem folded before Flop (didn't bet)
Seat 2: petrovichkag folded before Flop (didn't bet)
Seat 3: Greentvdinne (button) folded before Flop (didn't bet)
Seat 4: eRRe_ssbm (small blind) folded before Flop
Seat 5: Manic Jay (big blind) folded before Flop
Seat 6: alVatroos collected ($0.25)



PokerStars Hand #222957088603:  Hold'em No Limit ($0.05/$0.10 USD) - 2021/01/23 10:31:13 ET
Table 'Stephano III' 6-max Seat #4 is the button
Seat 1: Intimitatem ($10 in chips) 
Seat 2: petrovichkag ($13.02 in chips) 
Seat 3: Greentvdinne ($13.78 in chips) 
Seat 4: eRRe_ssbm ($14.07 in chips) 
Seat 5: Manic Jay ($10.06 in chips) 
Seat 6: alVatroos ($10.62 in chips) 
Manic Jay: posts small blind $0.05
alVatroos: posts big blind $0.10
*** HOLE CARDS ***
Intimitatem: folds 
petrovichkag: folds 
Greentvdinne: folds 
eRRe_ssbm: folds 
Manic Jay: folds 
Uncalled bet ($0.05) returned to alVatroos
alVatroos collected $0.10 from pot
alVatroos: doesn't show hand 
*** SUMMARY ***
Total pot $0.10 | Rake $0 
Seat 1: Intimitatem folded before Flop (didn't bet)
Seat 2: petrovichkag folded before Flop (didn't bet)
Seat 3: Greentvdinne folded before Flop (didn't bet)
Seat 4: eRRe_ssbm (button) folded before Flop (didn't bet)
Seat 5: Manic Jay (small blind) folded before Flop
Seat 6: alVatroos (big blind) collected ($0.10)



PokerStars Hand #222957097081:  Hold'em No Limit ($0.05/$0.10 USD) - 2021/01/23 10:31:29 ET
Table 'Stephano III' 6-max Seat #5 is the button
Seat 1: Intimitatem ($10 in chips) 
Seat 2: petrovichkag ($13.02 in chips) 
Seat 3: Greentvdinne ($13.78 in chips) 
Seat 4: eRRe_ssbm ($14.07 in chips) 
Seat 5: Manic Jay ($10.01 in chips) 
Seat 6: alVatroos ($10.67 in chips) 
alVatroos: posts small blind $0.05
Intimitatem: posts big blind $0.10
*** HOLE CARDS ***
petrovichkag: folds 
Greentvdinne: folds 
eRRe_ssbm: folds 
Manic Jay: folds 
alVatroos: raises $0.20 to $0.30
Intimitatem: folds 
Uncalled bet ($0.20) returned to alVatroos
alVatroos collected $0.20 from pot
alVatroos: doesn't show hand 
*** SUMMARY ***
Total pot $0.20 | Rake $0 
Seat 1: Intimitatem (big blind) folded before Flop
Seat 2: petrovichkag folded before Flop (didn't bet)
Seat 3: Greentvdinne folded before Flop (didn't bet)
Seat 4: eRRe_ssbm folded before Flop (didn't bet)
Seat 5: Manic Jay (button) folded before Flop (didn't bet)
Seat 6: alVatroos (small blind) collected ($0.20)



PokerStars Hand #222957114625:  Hold'em No Limit ($0.05/$0.10 USD) - 2021/01/23 10:32:01 ET
Table 'Stephano III' 6-max Seat #6 is the button
Seat 1: Intimitatem ($10 in chips) 
Seat 2: petrovichkag ($13.02 in chips) 
Seat 3: Greentvdinne ($13.78 in chips) 
Seat 4: eRRe_ssbm ($14.07 in chips) 
Seat 5: Manic Jay ($10.01 in chips) 
Seat 6: alVatroos ($10.77 in chips) 
Intimitatem: posts small blind $0.05
petrovichkag: posts big blind $0.10
*** HOLE CARDS ***
Greentvdinne: folds 
eRRe_ssbm: folds 
Manic Jay: calls $0.10
alVatroos: calls $0.10
Intimitatem: calls $0.05
petrovichkag: checks 
*** FLOP *** [2s Kd 2c]
Intimitatem: checks 
petrovichkag: checks 
Manic Jay: checks 
alVatroos: checks 
*** TURN *** [2s Kd 2c] [6d]
Intimitatem: bets $0.33
petrovichkag: folds 
Manic Jay: calls $0.33
alVatroos: folds 
*** RIVER *** [2s Kd 2c 6d] [3s]
Intimitatem: bets $0.75
Manic Jay: raises $1.25 to $2
Intimitatem: calls $1.25
*** SHOW DOWN ***
Manic Jay: shows [3h 3c] (a full house, Threes full of Deuces)
Intimitatem: mucks hand 
Manic Jay collected $4.83 from pot
*** SUMMARY ***
Total pot $5.06 | Rake $0.23 
Board [2s Kd 2c 6d 3s]
Seat 1: Intimitatem (small blind) mucked
Seat 2: petrovichkag (big blind) folded on the Turn
Seat 3: Greentvdinne folded before Flop (didn't bet)
Seat 4: eRRe_ssbm folded before Flop (didn't bet)
Seat 5: Manic Jay showed [3h 3c] and won ($4.83) with a full house, Threes full of Deuces
Seat 6: alVatroos (button) folded on the Turn



PokerStars Hand #222957157428:  Hold'em No Limit ($0.05/$0.10 USD) - 2021/01/23 10:33:19 ET
Table 'Stephano III' 6-max Seat #1 is the button
Seat 1: Intimitatem ($10 in chips) 
Seat 2: petrovichkag ($12.92 in chips) 
Seat 3: Greentvdinne ($13.78 in chips) 
Seat 4: eRRe_ssbm ($14.07 in chips) 
Seat 5: Manic Jay ($12.41 in chips) 
Seat 6: alVatroos ($10.67 in chips) 
petrovichkag: posts small blind $0.05
Greentvdinne: posts big blind $0.10
*** HOLE CARDS ***
eRRe_ssbm: folds 
Manic Jay: folds 
alVatroos: folds 
Intimitatem: folds 
petrovichkag: folds 
Uncalled bet ($0.05) returned to Greentvdinne
Greentvdinne collected $0.10 from pot
Greentvdinne: doesn't show hand 
*** SUMMARY ***
Total pot $0.10 | Rake $0 
Seat 1: Intimitatem (button) folded before Flop (didn't bet)
Seat 2: petrovichkag (small blind) folded before Flop
Seat 3: Greentvdinne (big blind) collected ($0.10)
Seat 4: eRRe_ssbm folded before Flop (didn't bet)
Seat 5: Manic Jay folded before Flop (didn't bet)
Seat 6: alVatroos folded before Flop (didn't bet)



PokerStars Hand #222957165335:  Hold'em No Limit ($0.05/$0.10 USD) - 2021/01/23 10:33:33 ET
Table 'Stephano III' 6-max Seat #2 is the button
Seat 1: Intimitatem ($10 in chips) 
Seat 2: petrovichkag ($12.87 in chips) 
Seat 3: Greentvdinne ($13.83 in chips) 
Seat 4: eRRe_ssbm ($14.07 in chips) 
Seat 5: Manic Jay ($12.41 in chips) 
Seat 6: alVatroos ($10.67 in chips) 
Greentvdinne: posts small blind $0.05
eRRe_ssbm: posts big blind $0.10
*** HOLE CARDS ***
Manic Jay: calls $0.10
alVatroos: folds 
Intimitatem: folds 
petrovichkag: folds 
Greentvdinne: raises $0.30 to $0.40
eRRe_ssbm: folds 
Manic Jay: folds 
Uncalled bet ($0.30) returned to Greentvdinne
Greentvdinne collected $0.30 from pot
Greentvdinne: doesn't show hand 
*** SUMMARY ***
Total pot $0.30 | Rake $0 
Seat 1: Intimitatem folded before Flop (didn't bet)
Seat 2: petrovichkag (button) folded before Flop (didn't bet)
Seat 3: Greentvdinne (small blind) collected ($0.30)
Seat 4: eRRe_ssbm (big blind) folded before Flop
Seat 5: Manic Jay folded before Flop
Seat 6: alVatroos folded before Flop (didn't bet)



PokerStars Hand #222957172352:  Hold'em No Limit ($0.05/$0.10 USD) - 2021/01/23 10:33:46 ET
Table 'Stephano III' 6-max Seat #3 is the button
Seat 1: Intimitatem ($10 in chips) 
Seat 2: petrovichkag ($12.87 in chips) 
Seat 3: Greentvdinne ($14.03 in chips) 
Seat 4: eRRe_ssbm ($13.97 in chips) 
Seat 5: Manic Jay ($12.31 in chips) 
Seat 6: alVatroos ($10.67 in chips) 
eRRe_ssbm: posts small blind $0.05
Manic Jay: posts big blind $0.10
*** HOLE CARDS ***
alVatroos: folds 
Intimitatem: raises $0.12 to $0.22
petrovichkag: folds 
Greentvdinne: folds 
eRRe_ssbm: folds 
Manic Jay: folds 
Uncalled bet ($0.12) returned to Intimitatem
Intimitatem collected $0.25 from pot
Intimitatem: doesn't show hand 
*** SUMMARY ***
Total pot $0.25 | Rake $0 
Seat 1: Intimitatem collected ($0.25)
Seat 2: petrovichkag folded before Flop (didn't bet)
Seat 3: Greentvdinne (button) folded before Flop (didn't bet)
Seat 4: eRRe_ssbm (small blind) folded before Flop
Seat 5: Manic Jay (big blind) folded before Flop
Seat 6: alVatroos folded before Flop (didn't bet)



PokerStars Hand #222957180247:  Hold'em No Limit ($0.05/$0.10 USD) - 2021/01/23 10:34:00 ET
Table 'Stephano III' 6-max Seat #4 is the button
Seat 1: Intimitatem ($10.15 in chips) 
Seat 2: petrovichkag ($12.87 in chips) 
Seat 3: Greentvdinne ($14.03 in chips) 
Seat 4: eRRe_ssbm ($13.92 in chips) 
Seat 5: Manic Jay ($12.21 in chips) 
Seat 6: alVatroos ($10.67 in chips) 
Manic Jay: posts small blind $0.05
alVatroos: posts big blind $0.10
*** HOLE CARDS ***
Intimitatem: folds 
petrovichkag: folds 
Greentvdinne: raises $0.20 to $0.30
eRRe_ssbm: folds 
Manic Jay: folds 
alVatroos: folds 
Uncalled bet ($0.20) returned to Greentvdinne
Greentvdinne collected $0.25 from pot
Greentvdinne: doesn't show hand 
*** SUMMARY ***
Total pot $0.25 | Rake $0 
Seat 1: Intimitatem folded before Flop (didn't bet)
Seat 2: petrovichkag folded before Flop (didn't bet)
Seat 3: Greentvdinne collected ($0.25)
Seat 4: eRRe_ssbm (button) folded before Flop (didn't bet)
Seat 5: Manic Jay (small blind) folded before Flop
Seat 6: alVatroos (big blind) folded before Flop



PokerStars Hand #222957195239:  Hold'em No Limit ($0.05/$0.10 USD) - 2021/01/23 10:34:27 ET
Table 'Stephano III' 6-max Seat #5 is the button
Seat 1: Intimitatem ($10.15 in chips) 
Seat 2: petrovichkag ($12.87 in chips) 
Seat 3: Greentvdinne ($14.18 in chips) 
Seat 4: eRRe_ssbm ($13.92 in chips) 
Seat 5: Manic Jay ($12.16 in chips) 
Seat 6: alVatroos ($10.57 in chips) 
alVatroos: posts small blind $0.05
Intimitatem: posts big blind $0.10
*** HOLE CARDS ***
petrovichkag: folds 
Greentvdinne: folds 
eRRe_ssbm: raises $0.20 to $0.30
Manic Jay: calls $0.30
alVatroos: folds 
Intimitatem: folds 
*** FLOP *** [4s 6c 6d]
eRRe_ssbm: bets $0.15
Manic Jay: folds 
Uncalled bet ($0.15) returned to eRRe_ssbm
eRRe_ssbm collected $0.72 from pot
eRRe_ssbm: doesn't show hand 
*** SUMMARY ***
Total pot $0.75 | Rake $0.03 
Board [4s 6c 6d]
Seat 1: Intimitatem (big blind) folded before Flop
Seat 2: petrovichkag folded before Flop (didn't bet)
Seat 3: Greentvdinne folded before Flop (didn't bet)
Seat 4: eRRe_ssbm collected ($0.72)
Seat 5: Manic Jay (button) folded on the Flop
Seat 6: alVatroos (small blind) folded before Flop



PokerStars Hand #222957211191:  Hold'em No Limit ($0.05/$0.10 USD) - 2021/01/23 10:34:56 ET
Table 'Stephano III' 6-max Seat #6 is the button
Seat 1: Intimitatem ($10.05 in chips) 
Seat 2: petrovichkag ($12.87 in chips) 
Seat 3: Greentvdinne ($14.18 in chips) 
Seat 4: eRRe_ssbm ($14.34 in chips) 
Seat 5: Manic Jay ($11.86 in chips) 
Seat 6: alVatroos ($10.52 in chips) 
Intimitatem: posts small blind $0.05
petrovichkag: posts big blind $0.10
*** HOLE CARDS ***
Greentvdinne: folds 
eRRe_ssbm: folds 
Manic Jay: folds 
alVatroos: folds 
Intimitatem: folds 
Uncalled bet ($0.05) returned to petrovichkag
petrovichkag collected $0.10 from pot
petrovichkag: doesn't show hand 
*** SUMMARY ***
Total pot $0.10 | Rake $0 
Seat 1: Intimitatem (small blind) folded before Flop
Seat 2: petrovichkag (big blind) collected ($0.10)
Seat 3: Greentvdinne folded before Flop (didn't bet)
Seat 4: eRRe_ssbm folded before Flop (didn't bet)
Seat 5: Manic Jay folded before Flop (didn't bet)
Seat 6: alVatroos (button) folded before Flop (didn't bet)



PokerStars Hand #222957221849:  Hold'em No Limit ($0.05/$0.10 USD) - 2021/01/23 10:35:16 ET
Table 'Stephano III' 6-max Seat #1 is the button
Seat 1: Intimitatem ($10 in chips) 
Seat 2: petrovichkag ($12.92 in chips) 
Seat 3: Greentvdinne ($14.18 in chips) 
Seat 4: eRRe_ssbm ($14.34 in chips) 
Seat 5: Manic Jay ($11.86 in chips) 
Seat 6: alVatroos ($10.52 in chips) 
petrovichkag: posts small blind $0.05
Greentvdinne: posts big blind $0.10
*** HOLE CARDS ***
eRRe_ssbm: folds 
Manic Jay: calls $0.10
alVatroos has timed out
alVatroos: folds 
Intimitatem: folds 
petrovichkag: folds 
Greentvdinne: checks 
*** FLOP *** [Qh 6d Qd]
Greentvdinne: checks 
Manic Jay: bets $0.30
Greentvdinne: folds 
Uncalled bet ($0.30) returned to Manic Jay
Manic Jay collected $0.24 from pot
*** SUMMARY ***
Total pot $0.25 | Rake $0.01 
Board [Qh 6d Qd]
Seat 1: Intimitatem (button) folded before Flop (didn't bet)
Seat 2: petrovichkag (small blind) folded before Flop
Seat 3: Greentvdinne (big blind) folded on the Flop
Seat 4: eRRe_ssbm folded before Flop (didn't bet)
Seat 5: Manic Jay collected ($0.24)
Seat 6: alVatroos folded before Flop (didn't bet)



PokerStars Hand #222957242174:  Hold'em No Limit ($0.05/$0.10 USD) - 2021/01/23 10:35:53 ET
Table 'Stephano III' 6-max Seat #2 is the button
Seat 1: Intimitatem ($10 in chips) 
Seat 2: petrovichkag ($12.87 in chips) 
Seat 3: Greentvdinne ($14.08 in chips) 
Seat 5: Manic Jay ($12 in chips) 
Seat 6: alVatroos ($10.52 in chips) 
Greentvdinne: posts small blind $0.05
eRRe_ssbm: is sitting out 
Manic Jay: posts big blind $0.10
*** HOLE CARDS ***
alVatroos: folds 
Intimitatem: folds 
petrovichkag: folds 
Greentvdinne: folds 
Uncalled bet ($0.05) returned to Manic Jay
Manic Jay collected $0.10 from pot
*** SUMMARY ***
Total pot $0.10 | Rake $0 
Seat 1: Intimitatem folded before Flop (didn't bet)
Seat 2: petrovichkag (button) folded before Flop (didn't bet)
Seat 3: Greentvdinne (small blind) folded before Flop
Seat 5: Manic Jay (big blind) collected ($0.10)
Seat 6: alVatroos folded before Flop (didn't bet)



PokerStars Hand #222957250737:  Hold'em No Limit ($0.05/$0.10 USD) - 2021/01/23 10:36:08 ET
Table 'Stephano III' 6-max Seat #3 is the button
Seat 1: Intimitatem ($10 in chips) 
Seat 2: petrovichkag ($12.87 in chips) 
Seat 3: Greentvdinne ($14.03 in chips) 
Seat 5: Manic Jay ($12.05 in chips) 
Seat 6: alVatroos ($10.52 in chips) 
Manic Jay: posts small blind $0.05
alVatroos: posts big blind $0.10
*** HOLE CARDS ***
Intimitatem: folds 
petrovichkag: folds 
Greentvdinne: folds 
Manic Jay: folds 
Uncalled bet ($0.05) returned to alVatroos
alVatroos collected $0.10 from pot
alVatroos: doesn't show hand 
*** SUMMARY ***
Total pot $0.10 | Rake $0 
Seat 1: Intimitatem folded before Flop (didn't bet)
Seat 2: petrovichkag folded before Flop (didn't bet)
Seat 3: Greentvdinne (button) folded before Flop (didn't bet)
Seat 5: Manic Jay (small blind) folded before Flop
Seat 6: alVatroos (big blind) collected ($0.10)



PokerStars Hand #222957256230:  Hold'em No Limit ($0.05/$0.10 USD) - 2021/01/23 10:36:18 ET
Table 'Stephano III' 6-max Seat #5 is the button
Seat 1: Intimitatem ($10 in chips) 
Seat 2: petrovichkag ($12.87 in chips) 
Seat 3: Greentvdinne ($14.03 in chips) 
Seat 5: Manic Jay ($12 in chips) 
Seat 6: alVatroos ($10.57 in chips) 
alVatroos: posts small blind $0.05
Intimitatem: posts big blind $0.10
*** HOLE CARDS ***
petrovichkag: raises $0.14 to $0.24
Greentvdinne: calls $0.24
Manic Jay: calls $0.24
alVatroos: folds 
Intimitatem: calls $0.14
*** FLOP *** [4c 2c 7s]
Intimitatem: checks 
petrovichkag: checks 
Greentvdinne: checks 
Manic Jay: checks 
*** TURN *** [4c 2c 7s] [Kc]
Intimitatem: checks 
petrovichkag: bets $0.75
Greentvdinne: folds 
Manic Jay: folds 
Intimitatem: folds 
Uncalled bet ($0.75) returned to petrovichkag
petrovichkag collected $0.96 from pot
petrovichkag: doesn't show hand 
*** SUMMARY ***
Total pot $1.01 | Rake $0.05 
Board [4c 2c 7s Kc]
Seat 1: Intimitatem (big blind) folded on the Turn
Seat 2: petrovichkag collected ($0.96)
Seat 3: Greentvdinne folded on the Turn
Seat 5: Manic Jay (button) folded on the Turn
Seat 6: alVatroos (small blind) folded before Flop



PokerStars Hand #222957292193:  Hold'em No Limit ($0.05/$0.10 USD) - 2021/01/23 10:37:23 ET
Table 'Stephano III' 6-max Seat #6 is the button
Seat 1: Intimitatem ($10 in chips) 
Seat 2: petrovichkag ($13.59 in chips) 
Seat 3: Greentvdinne ($13.79 in chips) 
Seat 5: Manic Jay ($11.76 in chips) 
Seat 6: alVatroos ($10.52 in chips) 
Intimitatem: posts small blind $0.05
petrovichkag: posts big blind $0.10
*** HOLE CARDS ***
Greentvdinne: folds 
Manic Jay: calls $0.10
alVatroos: folds 
Intimitatem: folds 
petrovichkag: raises $0.30 to $0.40
Manic Jay: calls $0.30
*** FLOP *** [4h Ts 9s]
petrovichkag: bets $0.27
Manic Jay: calls $0.27
*** TURN *** [4h Ts 9s] [7s]
petrovichkag: checks 
Manic Jay: checks 
*** RIVER *** [4h Ts 9s 7s] [Ah]
petrovichkag: bets $1.10
Manic Jay: calls $1.10
eRRe_ssbm leaves the table
*** SHOW DOWN ***
petrovichkag: shows [Qs Ks] (a flush, King high)
Manic Jay: mucks hand 
petrovichkag collected $3.43 from pot
*** SUMMARY ***
Total pot $3.59 | Rake $0.16 
Board [4h Ts 9s 7s Ah]
Seat 1: Intimitatem (small blind) folded before Flop
Seat 2: petrovichkag (big blind) showed [Qs Ks] and won ($3.43) with a flush, King high
Seat 3: Greentvdinne folded before Flop (didn't bet)
Seat 5: Manic Jay mucked
Seat 6: alVatroos (button) folded before Flop (didn't bet)



PokerStars Hand #222957313612:  Hold'em No Limit ($0.05/$0.10 USD) - 2021/01/23 10:38:02 ET
Table 'Stephano III' 6-max Seat #1 is the button
Seat 1: Intimitatem ($10 in chips) 
Seat 2: petrovichkag ($15.25 in chips) 
Seat 3: Greentvdinne ($13.79 in chips) 
Seat 5: Manic Jay ($9.99 in chips) 
Seat 6: alVatroos ($10.52 in chips) 
petrovichkag: posts small blind $0.05
Greentvdinne: posts big blind $0.10
*** HOLE CARDS ***
Manic Jay: folds 
alVatroos: folds 
Intimitatem: folds 
petrovichkag: raises $0.20 to $0.30
Greentvdinne: folds 
Uncalled bet ($0.20) returned to petrovichkag
petrovichkag collected $0.20 from pot
petrovichkag: doesn't show hand 
*** SUMMARY ***
Total pot $0.20 | Rake $0 
Seat 1: Intimitatem (button) folded before Flop (didn't bet)
Seat 2: petrovichkag (small blind) collected ($0.20)
Seat 3: Greentvdinne (big blind) folded before Flop
Seat 5: Manic Jay folded before Flop (didn't bet)
Seat 6: alVatroos folded before Flop (didn't bet)



PokerStars Hand #222957325290:  Hold'em No Limit ($0.05/$0.10 USD) - 2021/01/23 10:38:23 ET
Table 'Stephano III' 6-max Seat #2 is the button
Seat 1: Intimitatem ($10 in chips) 
Seat 2: petrovichkag ($15.35 in chips) 
Seat 3: Greentvdinne ($13.69 in chips) 
Seat 5: Manic Jay ($9.99 in chips) 
Seat 6: alVatroos ($10.52 in chips) 
Greentvdinne: posts small blind $0.05
Manic Jay: posts big blind $0.10
*** HOLE CARDS ***
alVatroos: folds 
Intimitatem: folds 
petrovichkag: folds 
Greentvdinne: calls $0.05
Manic Jay: checks 
*** FLOP *** [2h 8c 5h]
Greentvdinne: checks 
Manic Jay: checks 
*** TURN *** [2h 8c 5h] [Qc]
Greentvdinne: bets $0.20
Manic Jay: folds 
Uncalled bet ($0.20) returned to Greentvdinne
Ivan96716 joins the table at seat #4 
Greentvdinne collected $0.19 from pot
Greentvdinne: doesn't show hand 
*** SUMMARY ***
Total pot $0.20 | Rake $0.01 
Board [2h 8c 5h Qc]
Seat 1: Intimitatem folded before Flop (didn't bet)
Seat 2: petrovichkag (button) folded before Flop (didn't bet)
Seat 3: Greentvdinne (small blind) collected ($0.19)
Seat 5: Manic Jay (big blind) folded on the Turn
Seat 6: alVatroos folded before Flop (didn't bet)



PokerStars Hand #222957336378:  Hold'em No Limit ($0.05/$0.10 USD) - 2021/01/23 10:38:44 ET
Table 'Stephano III' 6-max Seat #3 is the button
Seat 1: Intimitatem ($10 in chips) 
Seat 2: petrovichkag ($15.35 in chips) 
Seat 3: Greentvdinne ($13.78 in chips) 
Seat 5: Manic Jay ($9.89 in chips) 
Seat 6: alVatroos ($10.52 in chips) 
Manic Jay: posts small blind $0.05
alVatroos: posts big blind $0.10
*** HOLE CARDS ***
Intimitatem: folds 
petrovichkag: folds 
Greentvdinne: folds 
Manic Jay: folds 
Uncalled bet ($0.05) returned to alVatroos
alVatroos collected $0.10 from pot
alVatroos: doesn't show hand 
*** SUMMARY ***
Total pot $0.10 | Rake $0 
Seat 1: Intimitatem folded before Flop (didn't bet)
Seat 2: petrovichkag folded before Flop (didn't bet)
Seat 3: Greentvdinne (button) folded before Flop (didn't bet)
Seat 5: Manic Jay (small blind) folded before Flop
Seat 6: alVatroos (big blind) collected ($0.10)



PokerStars Hand #222957340884:  Hold'em No Limit ($0.05/$0.10 USD) - 2021/01/23 10:38:52 ET
Table 'Stephano III' 6-max Seat #5 is the button
Seat 1: Intimitatem ($10 in chips) 
Seat 2: petrovichkag ($15.35 in chips) 
Seat 3: Greentvdinne ($13.78 in chips) 
Seat 4: Ivan96716 ($5.77 in chips) 
Seat 5: Manic Jay ($9.84 in chips) 
Seat 6: alVatroos ($10.57 in chips) 
alVatroos: posts small blind $0.05
Intimitatem: posts big blind $0.10
Ivan96716: posts big blind $0.10
*** HOLE CARDS ***
petrovichkag: folds 
Greentvdinne: calls $0.10
Ivan96716: checks 
Manic Jay: raises $0.20 to $0.30
alVatroos: raises $1 to $1.30
Intimitatem: folds 
Greentvdinne: folds 
Ivan96716: folds 
Manic Jay: calls $1
*** FLOP *** [As Kh 4s]
alVatroos: bets $0.55
Manic Jay: calls $0.55
*** TURN *** [As Kh 4s] [9h]
alVatroos: bets $0.76
Manic Jay: calls $0.76
*** RIVER *** [As Kh 4s 9h] [7h]
alVatroos: checks 
Ivan96716 leaves the table
Manic Jay: checks 
*** SHOW DOWN ***
alVatroos: shows [Js Jc] (a pair of Jacks)
Manic Jay: shows [Td Ah] (a pair of Aces)
Manic Jay collected $5.27 from pot
*** SUMMARY ***
Total pot $5.52 | Rake $0.25 
Board [As Kh 4s 9h 7h]
Seat 1: Intimitatem (big blind) folded before Flop
Seat 2: petrovichkag folded before Flop (didn't bet)
Seat 3: Greentvdinne folded before Flop
Seat 4: Ivan96716 folded before Flop (didn't bet)
Seat 5: Manic Jay (button) showed [Td Ah] and won ($5.27) with a pair of Aces
Seat 6: alVatroos (small blind) showed [Js Jc] and lost with a pair of Jacks



PokerStars Hand #222957365185:  Hold'em No Limit ($0.05/$0.10 USD) - 2021/01/23 10:39:36 ET
Table 'Stephano III' 6-max Seat #6 is the button
Seat 1: Intimitatem ($10 in chips) 
Seat 2: petrovichkag ($15.35 in chips) 
Seat 3: Greentvdinne ($13.68 in chips) 
Seat 5: Manic Jay ($12.50 in chips) 
Seat 6: alVatroos ($10 in chips) 
Intimitatem: posts small blind $0.05
petrovichkag: posts big blind $0.10
*** HOLE CARDS ***
Greentvdinne: raises $0.20 to $0.30
Manic Jay: folds 
alVatroos: folds 
Intimitatem: folds 
petrovichkag: folds 
Uncalled bet ($0.20) returned to Greentvdinne
Greentvdinne collected $0.25 from pot
Greentvdinne: doesn't show hand 
*** SUMMARY ***
Total pot $0.25 | Rake $0 
Seat 1: Intimitatem (small blind) folded before Flop
Seat 2: petrovichkag (big blind) folded before Flop
Seat 3: Greentvdinne collected ($0.25)
Seat 5: Manic Jay folded before Flop (didn't bet)
Seat 6: alVatroos (button) folded before Flop (didn't bet)



PokerStars Hand #222957368763:  Hold'em No Limit ($0.05/$0.10 USD) - 2021/01/23 10:39:43 ET
Table 'Stephano III' 6-max Seat #1 is the button
Seat 1: Intimitatem ($10 in chips) 
Seat 2: petrovichkag ($15.25 in chips) 
Seat 3: Greentvdinne ($13.83 in chips) 
Seat 5: Manic Jay ($12.50 in chips) 
Seat 6: alVatroos ($10 in chips) 
petrovichkag: posts small blind $0.05
Greentvdinne: posts big blind $0.10
*** HOLE CARDS ***
Manic Jay: calls $0.10
alVatroos: folds 
Intimitatem: folds 
petrovichkag: folds 
Greentvdinne: checks 
*** FLOP *** [2c Kc 9d]
Greentvdinne: checks 
Manic Jay: checks 
*** TURN *** [2c Kc 9d] [6h]
Greentvdinne: checks 
Manic Jay: checks 
*** RIVER *** [2c Kc 9d 6h] [Js]
Greentvdinne: bets $0.20
Manic Jay: calls $0.20
*** SHOW DOWN ***
Greentvdinne: shows [6c Jd] (two pair, Jacks and Sixes)
Manic Jay: mucks hand 
Greentvdinne collected $0.62 from pot
*** SUMMARY ***
Total pot $0.65 | Rake $0.03 
Board [2c Kc 9d 6h Js]
Seat 1: Intimitatem (button) folded before Flop (didn't bet)
Seat 2: petrovichkag (small blind) folded before Flop
Seat 3: Greentvdinne (big blind) showed [6c Jd] and won ($0.62) with two pair, Jacks and Sixes
Seat 5: Manic Jay mucked
Seat 6: alVatroos folded before Flop (didn't bet)



PokerStars Hand #222957387442:  Hold'em No Limit ($0.05/$0.10 USD) - 2021/01/23 10:40:17 ET
Table 'Stephano III' 6-max Seat #2 is the button
Seat 1: Intimitatem ($10 in chips) 
Seat 2: petrovichkag ($15.20 in chips) 
Seat 3: Greentvdinne ($14.15 in chips) 
Seat 5: Manic Jay ($12.20 in chips) 
Seat 6: alVatroos ($10 in chips) 
Greentvdinne: posts small blind $0.05
Manic Jay: posts big blind $0.10
*** HOLE CARDS ***
alVatroos: folds 
Intimitatem: folds 
petrovichkag: raises $0.14 to $0.24
Greentvdinne: folds 
Manic Jay: calls $0.14
*** FLOP *** [Qs Jc 2h]
Manic Jay: checks 
petrovichkag: checks 
*** TURN *** [Qs Jc 2h] [4s]
Manic Jay: checks 
petrovichkag: bets $0.40
Manic Jay: calls $0.40
*** RIVER *** [Qs Jc 2h 4s] [3d]
Manic Jay: checks 
petrovichkag: checks 
*** SHOW DOWN ***
Manic Jay: shows [Ts 8s] (high card Queen)
petrovichkag: shows [5s 3s] (a pair of Threes)
petrovichkag collected $1.27 from pot
Daurado joins the table at seat #4 
*** SUMMARY ***
Total pot $1.33 | Rake $0.06 
Board [Qs Jc 2h 4s 3d]
Seat 1: Intimitatem folded before Flop (didn't bet)
Seat 2: petrovichkag (button) showed [5s 3s] and won ($1.27) with a pair of Threes
Seat 3: Greentvdinne (small blind) folded before Flop
Seat 5: Manic Jay (big blind) showed [Ts 8s] and lost with high card Queen
Seat 6: alVatroos folded before Flop (didn't bet)



PokerStars Hand #222957404774:  Hold'em No Limit ($0.05/$0.10 USD) - 2021/01/23 10:40:48 ET
Table 'Stephano III' 6-max Seat #3 is the button
Seat 1: Intimitatem ($10 in chips) 
Seat 2: petrovichkag ($15.83 in chips) 
Seat 3: Greentvdinne ($14.10 in chips) 
Seat 5: Manic Jay ($11.56 in chips) 
Seat 6: alVatroos ($10 in chips) 
Manic Jay: posts small blind $0.05
alVatroos: posts big blind $0.10
*** HOLE CARDS ***
Intimitatem: raises $0.12 to $0.22
petrovichkag: raises $0.58 to $0.80
Greentvdinne: folds 
Manic Jay: folds 
alVatroos: folds 
Intimitatem: folds 
Uncalled bet ($0.58) returned to petrovichkag
petrovichkag collected $0.59 from pot
petrovichkag: doesn't show hand 
*** SUMMARY ***
Total pot $0.59 | Rake $0 
Seat 1: Intimitatem folded before Flop
Seat 2: petrovichkag collected ($0.59)
Seat 3: Greentvdinne (button) folded before Flop (didn't bet)
Seat 5: Manic Jay (small blind) folded before Flop
Seat 6: alVatroos (big blind) folded before Flop



PokerStars Hand #222957416691:  Hold'em No Limit ($0.05/$0.10 USD) - 2021/01/23 10:41:10 ET
Table 'Stephano III' 6-max Seat #5 is the button
Seat 1: Intimitatem ($10 in chips) 
Seat 2: petrovichkag ($16.20 in chips) 
Seat 3: Greentvdinne ($14.10 in chips) 
Seat 5: Manic Jay ($11.51 in chips) 
Seat 6: alVatroos ($10 in chips) 
alVatroos: posts small blind $0.05
Intimitatem: posts big blind $0.10
Daurado: sits out 
*** HOLE CARDS ***
petrovichkag: folds 
Greentvdinne: calls $0.10
Manic Jay: folds 
alVatroos: folds 
Intimitatem: checks 
*** FLOP *** [2d 7s 5d]
Intimitatem: checks 
Greentvdinne: checks 
*** TURN *** [2d 7s 5d] [8d]
Intimitatem: checks 
Greentvdinne: checks 
*** RIVER *** [2d 7s 5d 8d] [Kd]
Intimitatem: checks 
Greentvdinne: checks 
*** SHOW DOWN ***
Intimitatem: shows [3d 8c] (a flush, King high)
Greentvdinne: mucks hand 
Intimitatem collected $0.24 from pot
*** SUMMARY ***
Total pot $0.25 | Rake $0.01 
Board [2d 7s 5d 8d Kd]
Seat 1: Intimitatem (big blind) showed [3d 8c] and won ($0.24) with a flush, King high
Seat 2: petrovichkag folded before Flop (didn't bet)
Seat 3: Greentvdinne mucked
Seat 5: Manic Jay (button) folded before Flop (didn't bet)
Seat 6: alVatroos (small blind) folded before Flop



PokerStars Hand #222957432783:  Hold'em No Limit ($0.05/$0.10 USD) - 2021/01/23 10:41:39 ET
Table 'Stephano III' 6-max Seat #6 is the button
Seat 1: Intimitatem ($10.14 in chips) 
Seat 2: petrovichkag ($16.20 in chips) 
Seat 3: Greentvdinne ($14 in chips) 
Seat 5: Manic Jay ($11.51 in chips) 
Seat 6: alVatroos ($10 in chips) 
Intimitatem: posts small blind $0.05
petrovichkag: posts big blind $0.10
Daurado: sits out 
*** HOLE CARDS ***
Greentvdinne: folds 
Manic Jay: calls $0.10
alVatroos: folds 
Intimitatem: folds 
petrovichkag: checks 
*** FLOP *** [8h Ac 2h]
petrovichkag: checks 
Manic Jay: checks 
*** TURN *** [8h Ac 2h] [Ad]
petrovichkag: checks 
Manic Jay: checks 
*** RIVER *** [8h Ac 2h Ad] [8d]
petrovichkag: checks 
Manic Jay: checks 
*** SHOW DOWN ***
petrovichkag: shows [7c 5c] (two pair, Aces and Eights)
Manic Jay: shows [4s Ks] (two pair, Aces and Eights - King kicker)
Manic Jay collected $0.24 from pot
*** SUMMARY ***
Total pot $0.25 | Rake $0.01 
Board [8h Ac 2h Ad 8d]
Seat 1: Intimitatem (small blind) folded before Flop
Seat 2: petrovichkag (big blind) showed [7c 5c] and lost with two pair, Aces and Eights
Seat 3: Greentvdinne folded before Flop (didn't bet)
Seat 5: Manic Jay showed [4s Ks] and won ($0.24) with two pair, Aces and Eights
Seat 6: alVatroos (button) folded before Flop (didn't bet)



PokerStars Hand #222957446055:  Hold'em No Limit ($0.05/$0.10 USD) - 2021/01/23 10:42:03 ET
Table 'Stephano III' 6-max Seat #1 is the button
Seat 1: Intimitatem ($10.09 in chips) 
Seat 2: petrovichkag ($16.10 in chips) 
Seat 3: Greentvdinne ($14 in chips) 
Seat 5: Manic Jay ($11.65 in chips) 
Seat 6: alVatroos ($10 in chips) 
petrovichkag: posts small blind $0.05
Greentvdinne: posts big blind $0.10
Daurado: sits out 
*** HOLE CARDS ***
Manic Jay: folds 
alVatroos: folds 
Intimitatem: folds 
petrovichkag: folds 
Uncalled bet ($0.05) returned to Greentvdinne
Greentvdinne collected $0.10 from pot
Greentvdinne: doesn't show hand 
*** SUMMARY ***
Total pot $0.10 | Rake $0 
Seat 1: Intimitatem (button) folded before Flop (didn't bet)
Seat 2: petrovichkag (small blind) folded before Flop
Seat 3: Greentvdinne (big blind) collected ($0.10)
Seat 5: Manic Jay folded before Flop (didn't bet)
Seat 6: alVatroos folded before Flop (didn't bet)



PokerStars Hand #222957757542:  Hold'em No Limit ($0.05/$0.10 USD) - 2021/01/23 10:51:24 ET
Table 'Stephano III' 6-max Seat #5 is the button
Seat 1: Intimitatem ($10 in chips) 
Seat 2: petrovichkag ($16.54 in chips) 
Seat 3: Greentvdinne ($23.88 in chips) 
Seat 4: Daurado ($20.11 in chips) 
Seat 5: Impostore1988 ($9.80 in chips) 
Seat 6: stboyo ($7.90 in chips) 
stboyo: posts small blind $0.05
Intimitatem: posts big blind $0.10
*** HOLE CARDS ***
petrovichkag: folds 
Greentvdinne: folds 
Daurado: raises $0.15 to $0.25
Impostore1988: folds 
stboyo: folds 
Intimitatem: folds 
Uncalled bet ($0.15) returned to Daurado
Daurado collected $0.25 from pot
Daurado: doesn't show hand 
*** SUMMARY ***
Total pot $0.25 | Rake $0 
Seat 1: Intimitatem (big blind) folded before Flop
Seat 2: petrovichkag folded before Flop (didn't bet)
Seat 3: Greentvdinne folded before Flop (didn't bet)
Seat 4: Daurado collected ($0.25)
Seat 5: Impostore1988 (button) folded before Flop (didn't bet)
Seat 6: stboyo (small blind) folded before Flop



PokerStars Hand #222957765366:  Hold'em No Limit ($0.05/$0.10 USD) - 2021/01/23 10:51:38 ET
Table 'Stephano III' 6-max Seat #6 is the button
Seat 1: Intimitatem ($10 in chips) 
Seat 2: petrovichkag ($16.54 in chips) 
Seat 3: Greentvdinne ($23.88 in chips) 
Seat 4: Daurado ($20.26 in chips) 
Seat 5: Impostore1988 ($9.80 in chips) 
Seat 6: stboyo ($7.85 in chips) 
Intimitatem: posts small blind $0.05
petrovichkag: posts big blind $0.10
*** HOLE CARDS ***
Greentvdinne: folds 
Daurado: folds 
Impostore1988: raises $0.20 to $0.30
stboyo: folds 
Intimitatem: folds 
petrovichkag: folds 
Uncalled bet ($0.20) returned to Impostore1988
Impostore1988 collected $0.25 from pot
Impostore1988: doesn't show hand 
*** SUMMARY ***
Total pot $0.25 | Rake $0 
Seat 1: Intimitatem (small blind) folded before Flop
Seat 2: petrovichkag (big blind) folded before Flop
Seat 3: Greentvdinne folded before Flop (didn't bet)
Seat 4: Daurado folded before Flop (didn't bet)
Seat 5: Impostore1988 collected ($0.25)
Seat 6: stboyo (button) folded before Flop (didn't bet)



PokerStars Hand #222957772281:  Hold'em No Limit ($0.05/$0.10 USD) - 2021/01/23 10:51:50 ET
Table 'Stephano III' 6-max Seat #1 is the button
Seat 1: Intimitatem ($10 in chips) 
Seat 2: petrovichkag ($16.44 in chips) 
Seat 3: Greentvdinne ($23.88 in chips) 
Seat 4: Daurado ($20.26 in chips) 
Seat 5: Impostore1988 ($9.95 in chips) 
Seat 6: stboyo ($7.85 in chips) 
petrovichkag: posts small blind $0.05
Greentvdinne: posts big blind $0.10
*** HOLE CARDS ***
Daurado: raises $0.20 to $0.30
Impostore1988: folds 
stboyo: folds 
Intimitatem: folds 
petrovichkag: folds 
Greentvdinne: calls $0.20
*** FLOP *** [Ah 6s Qh]
Greentvdinne: checks 
Daurado: checks 
*** TURN *** [Ah 6s Qh] [Ad]
Greentvdinne: bets $0.30
Daurado: folds 
Uncalled bet ($0.30) returned to Greentvdinne
Greentvdinne collected $0.62 from pot
Greentvdinne: doesn't show hand 
*** SUMMARY ***
Total pot $0.65 | Rake $0.03 
Board [Ah 6s Qh Ad]
Seat 1: Intimitatem (button) folded before Flop (didn't bet)
Seat 2: petrovichkag (small blind) folded before Flop
Seat 3: Greentvdinne (big blind) collected ($0.62)
Seat 4: Daurado folded on the Turn
Seat 5: Impostore1988 folded before Flop (didn't bet)
Seat 6: stboyo folded before Flop (didn't bet)



PokerStars Hand #222957787899:  Hold'em No Limit ($0.05/$0.10 USD) - 2021/01/23 10:52:19 ET
Table 'Stephano III' 6-max Seat #2 is the button
Seat 1: Intimitatem ($10 in chips) 
Seat 2: petrovichkag ($16.39 in chips) 
Seat 3: Greentvdinne ($24.20 in chips) 
Seat 4: Daurado ($19.96 in chips) 
Seat 5: Impostore1988 ($9.95 in chips) 
Seat 6: stboyo ($7.85 in chips) 
Greentvdinne: posts small blind $0.05
Daurado: posts big blind $0.10
*** HOLE CARDS ***
Impostore1988: folds 
stboyo: raises $0.10 to $0.20
Intimitatem: folds 
petrovichkag: folds 
Greentvdinne: folds 
Daurado: calls $0.10
*** FLOP *** [7h 7s 5c]
Daurado: checks 
stboyo: bets $0.21
Daurado: folds 
Uncalled bet ($0.21) returned to stboyo
stboyo collected $0.43 from pot
stboyo: doesn't show hand 
*** SUMMARY ***
Total pot $0.45 | Rake $0.02 
Board [7h 7s 5c]
Seat 1: Intimitatem folded before Flop (didn't bet)
Seat 2: petrovichkag (button) folded before Flop (didn't bet)
Seat 3: Greentvdinne (small blind) folded before Flop
Seat 4: Daurado (big blind) folded on the Flop
Seat 5: Impostore1988 folded before Flop (didn't bet)
Seat 6: stboyo collected ($0.43)



PokerStars Hand #222957798393:  Hold'em No Limit ($0.05/$0.10 USD) - 2021/01/23 10:52:38 ET
Table 'Stephano III' 6-max Seat #3 is the button
Seat 1: Intimitatem ($10 in chips) 
Seat 2: petrovichkag ($16.39 in chips) 
Seat 3: Greentvdinne ($24.15 in chips) 
Seat 4: Daurado ($19.76 in chips) 
Seat 5: Impostore1988 ($9.95 in chips) 
Seat 6: stboyo ($8.08 in chips) 
Daurado: posts small blind $0.05
Impostore1988: posts big blind $0.10
*** HOLE CARDS ***
stboyo: calls $0.10
Intimitatem: folds 
petrovichkag: folds 
Greentvdinne: folds 
Daurado: calls $0.05
Impostore1988: raises $0.40 to $0.50
stboyo: calls $0.40
Daurado: folds 
*** FLOP *** [3c 8c Kh]
Impostore1988: checks 
stboyo: bets $0.52
Impostore1988: folds 
Uncalled bet ($0.52) returned to stboyo
stboyo collected $1.05 from pot
stboyo: doesn't show hand 
*** SUMMARY ***
Total pot $1.10 | Rake $0.05 
Board [3c 8c Kh]
Seat 1: Intimitatem folded before Flop (didn't bet)
Seat 2: petrovichkag folded before Flop (didn't bet)
Seat 3: Greentvdinne (button) folded before Flop (didn't bet)
Seat 4: Daurado (small blind) folded before Flop
Seat 5: Impostore1988 (big blind) folded on the Flop
Seat 6: stboyo collected ($1.05)



PokerStars Hand #222957815962:  Hold'em No Limit ($0.05/$0.10 USD) - 2021/01/23 10:53:10 ET
Table 'Stephano III' 6-max Seat #4 is the button
Seat 1: Intimitatem ($10 in chips) 
Seat 2: petrovichkag ($16.39 in chips) 
Seat 3: Greentvdinne ($24.15 in chips) 
Seat 4: Daurado ($19.66 in chips) 
Seat 5: Impostore1988 ($9.45 in chips) 
Seat 6: stboyo ($8.63 in chips) 
Impostore1988: posts small blind $0.05
stboyo: posts big blind $0.10
*** HOLE CARDS ***
Intimitatem: raises $0.12 to $0.22
petrovichkag: folds 
Greentvdinne: raises $0.59 to $0.81
Daurado: folds 
Impostore1988: folds 
stboyo: folds 
Intimitatem: raises $1.41 to $2.22
Greentvdinne: calls $1.41
*** FLOP *** [Td Qh As]
Intimitatem: checks 
Greentvdinne: bets $2.19
Intimitatem: calls $2.19
*** TURN *** [Td Qh As] [Ts]
Intimitatem: checks 
Greentvdinne: checks 
*** RIVER *** [Td Qh As Ts] [Jh]
Intimitatem: checks 
Greentvdinne: checks 
*** SHOW DOWN ***
Intimitatem: shows [Kd Ks] (a straight, Ten to Ace)
Greentvdinne: mucks hand 
Intimitatem collected $8.57 from pot
*** SUMMARY ***
Total pot $8.97 | Rake $0.40 
Board [Td Qh As Ts Jh]
Seat 1: Intimitatem showed [Kd Ks] and won ($8.57) with a straight, Ten to Ace
Seat 2: petrovichkag folded before Flop (didn't bet)
Seat 3: Greentvdinne mucked
Seat 4: Daurado (button) folded before Flop (didn't bet)
Seat 5: Impostore1988 (small blind) folded before Flop
Seat 6: stboyo (big blind) folded before Flop



PokerStars Hand #222957855544:  Hold'em No Limit ($0.05/$0.10 USD) - 2021/01/23 10:54:22 ET
Table 'Stephano III' 6-max Seat #5 is the button
Seat 1: Intimitatem ($14.16 in chips) 
Seat 2: petrovichkag ($16.39 in chips) 
Seat 4: Daurado ($19.66 in chips) 
Seat 5: Impostore1988 ($10 in chips) 
Seat 6: stboyo ($8.53 in chips) 
stboyo: posts small blind $0.05
Intimitatem: posts big blind $0.10
*** HOLE CARDS ***
petrovichkag: folds 
Daurado: folds 
Impostore1988: folds 
Greentvdinne leaves the table
stboyo: calls $0.05
Intimitatem: checks 
*** FLOP *** [Ts 6c Td]
atticus1401 joins the table at seat #3 
stboyo: checks 
Intimitatem: checks 
*** TURN *** [Ts 6c Td] [Qc]
stboyo: bets $0.10
Intimitatem: folds 
Uncalled bet ($0.10) returned to stboyo
stboyo collected $0.19 from pot
stboyo: doesn't show hand 
*** SUMMARY ***
Total pot $0.20 | Rake $0.01 
Board [Ts 6c Td Qc]
Seat 1: Intimitatem (big blind) folded on the Turn
Seat 2: petrovichkag folded before Flop (didn't bet)
Seat 4: Daurado folded before Flop (didn't bet)
Seat 5: Impostore1988 (button) folded before Flop (didn't bet)
Seat 6: stboyo (small blind) collected ($0.19)



PokerStars Hand #222957868418:  Hold'em No Limit ($0.05/$0.10 USD) - 2021/01/23 10:54:45 ET
Table 'Stephano III' 6-max Seat #6 is the button
Seat 1: Intimitatem ($14.06 in chips) 
Seat 2: petrovichkag ($16.39 in chips) 
Seat 3: atticus1401 ($8 in chips) 
Seat 4: Daurado ($19.66 in chips) 
Seat 5: Impostore1988 ($10 in chips) 
Seat 6: stboyo ($8.62 in chips) 
Intimitatem: posts small blind $0.05
petrovichkag: posts big blind $0.10
atticus1401: posts big blind $0.10
*** HOLE CARDS ***
atticus1401: raises $0.20 to $0.30
Daurado: folds 
Impostore1988: folds 
stboyo: folds 
Intimitatem: raises $0.90 to $1.20
petrovichkag: folds 
atticus1401: folds 
Uncalled bet ($0.90) returned to Intimitatem
Intimitatem collected $0.70 from pot
Intimitatem: doesn't show hand 
*** SUMMARY ***
Total pot $0.70 | Rake $0 
Seat 1: Intimitatem (small blind) collected ($0.70)
Seat 2: petrovichkag (big blind) folded before Flop
Seat 3: atticus1401 folded before Flop
Seat 4: Daurado folded before Flop (didn't bet)
Seat 5: Impostore1988 folded before Flop (didn't bet)
Seat 6: stboyo (button) folded before Flop (didn't bet)



PokerStars Hand #222957883801:  Hold'em No Limit ($0.05/$0.10 USD) - 2021/01/23 10:55:15 ET
Table 'Stephano III' 6-max Seat #1 is the button
Seat 1: Intimitatem ($14.46 in chips) 
Seat 2: petrovichkag ($16.29 in chips) 
Seat 3: atticus1401 ($7.70 in chips) 
Seat 4: Daurado ($19.66 in chips) 
Seat 5: Impostore1988 ($10 in chips) 
Seat 6: stboyo ($8.62 in chips) 
petrovichkag: posts small blind $0.05
atticus1401: posts big blind $0.10
*** HOLE CARDS ***
Daurado: folds 
Impostore1988: folds 
stboyo: folds 
Intimitatem: raises $0.12 to $0.22
petrovichkag: folds 
atticus1401: calls $0.12
*** FLOP *** [7s Ts 4c]
atticus1401: checks 
Intimitatem: checks 
*** TURN *** [7s Ts 4c] [4h]
atticus1401: checks 
Intimitatem: checks 
*** RIVER *** [7s Ts 4c 4h] [5d]
atticus1401: checks 
Intimitatem: checks 
*** SHOW DOWN ***
atticus1401: shows [3d Qd] (a pair of Fours)
Intimitatem: shows [6c Ac] (a pair of Fours - Ace kicker)
Intimitatem collected $0.47 from pot
*** SUMMARY ***
Total pot $0.49 | Rake $0.02 
Board [7s Ts 4c 4h 5d]
Seat 1: Intimitatem (button) showed [6c Ac] and won ($0.47) with a pair of Fours
Seat 2: petrovichkag (small blind) folded before Flop
Seat 3: atticus1401 (big blind) showed [3d Qd] and lost with a pair of Fours
Seat 4: Daurado folded before Flop (didn't bet)
Seat 5: Impostore1988 folded before Flop (didn't bet)
Seat 6: stboyo folded before Flop (didn't bet)



PokerStars Hand #222957897041:  Hold'em No Limit ($0.05/$0.10 USD) - 2021/01/23 10:55:46 ET
Table 'Stephano III' 6-max Seat #2 is the button
Seat 1: Intimitatem ($14.71 in chips) 
Seat 2: petrovichkag ($16.24 in chips) 
Seat 3: atticus1401 ($7.48 in chips) 
Seat 4: Daurado ($19.66 in chips) 
Seat 5: Impostore1988 ($10 in chips) 
Seat 6: stboyo ($8.62 in chips) 
atticus1401: posts small blind $0.05
Daurado: posts big blind $0.10
*** HOLE CARDS ***
Impostore1988: folds 
stboyo: raises $0.20 to $0.30
Intimitatem: folds 
petrovichkag: folds 
atticus1401: folds 
Daurado: folds 
Uncalled bet ($0.20) returned to stboyo
stboyo collected $0.25 from pot
stboyo: doesn't show hand 
*** SUMMARY ***
Total pot $0.25 | Rake $0 
Seat 1: Intimitatem folded before Flop (didn't bet)
Seat 2: petrovichkag (button) folded before Flop (didn't bet)
Seat 3: atticus1401 (small blind) folded before Flop
Seat 4: Daurado (big blind) folded before Flop
Seat 5: Impostore1988 folded before Flop (didn't bet)
Seat 6: stboyo collected ($0.25)



PokerStars Hand #222957905647:  Hold'em No Limit ($0.05/$0.10 USD) - 2021/01/23 10:56:05 ET
Table 'Stephano III' 6-max Seat #3 is the button
Seat 2: petrovichkag ($16.24 in chips) 
Seat 3: atticus1401 ($7.43 in chips) 
Seat 4: Daurado ($19.56 in chips) 
Seat 5: Impostore1988 ($10 in chips) 
Seat 6: stboyo ($8.77 in chips) 
Daurado: posts small blind $0.05
Impostore1988: posts big blind $0.10
*** HOLE CARDS ***
stboyo: folds 
petrovichkag: folds 
atticus1401: raises $0.10 to $0.20
Daurado: folds 
Impostore1988: folds 
Uncalled bet ($0.10) returned to atticus1401
atticus1401 collected $0.25 from pot
atticus1401: doesn't show hand 
*** SUMMARY ***
Total pot $0.25 | Rake $0 
Seat 2: petrovichkag folded before Flop (didn't bet)
Seat 3: atticus1401 (button) collected ($0.25)
Seat 4: Daurado (small blind) folded before Flop
Seat 5: Impostore1988 (big blind) folded before Flop
Seat 6: stboyo folded before Flop (didn't bet)



PokerStars Hand #222957910586:  Hold'em No Limit ($0.05/$0.10 USD) - 2021/01/23 10:56:17 ET
Table 'Stephano III' 6-max Seat #4 is the button
Seat 2: petrovichkag ($16.24 in chips) 
Seat 3: atticus1401 ($7.58 in chips) 
Seat 4: Daurado ($19.51 in chips) 
Seat 5: Impostore1988 ($9.90 in chips) 
Seat 6: stboyo ($8.77 in chips) 
Impostore1988: posts small blind $0.05
stboyo: posts big blind $0.10
*** HOLE CARDS ***
petrovichkag: folds 
atticus1401: calls $0.10
Daurado: folds 
Impostore1988: calls $0.05
stboyo: checks 
*** FLOP *** [Qs Jh 6d]
Impostore1988: checks 
stboyo: checks 
atticus1401: bets $0.29
Impostore1988: calls $0.29
stboyo: folds 
*** TURN *** [Qs Jh 6d] [5h]
Impostore1988: checks 
atticus1401: bets $0.42
Impostore1988: calls $0.42
*** RIVER *** [Qs Jh 6d 5h] [3d]
Impostore1988: checks 
atticus1401: checks 
*** SHOW DOWN ***
Impostore1988: shows [Ts 9s] (high card Queen)
atticus1401: shows [Tc Js] (a pair of Jacks)
atticus1401 collected $1.64 from pot
*** SUMMARY ***
Total pot $1.72 | Rake $0.08 
Board [Qs Jh 6d 5h 3d]
Seat 2: petrovichkag folded before Flop (didn't bet)
Seat 3: atticus1401 showed [Tc Js] and won ($1.64) with a pair of Jacks
Seat 4: Daurado (button) folded before Flop (didn't bet)
Seat 5: Impostore1988 (small blind) showed [Ts 9s] and lost with high card Queen
Seat 6: stboyo (big blind) folded on the Flop



PokerStars Hand #222957930391:  Hold'em No Limit ($0.05/$0.10 USD) - 2021/01/23 10:57:02 ET
Table 'Stephano III' 6-max Seat #5 is the button
Seat 3: atticus1401 ($8.41 in chips) 
Seat 4: Daurado ($19.51 in chips) 
Seat 5: Impostore1988 ($9.09 in chips) 
Seat 6: stboyo ($8.67 in chips) 
stboyo: posts small blind $0.05
petrovichkag: is sitting out 
petrovichkag leaves the table
atticus1401: posts big blind $0.10
*** HOLE CARDS ***
Daurado: folds 
Impostore1988: folds 
stboyo: calls $0.05
atticus1401: checks 
*** FLOP *** [Js 5h Tc]
SERG244 joins the table at seat #2 
stboyo: bets $0.10
atticus1401: calls $0.10
*** TURN *** [Js 5h Tc] [Ah]
stboyo: bets $0.19
atticus1401: calls $0.19
*** RIVER *** [Js 5h Tc Ah] [5d]
stboyo: checks 
atticus1401: checks 
*** SHOW DOWN ***
stboyo: shows [3c Qs] (a pair of Fives)
atticus1401: mucks hand 
stboyo collected $0.74 from pot
*** SUMMARY ***
Total pot $0.78 | Rake $0.04 
Board [Js 5h Tc Ah 5d]
Seat 3: atticus1401 (big blind) mucked
Seat 4: Daurado folded before Flop (didn't bet)
Seat 5: Impostore1988 (button) folded before Flop (didn't bet)
Seat 6: stboyo (small blind) showed [3c Qs] and won ($0.74) with a pair of Fives



PokerStars Hand #222957945509:  Hold'em No Limit ($0.05/$0.10 USD) - 2021/01/23 10:57:36 ET
Table 'Stephano III' 6-max Seat #6 is the button
Seat 3: atticus1401 ($8.02 in chips) 
Seat 4: Daurado ($19.51 in chips) 
Seat 5: Impostore1988 ($10 in chips) 
Seat 6: stboyo ($9.02 in chips) 
atticus1401: posts small blind $0.05
Daurado: posts big blind $0.10
*** HOLE CARDS ***
Impostore1988: raises $0.10 to $0.20
stboyo: folds 
atticus1401: raises $0.10 to $0.30
Daurado: folds 
Impostore1988: calls $0.10
*** FLOP *** [8d Qc 5h]
atticus1401: bets $0.67
Impostore1988: folds 
Uncalled bet ($0.67) returned to atticus1401
atticus1401 collected $0.67 from pot
atticus1401: doesn't show hand 
*** SUMMARY ***
Total pot $0.70 | Rake $0.03 
Board [8d Qc 5h]
Seat 3: atticus1401 (small blind) collected ($0.67)
Seat 4: Daurado (big blind) folded before Flop
Seat 5: Impostore1988 folded on the Flop
Seat 6: stboyo (button) folded before Flop (didn't bet)



PokerStars Hand #222957957617:  Hold'em No Limit ($0.05/$0.10 USD) - 2021/01/23 10:58:04 ET
Table 'Stephano III' 6-max Seat #3 is the button
Seat 3: atticus1401 ($8.39 in chips) 
Seat 4: Daurado ($19.41 in chips) 
Seat 5: Impostore1988 ($9.70 in chips) 
Seat 6: stboyo ($9.02 in chips) 
Daurado: posts small blind $0.05
Impostore1988: posts big blind $0.10
SERG244: sits out 
*** HOLE CARDS ***
stboyo: raises $0.10 to $0.20
atticus1401: folds 
Daurado: folds 
Impostore1988: folds 
Uncalled bet ($0.10) returned to stboyo
stboyo collected $0.25 from pot
stboyo: doesn't show hand 
*** SUMMARY ***
Total pot $0.25 | Rake $0 
Seat 3: atticus1401 (button) folded before Flop (didn't bet)
Seat 4: Daurado (small blind) folded before Flop
Seat 5: Impostore1988 (big blind) folded before Flop
Seat 6: stboyo collected ($0.25)



PokerStars Hand #222957961781:  Hold'em No Limit ($0.05/$0.10 USD) - 2021/01/23 10:58:13 ET
Table 'Stephano III' 6-max Seat #4 is the button
Seat 3: atticus1401 ($8.39 in chips) 
Seat 4: Daurado ($19.36 in chips) 
Seat 5: Impostore1988 ($9.60 in chips) 
Seat 6: stboyo ($9.17 in chips) 
Impostore1988: posts small blind $0.05
stboyo: posts big blind $0.10
SERG244: sits out 
*** HOLE CARDS ***
atticus1401: folds 
Daurado: raises $0.15 to $0.25
Impostore1988: folds 
stboyo: folds 
Uncalled bet ($0.15) returned to Daurado
Daurado collected $0.25 from pot
Daurado: doesn't show hand 
*** SUMMARY ***
Total pot $0.25 | Rake $0 
Seat 3: atticus1401 folded before Flop (didn't bet)
Seat 4: Daurado (button) collected ($0.25)
Seat 5: Impostore1988 (small blind) folded before Flop
Seat 6: stboyo (big blind) folded before Flop



PokerStars Hand #222957967758:  Hold'em No Limit ($0.05/$0.10 USD) - 2021/01/23 10:58:27 ET
Table 'Stephano III' 6-max Seat #5 is the button
Seat 1: Intimitatem ($14.71 in chips) 
Seat 3: atticus1401 ($8.39 in chips) 
Seat 4: Daurado ($19.51 in chips) 
Seat 5: Impostore1988 ($9.55 in chips) 
Seat 6: stboyo ($9.07 in chips) 
stboyo: posts small blind $0.05
Intimitatem: posts big blind $0.10
SERG244: sits out 
*** HOLE CARDS ***
atticus1401: raises $0.20 to $0.30
Daurado: folds 
Impostore1988: folds 
stboyo: folds 
Intimitatem: folds 
Uncalled bet ($0.20) returned to atticus1401
atticus1401 collected $0.25 from pot
atticus1401: doesn't show hand 
*** SUMMARY ***
Total pot $0.25 | Rake $0 
Seat 1: Intimitatem (big blind) folded before Flop
Seat 3: atticus1401 collected ($0.25)
Seat 4: Daurado folded before Flop (didn't bet)
Seat 5: Impostore1988 (button) folded before Flop (didn't bet)
Seat 6: stboyo (small blind) folded before Flop



PokerStars Hand #222957978224:  Hold'em No Limit ($0.05/$0.10 USD) - 2021/01/23 10:58:51 ET
Table 'Stephano III' 6-max Seat #6 is the button
Seat 1: Intimitatem ($14.61 in chips) 
Seat 2: SERG244 ($10 in chips) 
Seat 3: atticus1401 ($8.54 in chips) 
Seat 4: Daurado ($19.51 in chips) 
Seat 5: Impostore1988 ($9.55 in chips) 
Seat 6: stboyo ($9.02 in chips) 
Intimitatem: posts small blind $0.05
SERG244: posts big blind $0.10
*** HOLE CARDS ***
atticus1401: folds 
Daurado: folds 
Impostore1988: folds 
stboyo: calls $0.10
Intimitatem: folds 
SERG244: checks 
*** FLOP *** [2d 4d 8h]
SERG244: checks 
stboyo: bets $0.12
SERG244: folds 
Uncalled bet ($0.12) returned to stboyo
stboyo collected $0.24 from pot
stboyo: doesn't show hand 
*** SUMMARY ***
Total pot $0.25 | Rake $0.01 
Board [2d 4d 8h]
Seat 1: Intimitatem (small blind) folded before Flop
Seat 2: SERG244 (big blind) folded on the Flop
Seat 3: atticus1401 folded before Flop (didn't bet)
Seat 4: Daurado folded before Flop (didn't bet)
Seat 5: Impostore1988 folded before Flop (didn't bet)
Seat 6: stboyo (button) collected ($0.24)



PokerStars Hand #222957991505:  Hold'em No Limit ($0.05/$0.10 USD) - 2021/01/23 10:59:18 ET
Table 'Stephano III' 6-max Seat #1 is the button
Seat 1: Intimitatem ($14.56 in chips) 
Seat 2: SERG244 ($10 in chips) 
Seat 3: atticus1401 ($8.54 in chips) 
Seat 4: Daurado ($19.51 in chips) 
Seat 5: Impostore1988 ($9.55 in chips) 
Seat 6: stboyo ($9.16 in chips) 
SERG244: posts small blind $0.05
atticus1401: posts big blind $0.10
*** HOLE CARDS ***
Daurado: folds 
Impostore1988: folds 
stboyo: calls $0.10
Intimitatem: folds 
SERG244: folds 
atticus1401: checks 
*** FLOP *** [4s Jc Ks]
atticus1401: bets $0.24
stboyo: folds 
Uncalled bet ($0.24) returned to atticus1401
atticus1401 collected $0.24 from pot
atticus1401: doesn't show hand 
*** SUMMARY ***
Total pot $0.25 | Rake $0.01 
Board [4s Jc Ks]
Seat 1: Intimitatem (button) folded before Flop (didn't bet)
Seat 2: SERG244 (small blind) folded before Flop
Seat 3: atticus1401 (big blind) collected ($0.24)
Seat 4: Daurado folded before Flop (didn't bet)
Seat 5: Impostore1988 folded before Flop (didn't bet)
Seat 6: stboyo folded on the Flop



PokerStars Hand #222958005289:  Hold'em No Limit ($0.05/$0.10 USD) - 2021/01/23 10:59:50 ET
Table 'Stephano III' 6-max Seat #2 is the button
Seat 1: Intimitatem ($14.56 in chips) 
Seat 2: SERG244 ($10 in chips) 
Seat 3: atticus1401 ($8.68 in chips) 
Seat 4: Daurado ($19.51 in chips) 
Seat 5: Impostore1988 ($9.55 in chips) 
Seat 6: stboyo ($9.06 in chips) 
atticus1401: posts small blind $0.05
Daurado: posts big blind $0.10
*** HOLE CARDS ***
Impostore1988: folds 
stboyo: calls $0.10
Intimitatem: folds 
SERG244: folds 
atticus1401: calls $0.05
Daurado: raises $0.40 to $0.50
stboyo: folds 
atticus1401: folds 
Uncalled bet ($0.40) returned to Daurado
Daurado collected $0.30 from pot
Daurado: doesn't show hand 
*** SUMMARY ***
Total pot $0.30 | Rake $0 
Seat 1: Intimitatem folded before Flop (didn't bet)
Seat 2: SERG244 (button) folded before Flop (didn't bet)
Seat 3: atticus1401 (small blind) folded before Flop
Seat 4: Daurado (big blind) collected ($0.30)
Seat 5: Impostore1988 folded before Flop (didn't bet)
Seat 6: stboyo folded before Flop



PokerStars Hand #222958015316:  Hold'em No Limit ($0.05/$0.10 USD) - 2021/01/23 11:00:12 ET
Table 'Stephano III' 6-max Seat #3 is the button
Seat 1: Intimitatem ($14.56 in chips) 
Seat 2: SERG244 ($10 in chips) 
Seat 3: atticus1401 ($8.58 in chips) 
Seat 4: Daurado ($19.71 in chips) 
Seat 5: Impostore1988 ($9.55 in chips) 
Seat 6: stboyo ($8.96 in chips) 
Daurado: posts small blind $0.05
Impostore1988: posts big blind $0.10
*** HOLE CARDS ***
stboyo: folds 
Intimitatem: folds 
SERG244: folds 
atticus1401: folds 
Daurado: folds 
Uncalled bet ($0.05) returned to Impostore1988
Impostore1988 collected $0.10 from pot
Impostore1988: doesn't show hand 
*** SUMMARY ***
Total pot $0.10 | Rake $0 
Seat 1: Intimitatem folded before Flop (didn't bet)
Seat 2: SERG244 folded before Flop (didn't bet)
Seat 3: atticus1401 (button) folded before Flop (didn't bet)
Seat 4: Daurado (small blind) folded before Flop
Seat 5: Impostore1988 (big blind) collected ($0.10)
Seat 6: stboyo folded before Flop (didn't bet)



PokerStars Hand #222958019909:  Hold'em No Limit ($0.05/$0.10 USD) - 2021/01/23 11:00:22 ET
Table 'Stephano III' 6-max Seat #4 is the button
Seat 1: Intimitatem ($14.56 in chips) 
Seat 2: SERG244 ($10 in chips) 
Seat 3: atticus1401 ($8.58 in chips) 
Seat 4: Daurado ($19.66 in chips) 
Seat 5: Impostore1988 ($9.60 in chips) 
Seat 6: stboyo ($8.96 in chips) 
Impostore1988: posts small blind $0.05
stboyo: posts big blind $0.10
*** HOLE CARDS ***
Intimitatem: folds 
SERG244: folds 
atticus1401: folds 
Daurado: folds 
Impostore1988: folds 
Uncalled bet ($0.05) returned to stboyo
stboyo collected $0.10 from pot
stboyo: doesn't show hand 
*** SUMMARY ***
Total pot $0.10 | Rake $0 
Seat 1: Intimitatem folded before Flop (didn't bet)
Seat 2: SERG244 folded before Flop (didn't bet)
Seat 3: atticus1401 folded before Flop (didn't bet)
Seat 4: Daurado (button) folded before Flop (didn't bet)
Seat 5: Impostore1988 (small blind) folded before Flop
Seat 6: stboyo (big blind) collected ($0.10)



PokerStars Hand #222958025890:  Hold'em No Limit ($0.05/$0.10 USD) - 2021/01/23 11:00:35 ET
Table 'Stephano III' 6-max Seat #5 is the button
Seat 1: Intimitatem ($14.56 in chips) 
Seat 2: SERG244 ($10 in chips) 
Seat 3: atticus1401 ($8.58 in chips) 
Seat 4: Daurado ($19.66 in chips) 
Seat 5: Impostore1988 ($9.55 in chips) 
Seat 6: stboyo ($9.01 in chips) 
stboyo: posts small blind $0.05
Intimitatem: posts big blind $0.10
*** HOLE CARDS ***
SERG244: folds 
atticus1401: raises $0.20 to $0.30
Daurado: folds 
Impostore1988: folds 
stboyo: folds 
Intimitatem: folds 
Uncalled bet ($0.20) returned to atticus1401
atticus1401 collected $0.25 from pot
atticus1401: doesn't show hand 
*** SUMMARY ***
Total pot $0.25 | Rake $0 
Seat 1: Intimitatem (big blind) folded before Flop
Seat 2: SERG244 folded before Flop (didn't bet)
Seat 3: atticus1401 collected ($0.25)
Seat 4: Daurado folded before Flop (didn't bet)
Seat 5: Impostore1988 (button) folded before Flop (didn't bet)
Seat 6: stboyo (small blind) folded before Flop



PokerStars Hand #222958033912:  Hold'em No Limit ($0.05/$0.10 USD) - 2021/01/23 11:00:52 ET
Table 'Stephano III' 6-max Seat #6 is the button
Seat 1: Intimitatem ($14.46 in chips) 
Seat 2: SERG244 ($10 in chips) 
Seat 3: atticus1401 ($8.73 in chips) 
Seat 4: Daurado ($19.66 in chips) 
Seat 5: Impostore1988 ($9.55 in chips) 
Seat 6: stboyo ($8.96 in chips) 
Intimitatem: posts small blind $0.05
SERG244: posts big blind $0.10
*** HOLE CARDS ***
atticus1401: folds 
Daurado: folds 
Impostore1988: folds 
stboyo: folds 
Intimitatem: folds 
Uncalled bet ($0.05) returned to SERG244
SERG244 collected $0.10 from pot
SERG244: doesn't show hand 
*** SUMMARY ***
Total pot $0.10 | Rake $0 
Seat 1: Intimitatem (small blind) folded before Flop
Seat 2: SERG244 (big blind) collected ($0.10)
Seat 3: atticus1401 folded before Flop (didn't bet)
Seat 4: Daurado folded before Flop (didn't bet)
Seat 5: Impostore1988 folded before Flop (didn't bet)
Seat 6: stboyo (button) folded before Flop (didn't bet)



PokerStars Hand #222958039620:  Hold'em No Limit ($0.05/$0.10 USD) - 2021/01/23 11:01:04 ET
Table 'Stephano III' 6-max Seat #1 is the button
Seat 1: Intimitatem ($14.41 in chips) 
Seat 2: SERG244 ($10.05 in chips) 
Seat 3: atticus1401 ($8.73 in chips) 
Seat 4: Daurado ($19.66 in chips) 
Seat 5: Impostore1988 ($9.55 in chips) 
Seat 6: stboyo ($8.96 in chips) 
SERG244: posts small blind $0.05
atticus1401: posts big blind $0.10
*** HOLE CARDS ***
Daurado: folds 
Impostore1988: folds 
stboyo: folds 
Intimitatem: folds 
SERG244: raises $0.16 to $0.26
atticus1401: calls $0.16
*** FLOP *** [Tc 4h Jh]
SERG244: checks 
atticus1401: bets $0.25
SERG244: calls $0.25
*** TURN *** [Tc 4h Jh] [Ts]
SERG244: checks 
atticus1401: bets $0.49
SERG244: calls $0.49
*** RIVER *** [Tc 4h Jh Ts] [9h]
SERG244: checks 
atticus1401: checks 
*** SHOW DOWN ***
SERG244: shows [Td 7d] (three of a kind, Tens)
atticus1401: mucks hand 
SERG244 collected $1.91 from pot
*** SUMMARY ***
Total pot $2 | Rake $0.09 
Board [Tc 4h Jh Ts 9h]
Seat 1: Intimitatem (button) folded before Flop (didn't bet)
Seat 2: SERG244 (small blind) showed [Td 7d] and won ($1.91) with three of a kind, Tens
Seat 3: atticus1401 (big blind) mucked
Seat 4: Daurado folded before Flop (didn't bet)
Seat 5: Impostore1988 folded before Flop (didn't bet)
Seat 6: stboyo folded before Flop (didn't bet)



PokerStars Hand #222958067333:  Hold'em No Limit ($0.05/$0.10 USD) - 2021/01/23 11:01:56 ET
Table 'Stephano III' 6-max Seat #2 is the button
Seat 1: Intimitatem ($14.41 in chips) 
Seat 2: SERG244 ($10.96 in chips) 
Seat 3: atticus1401 ($7.73 in chips) 
Seat 4: Daurado ($19.66 in chips) 
Seat 5: Impostore1988 ($9.55 in chips) 
Seat 6: stboyo ($8.96 in chips) 
atticus1401: posts small blind $0.05
Daurado: posts big blind $0.10
*** HOLE CARDS ***
Impostore1988: folds 
stboyo: calls $0.10
Intimitatem: folds 
SERG244: folds 
atticus1401: calls $0.05
Daurado: raises $0.40 to $0.50
stboyo: folds 
atticus1401: folds 
Uncalled bet ($0.40) returned to Daurado
Daurado collected $0.30 from pot
Daurado: doesn't show hand 
*** SUMMARY ***
Total pot $0.30 | Rake $0 
Seat 1: Intimitatem folded before Flop (didn't bet)
Seat 2: SERG244 (button) folded before Flop (didn't bet)
Seat 3: atticus1401 (small blind) folded before Flop
Seat 4: Daurado (big blind) collected ($0.30)
Seat 5: Impostore1988 folded before Flop (didn't bet)
Seat 6: stboyo folded before Flop



PokerStars Hand #222958080723:  Hold'em No Limit ($0.05/$0.10 USD) - 2021/01/23 11:02:21 ET
Table 'Stephano III' 6-max Seat #3 is the button
Seat 1: Intimitatem ($14.41 in chips) 
Seat 2: SERG244 ($10.96 in chips) 
Seat 3: atticus1401 ($7.63 in chips) 
Seat 4: Daurado ($19.86 in chips) 
Seat 5: Impostore1988 ($9.55 in chips) 
Seat 6: stboyo ($8.86 in chips) 
Daurado: posts small blind $0.05
Impostore1988: posts big blind $0.10
*** HOLE CARDS ***
stboyo: folds 
Intimitatem: folds 
SERG244: raises $0.16 to $0.26
atticus1401: folds 
Daurado: folds 
Impostore1988: folds 
Uncalled bet ($0.16) returned to SERG244
SERG244 collected $0.25 from pot
SERG244: doesn't show hand 
*** SUMMARY ***
Total pot $0.25 | Rake $0 
Seat 1: Intimitatem folded before Flop (didn't bet)
Seat 2: SERG244 collected ($0.25)
Seat 3: atticus1401 (button) folded before Flop (didn't bet)
Seat 4: Daurado (small blind) folded before Flop
Seat 5: Impostore1988 (big blind) folded before Flop
Seat 6: stboyo folded before Flop (didn't bet)



PokerStars Hand #222958087621:  Hold'em No Limit ($0.05/$0.10 USD) - 2021/01/23 11:02:35 ET
Table 'Stephano III' 6-max Seat #4 is the button
Seat 1: Intimitatem ($14.41 in chips) 
Seat 2: SERG244 ($11.11 in chips) 
Seat 3: atticus1401 ($7.63 in chips) 
Seat 4: Daurado ($19.81 in chips) 
Seat 5: Impostore1988 ($9.45 in chips) 
Seat 6: stboyo ($8.86 in chips) 
Impostore1988: posts small blind $0.05
stboyo: posts big blind $0.10
*** HOLE CARDS ***
Intimitatem: folds 
SERG244: raises $0.16 to $0.26
atticus1401: folds 
Daurado: folds 
Impostore1988: folds 
stboyo: folds 
Uncalled bet ($0.16) returned to SERG244
SERG244 collected $0.25 from pot
SERG244: doesn't show hand 
*** SUMMARY ***
Total pot $0.25 | Rake $0 
Seat 1: Intimitatem folded before Flop (didn't bet)
Seat 2: SERG244 collected ($0.25)
Seat 3: atticus1401 folded before Flop (didn't bet)
Seat 4: Daurado (button) folded before Flop (didn't bet)
Seat 5: Impostore1988 (small blind) folded before Flop
Seat 6: stboyo (big blind) folded before Flop



PokerStars Hand #222958100036:  Hold'em No Limit ($0.05/$0.10 USD) - 2021/01/23 11:02:57 ET
Table 'Stephano III' 6-max Seat #5 is the button
Seat 1: Intimitatem ($14.41 in chips) 
Seat 2: SERG244 ($11.26 in chips) 
Seat 3: atticus1401 ($7.63 in chips) 
Seat 4: Daurado ($19.81 in chips) 
Seat 5: Impostore1988 ($9.40 in chips) 
Seat 6: stboyo ($8.76 in chips) 
stboyo: posts small blind $0.05
Intimitatem: posts big blind $0.10
*** HOLE CARDS ***
SERG244: folds 
atticus1401: calls $0.10
Daurado: folds 
Impostore1988: folds 
stboyo: calls $0.05
Intimitatem: checks 
*** FLOP *** [6h 4h Ks]
stboyo: bets $0.14
Intimitatem: folds 
atticus1401: calls $0.14
*** TURN *** [6h 4h Ks] [2c]
stboyo: bets $0.27
atticus1401: calls $0.27
*** RIVER *** [6h 4h Ks 2c] [2h]
stboyo: bets $0.53
atticus1401: raises $0.53 to $1.06
stboyo: folds 
Uncalled bet ($0.53) returned to atticus1401
atticus1401 collected $2.08 from pot
atticus1401: doesn't show hand 
*** SUMMARY ***
Total pot $2.18 | Rake $0.10 
Board [6h 4h Ks 2c 2h]
Seat 1: Intimitatem (big blind) folded on the Flop
Seat 2: SERG244 folded before Flop (didn't bet)
Seat 3: atticus1401 collected ($2.08)
Seat 4: Daurado folded before Flop (didn't bet)
Seat 5: Impostore1988 (button) folded before Flop (didn't bet)
Seat 6: stboyo (small blind) folded on the River



PokerStars Hand #222958134799:  Hold'em No Limit ($0.05/$0.10 USD) - 2021/01/23 11:03:56 ET
Table 'Stephano III' 6-max Seat #6 is the button
Seat 1: Intimitatem ($14.31 in chips) 
Seat 2: SERG244 ($11.26 in chips) 
Seat 3: atticus1401 ($8.67 in chips) 
Seat 4: Daurado ($19.81 in chips) 
Seat 5: Impostore1988 ($9.40 in chips) 
Seat 6: stboyo ($7.72 in chips) 
Intimitatem: posts small blind $0.05
SERG244: posts big blind $0.10
*** HOLE CARDS ***
atticus1401: calls $0.10
Daurado: folds 
Impostore1988: folds 
stboyo: calls $0.10
Intimitatem: folds 
SERG244: checks 
*** FLOP *** [6c Ts Qc]
SERG244: checks 
atticus1401: checks 
stboyo: checks 
*** TURN *** [6c Ts Qc] [Td]
SERG244: checks 
atticus1401: bets $0.33
stboyo: folds 
SERG244: folds 
Uncalled bet ($0.33) returned to atticus1401
atticus1401 collected $0.33 from pot
atticus1401: doesn't show hand 
*** SUMMARY ***
Total pot $0.35 | Rake $0.02 
Board [6c Ts Qc Td]
Seat 1: Intimitatem (small blind) folded before Flop
Seat 2: SERG244 (big blind) folded on the Turn
Seat 3: atticus1401 collected ($0.33)
Seat 4: Daurado folded before Flop (didn't bet)
Seat 5: Impostore1988 folded before Flop (didn't bet)
Seat 6: stboyo (button) folded on the Turn



PokerStars Hand #222958161628:  Hold'em No Limit ($0.05/$0.10 USD) - 2021/01/23 11:04:43 ET
Table 'Stephano III' 6-max Seat #1 is the button
Seat 1: Intimitatem ($14.26 in chips) 
Seat 2: SERG244 ($11.16 in chips) 
Seat 3: atticus1401 ($8.90 in chips) 
Seat 4: Daurado ($19.81 in chips) 
Seat 5: Impostore1988 ($9.40 in chips) 
Seat 6: stboyo ($7.62 in chips) 
SERG244: posts small blind $0.05
atticus1401: posts big blind $0.10
*** HOLE CARDS ***
Daurado: folds 
Impostore1988: raises $0.10 to $0.20
stboyo: folds 
Intimitatem: calls $0.20
SERG244: folds 
atticus1401: calls $0.10
*** FLOP *** [Qc 9h Qh]
atticus1401: checks 
Impostore1988: checks 
Intimitatem: checks 
*** TURN *** [Qc 9h Qh] [2h]
atticus1401: checks 
Impostore1988: checks 
Intimitatem: checks 
*** RIVER *** [Qc 9h Qh 2h] [5h]
atticus1401: checks 
Impostore1988: checks 
Intimitatem: checks 
*** SHOW DOWN ***
atticus1401: shows [8s As] (a pair of Queens)
Impostore1988: shows [Ad Js] (a pair of Queens - Ace+Jack kicker)
Intimitatem: mucks hand 
Impostore1988 collected $0.62 from pot
*** SUMMARY ***
Total pot $0.65 | Rake $0.03 
Board [Qc 9h Qh 2h 5h]
Seat 1: Intimitatem (button) mucked
Seat 2: SERG244 (small blind) folded before Flop
Seat 3: atticus1401 (big blind) showed [8s As] and lost with a pair of Queens
Seat 4: Daurado folded before Flop (didn't bet)
Seat 5: Impostore1988 showed [Ad Js] and won ($0.62) with a pair of Queens
Seat 6: stboyo folded before Flop (didn't bet)



PokerStars Hand #222958199609:  Hold'em No Limit ($0.05/$0.10 USD) - 2021/01/23 11:05:48 ET
Table 'Stephano III' 6-max Seat #2 is the button
Seat 1: Intimitatem ($14.06 in chips) 
Seat 2: SERG244 ($11.11 in chips) 
Seat 3: atticus1401 ($8.70 in chips) 
Seat 4: Daurado ($19.81 in chips) 
Seat 5: Impostore1988 ($9.82 in chips) 
Seat 6: stboyo ($7.62 in chips) 
atticus1401: posts small blind $0.05
Daurado: posts big blind $0.10
*** HOLE CARDS ***
Impostore1988: folds 
stboyo: folds 
Intimitatem: folds 
SERG244: folds 
atticus1401: calls $0.05
Daurado: checks 
*** FLOP *** [7h As 9h]
atticus1401: bets $0.19
Daurado: calls $0.19
*** TURN *** [7h As 9h] [Td]
atticus1401: checks 
Daurado: checks 
*** RIVER *** [7h As 9h Td] [5d]
atticus1401: bets $0.28
Daurado: calls $0.28
*** SHOW DOWN ***
atticus1401: shows [Ad 2d] (a pair of Aces)
Daurado: shows [9s 5s] (two pair, Nines and Fives)
Daurado collected $1.09 from pot
*** SUMMARY ***
Total pot $1.14 | Rake $0.05 
Board [7h As 9h Td 5d]
Seat 1: Intimitatem folded before Flop (didn't bet)
Seat 2: SERG244 (button) folded before Flop (didn't bet)
Seat 3: atticus1401 (small blind) showed [Ad 2d] and lost with a pair of Aces
Seat 4: Daurado (big blind) showed [9s 5s] and won ($1.09) with two pair, Nines and Fives
Seat 5: Impostore1988 folded before Flop (didn't bet)
Seat 6: stboyo folded before Flop (didn't bet)



PokerStars Hand #222958225585:  Hold'em No Limit ($0.05/$0.10 USD) - 2021/01/23 11:06:32 ET
Table 'Stephano III' 6-max Seat #3 is the button
Seat 1: Intimitatem ($14.06 in chips) 
Seat 2: SERG244 ($11.11 in chips) 
Seat 3: atticus1401 ($8.13 in chips) 
Seat 4: Daurado ($20.33 in chips) 
Seat 5: Impostore1988 ($9.82 in chips) 
Seat 6: stboyo ($7.62 in chips) 
Daurado: posts small blind $0.05
Impostore1988: posts big blind $0.10
*** HOLE CARDS ***
stboyo: folds 
Intimitatem: folds 
SERG244: folds 
atticus1401: folds 
Daurado: folds 
Uncalled bet ($0.05) returned to Impostore1988
Impostore1988 collected $0.10 from pot
Impostore1988: doesn't show hand 
*** SUMMARY ***
Total pot $0.10 | Rake $0 
Seat 1: Intimitatem folded before Flop (didn't bet)
Seat 2: SERG244 folded before Flop (didn't bet)
Seat 3: atticus1401 (button) folded before Flop (didn't bet)
Seat 4: Daurado (small blind) folded before Flop
Seat 5: Impostore1988 (big blind) collected ($0.10)
Seat 6: stboyo folded before Flop (didn't bet)



PokerStars Hand #222958232110:  Hold'em No Limit ($0.05/$0.10 USD) - 2021/01/23 11:06:43 ET
Table 'Stephano III' 6-max Seat #4 is the button
Seat 1: Intimitatem ($14.06 in chips) 
Seat 2: SERG244 ($11.11 in chips) 
Seat 3: atticus1401 ($8.13 in chips) 
Seat 4: Daurado ($20.28 in chips) 
Seat 5: Impostore1988 ($9.87 in chips) 
Seat 6: stboyo ($7.62 in chips) 
Impostore1988: posts small blind $0.05
stboyo: posts big blind $0.10
*** HOLE CARDS ***
Intimitatem: folds 
SERG244: folds 
atticus1401: folds 
Daurado: folds 
Impostore1988: raises $0.20 to $0.30
stboyo: folds 
Uncalled bet ($0.20) returned to Impostore1988
Impostore1988 collected $0.20 from pot
Impostore1988: doesn't show hand 
*** SUMMARY ***
Total pot $0.20 | Rake $0 
Seat 1: Intimitatem folded before Flop (didn't bet)
Seat 2: SERG244 folded before Flop (didn't bet)
Seat 3: atticus1401 folded before Flop (didn't bet)
Seat 4: Daurado (button) folded before Flop (didn't bet)
Seat 5: Impostore1988 (small blind) collected ($0.20)
Seat 6: stboyo (big blind) folded before Flop



PokerStars Hand #222958244599:  Hold'em No Limit ($0.05/$0.10 USD) - 2021/01/23 11:07:04 ET
Table 'Stephano III' 6-max Seat #5 is the button
Seat 1: Intimitatem ($14.06 in chips) 
Seat 2: SERG244 ($11.11 in chips) 
Seat 3: atticus1401 ($8.13 in chips) 
Seat 4: Daurado ($20.28 in chips) 
Seat 5: Impostore1988 ($9.97 in chips) 
Seat 6: stboyo ($7.52 in chips) 
stboyo: posts small blind $0.05
Intimitatem: posts big blind $0.10
*** HOLE CARDS ***
SERG244: folds 
atticus1401: folds 
Daurado: folds 
Impostore1988: raises $0.10 to $0.20
stboyo: folds 
Intimitatem: folds 
Uncalled bet ($0.10) returned to Impostore1988
Impostore1988 collected $0.25 from pot
Impostore1988: doesn't show hand 
*** SUMMARY ***
Total pot $0.25 | Rake $0 
Seat 1: Intimitatem (big blind) folded before Flop
Seat 2: SERG244 folded before Flop (didn't bet)
Seat 3: atticus1401 folded before Flop (didn't bet)
Seat 4: Daurado folded before Flop (didn't bet)
Seat 5: Impostore1988 (button) collected ($0.25)
Seat 6: stboyo (small blind) folded before Flop



PokerStars Hand #222958258546:  Hold'em No Limit ($0.05/$0.10 USD) - 2021/01/23 11:07:27 ET
Table 'Stephano III' 6-max Seat #6 is the button
Seat 1: Intimitatem ($13.96 in chips) 
Seat 2: SERG244 ($11.11 in chips) 
Seat 3: atticus1401 ($8.13 in chips) 
Seat 4: Daurado ($20.28 in chips) 
Seat 5: Impostore1988 ($10.12 in chips) 
Seat 6: stboyo ($7.47 in chips) 
Intimitatem: posts small blind $0.05
SERG244: posts big blind $0.10
*** HOLE CARDS ***
atticus1401: folds 
Daurado: folds 
Impostore1988: folds 
stboyo: folds 
Intimitatem: folds 
Uncalled bet ($0.05) returned to SERG244
SERG244 collected $0.10 from pot
SERG244: doesn't show hand 
*** SUMMARY ***
Total pot $0.10 | Rake $0 
Seat 1: Intimitatem (small blind) folded before Flop
Seat 2: SERG244 (big blind) collected ($0.10)
Seat 3: atticus1401 folded before Flop (didn't bet)
Seat 4: Daurado folded before Flop (didn't bet)
Seat 5: Impostore1988 folded before Flop (didn't bet)
Seat 6: stboyo (button) folded before Flop (didn't bet)



PokerStars Hand #222958264999:  Hold'em No Limit ($0.05/$0.10 USD) - 2021/01/23 11:07:38 ET
Table 'Stephano III' 6-max Seat #1 is the button
Seat 1: Intimitatem ($13.91 in chips) 
Seat 2: SERG244 ($11.16 in chips) 
Seat 3: atticus1401 ($8.13 in chips) 
Seat 4: Daurado ($20.28 in chips) 
Seat 5: Impostore1988 ($10.12 in chips) 
Seat 6: stboyo ($7.47 in chips) 
SERG244: posts small blind $0.05
atticus1401: posts big blind $0.10
*** HOLE CARDS ***
Daurado: raises $0.20 to $0.30
Impostore1988: folds 
stboyo: folds 
Intimitatem: folds 
SERG244: folds 
atticus1401: folds 
Uncalled bet ($0.20) returned to Daurado
Daurado collected $0.25 from pot
Daurado: doesn't show hand 
*** SUMMARY ***
Total pot $0.25 | Rake $0 
Seat 1: Intimitatem (button) folded before Flop (didn't bet)
Seat 2: SERG244 (small blind) folded before Flop
Seat 3: atticus1401 (big blind) folded before Flop
Seat 4: Daurado collected ($0.25)
Seat 5: Impostore1988 folded before Flop (didn't bet)
Seat 6: stboyo folded before Flop (didn't bet)



PokerStars Hand #222958273736:  Hold'em No Limit ($0.05/$0.10 USD) - 2021/01/23 11:07:53 ET
Table 'Stephano III' 6-max Seat #2 is the button
Seat 1: Intimitatem ($13.91 in chips) 
Seat 2: SERG244 ($11.11 in chips) 
Seat 3: atticus1401 ($8.03 in chips) 
Seat 4: Daurado ($20.43 in chips) 
Seat 5: Impostore1988 ($10.12 in chips) 
Seat 6: stboyo ($7.47 in chips) 
atticus1401: posts small blind $0.05
Daurado: posts big blind $0.10
*** HOLE CARDS ***
Impostore1988: folds 
stboyo: calls $0.10
Intimitatem: raises $0.30 to $0.40
SERG244: folds 
atticus1401: folds 
Daurado: folds 
stboyo: calls $0.30
*** FLOP *** [As 9h 6c]
stboyo: bets $0.35
Intimitatem: folds 
Uncalled bet ($0.35) returned to stboyo
stboyo collected $0.91 from pot
stboyo: doesn't show hand 
*** SUMMARY ***
Total pot $0.95 | Rake $0.04 
Board [As 9h 6c]
Seat 1: Intimitatem folded on the Flop
Seat 2: SERG244 (button) folded before Flop (didn't bet)
Seat 3: atticus1401 (small blind) folded before Flop
Seat 4: Daurado (big blind) folded before Flop
Seat 5: Impostore1988 folded before Flop (didn't bet)
Seat 6: stboyo collected ($0.91)



PokerStars Hand #222958293515:  Hold'em No Limit ($0.05/$0.10 USD) - 2021/01/23 11:08:26 ET
Table 'Stephano III' 6-max Seat #3 is the button
Seat 1: Intimitatem ($13.51 in chips) 
Seat 2: SERG244 ($11.11 in chips) 
Seat 3: atticus1401 ($7.98 in chips) 
Seat 4: Daurado ($20.33 in chips) 
Seat 5: Impostore1988 ($10.12 in chips) 
Seat 6: stboyo ($7.98 in chips) 
Daurado: posts small blind $0.05
Impostore1988: posts big blind $0.10
*** HOLE CARDS ***
stboyo: folds 
Intimitatem: raises $0.12 to $0.22
SERG244: folds 
atticus1401: folds 
Daurado: folds 
Impostore1988: folds 
Uncalled bet ($0.12) returned to Intimitatem
Intimitatem collected $0.25 from pot
Intimitatem: doesn't show hand 
*** SUMMARY ***
Total pot $0.25 | Rake $0 
Seat 1: Intimitatem collected ($0.25)
Seat 2: SERG244 folded before Flop (didn't bet)
Seat 3: atticus1401 (button) folded before Flop (didn't bet)
Seat 4: Daurado (small blind) folded before Flop
Seat 5: Impostore1988 (big blind) folded before Flop
Seat 6: stboyo folded before Flop (didn't bet)



PokerStars Hand #222958303425:  Hold'em No Limit ($0.05/$0.10 USD) - 2021/01/23 11:08:42 ET
Table 'Stephano III' 6-max Seat #4 is the button
Seat 1: Intimitatem ($13.66 in chips) 
Seat 2: SERG244 ($11.11 in chips) 
Seat 3: atticus1401 ($7.98 in chips) 
Seat 4: Daurado ($20.28 in chips) 
Seat 5: Impostore1988 ($10.02 in chips) 
Seat 6: stboyo ($7.98 in chips) 
Impostore1988: posts small blind $0.05
stboyo: posts big blind $0.10
*** HOLE CARDS ***
Intimitatem: folds 
SERG244: raises $0.16 to $0.26
atticus1401: folds 
Daurado: folds 
Impostore1988: folds 
stboyo: folds 
Uncalled bet ($0.16) returned to SERG244
SERG244 collected $0.25 from pot
SERG244: doesn't show hand 
*** SUMMARY ***
Total pot $0.25 | Rake $0 
Seat 1: Intimitatem folded before Flop (didn't bet)
Seat 2: SERG244 collected ($0.25)
Seat 3: atticus1401 folded before Flop (didn't bet)
Seat 4: Daurado (button) folded before Flop (didn't bet)
Seat 5: Impostore1988 (small blind) folded before Flop
Seat 6: stboyo (big blind) folded before Flop



PokerStars Hand #222958315908:  Hold'em No Limit ($0.05/$0.10 USD) - 2021/01/23 11:09:03 ET
Table 'Stephano III' 6-max Seat #5 is the button
Seat 1: Intimitatem ($13.66 in chips) 
Seat 2: SERG244 ($11.26 in chips) 
Seat 3: atticus1401 ($7.98 in chips) 
Seat 4: Daurado ($20.28 in chips) 
Seat 5: Impostore1988 ($9.97 in chips) 
Seat 6: stboyo ($7.88 in chips) 
stboyo: posts small blind $0.05
Intimitatem: posts big blind $0.10
*** HOLE CARDS ***
SERG244: folds 
SERG244 leaves the table
atticus1401: folds 
Daurado: folds 
Impostore1988: folds 
stboyo: raises $0.10 to $0.20
Hollseg joins the table at seat #2 
Intimitatem: raises $0.45 to $0.65
stboyo: calls $0.45
*** FLOP *** [6c 8s 7c]
stboyo: checks 
Intimitatem: bets $0.83
stboyo: folds 
Uncalled bet ($0.83) returned to Intimitatem
Intimitatem collected $1.24 from pot
Intimitatem: doesn't show hand 
*** SUMMARY ***
Total pot $1.30 | Rake $0.06 
Board [6c 8s 7c]
Seat 1: Intimitatem (big blind) collected ($1.24)
Seat 2: SERG244 folded before Flop (didn't bet)
Seat 3: atticus1401 folded before Flop (didn't bet)
Seat 4: Daurado folded before Flop (didn't bet)
Seat 5: Impostore1988 (button) folded before Flop (didn't bet)
Seat 6: stboyo (small blind) folded on the Flop



PokerStars Hand #222958342710:  Hold'em No Limit ($0.05/$0.10 USD) - 2021/01/23 11:09:48 ET
Table 'Stephano III' 6-max Seat #6 is the button
Seat 1: Intimitatem ($14.25 in chips) 
Seat 2: Hollseg ($10.45 in chips) 
Seat 3: atticus1401 ($7.98 in chips) 
Seat 4: Daurado ($20.28 in chips) 
Seat 5: Impostore1988 ($9.97 in chips) 
Seat 6: stboyo ($7.23 in chips) 
Intimitatem: posts small blind $0.05
Hollseg: posts big blind $0.10
*** HOLE CARDS ***
atticus1401: folds 
Daurado: folds 
Impostore1988: raises $0.10 to $0.20
stboyo: folds 
Intimitatem: folds 
Hollseg: folds 
Uncalled bet ($0.10) returned to Impostore1988
Impostore1988 collected $0.25 from pot
Impostore1988: doesn't show hand 
*** SUMMARY ***
Total pot $0.25 | Rake $0 
Seat 1: Intimitatem (small blind) folded before Flop
Seat 2: Hollseg (big blind) folded before Flop
Seat 3: atticus1401 folded before Flop (didn't bet)
Seat 4: Daurado folded before Flop (didn't bet)
Seat 5: Impostore1988 collected ($0.25)
Seat 6: stboyo (button) folded before Flop (didn't bet)



PokerStars Hand #222958351634:  Hold'em No Limit ($0.05/$0.10 USD) - 2021/01/23 11:10:03 ET
Table 'Stephano III' 6-max Seat #1 is the button
Seat 1: Intimitatem ($14.20 in chips) 
Seat 2: Hollseg ($10.35 in chips) 
Seat 3: atticus1401 ($7.98 in chips) 
Seat 4: Daurado ($20.28 in chips) 
Seat 5: Impostore1988 ($10.12 in chips) 
Seat 6: stboyo ($7.23 in chips) 
Hollseg: posts small blind $0.05
atticus1401: posts big blind $0.10
*** HOLE CARDS ***
Daurado: raises $0.20 to $0.30
Impostore1988: folds 
stboyo: calls $0.30
Intimitatem: folds 
Hollseg: folds 
atticus1401: calls $0.20
*** FLOP *** [2h Td Th]
atticus1401: checks 
Daurado: checks 
stboyo: checks 
*** TURN *** [2h Td Th] [Qs]
atticus1401: bets $0.46
Daurado: folds 
stboyo: folds 
Uncalled bet ($0.46) returned to atticus1401
atticus1401 collected $0.91 from pot
atticus1401: doesn't show hand 
*** SUMMARY ***
Total pot $0.95 | Rake $0.04 
Board [2h Td Th Qs]
Seat 1: Intimitatem (button) folded before Flop (didn't bet)
Seat 2: Hollseg (small blind) folded before Flop
Seat 3: atticus1401 (big blind) collected ($0.91)
Seat 4: Daurado folded on the Turn
Seat 5: Impostore1988 folded before Flop (didn't bet)
Seat 6: stboyo folded on the Turn



PokerStars Hand #222958373964:  Hold'em No Limit ($0.05/$0.10 USD) - 2021/01/23 11:10:40 ET
Table 'Stephano III' 6-max Seat #2 is the button
Seat 1: Intimitatem ($14.20 in chips) 
Seat 2: Hollseg ($10.30 in chips) 
Seat 3: atticus1401 ($8.59 in chips) 
Seat 4: Daurado ($19.98 in chips) 
Seat 5: Impostore1988 ($10.12 in chips) 
Seat 6: stboyo ($6.93 in chips) 
atticus1401: posts small blind $0.05
Daurado: posts big blind $0.10
*** HOLE CARDS ***
Impostore1988: folds 
stboyo: folds 
Intimitatem: folds 
Hollseg: folds 
atticus1401: calls $0.05
Daurado: checks 
*** FLOP *** [Th Kc Kh]
atticus1401: checks 
Daurado: checks 
*** TURN *** [Th Kc Kh] [Ac]
atticus1401: bets $0.19
Daurado: folds 
Uncalled bet ($0.19) returned to atticus1401
atticus1401 collected $0.19 from pot
atticus1401: doesn't show hand 
*** SUMMARY ***
Total pot $0.20 | Rake $0.01 
Board [Th Kc Kh Ac]
Seat 1: Intimitatem folded before Flop (didn't bet)
Seat 2: Hollseg (button) folded before Flop (didn't bet)
Seat 3: atticus1401 (small blind) collected ($0.19)
Seat 4: Daurado (big blind) folded on the Turn
Seat 5: Impostore1988 folded before Flop (didn't bet)
Seat 6: stboyo folded before Flop (didn't bet)



PokerStars Hand #222958395544:  Hold'em No Limit ($0.05/$0.10 USD) - 2021/01/23 11:11:16 ET
Table 'Stephano III' 6-max Seat #3 is the button
Seat 1: Intimitatem ($14.20 in chips) 
Seat 2: Hollseg ($10.30 in chips) 
Seat 3: atticus1401 ($8.68 in chips) 
Seat 4: Daurado ($19.88 in chips) 
Seat 5: Impostore1988 ($10.12 in chips) 
Seat 6: stboyo ($6.93 in chips) 
Daurado: posts small blind $0.05
Impostore1988: posts big blind $0.10
*** HOLE CARDS ***
stboyo: raises $0.10 to $0.20
Intimitatem: folds 
Hollseg: folds 
atticus1401: folds 
Daurado: folds 
Impostore1988: folds 
Uncalled bet ($0.10) returned to stboyo
stboyo collected $0.25 from pot
stboyo: doesn't show hand 
*** SUMMARY ***
Total pot $0.25 | Rake $0 
Seat 1: Intimitatem folded before Flop (didn't bet)
Seat 2: Hollseg folded before Flop (didn't bet)
Seat 3: atticus1401 (button) folded before Flop (didn't bet)
Seat 4: Daurado (small blind) folded before Flop
Seat 5: Impostore1988 (big blind) folded before Flop
Seat 6: stboyo collected ($0.25)



PokerStars Hand #222958408534:  Hold'em No Limit ($0.05/$0.10 USD) - 2021/01/23 11:11:38 ET
Table 'Stephano III' 6-max Seat #4 is the button
Seat 1: Intimitatem ($14.20 in chips) 
Seat 2: Hollseg ($10.30 in chips) 
Seat 3: atticus1401 ($8.68 in chips) 
Seat 4: Daurado ($19.83 in chips) 
Seat 5: Impostore1988 ($10.02 in chips) 
Seat 6: stboyo ($7.08 in chips) 
Impostore1988: posts small blind $0.05
stboyo: posts big blind $0.10
*** HOLE CARDS ***
Intimitatem: folds 
Hollseg: raises $0.20 to $0.30
atticus1401: folds 
Daurado: folds 
Impostore1988: folds 
stboyo: calls $0.20
*** FLOP *** [4d 9d 9s]
stboyo: bets $0.31
Hollseg: calls $0.31
*** TURN *** [4d 9d 9s] [Ad]
stboyo: bets $0.60
Hollseg: calls $0.60
*** RIVER *** [4d 9d 9s Ad] [2c]
stboyo: bets $2.36
Hollseg: calls $2.36
*** SHOW DOWN ***
stboyo: shows [Js Ah] (two pair, Aces and Nines)
Hollseg: shows [Kc Ac] (two pair, Aces and Nines - King kicker)
Hollseg collected $6.87 from pot
*** SUMMARY ***
Total pot $7.19 | Rake $0.32 
Board [4d 9d 9s Ad 2c]
Seat 1: Intimitatem folded before Flop (didn't bet)
Seat 2: Hollseg showed [Kc Ac] and won ($6.87) with two pair, Aces and Nines
Seat 3: atticus1401 folded before Flop (didn't bet)
Seat 4: Daurado (button) folded before Flop (didn't bet)
Seat 5: Impostore1988 (small blind) folded before Flop
Seat 6: stboyo (big blind) showed [Js Ah] and lost with two pair, Aces and Nines



PokerStars Hand #222958432784:  Hold'em No Limit ($0.05/$0.10 USD) - 2021/01/23 11:12:18 ET
Table 'Stephano III' 6-max Seat #5 is the button
Seat 1: Intimitatem ($14.20 in chips) 
Seat 2: Hollseg ($13.60 in chips) 
Seat 3: atticus1401 ($8.68 in chips) 
Seat 4: Daurado ($19.83 in chips) 
Seat 5: Impostore1988 ($9.97 in chips) 
Seat 6: stboyo ($3.51 in chips) 
stboyo: posts small blind $0.05
Intimitatem: posts big blind $0.10
*** HOLE CARDS ***
Hollseg: folds 
atticus1401: folds 
Daurado: folds 
Impostore1988: folds 
stboyo: calls $0.05
Intimitatem: checks 
*** FLOP *** [6s 2d Jc]
stboyo: checks 
Intimitatem: checks 
*** TURN *** [6s 2d Jc] [4c]
stboyo: checks 
Intimitatem: checks 
*** RIVER *** [6s 2d Jc 4c] [3c]
stboyo: checks 
Intimitatem: checks 
*** SHOW DOWN ***
stboyo: shows [Ad Ks] (high card Ace)
Intimitatem: mucks hand 
stboyo collected $0.19 from pot
*** SUMMARY ***
Total pot $0.20 | Rake $0.01 
Board [6s 2d Jc 4c 3c]
Seat 1: Intimitatem (big blind) mucked
Seat 2: Hollseg folded before Flop (didn't bet)
Seat 3: atticus1401 folded before Flop (didn't bet)
Seat 4: Daurado folded before Flop (didn't bet)
Seat 5: Impostore1988 (button) folded before Flop (didn't bet)
Seat 6: stboyo (small blind) showed [Ad Ks] and won ($0.19) with high card Ace



PokerStars Hand #222958456712:  Hold'em No Limit ($0.05/$0.10 USD) - 2021/01/23 11:12:58 ET
Table 'Stephano III' 6-max Seat #6 is the button
Seat 1: Intimitatem ($14.10 in chips) 
Seat 2: Hollseg ($13.60 in chips) 
Seat 3: atticus1401 ($8.68 in chips) 
Seat 4: Daurado ($19.83 in chips) 
Seat 5: Impostore1988 ($9.97 in chips) 
Seat 6: stboyo ($3.60 in chips) 
Intimitatem: posts small blind $0.05
Hollseg: posts big blind $0.10
*** HOLE CARDS ***
atticus1401: folds 
Daurado: raises $0.20 to $0.30
Impostore1988: folds 
stboyo: folds 
Intimitatem: folds 
Hollseg: calls $0.20
*** FLOP *** [4h Ts 9d]
Hollseg: checks 
Daurado: bets $0.41
Hollseg: calls $0.41
*** TURN *** [4h Ts 9d] [Ks]
Hollseg: checks 
Daurado: checks 
*** RIVER *** [4h Ts 9d Ks] [3c]
Hollseg: checks 
Daurado: checks 
*** SHOW DOWN ***
Hollseg: shows [9c Qc] (a pair of Nines)
Daurado: shows [Ad Th] (a pair of Tens)
Daurado collected $1.40 from pot
*** SUMMARY ***
Total pot $1.47 | Rake $0.07 
Board [4h Ts 9d Ks 3c]
Seat 1: Intimitatem (small blind) folded before Flop
Seat 2: Hollseg (big blind) showed [9c Qc] and lost with a pair of Nines
Seat 3: atticus1401 folded before Flop (didn't bet)
Seat 4: Daurado showed [Ad Th] and won ($1.40) with a pair of Tens
Seat 5: Impostore1988 folded before Flop (didn't bet)
Seat 6: stboyo (button) folded before Flop (didn't bet)



PokerStars Hand #222958494758:  Hold'em No Limit ($0.05/$0.10 USD) - 2021/01/23 11:13:53 ET
Table 'Stephano III' 6-max Seat #1 is the button
Seat 1: Intimitatem ($14.05 in chips) 
Seat 2: Hollseg ($12.89 in chips) 
Seat 3: atticus1401 ($8.68 in chips) 
Seat 4: Daurado ($20.52 in chips) 
Seat 5: Impostore1988 ($9.97 in chips) 
Seat 6: stboyo ($3.60 in chips) 
Hollseg: posts small blind $0.05
atticus1401: posts big blind $0.10
*** HOLE CARDS ***
Daurado: folds 
Impostore1988: folds 
stboyo: calls $0.10
Intimitatem: folds 
Hollseg: raises $0.40 to $0.50
atticus1401: raises $0.40 to $0.90
stboyo: folds 
Hollseg: calls $0.40
*** FLOP *** [6d 7c 3s]
Hollseg: checks 
atticus1401: bets $0.91
Hollseg: folds 
Uncalled bet ($0.91) returned to atticus1401
atticus1401 collected $1.81 from pot
atticus1401: doesn't show hand 
*** SUMMARY ***
Total pot $1.90 | Rake $0.09 
Board [6d 7c 3s]
Seat 1: Intimitatem (button) folded before Flop (didn't bet)
Seat 2: Hollseg (small blind) folded on the Flop
Seat 3: atticus1401 (big blind) collected ($1.81)
Seat 4: Daurado folded before Flop (didn't bet)
Seat 5: Impostore1988 folded before Flop (didn't bet)
Seat 6: stboyo folded before Flop



PokerStars Hand #222958532515:  Hold'em No Limit ($0.05/$0.10 USD) - 2021/01/23 11:14:56 ET
Table 'Stephano III' 6-max Seat #2 is the button
Seat 1: Intimitatem ($14.05 in chips) 
Seat 2: Hollseg ($11.99 in chips) 
Seat 3: atticus1401 ($9.59 in chips) 
Seat 4: Daurado ($20.52 in chips) 
Seat 5: Impostore1988 ($9.97 in chips) 
Seat 6: stboyo ($3.50 in chips) 
atticus1401: posts small blind $0.05
Daurado: posts big blind $0.10
*** HOLE CARDS ***
Impostore1988: folds 
stboyo: folds 
Intimitatem: folds 
Hollseg: folds 
atticus1401: calls $0.05
Daurado: checks 
*** FLOP *** [2s 9c 4h]
atticus1401: bets $0.19
Daurado: folds 
Uncalled bet ($0.19) returned to atticus1401
atticus1401 collected $0.19 from pot
atticus1401: doesn't show hand 
*** SUMMARY ***
Total pot $0.20 | Rake $0.01 
Board [2s 9c 4h]
Seat 1: Intimitatem folded before Flop (didn't bet)
Seat 2: Hollseg (button) folded before Flop (didn't bet)
Seat 3: atticus1401 (small blind) collected ($0.19)
Seat 4: Daurado (big blind) folded on the Flop
Seat 5: Impostore1988 folded before Flop (didn't bet)
Seat 6: stboyo folded before Flop (didn't bet)



PokerStars Hand #222958545857:  Hold'em No Limit ($0.05/$0.10 USD) - 2021/01/23 11:15:18 ET
Table 'Stephano III' 6-max Seat #3 is the button
Seat 1: Intimitatem ($14.05 in chips) 
Seat 2: Hollseg ($11.99 in chips) 
Seat 3: atticus1401 ($9.68 in chips) 
Seat 4: Daurado ($20.42 in chips) 
Seat 5: Impostore1988 ($9.97 in chips) 
Seat 6: stboyo ($3.50 in chips) 
Daurado: posts small blind $0.05
Impostore1988: posts big blind $0.10
*** HOLE CARDS ***
stboyo: folds 
Intimitatem: folds 
Hollseg: folds 
atticus1401: calls $0.10
Daurado: folds 
Impostore1988: raises $0.40 to $0.50
atticus1401: folds 
Uncalled bet ($0.40) returned to Impostore1988
Impostore1988 collected $0.25 from pot
Impostore1988: doesn't show hand 
*** SUMMARY ***
Total pot $0.25 | Rake $0 
Seat 1: Intimitatem folded before Flop (didn't bet)
Seat 2: Hollseg folded before Flop (didn't bet)
Seat 3: atticus1401 (button) folded before Flop
Seat 4: Daurado (small blind) folded before Flop
Seat 5: Impostore1988 (big blind) collected ($0.25)
Seat 6: stboyo folded before Flop (didn't bet)



PokerStars Hand #222958558957:  Hold'em No Limit ($0.05/$0.10 USD) - 2021/01/23 11:15:40 ET
Table 'Stephano III' 6-max Seat #4 is the button
Seat 1: Intimitatem ($14.05 in chips) 
Seat 2: Hollseg ($11.99 in chips) 
Seat 3: atticus1401 ($9.58 in chips) 
Seat 4: Daurado ($20.37 in chips) 
Seat 5: Impostore1988 ($10.12 in chips) 
Seat 6: stboyo ($3.50 in chips) 
Impostore1988: posts small blind $0.05
stboyo: posts big blind $0.10
*** HOLE CARDS ***
Intimitatem: folds 
Hollseg: folds 
atticus1401: calls $0.10
Daurado: folds 
Impostore1988: folds 
stboyo: checks 
*** FLOP *** [Ah Qs Th]
stboyo: checks 
atticus1401: checks 
*** TURN *** [Ah Qs Th] [Ks]
stboyo: checks 
atticus1401: bets $0.24
stboyo: folds 
Uncalled bet ($0.24) returned to atticus1401
atticus1401 collected $0.24 from pot
atticus1401: doesn't show hand 
*** SUMMARY ***
Total pot $0.25 | Rake $0.01 
Board [Ah Qs Th Ks]
Seat 1: Intimitatem folded before Flop (didn't bet)
Seat 2: Hollseg folded before Flop (didn't bet)
Seat 3: atticus1401 collected ($0.24)
Seat 4: Daurado (button) folded before Flop (didn't bet)
Seat 5: Impostore1988 (small blind) folded before Flop
Seat 6: stboyo (big blind) folded on the Turn



PokerStars Hand #222958589167:  Hold'em No Limit ($0.05/$0.10 USD) - 2021/01/23 11:16:30 ET
Table 'Stephano III' 6-max Seat #5 is the button
Seat 1: Intimitatem ($14.05 in chips) 
Seat 2: Hollseg ($11.99 in chips) 
Seat 3: atticus1401 ($9.72 in chips) 
Seat 4: Daurado ($20.37 in chips) 
Seat 5: Impostore1988 ($10.07 in chips) 
Seat 6: stboyo ($3.40 in chips) 
stboyo: posts small blind $0.05
Intimitatem: posts big blind $0.10
*** HOLE CARDS ***
Hollseg: folds 
atticus1401: folds 
Daurado: folds 
Impostore1988: raises $0.10 to $0.20
stboyo: folds 
Intimitatem: folds 
Uncalled bet ($0.10) returned to Impostore1988
Impostore1988 collected $0.25 from pot
Impostore1988: doesn't show hand 
*** SUMMARY ***
Total pot $0.25 | Rake $0 
Seat 1: Intimitatem (big blind) folded before Flop
Seat 2: Hollseg folded before Flop (didn't bet)
Seat 3: atticus1401 folded before Flop (didn't bet)
Seat 4: Daurado folded before Flop (didn't bet)
Seat 5: Impostore1988 (button) collected ($0.25)
Seat 6: stboyo (small blind) folded before Flop



PokerStars Hand #222958601457:  Hold'em No Limit ($0.05/$0.10 USD) - 2021/01/23 11:16:51 ET
Table 'Stephano III' 6-max Seat #6 is the button
Seat 1: Intimitatem ($13.95 in chips) 
Seat 2: Hollseg ($11.99 in chips) 
Seat 3: atticus1401 ($9.72 in chips) 
Seat 4: Daurado ($20.37 in chips) 
Seat 5: Impostore1988 ($10.22 in chips) 
Seat 6: stboyo ($3.35 in chips) 
Intimitatem: posts small blind $0.05
Hollseg: posts big blind $0.10
*** HOLE CARDS ***
atticus1401: folds 
Daurado: folds 
Impostore1988: folds 
stboyo: calls $0.10
Intimitatem: folds 
Hollseg: checks 
*** FLOP *** [6s Qh Jh]
Hollseg: checks 
stboyo: checks 
*** TURN *** [6s Qh Jh] [5c]
Hollseg: bets $0.10
stboyo: calls $0.10
*** RIVER *** [6s Qh Jh 5c] [2d]
Hollseg: bets $0.50
stboyo: raises $0.50 to $1
Hollseg: calls $0.50
*** SHOW DOWN ***
stboyo: shows [As Qd] (a pair of Queens)
Hollseg: shows [Qs 2s] (two pair, Queens and Deuces)
Hollseg collected $2.34 from pot
*** SUMMARY ***
Total pot $2.45 | Rake $0.11 
Board [6s Qh Jh 5c 2d]
Seat 1: Intimitatem (small blind) folded before Flop
Seat 2: Hollseg (big blind) showed [Qs 2s] and won ($2.34) with two pair, Queens and Deuces
Seat 3: atticus1401 folded before Flop (didn't bet)
Seat 4: Daurado folded before Flop (didn't bet)
Seat 5: Impostore1988 folded before Flop (didn't bet)
Seat 6: stboyo (button) showed [As Qd] and lost with a pair of Queens



PokerStars Hand #222958623872:  Hold'em No Limit ($0.05/$0.10 USD) - 2021/01/23 11:17:28 ET
Table 'Stephano III' 6-max Seat #1 is the button
Seat 1: Intimitatem ($13.90 in chips) 
Seat 2: Hollseg ($13.13 in chips) 
Seat 3: atticus1401 ($9.72 in chips) 
Seat 4: Daurado ($20.37 in chips) 
Seat 5: Impostore1988 ($10.22 in chips) 
Seat 6: stboyo ($2.15 in chips) 
Hollseg: posts small blind $0.05
atticus1401: posts big blind $0.10
*** HOLE CARDS ***
Daurado: folds 
Impostore1988: raises $0.10 to $0.20
stboyo: folds 
Intimitatem: folds 
Hollseg: folds 
atticus1401: folds 
Uncalled bet ($0.10) returned to Impostore1988
Impostore1988 collected $0.25 from pot
Impostore1988: doesn't show hand 
*** SUMMARY ***
Total pot $0.25 | Rake $0 
Seat 1: Intimitatem (button) folded before Flop (didn't bet)
Seat 2: Hollseg (small blind) folded before Flop
Seat 3: atticus1401 (big blind) folded before Flop
Seat 4: Daurado folded before Flop (didn't bet)
Seat 5: Impostore1988 collected ($0.25)
Seat 6: stboyo folded before Flop (didn't bet)



PokerStars Hand #222958631766:  Hold'em No Limit ($0.05/$0.10 USD) - 2021/01/23 11:17:41 ET
Table 'Stephano III' 6-max Seat #2 is the button
Seat 1: Intimitatem ($13.90 in chips) 
Seat 2: Hollseg ($13.08 in chips) 
Seat 3: atticus1401 ($9.62 in chips) 
Seat 4: Daurado ($20.37 in chips) 
Seat 5: Impostore1988 ($10.37 in chips) 
Seat 6: stboyo ($2.15 in chips) 
atticus1401: posts small blind $0.05
Daurado: posts big blind $0.10
*** HOLE CARDS ***
Impostore1988: folds 
stboyo: raises $0.10 to $0.20
Intimitatem: folds 
Hollseg: folds 
atticus1401: folds 
Daurado: calls $0.10
*** FLOP *** [4s Jc Ad]
Daurado: checks 
stboyo: bets $0.21
Daurado: folds 
Uncalled bet ($0.21) returned to stboyo
stboyo collected $0.43 from pot
stboyo: doesn't show hand 
*** SUMMARY ***
Total pot $0.45 | Rake $0.02 
Board [4s Jc Ad]
Seat 1: Intimitatem folded before Flop (didn't bet)
Seat 2: Hollseg (button) folded before Flop (didn't bet)
Seat 3: atticus1401 (small blind) folded before Flop
Seat 4: Daurado (big blind) folded on the Flop
Seat 5: Impostore1988 folded before Flop (didn't bet)
Seat 6: stboyo collected ($0.43)



PokerStars Hand #222958651040:  Hold'em No Limit ($0.05/$0.10 USD) - 2021/01/23 11:18:13 ET
Table 'Stephano III' 6-max Seat #3 is the button
Seat 1: Intimitatem ($13.90 in chips) 
Seat 2: Hollseg ($13.08 in chips) 
Seat 3: atticus1401 ($9.57 in chips) 
Seat 4: Daurado ($20.17 in chips) 
Seat 5: Impostore1988 ($10.37 in chips) 
Seat 6: stboyo ($2.38 in chips) 
Daurado: posts small blind $0.05
Impostore1988: posts big blind $0.10
*** HOLE CARDS ***
stboyo: folds 
Intimitatem: folds 
Hollseg: folds 
atticus1401: raises $0.20 to $0.30
Daurado: folds 
Impostore1988: calls $0.20
*** FLOP *** [Kd Qd 3c]
Impostore1988: checks 
atticus1401: bets $0.31
Impostore1988: folds 
Uncalled bet ($0.31) returned to atticus1401
atticus1401 collected $0.62 from pot
atticus1401: doesn't show hand 
*** SUMMARY ***
Total pot $0.65 | Rake $0.03 
Board [Kd Qd 3c]
Seat 1: Intimitatem folded before Flop (didn't bet)
Seat 2: Hollseg folded before Flop (didn't bet)
Seat 3: atticus1401 (button) collected ($0.62)
Seat 4: Daurado (small blind) folded before Flop
Seat 5: Impostore1988 (big blind) folded on the Flop
Seat 6: stboyo folded before Flop (didn't bet)



PokerStars Hand #222958670100:  Hold'em No Limit ($0.05/$0.10 USD) - 2021/01/23 11:18:44 ET
Table 'Stephano III' 6-max Seat #4 is the button
Seat 1: Intimitatem ($13.90 in chips) 
Seat 2: Hollseg ($13.08 in chips) 
Seat 3: atticus1401 ($9.89 in chips) 
Seat 4: Daurado ($20.12 in chips) 
Seat 5: Impostore1988 ($10.07 in chips) 
Seat 6: stboyo ($2.38 in chips) 
Impostore1988: posts small blind $0.05
stboyo: posts big blind $0.10
*** HOLE CARDS ***
Intimitatem: folds 
Hollseg: folds 
atticus1401: folds 
Daurado: folds 
Impostore1988: folds 
Uncalled bet ($0.05) returned to stboyo
stboyo collected $0.10 from pot
stboyo: doesn't show hand 
*** SUMMARY ***
Total pot $0.10 | Rake $0 
Seat 1: Intimitatem folded before Flop (didn't bet)
Seat 2: Hollseg folded before Flop (didn't bet)
Seat 3: atticus1401 folded before Flop (didn't bet)
Seat 4: Daurado (button) folded before Flop (didn't bet)
Seat 5: Impostore1988 (small blind) folded before Flop
Seat 6: stboyo (big blind) collected ($0.10)



PokerStars Hand #222958679897:  Hold'em No Limit ($0.05/$0.10 USD) - 2021/01/23 11:19:01 ET
Table 'Stephano III' 6-max Seat #5 is the button
Seat 1: Intimitatem ($13.90 in chips) 
Seat 2: Hollseg ($13.08 in chips) 
Seat 3: atticus1401 ($9.89 in chips) 
Seat 4: Daurado ($20.12 in chips) 
Seat 5: Impostore1988 ($10.02 in chips) 
Seat 6: stboyo ($2.43 in chips) 
stboyo: posts small blind $0.05
Intimitatem: posts big blind $0.10
*** HOLE CARDS ***
Hollseg: folds 
atticus1401: folds 
Daurado: folds 
Impostore1988: folds 
stboyo: calls $0.05
Intimitatem: raises $0.25 to $0.35
stboyo: calls $0.25
*** FLOP *** [5d 7c 9h]
stboyo: checks 
Intimitatem: checks 
*** TURN *** [5d 7c 9h] [Qd]
stboyo: bets $0.10
Intimitatem: raises $0.35 to $0.45
stboyo: folds 
Uncalled bet ($0.35) returned to Intimitatem
Intimitatem collected $0.86 from pot
Intimitatem: doesn't show hand 
*** SUMMARY ***
Total pot $0.90 | Rake $0.04 
Board [5d 7c 9h Qd]
Seat 1: Intimitatem (big blind) collected ($0.86)
Seat 2: Hollseg folded before Flop (didn't bet)
Seat 3: atticus1401 folded before Flop (didn't bet)
Seat 4: Daurado folded before Flop (didn't bet)
Seat 5: Impostore1988 (button) folded before Flop (didn't bet)
Seat 6: stboyo (small blind) folded on the Turn



PokerStars Hand #222958705285:  Hold'em No Limit ($0.05/$0.10 USD) - 2021/01/23 11:19:43 ET
Table 'Stephano III' 6-max Seat #6 is the button
Seat 1: Intimitatem ($14.31 in chips) 
Seat 2: Hollseg ($13.08 in chips) 
Seat 3: atticus1401 ($9.89 in chips) 
Seat 4: Daurado ($20.12 in chips) 
Seat 5: Impostore1988 ($10.02 in chips) 
Seat 6: stboyo ($1.98 in chips) 
Intimitatem: posts small blind $0.05
Hollseg: posts big blind $0.10
*** HOLE CARDS ***
atticus1401: folds 
Daurado: folds 
Impostore1988: folds 
stboyo: folds 
Intimitatem: raises $0.25 to $0.35
Hollseg: folds 
Uncalled bet ($0.25) returned to Intimitatem
Intimitatem collected $0.20 from pot
Intimitatem: doesn't show hand 
*** SUMMARY ***
Total pot $0.20 | Rake $0 
Seat 1: Intimitatem (small blind) collected ($0.20)
Seat 2: Hollseg (big blind) folded before Flop
Seat 3: atticus1401 folded before Flop (didn't bet)
Seat 4: Daurado folded before Flop (didn't bet)
Seat 5: Impostore1988 folded before Flop (didn't bet)
Seat 6: stboyo (button) folded before Flop (didn't bet)



PokerStars Hand #222958719161:  Hold'em No Limit ($0.05/$0.10 USD) - 2021/01/23 11:20:06 ET
Table 'Stephano III' 6-max Seat #1 is the button
Seat 1: Intimitatem ($14.41 in chips) 
Seat 2: Hollseg ($12.98 in chips) 
Seat 3: atticus1401 ($9.89 in chips) 
Seat 4: Daurado ($20.12 in chips) 
Seat 5: Impostore1988 ($10.02 in chips) 
Seat 6: stboyo ($1.98 in chips) 
Hollseg: posts small blind $0.05
atticus1401: posts big blind $0.10
*** HOLE CARDS ***
Daurado: folds 
Impostore1988: raises $0.10 to $0.20
stboyo: folds 
Intimitatem: folds 
Hollseg: folds 
atticus1401: calls $0.10
*** FLOP *** [8c 5s As]
atticus1401: checks 
Impostore1988: bets $0.22
atticus1401: folds 
Uncalled bet ($0.22) returned to Impostore1988
Impostore1988 collected $0.43 from pot
Impostore1988: doesn't show hand 
*** SUMMARY ***
Total pot $0.45 | Rake $0.02 
Board [8c 5s As]
Seat 1: Intimitatem (button) folded before Flop (didn't bet)
Seat 2: Hollseg (small blind) folded before Flop
Seat 3: atticus1401 (big blind) folded on the Flop
Seat 4: Daurado folded before Flop (didn't bet)
Seat 5: Impostore1988 collected ($0.43)
Seat 6: stboyo folded before Flop (didn't bet)



PokerStars Hand #222958731678:  Hold'em No Limit ($0.05/$0.10 USD) - 2021/01/23 11:20:26 ET
Table 'Stephano III' 6-max Seat #2 is the button
Seat 1: Intimitatem ($14.41 in chips) 
Seat 2: Hollseg ($12.93 in chips) 
Seat 3: atticus1401 ($9.69 in chips) 
Seat 4: Daurado ($20.12 in chips) 
Seat 5: Impostore1988 ($10.25 in chips) 
Seat 6: stboyo ($1.98 in chips) 
atticus1401: posts small blind $0.05
Daurado: posts big blind $0.10
*** HOLE CARDS ***
Impostore1988: folds 
stboyo: folds 
Intimitatem: folds 
Hollseg: folds 
atticus1401: calls $0.05
Daurado: checks 
*** FLOP *** [7s Qc 9d]
atticus1401: bets $0.19
Daurado: folds 
Uncalled bet ($0.19) returned to atticus1401
atticus1401 collected $0.19 from pot
atticus1401: doesn't show hand 
*** SUMMARY ***
Total pot $0.20 | Rake $0.01 
Board [7s Qc 9d]
Seat 1: Intimitatem folded before Flop (didn't bet)
Seat 2: Hollseg (button) folded before Flop (didn't bet)
Seat 3: atticus1401 (small blind) collected ($0.19)
Seat 4: Daurado (big blind) folded on the Flop
Seat 5: Impostore1988 folded before Flop (didn't bet)
Seat 6: stboyo folded before Flop (didn't bet)



PokerStars Hand #222958740768:  Hold'em No Limit ($0.05/$0.10 USD) - 2021/01/23 11:20:41 ET
Table 'Stephano III' 6-max Seat #3 is the button
Seat 1: Intimitatem ($14.41 in chips) 
Seat 2: Hollseg ($12.93 in chips) 
Seat 3: atticus1401 ($9.78 in chips) 
Seat 4: Daurado ($20.02 in chips) 
Seat 5: Impostore1988 ($10.25 in chips) 
Seat 6: stboyo ($1.98 in chips) 
Daurado: posts small blind $0.05
Impostore1988: posts big blind $0.10
*** HOLE CARDS ***
stboyo: folds 
Intimitatem: folds 
Hollseg: folds 
stboyo leaves the table
atticus1401: raises $0.20 to $0.30
Daurado: folds 
Impostore1988: folds 
Uncalled bet ($0.20) returned to atticus1401
atticus1401 collected $0.25 from pot
atticus1401: doesn't show hand 
*** SUMMARY ***
Total pot $0.25 | Rake $0 
Seat 1: Intimitatem folded before Flop (didn't bet)
Seat 2: Hollseg folded before Flop (didn't bet)
Seat 3: atticus1401 (button) collected ($0.25)
Seat 4: Daurado (small blind) folded before Flop
Seat 5: Impostore1988 (big blind) folded before Flop
Seat 6: stboyo folded before Flop (didn't bet)



PokerStars Hand #222958751880:  Hold'em No Limit ($0.05/$0.10 USD) - 2021/01/23 11:20:59 ET
Table 'Stephano III' 6-max Seat #4 is the button
Seat 1: Intimitatem ($14.41 in chips) 
Seat 2: Hollseg ($12.93 in chips) 
Seat 3: atticus1401 ($9.93 in chips) 
Seat 4: Daurado ($19.97 in chips) 
Seat 5: Impostore1988 ($10.15 in chips) 
nickpotss38 joins the table at seat #6 
Impostore1988: posts small blind $0.05
Intimitatem: posts big blind $0.10
*** HOLE CARDS ***
Hollseg: folds 
atticus1401: raises $0.20 to $0.30
Daurado: folds 
Impostore1988: folds 
Intimitatem: folds 
Uncalled bet ($0.20) returned to atticus1401
atticus1401 collected $0.25 from pot
atticus1401: doesn't show hand 
*** SUMMARY ***
Total pot $0.25 | Rake $0 
Seat 1: Intimitatem (big blind) folded before Flop
Seat 2: Hollseg folded before Flop (didn't bet)
Seat 3: atticus1401 collected ($0.25)
Seat 4: Daurado (button) folded before Flop (didn't bet)
Seat 5: Impostore1988 (small blind) folded before Flop



PokerStars Hand #222958762356:  Hold'em No Limit ($0.05/$0.10 USD) - 2021/01/23 11:21:17 ET
Table 'Stephano III' 6-max Seat #5 is the button
Seat 1: Intimitatem ($14.31 in chips) 
Seat 2: Hollseg ($12.93 in chips) 
Seat 3: atticus1401 ($10.08 in chips) 
Seat 4: Daurado ($19.97 in chips) 
Seat 5: Impostore1988 ($10.10 in chips) 
Intimitatem: posts small blind $0.05
Hollseg: posts big blind $0.10
*** HOLE CARDS ***
atticus1401: folds 
Daurado: folds 
Impostore1988: raises $0.10 to $0.20
Intimitatem: folds 
Hollseg: folds 
Uncalled bet ($0.10) returned to Impostore1988
Impostore1988 collected $0.25 from pot
Impostore1988: doesn't show hand 
*** SUMMARY ***
Total pot $0.25 | Rake $0 
Seat 1: Intimitatem (small blind) folded before Flop
Seat 2: Hollseg (big blind) folded before Flop
Seat 3: atticus1401 folded before Flop (didn't bet)
Seat 4: Daurado folded before Flop (didn't bet)
Seat 5: Impostore1988 (button) collected ($0.25)



PokerStars Hand #222958773401:  Hold'em No Limit ($0.05/$0.10 USD) - 2021/01/23 11:21:35 ET
Table 'Stephano III' 6-max Seat #1 is the button
Seat 1: Intimitatem ($14.26 in chips) 
Seat 2: Hollseg ($12.83 in chips) 
Seat 3: atticus1401 ($10.08 in chips) 
Seat 4: Daurado ($19.97 in chips) 
Seat 5: Impostore1988 ($10.25 in chips) 
Seat 6: nickpotss38 ($5.91 in chips) 
Hollseg: posts small blind $0.05
atticus1401: posts big blind $0.10
nickpotss38: posts big blind $0.10
*** HOLE CARDS ***
Daurado: folds 
Impostore1988: folds 
nickpotss38: raises $0.10 to $0.20
Intimitatem: calls $0.20
Hollseg: folds 
atticus1401: calls $0.10
*** FLOP *** [6s 4c 8c]
atticus1401: checks 
nickpotss38: checks 
Intimitatem: checks 
*** TURN *** [6s 4c 8c] [Ac]
atticus1401: checks 
nickpotss38: checks 
Intimitatem: checks 
*** RIVER *** [6s 4c 8c Ac] [9d]
atticus1401: checks 
nickpotss38: bets $0.31
Intimitatem: folds 
atticus1401: folds 
Uncalled bet ($0.31) returned to nickpotss38
nickpotss38 collected $0.62 from pot
nickpotss38: doesn't show hand 
*** SUMMARY ***
Total pot $0.65 | Rake $0.03 
Board [6s 4c 8c Ac 9d]
Seat 1: Intimitatem (button) folded on the River
Seat 2: Hollseg (small blind) folded before Flop
Seat 3: atticus1401 (big blind) folded on the River
Seat 4: Daurado folded before Flop (didn't bet)
Seat 5: Impostore1988 folded before Flop (didn't bet)
Seat 6: nickpotss38 collected ($0.62)



PokerStars Hand #222958804950:  Hold'em No Limit ($0.05/$0.10 USD) - 2021/01/23 11:22:27 ET
Table 'Stephano III' 6-max Seat #2 is the button
Seat 1: Intimitatem ($14.06 in chips) 
Seat 2: Hollseg ($12.78 in chips) 
Seat 3: atticus1401 ($9.88 in chips) 
Seat 4: Daurado ($19.97 in chips) 
Seat 5: Impostore1988 ($10.25 in chips) 
Seat 6: nickpotss38 ($6.33 in chips) 
atticus1401: posts small blind $0.05
Daurado: posts big blind $0.10
*** HOLE CARDS ***
Impostore1988: folds 
nickpotss38: raises $0.10 to $0.20
Intimitatem: folds 
Hollseg: folds 
atticus1401: calls $0.15
Daurado: folds 
*** FLOP *** [8s Th 2h]
atticus1401: checks 
nickpotss38: checks 
*** TURN *** [8s Th 2h] [Kh]
atticus1401: checks 
nickpotss38: bets $0.10
atticus1401: folds 
Uncalled bet ($0.10) returned to nickpotss38
nickpotss38 collected $0.48 from pot
nickpotss38: doesn't show hand 
*** SUMMARY ***
Total pot $0.50 | Rake $0.02 
Board [8s Th 2h Kh]
Seat 1: Intimitatem folded before Flop (didn't bet)
Seat 2: Hollseg (button) folded before Flop (didn't bet)
Seat 3: atticus1401 (small blind) folded on the Turn
Seat 4: Daurado (big blind) folded before Flop
Seat 5: Impostore1988 folded before Flop (didn't bet)
Seat 6: nickpotss38 collected ($0.48)



PokerStars Hand #222958822750:  Hold'em No Limit ($0.05/$0.10 USD) - 2021/01/23 11:22:56 ET
Table 'Stephano III' 6-max Seat #3 is the button
Seat 1: Intimitatem ($14.06 in chips) 
Seat 2: Hollseg ($12.78 in chips) 
Seat 3: atticus1401 ($9.68 in chips) 
Seat 4: Daurado ($19.87 in chips) 
Seat 5: Impostore1988 ($10.25 in chips) 
Seat 6: nickpotss38 ($6.61 in chips) 
Daurado: posts small blind $0.05
Impostore1988: posts big blind $0.10
*** HOLE CARDS ***
nickpotss38: folds 
Intimitatem: raises $0.12 to $0.22
Hollseg: folds 
atticus1401: folds 
Daurado: folds 
Impostore1988: folds 
Uncalled bet ($0.12) returned to Intimitatem
Intimitatem collected $0.25 from pot
Intimitatem: doesn't show hand 
*** SUMMARY ***
Total pot $0.25 | Rake $0 
Seat 1: Intimitatem collected ($0.25)
Seat 2: Hollseg folded before Flop (didn't bet)
Seat 3: atticus1401 (button) folded before Flop (didn't bet)
Seat 4: Daurado (small blind) folded before Flop
Seat 5: Impostore1988 (big blind) folded before Flop
Seat 6: nickpotss38 folded before Flop (didn't bet)



PokerStars Hand #222958831012:  Hold'em No Limit ($0.05/$0.10 USD) - 2021/01/23 11:23:10 ET
Table 'Stephano III' 6-max Seat #4 is the button
Seat 1: Intimitatem ($14.21 in chips) 
Seat 2: Hollseg ($12.78 in chips) 
Seat 3: atticus1401 ($9.68 in chips) 
Seat 4: Daurado ($19.82 in chips) 
Seat 5: Impostore1988 ($10.15 in chips) 
Seat 6: nickpotss38 ($6.61 in chips) 
Impostore1988: posts small blind $0.05
nickpotss38: posts big blind $0.10
*** HOLE CARDS ***
Intimitatem: folds 
Hollseg: folds 
atticus1401: raises $0.20 to $0.30
Daurado: folds 
Impostore1988: folds 
nickpotss38: folds 
Uncalled bet ($0.20) returned to atticus1401
atticus1401 collected $0.25 from pot
atticus1401: doesn't show hand 
*** SUMMARY ***
Total pot $0.25 | Rake $0 
Seat 1: Intimitatem folded before Flop (didn't bet)
Seat 2: Hollseg folded before Flop (didn't bet)
Seat 3: atticus1401 collected ($0.25)
Seat 4: Daurado (button) folded before Flop (didn't bet)
Seat 5: Impostore1988 (small blind) folded before Flop
Seat 6: nickpotss38 (big blind) folded before Flop



PokerStars Hand #222958838000:  Hold'em No Limit ($0.05/$0.10 USD) - 2021/01/23 11:23:21 ET
Table 'Stephano III' 6-max Seat #5 is the button
Seat 1: Intimitatem ($14.21 in chips) 
Seat 2: Hollseg ($12.78 in chips) 
Seat 3: atticus1401 ($9.83 in chips) 
Seat 4: Daurado ($19.82 in chips) 
Seat 5: Impostore1988 ($10.10 in chips) 
Seat 6: nickpotss38 ($6.51 in chips) 
nickpotss38: posts small blind $0.05
Intimitatem: posts big blind $0.10
*** HOLE CARDS ***
Hollseg: raises $0.20 to $0.30
atticus1401: folds 
Daurado: folds 
Impostore1988: folds 
nickpotss38: folds 
Intimitatem: folds 
Uncalled bet ($0.20) returned to Hollseg
Hollseg collected $0.25 from pot
Hollseg: doesn't show hand 
*** SUMMARY ***
Total pot $0.25 | Rake $0 
Seat 1: Intimitatem (big blind) folded before Flop
Seat 2: Hollseg collected ($0.25)
Seat 3: atticus1401 folded before Flop (didn't bet)
Seat 4: Daurado folded before Flop (didn't bet)
Seat 5: Impostore1988 (button) folded before Flop (didn't bet)
Seat 6: nickpotss38 (small blind) folded before Flop



PokerStars Hand #222958844970:  Hold'em No Limit ($0.05/$0.10 USD) - 2021/01/23 11:23:33 ET
Table 'Stephano III' 6-max Seat #6 is the button
Seat 1: Intimitatem ($14.11 in chips) 
Seat 2: Hollseg ($12.93 in chips) 
Seat 3: atticus1401 ($9.83 in chips) 
Seat 4: Daurado ($19.82 in chips) 
Seat 5: Impostore1988 ($10.10 in chips) 
Seat 6: nickpotss38 ($6.46 in chips) 
Intimitatem: posts small blind $0.05
Hollseg: posts big blind $0.10
*** HOLE CARDS ***
atticus1401: raises $0.20 to $0.30
Daurado: folds 
Impostore1988: folds 
nickpotss38: raises $0.75 to $1.05
Intimitatem: folds 
Hollseg: folds 
atticus1401: folds 
Uncalled bet ($0.75) returned to nickpotss38
nickpotss38 collected $0.75 from pot
nickpotss38: doesn't show hand 
*** SUMMARY ***
Total pot $0.75 | Rake $0 
Seat 1: Intimitatem (small blind) folded before Flop
Seat 2: Hollseg (big blind) folded before Flop
Seat 3: atticus1401 folded before Flop
Seat 4: Daurado folded before Flop (didn't bet)
Seat 5: Impostore1988 folded before Flop (didn't bet)
Seat 6: nickpotss38 (button) collected ($0.75)



PokerStars Hand #222958855305:  Hold'em No Limit ($0.05/$0.10 USD) - 2021/01/23 11:23:50 ET
Table 'Stephano III' 6-max Seat #1 is the button
Seat 1: Intimitatem ($14.06 in chips) 
Seat 2: Hollseg ($12.83 in chips) 
Seat 3: atticus1401 ($9.53 in chips) 
Seat 4: Daurado ($19.82 in chips) 
Seat 5: Impostore1988 ($10.10 in chips) 
Seat 6: nickpotss38 ($6.91 in chips) 
Hollseg: posts small blind $0.05
atticus1401: posts big blind $0.10
*** HOLE CARDS ***
Daurado: folds 
Impostore1988: raises $0.10 to $0.20
nickpotss38: folds 
Intimitatem: folds 
Hollseg: folds 
atticus1401: calls $0.10
*** FLOP *** [Qh 3d 6h]
atticus1401: checks 
Impostore1988: bets $0.22
atticus1401: calls $0.22
*** TURN *** [Qh 3d 6h] [Kc]
atticus1401: checks 
Impostore1988: checks 
*** RIVER *** [Qh 3d 6h Kc] [6c]
atticus1401: bets $0.43
Impostore1988: folds 
Uncalled bet ($0.43) returned to atticus1401
atticus1401 collected $0.85 from pot
atticus1401: doesn't show hand 
*** SUMMARY ***
Total pot $0.89 | Rake $0.04 
Board [Qh 3d 6h Kc 6c]
Seat 1: Intimitatem (button) folded before Flop (didn't bet)
Seat 2: Hollseg (small blind) folded before Flop
Seat 3: atticus1401 (big blind) collected ($0.85)
Seat 4: Daurado folded before Flop (didn't bet)
Seat 5: Impostore1988 folded on the River
Seat 6: nickpotss38 folded before Flop (didn't bet)



PokerStars Hand #222958874175:  Hold'em No Limit ($0.05/$0.10 USD) - 2021/01/23 11:24:21 ET
Table 'Stephano III' 6-max Seat #2 is the button
Seat 1: Intimitatem ($14.06 in chips) 
Seat 2: Hollseg ($12.78 in chips) 
Seat 3: atticus1401 ($9.96 in chips) 
Seat 4: Daurado ($19.82 in chips) 
Seat 5: Impostore1988 ($9.68 in chips) 
Seat 6: nickpotss38 ($6.91 in chips) 
atticus1401: posts small blind $0.05
Daurado: posts big blind $0.10
*** HOLE CARDS ***
Impostore1988: folds 
nickpotss38: folds 
Intimitatem: folds 
Hollseg: raises $0.15 to $0.25
atticus1401: folds 
Daurado: folds 
Uncalled bet ($0.15) returned to Hollseg
Hollseg collected $0.25 from pot
Hollseg: doesn't show hand 
*** SUMMARY ***
Total pot $0.25 | Rake $0 
Seat 1: Intimitatem folded before Flop (didn't bet)
Seat 2: Hollseg (button) collected ($0.25)
Seat 3: atticus1401 (small blind) folded before Flop
Seat 4: Daurado (big blind) folded before Flop
Seat 5: Impostore1988 folded before Flop (didn't bet)
Seat 6: nickpotss38 folded before Flop (didn't bet)



PokerStars Hand #222958880667:  Hold'em No Limit ($0.05/$0.10 USD) - 2021/01/23 11:24:32 ET
Table 'Stephano III' 6-max Seat #3 is the button
Seat 1: Intimitatem ($14.06 in chips) 
Seat 2: Hollseg ($12.93 in chips) 
Seat 3: atticus1401 ($9.91 in chips) 
Seat 4: Daurado ($19.72 in chips) 
Seat 5: Impostore1988 ($9.68 in chips) 
Seat 6: nickpotss38 ($6.91 in chips) 
Daurado: posts small blind $0.05
Impostore1988: posts big blind $0.10
*** HOLE CARDS ***
nickpotss38: folds 
Intimitatem: folds 
Hollseg: raises $0.15 to $0.25
atticus1401: folds 
Daurado: folds 
Impostore1988: calls $0.15
*** FLOP *** [5s Jh As]
Impostore1988: checks 
Hollseg: checks 
*** TURN *** [5s Jh As] [9s]
Impostore1988: checks 
Hollseg: bets $0.24
Impostore1988: folds 
Uncalled bet ($0.24) returned to Hollseg
Hollseg collected $0.53 from pot
Hollseg: doesn't show hand 
*** SUMMARY ***
Total pot $0.55 | Rake $0.02 
Board [5s Jh As 9s]
Seat 1: Intimitatem folded before Flop (didn't bet)
Seat 2: Hollseg collected ($0.53)
Seat 3: atticus1401 (button) folded before Flop (didn't bet)
Seat 4: Daurado (small blind) folded before Flop
Seat 5: Impostore1988 (big blind) folded on the Turn
Seat 6: nickpotss38 folded before Flop (didn't bet)



PokerStars Hand #222958895410:  Hold'em No Limit ($0.05/$0.10 USD) - 2021/01/23 11:24:56 ET
Table 'Stephano III' 6-max Seat #4 is the button
Seat 1: Intimitatem ($14.06 in chips) 
Seat 2: Hollseg ($13.21 in chips) 
Seat 3: atticus1401 ($9.91 in chips) 
Seat 4: Daurado ($19.67 in chips) 
Seat 5: Impostore1988 ($9.43 in chips) 
Seat 6: nickpotss38 ($6.91 in chips) 
Impostore1988: posts small blind $0.05
nickpotss38: posts big blind $0.10
*** HOLE CARDS ***
Intimitatem: folds 
Hollseg: folds 
atticus1401: raises $0.20 to $0.30
Daurado: folds 
Impostore1988: folds 
nickpotss38: calls $0.20
*** FLOP *** [9c 3c 5h]
nickpotss38: checks 
atticus1401: checks 
*** TURN *** [9c 3c 5h] [6d]
nickpotss38: checks 
atticus1401: bets $0.31
nickpotss38: folds 
Uncalled bet ($0.31) returned to atticus1401
atticus1401 collected $0.62 from pot
atticus1401: doesn't show hand 
*** SUMMARY ***
Total pot $0.65 | Rake $0.03 
Board [9c 3c 5h 6d]
Seat 1: Intimitatem folded before Flop (didn't bet)
Seat 2: Hollseg folded before Flop (didn't bet)
Seat 3: atticus1401 collected ($0.62)
Seat 4: Daurado (button) folded before Flop (didn't bet)
Seat 5: Impostore1988 (small blind) folded before Flop
Seat 6: nickpotss38 (big blind) folded on the Turn



PokerStars Hand #222958923872:  Hold'em No Limit ($0.05/$0.10 USD) - 2021/01/23 11:25:43 ET
Table 'Stephano III' 6-max Seat #5 is the button
Seat 1: Intimitatem ($14.06 in chips) 
Seat 2: Hollseg ($13.21 in chips) 
Seat 3: atticus1401 ($10.23 in chips) 
Seat 4: Daurado ($19.67 in chips) 
Seat 5: Impostore1988 ($9.38 in chips) 
Seat 6: nickpotss38 ($6.61 in chips) 
nickpotss38: posts small blind $0.05
Intimitatem: posts big blind $0.10
*** HOLE CARDS ***
Hollseg: folds 
atticus1401: folds 
Daurado: folds 
Impostore1988: folds 
nickpotss38: raises $0.20 to $0.30
Intimitatem: folds 
Uncalled bet ($0.20) returned to nickpotss38
nickpotss38 collected $0.20 from pot
nickpotss38: doesn't show hand 
*** SUMMARY ***
Total pot $0.20 | Rake $0 
Seat 1: Intimitatem (big blind) folded before Flop
Seat 2: Hollseg folded before Flop (didn't bet)
Seat 3: atticus1401 folded before Flop (didn't bet)
Seat 4: Daurado folded before Flop (didn't bet)
Seat 5: Impostore1988 (button) folded before Flop (didn't bet)
Seat 6: nickpotss38 (small blind) collected ($0.20)



PokerStars Hand #222958931964:  Hold'em No Limit ($0.05/$0.10 USD) - 2021/01/23 11:25:56 ET
Table 'Stephano III' 6-max Seat #6 is the button
Seat 1: Intimitatem ($13.96 in chips) 
Seat 2: Hollseg ($13.21 in chips) 
Seat 3: atticus1401 ($10.23 in chips) 
Seat 4: Daurado ($19.67 in chips) 
Seat 5: Impostore1988 ($10 in chips) 
Seat 6: nickpotss38 ($6.71 in chips) 
Intimitatem: posts small blind $0.05
Hollseg: posts big blind $0.10
*** HOLE CARDS ***
atticus1401: folds 
Daurado: folds 
Impostore1988: folds 
nickpotss38: calls $0.10
Intimitatem: folds 
Hollseg: checks 
*** FLOP *** [Tc 7s 5h]
Hollseg: checks 
nickpotss38: bets $0.10
Hollseg: calls $0.10
*** TURN *** [Tc 7s 5h] [9s]
Hollseg: checks 
nickpotss38: bets $0.10
Hollseg: folds 
Uncalled bet ($0.10) returned to nickpotss38
nickpotss38 collected $0.43 from pot
nickpotss38: doesn't show hand 
*** SUMMARY ***
Total pot $0.45 | Rake $0.02 
Board [Tc 7s 5h 9s]
Seat 1: Intimitatem (small blind) folded before Flop
Seat 2: Hollseg (big blind) folded on the Turn
Seat 3: atticus1401 folded before Flop (didn't bet)
Seat 4: Daurado folded before Flop (didn't bet)
Seat 5: Impostore1988 folded before Flop (didn't bet)
Seat 6: nickpotss38 (button) collected ($0.43)



PokerStars Hand #222958947361:  Hold'em No Limit ($0.05/$0.10 USD) - 2021/01/23 11:26:22 ET
Table 'Stephano III' 6-max Seat #1 is the button
Seat 1: Intimitatem ($13.91 in chips) 
Seat 2: Hollseg ($13.01 in chips) 
Seat 3: atticus1401 ($10.23 in chips) 
Seat 4: Daurado ($19.67 in chips) 
Seat 5: Impostore1988 ($10 in chips) 
Seat 6: nickpotss38 ($6.94 in chips) 
Hollseg: posts small blind $0.05
atticus1401: posts big blind $0.10
*** HOLE CARDS ***
Daurado: folds 
Impostore1988: raises $0.10 to $0.20
nickpotss38: folds 
Intimitatem: folds 
Hollseg: folds 
atticus1401: folds 
Uncalled bet ($0.10) returned to Impostore1988
Impostore1988 collected $0.25 from pot
Impostore1988: doesn't show hand 
*** SUMMARY ***
Total pot $0.25 | Rake $0 
Seat 1: Intimitatem (button) folded before Flop (didn't bet)
Seat 2: Hollseg (small blind) folded before Flop
Seat 3: atticus1401 (big blind) folded before Flop
Seat 4: Daurado folded before Flop (didn't bet)
Seat 5: Impostore1988 collected ($0.25)
Seat 6: nickpotss38 folded before Flop (didn't bet)



PokerStars Hand #222958953896:  Hold'em No Limit ($0.05/$0.10 USD) - 2021/01/23 11:26:32 ET
Table 'Stephano III' 6-max Seat #2 is the button
Seat 1: Intimitatem ($13.91 in chips) 
Seat 2: Hollseg ($12.96 in chips) 
Seat 3: atticus1401 ($10.13 in chips) 
Seat 4: Daurado ($19.67 in chips) 
Seat 5: Impostore1988 ($10.15 in chips) 
Seat 6: nickpotss38 ($6.94 in chips) 
atticus1401: posts small blind $0.05
Daurado: posts big blind $0.10
*** HOLE CARDS ***
Impostore1988: folds 
nickpotss38: calls $0.10
Intimitatem: folds 
Hollseg: folds 
atticus1401: calls $0.05
Daurado: raises $0.30 to $0.40
nickpotss38: calls $0.30
atticus1401: calls $0.30
*** FLOP *** [2c 3d 5s]
atticus1401: checks 
Daurado: checks 
nickpotss38: checks 
*** TURN *** [2c 3d 5s] [4h]
atticus1401: checks 
Daurado: checks 
nickpotss38: bets $0.57
atticus1401: folds 
Daurado: calls $0.57
*** RIVER *** [2c 3d 5s 4h] [Qs]
Daurado: checks 
nickpotss38: bets $0.61
Daurado: calls $0.61
*** SHOW DOWN ***
nickpotss38: shows [8d 9h] (high card Queen)
Daurado: shows [Ac Td] (a straight, Ace to Five)
Daurado collected $3.40 from pot
*** SUMMARY ***
Total pot $3.56 | Rake $0.16 
Board [2c 3d 5s 4h Qs]
Seat 1: Intimitatem folded before Flop (didn't bet)
Seat 2: Hollseg (button) folded before Flop (didn't bet)
Seat 3: atticus1401 (small blind) folded on the Turn
Seat 4: Daurado (big blind) showed [Ac Td] and won ($3.40) with a straight, Ace to Five
Seat 5: Impostore1988 folded before Flop (didn't bet)
Seat 6: nickpotss38 showed [8d 9h] and lost with high card Queen



PokerStars Hand #222959010559:  Hold'em No Limit ($0.05/$0.10 USD) - 2021/01/23 11:28:00 ET
Table 'Stephano III' 6-max Seat #3 is the button
Seat 1: Intimitatem ($13.91 in chips) 
Seat 2: Hollseg ($12.96 in chips) 
Seat 3: atticus1401 ($9.73 in chips) 
Seat 4: Daurado ($21.49 in chips) 
Seat 5: Impostore1988 ($10.15 in chips) 
Seat 6: nickpotss38 ($5.36 in chips) 
Daurado: posts small blind $0.05
Impostore1988: posts big blind $0.10
*** HOLE CARDS ***
nickpotss38: folds 
Intimitatem: folds 
Hollseg: folds 
atticus1401: folds 
Daurado: folds 
Uncalled bet ($0.05) returned to Impostore1988
Impostore1988 collected $0.10 from pot
Impostore1988: doesn't show hand 
*** SUMMARY ***
Total pot $0.10 | Rake $0 
Seat 1: Intimitatem folded before Flop (didn't bet)
Seat 2: Hollseg folded before Flop (didn't bet)
Seat 3: atticus1401 (button) folded before Flop (didn't bet)
Seat 4: Daurado (small blind) folded before Flop
Seat 5: Impostore1988 (big blind) collected ($0.10)
Seat 6: nickpotss38 folded before Flop (didn't bet)



PokerStars Hand #222959016659:  Hold'em No Limit ($0.05/$0.10 USD) - 2021/01/23 11:28:10 ET
Table 'Stephano III' 6-max Seat #4 is the button
Seat 1: Intimitatem ($13.91 in chips) 
Seat 2: Hollseg ($12.96 in chips) 
Seat 3: atticus1401 ($9.73 in chips) 
Seat 4: Daurado ($21.44 in chips) 
Seat 5: Impostore1988 ($10.20 in chips) 
Seat 6: nickpotss38 ($5.36 in chips) 
Impostore1988: posts small blind $0.05
nickpotss38: posts big blind $0.10
*** HOLE CARDS ***
Intimitatem has timed out
Intimitatem: folds 
Hollseg: folds 
atticus1401: calls $0.10
Daurado: raises $0.30 to $0.40
Impostore1988: folds 
nickpotss38: calls $0.30
atticus1401: calls $0.30
*** FLOP *** [Ah 4d 9s]
nickpotss38: checks 
atticus1401: checks 
Daurado: checks 
*** TURN *** [Ah 4d 9s] [3h]
nickpotss38: bets $0.10
atticus1401: calls $0.10
Daurado: calls $0.10
*** RIVER *** [Ah 4d 9s 3h] [2h]
nickpotss38: checks 
atticus1401: bets $0.74
Daurado: folds 
nickpotss38: folds 
Uncalled bet ($0.74) returned to atticus1401
atticus1401 collected $1.48 from pot
atticus1401: doesn't show hand 
*** SUMMARY ***
Total pot $1.55 | Rake $0.07 
Board [Ah 4d 9s 3h 2h]
Seat 1: Intimitatem folded before Flop (didn't bet)
Seat 2: Hollseg folded before Flop (didn't bet)
Seat 3: atticus1401 collected ($1.48)
Seat 4: Daurado (button) folded on the River
Seat 5: Impostore1988 (small blind) folded before Flop
Seat 6: nickpotss38 (big blind) folded on the River



PokerStars Hand #222959057697:  Hold'em No Limit ($0.05/$0.10 USD) - 2021/01/23 11:29:18 ET
Table 'Stephano III' 6-max Seat #5 is the button
Seat 1: Intimitatem ($13.91 in chips) 
Seat 2: Hollseg ($12.96 in chips) 
Seat 3: atticus1401 ($10.71 in chips) 
Seat 4: Daurado ($20.94 in chips) 
Seat 5: Impostore1988 ($10.15 in chips) 
Seat 6: nickpotss38 ($4.86 in chips) 
nickpotss38: posts small blind $0.05
Intimitatem: posts big blind $0.10
*** HOLE CARDS ***
Hollseg: folds 
atticus1401: folds 
Daurado: folds 
Impostore1988: folds 
nickpotss38: calls $0.05
Intimitatem: checks 
*** FLOP *** [8s 9d 2d]
nickpotss38: checks 
Intimitatem: checks 
*** TURN *** [8s 9d 2d] [9h]
nickpotss38: checks 
Intimitatem: checks 
*** RIVER *** [8s 9d 2d 9h] [Jc]
nickpotss38: checks 
Intimitatem: checks 
*** SHOW DOWN ***
nickpotss38: shows [3h As] (a pair of Nines)
Intimitatem: mucks hand 
nickpotss38 collected $0.19 from pot
*** SUMMARY ***
Total pot $0.20 | Rake $0.01 
Board [8s 9d 2d 9h Jc]
Seat 1: Intimitatem (big blind) mucked
Seat 2: Hollseg folded before Flop (didn't bet)
Seat 3: atticus1401 folded before Flop (didn't bet)
Seat 4: Daurado folded before Flop (didn't bet)
Seat 5: Impostore1988 (button) folded before Flop (didn't bet)
Seat 6: nickpotss38 (small blind) showed [3h As] and won ($0.19) with a pair of Nines



PokerStars Hand #222959093181:  Hold'em No Limit ($0.05/$0.10 USD) - 2021/01/23 11:30:13 ET
Table 'Stephano III' 6-max Seat #6 is the button
Seat 1: Intimitatem ($13.81 in chips) 
Seat 2: Hollseg ($12.96 in chips) 
Seat 3: atticus1401 ($10.71 in chips) 
Seat 4: Daurado ($20.94 in chips) 
Seat 5: Impostore1988 ($10.15 in chips) 
Seat 6: nickpotss38 ($4.95 in chips) 
Intimitatem: posts small blind $0.05
Hollseg: posts big blind $0.10
*** HOLE CARDS ***
atticus1401: folds 
Daurado: folds 
Impostore1988: folds 
nickpotss38: folds 
Intimitatem: raises $0.25 to $0.35
Hollseg: calls $0.25
*** FLOP *** [2d 2h Qc]
Intimitatem: bets $0.22
Hollseg: calls $0.22
*** TURN *** [2d 2h Qc] [4d]
Intimitatem: checks 
Hollseg: bets $0.60
Intimitatem: folds 
Uncalled bet ($0.60) returned to Hollseg
Hollseg collected $1.09 from pot
Hollseg: doesn't show hand 
*** SUMMARY ***
Total pot $1.14 | Rake $0.05 
Board [2d 2h Qc 4d]
Seat 1: Intimitatem (small blind) folded on the Turn
Seat 2: Hollseg (big blind) collected ($1.09)
Seat 3: atticus1401 folded before Flop (didn't bet)
Seat 4: Daurado folded before Flop (didn't bet)
Seat 5: Impostore1988 folded before Flop (didn't bet)
Seat 6: nickpotss38 (button) folded before Flop (didn't bet)



PokerStars Hand #222959118486:  Hold'em No Limit ($0.05/$0.10 USD) - 2021/01/23 11:30:54 ET
Table 'Stephano III' 6-max Seat #1 is the button
Seat 1: Intimitatem ($13.24 in chips) 
Seat 2: Hollseg ($13.48 in chips) 
Seat 3: atticus1401 ($10.71 in chips) 
Seat 4: Daurado ($20.94 in chips) 
Seat 5: Impostore1988 ($10.15 in chips) 
Seat 6: nickpotss38 ($4.95 in chips) 
Hollseg: posts small blind $0.05
atticus1401: posts big blind $0.10
*** HOLE CARDS ***
Daurado: folds 
Impostore1988: folds 
nickpotss38: folds 
Intimitatem: folds 
Hollseg: raises $0.20 to $0.30
atticus1401: folds 
Uncalled bet ($0.20) returned to Hollseg
Hollseg collected $0.20 from pot
Hollseg: doesn't show hand 
*** SUMMARY ***
Total pot $0.20 | Rake $0 
Seat 1: Intimitatem (button) folded before Flop (didn't bet)
Seat 2: Hollseg (small blind) collected ($0.20)
Seat 3: atticus1401 (big blind) folded before Flop
Seat 4: Daurado folded before Flop (didn't bet)
Seat 5: Impostore1988 folded before Flop (didn't bet)
Seat 6: nickpotss38 folded before Flop (didn't bet)



PokerStars Hand #222959141140:  Hold'em No Limit ($0.05/$0.10 USD) - 2021/01/23 11:31:31 ET
Table 'Stephano III' 6-max Seat #2 is the button
Seat 1: Intimitatem ($13.24 in chips) 
Seat 2: Hollseg ($13.58 in chips) 
Seat 3: atticus1401 ($10.61 in chips) 
Seat 4: Daurado ($20.94 in chips) 
Seat 5: Impostore1988 ($10.15 in chips) 
Seat 6: nickpotss38 ($4.95 in chips) 
atticus1401: posts small blind $0.05
Daurado: posts big blind $0.10
*** HOLE CARDS ***
Impostore1988: raises $0.10 to $0.20
nickpotss38: folds 
Intimitatem: folds 
Hollseg: folds 
atticus1401: raises $0.50 to $0.70
Daurado: folds 
Impostore1988: calls $0.50
*** FLOP *** [5c 8d 9d]
atticus1401: bets $0.72
Impostore1988: folds 
Uncalled bet ($0.72) returned to atticus1401
atticus1401 collected $1.43 from pot
atticus1401: doesn't show hand 
*** SUMMARY ***
Total pot $1.50 | Rake $0.07 
Board [5c 8d 9d]
Seat 1: Intimitatem folded before Flop (didn't bet)
Seat 2: Hollseg (button) folded before Flop (didn't bet)
Seat 3: atticus1401 (small blind) collected ($1.43)
Seat 4: Daurado (big blind) folded before Flop
Seat 5: Impostore1988 folded on the Flop
Seat 6: nickpotss38 folded before Flop (didn't bet)



PokerStars Hand #222959162912:  Hold'em No Limit ($0.05/$0.10 USD) - 2021/01/23 11:32:06 ET
Table 'Stephano III' 6-max Seat #3 is the button
Seat 1: Intimitatem ($13.24 in chips) 
Seat 2: Hollseg ($13.58 in chips) 
Seat 3: atticus1401 ($11.34 in chips) 
Seat 4: Daurado ($20.84 in chips) 
Seat 5: Impostore1988 ($9.45 in chips) 
Seat 6: nickpotss38 ($4.95 in chips) 
Daurado: posts small blind $0.05
Impostore1988: posts big blind $0.10
*** HOLE CARDS ***
nickpotss38: folds 
Intimitatem: folds 
Hollseg: folds 
atticus1401: folds 
Daurado: raises $0.20 to $0.30
Impostore1988: folds 
Uncalled bet ($0.20) returned to Daurado
Daurado collected $0.20 from pot
Daurado: doesn't show hand 
*** SUMMARY ***
Total pot $0.20 | Rake $0 
Seat 1: Intimitatem folded before Flop (didn't bet)
Seat 2: Hollseg folded before Flop (didn't bet)
Seat 3: atticus1401 (button) folded before Flop (didn't bet)
Seat 4: Daurado (small blind) collected ($0.20)
Seat 5: Impostore1988 (big blind) folded before Flop
Seat 6: nickpotss38 folded before Flop (didn't bet)



PokerStars Hand #222959174494:  Hold'em No Limit ($0.05/$0.10 USD) - 2021/01/23 11:32:25 ET
Table 'Stephano III' 6-max Seat #4 is the button
Seat 1: Intimitatem ($13.24 in chips) 
Seat 2: Hollseg ($13.58 in chips) 
Seat 3: atticus1401 ($11.34 in chips) 
Seat 4: Daurado ($20.94 in chips) 
Seat 5: Impostore1988 ($9.35 in chips) 
Seat 6: nickpotss38 ($4.95 in chips) 
Impostore1988: posts small blind $0.05
nickpotss38: posts big blind $0.10
*** HOLE CARDS ***
Intimitatem: folds 
Hollseg: raises $0.20 to $0.30
atticus1401: folds 
Daurado: folds 
Impostore1988: folds 
nickpotss38: folds 
Uncalled bet ($0.20) returned to Hollseg
Hollseg collected $0.25 from pot
Hollseg: doesn't show hand 
*** SUMMARY ***
Total pot $0.25 | Rake $0 
Seat 1: Intimitatem folded before Flop (didn't bet)
Seat 2: Hollseg collected ($0.25)
Seat 3: atticus1401 folded before Flop (didn't bet)
Seat 4: Daurado (button) folded before Flop (didn't bet)
Seat 5: Impostore1988 (small blind) folded before Flop
Seat 6: nickpotss38 (big blind) folded before Flop



PokerStars Hand #222959185557:  Hold'em No Limit ($0.05/$0.10 USD) - 2021/01/23 11:32:43 ET
Table 'Stephano III' 6-max Seat #5 is the button
Seat 1: Intimitatem ($13.24 in chips) 
Seat 2: Hollseg ($13.73 in chips) 
Seat 3: atticus1401 ($11.34 in chips) 
Seat 4: Daurado ($20.94 in chips) 
Seat 5: Impostore1988 ($9.30 in chips) 
Seat 6: nickpotss38 ($4.85 in chips) 
nickpotss38: posts small blind $0.05
Intimitatem: posts big blind $0.10
*** HOLE CARDS ***
Hollseg: folds 
atticus1401: raises $0.20 to $0.30
Daurado: folds 
Impostore1988: folds 
nickpotss38: raises $0.70 to $1
Intimitatem: folds 
atticus1401: calls $0.70
*** FLOP *** [8s Ts 6d]
nickpotss38: bets $2.01
atticus1401: folds 
Uncalled bet ($2.01) returned to nickpotss38
nickpotss38 collected $2.01 from pot
nickpotss38: doesn't show hand 
*** SUMMARY ***
Total pot $2.10 | Rake $0.09 
Board [8s Ts 6d]
Seat 1: Intimitatem (big blind) folded before Flop
Seat 2: Hollseg folded before Flop (didn't bet)
Seat 3: atticus1401 folded on the Flop
Seat 4: Daurado folded before Flop (didn't bet)
Seat 5: Impostore1988 (button) folded before Flop (didn't bet)
Seat 6: nickpotss38 (small blind) collected ($2.01)



PokerStars Hand #222959202422:  Hold'em No Limit ($0.05/$0.10 USD) - 2021/01/23 11:33:11 ET
Table 'Stephano III' 6-max Seat #6 is the button
Seat 1: Intimitatem ($13.14 in chips) 
Seat 2: Hollseg ($13.73 in chips) 
Seat 3: atticus1401 ($10.34 in chips) 
Seat 4: Daurado ($20.94 in chips) 
Seat 5: Impostore1988 ($9.30 in chips) 
Seat 6: nickpotss38 ($5.86 in chips) 
Intimitatem: posts small blind $0.05
Hollseg: posts big blind $0.10
*** HOLE CARDS ***
atticus1401: calls $0.10
Daurado: folds 
Impostore1988: raises $0.35 to $0.45
nickpotss38 has timed out
nickpotss38: folds 
Intimitatem: folds 
Hollseg: folds 
atticus1401: folds 
Uncalled bet ($0.35) returned to Impostore1988
Impostore1988 collected $0.35 from pot
Impostore1988: doesn't show hand 
*** SUMMARY ***
Total pot $0.35 | Rake $0 
Seat 1: Intimitatem (small blind) folded before Flop
Seat 2: Hollseg (big blind) folded before Flop
Seat 3: atticus1401 folded before Flop
Seat 4: Daurado folded before Flop (didn't bet)
Seat 5: Impostore1988 collected ($0.35)
Seat 6: nickpotss38 (button) folded before Flop (didn't bet)



PokerStars Hand #222959222583:  Hold'em No Limit ($0.05/$0.10 USD) - 2021/01/23 11:33:43 ET
Table 'Stephano III' 6-max Seat #1 is the button
Seat 1: Intimitatem ($13.09 in chips) 
Seat 2: Hollseg ($13.63 in chips) 
Seat 3: atticus1401 ($10.24 in chips) 
Seat 4: Daurado ($20.94 in chips) 
Seat 5: Impostore1988 ($9.55 in chips) 
Seat 6: nickpotss38 ($5.86 in chips) 
Hollseg: posts small blind $0.05
atticus1401: posts big blind $0.10
*** HOLE CARDS ***
Daurado: folds 
Impostore1988: folds 
nickpotss38: calls $0.10
Intimitatem has timed out
Intimitatem: folds 
Hollseg: folds 
atticus1401: checks 
*** FLOP *** [7c Jd 5d]
atticus1401: checks 
nickpotss38: checks 
*** TURN *** [7c Jd 5d] [Kh]
atticus1401: checks 
nickpotss38: checks 
*** RIVER *** [7c Jd 5d Kh] [5h]
atticus1401: checks 
nickpotss38: checks 
*** SHOW DOWN ***
atticus1401: shows [4d Tc] (a pair of Fives)
nickpotss38: shows [3d 3s] (two pair, Fives and Threes)
nickpotss38 collected $0.24 from pot
*** SUMMARY ***
Total pot $0.25 | Rake $0.01 
Board [7c Jd 5d Kh 5h]
Seat 1: Intimitatem (button) folded before Flop (didn't bet)
Seat 2: Hollseg (small blind) folded before Flop
Seat 3: atticus1401 (big blind) showed [4d Tc] and lost with a pair of Fives
Seat 4: Daurado folded before Flop (didn't bet)
Seat 5: Impostore1988 folded before Flop (didn't bet)
Seat 6: nickpotss38 showed [3d 3s] and won ($0.24) with two pair, Fives and Threes



PokerStars Hand #222959245281:  Hold'em No Limit ($0.05/$0.10 USD) - 2021/01/23 11:34:20 ET
Table 'Stephano III' 6-max Seat #2 is the button
Seat 1: Intimitatem ($13.09 in chips) 
Seat 2: Hollseg ($13.58 in chips) 
Seat 3: atticus1401 ($10.14 in chips) 
Seat 4: Daurado ($20.94 in chips) 
Seat 5: Impostore1988 ($9.55 in chips) 
Seat 6: nickpotss38 ($6 in chips) 
atticus1401: posts small blind $0.05
Daurado: posts big blind $0.10
*** HOLE CARDS ***
Impostore1988: folds 
nickpotss38 has timed out
nickpotss38: folds 
Intimitatem: folds 
Hollseg: folds 
atticus1401: calls $0.05
Daurado: checks 
*** FLOP *** [Kh 3d 5h]
atticus1401: checks 
Daurado: bets $0.10
atticus1401: calls $0.10
*** TURN *** [Kh 3d 5h] [Ks]
atticus1401: checks 
Daurado: bets $0.13
atticus1401: calls $0.13
*** RIVER *** [Kh 3d 5h Ks] [6h]
atticus1401: checks 
Daurado: checks 
*** SHOW DOWN ***
atticus1401: shows [Kd 5s] (a full house, Kings full of Fives)
Daurado: mucks hand 
atticus1401 collected $0.63 from pot
*** SUMMARY ***
Total pot $0.66 | Rake $0.03 
Board [Kh 3d 5h Ks 6h]
Seat 1: Intimitatem folded before Flop (didn't bet)
Seat 2: Hollseg (button) folded before Flop (didn't bet)
Seat 3: atticus1401 (small blind) showed [Kd 5s] and won ($0.63) with a full house, Kings full of Fives
Seat 4: Daurado (big blind) mucked
Seat 5: Impostore1988 folded before Flop (didn't bet)
Seat 6: nickpotss38 folded before Flop (didn't bet)



PokerStars Hand #222959282127:  Hold'em No Limit ($0.05/$0.10 USD) - 2021/01/23 11:35:12 ET
Table 'Stephano III' 6-max Seat #3 is the button
Seat 1: Intimitatem ($13.09 in chips) 
Seat 2: Hollseg ($13.58 in chips) 
Seat 3: atticus1401 ($10.44 in chips) 
Seat 4: Daurado ($20.61 in chips) 
Seat 5: Impostore1988 ($10 in chips) 
Seat 6: nickpotss38 ($6 in chips) 
Daurado: posts small blind $0.05
Impostore1988: posts big blind $0.10
*** HOLE CARDS ***
nickpotss38: folds 
Intimitatem: folds 
Hollseg: folds 
atticus1401: calls $0.10
Daurado: calls $0.05
Impostore1988: checks 
*** FLOP *** [Qs 6h 3d]
Daurado: checks 
Impostore1988: checks 
atticus1401: bets $0.29
Daurado: folds 
Impostore1988: folds 
Uncalled bet ($0.29) returned to atticus1401
atticus1401 collected $0.29 from pot
atticus1401: doesn't show hand 
*** SUMMARY ***
Total pot $0.30 | Rake $0.01 
Board [Qs 6h 3d]
Seat 1: Intimitatem folded before Flop (didn't bet)
Seat 2: Hollseg folded before Flop (didn't bet)
Seat 3: atticus1401 (button) collected ($0.29)
Seat 4: Daurado (small blind) folded on the Flop
Seat 5: Impostore1988 (big blind) folded on the Flop
Seat 6: nickpotss38 folded before Flop (didn't bet)



PokerStars Hand #222959301823:  Hold'em No Limit ($0.05/$0.10 USD) - 2021/01/23 11:35:44 ET
Table 'Stephano III' 6-max Seat #4 is the button
Seat 1: Intimitatem ($13.09 in chips) 
Seat 2: Hollseg ($13.58 in chips) 
Seat 3: atticus1401 ($10.63 in chips) 
Seat 4: Daurado ($20.51 in chips) 
Seat 5: Impostore1988 ($9.90 in chips) 
Seat 6: nickpotss38 ($6 in chips) 
Impostore1988: posts small blind $0.05
nickpotss38: posts big blind $0.10
*** HOLE CARDS ***
Intimitatem: folds 
Hollseg: raises $0.20 to $0.30
atticus1401: folds 
Daurado: folds 
Impostore1988: folds 
nickpotss38: folds 
Uncalled bet ($0.20) returned to Hollseg
Hollseg collected $0.25 from pot
Hollseg: doesn't show hand 
*** SUMMARY ***
Total pot $0.25 | Rake $0 
Seat 1: Intimitatem folded before Flop (didn't bet)
Seat 2: Hollseg collected ($0.25)
Seat 3: atticus1401 folded before Flop (didn't bet)
Seat 4: Daurado (button) folded before Flop (didn't bet)
Seat 5: Impostore1988 (small blind) folded before Flop
Seat 6: nickpotss38 (big blind) folded before Flop



PokerStars Hand #222959310845:  Hold'em No Limit ($0.05/$0.10 USD) - 2021/01/23 11:35:58 ET
Table 'Stephano III' 6-max Seat #5 is the button
Seat 1: Intimitatem ($13.09 in chips) 
Seat 2: Hollseg ($13.73 in chips) 
Seat 3: atticus1401 ($10.63 in chips) 
Seat 4: Daurado ($20.51 in chips) 
Seat 5: Impostore1988 ($9.85 in chips) 
Seat 6: nickpotss38 ($5.90 in chips) 
nickpotss38: posts small blind $0.05
Intimitatem: posts big blind $0.10
*** HOLE CARDS ***
Hollseg: folds 
atticus1401: folds 
Daurado: folds 
Impostore1988: folds 
nickpotss38: folds 
Uncalled bet ($0.05) returned to Intimitatem
Intimitatem collected $0.10 from pot
Intimitatem: doesn't show hand 
*** SUMMARY ***
Total pot $0.10 | Rake $0 
Seat 1: Intimitatem (big blind) collected ($0.10)
Seat 2: Hollseg folded before Flop (didn't bet)
Seat 3: atticus1401 folded before Flop (didn't bet)
Seat 4: Daurado folded before Flop (didn't bet)
Seat 5: Impostore1988 (button) folded before Flop (didn't bet)
Seat 6: nickpotss38 (small blind) folded before Flop



PokerStars Hand #222959316388:  Hold'em No Limit ($0.05/$0.10 USD) - 2021/01/23 11:36:07 ET
Table 'Stephano III' 6-max Seat #6 is the button
Seat 1: Intimitatem ($13.14 in chips) 
Seat 2: Hollseg ($13.73 in chips) 
Seat 3: atticus1401 ($10.63 in chips) 
Seat 4: Daurado ($20.51 in chips) 
Seat 5: Impostore1988 ($9.85 in chips) 
Seat 6: nickpotss38 ($5.85 in chips) 
Intimitatem: posts small blind $0.05
Hollseg: posts big blind $0.10
*** HOLE CARDS ***
atticus1401: folds 
Daurado: folds 
Impostore1988: raises $0.20 to $0.30
nickpotss38: folds 
Intimitatem: folds 
Hollseg: folds 
Uncalled bet ($0.20) returned to Impostore1988
Impostore1988 collected $0.25 from pot
Impostore1988: doesn't show hand 
*** SUMMARY ***
Total pot $0.25 | Rake $0 
Seat 1: Intimitatem (small blind) folded before Flop
Seat 2: Hollseg (big blind) folded before Flop
Seat 3: atticus1401 folded before Flop (didn't bet)
Seat 4: Daurado folded before Flop (didn't bet)
Seat 5: Impostore1988 collected ($0.25)
Seat 6: nickpotss38 (button) folded before Flop (didn't bet)



PokerStars Hand #222959325089:  Hold'em No Limit ($0.05/$0.10 USD) - 2021/01/23 11:36:21 ET
Table 'Stephano III' 6-max Seat #1 is the button
Seat 1: Intimitatem ($13.09 in chips) 
Seat 2: Hollseg ($13.63 in chips) 
Seat 3: atticus1401 ($10.63 in chips) 
Seat 4: Daurado ($20.51 in chips) 
Seat 5: Impostore1988 ($10 in chips) 
Seat 6: nickpotss38 ($5.85 in chips) 
Hollseg: posts small blind $0.05
atticus1401: posts big blind $0.10
*** HOLE CARDS ***
Daurado: raises $0.20 to $0.30
Impostore1988: folds 
nickpotss38: calls $0.30
Intimitatem: folds 
Hollseg: folds 
atticus1401: folds 
*** FLOP *** [7d Th 4c]
Daurado: checks 
nickpotss38: bets $0.36
Daurado: folds 
Uncalled bet ($0.36) returned to nickpotss38
nickpotss38 collected $0.72 from pot
nickpotss38: doesn't show hand 
*** SUMMARY ***
Total pot $0.75 | Rake $0.03 
Board [7d Th 4c]
Seat 1: Intimitatem (button) folded before Flop (didn't bet)
Seat 2: Hollseg (small blind) folded before Flop
Seat 3: atticus1401 (big blind) folded before Flop
Seat 4: Daurado folded on the Flop
Seat 5: Impostore1988 folded before Flop (didn't bet)
Seat 6: nickpotss38 collected ($0.72)



PokerStars Hand #222959335958:  Hold'em No Limit ($0.05/$0.10 USD) - 2021/01/23 11:36:39 ET
Table 'Stephano III' 6-max Seat #2 is the button
Seat 1: Intimitatem ($13.09 in chips) 
Seat 2: Hollseg ($13.58 in chips) 
Seat 3: atticus1401 ($10.53 in chips) 
Seat 4: Daurado ($20.21 in chips) 
Seat 5: Impostore1988 ($10 in chips) 
Seat 6: nickpotss38 ($6.27 in chips) 
atticus1401: posts small blind $0.05
Daurado: posts big blind $0.10
*** HOLE CARDS ***
Impostore1988: folds 
nickpotss38: folds 
Intimitatem: folds 
Hollseg: folds 
atticus1401: calls $0.05
Daurado: checks 
*** FLOP *** [Kd 9h 2c]
atticus1401: checks 
Daurado: checks 
*** TURN *** [Kd 9h 2c] [9s]
atticus1401: checks 
Daurado: checks 
*** RIVER *** [Kd 9h 2c 9s] [6h]
atticus1401: checks 
Daurado: checks 
*** SHOW DOWN ***
atticus1401: shows [Jd 7s] (a pair of Nines)
Daurado: shows [6s Qh] (two pair, Nines and Sixes)
Daurado collected $0.19 from pot
*** SUMMARY ***
Total pot $0.20 | Rake $0.01 
Board [Kd 9h 2c 9s 6h]
Seat 1: Intimitatem folded before Flop (didn't bet)
Seat 2: Hollseg (button) folded before Flop (didn't bet)
Seat 3: atticus1401 (small blind) showed [Jd 7s] and lost with a pair of Nines
Seat 4: Daurado (big blind) showed [6s Qh] and won ($0.19) with two pair, Nines and Sixes
Seat 5: Impostore1988 folded before Flop (didn't bet)
Seat 6: nickpotss38 folded before Flop (didn't bet)



PokerStars Hand #222959350778:  Hold'em No Limit ($0.05/$0.10 USD) - 2021/01/23 11:37:03 ET
Table 'Stephano III' 6-max Seat #3 is the button
Seat 1: Intimitatem ($13.09 in chips) 
Seat 2: Hollseg ($13.58 in chips) 
Seat 3: atticus1401 ($10.43 in chips) 
Seat 4: Daurado ($20.30 in chips) 
Seat 5: Impostore1988 ($10 in chips) 
Seat 6: nickpotss38 ($6.27 in chips) 
Daurado: posts small blind $0.05
Impostore1988: posts big blind $0.10
*** HOLE CARDS ***
nickpotss38: folds 
Intimitatem: raises $0.12 to $0.22
Hollseg: folds 
atticus1401: folds 
Daurado: folds 
Impostore1988: folds 
Uncalled bet ($0.12) returned to Intimitatem
Intimitatem collected $0.25 from pot
Intimitatem: doesn't show hand 
*** SUMMARY ***
Total pot $0.25 | Rake $0 
Seat 1: Intimitatem collected ($0.25)
Seat 2: Hollseg folded before Flop (didn't bet)
Seat 3: atticus1401 (button) folded before Flop (didn't bet)
Seat 4: Daurado (small blind) folded before Flop
Seat 5: Impostore1988 (big blind) folded before Flop
Seat 6: nickpotss38 folded before Flop (didn't bet)



PokerStars Hand #222959359835:  Hold'em No Limit ($0.05/$0.10 USD) - 2021/01/23 11:37:18 ET
Table 'Stephano III' 6-max Seat #4 is the button
Seat 1: Intimitatem ($13.24 in chips) 
Seat 2: Hollseg ($13.58 in chips) 
Seat 3: atticus1401 ($10.43 in chips) 
Seat 4: Daurado ($20.25 in chips) 
Seat 5: Impostore1988 ($9.90 in chips) 
Seat 6: nickpotss38 ($6.27 in chips) 
Impostore1988: posts small blind $0.05
nickpotss38: posts big blind $0.10
*** HOLE CARDS ***
Intimitatem: folds 
Hollseg: folds 
atticus1401: folds 
Daurado: folds 
Impostore1988: folds 
Uncalled bet ($0.05) returned to nickpotss38
nickpotss38 collected $0.10 from pot
nickpotss38: doesn't show hand 
*** SUMMARY ***
Total pot $0.10 | Rake $0 
Seat 1: Intimitatem folded before Flop (didn't bet)
Seat 2: Hollseg folded before Flop (didn't bet)
Seat 3: atticus1401 folded before Flop (didn't bet)
Seat 4: Daurado (button) folded before Flop (didn't bet)
Seat 5: Impostore1988 (small blind) folded before Flop
Seat 6: nickpotss38 (big blind) collected ($0.10)



PokerStars Hand #222959366473:  Hold'em No Limit ($0.05/$0.10 USD) - 2021/01/23 11:37:29 ET
Table 'Stephano III' 6-max Seat #5 is the button
Seat 1: Intimitatem ($13.24 in chips) 
Seat 2: Hollseg ($13.58 in chips) 
Seat 3: atticus1401 ($10.43 in chips) 
Seat 4: Daurado ($20.25 in chips) 
Seat 5: Impostore1988 ($9.85 in chips) 
Seat 6: nickpotss38 ($6.32 in chips) 
nickpotss38: posts small blind $0.05
Intimitatem: posts big blind $0.10
*** HOLE CARDS ***
Hollseg: folds 
atticus1401: folds 
Daurado: raises $0.15 to $0.25
Impostore1988: folds 
nickpotss38: calls $0.20
Intimitatem: calls $0.15
*** FLOP *** [6d 8s 5d]
nickpotss38: checks 
Intimitatem: checks 
Daurado: checks 
*** TURN *** [6d 8s 5d] [Th]
nickpotss38: checks 
Intimitatem: checks 
Daurado: checks 
*** RIVER *** [6d 8s 5d Th] [5s]
nickpotss38: bets $0.10
Intimitatem: folds 
Daurado: folds 
Uncalled bet ($0.10) returned to nickpotss38
nickpotss38 collected $0.72 from pot
nickpotss38: doesn't show hand 
*** SUMMARY ***
Total pot $0.75 | Rake $0.03 
Board [6d 8s 5d Th 5s]
Seat 1: Intimitatem (big blind) folded on the River
Seat 2: Hollseg folded before Flop (didn't bet)
Seat 3: atticus1401 folded before Flop (didn't bet)
Seat 4: Daurado folded on the River
Seat 5: Impostore1988 (button) folded before Flop (didn't bet)
Seat 6: nickpotss38 (small blind) collected ($0.72)



PokerStars Hand #222959411649:  Hold'em No Limit ($0.05/$0.10 USD) - 2021/01/23 11:38:43 ET
Table 'Stephano III' 6-max Seat #6 is the button
Seat 1: Intimitatem ($12.99 in chips) 
Seat 2: Hollseg ($13.58 in chips) 
Seat 3: atticus1401 ($10.43 in chips) 
Seat 4: Daurado ($20 in chips) 
Seat 5: Impostore1988 ($9.85 in chips) 
Seat 6: nickpotss38 ($6.79 in chips) 
Intimitatem: posts small blind $0.05
Hollseg: posts big blind $0.10
*** HOLE CARDS ***
atticus1401: folds 
Daurado: raises $0.20 to $0.30
Impostore1988 has timed out
Impostore1988: folds 
nickpotss38: folds 
Intimitatem: folds 
Hollseg: folds 
Uncalled bet ($0.20) returned to Daurado
Daurado collected $0.25 from pot
Daurado: doesn't show hand 
*** SUMMARY ***
Total pot $0.25 | Rake $0 
Seat 1: Intimitatem (small blind) folded before Flop
Seat 2: Hollseg (big blind) folded before Flop
Seat 3: atticus1401 folded before Flop (didn't bet)
Seat 4: Daurado collected ($0.25)
Seat 5: Impostore1988 folded before Flop (didn't bet)
Seat 6: nickpotss38 (button) folded before Flop (didn't bet)



PokerStars Hand #222959427591:  Hold'em No Limit ($0.05/$0.10 USD) - 2021/01/23 11:39:09 ET
Table 'Stephano III' 6-max Seat #1 is the button
Seat 1: Intimitatem ($12.94 in chips) 
Seat 2: Hollseg ($13.48 in chips) 
Seat 3: atticus1401 ($10.43 in chips) 
Seat 4: Daurado ($20.15 in chips) 
Seat 6: nickpotss38 ($6.79 in chips) 
Hollseg: posts small blind $0.05
atticus1401: posts big blind $0.10
*** HOLE CARDS ***
Daurado: folds 
nickpotss38: calls $0.10
Intimitatem: folds 
Hollseg: folds 
atticus1401: checks 
*** FLOP *** [9c 4s Qh]
atticus1401: bets $0.24
nickpotss38: calls $0.24
*** TURN *** [9c 4s Qh] [3h]
atticus1401: bets $0.35
nickpotss38: calls $0.35
*** RIVER *** [9c 4s Qh 3h] [Ad]
atticus1401: checks 
nickpotss38: checks 
*** SHOW DOWN ***
atticus1401: shows [5d 9s] (a pair of Nines)
nickpotss38: shows [8s Qd] (a pair of Queens)
nickpotss38 collected $1.37 from pot
*** SUMMARY ***
Total pot $1.43 | Rake $0.06 
Board [9c 4s Qh 3h Ad]
Seat 1: Intimitatem (button) folded before Flop (didn't bet)
Seat 2: Hollseg (small blind) folded before Flop
Seat 3: atticus1401 (big blind) showed [5d 9s] and lost with a pair of Nines
Seat 4: Daurado folded before Flop (didn't bet)
Seat 6: nickpotss38 showed [8s Qd] and won ($1.37) with a pair of Queens



PokerStars Hand #222959451658:  Hold'em No Limit ($0.05/$0.10 USD) - 2021/01/23 11:39:48 ET
Table 'Stephano III' 6-max Seat #2 is the button
Seat 1: Intimitatem ($12.94 in chips) 
Seat 2: Hollseg ($13.43 in chips) 
Seat 3: atticus1401 ($9.74 in chips) 
Seat 4: Daurado ($20.15 in chips) 
Seat 5: Impostore1988 ($9.85 in chips) 
Seat 6: nickpotss38 ($7.47 in chips) 
atticus1401: posts small blind $0.05
Daurado: posts big blind $0.10
*** HOLE CARDS ***
Impostore1988 has timed out
Impostore1988: folds 
nickpotss38: calls $0.10
Intimitatem: folds 
Hollseg: raises $0.20 to $0.30
atticus1401: calls $0.25
Daurado: folds 
nickpotss38: calls $0.20
*** FLOP *** [6d 8h 2h]
atticus1401: checks 
nickpotss38: checks 
Hollseg: checks 
*** TURN *** [6d 8h 2h] [Jh]
atticus1401: bets $0.48
nickpotss38: folds 
Hollseg: folds 
Uncalled bet ($0.48) returned to atticus1401
atticus1401 collected $0.96 from pot
atticus1401: doesn't show hand 
*** SUMMARY ***
Total pot $1 | Rake $0.04 
Board [6d 8h 2h Jh]
Seat 1: Intimitatem folded before Flop (didn't bet)
Seat 2: Hollseg (button) folded on the Turn
Seat 3: atticus1401 (small blind) collected ($0.96)
Seat 4: Daurado (big blind) folded before Flop
Seat 5: Impostore1988 folded before Flop (didn't bet)
Seat 6: nickpotss38 folded on the Turn



PokerStars Hand #222959475596:  Hold'em No Limit ($0.05/$0.10 USD) - 2021/01/23 11:40:27 ET
Table 'Stephano III' 6-max Seat #3 is the button
Seat 1: Intimitatem ($12.94 in chips) 
Seat 2: Hollseg ($13.13 in chips) 
Seat 3: atticus1401 ($10.40 in chips) 
Seat 4: Daurado ($20.05 in chips) 
Seat 5: Impostore1988 ($9.85 in chips) 
Seat 6: nickpotss38 ($7.17 in chips) 
Daurado: posts small blind $0.05
Impostore1988: posts big blind $0.10
*** HOLE CARDS ***
nickpotss38: folds 
Intimitatem: folds 
Hollseg: raises $0.15 to $0.25
atticus1401: calls $0.25
Daurado: folds 
Impostore1988: calls $0.15
*** FLOP *** [7s 7d As]
Impostore1988: checks 
Hollseg: bets $0.25
atticus1401: calls $0.25
Impostore1988: folds 
*** TURN *** [7s 7d As] [7c]
Hollseg: checks 
atticus1401: bets $0.62
Hollseg: folds 
Uncalled bet ($0.62) returned to atticus1401
atticus1401 collected $1.24 from pot
atticus1401: doesn't show hand 
*** SUMMARY ***
Total pot $1.30 | Rake $0.06 
Board [7s 7d As 7c]
Seat 1: Intimitatem folded before Flop (didn't bet)
Seat 2: Hollseg folded on the Turn
Seat 3: atticus1401 (button) collected ($1.24)
Seat 4: Daurado (small blind) folded before Flop
Seat 5: Impostore1988 (big blind) folded on the Flop
Seat 6: nickpotss38 folded before Flop (didn't bet)



PokerStars Hand #222959499760:  Hold'em No Limit ($0.05/$0.10 USD) - 2021/01/23 11:41:06 ET
Table 'Stephano III' 6-max Seat #4 is the button
Seat 1: Intimitatem ($12.94 in chips) 
Seat 2: Hollseg ($12.63 in chips) 
Seat 3: atticus1401 ($11.14 in chips) 
Seat 4: Daurado ($20 in chips) 
Seat 5: Impostore1988 ($9.60 in chips) 
Seat 6: nickpotss38 ($7.17 in chips) 
Impostore1988: posts small blind $0.05
nickpotss38: posts big blind $0.10
*** HOLE CARDS ***
Intimitatem: folds 
Hollseg: folds 
atticus1401: folds 
Daurado: folds 
Impostore1988: folds 
Uncalled bet ($0.05) returned to nickpotss38
nickpotss38 collected $0.10 from pot
nickpotss38: doesn't show hand 
*** SUMMARY ***
Total pot $0.10 | Rake $0 
Seat 1: Intimitatem folded before Flop (didn't bet)
Seat 2: Hollseg folded before Flop (didn't bet)
Seat 3: atticus1401 folded before Flop (didn't bet)
Seat 4: Daurado (button) folded before Flop (didn't bet)
Seat 5: Impostore1988 (small blind) folded before Flop
Seat 6: nickpotss38 (big blind) collected ($0.10)



PokerStars Hand #222959507159:  Hold'em No Limit ($0.05/$0.10 USD) - 2021/01/23 11:41:18 ET
Table 'Stephano III' 6-max Seat #5 is the button
Seat 1: Intimitatem ($12.94 in chips) 
Seat 2: Hollseg ($12.63 in chips) 
Seat 3: atticus1401 ($11.14 in chips) 
Seat 4: Daurado ($20 in chips) 
Seat 5: Impostore1988 ($9.55 in chips) 
Seat 6: nickpotss38 ($7.22 in chips) 
nickpotss38: posts small blind $0.05
Intimitatem: posts big blind $0.10
*** HOLE CARDS ***
Hollseg: folds 
atticus1401: folds 
Daurado: folds 
Impostore1988: folds 
nickpotss38: raises $0.20 to $0.30
Intimitatem: calls $0.20
*** FLOP *** [9s 3c 8d]
nickpotss38: bets $0.57
Intimitatem: folds 
Uncalled bet ($0.57) returned to nickpotss38
nickpotss38 collected $0.57 from pot
nickpotss38: doesn't show hand 
*** SUMMARY ***
Total pot $0.60 | Rake $0.03 
Board [9s 3c 8d]
Seat 1: Intimitatem (big blind) folded on the Flop
Seat 2: Hollseg folded before Flop (didn't bet)
Seat 3: atticus1401 folded before Flop (didn't bet)
Seat 4: Daurado folded before Flop (didn't bet)
Seat 5: Impostore1988 (button) folded before Flop (didn't bet)
Seat 6: nickpotss38 (small blind) collected ($0.57)



PokerStars Hand #222959523922:  Hold'em No Limit ($0.05/$0.10 USD) - 2021/01/23 11:41:46 ET
Table 'Stephano III' 6-max Seat #6 is the button
Seat 1: Intimitatem ($12.64 in chips) 
Seat 2: Hollseg ($12.63 in chips) 
Seat 3: atticus1401 ($11.14 in chips) 
Seat 4: Daurado ($20 in chips) 
Seat 5: Impostore1988 ($9.55 in chips) 
Seat 6: nickpotss38 ($7.49 in chips) 
Intimitatem: posts small blind $0.05
Hollseg: posts big blind $0.10
*** HOLE CARDS ***
atticus1401: raises $0.20 to $0.30
Daurado: folds 
Impostore1988: folds 
nickpotss38: folds 
Intimitatem: folds 
Hollseg: folds 
Uncalled bet ($0.20) returned to atticus1401
atticus1401 collected $0.25 from pot
atticus1401: doesn't show hand 
*** SUMMARY ***
Total pot $0.25 | Rake $0 
Seat 1: Intimitatem (small blind) folded before Flop
Seat 2: Hollseg (big blind) folded before Flop
Seat 3: atticus1401 collected ($0.25)
Seat 4: Daurado folded before Flop (didn't bet)
Seat 5: Impostore1988 folded before Flop (didn't bet)
Seat 6: nickpotss38 (button) folded before Flop (didn't bet)



PokerStars Hand #222960101005:  Hold'em No Limit ($0.05/$0.10 USD) - 2021/01/23 11:57:50 ET
Table 'Stephano III' 6-max Seat #6 is the button
Seat 2: Hollseg ($10.59 in chips) 
Seat 3: eldar919 ($10 in chips) 
Seat 5: Impostore1988 ($12.49 in chips) 
Seat 6: nickpotss38 ($8.14 in chips) 
Hollseg: posts small blind $0.05
eldar919: posts big blind $0.10
*** HOLE CARDS ***
Impostore1988: folds 
nickpotss38: folds 
Hollseg: raises $0.20 to $0.30
eldar919: calls $0.20
*** FLOP *** [8d 4h As]
Hollseg: checks 
eldar919: checks 
*** TURN *** [8d 4h As] [Jh]
Hollseg: bets $0.20
Leonid AK74 is disconnected 
Daurado leaves the table
eldar919: raises $0.49 to $0.69
Hollseg: calls $0.49
*** RIVER *** [8d 4h As Jh] [Kd]
Hollseg: checks 
eldar919: bets $1.26
jorgeebanks joins the table at seat #4 
Hollseg: folds 
Uncalled bet ($1.26) returned to eldar919
eldar919 collected $1.89 from pot
eldar919: doesn't show hand 
*** SUMMARY ***
Total pot $1.98 | Rake $0.09 
Board [8d 4h As Jh Kd]
Seat 2: Hollseg (small blind) folded on the River
Seat 3: eldar919 (big blind) collected ($1.89)
Seat 5: Impostore1988 folded before Flop (didn't bet)
Seat 6: nickpotss38 (button) folded before Flop (didn't bet)



PokerStars Hand #222960137584:  Hold'em No Limit ($0.05/$0.10 USD) - 2021/01/23 11:59:07 ET
Table 'Stephano III' 6-max Seat #2 is the button
Seat 2: Hollseg ($10 in chips) 
Seat 3: eldar919 ($10.90 in chips) 
Seat 4: jorgeebanks ($10 in chips) 
Seat 5: Impostore1988 ($12.49 in chips) 
Seat 6: nickpotss38 ($8.14 in chips) 
eldar919: posts small blind $0.05
jorgeebanks: posts big blind $0.10
Leonid AK74 has timed out while disconnected
Leonid AK74: is sitting out 
*** HOLE CARDS ***
Impostore1988: folds 
nickpotss38: folds 
Hollseg: raises $0.15 to $0.25
eldar919: folds 
jorgeebanks: folds 
Uncalled bet ($0.15) returned to Hollseg
Hollseg collected $0.25 from pot
Hollseg: doesn't show hand 
*** SUMMARY ***
Total pot $0.25 | Rake $0 
Seat 2: Hollseg (button) collected ($0.25)
Seat 3: eldar919 (small blind) folded before Flop
Seat 4: jorgeebanks (big blind) folded before Flop
Seat 5: Impostore1988 folded before Flop (didn't bet)
Seat 6: nickpotss38 folded before Flop (didn't bet)



PokerStars Hand #222960147431:  Hold'em No Limit ($0.05/$0.10 USD) - 2021/01/23 11:59:28 ET
Table 'Stephano III' 6-max Seat #3 is the button
Seat 2: Hollseg ($10.15 in chips) 
Seat 3: eldar919 ($10.85 in chips) 
Seat 4: jorgeebanks ($9.90 in chips) 
Seat 5: Impostore1988 ($12.49 in chips) 
Seat 6: nickpotss38 ($8.14 in chips) 
jorgeebanks: posts small blind $0.05
Impostore1988: posts big blind $0.10
*** HOLE CARDS ***
nickpotss38: folds 
Hollseg: folds 
eldar919: folds 
jorgeebanks: folds 
Uncalled bet ($0.05) returned to Impostore1988
Impostore1988 collected $0.10 from pot
Impostore1988: doesn't show hand 
*** SUMMARY ***
Total pot $0.10 | Rake $0 
Seat 2: Hollseg folded before Flop (didn't bet)
Seat 3: eldar919 (button) folded before Flop (didn't bet)
Seat 4: jorgeebanks (small blind) folded before Flop
Seat 5: Impostore1988 (big blind) collected ($0.10)
Seat 6: nickpotss38 folded before Flop (didn't bet)



PokerStars Hand #222960153295:  Hold'em No Limit ($0.05/$0.10 USD) - 2021/01/23 11:59:40 ET
Table 'Stephano III' 6-max Seat #4 is the button
Seat 2: Hollseg ($10.15 in chips) 
Seat 3: eldar919 ($10.85 in chips) 
Seat 4: jorgeebanks ($9.85 in chips) 
Seat 5: Impostore1988 ($12.54 in chips) 
Seat 6: nickpotss38 ($8.14 in chips) 
Impostore1988: posts small blind $0.05
nickpotss38: posts big blind $0.10
*** HOLE CARDS ***
Hollseg: folds 
eldar919: raises $0.20 to $0.30
jorgeebanks: folds 
jorgeebanks leaves the table
APG10000 joins the table at seat #4 
Impostore1988: folds 
nickpotss38: calls $0.20
*** FLOP *** [5c 9s Qs]
nickpotss38: checks 
eldar919: bets $0.40
APG10000 leaves the table
nickpotss38: folds 
Uncalled bet ($0.40) returned to eldar919
eldar919 collected $0.62 from pot
eldar919: doesn't show hand 
*** SUMMARY ***
Total pot $0.65 | Rake $0.03 
Board [5c 9s Qs]
Seat 2: Hollseg folded before Flop (didn't bet)
Seat 3: eldar919 collected ($0.62)
Seat 4: jorgeebanks (button) folded before Flop (didn't bet)
Seat 5: Impostore1988 (small blind) folded before Flop
Seat 6: nickpotss38 (big blind) folded on the Flop



PokerStars Hand #222960170572:  Hold'em No Limit ($0.05/$0.10 USD) - 2021/01/23 12:00:15 ET
Table 'Stephano III' 6-max Seat #5 is the button
Seat 2: Hollseg ($10.15 in chips) 
Seat 3: eldar919 ($11.17 in chips) 
Seat 5: Impostore1988 ($12.49 in chips) 
Seat 6: nickpotss38 ($7.84 in chips) 
nickpotss38: posts small blind $0.05
Hollseg: posts big blind $0.10
*** HOLE CARDS ***
eldar919: folds 
Impostore1988: folds 
khv)miz joins the table at seat #4 
nickpotss38: calls $0.05
Hollseg: checks 
*** FLOP *** [7s 2d 2h]
nickpotss38: checks 
Hollseg: checks 
*** TURN *** [7s 2d 2h] [Ts]
nickpotss38: bets $0.10
Hollseg: folds 
Uncalled bet ($0.10) returned to nickpotss38
nickpotss38 collected $0.19 from pot
nickpotss38: doesn't show hand 
*** SUMMARY ***
Total pot $0.20 | Rake $0.01 
Board [7s 2d 2h Ts]
Seat 2: Hollseg (big blind) folded on the Turn
Seat 3: eldar919 folded before Flop (didn't bet)
Seat 5: Impostore1988 (button) folded before Flop (didn't bet)
Seat 6: nickpotss38 (small blind) collected ($0.19)



PokerStars Hand #222960189169:  Hold'em No Limit ($0.05/$0.10 USD) - 2021/01/23 12:00:52 ET
Table 'Stephano III' 6-max Seat #6 is the button
Seat 2: Hollseg ($10.05 in chips) 
Seat 3: eldar919 ($11.17 in chips) 
Seat 4: khv)miz ($10 in chips) 
Seat 5: Impostore1988 ($12.49 in chips) 
Seat 6: nickpotss38 ($7.93 in chips) 
Hollseg: posts small blind $0.05
eldar919: posts big blind $0.10
khv)miz: posts big blind $0.10
*** HOLE CARDS ***
khv)miz: raises $0.20 to $0.30
Impostore1988: folds 
nickpotss38: folds 
Hollseg: folds 
eldar919: calls $0.20
*** FLOP *** [6c Kc 9h]
eldar919: checks 
khv)miz: bets $0.31
eldar919: raises $0.44 to $0.75
khv)miz: calls $0.44
*** TURN *** [6c Kc 9h] [2s]
eldar919: checks 
khv)miz: checks 
*** RIVER *** [6c Kc 9h 2s] [6h]
eldar919: bets $1.37
khv)miz: folds 
Uncalled bet ($1.37) returned to eldar919
eldar919 collected $2.05 from pot
eldar919: doesn't show hand 
*** SUMMARY ***
Total pot $2.15 | Rake $0.10 
Board [6c Kc 9h 2s 6h]
Seat 2: Hollseg (small blind) folded before Flop
Seat 3: eldar919 (big blind) collected ($2.05)
Seat 4: khv)miz folded on the River
Seat 5: Impostore1988 folded before Flop (didn't bet)
Seat 6: nickpotss38 (button) folded before Flop (didn't bet)



PokerStars Hand #222960217917:  Hold'em No Limit ($0.05/$0.10 USD) - 2021/01/23 12:01:29 ET
Table 'Stephano III' 6-max Seat #2 is the button
Seat 2: Hollseg ($10 in chips) 
Seat 3: eldar919 ($12.17 in chips) 
Seat 4: khv)miz ($8.95 in chips) 
Seat 5: Impostore1988 ($12.49 in chips) 
Seat 6: nickpotss38 ($7.93 in chips) 
eldar919: posts small blind $0.05
khv)miz: posts big blind $0.10
*** HOLE CARDS ***
Impostore1988: folds 
nickpotss38: folds 
Hollseg: folds 
eldar919: raises $0.20 to $0.30
khv)miz: calls $0.20
*** FLOP *** [Qc 3d 6c]
eldar919: bets $0.29
khv)miz: calls $0.29
*** TURN *** [Qc 3d 6c] [3c]
eldar919: bets $0.57
khv)miz: folds 
Uncalled bet ($0.57) returned to eldar919
eldar919 collected $1.13 from pot
eldar919: doesn't show hand 
*** SUMMARY ***
Total pot $1.18 | Rake $0.05 
Board [Qc 3d 6c 3c]
Seat 2: Hollseg (button) folded before Flop (didn't bet)
Seat 3: eldar919 (small blind) collected ($1.13)
Seat 4: khv)miz (big blind) folded on the Turn
Seat 5: Impostore1988 folded before Flop (didn't bet)
Seat 6: nickpotss38 folded before Flop (didn't bet)



PokerStars Hand #222960246811:  Hold'em No Limit ($0.05/$0.10 USD) - 2021/01/23 12:02:16 ET
Table 'Stephano III' 6-max Seat #3 is the button
Seat 2: Hollseg ($10 in chips) 
Seat 3: eldar919 ($12.71 in chips) 
Seat 4: khv)miz ($8.36 in chips) 
Seat 5: Impostore1988 ($12.49 in chips) 
Seat 6: nickpotss38 ($7.93 in chips) 
khv)miz: posts small blind $0.05
Impostore1988: posts big blind $0.10
*** HOLE CARDS ***
nickpotss38: raises $0.10 to $0.20
Hollseg: folds 
eldar919: calls $0.20
khv)miz: folds 
Impostore1988: folds 
*** FLOP *** [As 4h 6d]
nickpotss38: checks 
eldar919: bets $0.35
nickpotss38 is disconnected 
nickpotss38 has timed out while disconnected
nickpotss38: folds 
Uncalled bet ($0.35) returned to eldar919
eldar919 collected $0.53 from pot
eldar919: doesn't show hand 
*** SUMMARY ***
Total pot $0.55 | Rake $0.02 
Board [As 4h 6d]
Seat 2: Hollseg folded before Flop (didn't bet)
Seat 3: eldar919 (button) collected ($0.53)
Seat 4: khv)miz (small blind) folded before Flop
Seat 5: Impostore1988 (big blind) folded before Flop
Seat 6: nickpotss38 folded on the Flop



PokerStars Hand #222960281239:  Hold'em No Limit ($0.05/$0.10 USD) - 2021/01/23 12:03:12 ET
Table 'Stephano III' 6-max Seat #4 is the button
Seat 2: Hollseg ($10 in chips) 
Seat 3: eldar919 ($13.04 in chips) 
Seat 4: khv)miz ($8.31 in chips) 
Seat 5: Impostore1988 ($12.39 in chips) 
Impostore1988: posts small blind $0.05
Hollseg: posts big blind $0.10
*** HOLE CARDS ***
eldar919: folds 
khv)miz: folds 
Impostore1988: folds 
Uncalled bet ($0.05) returned to Hollseg
Hollseg collected $0.10 from pot
Hollseg: doesn't show hand 
*** SUMMARY ***
Total pot $0.10 | Rake $0 
Seat 2: Hollseg (big blind) collected ($0.10)
Seat 3: eldar919 folded before Flop (didn't bet)
Seat 4: khv)miz (button) folded before Flop (didn't bet)
Seat 5: Impostore1988 (small blind) folded before Flop



PokerStars Hand #222960286912:  Hold'em No Limit ($0.05/$0.10 USD) - 2021/01/23 12:03:21 ET
Table 'Stephano III' 6-max Seat #5 is the button
Seat 2: Hollseg ($10.05 in chips) 
Seat 3: eldar919 ($13.04 in chips) 
Seat 4: khv)miz ($8.31 in chips) 
Seat 5: Impostore1988 ($12.34 in chips) 
Hollseg: posts small blind $0.05
eldar919: posts big blind $0.10
*** HOLE CARDS ***
khv)miz: folds 
Impostore1988: folds 
Hollseg: folds 
Uncalled bet ($0.05) returned to eldar919
eldar919 collected $0.10 from pot
eldar919: doesn't show hand 
*** SUMMARY ***
Total pot $0.10 | Rake $0 
Seat 2: Hollseg (small blind) folded before Flop
Seat 3: eldar919 (big blind) collected ($0.10)
Seat 4: khv)miz folded before Flop (didn't bet)
Seat 5: Impostore1988 (button) folded before Flop (didn't bet)



PokerStars Hand #222960291182:  Hold'em No Limit ($0.05/$0.10 USD) - 2021/01/23 12:03:28 ET
Table 'Stephano III' 6-max Seat #2 is the button
Seat 2: Hollseg ($10 in chips) 
Seat 3: eldar919 ($13.09 in chips) 
Seat 4: khv)miz ($8.31 in chips) 
Seat 5: Impostore1988 ($12.34 in chips) 
eldar919: posts small blind $0.05
khv)miz: posts big blind $0.10
*** HOLE CARDS ***
Impostore1988: folds 
Hollseg: raises $0.15 to $0.25
eldar919: folds 
khv)miz: calls $0.15
*** FLOP *** [5s 3c 6s]
khv)miz: checks 
Hollseg: checks 
*** TURN *** [5s 3c 6s] [Jc]
khv)miz: checks 
Hollseg: checks 
*** RIVER *** [5s 3c 6s Jc] [Kh]
khv)miz: checks 
Hollseg: checks 
*** SHOW DOWN ***
khv)miz: shows [Td Kd] (a pair of Kings)
Hollseg: mucks hand 
khv)miz collected $0.53 from pot
*** SUMMARY ***
Total pot $0.55 | Rake $0.02 
Board [5s 3c 6s Jc Kh]
Seat 2: Hollseg (button) mucked
Seat 3: eldar919 (small blind) folded before Flop
Seat 4: khv)miz (big blind) showed [Td Kd] and won ($0.53) with a pair of Kings
Seat 5: Impostore1988 folded before Flop (didn't bet)



PokerStars Hand #222960317185:  Hold'em No Limit ($0.05/$0.10 USD) - 2021/01/23 12:04:09 ET
Table 'Stephano III' 6-max Seat #3 is the button
Seat 2: Hollseg ($10 in chips) 
Seat 3: eldar919 ($13.04 in chips) 
Seat 4: khv)miz ($8.59 in chips) 
Seat 5: Impostore1988 ($12.34 in chips) 
Seat 6: nickpotss38 ($7.73 in chips) 
khv)miz: posts small blind $0.05
Impostore1988: posts big blind $0.10
nickpotss38: posts small & big blinds $0.15
*** HOLE CARDS ***
nickpotss38: raises $0.10 to $0.20
Hollseg: folds 
eldar919: calls $0.20
khv)miz: calls $0.15
Impostore1988: folds 
*** FLOP *** [Ts 9d Ac]
khv)miz: checks 
nickpotss38: checks 
eldar919: bets $0.36
khv)miz: folds 
nickpotss38: calls $0.36
*** TURN *** [Ts 9d Ac] [7h]
nickpotss38: checks 
eldar919: checks 
*** RIVER *** [Ts 9d Ac 7h] [Ad]
nickpotss38: checks 
eldar919: bets $0.93
nickpotss38: folds 
Uncalled bet ($0.93) returned to eldar919
eldar919 collected $1.40 from pot
eldar919: doesn't show hand 
*** SUMMARY ***
Total pot $1.47 | Rake $0.07 
Board [Ts 9d Ac 7h Ad]
Seat 2: Hollseg folded before Flop (didn't bet)
Seat 3: eldar919 (button) collected ($1.40)
Seat 4: khv)miz (small blind) folded on the Flop
Seat 5: Impostore1988 (big blind) folded before Flop
Seat 6: nickpotss38 folded on the River



PokerStars Hand #222960354902:  Hold'em No Limit ($0.05/$0.10 USD) - 2021/01/23 12:05:09 ET
Table 'Stephano III' 6-max Seat #4 is the button
Seat 2: Hollseg ($10 in chips) 
Seat 3: eldar919 ($13.88 in chips) 
Seat 4: khv)miz ($8.39 in chips) 
Seat 5: Impostore1988 ($12.24 in chips) 
Seat 6: nickpotss38 ($7.12 in chips) 
Impostore1988: posts small blind $0.05
nickpotss38: posts big blind $0.10
Leonid AK74: sits out 
*** HOLE CARDS ***
Hollseg: folds 
eldar919: folds 
khv)miz: calls $0.10
Impostore1988: raises $0.40 to $0.50
nickpotss38: folds 
khv)miz: calls $0.40
*** FLOP *** [5h Th Qd]
Impostore1988: checks 
khv)miz: checks 
*** TURN *** [5h Th Qd] [4h]
Impostore1988: checks 
khv)miz: checks 
*** RIVER *** [5h Th Qd 4h] [5c]
Impostore1988: checks 
khv)miz: bets $0.53
Impostore1988: folds 
Uncalled bet ($0.53) returned to khv)miz
khv)miz collected $1.05 from pot
khv)miz: doesn't show hand 
*** SUMMARY ***
Total pot $1.10 | Rake $0.05 
Board [5h Th Qd 4h 5c]
Seat 2: Hollseg folded before Flop (didn't bet)
Seat 3: eldar919 folded before Flop (didn't bet)
Seat 4: khv)miz (button) collected ($1.05)
Seat 5: Impostore1988 (small blind) folded on the River
Seat 6: nickpotss38 (big blind) folded before Flop



PokerStars Hand #222960379848:  Hold'em No Limit ($0.05/$0.10 USD) - 2021/01/23 12:05:49 ET
Table 'Stephano III' 6-max Seat #5 is the button
Seat 2: Hollseg ($10 in chips) 
Seat 3: eldar919 ($13.88 in chips) 
Seat 4: khv)miz ($8.94 in chips) 
Seat 5: Impostore1988 ($11.74 in chips) 
nickpotss38 is disconnected 
nickpotss38 has timed out while disconnected
nickpotss38: is sitting out 
Hollseg: posts small blind $0.05
eldar919: posts big blind $0.10
*** HOLE CARDS ***
khv)miz: folds 
Impostore1988: folds 
Hollseg: folds 
Uncalled bet ($0.05) returned to eldar919
eldar919 collected $0.10 from pot
eldar919: doesn't show hand 
*** SUMMARY ***
Total pot $0.10 | Rake $0 
Seat 2: Hollseg (small blind) folded before Flop
Seat 3: eldar919 (big blind) collected ($0.10)
Seat 4: khv)miz folded before Flop (didn't bet)
Seat 5: Impostore1988 (button) folded before Flop (didn't bet)



PokerStars Hand #222960391122:  Hold'em No Limit ($0.05/$0.10 USD) - 2021/01/23 12:06:07 ET
Table 'Stephano III' 6-max Seat #2 is the button
Seat 2: Hollseg ($9.95 in chips) 
Seat 3: eldar919 ($13.93 in chips) 
Seat 4: khv)miz ($8.94 in chips) 
Seat 5: Impostore1988 ($11.74 in chips) 
eldar919: posts small blind $0.05
khv)miz: posts big blind $0.10
Leonid AK74: sits out 
*** HOLE CARDS ***
Impostore1988: folds 
Hollseg: folds 
eldar919: folds 
Uncalled bet ($0.05) returned to khv)miz
khv)miz collected $0.10 from pot
khv)miz: doesn't show hand 
*** SUMMARY ***
Total pot $0.10 | Rake $0 
Seat 2: Hollseg (button) folded before Flop (didn't bet)
Seat 3: eldar919 (small blind) folded before Flop
Seat 4: khv)miz (big blind) collected ($0.10)
Seat 5: Impostore1988 folded before Flop (didn't bet)



PokerStars Hand #222960396397:  Hold'em No Limit ($0.05/$0.10 USD) - 2021/01/23 12:06:15 ET
Table 'Stephano III' 6-max Seat #3 is the button
Seat 2: Hollseg ($9.95 in chips) 
Seat 3: eldar919 ($13.88 in chips) 
Seat 4: khv)miz ($8.99 in chips) 
Seat 5: Impostore1988 ($11.74 in chips) 
khv)miz: posts small blind $0.05
Impostore1988: posts big blind $0.10
Leonid AK74: sits out 
*** HOLE CARDS ***
Hollseg: raises $0.15 to $0.25
eldar919: folds 
khv)miz: calls $0.20
Impostore1988: folds 
*** FLOP *** [5h Qd 2d]
khv)miz: bets $0.29
Hollseg: raises $0.71 to $1
khv)miz: calls $0.71
*** TURN *** [5h Qd 2d] [5d]
khv)miz: bets $1.24
Hollseg: raises $1.24 to $2.48
khv)miz: raises $5.26 to $7.74 and is all-in
Hollseg: calls $5.26
*** RIVER *** [5h Qd 2d 5d] [3c]
*** SHOW DOWN ***
khv)miz: shows [6d Td] (a flush, Queen high)
Hollseg: shows [2c 2s] (a full house, Deuces full of Fives)
Hollseg collected $17.27 from pot
*** SUMMARY ***
Total pot $18.08 | Rake $0.81 
Board [5h Qd 2d 5d 3c]
Seat 2: Hollseg showed [2c 2s] and won ($17.27) with a full house, Deuces full of Fives
Seat 3: eldar919 (button) folded before Flop (didn't bet)
Seat 4: khv)miz (small blind) showed [6d Td] and lost with a flush, Queen high
Seat 5: Impostore1988 (big blind) folded before Flop



PokerStars Hand #222960421442:  Hold'em No Limit ($0.05/$0.10 USD) - 2021/01/23 12:06:54 ET
Table 'Stephano III' 6-max Seat #5 is the button
Seat 2: Hollseg ($18.23 in chips) 
Seat 3: eldar919 ($13.88 in chips) 
Seat 5: Impostore1988 ($11.64 in chips) 
Hollseg: posts small blind $0.05
eldar919: posts big blind $0.10
*** HOLE CARDS ***
Impostore1988: raises $0.10 to $0.20
Hollseg: folds 
eldar919: calls $0.10
*** FLOP *** [Kc 4h 5c]
eldar919: checks 
Impostore1988: bets $0.30
eldar919: raises $0.30 to $0.60
Impostore1988: calls $0.30
*** TURN *** [Kc 4h 5c] [3c]
eldar919: bets $1.25
Impostore1988: folds 
Uncalled bet ($1.25) returned to eldar919
eldar919 collected $1.58 from pot
eldar919: doesn't show hand 
*** SUMMARY ***
Total pot $1.65 | Rake $0.07 
Board [Kc 4h 5c 3c]
Seat 2: Hollseg (small blind) folded before Flop
Seat 3: eldar919 (big blind) collected ($1.58)
Seat 5: Impostore1988 (button) folded on the Turn



PokerStars Hand #222960450950:  Hold'em No Limit ($0.05/$0.10 USD) - 2021/01/23 12:07:41 ET
Table 'Stephano III' 6-max Seat #2 is the button
Seat 2: Hollseg ($18.18 in chips) 
Seat 3: eldar919 ($14.66 in chips) 
Seat 4: khv)miz ($10 in chips) 
Seat 5: Impostore1988 ($10.84 in chips) 
Seat 6: nickpotss38 ($7.02 in chips) 
eldar919: posts small blind $0.05
khv)miz: posts big blind $0.10
nickpotss38: posts small blind $0.05
Leonid AK74: sits out 
*** HOLE CARDS ***
Impostore1988: folds 
nickpotss38: folds 
Hollseg: raises $0.15 to $0.25
eldar919: calls $0.20
khv)miz: calls $0.15
*** FLOP *** [Td Js 3h]
eldar919: bets $0.38
khv)miz: folds 
Hollseg: folds 
Uncalled bet ($0.38) returned to eldar919
eldar919 collected $0.76 from pot
eldar919: doesn't show hand 
*** SUMMARY ***
Total pot $0.80 | Rake $0.04 
Board [Td Js 3h]
Seat 2: Hollseg (button) folded on the Flop
Seat 3: eldar919 (small blind) collected ($0.76)
Seat 4: khv)miz (big blind) folded on the Flop
Seat 5: Impostore1988 folded before Flop (didn't bet)
Seat 6: nickpotss38 folded before Flop (didn't bet)



PokerStars Hand #222960477890:  Hold'em No Limit ($0.05/$0.10 USD) - 2021/01/23 12:08:24 ET
Table 'Stephano III' 6-max Seat #3 is the button
Seat 2: Hollseg ($17.93 in chips) 
Seat 3: eldar919 ($15.17 in chips) 
Seat 4: khv)miz ($9.75 in chips) 
Seat 5: Impostore1988 ($10.84 in chips) 
Seat 6: nickpotss38 ($6.97 in chips) 
khv)miz: posts small blind $0.05
Impostore1988: posts big blind $0.10
Leonid AK74: sits out 
*** HOLE CARDS ***
nickpotss38: folds 
Hollseg: raises $0.15 to $0.25
eldar919: folds 
khv)miz: folds 
Impostore1988: calls $0.15
*** FLOP *** [Kh 6c Jd]
Impostore1988: checks 
Hollseg: checks 
*** TURN *** [Kh 6c Jd] [Th]
Impostore1988: checks 
Hollseg: checks 
*** RIVER *** [Kh 6c Jd Th] [2d]
Impostore1988: checks 
Hollseg: checks 
*** SHOW DOWN ***
Impostore1988: shows [6s As] (a pair of Sixes)
Hollseg: mucks hand 
Impostore1988 collected $0.53 from pot
*** SUMMARY ***
Total pot $0.55 | Rake $0.02 
Board [Kh 6c Jd Th 2d]
Seat 2: Hollseg mucked
Seat 3: eldar919 (button) folded before Flop (didn't bet)
Seat 4: khv)miz (small blind) folded before Flop
Seat 5: Impostore1988 (big blind) showed [6s As] and won ($0.53) with a pair of Sixes
Seat 6: nickpotss38 folded before Flop (didn't bet)



PokerStars Hand #222960510720:  Hold'em No Limit ($0.05/$0.10 USD) - 2021/01/23 12:09:16 ET
Table 'Stephano III' 6-max Seat #4 is the button
Seat 2: Hollseg ($17.68 in chips) 
Seat 3: eldar919 ($15.17 in chips) 
Seat 4: khv)miz ($9.70 in chips) 
Seat 5: Impostore1988 ($11.12 in chips) 
Seat 6: nickpotss38 ($6.97 in chips) 
Impostore1988: posts small blind $0.05
nickpotss38: posts big blind $0.10
Leonid AK74: sits out 
*** HOLE CARDS ***
Hollseg: folds 
eldar919: folds 
khv)miz: raises $0.20 to $0.30
Impostore1988: folds 
nickpotss38: folds 
Uncalled bet ($0.20) returned to khv)miz
khv)miz collected $0.25 from pot
khv)miz: doesn't show hand 
*** SUMMARY ***
Total pot $0.25 | Rake $0 
Seat 2: Hollseg folded before Flop (didn't bet)
Seat 3: eldar919 folded before Flop (didn't bet)
Seat 4: khv)miz (button) collected ($0.25)
Seat 5: Impostore1988 (small blind) folded before Flop
Seat 6: nickpotss38 (big blind) folded before Flop



PokerStars Hand #222960519118:  Hold'em No Limit ($0.05/$0.10 USD) - 2021/01/23 12:09:29 ET
Table 'Stephano III' 6-max Seat #5 is the button
Seat 1: Leonid AK74 ($9.85 in chips) 
Seat 2: Hollseg ($17.68 in chips) 
Seat 3: eldar919 ($15.17 in chips) 
Seat 4: khv)miz ($9.85 in chips) 
Seat 5: Impostore1988 ($11.07 in chips) 
Seat 6: nickpotss38 ($6.87 in chips) 
nickpotss38: posts small blind $0.05
Leonid AK74: posts big blind $0.10
*** HOLE CARDS ***
Hollseg: folds 
eldar919: folds 
khv)miz: folds 
Impostore1988: folds 
nickpotss38: folds 
Uncalled bet ($0.05) returned to Leonid AK74
Leonid AK74 collected $0.10 from pot
*** SUMMARY ***
Total pot $0.10 | Rake $0 
Seat 1: Leonid AK74 (big blind) collected ($0.10)
Seat 2: Hollseg folded before Flop (didn't bet)
Seat 3: eldar919 folded before Flop (didn't bet)
Seat 4: khv)miz folded before Flop (didn't bet)
Seat 5: Impostore1988 (button) folded before Flop (didn't bet)
Seat 6: nickpotss38 (small blind) folded before Flop



PokerStars Hand #222960527565:  Hold'em No Limit ($0.05/$0.10 USD) - 2021/01/23 12:09:43 ET
Table 'Stephano III' 6-max Seat #6 is the button
Seat 1: Leonid AK74 ($9.90 in chips) 
Seat 2: Hollseg ($17.68 in chips) 
Seat 3: eldar919 ($15.17 in chips) 
Seat 4: khv)miz ($9.85 in chips) 
Seat 5: Impostore1988 ($11.07 in chips) 
Seat 6: nickpotss38 ($6.82 in chips) 
Leonid AK74: posts small blind $0.05
Hollseg: posts big blind $0.10
*** HOLE CARDS ***
eldar919: folds 
khv)miz: folds 
Impostore1988: folds 
nickpotss38: calls $0.10
Leonid AK74: folds 
Hollseg: checks 
*** FLOP *** [4s 9h Kc]
Hollseg: checks 
nickpotss38: bets $0.10
Hollseg: folds 
Uncalled bet ($0.10) returned to nickpotss38
nickpotss38 collected $0.24 from pot
nickpotss38: doesn't show hand 
*** SUMMARY ***
Total pot $0.25 | Rake $0.01 
Board [4s 9h Kc]
Seat 1: Leonid AK74 (small blind) folded before Flop
Seat 2: Hollseg (big blind) folded on the Flop
Seat 3: eldar919 folded before Flop (didn't bet)
Seat 4: khv)miz folded before Flop (didn't bet)
Seat 5: Impostore1988 folded before Flop (didn't bet)
Seat 6: nickpotss38 (button) collected ($0.24)



PokerStars Hand #222960546652:  Hold'em No Limit ($0.05/$0.10 USD) - 2021/01/23 12:10:13 ET
Table 'Stephano III' 6-max Seat #1 is the button
Seat 1: Leonid AK74 ($9.85 in chips) 
Seat 2: Hollseg ($17.58 in chips) 
Seat 3: eldar919 ($15.17 in chips) 
Seat 4: khv)miz ($9.85 in chips) 
Seat 5: Impostore1988 ($11.07 in chips) 
Seat 6: nickpotss38 ($6.96 in chips) 
Hollseg: posts small blind $0.05
eldar919: posts big blind $0.10
*** HOLE CARDS ***
khv)miz: raises $0.20 to $0.30
Impostore1988: raises $0.60 to $0.90
nickpotss38: folds 
Leonid AK74: folds 
Hollseg: folds 
eldar919: folds 
khv)miz: calls $0.60
*** FLOP *** [6c 4c 9d]
khv)miz: checks 
Impostore1988: bets $0.93
khv)miz: calls $0.93
*** TURN *** [6c 4c 9d] [Tc]
khv)miz: checks 
Impostore1988: bets $3.64
khv)miz: raises $3.64 to $7.28
Impostore1988: raises $1.96 to $9.24 and is all-in
khv)miz: calls $0.74 and is all-in
Uncalled bet ($1.22) returned to Impostore1988
*** RIVER *** [6c 4c 9d Tc] [4s]
*** SHOW DOWN ***
khv)miz: shows [8h 7s] (a straight, Six to Ten)
Impostore1988: shows [Kc Jc] (a flush, King high)
Impostore1988 collected $18.96 from pot
*** SUMMARY ***
Total pot $19.85 | Rake $0.89 
Board [6c 4c 9d Tc 4s]
Seat 1: Leonid AK74 (button) folded before Flop (didn't bet)
Seat 2: Hollseg (small blind) folded before Flop
Seat 3: eldar919 (big blind) folded before Flop
Seat 4: khv)miz showed [8h 7s] and lost with a straight, Six to Ten
Seat 5: Impostore1988 showed [Kc Jc] and won ($18.96) with a flush, King high
Seat 6: nickpotss38 folded before Flop (didn't bet)



PokerStars Hand #222960578516:  Hold'em No Limit ($0.05/$0.10 USD) - 2021/01/23 12:11:04 ET
Table 'Stephano III' 6-max Seat #2 is the button
Seat 1: Leonid AK74 ($9.85 in chips) 
Seat 2: Hollseg ($17.53 in chips) 
Seat 3: eldar919 ($15.07 in chips) 
Seat 5: Impostore1988 ($20.18 in chips) 
Seat 6: nickpotss38 ($6.96 in chips) 
eldar919: posts small blind $0.05
Impostore1988: posts big blind $0.10
*** HOLE CARDS ***
nickpotss38: folds 
Leonid AK74: folds 
Hollseg: raises $0.15 to $0.25
eldar919: folds 
Impostore1988: folds 
Uncalled bet ($0.15) returned to Hollseg
Hollseg collected $0.25 from pot
Hollseg: doesn't show hand 
*** SUMMARY ***
Total pot $0.25 | Rake $0 
Seat 1: Leonid AK74 folded before Flop (didn't bet)
Seat 2: Hollseg (button) collected ($0.25)
Seat 3: eldar919 (small blind) folded before Flop
Seat 5: Impostore1988 (big blind) folded before Flop
Seat 6: nickpotss38 folded before Flop (didn't bet)



PokerStars Hand #222960587947:  Hold'em No Limit ($0.05/$0.10 USD) - 2021/01/23 12:11:19 ET
Table 'Stephano III' 6-max Seat #3 is the button
Seat 1: Leonid AK74 ($9.85 in chips) 
Seat 2: Hollseg ($17.68 in chips) 
Seat 3: eldar919 ($15.02 in chips) 
Seat 5: Impostore1988 ($20.08 in chips) 
Seat 6: nickpotss38 ($6.96 in chips) 
Impostore1988: posts small blind $0.05
nickpotss38: posts big blind $0.10
*** HOLE CARDS ***
Leonid AK74: folds 
Hollseg: raises $0.15 to $0.25
eldar919: calls $0.25
Impostore1988: folds 
nickpotss38: folds 
*** FLOP *** [7h Ks Qh]
Hollseg: checks 
eldar919: bets $0.31
Hollseg: calls $0.31
*** TURN *** [7h Ks Qh] [8c]
Hollseg: checks 
eldar919: bets $0.80
Hollseg: calls $0.80
*** RIVER *** [7h Ks Qh 8c] [3h]
Hollseg: checks 
eldar919: checks 
*** SHOW DOWN ***
Hollseg: shows [Kh Jc] (a pair of Kings)
eldar919: mucks hand 
Hollseg collected $2.74 from pot
*** SUMMARY ***
Total pot $2.87 | Rake $0.13 
Board [7h Ks Qh 8c 3h]
Seat 1: Leonid AK74 folded before Flop (didn't bet)
Seat 2: Hollseg showed [Kh Jc] and won ($2.74) with a pair of Kings
Seat 3: eldar919 (button) mucked
Seat 5: Impostore1988 (small blind) folded before Flop
Seat 6: nickpotss38 (big blind) folded before Flop



PokerStars Hand #222960623304:  Hold'em No Limit ($0.05/$0.10 USD) - 2021/01/23 12:12:15 ET
Table 'Stephano III' 6-max Seat #5 is the button
Seat 1: Leonid AK74 ($9.85 in chips) 
Seat 2: Hollseg ($19.06 in chips) 
Seat 3: eldar919 ($13.66 in chips) 
Seat 5: Impostore1988 ($20.03 in chips) 
Seat 6: nickpotss38 ($6.86 in chips) 
nickpotss38: posts small blind $0.05
Leonid AK74: posts big blind $0.10
khv)miz: sits out 
*** HOLE CARDS ***
Hollseg: folds 
eldar919: raises $0.20 to $0.30
Impostore1988: folds 
nickpotss38: raises $0.20 to $0.50
Leonid AK74: calls $0.40
eldar919: calls $0.20
*** FLOP *** [3s Tc 5h]
nickpotss38: checks 
Leonid AK74: checks 
eldar919: bets $0.80
nickpotss38: calls $0.80
Leonid AK74: calls $0.80
*** TURN *** [3s Tc 5h] [6s]
nickpotss38: checks 
Leonid AK74: checks 
eldar919: bets $2.35
nickpotss38: folds 
Leonid AK74: folds 
Uncalled bet ($2.35) returned to eldar919
eldar919 collected $3.72 from pot
eldar919: doesn't show hand 
*** SUMMARY ***
Total pot $3.90 | Rake $0.18 
Board [3s Tc 5h 6s]
Seat 1: Leonid AK74 (big blind) folded on the Turn
Seat 2: Hollseg folded before Flop (didn't bet)
Seat 3: eldar919 collected ($3.72)
Seat 5: Impostore1988 (button) folded before Flop (didn't bet)
Seat 6: nickpotss38 (small blind) folded on the Turn



PokerStars Hand #222960668880:  Hold'em No Limit ($0.05/$0.10 USD) - 2021/01/23 12:13:25 ET
Table 'Stephano III' 6-max Seat #6 is the button
Seat 1: Leonid AK74 ($8.55 in chips) 
Seat 2: Hollseg ($19.06 in chips) 
Seat 3: eldar919 ($16.08 in chips) 
Seat 4: khv)miz ($4.91 in chips) 
Seat 5: Impostore1988 ($20.03 in chips) 
Seat 6: nickpotss38 ($5.56 in chips) 
Leonid AK74: posts small blind $0.05
Hollseg: posts big blind $0.10
khv)miz: posts small & big blinds $0.15
*** HOLE CARDS ***
eldar919: raises $0.20 to $0.30
khv)miz: raises $0.70 to $1
Impostore1988: folds 
nickpotss38: raises $2.50 to $3.50
Leonid AK74: folds 
Hollseg: folds 
eldar919: folds 
khv)miz: raises $1.36 to $4.86 and is all-in
nickpotss38: calls $1.36
*** FLOP *** [4c Td Jd]
*** TURN *** [4c Td Jd] [6s]
*** RIVER *** [4c Td Jd 6s] [7d]
*** SHOW DOWN ***
khv)miz: shows [2c 2d] (a pair of Deuces)
nickpotss38: shows [Qs Js] (a pair of Jacks)
nickpotss38 collected $9.76 from pot
khv)miz cashed out the hand for $4.57 | Cash Out Fee $0.05
*** SUMMARY ***
Total pot $10.22 | Rake $0.46 
Board [4c Td Jd 6s 7d]
Seat 1: Leonid AK74 (small blind) folded before Flop
Seat 2: Hollseg (big blind) folded before Flop
Seat 3: eldar919 folded before Flop
Seat 4: khv)miz showed [2c 2d] and lost with a pair of Deuces (cashed out).
Seat 5: Impostore1988 folded before Flop (didn't bet)
Seat 6: nickpotss38 (button) showed [Qs Js] and won ($9.76) with a pair of Jacks



PokerStars Hand #222960693380:  Hold'em No Limit ($0.05/$0.10 USD) - 2021/01/23 12:14:04 ET
Table 'Stephano III' 6-max Seat #1 is the button
Seat 1: Leonid AK74 ($8.50 in chips) 
Seat 2: Hollseg ($18.96 in chips) 
Seat 3: eldar919 ($15.78 in chips) 
Seat 4: khv)miz ($4.57 in chips) 
Seat 5: Impostore1988 ($20.03 in chips) 
Seat 6: nickpotss38 ($10.46 in chips) 
Hollseg: posts small blind $0.05
eldar919: posts big blind $0.10
*** HOLE CARDS ***
khv)miz: folds 
Impostore1988: folds 
nickpotss38: folds 
Leonid AK74: folds 
Hollseg: raises $0.20 to $0.30
eldar919: folds 
Uncalled bet ($0.20) returned to Hollseg
Hollseg collected $0.20 from pot
Hollseg: doesn't show hand 
*** SUMMARY ***
Total pot $0.20 | Rake $0 
Seat 1: Leonid AK74 (button) folded before Flop (didn't bet)
Seat 2: Hollseg (small blind) collected ($0.20)
Seat 3: eldar919 (big blind) folded before Flop
Seat 4: khv)miz folded before Flop (didn't bet)
Seat 5: Impostore1988 folded before Flop (didn't bet)
Seat 6: nickpotss38 folded before Flop (didn't bet)



PokerStars Hand #222960707439:  Hold'em No Limit ($0.05/$0.10 USD) - 2021/01/23 12:14:26 ET
Table 'Stephano III' 6-max Seat #2 is the button
Seat 1: Leonid AK74 ($8.50 in chips) 
Seat 2: Hollseg ($19.06 in chips) 
Seat 3: eldar919 ($15.68 in chips) 
Seat 4: khv)miz ($4.57 in chips) 
Seat 5: Impostore1988 ($20.03 in chips) 
Seat 6: nickpotss38 ($10.46 in chips) 
eldar919: posts small blind $0.05
khv)miz: posts big blind $0.10
*** HOLE CARDS ***
Impostore1988: raises $0.20 to $0.30
nickpotss38: folds 
Leonid AK74: folds 
Hollseg: folds 
eldar919: calls $0.25
khv)miz: folds 
*** FLOP *** [Js Jh 8s]
eldar919: bets $0.45
Impostore1988: folds 
Uncalled bet ($0.45) returned to eldar919
eldar919 collected $0.67 from pot
eldar919: doesn't show hand 
*** SUMMARY ***
Total pot $0.70 | Rake $0.03 
Board [Js Jh 8s]
Seat 1: Leonid AK74 folded before Flop (didn't bet)
Seat 2: Hollseg (button) folded before Flop (didn't bet)
Seat 3: eldar919 (small blind) collected ($0.67)
Seat 4: khv)miz (big blind) folded before Flop
Seat 5: Impostore1988 folded on the Flop
Seat 6: nickpotss38 folded before Flop (didn't bet)



PokerStars Hand #222960742400:  Hold'em No Limit ($0.05/$0.10 USD) - 2021/01/23 12:15:22 ET
Table 'Stephano III' 6-max Seat #3 is the button
Seat 1: Leonid AK74 ($8.50 in chips) 
Seat 2: Hollseg ($19.06 in chips) 
Seat 3: eldar919 ($16.05 in chips) 
Seat 4: khv)miz ($4.47 in chips) 
Seat 5: Impostore1988 ($19.73 in chips) 
Seat 6: nickpotss38 ($10.46 in chips) 
khv)miz: posts small blind $0.05
Impostore1988: posts big blind $0.10
*** HOLE CARDS ***
nickpotss38: calls $0.10
Leonid AK74: folds 
Hollseg: folds 
eldar919: folds 
khv)miz: folds 
Impostore1988: checks 
*** FLOP *** [Kd Qd 2s]
Impostore1988: checks 
nickpotss38: checks 
*** TURN *** [Kd Qd 2s] [Ac]
Impostore1988: checks 
nickpotss38: checks 
*** RIVER *** [Kd Qd 2s Ac] [2h]
Impostore1988: checks 
nickpotss38: bets $0.10
Impostore1988: folds 
Uncalled bet ($0.10) returned to nickpotss38
nickpotss38 collected $0.24 from pot
nickpotss38: doesn't show hand 
*** SUMMARY ***
Total pot $0.25 | Rake $0.01 
Board [Kd Qd 2s Ac 2h]
Seat 1: Leonid AK74 folded before Flop (didn't bet)
Seat 2: Hollseg folded before Flop (didn't bet)
Seat 3: eldar919 (button) folded before Flop (didn't bet)
Seat 4: khv)miz (small blind) folded before Flop
Seat 5: Impostore1988 (big blind) folded on the River
Seat 6: nickpotss38 collected ($0.24)



PokerStars Hand #222960775533:  Hold'em No Limit ($0.05/$0.10 USD) - 2021/01/23 12:16:14 ET
Table 'Stephano III' 6-max Seat #4 is the button
Seat 1: Leonid AK74 ($8.50 in chips) 
Seat 2: Hollseg ($19.06 in chips) 
Seat 3: eldar919 ($16.05 in chips) 
Seat 4: khv)miz ($4.42 in chips) 
Seat 5: Impostore1988 ($19.63 in chips) 
Seat 6: nickpotss38 ($10.60 in chips) 
Impostore1988: posts small blind $0.05
nickpotss38: posts big blind $0.10
*** HOLE CARDS ***
Leonid AK74: folds 
Hollseg: folds 
eldar919: raises $0.15 to $0.25
khv)miz: calls $0.25
Impostore1988: folds 
nickpotss38: folds 
*** FLOP *** [5d 2d 7d]
eldar919: bets $0.31
khv)miz: raises $0.31 to $0.62
eldar919: calls $0.31
*** TURN *** [5d 2d 7d] [Ts]
eldar919: checks 
khv)miz: bets $0.90
eldar919: calls $0.90
*** RIVER *** [5d 2d 7d Ts] [Qc]
eldar919: checks 
khv)miz: bets $1.76
eldar919: folds 
Uncalled bet ($1.76) returned to khv)miz
khv)miz collected $3.52 from pot
khv)miz: doesn't show hand 
*** SUMMARY ***
Total pot $3.69 | Rake $0.17 
Board [5d 2d 7d Ts Qc]
Seat 1: Leonid AK74 folded before Flop (didn't bet)
Seat 2: Hollseg folded before Flop (didn't bet)
Seat 3: eldar919 folded on the River
Seat 4: khv)miz (button) collected ($3.52)
Seat 5: Impostore1988 (small blind) folded before Flop
Seat 6: nickpotss38 (big blind) folded before Flop



PokerStars Hand #222960805222:  Hold'em No Limit ($0.05/$0.10 USD) - 2021/01/23 12:17:00 ET
Table 'Stephano III' 6-max Seat #5 is the button
Seat 1: Leonid AK74 ($8.50 in chips) 
Seat 2: Hollseg ($19.06 in chips) 
Seat 3: eldar919 ($14.28 in chips) 
Seat 4: khv)miz ($6.17 in chips) 
Seat 5: Impostore1988 ($19.58 in chips) 
Seat 6: nickpotss38 ($10.50 in chips) 
nickpotss38: posts small blind $0.05
Leonid AK74: posts big blind $0.10
*** HOLE CARDS ***
Hollseg: folds 
eldar919: raises $0.15 to $0.25
khv)miz: calls $0.25
Impostore1988: folds 
nickpotss38: folds 
Leonid AK74: folds 
*** FLOP *** [5c 6c 5d]
eldar919: checks 
khv)miz: bets $0.31
eldar919: folds 
Uncalled bet ($0.31) returned to khv)miz
khv)miz collected $0.62 from pot
khv)miz: doesn't show hand 
*** SUMMARY ***
Total pot $0.65 | Rake $0.03 
Board [5c 6c 5d]
Seat 1: Leonid AK74 (big blind) folded before Flop
Seat 2: Hollseg folded before Flop (didn't bet)
Seat 3: eldar919 folded on the Flop
Seat 4: khv)miz collected ($0.62)
Seat 5: Impostore1988 (button) folded before Flop (didn't bet)
Seat 6: nickpotss38 (small blind) folded before Flop



PokerStars Hand #222960826569:  Hold'em No Limit ($0.05/$0.10 USD) - 2021/01/23 12:17:34 ET
Table 'Stephano III' 6-max Seat #6 is the button
Seat 1: Leonid AK74 ($8.40 in chips) 
Seat 2: Hollseg ($19.06 in chips) 
Seat 3: eldar919 ($14.03 in chips) 
Seat 4: khv)miz ($6.54 in chips) 
Seat 5: Impostore1988 ($19.58 in chips) 
Seat 6: nickpotss38 ($10.45 in chips) 
Leonid AK74: posts small blind $0.05
Hollseg: posts big blind $0.10
*** HOLE CARDS ***
eldar919: folds 
khv)miz: raises $0.20 to $0.30
Impostore1988: folds 
nickpotss38: calls $0.30
Leonid AK74: folds 
Hollseg: folds 
*** FLOP *** [6d 4s 9h]
khv)miz: bets $0.36
nickpotss38: folds 
Uncalled bet ($0.36) returned to khv)miz
khv)miz collected $0.72 from pot
khv)miz: doesn't show hand 
*** SUMMARY ***
Total pot $0.75 | Rake $0.03 
Board [6d 4s 9h]
Seat 1: Leonid AK74 (small blind) folded before Flop
Seat 2: Hollseg (big blind) folded before Flop
Seat 3: eldar919 folded before Flop (didn't bet)
Seat 4: khv)miz collected ($0.72)
Seat 5: Impostore1988 folded before Flop (didn't bet)
Seat 6: nickpotss38 (button) folded on the Flop



PokerStars Hand #222960847685:  Hold'em No Limit ($0.05/$0.10 USD) - 2021/01/23 12:18:08 ET
Table 'Stephano III' 6-max Seat #1 is the button
Seat 1: Leonid AK74 ($8.35 in chips) 
Seat 2: Hollseg ($18.96 in chips) 
Seat 3: eldar919 ($14.03 in chips) 
Seat 4: khv)miz ($6.96 in chips) 
Seat 5: Impostore1988 ($19.58 in chips) 
Seat 6: nickpotss38 ($10.15 in chips) 
Hollseg: posts small blind $0.05
eldar919: posts big blind $0.10
*** HOLE CARDS ***
khv)miz: raises $0.20 to $0.30
Impostore1988: folds 
nickpotss38: calls $0.30
Leonid AK74: calls $0.30
Hollseg: folds 
eldar919: folds 
*** FLOP *** [Qh 5c 2h]
khv)miz: checks 
nickpotss38: checks 
Leonid AK74: checks 
*** TURN *** [Qh 5c 2h] [7h]
khv)miz: checks 
nickpotss38: checks 
Leonid AK74: checks 
*** RIVER *** [Qh 5c 2h 7h] [Ac]
khv)miz: checks 
nickpotss38: checks 
Leonid AK74: checks 
*** SHOW DOWN ***
khv)miz: shows [Ts 3s] (high card Ace)
nickpotss38: shows [8s 8h] (a pair of Eights)
Leonid AK74: mucks hand 
nickpotss38 collected $1 from pot
*** SUMMARY ***
Total pot $1.05 | Rake $0.05 
Board [Qh 5c 2h 7h Ac]
Seat 1: Leonid AK74 (button) mucked
Seat 2: Hollseg (small blind) folded before Flop
Seat 3: eldar919 (big blind) folded before Flop
Seat 4: khv)miz showed [Ts 3s] and lost with high card Ace
Seat 5: Impostore1988 folded before Flop (didn't bet)
Seat 6: nickpotss38 showed [8s 8h] and won ($1) with a pair of Eights



PokerStars Hand #222960894686:  Hold'em No Limit ($0.05/$0.10 USD) - 2021/01/23 12:19:19 ET
Table 'Stephano III' 6-max Seat #2 is the button
Seat 1: Leonid AK74 ($8.05 in chips) 
Seat 2: Hollseg ($18.91 in chips) 
Seat 3: eldar919 ($13.93 in chips) 
Seat 4: khv)miz ($6.66 in chips) 
Seat 5: Impostore1988 ($19.58 in chips) 
Seat 6: nickpotss38 ($10.85 in chips) 
eldar919: posts small blind $0.05
khv)miz: posts big blind $0.10
*** HOLE CARDS ***
Impostore1988: folds 
nickpotss38: calls $0.10
Leonid AK74: folds 
Hollseg: folds 
eldar919: folds 
khv)miz: checks 
*** FLOP *** [Jd Th 3s]
khv)miz: checks 
nickpotss38: checks 
*** TURN *** [Jd Th 3s] [4c]
khv)miz: checks 
nickpotss38: checks 
*** RIVER *** [Jd Th 3s 4c] [5s]
khv)miz: checks 
nickpotss38: checks 
*** SHOW DOWN ***
khv)miz: shows [8s 2c] (high card Jack)
nickpotss38: shows [8h Ad] (high card Ace)
nickpotss38 collected $0.24 from pot
*** SUMMARY ***
Total pot $0.25 | Rake $0.01 
Board [Jd Th 3s 4c 5s]
Seat 1: Leonid AK74 folded before Flop (didn't bet)
Seat 2: Hollseg (button) folded before Flop (didn't bet)
Seat 3: eldar919 (small blind) folded before Flop
Seat 4: khv)miz (big blind) showed [8s 2c] and lost with high card Jack
Seat 5: Impostore1988 folded before Flop (didn't bet)
Seat 6: nickpotss38 showed [8h Ad] and won ($0.24) with high card Ace



PokerStars Hand #222960915178:  Hold'em No Limit ($0.05/$0.10 USD) - 2021/01/23 12:19:51 ET
Table 'Stephano III' 6-max Seat #3 is the button
Seat 1: Leonid AK74 ($8.05 in chips) 
Seat 2: Hollseg ($18.91 in chips) 
Seat 3: eldar919 ($13.88 in chips) 
Seat 4: khv)miz ($6.56 in chips) 
Seat 5: Impostore1988 ($19.58 in chips) 
Seat 6: nickpotss38 ($10.99 in chips) 
khv)miz: posts small blind $0.05
Impostore1988: posts big blind $0.10
*** HOLE CARDS ***
nickpotss38: folds 
Leonid AK74: folds 
Hollseg: folds 
eldar919: raises $0.15 to $0.25
khv)miz: calls $0.20
Impostore1988: folds 
*** FLOP *** [7s Th 3c]
khv)miz: checks 
eldar919: bets $0.30
khv)miz: folds 
Uncalled bet ($0.30) returned to eldar919
eldar919 collected $0.57 from pot
eldar919: doesn't show hand 
*** SUMMARY ***
Total pot $0.60 | Rake $0.03 
Board [7s Th 3c]
Seat 1: Leonid AK74 folded before Flop (didn't bet)
Seat 2: Hollseg folded before Flop (didn't bet)
Seat 3: eldar919 (button) collected ($0.57)
Seat 4: khv)miz (small blind) folded on the Flop
Seat 5: Impostore1988 (big blind) folded before Flop
Seat 6: nickpotss38 folded before Flop (didn't bet)



PokerStars Hand #222960933626:  Hold'em No Limit ($0.05/$0.10 USD) - 2021/01/23 12:20:21 ET
Table 'Stephano III' 6-max Seat #4 is the button
Seat 1: Leonid AK74 ($8.05 in chips) 
Seat 2: Hollseg ($18.91 in chips) 
Seat 3: eldar919 ($14.20 in chips) 
Seat 4: khv)miz ($6.31 in chips) 
Seat 5: Impostore1988 ($19.48 in chips) 
Seat 6: nickpotss38 ($10.99 in chips) 
Impostore1988: posts small blind $0.05
nickpotss38: posts big blind $0.10
*** HOLE CARDS ***
Leonid AK74: folds 
Hollseg: folds 
eldar919: raises $0.15 to $0.25
khv)miz: folds 
Impostore1988: folds 
nickpotss38: folds 
Uncalled bet ($0.15) returned to eldar919
eldar919 collected $0.25 from pot
eldar919: doesn't show hand 
*** SUMMARY ***
Total pot $0.25 | Rake $0 
Seat 1: Leonid AK74 folded before Flop (didn't bet)
Seat 2: Hollseg folded before Flop (didn't bet)
Seat 3: eldar919 collected ($0.25)
Seat 4: khv)miz (button) folded before Flop (didn't bet)
Seat 5: Impostore1988 (small blind) folded before Flop
Seat 6: nickpotss38 (big blind) folded before Flop



PokerStars Hand #222960952623:  Hold'em No Limit ($0.05/$0.10 USD) - 2021/01/23 12:20:51 ET
Table 'Stephano III' 6-max Seat #5 is the button
Seat 1: Leonid AK74 ($8.05 in chips) 
Seat 2: Hollseg ($18.91 in chips) 
Seat 3: eldar919 ($14.35 in chips) 
Seat 4: khv)miz ($6.31 in chips) 
Seat 5: Impostore1988 ($19.43 in chips) 
Seat 6: nickpotss38 ($10.89 in chips) 
nickpotss38: posts small blind $0.05
Leonid AK74: posts big blind $0.10
*** HOLE CARDS ***
Hollseg: folds 
eldar919: folds 
khv)miz: folds 
Impostore1988: folds 
nickpotss38: raises $0.10 to $0.20
Leonid AK74: calls $0.10
*** FLOP *** [Td 7c 8h]
nickpotss38: bets $0.19
Leonid AK74: folds 
Uncalled bet ($0.19) returned to nickpotss38
nickpotss38 collected $0.38 from pot
nickpotss38: doesn't show hand 
*** SUMMARY ***
Total pot $0.40 | Rake $0.02 
Board [Td 7c 8h]
Seat 1: Leonid AK74 (big blind) folded on the Flop
Seat 2: Hollseg folded before Flop (didn't bet)
Seat 3: eldar919 folded before Flop (didn't bet)
Seat 4: khv)miz folded before Flop (didn't bet)
Seat 5: Impostore1988 (button) folded before Flop (didn't bet)
Seat 6: nickpotss38 (small blind) collected ($0.38)



PokerStars Hand #222960973502:  Hold'em No Limit ($0.05/$0.10 USD) - 2021/01/23 12:21:24 ET
Table 'Stephano III' 6-max Seat #6 is the button
Seat 1: Leonid AK74 ($7.85 in chips) 
Seat 2: Hollseg ($18.91 in chips) 
Seat 3: eldar919 ($14.35 in chips) 
Seat 4: khv)miz ($6.31 in chips) 
Seat 5: Impostore1988 ($19.43 in chips) 
Seat 6: nickpotss38 ($11.07 in chips) 
Leonid AK74: posts small blind $0.05
Hollseg: posts big blind $0.10
*** HOLE CARDS ***
eldar919: folds 
khv)miz: raises $0.20 to $0.30
Impostore1988: folds 
nickpotss38: calls $0.30
Leonid AK74: folds 
Hollseg: folds 
*** FLOP *** [4d 6c Td]
khv)miz: checks 
nickpotss38: bets $0.36
khv)miz: calls $0.36
*** TURN *** [4d 6c Td] [2h]
khv)miz: checks 
nickpotss38: checks 
*** RIVER *** [4d 6c Td 2h] [Jd]
khv)miz: checks 
nickpotss38: bets $0.10
khv)miz: folds 
Uncalled bet ($0.10) returned to nickpotss38
nickpotss38 collected $1.40 from pot
nickpotss38: doesn't show hand 
*** SUMMARY ***
Total pot $1.47 | Rake $0.07 
Board [4d 6c Td 2h Jd]
Seat 1: Leonid AK74 (small blind) folded before Flop
Seat 2: Hollseg (big blind) folded before Flop
Seat 3: eldar919 folded before Flop (didn't bet)
Seat 4: khv)miz folded on the River
Seat 5: Impostore1988 folded before Flop (didn't bet)
Seat 6: nickpotss38 (button) collected ($1.40)



PokerStars Hand #222960992624:  Hold'em No Limit ($0.05/$0.10 USD) - 2021/01/23 12:21:54 ET
Table 'Stephano III' 6-max Seat #1 is the button
Seat 1: Leonid AK74 ($7.80 in chips) 
Seat 2: Hollseg ($18.81 in chips) 
Seat 3: eldar919 ($14.35 in chips) 
Seat 4: khv)miz ($5.65 in chips) 
Seat 5: Impostore1988 ($19.43 in chips) 
Seat 6: nickpotss38 ($11.81 in chips) 
Hollseg: posts small blind $0.05
eldar919: posts big blind $0.10
*** HOLE CARDS ***
khv)miz: folds 
Impostore1988: folds 
nickpotss38: calls $0.10
Leonid AK74: folds 
Hollseg: folds 
eldar919: checks 
*** FLOP *** [Kd 2s 3s]
eldar919: checks 
nickpotss38: bets $0.12
eldar919: folds 
Uncalled bet ($0.12) returned to nickpotss38
nickpotss38 collected $0.24 from pot
nickpotss38: doesn't show hand 
*** SUMMARY ***
Total pot $0.25 | Rake $0.01 
Board [Kd 2s 3s]
Seat 1: Leonid AK74 (button) folded before Flop (didn't bet)
Seat 2: Hollseg (small blind) folded before Flop
Seat 3: eldar919 (big blind) folded on the Flop
Seat 4: khv)miz folded before Flop (didn't bet)
Seat 5: Impostore1988 folded before Flop (didn't bet)
Seat 6: nickpotss38 collected ($0.24)



PokerStars Hand #222961007159:  Hold'em No Limit ($0.05/$0.10 USD) - 2021/01/23 12:22:17 ET
Table 'Stephano III' 6-max Seat #2 is the button
Seat 1: Leonid AK74 ($7.80 in chips) 
Seat 2: Hollseg ($18.76 in chips) 
Seat 3: eldar919 ($14.25 in chips) 
Seat 4: khv)miz ($5.65 in chips) 
Seat 5: Impostore1988 ($19.43 in chips) 
Seat 6: nickpotss38 ($11.95 in chips) 
eldar919: posts small blind $0.05
khv)miz: posts big blind $0.10
*** HOLE CARDS ***
Impostore1988: folds 
nickpotss38 has timed out
nickpotss38: folds 
Leonid AK74: raises $0.25 to $0.35
Hollseg: folds 
eldar919: folds 
khv)miz: calls $0.25
*** FLOP *** [Kh Td 9h]
khv)miz: checks 
Leonid AK74: bets $0.25
khv)miz: calls $0.25
*** TURN *** [Kh Td 9h] [7h]
khv)miz: checks 
Leonid AK74: checks 
*** RIVER *** [Kh Td 9h 7h] [Tc]
khv)miz: checks 
Leonid AK74: checks 
*** SHOW DOWN ***
khv)miz: shows [2d 2h] (two pair, Tens and Deuces)
Leonid AK74: mucks hand 
khv)miz collected $1.19 from pot
*** SUMMARY ***
Total pot $1.25 | Rake $0.06 
Board [Kh Td 9h 7h Tc]
Seat 1: Leonid AK74 mucked
Seat 2: Hollseg (button) folded before Flop (didn't bet)
Seat 3: eldar919 (small blind) folded before Flop
Seat 4: khv)miz (big blind) showed [2d 2h] and won ($1.19) with two pair, Tens and Deuces
Seat 5: Impostore1988 folded before Flop (didn't bet)
Seat 6: nickpotss38 folded before Flop (didn't bet)



PokerStars Hand #222961049575:  Hold'em No Limit ($0.05/$0.10 USD) - 2021/01/23 12:23:24 ET
Table 'Stephano III' 6-max Seat #3 is the button
Seat 1: Leonid AK74 ($7.20 in chips) 
Seat 2: Hollseg ($18.76 in chips) 
Seat 3: eldar919 ($14.20 in chips) 
Seat 4: khv)miz ($6.24 in chips) 
Seat 5: Impostore1988 ($19.43 in chips) 
Seat 6: nickpotss38 ($11.95 in chips) 
khv)miz: posts small blind $0.05
Impostore1988: posts big blind $0.10
*** HOLE CARDS ***
nickpotss38: calls $0.10
Leonid AK74: folds 
Hollseg: folds 
eldar919: folds 
khv)miz: calls $0.05
Impostore1988: checks 
*** FLOP *** [3d 8d Tc]
khv)miz: checks 
Impostore1988: checks 
nickpotss38: checks 
*** TURN *** [3d 8d Tc] [2c]
khv)miz: bets $0.22
Impostore1988: folds 
nickpotss38: calls $0.22
*** RIVER *** [3d 8d Tc 2c] [Jc]
khv)miz: checks 
nickpotss38: checks 
*** SHOW DOWN ***
khv)miz: shows [Th 4c] (a pair of Tens)
nickpotss38: mucks hand 
khv)miz collected $0.71 from pot
*** SUMMARY ***
Total pot $0.74 | Rake $0.03 
Board [3d 8d Tc 2c Jc]
Seat 1: Leonid AK74 folded before Flop (didn't bet)
Seat 2: Hollseg folded before Flop (didn't bet)
Seat 3: eldar919 (button) folded before Flop (didn't bet)
Seat 4: khv)miz (small blind) showed [Th 4c] and won ($0.71) with a pair of Tens
Seat 5: Impostore1988 (big blind) folded on the Turn
Seat 6: nickpotss38 mucked



PokerStars Hand #222961087316:  Hold'em No Limit ($0.05/$0.10 USD) - 2021/01/23 12:24:11 ET
Table 'Stephano III' 6-max Seat #4 is the button
Seat 1: Leonid AK74 ($7.20 in chips) 
Seat 2: Hollseg ($18.76 in chips) 
Seat 3: eldar919 ($14.20 in chips) 
Seat 4: khv)miz ($6.63 in chips) 
Seat 5: Impostore1988 ($19.33 in chips) 
Seat 6: nickpotss38 ($11.63 in chips) 
Impostore1988: posts small blind $0.05
nickpotss38: posts big blind $0.10
*** HOLE CARDS ***
Leonid AK74: folds 
Hollseg: folds 
eldar919: folds 
khv)miz: raises $0.20 to $0.30
Impostore1988: folds 
nickpotss38: raises $0.65 to $0.95
khv)miz: calls $0.65
*** FLOP *** [6c 3c Ah]
nickpotss38: checks 
khv)miz: checks 
*** TURN *** [6c 3c Ah] [Ts]
nickpotss38: bets $0.10
khv)miz: raises $1.03 to $1.13
nickpotss38: folds 
Uncalled bet ($1.03) returned to khv)miz
khv)miz collected $2.05 from pot
khv)miz: doesn't show hand 
*** SUMMARY ***
Total pot $2.15 | Rake $0.10 
Board [6c 3c Ah Ts]
Seat 1: Leonid AK74 folded before Flop (didn't bet)
Seat 2: Hollseg folded before Flop (didn't bet)
Seat 3: eldar919 folded before Flop (didn't bet)
Seat 4: khv)miz (button) collected ($2.05)
Seat 5: Impostore1988 (small blind) folded before Flop
Seat 6: nickpotss38 (big blind) folded on the Turn



PokerStars Hand #222961108444:  Hold'em No Limit ($0.05/$0.10 USD) - 2021/01/23 12:24:44 ET
Table 'Stephano III' 6-max Seat #5 is the button
Seat 2: Hollseg ($18.76 in chips) 
Seat 3: eldar919 ($14.20 in chips) 
Seat 4: khv)miz ($7.63 in chips) 
Seat 5: Impostore1988 ($19.28 in chips) 
Seat 6: nickpotss38 ($10.58 in chips) 
nickpotss38: posts small blind $0.05
Leonid AK74 has timed out
Leonid AK74: is sitting out 
Hollseg: posts big blind $0.10
*** HOLE CARDS ***
eldar919: folds 
khv)miz: folds 
Impostore1988: folds 
nickpotss38: folds 
Uncalled bet ($0.05) returned to Hollseg
Hollseg collected $0.10 from pot
Hollseg: doesn't show hand 
*** SUMMARY ***
Total pot $0.10 | Rake $0 
Seat 2: Hollseg (big blind) collected ($0.10)
Seat 3: eldar919 folded before Flop (didn't bet)
Seat 4: khv)miz folded before Flop (didn't bet)
Seat 5: Impostore1988 (button) folded before Flop (didn't bet)
Seat 6: nickpotss38 (small blind) folded before Flop



PokerStars Hand #222961119417:  Hold'em No Limit ($0.05/$0.10 USD) - 2021/01/23 12:25:01 ET
Table 'Stephano III' 6-max Seat #6 is the button
Seat 2: Hollseg ($18.81 in chips) 
Seat 3: eldar919 ($14.20 in chips) 
Seat 4: khv)miz ($7.63 in chips) 
Seat 5: Impostore1988 ($19.28 in chips) 
Seat 6: nickpotss38 ($10.53 in chips) 
Hollseg: posts small blind $0.05
eldar919: posts big blind $0.10
*** HOLE CARDS ***
khv)miz: folds 
Impostore1988: folds 
nickpotss38: raises $0.10 to $0.20
Hollseg: folds 
eldar919: folds 
Uncalled bet ($0.10) returned to nickpotss38
nickpotss38 collected $0.25 from pot
nickpotss38: doesn't show hand 
*** SUMMARY ***
Total pot $0.25 | Rake $0 
Seat 2: Hollseg (small blind) folded before Flop
Seat 3: eldar919 (big blind) folded before Flop
Seat 4: khv)miz folded before Flop (didn't bet)
Seat 5: Impostore1988 folded before Flop (didn't bet)
Seat 6: nickpotss38 (button) collected ($0.25)



PokerStars Hand #222961127466:  Hold'em No Limit ($0.05/$0.10 USD) - 2021/01/23 12:25:13 ET
Table 'Stephano III' 6-max Seat #2 is the button
Seat 2: Hollseg ($18.76 in chips) 
Seat 3: eldar919 ($14.10 in chips) 
Seat 4: khv)miz ($7.63 in chips) 
Seat 5: Impostore1988 ($19.28 in chips) 
Seat 6: nickpotss38 ($10.68 in chips) 
eldar919: posts small blind $0.05
khv)miz: posts big blind $0.10
*** HOLE CARDS ***
Impostore1988: folds 
nickpotss38: folds 
Hollseg: raises $0.15 to $0.25
eldar919: folds 
khv)miz: calls $0.15
*** FLOP *** [Jc Ks 7h]
khv)miz: checks 
Hollseg: checks 
*** TURN *** [Jc Ks 7h] [4s]
khv)miz: checks 
Hollseg: checks 
*** RIVER *** [Jc Ks 7h 4s] [Qs]
khv)miz: bets $0.27
Hollseg: folds 
Uncalled bet ($0.27) returned to khv)miz
khv)miz collected $0.53 from pot
khv)miz: doesn't show hand 
*** SUMMARY ***
Total pot $0.55 | Rake $0.02 
Board [Jc Ks 7h 4s Qs]
Seat 2: Hollseg (button) folded on the River
Seat 3: eldar919 (small blind) folded before Flop
Seat 4: khv)miz (big blind) collected ($0.53)
Seat 5: Impostore1988 folded before Flop (didn't bet)
Seat 6: nickpotss38 folded before Flop (didn't bet)



PokerStars Hand #222961146365:  Hold'em No Limit ($0.05/$0.10 USD) - 2021/01/23 12:25:43 ET
Table 'Stephano III' 6-max Seat #3 is the button
Seat 2: Hollseg ($18.51 in chips) 
Seat 3: eldar919 ($14.05 in chips) 
Seat 4: khv)miz ($7.91 in chips) 
Seat 5: Impostore1988 ($19.28 in chips) 
Seat 6: nickpotss38 ($10.68 in chips) 
khv)miz: posts small blind $0.05
Impostore1988: posts big blind $0.10
Leonid AK74: sits out 
*** HOLE CARDS ***
nickpotss38: folds 
Hollseg: folds 
eldar919: folds 
khv)miz: folds 
Uncalled bet ($0.05) returned to Impostore1988
Impostore1988 collected $0.10 from pot
Impostore1988: doesn't show hand 
*** SUMMARY ***
Total pot $0.10 | Rake $0 
Seat 2: Hollseg folded before Flop (didn't bet)
Seat 3: eldar919 (button) folded before Flop (didn't bet)
Seat 4: khv)miz (small blind) folded before Flop
Seat 5: Impostore1988 (big blind) collected ($0.10)
Seat 6: nickpotss38 folded before Flop (didn't bet)



PokerStars Hand #222961155623:  Hold'em No Limit ($0.05/$0.10 USD) - 2021/01/23 12:25:57 ET
Table 'Stephano III' 6-max Seat #4 is the button
Seat 2: Hollseg ($18.51 in chips) 
Seat 3: eldar919 ($14.05 in chips) 
Seat 4: khv)miz ($7.86 in chips) 
Seat 5: Impostore1988 ($19.33 in chips) 
Seat 6: nickpotss38 ($10.68 in chips) 
Impostore1988: posts small blind $0.05
nickpotss38: posts big blind $0.10
Leonid AK74: sits out 
*** HOLE CARDS ***
Hollseg: folds 
eldar919: folds 
khv)miz: folds 
Impostore1988: folds 
Uncalled bet ($0.05) returned to nickpotss38
nickpotss38 collected $0.10 from pot
nickpotss38: doesn't show hand 
*** SUMMARY ***
Total pot $0.10 | Rake $0 
Seat 2: Hollseg folded before Flop (didn't bet)
Seat 3: eldar919 folded before Flop (didn't bet)
Seat 4: khv)miz (button) folded before Flop (didn't bet)
Seat 5: Impostore1988 (small blind) folded before Flop
Seat 6: nickpotss38 (big blind) collected ($0.10)



PokerStars Hand #222961166148:  Hold'em No Limit ($0.05/$0.10 USD) - 2021/01/23 12:26:13 ET
Table 'Stephano III' 6-max Seat #5 is the button
Seat 1: Leonid AK74 ($7.20 in chips) 
Seat 2: Hollseg ($18.51 in chips) 
Seat 3: eldar919 ($14.05 in chips) 
Seat 4: khv)miz ($7.86 in chips) 
Seat 5: Impostore1988 ($19.28 in chips) 
Seat 6: nickpotss38 ($10.73 in chips) 
nickpotss38: posts small blind $0.05
Leonid AK74: posts big blind $0.10
*** HOLE CARDS ***
Hollseg: folds 
eldar919: folds 
khv)miz: raises $0.20 to $0.30
Impostore1988: folds 
nickpotss38: folds 
Leonid AK74: folds 
Uncalled bet ($0.20) returned to khv)miz
khv)miz collected $0.25 from pot
khv)miz: doesn't show hand 
*** SUMMARY ***
Total pot $0.25 | Rake $0 
Seat 1: Leonid AK74 (big blind) folded before Flop
Seat 2: Hollseg folded before Flop (didn't bet)
Seat 3: eldar919 folded before Flop (didn't bet)
Seat 4: khv)miz collected ($0.25)
Seat 5: Impostore1988 (button) folded before Flop (didn't bet)
Seat 6: nickpotss38 (small blind) folded before Flop



PokerStars Hand #222961178708:  Hold'em No Limit ($0.05/$0.10 USD) - 2021/01/23 12:26:32 ET
Table 'Stephano III' 6-max Seat #6 is the button
Seat 1: Leonid AK74 ($7.10 in chips) 
Seat 2: Hollseg ($18.51 in chips) 
Seat 3: eldar919 ($14.05 in chips) 
Seat 4: khv)miz ($8.01 in chips) 
Seat 5: Impostore1988 ($19.28 in chips) 
Seat 6: nickpotss38 ($10.68 in chips) 
Leonid AK74: posts small blind $0.05
Hollseg: posts big blind $0.10
*** HOLE CARDS ***
eldar919: folds 
khv)miz: folds 
Impostore1988: folds 
nickpotss38: calls $0.10
Leonid AK74: folds 
Hollseg: checks 
*** FLOP *** [Kd 9h Ac]
Hollseg: checks 
nickpotss38: checks 
*** TURN *** [Kd 9h Ac] [3c]
Hollseg: checks 
nickpotss38: bets $0.12
Hollseg: calls $0.12
*** RIVER *** [Kd 9h Ac 3c] [Th]
Hollseg: checks 
nickpotss38: checks 
*** SHOW DOWN ***
Hollseg: shows [9c Td] (two pair, Tens and Nines)
nickpotss38: mucks hand 
Hollseg collected $0.47 from pot
*** SUMMARY ***
Total pot $0.49 | Rake $0.02 
Board [Kd 9h Ac 3c Th]
Seat 1: Leonid AK74 (small blind) folded before Flop
Seat 2: Hollseg (big blind) showed [9c Td] and won ($0.47) with two pair, Tens and Nines
Seat 3: eldar919 folded before Flop (didn't bet)
Seat 4: khv)miz folded before Flop (didn't bet)
Seat 5: Impostore1988 folded before Flop (didn't bet)
Seat 6: nickpotss38 (button) mucked



PokerStars Hand #222961204562:  Hold'em No Limit ($0.05/$0.10 USD) - 2021/01/23 12:27:12 ET
Table 'Stephano III' 6-max Seat #1 is the button
Seat 1: Leonid AK74 ($7.05 in chips) 
Seat 2: Hollseg ($18.76 in chips) 
Seat 3: eldar919 ($14.05 in chips) 
Seat 4: khv)miz ($8.01 in chips) 
Seat 5: Impostore1988 ($19.28 in chips) 
Seat 6: nickpotss38 ($10.46 in chips) 
Hollseg: posts small blind $0.05
eldar919: posts big blind $0.10
*** HOLE CARDS ***
khv)miz: raises $0.20 to $0.30
Impostore1988: folds 
nickpotss38: calls $0.30
Leonid AK74: folds 
Hollseg: folds 
eldar919: folds 
*** FLOP *** [3d Ts Kh]
khv)miz: bets $0.36
nickpotss38: calls $0.36
*** TURN *** [3d Ts Kh] [Jc]
khv)miz: checks 
nickpotss38: bets $0.70
khv)miz: calls $0.70
*** RIVER *** [3d Ts Kh Jc] [5h]
khv)miz: bets $1.37
nickpotss38: folds 
Uncalled bet ($1.37) returned to khv)miz
khv)miz collected $2.74 from pot
khv)miz: doesn't show hand 
*** SUMMARY ***
Total pot $2.87 | Rake $0.13 
Board [3d Ts Kh Jc 5h]
Seat 1: Leonid AK74 (button) folded before Flop (didn't bet)
Seat 2: Hollseg (small blind) folded before Flop
Seat 3: eldar919 (big blind) folded before Flop
Seat 4: khv)miz collected ($2.74)
Seat 5: Impostore1988 folded before Flop (didn't bet)
Seat 6: nickpotss38 folded on the River



PokerStars Hand #222961222320:  Hold'em No Limit ($0.05/$0.10 USD) - 2021/01/23 12:27:39 ET
Table 'Stephano III' 6-max Seat #2 is the button
Seat 1: Leonid AK74 ($7.05 in chips) 
Seat 2: Hollseg ($18.71 in chips) 
Seat 3: eldar919 ($13.95 in chips) 
Seat 4: khv)miz ($9.39 in chips) 
Seat 5: Impostore1988 ($19.28 in chips) 
Seat 6: nickpotss38 ($9.10 in chips) 
eldar919: posts small blind $0.05
khv)miz: posts big blind $0.10
*** HOLE CARDS ***
Impostore1988: raises $0.10 to $0.20
nickpotss38: folds 
Leonid AK74: folds 
Hollseg: folds 
eldar919: folds 
khv)miz: calls $0.10
*** FLOP *** [Jh 4h 4c]
khv)miz: checks 
Impostore1988: checks 
*** TURN *** [Jh 4h 4c] [3s]
khv)miz: checks 
Impostore1988: checks 
*** RIVER *** [Jh 4h 4c 3s] [4s]
khv)miz: checks 
Impostore1988: checks 
*** SHOW DOWN ***
khv)miz: shows [7d 5h] (three of a kind, Fours)
Impostore1988: shows [Ad 3d] (a full house, Fours full of Threes)
Impostore1988 collected $0.43 from pot
*** SUMMARY ***
Total pot $0.45 | Rake $0.02 
Board [Jh 4h 4c 3s 4s]
Seat 1: Leonid AK74 folded before Flop (didn't bet)
Seat 2: Hollseg (button) folded before Flop (didn't bet)
Seat 3: eldar919 (small blind) folded before Flop
Seat 4: khv)miz (big blind) showed [7d 5h] and lost with three of a kind, Fours
Seat 5: Impostore1988 showed [Ad 3d] and won ($0.43) with a full house, Fours full of Threes
Seat 6: nickpotss38 folded before Flop (didn't bet)



PokerStars Hand #222961253190:  Hold'em No Limit ($0.05/$0.10 USD) - 2021/01/23 12:28:26 ET
Table 'Stephano III' 6-max Seat #3 is the button
Seat 1: Leonid AK74 ($7.05 in chips) 
Seat 2: Hollseg ($18.71 in chips) 
Seat 3: eldar919 ($13.90 in chips) 
Seat 4: khv)miz ($9.19 in chips) 
Seat 5: Impostore1988 ($19.51 in chips) 
Seat 6: nickpotss38 ($9.10 in chips) 
khv)miz: posts small blind $0.05
Impostore1988: posts big blind $0.10
*** HOLE CARDS ***
nickpotss38: raises $0.10 to $0.20
Leonid AK74: folds 
Hollseg: folds 
eldar919: folds 
khv)miz: folds 
Impostore1988: calls $0.10
*** FLOP *** [3c 4d 8s]
Impostore1988: checks 
nickpotss38: bets $0.21
Impostore1988: folds 
Uncalled bet ($0.21) returned to nickpotss38
nickpotss38 collected $0.43 from pot
nickpotss38: doesn't show hand 
*** SUMMARY ***
Total pot $0.45 | Rake $0.02 
Board [3c 4d 8s]
Seat 1: Leonid AK74 folded before Flop (didn't bet)
Seat 2: Hollseg folded before Flop (didn't bet)
Seat 3: eldar919 (button) folded before Flop (didn't bet)
Seat 4: khv)miz (small blind) folded before Flop
Seat 5: Impostore1988 (big blind) folded on the Flop
Seat 6: nickpotss38 collected ($0.43)



PokerStars Hand #222961269957:  Hold'em No Limit ($0.05/$0.10 USD) - 2021/01/23 12:28:52 ET
Table 'Stephano III' 6-max Seat #4 is the button
Seat 1: Leonid AK74 ($7.05 in chips) 
Seat 2: Hollseg ($18.71 in chips) 
Seat 3: eldar919 ($13.90 in chips) 
Seat 4: khv)miz ($9.14 in chips) 
Seat 5: Impostore1988 ($19.31 in chips) 
Seat 6: nickpotss38 ($9.33 in chips) 
Impostore1988: posts small blind $0.05
nickpotss38: posts big blind $0.10
*** HOLE CARDS ***
Leonid AK74: calls $0.10
Hollseg: folds 
eldar919: folds 
khv)miz: folds 
Impostore1988: raises $0.50 to $0.60
nickpotss38: folds 
Leonid AK74: folds 
Uncalled bet ($0.50) returned to Impostore1988
Impostore1988 collected $0.30 from pot
Impostore1988: doesn't show hand 
*** SUMMARY ***
Total pot $0.30 | Rake $0 
Seat 1: Leonid AK74 folded before Flop
Seat 2: Hollseg folded before Flop (didn't bet)
Seat 3: eldar919 folded before Flop (didn't bet)
Seat 4: khv)miz (button) folded before Flop (didn't bet)
Seat 5: Impostore1988 (small blind) collected ($0.30)
Seat 6: nickpotss38 (big blind) folded before Flop



PokerStars Hand #222961290589:  Hold'em No Limit ($0.05/$0.10 USD) - 2021/01/23 12:29:24 ET
Table 'Stephano III' 6-max Seat #5 is the button
Seat 1: Leonid AK74 ($6.95 in chips) 
Seat 2: Hollseg ($18.71 in chips) 
Seat 3: eldar919 ($13.90 in chips) 
Seat 4: khv)miz ($9.14 in chips) 
Seat 5: Impostore1988 ($19.51 in chips) 
Seat 6: nickpotss38 ($9.23 in chips) 
nickpotss38: posts small blind $0.05
Leonid AK74: posts big blind $0.10
*** HOLE CARDS ***
Hollseg: folds 
eldar919: folds 
khv)miz: raises $0.20 to $0.30
Impostore1988: folds 
nickpotss38: folds 
Leonid AK74: calls $0.20
*** FLOP *** [6c Qd 5s]
Leonid AK74: checks 
khv)miz: checks 
*** TURN *** [6c Qd 5s] [6d]
Leonid AK74: checks 
khv)miz: checks 
*** RIVER *** [6c Qd 5s 6d] [Ts]
Leonid AK74: checks 
khv)miz: checks 
*** SHOW DOWN ***
Leonid AK74: shows [Th As] (two pair, Tens and Sixes)
khv)miz: mucks hand 
Leonid AK74 collected $0.62 from pot
*** SUMMARY ***
Total pot $0.65 | Rake $0.03 
Board [6c Qd 5s 6d Ts]
Seat 1: Leonid AK74 (big blind) showed [Th As] and won ($0.62) with two pair, Tens and Sixes
Seat 2: Hollseg folded before Flop (didn't bet)
Seat 3: eldar919 folded before Flop (didn't bet)
Seat 4: khv)miz mucked
Seat 5: Impostore1988 (button) folded before Flop (didn't bet)
Seat 6: nickpotss38 (small blind) folded before Flop



PokerStars Hand #222961317556:  Hold'em No Limit ($0.05/$0.10 USD) - 2021/01/23 12:30:06 ET
Table 'Stephano III' 6-max Seat #6 is the button
Seat 1: Leonid AK74 ($7.27 in chips) 
Seat 2: Hollseg ($18.71 in chips) 
Seat 3: eldar919 ($13.90 in chips) 
Seat 4: khv)miz ($8.84 in chips) 
Seat 5: Impostore1988 ($19.51 in chips) 
Seat 6: nickpotss38 ($9.18 in chips) 
Leonid AK74: posts small blind $0.05
Hollseg: posts big blind $0.10
*** HOLE CARDS ***
eldar919 has timed out
eldar919: folds 
khv)miz: raises $0.20 to $0.30
Impostore1988: folds 
nickpotss38: raises $0.75 to $1.05
Leonid AK74: folds 
Hollseg: folds 
khv)miz: calls $0.75
*** FLOP *** [Ks 4d 8h]
khv)miz: checks 
nickpotss38: bets $1.07
khv)miz: folds 
Uncalled bet ($1.07) returned to nickpotss38
nickpotss38 collected $2.15 from pot
nickpotss38: doesn't show hand 
*** SUMMARY ***
Total pot $2.25 | Rake $0.10 
Board [Ks 4d 8h]
Seat 1: Leonid AK74 (small blind) folded before Flop
Seat 2: Hollseg (big blind) folded before Flop
Seat 3: eldar919 folded before Flop (didn't bet)
Seat 4: khv)miz folded on the Flop
Seat 5: Impostore1988 folded before Flop (didn't bet)
Seat 6: nickpotss38 (button) collected ($2.15)



PokerStars Hand #222961345865:  Hold'em No Limit ($0.05/$0.10 USD) - 2021/01/23 12:30:48 ET
Table 'Stephano III' 6-max Seat #1 is the button
Seat 1: Leonid AK74 ($7.22 in chips) 
Seat 2: Hollseg ($18.61 in chips) 
Seat 4: khv)miz ($7.79 in chips) 
Seat 5: Impostore1988 ($19.51 in chips) 
Seat 6: nickpotss38 ($10.28 in chips) 
Hollseg: posts small blind $0.05
khv)miz: posts big blind $0.10
*** HOLE CARDS ***
Impostore1988: raises $0.20 to $0.30
nickpotss38: folds 
Leonid AK74: folds 
Hollseg: folds 
khv)miz: folds 
Uncalled bet ($0.20) returned to Impostore1988
Impostore1988 collected $0.25 from pot
Impostore1988: doesn't show hand 
*** SUMMARY ***
Total pot $0.25 | Rake $0 
Seat 1: Leonid AK74 (button) folded before Flop (didn't bet)
Seat 2: Hollseg (small blind) folded before Flop
Seat 4: khv)miz (big blind) folded before Flop
Seat 5: Impostore1988 collected ($0.25)
Seat 6: nickpotss38 folded before Flop (didn't bet)



PokerStars Hand #222961355223:  Hold'em No Limit ($0.05/$0.10 USD) - 2021/01/23 12:31:02 ET
Table 'Stephano III' 6-max Seat #2 is the button
Seat 1: Leonid AK74 ($7.22 in chips) 
Seat 2: Hollseg ($18.56 in chips) 
Seat 4: khv)miz ($7.69 in chips) 
Seat 5: Impostore1988 ($19.66 in chips) 
Seat 6: nickpotss38 ($10.28 in chips) 
khv)miz: posts small blind $0.05
Impostore1988: posts big blind $0.10
*** HOLE CARDS ***
nickpotss38: calls $0.10
Leonid AK74: folds 
Hollseg: folds 
khv)miz: folds 
Impostore1988: checks 
*** FLOP *** [Ks 3s 9h]
Impostore1988: checks 
nickpotss38: bets $0.12
Impostore1988: folds 
Uncalled bet ($0.12) returned to nickpotss38
nickpotss38 collected $0.24 from pot
nickpotss38: doesn't show hand 
*** SUMMARY ***
Total pot $0.25 | Rake $0.01 
Board [Ks 3s 9h]
Seat 1: Leonid AK74 folded before Flop (didn't bet)
Seat 2: Hollseg (button) folded before Flop (didn't bet)
Seat 4: khv)miz (small blind) folded before Flop
Seat 5: Impostore1988 (big blind) folded on the Flop
Seat 6: nickpotss38 collected ($0.24)



PokerStars Hand #222961369474:  Hold'em No Limit ($0.05/$0.10 USD) - 2021/01/23 12:31:24 ET
Table 'Stephano III' 6-max Seat #4 is the button
Seat 1: Leonid AK74 ($7.22 in chips) 
Seat 2: Hollseg ($18.56 in chips) 
Seat 4: khv)miz ($7.64 in chips) 
Seat 5: Impostore1988 ($19.56 in chips) 
Seat 6: nickpotss38 ($10.42 in chips) 
Impostore1988: posts small blind $0.05
nickpotss38: posts big blind $0.10
*** HOLE CARDS ***
Leonid AK74: folds 
Hollseg: folds 
khv)miz: folds 
Impostore1988: raises $0.20 to $0.30
nickpotss38: calls $0.20
*** FLOP *** [Th Kd 9h]
Impostore1988: bets $0.57
nickpotss38: calls $0.57
*** TURN *** [Th Kd 9h] [Tc]
Impostore1988: bets $0.83
nickpotss38: calls $0.83
*** RIVER *** [Th Kd 9h Tc] [Kh]
Impostore1988: checks 
nickpotss38: bets $3.25
Impostore1988: folds 
Uncalled bet ($3.25) returned to nickpotss38
nickpotss38 collected $3.25 from pot
nickpotss38: doesn't show hand 
*** SUMMARY ***
Total pot $3.40 | Rake $0.15 
Board [Th Kd 9h Tc Kh]
Seat 1: Leonid AK74 folded before Flop (didn't bet)
Seat 2: Hollseg folded before Flop (didn't bet)
Seat 4: khv)miz (button) folded before Flop (didn't bet)
Seat 5: Impostore1988 (small blind) folded on the River
Seat 6: nickpotss38 (big blind) collected ($3.25)



PokerStars Hand #222961396657:  Hold'em No Limit ($0.05/$0.10 USD) - 2021/01/23 12:32:04 ET
Table 'Stephano III' 6-max Seat #5 is the button
Seat 1: Leonid AK74 ($7.22 in chips) 
Seat 2: Hollseg ($18.56 in chips) 
Seat 4: khv)miz ($7.64 in chips) 
Seat 5: Impostore1988 ($17.86 in chips) 
Seat 6: nickpotss38 ($11.97 in chips) 
nickpotss38: posts small blind $0.05
Leonid AK74: posts big blind $0.10
*** HOLE CARDS ***
Hollseg: folds 
khv)miz: folds 
Impostore1988: folds 
nickpotss38: folds 
Uncalled bet ($0.05) returned to Leonid AK74
Leonid AK74 collected $0.10 from pot
*** SUMMARY ***
Total pot $0.10 | Rake $0 
Seat 1: Leonid AK74 (big blind) collected ($0.10)
Seat 2: Hollseg folded before Flop (didn't bet)
Seat 4: khv)miz folded before Flop (didn't bet)
Seat 5: Impostore1988 (button) folded before Flop (didn't bet)
Seat 6: nickpotss38 (small blind) folded before Flop



PokerStars Hand #222961405032:  Hold'em No Limit ($0.05/$0.10 USD) - 2021/01/23 12:32:17 ET
Table 'Stephano III' 6-max Seat #6 is the button
Seat 1: Leonid AK74 ($7.27 in chips) 
Seat 2: Hollseg ($18.56 in chips) 
Seat 4: khv)miz ($7.64 in chips) 
Seat 5: Impostore1988 ($17.86 in chips) 
Seat 6: nickpotss38 ($11.92 in chips) 
Leonid AK74: posts small blind $0.05
Hollseg: posts big blind $0.10
*** HOLE CARDS ***
khv)miz: folds 
Impostore1988: raises $0.20 to $0.30
nickpotss38: folds 
Leonid AK74: calls $0.25
Hollseg: folds 
*** FLOP *** [7s 7d 3s]
Leonid AK74: bets $0.34
Impostore1988: folds 
Uncalled bet ($0.34) returned to Leonid AK74
Leonid AK74 collected $0.67 from pot
*** SUMMARY ***
Total pot $0.70 | Rake $0.03 
Board [7s 7d 3s]
Seat 1: Leonid AK74 (small blind) collected ($0.67)
Seat 2: Hollseg (big blind) folded before Flop
Seat 4: khv)miz folded before Flop (didn't bet)
Seat 5: Impostore1988 folded on the Flop
Seat 6: nickpotss38 (button) folded before Flop (didn't bet)



PokerStars Hand #222961435592:  Hold'em No Limit ($0.05/$0.10 USD) - 2021/01/23 12:33:03 ET
Table 'Stephano III' 6-max Seat #1 is the button
Seat 1: Leonid AK74 ($7.64 in chips) 
Seat 2: Hollseg ($18.46 in chips) 
Seat 3: eldar919 ($13.90 in chips) 
Seat 4: khv)miz ($7.64 in chips) 
Seat 5: Impostore1988 ($17.56 in chips) 
Seat 6: nickpotss38 ($11.92 in chips) 
Hollseg: posts small blind $0.05
eldar919: posts big blind $0.10
*** HOLE CARDS ***
khv)miz: raises $0.20 to $0.30
Impostore1988: folds 
nickpotss38: calls $0.30
Leonid AK74: folds 
Hollseg: folds 
eldar919: folds 
*** FLOP *** [Qd Jh Ac]
khv)miz: checks 
nickpotss38: checks 
*** TURN *** [Qd Jh Ac] [Jc]
khv)miz: checks 
nickpotss38: bets $0.36
khv)miz: calls $0.36
*** RIVER *** [Qd Jh Ac Jc] [Kh]
khv)miz: checks 
nickpotss38: bets $0.70
khv)miz: calls $0.70
*** SHOW DOWN ***
nickpotss38: shows [3h Qh] (two pair, Queens and Jacks)
khv)miz: shows [Qs 9c] (two pair, Queens and Jacks)
khv)miz collected $1.37 from pot
nickpotss38 collected $1.37 from pot
*** SUMMARY ***
Total pot $2.87 | Rake $0.13 
Board [Qd Jh Ac Jc Kh]
Seat 1: Leonid AK74 (button) folded before Flop (didn't bet)
Seat 2: Hollseg (small blind) folded before Flop
Seat 3: eldar919 (big blind) folded before Flop
Seat 4: khv)miz showed [Qs 9c] and won ($1.37) with two pair, Queens and Jacks
Seat 5: Impostore1988 folded before Flop (didn't bet)
Seat 6: nickpotss38 showed [3h Qh] and won ($1.37) with two pair, Queens and Jacks



PokerStars Hand #222961467680:  Hold'em No Limit ($0.05/$0.10 USD) - 2021/01/23 12:33:51 ET
Table 'Stephano III' 6-max Seat #2 is the button
Seat 1: Leonid AK74 ($7.64 in chips) 
Seat 2: Hollseg ($18.41 in chips) 
Seat 3: eldar919 ($13.80 in chips) 
Seat 4: khv)miz ($7.65 in chips) 
Seat 5: Impostore1988 ($17.56 in chips) 
Seat 6: nickpotss38 ($11.93 in chips) 
eldar919: posts small blind $0.05
khv)miz: posts big blind $0.10
*** HOLE CARDS ***
Impostore1988: folds 
nickpotss38: folds 
Leonid AK74: folds 
Hollseg: folds 
eldar919: folds 
Uncalled bet ($0.05) returned to khv)miz
khv)miz collected $0.10 from pot
khv)miz: doesn't show hand 
*** SUMMARY ***
Total pot $0.10 | Rake $0 
Seat 1: Leonid AK74 folded before Flop (didn't bet)
Seat 2: Hollseg (button) folded before Flop (didn't bet)
Seat 3: eldar919 (small blind) folded before Flop
Seat 4: khv)miz (big blind) collected ($0.10)
Seat 5: Impostore1988 folded before Flop (didn't bet)
Seat 6: nickpotss38 folded before Flop (didn't bet)



PokerStars Hand #222961489159:  Hold'em No Limit ($0.05/$0.10 USD) - 2021/01/23 12:34:23 ET
Table 'Stephano III' 6-max Seat #3 is the button
Seat 1: Leonid AK74 ($7.64 in chips) 
Seat 2: Hollseg ($18.41 in chips) 
Seat 3: eldar919 ($13.75 in chips) 
Seat 4: khv)miz ($7.70 in chips) 
Seat 5: Impostore1988 ($17.56 in chips) 
Seat 6: nickpotss38 ($11.93 in chips) 
khv)miz: posts small blind $0.05
Impostore1988: posts big blind $0.10
*** HOLE CARDS ***
nickpotss38: raises $0.20 to $0.30
Leonid AK74: calls $0.30
Hollseg: folds 
eldar919: folds 
khv)miz: folds 
Impostore1988: folds 
*** FLOP *** [2c 6s Ts]
nickpotss38: bets $0.36
Leonid AK74: calls $0.36
*** TURN *** [2c 6s Ts] [4c]
nickpotss38: bets $0.70
Leonid AK74: calls $0.70
*** RIVER *** [2c 6s Ts 4c] [7h]
nickpotss38: bets $1.37
Leonid AK74: calls $1.37
*** SHOW DOWN ***
nickpotss38: shows [Th As] (a pair of Tens)
Leonid AK74: mucks hand 
nickpotss38 collected $5.36 from pot
*** SUMMARY ***
Total pot $5.61 | Rake $0.25 
Board [2c 6s Ts 4c 7h]
Seat 1: Leonid AK74 mucked
Seat 2: Hollseg folded before Flop (didn't bet)
Seat 3: eldar919 (button) folded before Flop (didn't bet)
Seat 4: khv)miz (small blind) folded before Flop
Seat 5: Impostore1988 (big blind) folded before Flop
Seat 6: nickpotss38 showed [Th As] and won ($5.36) with a pair of Tens



PokerStars Hand #222961518837:  Hold'em No Limit ($0.05/$0.10 USD) - 2021/01/23 12:35:07 ET
Table 'Stephano III' 6-max Seat #4 is the button
Seat 1: Leonid AK74 ($4.91 in chips) 
Seat 2: Hollseg ($18.41 in chips) 
Seat 3: eldar919 ($13.75 in chips) 
Seat 4: khv)miz ($7.65 in chips) 
Seat 5: Impostore1988 ($17.46 in chips) 
Seat 6: nickpotss38 ($14.56 in chips) 
Impostore1988: posts small blind $0.05
nickpotss38: posts big blind $0.10
*** HOLE CARDS ***
Leonid AK74: folds 
Hollseg: folds 
Leonid AK74 leaves the table
eldar919 is disconnected 
eldar919 has timed out while being disconnected
eldar919: folds 
volshebniknl joins the table at seat #1 
khv)miz: raises $0.20 to $0.30
Impostore1988: raises $0.70 to $1
nickpotss38: folds 
khv)miz: calls $0.70
*** FLOP *** [2c Kc Tc]
Impostore1988: checks 
khv)miz: bets $1.01
Impostore1988: folds 
Uncalled bet ($1.01) returned to khv)miz
khv)miz collected $2.01 from pot
khv)miz: doesn't show hand 
*** SUMMARY ***
Total pot $2.10 | Rake $0.09 
Board [2c Kc Tc]
Seat 1: Leonid AK74 folded before Flop (didn't bet)
Seat 2: Hollseg folded before Flop (didn't bet)
Seat 3: eldar919 folded before Flop (didn't bet)
Seat 4: khv)miz (button) collected ($2.01)
Seat 5: Impostore1988 (small blind) folded on the Flop
Seat 6: nickpotss38 (big blind) folded before Flop



PokerStars Hand #222961554050:  Hold'em No Limit ($0.05/$0.10 USD) - 2021/01/23 12:36:00 ET
Table 'Stephano III' 6-max Seat #5 is the button
Seat 1: volshebniknl ($10 in chips) 
Seat 2: Hollseg ($18.41 in chips) 
Seat 4: khv)miz ($8.66 in chips) 
Seat 5: Impostore1988 ($16.46 in chips) 
Seat 6: nickpotss38 ($14.46 in chips) 
nickpotss38: posts small blind $0.05
volshebniknl: posts big blind $0.10
*** HOLE CARDS ***
Hollseg: folds 
khv)miz: folds 
Impostore1988: raises $0.10 to $0.20
nickpotss38: folds 
volshebniknl: calls $0.10
*** FLOP *** [Qs Qh Kh]
volshebniknl: checks 
Impostore1988: bets $0.43
volshebniknl: folds 
Uncalled bet ($0.43) returned to Impostore1988
Impostore1988 collected $0.43 from pot
Impostore1988: doesn't show hand 
*** SUMMARY ***
Total pot $0.45 | Rake $0.02 
Board [Qs Qh Kh]
Seat 1: volshebniknl (big blind) folded on the Flop
Seat 2: Hollseg folded before Flop (didn't bet)
Seat 4: khv)miz folded before Flop (didn't bet)
Seat 5: Impostore1988 (button) collected ($0.43)
Seat 6: nickpotss38 (small blind) folded before Flop



PokerStars Hand #222961574796:  Hold'em No Limit ($0.05/$0.10 USD) - 2021/01/23 12:36:31 ET
Table 'Stephano III' 6-max Seat #6 is the button
Seat 1: volshebniknl ($10 in chips) 
Seat 2: Hollseg ($18.41 in chips) 
Seat 4: khv)miz ($8.66 in chips) 
Seat 5: Impostore1988 ($16.69 in chips) 
Seat 6: nickpotss38 ($14.41 in chips) 
volshebniknl: posts small blind $0.05
Hollseg: posts big blind $0.10
*** HOLE CARDS ***
khv)miz: raises $0.20 to $0.30
Impostore1988: folds 
nickpotss38: folds 
volshebniknl: folds 
Hollseg: folds 
Uncalled bet ($0.20) returned to khv)miz
khv)miz collected $0.25 from pot
khv)miz: doesn't show hand 
*** SUMMARY ***
Total pot $0.25 | Rake $0 
Seat 1: volshebniknl (small blind) folded before Flop
Seat 2: Hollseg (big blind) folded before Flop
Seat 4: khv)miz collected ($0.25)
Seat 5: Impostore1988 folded before Flop (didn't bet)
Seat 6: nickpotss38 (button) folded before Flop (didn't bet)



PokerStars Hand #222961582404:  Hold'em No Limit ($0.05/$0.10 USD) - 2021/01/23 12:36:42 ET
Table 'Stephano III' 6-max Seat #1 is the button
Seat 1: volshebniknl ($10 in chips) 
Seat 2: Hollseg ($18.31 in chips) 
Seat 4: khv)miz ($8.81 in chips) 
Seat 5: Impostore1988 ($16.69 in chips) 
Seat 6: nickpotss38 ($14.41 in chips) 
Hollseg: posts small blind $0.05
khv)miz: posts big blind $0.10
*** HOLE CARDS ***
Impostore1988: folds 
nickpotss38: folds 
volshebniknl: folds 
Hollseg: folds 
Uncalled bet ($0.05) returned to khv)miz
khv)miz collected $0.10 from pot
khv)miz: doesn't show hand 
*** SUMMARY ***
Total pot $0.10 | Rake $0 
Seat 1: volshebniknl (button) folded before Flop (didn't bet)
Seat 2: Hollseg (small blind) folded before Flop
Seat 4: khv)miz (big blind) collected ($0.10)
Seat 5: Impostore1988 folded before Flop (didn't bet)
Seat 6: nickpotss38 folded before Flop (didn't bet)



PokerStars Hand #222961592815:  Hold'em No Limit ($0.05/$0.10 USD) - 2021/01/23 12:36:58 ET
Table 'Stephano III' 6-max Seat #2 is the button
Seat 1: volshebniknl ($10 in chips) 
Seat 2: Hollseg ($18.26 in chips) 
Seat 4: khv)miz ($8.86 in chips) 
Seat 5: Impostore1988 ($16.69 in chips) 
Seat 6: nickpotss38 ($14.41 in chips) 
khv)miz: posts small blind $0.05
Impostore1988: posts big blind $0.10
*** HOLE CARDS ***
nickpotss38: folds 
volshebniknl: folds 
Hollseg: folds 
khv)miz: raises $0.20 to $0.30
Impostore1988: calls $0.20
*** FLOP *** [Kc As 7c]
khv)miz: bets $0.29
Impostore1988: folds 
Uncalled bet ($0.29) returned to khv)miz
khv)miz collected $0.57 from pot
khv)miz: doesn't show hand 
*** SUMMARY ***
Total pot $0.60 | Rake $0.03 
Board [Kc As 7c]
Seat 1: volshebniknl folded before Flop (didn't bet)
Seat 2: Hollseg (button) folded before Flop (didn't bet)
Seat 4: khv)miz (small blind) collected ($0.57)
Seat 5: Impostore1988 (big blind) folded on the Flop
Seat 6: nickpotss38 folded before Flop (didn't bet)



PokerStars Hand #222961604787:  Hold'em No Limit ($0.05/$0.10 USD) - 2021/01/23 12:37:16 ET
Table 'Stephano III' 6-max Seat #4 is the button
Seat 1: volshebniknl ($10 in chips) 
Seat 2: Hollseg ($18.26 in chips) 
Seat 4: khv)miz ($9.13 in chips) 
Seat 5: Impostore1988 ($16.39 in chips) 
Seat 6: nickpotss38 ($14.41 in chips) 
Impostore1988: posts small blind $0.05
nickpotss38: posts big blind $0.10
eldar919: sits out 
*** HOLE CARDS ***
volshebniknl: folds 
Hollseg: folds 
khv)miz: folds 
Impostore1988: folds 
Uncalled bet ($0.05) returned to nickpotss38
nickpotss38 collected $0.10 from pot
nickpotss38: doesn't show hand 
*** SUMMARY ***
Total pot $0.10 | Rake $0 
Seat 1: volshebniknl folded before Flop (didn't bet)
Seat 2: Hollseg folded before Flop (didn't bet)
Seat 4: khv)miz (button) folded before Flop (didn't bet)
Seat 5: Impostore1988 (small blind) folded before Flop
Seat 6: nickpotss38 (big blind) collected ($0.10)



PokerStars Hand #222961609971:  Hold'em No Limit ($0.05/$0.10 USD) - 2021/01/23 12:37:23 ET
Table 'Stephano III' 6-max Seat #5 is the button
Seat 1: volshebniknl ($10 in chips) 
Seat 2: Hollseg ($18.26 in chips) 
Seat 4: khv)miz ($9.13 in chips) 
Seat 5: Impostore1988 ($16.34 in chips) 
Seat 6: nickpotss38 ($14.46 in chips) 
nickpotss38: posts small blind $0.05
volshebniknl: posts big blind $0.10
eldar919: sits out 
*** HOLE CARDS ***
Hollseg: folds 
khv)miz: raises $0.20 to $0.30
Impostore1988: raises $0.60 to $0.90
nickpotss38: folds 
volshebniknl: folds 
khv)miz: calls $0.60
*** FLOP *** [6s Tc 5h]
khv)miz: checks 
Impostore1988: checks 
*** TURN *** [6s Tc 5h] [2s]
khv)miz: bets $0.93
Impostore1988: calls $0.93
*** RIVER *** [6s Tc 5h 2s] [7h]
khv)miz: bets $2.73
Impostore1988: folds 
Uncalled bet ($2.73) returned to khv)miz
khv)miz collected $3.64 from pot
khv)miz: doesn't show hand 
*** SUMMARY ***
Total pot $3.81 | Rake $0.17 
Board [6s Tc 5h 2s 7h]
Seat 1: volshebniknl (big blind) folded before Flop
Seat 2: Hollseg folded before Flop (didn't bet)
Seat 4: khv)miz collected ($3.64)
Seat 5: Impostore1988 (button) folded on the River
Seat 6: nickpotss38 (small blind) folded before Flop



PokerStars Hand #222961635488:  Hold'em No Limit ($0.05/$0.10 USD) - 2021/01/23 12:38:01 ET
Table 'Stephano III' 6-max Seat #6 is the button
Seat 1: volshebniknl ($10 in chips) 
Seat 2: Hollseg ($18.26 in chips) 
Seat 4: khv)miz ($10.94 in chips) 
Seat 5: Impostore1988 ($14.51 in chips) 
Seat 6: nickpotss38 ($14.41 in chips) 
volshebniknl: posts small blind $0.05
Hollseg: posts big blind $0.10
eldar919: sits out 
*** HOLE CARDS ***
khv)miz: raises $0.20 to $0.30
Impostore1988: folds 
nickpotss38: folds 
volshebniknl: folds 
Hollseg: calls $0.20
*** FLOP *** [9c 3s 2h]
Hollseg: checks 
khv)miz: checks 
*** TURN *** [9c 3s 2h] [4h]
Hollseg: checks 
khv)miz: checks 
*** RIVER *** [9c 3s 2h 4h] [Qs]
Hollseg: bets $0.90
khv)miz: calls $0.90
*** SHOW DOWN ***
Hollseg: shows [5d Ad] (a straight, Ace to Five)
khv)miz: mucks hand 
Hollseg collected $2.34 from pot
*** SUMMARY ***
Total pot $2.45 | Rake $0.11 
Board [9c 3s 2h 4h Qs]
Seat 1: volshebniknl (small blind) folded before Flop
Seat 2: Hollseg (big blind) showed [5d Ad] and won ($2.34) with a straight, Ace to Five
Seat 4: khv)miz mucked
Seat 5: Impostore1988 folded before Flop (didn't bet)
Seat 6: nickpotss38 (button) folded before Flop (didn't bet)



PokerStars Hand #222961659108:  Hold'em No Limit ($0.05/$0.10 USD) - 2021/01/23 12:38:37 ET
Table 'Stephano III' 6-max Seat #1 is the button
Seat 1: volshebniknl ($10 in chips) 
Seat 2: Hollseg ($19.40 in chips) 
Seat 3: eldar919 ($13.75 in chips) 
Seat 4: khv)miz ($9.74 in chips) 
Seat 5: Impostore1988 ($14.51 in chips) 
Seat 6: nickpotss38 ($14.41 in chips) 
Hollseg: posts small blind $0.05
eldar919: posts big blind $0.10
*** HOLE CARDS ***
khv)miz: raises $0.20 to $0.30
Impostore1988: folds 
nickpotss38: folds 
volshebniknl: folds 
Hollseg: folds 
eldar919: folds 
Uncalled bet ($0.20) returned to khv)miz
khv)miz collected $0.25 from pot
khv)miz: doesn't show hand 
*** SUMMARY ***
Total pot $0.25 | Rake $0 
Seat 1: volshebniknl (button) folded before Flop (didn't bet)
Seat 2: Hollseg (small blind) folded before Flop
Seat 3: eldar919 (big blind) folded before Flop
Seat 4: khv)miz collected ($0.25)
Seat 5: Impostore1988 folded before Flop (didn't bet)
Seat 6: nickpotss38 folded before Flop (didn't bet)



PokerStars Hand #222961675677:  Hold'em No Limit ($0.05/$0.10 USD) - 2021/01/23 12:39:01 ET
Table 'Stephano III' 6-max Seat #2 is the button
Seat 1: volshebniknl ($10 in chips) 
Seat 2: Hollseg ($19.35 in chips) 
Seat 3: eldar919 ($13.65 in chips) 
Seat 4: khv)miz ($9.89 in chips) 
Seat 5: Impostore1988 ($14.51 in chips) 
Seat 6: nickpotss38 ($14.41 in chips) 
eldar919: posts small blind $0.05
khv)miz: posts big blind $0.10
*** HOLE CARDS ***
Impostore1988: folds 
nickpotss38: folds 
volshebniknl: folds 
Hollseg: folds 
eldar919: raises $0.15 to $0.25
khv)miz: calls $0.15
*** FLOP *** [Jc 3c 9c]
eldar919: bets $0.24
khv)miz: folds 
Uncalled bet ($0.24) returned to eldar919
eldar919 collected $0.48 from pot
eldar919: doesn't show hand 
*** SUMMARY ***
Total pot $0.50 | Rake $0.02 
Board [Jc 3c 9c]
Seat 1: volshebniknl folded before Flop (didn't bet)
Seat 2: Hollseg (button) folded before Flop (didn't bet)
Seat 3: eldar919 (small blind) collected ($0.48)
Seat 4: khv)miz (big blind) folded on the Flop
Seat 5: Impostore1988 folded before Flop (didn't bet)
Seat 6: nickpotss38 folded before Flop (didn't bet)



PokerStars Hand #222959543211:  Hold'em No Limit ($0.05/$0.10 USD) - 2021/01/23 11:42:17 ET
Table 'Stephano III' 6-max Seat #1 is the button
Seat 1: Intimitatem ($12.59 in chips) 
Seat 2: Hollseg ($12.53 in chips) 
Seat 3: atticus1401 ($11.29 in chips) 
Seat 4: Daurado ($20 in chips) 
Seat 5: Impostore1988 ($9.55 in chips) 
Seat 6: nickpotss38 ($7.49 in chips) 
Hollseg: posts small blind $0.05
atticus1401: posts big blind $0.10
*** HOLE CARDS ***
Daurado: folds 
Impostore1988: raises $0.10 to $0.20
nickpotss38: folds 
Intimitatem: folds 
Hollseg: folds 
atticus1401: raises $0.10 to $0.30
Impostore1988: raises $1.10 to $1.40
atticus1401: calls $1.10
*** FLOP *** [5s 3s Qs]
atticus1401: bets $1.36
Impostore1988: calls $1.36
*** TURN *** [5s 3s Qs] [9c]
atticus1401: checks 
Impostore1988: bets $1.80
atticus1401: folds 
Uncalled bet ($1.80) returned to Impostore1988
Impostore1988 collected $5.32 from pot
Impostore1988: doesn't show hand 
*** SUMMARY ***
Total pot $5.57 | Rake $0.25 
Board [5s 3s Qs 9c]
Seat 1: Intimitatem (button) folded before Flop (didn't bet)
Seat 2: Hollseg (small blind) folded before Flop
Seat 3: atticus1401 (big blind) folded on the Turn
Seat 4: Daurado folded before Flop (didn't bet)
Seat 5: Impostore1988 collected ($5.32)
Seat 6: nickpotss38 folded before Flop (didn't bet)



PokerStars Hand #222959576436:  Hold'em No Limit ($0.05/$0.10 USD) - 2021/01/23 11:43:11 ET
Table 'Stephano III' 6-max Seat #2 is the button
Seat 1: Intimitatem ($12.59 in chips) 
Seat 2: Hollseg ($12.48 in chips) 
Seat 3: atticus1401 ($8.53 in chips) 
Seat 4: Daurado ($20 in chips) 
Seat 5: Impostore1988 ($12.11 in chips) 
Seat 6: nickpotss38 ($7.49 in chips) 
atticus1401: posts small blind $0.05
Daurado: posts big blind $0.10
*** HOLE CARDS ***
Impostore1988: folds 
nickpotss38: calls $0.10
Intimitatem: folds 
Hollseg: folds 
atticus1401: calls $0.05
Daurado: checks 
*** FLOP *** [Qs Qc 6c]
atticus1401: checks 
Daurado: checks 
nickpotss38: checks 
*** TURN *** [Qs Qc 6c] [Ah]
atticus1401: checks 
Daurado: checks 
nickpotss38: bets $0.10
atticus1401: folds 
Daurado: folds 
Uncalled bet ($0.10) returned to nickpotss38
nickpotss38 collected $0.29 from pot
nickpotss38: doesn't show hand 
*** SUMMARY ***
Total pot $0.30 | Rake $0.01 
Board [Qs Qc 6c Ah]
Seat 1: Intimitatem folded before Flop (didn't bet)
Seat 2: Hollseg (button) folded before Flop (didn't bet)
Seat 3: atticus1401 (small blind) folded on the Turn
Seat 4: Daurado (big blind) folded on the Turn
Seat 5: Impostore1988 folded before Flop (didn't bet)
Seat 6: nickpotss38 collected ($0.29)



PokerStars Hand #222959599620:  Hold'em No Limit ($0.05/$0.10 USD) - 2021/01/23 11:43:49 ET
Table 'Stephano III' 6-max Seat #3 is the button
Seat 1: Intimitatem ($12.59 in chips) 
Seat 2: Hollseg ($12.48 in chips) 
Seat 3: atticus1401 ($8.43 in chips) 
Seat 4: Daurado ($19.90 in chips) 
Seat 5: Impostore1988 ($12.11 in chips) 
Seat 6: nickpotss38 ($7.68 in chips) 
Daurado: posts small blind $0.05
Impostore1988: posts big blind $0.10
*** HOLE CARDS ***
nickpotss38: folds 
Intimitatem: folds 
Hollseg: folds 
atticus1401: calls $0.10
Daurado: raises $0.30 to $0.40
Impostore1988: folds 
atticus1401: folds 
Uncalled bet ($0.30) returned to Daurado
Daurado collected $0.30 from pot
Daurado: doesn't show hand 
*** SUMMARY ***
Total pot $0.30 | Rake $0 
Seat 1: Intimitatem folded before Flop (didn't bet)
Seat 2: Hollseg folded before Flop (didn't bet)
Seat 3: atticus1401 (button) folded before Flop
Seat 4: Daurado (small blind) collected ($0.30)
Seat 5: Impostore1988 (big blind) folded before Flop
Seat 6: nickpotss38 folded before Flop (didn't bet)



PokerStars Hand #222959609690:  Hold'em No Limit ($0.05/$0.10 USD) - 2021/01/23 11:44:05 ET
Table 'Stephano III' 6-max Seat #4 is the button
Seat 1: Intimitatem ($12.59 in chips) 
Seat 2: Hollseg ($12.48 in chips) 
Seat 3: atticus1401 ($8.33 in chips) 
Seat 4: Daurado ($20.10 in chips) 
Seat 5: Impostore1988 ($12.01 in chips) 
Seat 6: nickpotss38 ($7.68 in chips) 
Impostore1988: posts small blind $0.05
nickpotss38: posts big blind $0.10
*** HOLE CARDS ***
Intimitatem: raises $0.12 to $0.22
Hollseg: folds 
atticus1401: folds 
Daurado: folds 
Impostore1988: folds 
nickpotss38: calls $0.12
*** FLOP *** [Jd Qd Th]
nickpotss38: checks 
Intimitatem: bets $0.25
nickpotss38: folds 
Uncalled bet ($0.25) returned to Intimitatem
Intimitatem collected $0.47 from pot
Intimitatem: doesn't show hand 
*** SUMMARY ***
Total pot $0.49 | Rake $0.02 
Board [Jd Qd Th]
Seat 1: Intimitatem collected ($0.47)
Seat 2: Hollseg folded before Flop (didn't bet)
Seat 3: atticus1401 folded before Flop (didn't bet)
Seat 4: Daurado (button) folded before Flop (didn't bet)
Seat 5: Impostore1988 (small blind) folded before Flop
Seat 6: nickpotss38 (big blind) folded on the Flop



PokerStars Hand #222959634309:  Hold'em No Limit ($0.05/$0.10 USD) - 2021/01/23 11:44:45 ET
Table 'Stephano III' 6-max Seat #5 is the button
Seat 1: Intimitatem ($12.84 in chips) 
Seat 2: Hollseg ($12.48 in chips) 
Seat 3: atticus1401 ($8.33 in chips) 
Seat 4: Daurado ($20.10 in chips) 
Seat 5: Impostore1988 ($11.96 in chips) 
Seat 6: nickpotss38 ($7.46 in chips) 
nickpotss38: posts small blind $0.05
Intimitatem: posts big blind $0.10
*** HOLE CARDS ***
Hollseg: folds 
atticus1401: folds 
Daurado: folds 
Impostore1988: folds 
nickpotss38: calls $0.05
Intimitatem: raises $0.30 to $0.40
nickpotss38: calls $0.30
*** FLOP *** [3c 4d 3h]
nickpotss38: checks 
Intimitatem: bets $0.35
nickpotss38: calls $0.35
*** TURN *** [3c 4d 3h] [8d]
nickpotss38: checks 
Intimitatem: checks 
*** RIVER *** [3c 4d 3h 8d] [8h]
nickpotss38: bets $1.43
Intimitatem: calls $1.43
*** SHOW DOWN ***
nickpotss38: shows [4h 4s] (a full house, Fours full of Eights)
Intimitatem: mucks hand 
nickpotss38 collected $4.16 from pot
*** SUMMARY ***
Total pot $4.36 | Rake $0.20 
Board [3c 4d 3h 8d 8h]
Seat 1: Intimitatem (big blind) mucked
Seat 2: Hollseg folded before Flop (didn't bet)
Seat 3: atticus1401 folded before Flop (didn't bet)
Seat 4: Daurado folded before Flop (didn't bet)
Seat 5: Impostore1988 (button) folded before Flop (didn't bet)
Seat 6: nickpotss38 (small blind) showed [4h 4s] and won ($4.16) with a full house, Fours full of Eights



PokerStars Hand #222959663598:  Hold'em No Limit ($0.05/$0.10 USD) - 2021/01/23 11:45:32 ET
Table 'Stephano III' 6-max Seat #6 is the button
Seat 1: Intimitatem ($10.66 in chips) 
Seat 2: Hollseg ($12.48 in chips) 
Seat 3: atticus1401 ($8.33 in chips) 
Seat 4: Daurado ($20.10 in chips) 
Seat 5: Impostore1988 ($11.96 in chips) 
Seat 6: nickpotss38 ($9.44 in chips) 
Intimitatem: posts small blind $0.05
Hollseg: posts big blind $0.10
*** HOLE CARDS ***
atticus1401: calls $0.10
Daurado: raises $0.30 to $0.40
Impostore1988: folds 
nickpotss38: calls $0.40
Intimitatem: folds 
Hollseg: folds 
atticus1401: calls $0.30
*** FLOP *** [3d Ac 7c]
atticus1401: checks 
Daurado: bets $0.43
nickpotss38: folds 
atticus1401: calls $0.43
*** TURN *** [3d Ac 7c] [3s]
atticus1401: checks 
Daurado: checks 
*** RIVER *** [3d Ac 7c 3s] [Kd]
atticus1401: checks 
Daurado: checks 
*** SHOW DOWN ***
atticus1401: shows [5d 4d] (a pair of Threes)
Daurado: shows [Kc Tc] (two pair, Kings and Threes)
Daurado collected $2.11 from pot
*** SUMMARY ***
Total pot $2.21 | Rake $0.10 
Board [3d Ac 7c 3s Kd]
Seat 1: Intimitatem (small blind) folded before Flop
Seat 2: Hollseg (big blind) folded before Flop
Seat 3: atticus1401 showed [5d 4d] and lost with a pair of Threes
Seat 4: Daurado showed [Kc Tc] and won ($2.11) with two pair, Kings and Threes
Seat 5: Impostore1988 folded before Flop (didn't bet)
Seat 6: nickpotss38 (button) folded on the Flop



PokerStars Hand #222959697459:  Hold'em No Limit ($0.05/$0.10 USD) - 2021/01/23 11:46:27 ET
Table 'Stephano III' 6-max Seat #1 is the button
Seat 1: Intimitatem ($10.61 in chips) 
Seat 2: Hollseg ($12.38 in chips) 
Seat 3: atticus1401 ($7.50 in chips) 
Seat 4: Daurado ($21.38 in chips) 
Seat 5: Impostore1988 ($11.96 in chips) 
Seat 6: nickpotss38 ($9.04 in chips) 
Hollseg: posts small blind $0.05
atticus1401: posts big blind $0.10
*** HOLE CARDS ***
Daurado: folds 
Impostore1988: folds 
nickpotss38: folds 
Intimitatem: folds 
Hollseg: folds 
Uncalled bet ($0.05) returned to atticus1401
atticus1401 collected $0.10 from pot
atticus1401: doesn't show hand 
*** SUMMARY ***
Total pot $0.10 | Rake $0 
Seat 1: Intimitatem (button) folded before Flop (didn't bet)
Seat 2: Hollseg (small blind) folded before Flop
Seat 3: atticus1401 (big blind) collected ($0.10)
Seat 4: Daurado folded before Flop (didn't bet)
Seat 5: Impostore1988 folded before Flop (didn't bet)
Seat 6: nickpotss38 folded before Flop (didn't bet)



PokerStars Hand #222959703836:  Hold'em No Limit ($0.05/$0.10 USD) - 2021/01/23 11:46:37 ET
Table 'Stephano III' 6-max Seat #2 is the button
Seat 1: Intimitatem ($10.61 in chips) 
Seat 2: Hollseg ($12.33 in chips) 
Seat 3: atticus1401 ($7.55 in chips) 
Seat 4: Daurado ($21.38 in chips) 
Seat 5: Impostore1988 ($11.96 in chips) 
Seat 6: nickpotss38 ($9.04 in chips) 
atticus1401: posts small blind $0.05
Daurado: posts big blind $0.10
*** HOLE CARDS ***
Impostore1988: folds 
nickpotss38: calls $0.10
Intimitatem: folds 
Hollseg: folds 
atticus1401: calls $0.05
Daurado: checks 
*** FLOP *** [Kc 5d 5s]
atticus1401: checks 
Daurado: checks 
nickpotss38: checks 
*** TURN *** [Kc 5d 5s] [5h]
atticus1401: checks 
Daurado: checks 
nickpotss38: checks 
*** RIVER *** [Kc 5d 5s 5h] [7h]
atticus1401: checks 
Daurado: checks 
nickpotss38: checks 
*** SHOW DOWN ***
atticus1401: shows [Qc Tc] (three of a kind, Fives)
Daurado: shows [4h Qh] (three of a kind, Fives)
nickpotss38: shows [As Ts] (three of a kind, Fives - Ace kicker)
nickpotss38 collected $0.29 from pot
*** SUMMARY ***
Total pot $0.30 | Rake $0.01 
Board [Kc 5d 5s 5h 7h]
Seat 1: Intimitatem folded before Flop (didn't bet)
Seat 2: Hollseg (button) folded before Flop (didn't bet)
Seat 3: atticus1401 (small blind) showed [Qc Tc] and lost with three of a kind, Fives
Seat 4: Daurado (big blind) showed [4h Qh] and lost with three of a kind, Fives
Seat 5: Impostore1988 folded before Flop (didn't bet)
Seat 6: nickpotss38 showed [As Ts] and won ($0.29) with three of a kind, Fives



PokerStars Hand #222959726502:  Hold'em No Limit ($0.05/$0.10 USD) - 2021/01/23 11:47:14 ET
Table 'Stephano III' 6-max Seat #3 is the button
Seat 1: Intimitatem ($10.61 in chips) 
Seat 2: Hollseg ($12.33 in chips) 
Seat 3: atticus1401 ($7.45 in chips) 
Seat 4: Daurado ($21.28 in chips) 
Seat 5: Impostore1988 ($11.96 in chips) 
Seat 6: nickpotss38 ($9.23 in chips) 
Daurado: posts small blind $0.05
Impostore1988: posts big blind $0.10
*** HOLE CARDS ***
nickpotss38: calls $0.10
Intimitatem: raises $0.30 to $0.40
Hollseg: folds 
atticus1401: folds 
atticus1401 leaves the table
Daurado: folds 
Impostore1988: calls $0.30
nickpotss38: calls $0.30
*** FLOP *** [9c Qh 8d]
Impostore1988: checks 
nickpotss38: checks 
eldar919 joins the table at seat #3 
Intimitatem: checks 
*** TURN *** [9c Qh 8d] [2c]
Impostore1988: checks 
nickpotss38: checks 
Intimitatem: checks 
*** RIVER *** [9c Qh 8d 2c] [6s]
Impostore1988: checks 
nickpotss38: checks 
Intimitatem: checks 
*** SHOW DOWN ***
Impostore1988: shows [Jd Ac] (high card Ace)
nickpotss38: mucks hand 
Intimitatem: mucks hand 
Impostore1988 collected $1.19 from pot
*** SUMMARY ***
Total pot $1.25 | Rake $0.06 
Board [9c Qh 8d 2c 6s]
Seat 1: Intimitatem mucked
Seat 2: Hollseg folded before Flop (didn't bet)
Seat 3: atticus1401 (button) folded before Flop (didn't bet)
Seat 4: Daurado (small blind) folded before Flop
Seat 5: Impostore1988 (big blind) showed [Jd Ac] and won ($1.19) with high card Ace
Seat 6: nickpotss38 mucked



PokerStars Hand #222959753260:  Hold'em No Limit ($0.05/$0.10 USD) - 2021/01/23 11:47:57 ET
Table 'Stephano III' 6-max Seat #4 is the button
Seat 1: Intimitatem ($10.21 in chips) 
Seat 2: Hollseg ($12.33 in chips) 
Seat 4: Daurado ($21.23 in chips) 
Seat 5: Impostore1988 ($12.75 in chips) 
Seat 6: nickpotss38 ($8.83 in chips) 
Impostore1988: posts small blind $0.05
nickpotss38: posts big blind $0.10
eldar919: sits out 
*** HOLE CARDS ***
Intimitatem: raises $0.12 to $0.22
Hollseg: folds 
Daurado: folds 
Impostore1988: folds 
nickpotss38: calls $0.12
*** FLOP *** [5c Ks Js]
nickpotss38: checks 
Intimitatem: bets $0.25
nickpotss38: folds 
Uncalled bet ($0.25) returned to Intimitatem
Intimitatem collected $0.47 from pot
Intimitatem: doesn't show hand 
*** SUMMARY ***
Total pot $0.49 | Rake $0.02 
Board [5c Ks Js]
Seat 1: Intimitatem collected ($0.47)
Seat 2: Hollseg folded before Flop (didn't bet)
Seat 4: Daurado (button) folded before Flop (didn't bet)
Seat 5: Impostore1988 (small blind) folded before Flop
Seat 6: nickpotss38 (big blind) folded on the Flop



PokerStars Hand #222959769793:  Hold'em No Limit ($0.05/$0.10 USD) - 2021/01/23 11:48:24 ET
Table 'Stephano III' 6-max Seat #5 is the button
Seat 1: Intimitatem ($10.46 in chips) 
Seat 2: Hollseg ($12.33 in chips) 
Seat 4: Daurado ($21.23 in chips) 
Seat 5: Impostore1988 ($12.70 in chips) 
Seat 6: nickpotss38 ($8.61 in chips) 
nickpotss38: posts small blind $0.05
Intimitatem: posts big blind $0.10
eldar919: sits out 
*** HOLE CARDS ***
Hollseg: folds 
Daurado: raises $0.15 to $0.25
Impostore1988: folds 
nickpotss38: folds 
Intimitatem: folds 
Uncalled bet ($0.15) returned to Daurado
Daurado collected $0.25 from pot
Daurado: doesn't show hand 
*** SUMMARY ***
Total pot $0.25 | Rake $0 
Seat 1: Intimitatem (big blind) folded before Flop
Seat 2: Hollseg folded before Flop (didn't bet)
Seat 4: Daurado collected ($0.25)
Seat 5: Impostore1988 (button) folded before Flop (didn't bet)
Seat 6: nickpotss38 (small blind) folded before Flop



PokerStars Hand #222959777655:  Hold'em No Limit ($0.05/$0.10 USD) - 2021/01/23 11:48:36 ET
Table 'Stephano III' 6-max Seat #6 is the button
Seat 1: Intimitatem ($10.36 in chips) 
Seat 2: Hollseg ($12.33 in chips) 
Seat 4: Daurado ($21.38 in chips) 
Seat 5: Impostore1988 ($12.70 in chips) 
Seat 6: nickpotss38 ($8.56 in chips) 
Intimitatem: posts small blind $0.05
Hollseg: posts big blind $0.10
eldar919: sits out 
*** HOLE CARDS ***
Daurado: raises $0.20 to $0.30
Impostore1988: folds 
nickpotss38: calls $0.30
Intimitatem: raises $0.90 to $1.20
Hollseg: folds 
Daurado: folds 
nickpotss38: calls $0.90
*** FLOP *** [Ts Qh 3h]
Intimitatem: bets $1.79
nickpotss38: folds 
Uncalled bet ($1.79) returned to Intimitatem
Intimitatem collected $2.67 from pot
Intimitatem: doesn't show hand 
*** SUMMARY ***
Total pot $2.80 | Rake $0.13 
Board [Ts Qh 3h]
Seat 1: Intimitatem (small blind) collected ($2.67)
Seat 2: Hollseg (big blind) folded before Flop
Seat 4: Daurado folded before Flop
Seat 5: Impostore1988 folded before Flop (didn't bet)
Seat 6: nickpotss38 (button) folded on the Flop



PokerStars Hand #222959799393:  Hold'em No Limit ($0.05/$0.10 USD) - 2021/01/23 11:49:11 ET
Table 'Stephano III' 6-max Seat #1 is the button
Seat 1: Intimitatem ($11.83 in chips) 
Seat 2: Hollseg ($12.23 in chips) 
Seat 3: eldar919 ($10 in chips) 
Seat 4: Daurado ($21.08 in chips) 
Seat 5: Impostore1988 ($12.70 in chips) 
Seat 6: nickpotss38 ($7.36 in chips) 
Hollseg: posts small blind $0.05
eldar919: posts big blind $0.10
*** HOLE CARDS ***
Daurado: folds 
Impostore1988: folds 
nickpotss38: folds 
Intimitatem: raises $0.12 to $0.22
Hollseg: folds 
eldar919: raises $0.53 to $0.75
Intimitatem: calls $0.53
*** FLOP *** [5c Jc 9c]
eldar919: bets $0.85
Intimitatem: calls $0.85
*** TURN *** [5c Jc 9c] [Qd]
eldar919: bets $2.07
Intimitatem: raises $8.16 to $10.23 and is all-in
eldar919: folds 
Uncalled bet ($8.16) returned to Intimitatem
Intimitatem collected $7.06 from pot
Intimitatem: doesn't show hand 
*** SUMMARY ***
Total pot $7.39 | Rake $0.33 
Board [5c Jc 9c Qd]
Seat 1: Intimitatem (button) collected ($7.06)
Seat 2: Hollseg (small blind) folded before Flop
Seat 3: eldar919 (big blind) folded on the Turn
Seat 4: Daurado folded before Flop (didn't bet)
Seat 5: Impostore1988 folded before Flop (didn't bet)
Seat 6: nickpotss38 folded before Flop (didn't bet)



PokerStars Hand #222959839117:  Hold'em No Limit ($0.05/$0.10 USD) - 2021/01/23 11:50:16 ET
Table 'Stephano III' 6-max Seat #2 is the button
Seat 1: Intimitatem ($15.22 in chips) 
Seat 2: Hollseg ($12.18 in chips) 
Seat 3: eldar919 ($10 in chips) 
Seat 4: Daurado ($21.08 in chips) 
Seat 5: Impostore1988 ($12.70 in chips) 
Seat 6: nickpotss38 ($7.36 in chips) 
eldar919: posts small blind $0.05
Daurado: posts big blind $0.10
*** HOLE CARDS ***
Impostore1988: raises $0.10 to $0.20
nickpotss38: folds 
Intimitatem: folds 
Hollseg: folds 
eldar919: calls $0.15
Daurado: calls $0.10
*** FLOP *** [6d 9h As]
eldar919: checks 
Daurado: checks 
Impostore1988: bets $0.29
eldar919: folds 
Daurado: calls $0.29
*** TURN *** [6d 9h As] [3h]
Daurado: checks 
Impostore1988: bets $0.57
Daurado: calls $0.57
*** RIVER *** [6d 9h As 3h] [2d]
Daurado: checks 
Impostore1988: bets $1
Daurado: calls $1
*** SHOW DOWN ***
Impostore1988: shows [Ac Jd] (a pair of Aces)
Daurado: shows [3s Ad] (two pair, Aces and Threes)
Daurado collected $4.13 from pot
*** SUMMARY ***
Total pot $4.32 | Rake $0.19 
Board [6d 9h As 3h 2d]
Seat 1: Intimitatem folded before Flop (didn't bet)
Seat 2: Hollseg (button) folded before Flop (didn't bet)
Seat 3: eldar919 (small blind) folded on the Flop
Seat 4: Daurado (big blind) showed [3s Ad] and won ($4.13) with two pair, Aces and Threes
Seat 5: Impostore1988 showed [Ac Jd] and lost with a pair of Aces
Seat 6: nickpotss38 folded before Flop (didn't bet)



PokerStars Hand #222959880852:  Hold'em No Limit ($0.05/$0.10 USD) - 2021/01/23 11:51:23 ET
Table 'Stephano III' 6-max Seat #3 is the button
Seat 1: Intimitatem ($15.22 in chips) 
Seat 2: Hollseg ($12.18 in chips) 
Seat 3: eldar919 ($10 in chips) 
Seat 4: Daurado ($23.15 in chips) 
Seat 5: Impostore1988 ($10.64 in chips) 
Seat 6: nickpotss38 ($7.36 in chips) 
Daurado: posts small blind $0.05
Impostore1988: posts big blind $0.10
*** HOLE CARDS ***
nickpotss38: calls $0.10
Intimitatem: folds 
Hollseg: folds 
eldar919: folds 
Daurado: folds 
Impostore1988: raises $0.40 to $0.50
nickpotss38: calls $0.40
*** FLOP *** [7d Qc Ts]
Impostore1988: bets $0.70
nickpotss38: calls $0.70
*** TURN *** [7d Qc Ts] [6s]
Impostore1988: bets $1
nickpotss38: calls $1
*** RIVER *** [7d Qc Ts 6s] [Jc]
Impostore1988: bets $1.10
nickpotss38: folds 
Uncalled bet ($1.10) returned to Impostore1988
Impostore1988 collected $4.25 from pot
Impostore1988: doesn't show hand 
*** SUMMARY ***
Total pot $4.45 | Rake $0.20 
Board [7d Qc Ts 6s Jc]
Seat 1: Intimitatem folded before Flop (didn't bet)
Seat 2: Hollseg folded before Flop (didn't bet)
Seat 3: eldar919 (button) folded before Flop (didn't bet)
Seat 4: Daurado (small blind) folded before Flop
Seat 5: Impostore1988 (big blind) collected ($4.25)
Seat 6: nickpotss38 folded on the River



PokerStars Hand #222961689458:  Hold'em No Limit ($0.05/$0.10 USD) - 2021/01/23 12:39:22 ET
Table 'Stephano III' 6-max Seat #3 is the button
Seat 1: volshebniknl ($10 in chips) 
Seat 2: Hollseg ($19.35 in chips) 
Seat 3: eldar919 ($13.88 in chips) 
Seat 4: khv)miz ($9.64 in chips) 
Seat 5: Impostore1988 ($14.51 in chips) 
Seat 6: nickpotss38 ($14.41 in chips) 
khv)miz: posts small blind $0.05
Impostore1988: posts big blind $0.10
*** HOLE CARDS ***
nickpotss38: folds 
volshebniknl: folds 
Hollseg: folds 
eldar919: raises $0.15 to $0.25
khv)miz: calls $0.20
Impostore1988: folds 
*** FLOP *** [6d Ad 8c]
khv)miz: checks 
eldar919: bets $0.29
khv)miz: calls $0.29
*** TURN *** [6d Ad 8c] [7s]
khv)miz: checks 
eldar919: bets $0.75
khv)miz: calls $0.75
*** RIVER *** [6d Ad 8c 7s] [8d]
khv)miz: checks 
eldar919: checks 
*** SHOW DOWN ***
khv)miz: shows [8h 2h] (three of a kind, Eights)
eldar919: mucks hand 
khv)miz collected $2.56 from pot
*** SUMMARY ***
Total pot $2.68 | Rake $0.12 
Board [6d Ad 8c 7s 8d]
Seat 1: volshebniknl folded before Flop (didn't bet)
Seat 2: Hollseg folded before Flop (didn't bet)
Seat 3: eldar919 (button) mucked
Seat 4: khv)miz (small blind) showed [8h 2h] and won ($2.56) with three of a kind, Eights
Seat 5: Impostore1988 (big blind) folded before Flop
Seat 6: nickpotss38 folded before Flop (didn't bet)



PokerStars Hand #222961725830:  Hold'em No Limit ($0.05/$0.10 USD) - 2021/01/23 12:40:16 ET
Table 'Stephano III' 6-max Seat #4 is the button
Seat 1: volshebniknl ($10 in chips) 
Seat 2: Hollseg ($19.35 in chips) 
Seat 3: eldar919 ($12.59 in chips) 
Seat 4: khv)miz ($10.91 in chips) 
Seat 5: Impostore1988 ($14.41 in chips) 
Seat 6: nickpotss38 ($14.41 in chips) 
Impostore1988: posts small blind $0.05
nickpotss38: posts big blind $0.10
*** HOLE CARDS ***
volshebniknl: folds 
Hollseg: folds 
eldar919: raises $0.15 to $0.25
khv)miz: calls $0.25
Impostore1988: folds 
nickpotss38: folds 
*** FLOP *** [Tc 6d 4c]
nickpotss38 leaves the table
eldar919: bets $0.31
khv)miz: calls $0.31
*** TURN *** [Tc 6d 4c] [Ah]
eldar919: bets $0.61
khv)miz: calls $0.61
*** RIVER *** [Tc 6d 4c Ah] [Kd]
eldar919: checks 
khv)miz: bets $1.19
eldar919: folds 
Uncalled bet ($1.19) returned to khv)miz
khv)miz collected $2.38 from pot
khv)miz: doesn't show hand 
*** SUMMARY ***
Total pot $2.49 | Rake $0.11 
Board [Tc 6d 4c Ah Kd]
Seat 1: volshebniknl folded before Flop (didn't bet)
Seat 2: Hollseg folded before Flop (didn't bet)
Seat 3: eldar919 folded on the River
Seat 4: khv)miz (button) collected ($2.38)
Seat 5: Impostore1988 (small blind) folded before Flop
Seat 6: nickpotss38 (big blind) folded before Flop



PokerStars Hand #222961765803:  Hold'em No Limit ($0.05/$0.10 USD) - 2021/01/23 12:41:15 ET
Table 'Stephano III' 6-max Seat #5 is the button
Seat 1: volshebniknl ($10 in chips) 
Seat 2: Hollseg ($19.35 in chips) 
Seat 3: eldar919 ($11.42 in chips) 
Seat 4: khv)miz ($12.12 in chips) 
Seat 5: Impostore1988 ($14.36 in chips) 
volshebniknl: posts small blind $0.05
Hollseg: posts big blind $0.10
*** HOLE CARDS ***
4ert966 joins the table at seat #6 
eldar919: raises $0.20 to $0.30
khv)miz: calls $0.30
Impostore1988: folds 
volshebniknl: folds 
Hollseg: folds 
*** FLOP *** [6s Kc 6h]
eldar919: bets $0.36
khv)miz: raises $0.36 to $0.72
eldar919: calls $0.36
*** TURN *** [6s Kc 6h] [Js]
eldar919: checks 
khv)miz: bets $1.57
eldar919: raises $2.38 to $3.95
khv)miz: calls $2.38
*** RIVER *** [6s Kc 6h Js] [Tc]
eldar919: checks 
khv)miz: checks 
*** SHOW DOWN ***
eldar919: shows [Jh Kd] (two pair, Kings and Jacks)
khv)miz: mucks hand 
eldar919 collected $9.64 from pot
*** SUMMARY ***
Total pot $10.09 | Rake $0.45 
Board [6s Kc 6h Js Tc]
Seat 1: volshebniknl (small blind) folded before Flop
Seat 2: Hollseg (big blind) folded before Flop
Seat 3: eldar919 showed [Jh Kd] and won ($9.64) with two pair, Kings and Jacks
Seat 4: khv)miz mucked
Seat 5: Impostore1988 (button) folded before Flop (didn't bet)



PokerStars Hand #222961808314:  Hold'em No Limit ($0.05/$0.10 USD) - 2021/01/23 12:42:18 ET
Table 'Stephano III' 6-max Seat #1 is the button
Seat 1: volshebniknl ($10 in chips) 
Seat 2: Hollseg ($19.25 in chips) 
Seat 3: eldar919 ($16.09 in chips) 
Seat 4: khv)miz ($7.15 in chips) 
Seat 5: Impostore1988 ($14.36 in chips) 
Hollseg: posts small blind $0.05
eldar919: posts big blind $0.10
4ert966: sits out 
*** HOLE CARDS ***
khv)miz: raises $0.20 to $0.30
Impostore1988: folds 
volshebniknl: folds 
Hollseg: folds 
eldar919: calls $0.20
*** FLOP *** [Js 2c 6d]
eldar919: bets $0.31
khv)miz: folds 
Uncalled bet ($0.31) returned to eldar919
eldar919 collected $0.62 from pot
eldar919: doesn't show hand 
*** SUMMARY ***
Total pot $0.65 | Rake $0.03 
Board [Js 2c 6d]
Seat 1: volshebniknl (button) folded before Flop (didn't bet)
Seat 2: Hollseg (small blind) folded before Flop
Seat 3: eldar919 (big blind) collected ($0.62)
Seat 4: khv)miz folded on the Flop
Seat 5: Impostore1988 folded before Flop (didn't bet)



PokerStars Hand #222961827783:  Hold'em No Limit ($0.05/$0.10 USD) - 2021/01/23 12:42:47 ET
Table 'Stephano III' 6-max Seat #2 is the button
Seat 1: volshebniknl ($10 in chips) 
Seat 2: Hollseg ($19.20 in chips) 
Seat 3: eldar919 ($16.41 in chips) 
Seat 4: khv)miz ($6.85 in chips) 
Seat 5: Impostore1988 ($14.36 in chips) 
eldar919: posts small blind $0.05
khv)miz: posts big blind $0.10
4ert966: sits out 
*** HOLE CARDS ***
Impostore1988: folds 
volshebniknl: folds 
Hollseg: raises $0.15 to $0.25
eldar919: calls $0.20
khv)miz: calls $0.15
*** FLOP *** [6h 8d Th]
eldar919: checks 
khv)miz: checks 
Hollseg: bets $0.30
eldar919: folds 
khv)miz: folds 
Uncalled bet ($0.30) returned to Hollseg
Hollseg collected $0.72 from pot
Hollseg: doesn't show hand 
*** SUMMARY ***
Total pot $0.75 | Rake $0.03 
Board [6h 8d Th]
Seat 1: volshebniknl folded before Flop (didn't bet)
Seat 2: Hollseg (button) collected ($0.72)
Seat 3: eldar919 (small blind) folded on the Flop
Seat 4: khv)miz (big blind) folded on the Flop
Seat 5: Impostore1988 folded before Flop (didn't bet)



PokerStars Hand #222961856404:  Hold'em No Limit ($0.05/$0.10 USD) - 2021/01/23 12:43:29 ET
Table 'Stephano III' 6-max Seat #3 is the button
Seat 1: volshebniknl ($10 in chips) 
Seat 2: Hollseg ($19.67 in chips) 
Seat 3: eldar919 ($16.16 in chips) 
Seat 4: khv)miz ($6.60 in chips) 
Seat 5: Impostore1988 ($14.36 in chips) 
khv)miz: posts small blind $0.05
Impostore1988: posts big blind $0.10
4ert966: sits out 
*** HOLE CARDS ***
volshebniknl: raises $0.20 to $0.30
Hollseg: folds 
eldar919: calls $0.30
khv)miz: folds 
Impostore1988: folds 
*** FLOP *** [Ts Ah 5h]
volshebniknl: checks 
eldar919: checks 
*** TURN *** [Ts Ah 5h] [Jd]
volshebniknl: checks 
eldar919: checks 
*** RIVER *** [Ts Ah 5h Jd] [6s]
volshebniknl: checks 
eldar919: checks 
*** SHOW DOWN ***
volshebniknl: shows [Jc Qc] (a pair of Jacks)
eldar919: mucks hand 
volshebniknl collected $0.72 from pot
*** SUMMARY ***
Total pot $0.75 | Rake $0.03 
Board [Ts Ah 5h Jd 6s]
Seat 1: volshebniknl showed [Jc Qc] and won ($0.72) with a pair of Jacks
Seat 2: Hollseg folded before Flop (didn't bet)
Seat 3: eldar919 (button) mucked
Seat 4: khv)miz (small blind) folded before Flop
Seat 5: Impostore1988 (big blind) folded before Flop



PokerStars Hand #222961893355:  Hold'em No Limit ($0.05/$0.10 USD) - 2021/01/23 12:44:24 ET
Table 'Stephano III' 6-max Seat #4 is the button
Seat 1: volshebniknl ($10.42 in chips) 
Seat 2: Hollseg ($19.67 in chips) 
Seat 3: eldar919 ($15.86 in chips) 
Seat 4: khv)miz ($6.55 in chips) 
Seat 5: Impostore1988 ($14.26 in chips) 
Seat 6: 4ert966 ($8 in chips) 
Impostore1988: posts small blind $0.05
4ert966: posts big blind $0.10
*** HOLE CARDS ***
volshebniknl: folds 
Hollseg: raises $0.20 to $0.30
eldar919: calls $0.30
khv)miz: folds 
Impostore1988: folds 
4ert966: folds 
*** FLOP *** [7d 8h Kd]
Hollseg: checks 
eldar919: bets $0.36
Hollseg: folds 
Uncalled bet ($0.36) returned to eldar919
eldar919 collected $0.72 from pot
eldar919: doesn't show hand 
*** SUMMARY ***
Total pot $0.75 | Rake $0.03 
Board [7d 8h Kd]
Seat 1: volshebniknl folded before Flop (didn't bet)
Seat 2: Hollseg folded on the Flop
Seat 3: eldar919 collected ($0.72)
Seat 4: khv)miz (button) folded before Flop (didn't bet)
Seat 5: Impostore1988 (small blind) folded before Flop
Seat 6: 4ert966 (big blind) folded before Flop



PokerStars Hand #222961914908:  Hold'em No Limit ($0.05/$0.10 USD) - 2021/01/23 12:44:56 ET
Table 'Stephano III' 6-max Seat #5 is the button
Seat 1: volshebniknl ($10.42 in chips) 
Seat 2: Hollseg ($19.37 in chips) 
Seat 3: eldar919 ($16.28 in chips) 
Seat 4: khv)miz ($6.55 in chips) 
Seat 5: Impostore1988 ($14.21 in chips) 
Seat 6: 4ert966 ($7.90 in chips) 
4ert966: posts small blind $0.05
volshebniknl: posts big blind $0.10
*** HOLE CARDS ***
Hollseg: folds 
eldar919: raises $0.15 to $0.25
khv)miz: calls $0.25
Impostore1988: folds 
4ert966: folds 
volshebniknl: folds 
*** FLOP *** [Th 5d 4s]
eldar919: bets $0.31
khv)miz: calls $0.31
*** TURN *** [Th 5d 4s] [9d]
eldar919: checks 
khv)miz: checks 
*** RIVER *** [Th 5d 4s 9d] [6h]
eldar919: bets $1.21
khv)miz: folds 
Uncalled bet ($1.21) returned to eldar919
eldar919 collected $1.21 from pot
*** SUMMARY ***
Total pot $1.27 | Rake $0.06 
Board [Th 5d 4s 9d 6h]
Seat 1: volshebniknl (big blind) folded before Flop
Seat 2: Hollseg folded before Flop (didn't bet)
Seat 3: eldar919 collected ($1.21)
Seat 4: khv)miz folded on the River
Seat 5: Impostore1988 (button) folded before Flop (didn't bet)
Seat 6: 4ert966 (small blind) folded before Flop



PokerStars Hand #222961956604:  Hold'em No Limit ($0.05/$0.10 USD) - 2021/01/23 12:45:58 ET
Table 'Stephano III' 6-max Seat #6 is the button
Seat 1: volshebniknl ($10.32 in chips) 
Seat 3: eldar919 ($16.93 in chips) 
Seat 4: khv)miz ($5.99 in chips) 
Seat 5: Impostore1988 ($14.21 in chips) 
Seat 6: 4ert966 ($7.85 in chips) 
volshebniknl: posts small blind $0.05
Hollseg: is sitting out 
eldar919: posts big blind $0.10
*** HOLE CARDS ***
khv)miz: raises $0.20 to $0.30
Hollseg leaves the table
Impostore1988: raises $0.90 to $1.20
4ert966: folds 
volshebniknl: folds 
eldar919: folds 
khv)miz: calls $0.90
*** FLOP *** [9h 7h 4s]
khv)miz: checks 
Impostore1988: bets $13.01 and is all-in
khv)miz: folds 
Uncalled bet ($13.01) returned to Impostore1988
Impostore1988 collected $2.44 from pot
Impostore1988: doesn't show hand 
*** SUMMARY ***
Total pot $2.55 | Rake $0.11 
Board [9h 7h 4s]
Seat 1: volshebniknl (small blind) folded before Flop
Seat 3: eldar919 (big blind) folded before Flop
Seat 4: khv)miz folded on the Flop
Seat 5: Impostore1988 collected ($2.44)
Seat 6: 4ert966 (button) folded before Flop (didn't bet)



PokerStars Hand #222961983383:  Hold'em No Limit ($0.05/$0.10 USD) - 2021/01/23 12:46:38 ET
Table 'Stephano III' 6-max Seat #1 is the button
Seat 1: volshebniknl ($10.27 in chips) 
Seat 3: eldar919 ($16.83 in chips) 
Seat 4: khv)miz ($4.79 in chips) 
Seat 5: Impostore1988 ($15.45 in chips) 
Seat 6: 4ert966 ($7.85 in chips) 
eldar919: posts small blind $0.05
khv)miz: posts big blind $0.10
*** HOLE CARDS ***
Impostore1988: folds 
4ert966: folds 
volshebniknl: raises $0.12 to $0.22
eldar919: folds 
khv)miz: folds 
Uncalled bet ($0.12) returned to volshebniknl
volshebniknl collected $0.25 from pot
volshebniknl: doesn't show hand 
*** SUMMARY ***
Total pot $0.25 | Rake $0 
Seat 1: volshebniknl (button) collected ($0.25)
Seat 3: eldar919 (small blind) folded before Flop
Seat 4: khv)miz (big blind) folded before Flop
Seat 5: Impostore1988 folded before Flop (didn't bet)
Seat 6: 4ert966 folded before Flop (didn't bet)



PokerStars Hand #222961997537:  Hold'em No Limit ($0.05/$0.10 USD) - 2021/01/23 12:46:59 ET
Table 'Stephano III' 6-max Seat #3 is the button
Seat 1: volshebniknl ($10.42 in chips) 
Seat 3: eldar919 ($16.78 in chips) 
Seat 4: khv)miz ($4.69 in chips) 
Seat 5: Impostore1988 ($15.45 in chips) 
Seat 6: 4ert966 ($7.85 in chips) 
khv)miz: posts small blind $0.05
Impostore1988: posts big blind $0.10
*** HOLE CARDS ***
4ert966: folds 
volshebniknl: folds 
danutz784 joins the table at seat #2 
eldar919: raises $0.20 to $0.30
khv)miz: calls $0.25
Impostore1988: folds 
*** FLOP *** [7d 6s Td]
khv)miz: bets $0.34
eldar919: calls $0.34
*** TURN *** [7d 6s Td] [Ks]
khv)miz: bets $0.99
eldar919: folds 
Uncalled bet ($0.99) returned to khv)miz
khv)miz collected $1.32 from pot
khv)miz: doesn't show hand 
*** SUMMARY ***
Total pot $1.38 | Rake $0.06 
Board [7d 6s Td Ks]
Seat 1: volshebniknl folded before Flop (didn't bet)
Seat 3: eldar919 (button) folded on the Turn
Seat 4: khv)miz (small blind) collected ($1.32)
Seat 5: Impostore1988 (big blind) folded before Flop
Seat 6: 4ert966 folded before Flop (didn't bet)



PokerStars Hand #222962021723:  Hold'em No Limit ($0.05/$0.10 USD) - 2021/01/23 12:47:35 ET
Table 'Stephano III' 6-max Seat #4 is the button
Seat 1: volshebniknl ($10.42 in chips) 
Seat 2: danutz784 ($8 in chips) 
Seat 3: eldar919 ($16.14 in chips) 
Seat 4: khv)miz ($5.37 in chips) 
Seat 5: Impostore1988 ($15.35 in chips) 
Seat 6: 4ert966 ($7.85 in chips) 
Impostore1988: posts small blind $0.05
4ert966: posts big blind $0.10
danutz784: posts big blind $0.10
*** HOLE CARDS ***
volshebniknl: folds 
danutz784: checks 
eldar919: raises $0.30 to $0.40
khv)miz: calls $0.40
Impostore1988: folds 
4ert966: folds 
danutz784: calls $0.30
*** FLOP *** [9c 5h 2d]
danutz784: checks 
eldar919: checks 
khv)miz: checks 
*** TURN *** [9c 5h 2d] [Js]
danutz784: checks 
eldar919: bets $0.86
khv)miz: folds 
danutz784: folds 
Uncalled bet ($0.86) returned to eldar919
eldar919 collected $1.29 from pot
eldar919: doesn't show hand 
*** SUMMARY ***
Total pot $1.35 | Rake $0.06 
Board [9c 5h 2d Js]
Seat 1: volshebniknl folded before Flop (didn't bet)
Seat 2: danutz784 folded on the Turn
Seat 3: eldar919 collected ($1.29)
Seat 4: khv)miz (button) folded on the Turn
Seat 5: Impostore1988 (small blind) folded before Flop
Seat 6: 4ert966 (big blind) folded before Flop



PokerStars Hand #222962059009:  Hold'em No Limit ($0.05/$0.10 USD) - 2021/01/23 12:48:30 ET
Table 'Stephano III' 6-max Seat #5 is the button
Seat 1: volshebniknl ($10.42 in chips) 
Seat 2: danutz784 ($7.60 in chips) 
Seat 3: eldar919 ($17.03 in chips) 
Seat 4: khv)miz ($4.97 in chips) 
Seat 5: Impostore1988 ($15.30 in chips) 
Seat 6: 4ert966 ($7.75 in chips) 
4ert966: posts small blind $0.05
volshebniknl: posts big blind $0.10
*** HOLE CARDS ***
danutz784: raises $0.10 to $0.20
eldar919 has timed out
eldar919: folds 
khv)miz: calls $0.20
Impostore1988: folds 
4ert966: folds 
volshebniknl: calls $0.10
*** FLOP *** [7c Qd 7d]
volshebniknl: checks 
danutz784: bets $0.31
khv)miz: calls $0.31
volshebniknl: folds 
*** TURN *** [7c Qd 7d] [3c]
danutz784: bets $1.21
khv)miz: raises $1.21 to $2.42
danutz784: calls $1.21
*** RIVER *** [7c Qd 7d 3c] [Td]
danutz784: bets $4.67 and is all-in
khv)miz: calls $2.04 and is all-in
Uncalled bet ($2.63) returned to danutz784
*** SHOW DOWN ***
danutz784: shows [Th Qs] (two pair, Queens and Tens)
khv)miz: shows [Qc 9s] (two pair, Queens and Sevens)
danutz784 collected $9.73 from pot
*** SUMMARY ***
Total pot $10.19 | Rake $0.46 
Board [7c Qd 7d 3c Td]
Seat 1: volshebniknl (big blind) folded on the Flop
Seat 2: danutz784 showed [Th Qs] and won ($9.73) with two pair, Queens and Tens
Seat 3: eldar919 folded before Flop (didn't bet)
Seat 4: khv)miz showed [Qc 9s] and lost with two pair, Queens and Sevens
Seat 5: Impostore1988 (button) folded before Flop (didn't bet)
Seat 6: 4ert966 (small blind) folded before Flop



PokerStars Hand #222962096544:  Hold'em No Limit ($0.05/$0.10 USD) - 2021/01/23 12:49:25 ET
Table 'Stephano III' 6-max Seat #6 is the button
Seat 1: volshebniknl ($10.22 in chips) 
Seat 2: danutz784 ($12.36 in chips) 
Seat 3: eldar919 ($17.03 in chips) 
Seat 5: Impostore1988 ($15.30 in chips) 
Seat 6: 4ert966 ($7.70 in chips) 
volshebniknl: posts small blind $0.05
danutz784: posts big blind $0.10
*** HOLE CARDS ***
eldar919: raises $0.20 to $0.30
khv)miz leaves the table
Impostore1988 has timed out
Impostore1988: folds 
4ert966: raises $0.60 to $0.90
volshebniknl: folds 
danutz784: folds 
eldar919: folds 
Uncalled bet ($0.60) returned to 4ert966
4ert966 collected $0.75 from pot
*** SUMMARY ***
Total pot $0.75 | Rake $0 
Seat 1: volshebniknl (small blind) folded before Flop
Seat 2: danutz784 (big blind) folded before Flop
Seat 3: eldar919 folded before Flop
Seat 5: Impostore1988 folded before Flop (didn't bet)
Seat 6: 4ert966 (button) collected ($0.75)



PokerStars Hand #222962122071:  Hold'em No Limit ($0.05/$0.10 USD) - 2021/01/23 12:50:03 ET
Table 'Stephano III' 6-max Seat #1 is the button
Seat 1: volshebniknl ($10.17 in chips) 
Seat 2: danutz784 ($12.26 in chips) 
Seat 3: eldar919 ($16.73 in chips) 
Seat 5: Impostore1988 ($15.30 in chips) 
Seat 6: 4ert966 ($8.15 in chips) 
danutz784: posts small blind $0.05
eldar919: posts big blind $0.10
*** HOLE CARDS ***
legendasheff joins the table at seat #4 
Impostore1988: folds 
4ert966: raises $0.20 to $0.30
volshebniknl: calls $0.30
danutz784: calls $0.25
eldar919: calls $0.20
*** FLOP *** [2c 3c 6h]
danutz784: bets $0.10
eldar919: raises $0.68 to $0.78
4ert966: calls $0.78
volshebniknl: folds 
danutz784: folds 
*** TURN *** [2c 3c 6h] [5d]
eldar919: bets $2.05
4ert966: folds 
Uncalled bet ($2.05) returned to eldar919
eldar919 collected $2.73 from pot
eldar919: doesn't show hand 
*** SUMMARY ***
Total pot $2.86 | Rake $0.13 
Board [2c 3c 6h 5d]
Seat 1: volshebniknl (button) folded on the Flop
Seat 2: danutz784 (small blind) folded on the Flop
Seat 3: eldar919 (big blind) collected ($2.73)
Seat 5: Impostore1988 folded before Flop (didn't bet)
Seat 6: 4ert966 folded on the Turn



PokerStars Hand #222962162801:  Hold'em No Limit ($0.05/$0.10 USD) - 2021/01/23 12:51:03 ET
Table 'Stephano III' 6-max Seat #2 is the button
Seat 1: volshebniknl ($10 in chips) 
Seat 2: danutz784 ($11.86 in chips) 
Seat 3: eldar919 ($18.38 in chips) 
Seat 4: legendasheff ($10 in chips) 
Seat 5: Impostore1988 ($15.30 in chips) 
Seat 6: 4ert966 ($7.07 in chips) 
eldar919: posts small blind $0.05
legendasheff: posts big blind $0.10
*** HOLE CARDS ***
Impostore1988: folds 
4ert966: folds 
volshebniknl: folds 
danutz784: calls $0.10
eldar919: folds 
legendasheff: checks 
*** FLOP *** [Js 9s 7h]
legendasheff: checks 
danutz784: checks 
*** TURN *** [Js 9s 7h] [6h]
legendasheff: bets $0.15
danutz784: calls $0.15
*** RIVER *** [Js 9s 7h 6h] [Tc]
legendasheff: checks 
danutz784: bets $0.53
legendasheff: raises $1.27 to $1.80
danutz784: folds 
Uncalled bet ($1.27) returned to legendasheff
legendasheff collected $1.54 from pot
legendasheff: doesn't show hand 
*** SUMMARY ***
Total pot $1.61 | Rake $0.07 
Board [Js 9s 7h 6h Tc]
Seat 1: volshebniknl folded before Flop (didn't bet)
Seat 2: danutz784 (button) folded on the River
Seat 3: eldar919 (small blind) folded before Flop
Seat 4: legendasheff (big blind) collected ($1.54)
Seat 5: Impostore1988 folded before Flop (didn't bet)
Seat 6: 4ert966 folded before Flop (didn't bet)



PokerStars Hand #222962189740:  Hold'em No Limit ($0.05/$0.10 USD) - 2021/01/23 12:51:43 ET
Table 'Stephano III' 6-max Seat #3 is the button
Seat 1: volshebniknl ($10 in chips) 
Seat 2: danutz784 ($11.08 in chips) 
Seat 3: eldar919 ($18.33 in chips) 
Seat 4: legendasheff ($10.76 in chips) 
Seat 5: Impostore1988 ($15.30 in chips) 
Seat 6: 4ert966 ($7.07 in chips) 
legendasheff: posts small blind $0.05
Impostore1988: posts big blind $0.10
*** HOLE CARDS ***
4ert966: raises $0.20 to $0.30
volshebniknl: folds 
danutz784: calls $0.30
eldar919 has timed out
eldar919: folds 
legendasheff: folds 
Impostore1988: folds 
*** FLOP *** [Kh 5h 4d]
4ert966: bets $0.22
danutz784: calls $0.22
*** TURN *** [Kh 5h 4d] [5c]
4ert966: bets $0.80
danutz784: raises $2.74 to $3.54
4ert966: calls $2.74
*** RIVER *** [Kh 5h 4d 5c] [Qh]
4ert966: bets $3.01 and is all-in
danutz784: calls $3.01
*** SHOW DOWN ***
4ert966: shows [Ks Kc] (a full house, Kings full of Fives)
danutz784: shows [6s 5s] (three of a kind, Fives)
4ert966 collected $13.65 from pot
*** SUMMARY ***
Total pot $14.29 | Rake $0.64 
Board [Kh 5h 4d 5c Qh]
Seat 1: volshebniknl folded before Flop (didn't bet)
Seat 2: danutz784 showed [6s 5s] and lost with three of a kind, Fives
Seat 3: eldar919 (button) folded before Flop (didn't bet)
Seat 4: legendasheff (small blind) folded before Flop
Seat 5: Impostore1988 (big blind) folded before Flop
Seat 6: 4ert966 showed [Ks Kc] and won ($13.65) with a full house, Kings full of Fives



PokerStars Hand #222962260107:  Hold'em No Limit ($0.05/$0.10 USD) - 2021/01/23 12:53:18 ET
Table 'Stephano III' 6-max Seat #4 is the button
Seat 1: volshebniknl ($10 in chips) 
Seat 2: danutz784 ($4.01 in chips) 
Seat 3: eldar919 ($18.33 in chips) 
Seat 4: legendasheff ($10.71 in chips) 
Seat 5: Impostore1988 ($15.20 in chips) 
Seat 6: 4ert966 ($13.65 in chips) 
Impostore1988: posts small blind $0.05
4ert966: posts big blind $0.10
*** HOLE CARDS ***
volshebniknl: folds 
danutz784: calls $0.10
eldar919: raises $0.35 to $0.45
legendasheff: calls $0.45
Impostore1988: folds 
4ert966: folds 
danutz784: folds 
*** FLOP *** [8h 5c 7c]
eldar919: bets $0.55
legendasheff: calls $0.55
*** TURN *** [8h 5c 7c] [9h]
eldar919: bets $1.43
legendasheff: calls $1.43
*** RIVER *** [8h 5c 7c 9h] [3c]
eldar919: checks 
legendasheff: checks 
*** SHOW DOWN ***
eldar919: shows [Ac Ah] (a pair of Aces)
legendasheff: shows [6s 6h] (a straight, Five to Nine)
legendasheff collected $4.88 from pot
*** SUMMARY ***
Total pot $5.11 | Rake $0.23 
Board [8h 5c 7c 9h 3c]
Seat 1: volshebniknl folded before Flop (didn't bet)
Seat 2: danutz784 folded before Flop
Seat 3: eldar919 showed [Ac Ah] and lost with a pair of Aces
Seat 4: legendasheff (button) showed [6s 6h] and won ($4.88) with a straight, Five to Nine
Seat 5: Impostore1988 (small blind) folded before Flop
Seat 6: 4ert966 (big blind) folded before Flop



PokerStars Hand #222962295361:  Hold'em No Limit ($0.05/$0.10 USD) - 2021/01/23 12:54:11 ET
Table 'Stephano III' 6-max Seat #5 is the button
Seat 1: volshebniknl ($10 in chips) 
Seat 2: danutz784 ($9.35 in chips) 
Seat 3: eldar919 ($15.90 in chips) 
Seat 4: legendasheff ($13.16 in chips) 
Seat 5: Impostore1988 ($15.15 in chips) 
Seat 6: 4ert966 ($13.55 in chips) 
4ert966: posts small blind $0.05
volshebniknl: posts big blind $0.10
*** HOLE CARDS ***
danutz784: raises $0.25 to $0.35
eldar919: folds 
legendasheff: folds 
Impostore1988: folds 
4ert966: folds 
volshebniknl: folds 
Uncalled bet ($0.25) returned to danutz784
danutz784 collected $0.25 from pot
danutz784: doesn't show hand 
*** SUMMARY ***
Total pot $0.25 | Rake $0 
Seat 1: volshebniknl (big blind) folded before Flop
Seat 2: danutz784 collected ($0.25)
Seat 3: eldar919 folded before Flop (didn't bet)
Seat 4: legendasheff folded before Flop (didn't bet)
Seat 5: Impostore1988 (button) folded before Flop (didn't bet)
Seat 6: 4ert966 (small blind) folded before Flop



PokerStars Hand #222962309392:  Hold'em No Limit ($0.05/$0.10 USD) - 2021/01/23 12:54:32 ET
Table 'Stephano III' 6-max Seat #6 is the button
Seat 1: volshebniknl ($10 in chips) 
Seat 2: danutz784 ($9.50 in chips) 
Seat 3: eldar919 ($15.90 in chips) 
Seat 4: legendasheff ($13.16 in chips) 
Seat 5: Impostore1988 ($15.15 in chips) 
Seat 6: 4ert966 ($13.50 in chips) 
volshebniknl: posts small blind $0.05
danutz784: posts big blind $0.10
*** HOLE CARDS ***
eldar919: folds 
legendasheff: folds 
Impostore1988: raises $0.20 to $0.30
4ert966: folds 
volshebniknl: folds 
danutz784: folds 
Uncalled bet ($0.20) returned to Impostore1988
Impostore1988 collected $0.25 from pot
Impostore1988: doesn't show hand 
*** SUMMARY ***
Total pot $0.25 | Rake $0 
Seat 1: volshebniknl (small blind) folded before Flop
Seat 2: danutz784 (big blind) folded before Flop
Seat 3: eldar919 folded before Flop (didn't bet)
Seat 4: legendasheff folded before Flop (didn't bet)
Seat 5: Impostore1988 collected ($0.25)
Seat 6: 4ert966 (button) folded before Flop (didn't bet)



PokerStars Hand #222962330627:  Hold'em No Limit ($0.05/$0.10 USD) - 2021/01/23 12:55:03 ET
Table 'Stephano III' 6-max Seat #1 is the button
Seat 1: volshebniknl ($10 in chips) 
Seat 2: danutz784 ($9.40 in chips) 
Seat 3: eldar919 ($15.90 in chips) 
Seat 4: legendasheff ($13.16 in chips) 
Seat 5: Impostore1988 ($15.30 in chips) 
Seat 6: 4ert966 ($13.50 in chips) 
danutz784: posts small blind $0.05
eldar919: posts big blind $0.10
*** HOLE CARDS ***
legendasheff: raises $0.15 to $0.25
Impostore1988: folds 
4ert966: raises $0.50 to $0.75
volshebniknl: folds 
danutz784: calls $0.70
eldar919: folds 
legendasheff: calls $0.50
*** FLOP *** [7c 8s Jc]
danutz784: checks 
legendasheff: checks 
4ert966: bets $1.57
danutz784: folds 
legendasheff: folds 
Uncalled bet ($1.57) returned to 4ert966
4ert966 collected $2.24 from pot
*** SUMMARY ***
Total pot $2.35 | Rake $0.11 
Board [7c 8s Jc]
Seat 1: volshebniknl (button) folded before Flop (didn't bet)
Seat 2: danutz784 (small blind) folded on the Flop
Seat 3: eldar919 (big blind) folded before Flop
Seat 4: legendasheff folded on the Flop
Seat 5: Impostore1988 folded before Flop (didn't bet)
Seat 6: 4ert966 collected ($2.24)



PokerStars Hand #222962359938:  Hold'em No Limit ($0.05/$0.10 USD) - 2021/01/23 12:56:01 ET
Table 'Stephano III' 6-max Seat #2 is the button
Seat 1: volshebniknl ($10 in chips) 
Seat 2: danutz784 ($8.65 in chips) 
Seat 3: eldar919 ($15.80 in chips) 
Seat 4: legendasheff ($12.41 in chips) 
Seat 5: Impostore1988 ($15.30 in chips) 
Seat 6: 4ert966 ($14.99 in chips) 
eldar919: posts small blind $0.05
legendasheff: posts big blind $0.10
*** HOLE CARDS ***
Impostore1988: folds 
4ert966: folds 
volshebniknl: folds 
danutz784: raises $0.25 to $0.35
eldar919: calls $0.30
legendasheff: folds 
*** FLOP *** [6s Qc 5d]
eldar919: checks 
danutz784: bets $0.38
eldar919: calls $0.38
*** TURN *** [6s Qc 5d] [7h]
eldar919: bets $0.99
danutz784: calls $0.99
*** RIVER *** [6s Qc 5d 7h] [2h]
eldar919: bets $1.69
danutz784: folds 
Uncalled bet ($1.69) returned to eldar919
eldar919 collected $3.38 from pot
eldar919: doesn't show hand 
*** SUMMARY ***
Total pot $3.54 | Rake $0.16 
Board [6s Qc 5d 7h 2h]
Seat 1: volshebniknl folded before Flop (didn't bet)
Seat 2: danutz784 (button) folded on the River
Seat 3: eldar919 (small blind) collected ($3.38)
Seat 4: legendasheff (big blind) folded before Flop
Seat 5: Impostore1988 folded before Flop (didn't bet)
Seat 6: 4ert966 folded before Flop (didn't bet)



PokerStars Hand #222962388041:  Hold'em No Limit ($0.05/$0.10 USD) - 2021/01/23 12:56:58 ET
Table 'Stephano III' 6-max Seat #3 is the button
Seat 1: volshebniknl ($10 in chips) 
Seat 2: danutz784 ($6.93 in chips) 
Seat 3: eldar919 ($17.46 in chips) 
Seat 4: legendasheff ($12.31 in chips) 
Seat 5: Impostore1988 ($15.30 in chips) 
Seat 6: 4ert966 ($14.99 in chips) 
legendasheff: posts small blind $0.05
Impostore1988: posts big blind $0.10
*** HOLE CARDS ***
4ert966: raises $0.20 to $0.30
volshebniknl: folds 
danutz784: raises $1.30 to $1.60
eldar919: folds 
legendasheff: folds 
Impostore1988: folds 
4ert966: folds 
Uncalled bet ($1.30) returned to danutz784
danutz784 collected $0.75 from pot
danutz784: doesn't show hand 
*** SUMMARY ***
Total pot $0.75 | Rake $0 
Seat 1: volshebniknl folded before Flop (didn't bet)
Seat 2: danutz784 collected ($0.75)
Seat 3: eldar919 (button) folded before Flop (didn't bet)
Seat 4: legendasheff (small blind) folded before Flop
Seat 5: Impostore1988 (big blind) folded before Flop
Seat 6: 4ert966 folded before Flop



PokerStars Hand #222962404309:  Hold'em No Limit ($0.05/$0.10 USD) - 2021/01/23 12:57:31 ET
Table 'Stephano III' 6-max Seat #4 is the button
Seat 1: volshebniknl ($10 in chips) 
Seat 2: danutz784 ($7.38 in chips) 
Seat 3: eldar919 ($17.46 in chips) 
Seat 4: legendasheff ($12.26 in chips) 
Seat 5: Impostore1988 ($15.20 in chips) 
Seat 6: 4ert966 ($14.69 in chips) 
Impostore1988: posts small blind $0.05
4ert966: posts big blind $0.10
*** HOLE CARDS ***
volshebniknl: folds 
danutz784: calls $0.10
eldar919: folds 
legendasheff: folds 
Impostore1988: folds 
4ert966: checks 
*** FLOP *** [8c 9c 7s]
4ert966: checks 
danutz784: checks 
*** TURN *** [8c 9c 7s] [2c]
4ert966: checks 
danutz784: checks 
*** RIVER *** [8c 9c 7s 2c] [Ah]
4ert966: bets $0.17
danutz784: calls $0.17
*** SHOW DOWN ***
4ert966: shows [8h Kd] (a pair of Eights)
danutz784: mucks hand 
4ert966 collected $0.56 from pot
*** SUMMARY ***
Total pot $0.59 | Rake $0.03 
Board [8c 9c 7s 2c Ah]
Seat 1: volshebniknl folded before Flop (didn't bet)
Seat 2: danutz784 mucked
Seat 3: eldar919 folded before Flop (didn't bet)
Seat 4: legendasheff (button) folded before Flop (didn't bet)
Seat 5: Impostore1988 (small blind) folded before Flop
Seat 6: 4ert966 (big blind) showed [8h Kd] and won ($0.56) with a pair of Eights



PokerStars Hand #222962445322:  Hold'em No Limit ($0.05/$0.10 USD) - 2021/01/23 12:58:53 ET
Table 'Stephano III' 6-max Seat #5 is the button
Seat 1: volshebniknl ($10 in chips) 
Seat 2: danutz784 ($7.11 in chips) 
Seat 3: eldar919 ($17.46 in chips) 
Seat 4: legendasheff ($12.26 in chips) 
Seat 5: Impostore1988 ($15.15 in chips) 
Seat 6: 4ert966 ($14.98 in chips) 
4ert966: posts small blind $0.05
volshebniknl: posts big blind $0.10
*** HOLE CARDS ***
danutz784: calls $0.10
eldar919: raises $0.30 to $0.40
legendasheff: folds 
Impostore1988: folds 
4ert966: folds 
volshebniknl: folds 
danutz784: calls $0.30
*** FLOP *** [6s 6d 2c]
danutz784: checks 
eldar919: bets $0.46
danutz784: folds 
Uncalled bet ($0.46) returned to eldar919
eldar919 collected $0.91 from pot
*** SUMMARY ***
Total pot $0.95 | Rake $0.04 
Board [6s 6d 2c]
Seat 1: volshebniknl (big blind) folded before Flop
Seat 2: danutz784 folded on the Flop
Seat 3: eldar919 collected ($0.91)
Seat 4: legendasheff folded before Flop (didn't bet)
Seat 5: Impostore1988 (button) folded before Flop (didn't bet)
Seat 6: 4ert966 (small blind) folded before Flop



PokerStars Hand #222962485279:  Hold'em No Limit ($0.05/$0.10 USD) - 2021/01/23 13:00:11 ET
Table 'Stephano III' 6-max Seat #6 is the button
Seat 1: volshebniknl ($10 in chips) 
Seat 2: danutz784 ($6.71 in chips) 
Seat 3: eldar919 ($17.97 in chips) 
Seat 4: legendasheff ($12.26 in chips) 
Seat 5: Impostore1988 ($15.15 in chips) 
Seat 6: 4ert966 ($14.93 in chips) 
volshebniknl: posts small blind $0.05
danutz784: posts big blind $0.10
*** HOLE CARDS ***
eldar919: folds 
legendasheff: raises $0.15 to $0.25
Impostore1988: raises $0.75 to $1
4ert966: folds 
volshebniknl: folds 
danutz784: folds 
legendasheff: folds 
Uncalled bet ($0.75) returned to Impostore1988
Impostore1988 collected $0.65 from pot
Impostore1988: doesn't show hand 
*** SUMMARY ***
Total pot $0.65 | Rake $0 
Seat 1: volshebniknl (small blind) folded before Flop
Seat 2: danutz784 (big blind) folded before Flop
Seat 3: eldar919 folded before Flop (didn't bet)
Seat 4: legendasheff folded before Flop
Seat 5: Impostore1988 collected ($0.65)
Seat 6: 4ert966 (button) folded before Flop (didn't bet)



PokerStars Hand #222962501893:  Hold'em No Limit ($0.05/$0.10 USD) - 2021/01/23 13:00:43 ET
Table 'Stephano III' 6-max Seat #1 is the button
Seat 1: volshebniknl ($10 in chips) 
Seat 2: danutz784 ($6.61 in chips) 
Seat 3: eldar919 ($17.97 in chips) 
Seat 4: legendasheff ($12.01 in chips) 
Seat 5: Impostore1988 ($15.55 in chips) 
Seat 6: 4ert966 ($14.93 in chips) 
danutz784: posts small blind $0.05
eldar919: posts big blind $0.10
*** HOLE CARDS ***
legendasheff: folds 
Impostore1988: folds 
4ert966: folds 
volshebniknl: folds 
danutz784: calls $0.05
eldar919: raises $0.20 to $0.30
danutz784: calls $0.20
*** FLOP *** [8c 9d 3c]
danutz784: checks 
eldar919: checks 
*** TURN *** [8c 9d 3c] [Ac]
danutz784: checks 
eldar919: checks 
*** RIVER *** [8c 9d 3c Ac] [3h]
danutz784: checks 
eldar919: checks 
*** SHOW DOWN ***
danutz784: shows [Jh 4s] (a pair of Threes)
eldar919: shows [Qh Th] (a pair of Threes - Ace+Queen kicker)
eldar919 collected $0.57 from pot
*** SUMMARY ***
Total pot $0.60 | Rake $0.03 
Board [8c 9d 3c Ac 3h]
Seat 1: volshebniknl (button) folded before Flop (didn't bet)
Seat 2: danutz784 (small blind) showed [Jh 4s] and lost with a pair of Threes
Seat 3: eldar919 (big blind) showed [Qh Th] and won ($0.57) with a pair of Threes
Seat 4: legendasheff folded before Flop (didn't bet)
Seat 5: Impostore1988 folded before Flop (didn't bet)
Seat 6: 4ert966 folded before Flop (didn't bet)



PokerStars Hand #222962535582:  Hold'em No Limit ($0.05/$0.10 USD) - 2021/01/23 13:01:40 ET
Table 'Stephano III' 6-max Seat #2 is the button
Seat 1: volshebniknl ($10 in chips) 
Seat 2: danutz784 ($6.31 in chips) 
Seat 3: eldar919 ($18.24 in chips) 
Seat 4: legendasheff ($12.01 in chips) 
Seat 5: Impostore1988 ($15.55 in chips) 
Seat 6: 4ert966 ($14.93 in chips) 
eldar919: posts small blind $0.05
legendasheff: posts big blind $0.10
*** HOLE CARDS ***
Impostore1988: folds 
4ert966: folds 
volshebniknl: folds 
danutz784: folds 
volshebniknl leaves the table
pondax joins the table at seat #1 
eldar919: folds 
Uncalled bet ($0.05) returned to legendasheff
legendasheff collected $0.10 from pot
legendasheff: doesn't show hand 
*** SUMMARY ***
Total pot $0.10 | Rake $0 
Seat 1: volshebniknl folded before Flop (didn't bet)
Seat 2: danutz784 (button) folded before Flop (didn't bet)
Seat 3: eldar919 (small blind) folded before Flop
Seat 4: legendasheff (big blind) collected ($0.10)
Seat 5: Impostore1988 folded before Flop (didn't bet)
Seat 6: 4ert966 folded before Flop (didn't bet)



PokerStars Hand #222962559608:  Hold'em No Limit ($0.05/$0.10 USD) - 2021/01/23 13:02:18 ET
Table 'Stephano III' 6-max Seat #3 is the button
Seat 2: danutz784 ($6.31 in chips) 
Seat 3: eldar919 ($18.19 in chips) 
Seat 4: legendasheff ($12.06 in chips) 
Seat 5: Impostore1988 ($15.55 in chips) 
Seat 6: 4ert966 ($14.93 in chips) 
legendasheff: posts small blind $0.05
Impostore1988: posts big blind $0.10
pondax: sits out 
*** HOLE CARDS ***
4ert966: folds 
danutz784: calls $0.10
eldar919: folds 
legendasheff: folds 
Impostore1988: checks 
*** FLOP *** [7d 4c 2c]
Impostore1988: checks 
danutz784: bets $0.10
Impostore1988: folds 
Uncalled bet ($0.10) returned to danutz784
danutz784 collected $0.24 from pot
danutz784: doesn't show hand 
*** SUMMARY ***
Total pot $0.25 | Rake $0.01 
Board [7d 4c 2c]
Seat 2: danutz784 collected ($0.24)
Seat 3: eldar919 (button) folded before Flop (didn't bet)
Seat 4: legendasheff (small blind) folded before Flop
Seat 5: Impostore1988 (big blind) folded on the Flop
Seat 6: 4ert966 folded before Flop (didn't bet)



PokerStars Hand #222962583549:  Hold'em No Limit ($0.05/$0.10 USD) - 2021/01/23 13:02:53 ET
Table 'Stephano III' 6-max Seat #4 is the button
Seat 2: danutz784 ($6.45 in chips) 
Seat 3: eldar919 ($18.19 in chips) 
Seat 4: legendasheff ($12.01 in chips) 
Seat 5: Impostore1988 ($15.45 in chips) 
Seat 6: 4ert966 ($14.93 in chips) 
Impostore1988: posts small blind $0.05
4ert966: posts big blind $0.10
pondax: sits out 
*** HOLE CARDS ***
danutz784: folds 
eldar919: raises $0.15 to $0.25
legendasheff: folds 
Impostore1988: folds 
4ert966: folds 
Uncalled bet ($0.15) returned to eldar919
eldar919 collected $0.25 from pot
eldar919: doesn't show hand 
*** SUMMARY ***
Total pot $0.25 | Rake $0 
Seat 2: danutz784 folded before Flop (didn't bet)
Seat 3: eldar919 collected ($0.25)
Seat 4: legendasheff (button) folded before Flop (didn't bet)
Seat 5: Impostore1988 (small blind) folded before Flop
Seat 6: 4ert966 (big blind) folded before Flop



PokerStars Hand #222962599496:  Hold'em No Limit ($0.05/$0.10 USD) - 2021/01/23 13:03:17 ET
Table 'Stephano III' 6-max Seat #5 is the button
Seat 1: pondax ($10 in chips) 
Seat 2: danutz784 ($6.45 in chips) 
Seat 3: eldar919 ($18.34 in chips) 
Seat 4: legendasheff ($12.01 in chips) 
Seat 5: Impostore1988 ($15.40 in chips) 
Seat 6: 4ert966 ($14.83 in chips) 
4ert966: posts small blind $0.05
pondax: posts big blind $0.10
*** HOLE CARDS ***
danutz784: raises $0.10 to $0.20
eldar919: calls $0.20
legendasheff: folds 
Impostore1988: folds 
4ert966: folds 
pondax: folds 
*** FLOP *** [2c 7d 4d]
danutz784: bets $0.53
eldar919: folds 
Uncalled bet ($0.53) returned to danutz784
danutz784 collected $0.53 from pot
danutz784: doesn't show hand 
*** SUMMARY ***
Total pot $0.55 | Rake $0.02 
Board [2c 7d 4d]
Seat 1: pondax (big blind) folded before Flop
Seat 2: danutz784 collected ($0.53)
Seat 3: eldar919 folded on the Flop
Seat 4: legendasheff folded before Flop (didn't bet)
Seat 5: Impostore1988 (button) folded before Flop (didn't bet)
Seat 6: 4ert966 (small blind) folded before Flop



PokerStars Hand #222962620456:  Hold'em No Limit ($0.05/$0.10 USD) - 2021/01/23 13:03:48 ET
Table 'Stephano III' 6-max Seat #6 is the button
Seat 1: pondax ($9.90 in chips) 
Seat 2: danutz784 ($6.78 in chips) 
Seat 3: eldar919 ($18.14 in chips) 
Seat 4: legendasheff ($12.01 in chips) 
Seat 5: Impostore1988 ($15.40 in chips) 
Seat 6: 4ert966 ($14.78 in chips) 
pondax: posts small blind $0.05
danutz784: posts big blind $0.10
*** HOLE CARDS ***
eldar919: folds 
legendasheff has timed out
legendasheff: folds 
Impostore1988: folds 
4ert966: raises $0.20 to $0.30
pondax: folds 
danutz784: raises $0.75 to $1.05
4ert966: calls $0.75
*** FLOP *** [2c 3d Ah]
danutz784: bets $5.73 and is all-in
4ert966 is disconnected 
4ert966 is connected 
4ert966: folds 
Uncalled bet ($5.73) returned to danutz784
danutz784 collected $2.05 from pot
danutz784: doesn't show hand 
*** SUMMARY ***
Total pot $2.15 | Rake $0.10 
Board [2c 3d Ah]
Seat 1: pondax (small blind) folded before Flop
Seat 2: danutz784 (big blind) collected ($2.05)
Seat 3: eldar919 folded before Flop (didn't bet)
Seat 4: legendasheff folded before Flop (didn't bet)
Seat 5: Impostore1988 folded before Flop (didn't bet)
Seat 6: 4ert966 (button) folded on the Flop



PokerStars Hand #222962764734:  Hold'em No Limit ($0.05/$0.10 USD) - 2021/01/23 13:07:16 ET
Table 'Stephano III' 6-max Seat #1 is the button
Seat 1: pondax ($10 in chips) 
Seat 2: danutz784 ($7.78 in chips) 
Seat 3: eldar919 ($18.14 in chips) 
Seat 5: Impostore1988 ($15.40 in chips) 
Seat 6: 4ert966 ($13.73 in chips) 
danutz784: posts small blind $0.05
eldar919: posts big blind $0.10
*** HOLE CARDS ***
Impostore1988: raises $0.10 to $0.20
4ert966: folds 
pondax: folds 
danutz784: folds 
eldar919: folds 
Uncalled bet ($0.10) returned to Impostore1988
Impostore1988 collected $0.25 from pot
Impostore1988: doesn't show hand 
*** SUMMARY ***
Total pot $0.25 | Rake $0 
Seat 1: pondax (button) folded before Flop (didn't bet)
Seat 2: danutz784 (small blind) folded before Flop
Seat 3: eldar919 (big blind) folded before Flop
Seat 5: Impostore1988 collected ($0.25)
Seat 6: 4ert966 folded before Flop (didn't bet)



PokerStars Hand #222962777096:  Hold'em No Limit ($0.05/$0.10 USD) - 2021/01/23 13:07:34 ET
Table 'Stephano III' 6-max Seat #2 is the button
Seat 1: pondax ($10 in chips) 
Seat 2: danutz784 ($7.73 in chips) 
Seat 3: eldar919 ($18.04 in chips) 
Seat 4: legendasheff ($12.01 in chips) 
Seat 5: Impostore1988 ($15.55 in chips) 
Seat 6: 4ert966 ($13.73 in chips) 
eldar919: posts small blind $0.05
legendasheff: posts big blind $0.10
*** HOLE CARDS ***
Impostore1988: folds 
4ert966: folds 
pondax: folds 
danutz784: calls $0.10
eldar919: raises $0.20 to $0.30
legendasheff: folds 
danutz784: folds 
Uncalled bet ($0.20) returned to eldar919
eldar919 collected $0.30 from pot
*** SUMMARY ***
Total pot $0.30 | Rake $0 
Seat 1: pondax folded before Flop (didn't bet)
Seat 2: danutz784 (button) folded before Flop
Seat 3: eldar919 (small blind) collected ($0.30)
Seat 4: legendasheff (big blind) folded before Flop
Seat 5: Impostore1988 folded before Flop (didn't bet)
Seat 6: 4ert966 folded before Flop (didn't bet)



PokerStars Hand #222962792982:  Hold'em No Limit ($0.05/$0.10 USD) - 2021/01/23 13:07:57 ET
Table 'Stephano III' 6-max Seat #3 is the button
Seat 1: pondax ($10 in chips) 
Seat 2: danutz784 ($7.63 in chips) 
Seat 3: eldar919 ($18.24 in chips) 
Seat 4: legendasheff ($11.91 in chips) 
Seat 5: Impostore1988 ($15.55 in chips) 
Seat 6: 4ert966 ($13.73 in chips) 
legendasheff: posts small blind $0.05
Impostore1988: posts big blind $0.10
*** HOLE CARDS ***
4ert966: raises $0.20 to $0.30
pondax: folds 
danutz784: calls $0.30
eldar919: calls $0.30
legendasheff: folds 
Impostore1988: calls $0.20
*** FLOP *** [3s 6c Kd]
Impostore1988: bets $0.60
4ert966: calls $0.60
danutz784: raises $0.60 to $1.20
eldar919: folds 
Impostore1988: folds 
4ert966: calls $0.60
*** TURN *** [3s 6c Kd] [Qh]
4ert966: checks 
danutz784: bets $2.03
4ert966: folds 
Uncalled bet ($2.03) returned to danutz784
danutz784 collected $4.06 from pot
danutz784: doesn't show hand 
*** SUMMARY ***
Total pot $4.25 | Rake $0.19 
Board [3s 6c Kd Qh]
Seat 1: pondax folded before Flop (didn't bet)
Seat 2: danutz784 collected ($4.06)
Seat 3: eldar919 (button) folded on the Flop
Seat 4: legendasheff (small blind) folded before Flop
Seat 5: Impostore1988 (big blind) folded on the Flop
Seat 6: 4ert966 folded on the Turn



PokerStars Hand #222962841122:  Hold'em No Limit ($0.05/$0.10 USD) - 2021/01/23 13:09:07 ET
Table 'Stephano III' 6-max Seat #4 is the button
Seat 1: pondax ($10 in chips) 
Seat 2: danutz784 ($10.19 in chips) 
Seat 3: eldar919 ($17.94 in chips) 
Seat 4: legendasheff ($11.86 in chips) 
Seat 5: Impostore1988 ($14.65 in chips) 
Seat 6: 4ert966 ($12.23 in chips) 
Impostore1988: posts small blind $0.05
4ert966: posts big blind $0.10
*** HOLE CARDS ***
pondax: folds 
danutz784: calls $0.10
eldar919: folds 
legendasheff: raises $0.25 to $0.35
Impostore1988: folds 
4ert966: folds 
danutz784: calls $0.25
*** FLOP *** [Kc 3h 8c]
danutz784: checks 
legendasheff: bets $0.27
danutz784: calls $0.27
*** TURN *** [Kc 3h 8c] [7c]
danutz784: checks 
legendasheff: bets $1.06
danutz784: calls $1.06
*** RIVER *** [Kc 3h 8c 7c] [As]
danutz784: checks 
legendasheff: bets $2.68
danutz784: calls $2.68
*** SHOW DOWN ***
legendasheff: shows [8s 8d] (three of a kind, Eights)
danutz784: mucks hand 
legendasheff collected $8.47 from pot
*** SUMMARY ***
Total pot $8.87 | Rake $0.40 
Board [Kc 3h 8c 7c As]
Seat 1: pondax folded before Flop (didn't bet)
Seat 2: danutz784 mucked
Seat 3: eldar919 folded before Flop (didn't bet)
Seat 4: legendasheff (button) showed [8s 8d] and won ($8.47) with three of a kind, Eights
Seat 5: Impostore1988 (small blind) folded before Flop
Seat 6: 4ert966 (big blind) folded before Flop



PokerStars Hand #222962871112:  Hold'em No Limit ($0.05/$0.10 USD) - 2021/01/23 13:09:51 ET
Table 'Stephano III' 6-max Seat #5 is the button
Seat 1: pondax ($10 in chips) 
Seat 2: danutz784 ($5.83 in chips) 
Seat 3: eldar919 ($17.94 in chips) 
Seat 4: legendasheff ($15.97 in chips) 
Seat 5: Impostore1988 ($14.60 in chips) 
Seat 6: 4ert966 ($12.13 in chips) 
4ert966: posts small blind $0.05
pondax: posts big blind $0.10
*** HOLE CARDS ***
danutz784: folds 
eldar919: folds 
legendasheff: folds 
Impostore1988: raises $0.20 to $0.30
4ert966: folds 
pondax: folds 
Uncalled bet ($0.20) returned to Impostore1988
Impostore1988 collected $0.25 from pot
Impostore1988: doesn't show hand 
*** SUMMARY ***
Total pot $0.25 | Rake $0 
Seat 1: pondax (big blind) folded before Flop
Seat 2: danutz784 folded before Flop (didn't bet)
Seat 3: eldar919 folded before Flop (didn't bet)
Seat 4: legendasheff folded before Flop (didn't bet)
Seat 5: Impostore1988 (button) collected ($0.25)
Seat 6: 4ert966 (small blind) folded before Flop



PokerStars Hand #222962885505:  Hold'em No Limit ($0.05/$0.10 USD) - 2021/01/23 13:10:12 ET
Table 'Stephano III' 6-max Seat #6 is the button
Seat 1: pondax ($9.90 in chips) 
Seat 2: danutz784 ($5.83 in chips) 
Seat 3: eldar919 ($17.94 in chips) 
Seat 4: legendasheff ($15.97 in chips) 
Seat 5: Impostore1988 ($14.75 in chips) 
Seat 6: 4ert966 ($12.08 in chips) 
pondax: posts small blind $0.05
danutz784: posts big blind $0.10
*** HOLE CARDS ***
eldar919: folds 
legendasheff: folds 
Impostore1988: folds 
4ert966: folds 
pondax: folds 
Uncalled bet ($0.05) returned to danutz784
danutz784 collected $0.10 from pot
danutz784: doesn't show hand 
*** SUMMARY ***
Total pot $0.10 | Rake $0 
Seat 1: pondax (small blind) folded before Flop
Seat 2: danutz784 (big blind) collected ($0.10)
Seat 3: eldar919 folded before Flop (didn't bet)
Seat 4: legendasheff folded before Flop (didn't bet)
Seat 5: Impostore1988 folded before Flop (didn't bet)
Seat 6: 4ert966 (button) folded before Flop (didn't bet)



PokerStars Hand #222962897779:  Hold'em No Limit ($0.05/$0.10 USD) - 2021/01/23 13:10:30 ET
Table 'Stephano III' 6-max Seat #1 is the button
Seat 1: pondax ($10 in chips) 
Seat 2: danutz784 ($5.88 in chips) 
Seat 3: eldar919 ($17.94 in chips) 
Seat 4: legendasheff ($15.97 in chips) 
Seat 5: Impostore1988 ($14.75 in chips) 
Seat 6: 4ert966 ($12.08 in chips) 
danutz784: posts small blind $0.05
eldar919: posts big blind $0.10
*** HOLE CARDS ***
legendasheff: folds 
Impostore1988: folds 
4ert966: folds 
pondax: folds 
danutz784: calls $0.05
eldar919: checks 
*** FLOP *** [7c Jd 4c]
danutz784: bets $0.69
eldar919: folds 
Uncalled bet ($0.69) returned to danutz784
danutz784 collected $0.19 from pot
danutz784: doesn't show hand 
*** SUMMARY ***
Total pot $0.20 | Rake $0.01 
Board [7c Jd 4c]
Seat 1: pondax (button) folded before Flop (didn't bet)
Seat 2: danutz784 (small blind) collected ($0.19)
Seat 3: eldar919 (big blind) folded on the Flop
Seat 4: legendasheff folded before Flop (didn't bet)
Seat 5: Impostore1988 folded before Flop (didn't bet)
Seat 6: 4ert966 folded before Flop (didn't bet)



PokerStars Hand #222962923136:  Hold'em No Limit ($0.05/$0.10 USD) - 2021/01/23 13:11:07 ET
Table 'Stephano III' 6-max Seat #2 is the button
Seat 1: pondax ($10 in chips) 
Seat 2: danutz784 ($5.97 in chips) 
Seat 3: eldar919 ($17.84 in chips) 
Seat 4: legendasheff ($15.97 in chips) 
Seat 5: Impostore1988 ($14.75 in chips) 
Seat 6: 4ert966 ($12.08 in chips) 
eldar919: posts small blind $0.05
legendasheff: posts big blind $0.10
*** HOLE CARDS ***
Impostore1988: folds 
4ert966: raises $0.20 to $0.30
pondax: folds 
danutz784: folds 
eldar919: folds 
legendasheff: folds 
Uncalled bet ($0.20) returned to 4ert966
4ert966 collected $0.25 from pot
4ert966: doesn't show hand 
*** SUMMARY ***
Total pot $0.25 | Rake $0 
Seat 1: pondax folded before Flop (didn't bet)
Seat 2: danutz784 (button) folded before Flop (didn't bet)
Seat 3: eldar919 (small blind) folded before Flop
Seat 4: legendasheff (big blind) folded before Flop
Seat 5: Impostore1988 folded before Flop (didn't bet)
Seat 6: 4ert966 collected ($0.25)



PokerStars Hand #222962935909:  Hold'em No Limit ($0.05/$0.10 USD) - 2021/01/23 13:11:25 ET
Table 'Stephano III' 6-max Seat #3 is the button
Seat 1: pondax ($10 in chips) 
Seat 2: danutz784 ($5.97 in chips) 
Seat 3: eldar919 ($17.79 in chips) 
Seat 4: legendasheff ($15.87 in chips) 
Seat 5: Impostore1988 ($14.75 in chips) 
Seat 6: 4ert966 ($12.23 in chips) 
legendasheff: posts small blind $0.05
Impostore1988: posts big blind $0.10
*** HOLE CARDS ***
4ert966: folds 
pondax: folds 
danutz784: folds 
eldar919: folds 
legendasheff: raises $0.15 to $0.25
Impostore1988: calls $0.15
*** FLOP *** [8h 2h 6c]
legendasheff: bets $0.16
Impostore1988: calls $0.16
*** TURN *** [8h 2h 6c] [Kc]
legendasheff: bets $0.62
Impostore1988: calls $0.62
*** RIVER *** [8h 2h 6c Kc] [Th]
legendasheff: checks 
Impostore1988: bets $2
legendasheff: folds 
Uncalled bet ($2) returned to Impostore1988
Impostore1988 collected $1.97 from pot
Impostore1988: doesn't show hand 
*** SUMMARY ***
Total pot $2.06 | Rake $0.09 
Board [8h 2h 6c Kc Th]
Seat 1: pondax folded before Flop (didn't bet)
Seat 2: danutz784 folded before Flop (didn't bet)
Seat 3: eldar919 (button) folded before Flop (didn't bet)
Seat 4: legendasheff (small blind) folded on the River
Seat 5: Impostore1988 (big blind) collected ($1.97)
Seat 6: 4ert966 folded before Flop (didn't bet)



PokerStars Hand #222962966123:  Hold'em No Limit ($0.05/$0.10 USD) - 2021/01/23 13:12:10 ET
Table 'Stephano III' 6-max Seat #4 is the button
Seat 1: pondax ($10 in chips) 
Seat 2: danutz784 ($5.97 in chips) 
Seat 3: eldar919 ($17.79 in chips) 
Seat 4: legendasheff ($14.84 in chips) 
Seat 5: Impostore1988 ($15.69 in chips) 
Seat 6: 4ert966 ($12.23 in chips) 
Impostore1988: posts small blind $0.05
4ert966: posts big blind $0.10
*** HOLE CARDS ***
pondax: folds 
danutz784: calls $0.10
eldar919: folds 
legendasheff: folds 
Impostore1988: calls $0.05
4ert966: checks 
*** FLOP *** [5c 5s 9s]
Impostore1988: checks 
4ert966: checks 
danutz784: checks 
*** TURN *** [5c 5s 9s] [9c]
Impostore1988: checks 
4ert966: checks 
danutz784: checks 
*** RIVER *** [5c 5s 9s 9c] [6c]
Impostore1988: checks 
4ert966: checks 
danutz784: bets $0.29
Impostore1988: folds 
4ert966: calls $0.29
*** SHOW DOWN ***
danutz784: shows [7c 4c] (a flush, Nine high)
4ert966: mucks hand 
danutz784 collected $0.84 from pot
*** SUMMARY ***
Total pot $0.88 | Rake $0.04 
Board [5c 5s 9s 9c 6c]
Seat 1: pondax folded before Flop (didn't bet)
Seat 2: danutz784 showed [7c 4c] and won ($0.84) with a flush, Nine high
Seat 3: eldar919 folded before Flop (didn't bet)
Seat 4: legendasheff (button) folded before Flop (didn't bet)
Seat 5: Impostore1988 (small blind) folded on the River
Seat 6: 4ert966 (big blind) mucked



PokerStars Hand #222963007383:  Hold'em No Limit ($0.05/$0.10 USD) - 2021/01/23 13:13:10 ET
Table 'Stephano III' 6-max Seat #5 is the button
Seat 1: pondax ($10 in chips) 
Seat 2: danutz784 ($6.42 in chips) 
Seat 3: eldar919 ($17.79 in chips) 
Seat 4: legendasheff ($14.84 in chips) 
Seat 5: Impostore1988 ($15.59 in chips) 
Seat 6: 4ert966 ($11.84 in chips) 
4ert966: posts small blind $0.05
pondax: posts big blind $0.10
*** HOLE CARDS ***
danutz784: folds 
eldar919: raises $0.15 to $0.25
legendasheff: folds 
Impostore1988: calls $0.25
4ert966: folds 
pondax: folds 
*** FLOP *** [Kd 3d Jd]
eldar919: checks 
Impostore1988: checks 
*** TURN *** [Kd 3d Jd] [Qc]
eldar919: bets $0.41
Impostore1988: raises $1.19 to $1.60
eldar919: folds 
Uncalled bet ($1.19) returned to Impostore1988
Impostore1988 collected $1.40 from pot
Impostore1988: doesn't show hand 
*** SUMMARY ***
Total pot $1.47 | Rake $0.07 
Board [Kd 3d Jd Qc]
Seat 1: pondax (big blind) folded before Flop
Seat 2: danutz784 folded before Flop (didn't bet)
Seat 3: eldar919 folded on the Turn
Seat 4: legendasheff folded before Flop (didn't bet)
Seat 5: Impostore1988 (button) collected ($1.40)
Seat 6: 4ert966 (small blind) folded before Flop



PokerStars Hand #222963039703:  Hold'em No Limit ($0.05/$0.10 USD) - 2021/01/23 13:13:57 ET
Table 'Stephano III' 6-max Seat #6 is the button
Seat 1: pondax ($9.90 in chips) 
Seat 2: danutz784 ($6.42 in chips) 
Seat 3: eldar919 ($17.13 in chips) 
Seat 4: legendasheff ($14.84 in chips) 
Seat 5: Impostore1988 ($16.33 in chips) 
Seat 6: 4ert966 ($11.79 in chips) 
pondax: posts small blind $0.05
danutz784: posts big blind $0.10
*** HOLE CARDS ***
eldar919: folds 
legendasheff: folds 
Impostore1988: folds 
4ert966: raises $0.20 to $0.30
pondax: folds 
danutz784: calls $0.20
*** FLOP *** [Qs Ts As]
danutz784: bets $0.31
4ert966: calls $0.31
*** TURN *** [Qs Ts As] [2d]
danutz784: bets $0.60
4ert966: raises $8.60 to $9.20
danutz784: folds 
Uncalled bet ($8.60) returned to 4ert966
4ert966 collected $2.36 from pot
4ert966: doesn't show hand 
*** SUMMARY ***
Total pot $2.47 | Rake $0.11 
Board [Qs Ts As 2d]
Seat 1: pondax (small blind) folded before Flop
Seat 2: danutz784 (big blind) folded on the Turn
Seat 3: eldar919 folded before Flop (didn't bet)
Seat 4: legendasheff folded before Flop (didn't bet)
Seat 5: Impostore1988 folded before Flop (didn't bet)
Seat 6: 4ert966 (button) collected ($2.36)



PokerStars Hand #222963068602:  Hold'em No Limit ($0.05/$0.10 USD) - 2021/01/23 13:14:40 ET
Table 'Stephano III' 6-max Seat #1 is the button
Seat 1: pondax ($10 in chips) 
Seat 2: danutz784 ($5.21 in chips) 
Seat 3: eldar919 ($17.13 in chips) 
Seat 4: legendasheff ($14.84 in chips) 
Seat 5: Impostore1988 ($16.33 in chips) 
Seat 6: 4ert966 ($12.94 in chips) 
danutz784: posts small blind $0.05
eldar919: posts big blind $0.10
*** HOLE CARDS ***
legendasheff: folds 
Impostore1988: folds 
4ert966: folds 
pondax: folds 
danutz784: folds 
Uncalled bet ($0.05) returned to eldar919
danutz784 leaves the table
eldar919 collected $0.10 from pot
*** SUMMARY ***
Total pot $0.10 | Rake $0 
Seat 1: pondax (button) folded before Flop (didn't bet)
Seat 2: danutz784 (small blind) folded before Flop
Seat 3: eldar919 (big blind) collected ($0.10)
Seat 4: legendasheff folded before Flop (didn't bet)
Seat 5: Impostore1988 folded before Flop (didn't bet)
Seat 6: 4ert966 folded before Flop (didn't bet)



PokerStars Hand #222963093366:  Hold'em No Limit ($0.05/$0.10 USD) - 2021/01/23 13:15:03 ET
Table 'Stephano III' 6-max Seat #3 is the button
Seat 1: pondax ($10 in chips) 
Seat 3: eldar919 ($17.18 in chips) 
Seat 4: legendasheff ($14.84 in chips) 
Seat 5: Impostore1988 ($16.33 in chips) 
Seat 6: 4ert966 ($12.94 in chips) 
legendasheff: posts small blind $0.05
Impostore1988: posts big blind $0.10
*** HOLE CARDS ***
4ert966: folds 
pondax: raises $0.20 to $0.30
eldar919: calls $0.30
legendasheff: calls $0.25
Impostore1988: folds 
*** FLOP *** [5c 4d 5s]
legendasheff: checks 
pondax: checks 
eldar919: checks 
*** TURN *** [5c 4d 5s] [3s]
legendasheff: bets $0.63
pondax: folds 
eldar919: folds 
Uncalled bet ($0.63) returned to legendasheff
legendasheff collected $0.96 from pot
legendasheff: doesn't show hand 
*** SUMMARY ***
Total pot $1 | Rake $0.04 
Board [5c 4d 5s 3s]
Seat 1: pondax folded on the Turn
Seat 3: eldar919 (button) folded on the Turn
Seat 4: legendasheff (small blind) collected ($0.96)
Seat 5: Impostore1988 (big blind) folded before Flop
Seat 6: 4ert966 folded before Flop (didn't bet)



PokerStars Hand #222963119751:  Hold'em No Limit ($0.05/$0.10 USD) - 2021/01/23 13:15:39 ET
Table 'Stephano III' 6-max Seat #4 is the button
Seat 1: pondax ($10 in chips) 
Seat 3: eldar919 ($16.88 in chips) 
Seat 4: legendasheff ($15.50 in chips) 
Seat 5: Impostore1988 ($16.23 in chips) 
Seat 6: 4ert966 ($12.94 in chips) 
Impostore1988: posts small blind $0.05
4ert966: posts big blind $0.10
*** HOLE CARDS ***
pondax: folds 
eldar919: raises $0.15 to $0.25
legendasheff: folds 
Impostore1988: folds 
4ert966: folds 
Uncalled bet ($0.15) returned to eldar919
eldar919 collected $0.25 from pot
eldar919: doesn't show hand 
*** SUMMARY ***
Total pot $0.25 | Rake $0 
Seat 1: pondax folded before Flop (didn't bet)
Seat 3: eldar919 collected ($0.25)
Seat 4: legendasheff (button) folded before Flop (didn't bet)
Seat 5: Impostore1988 (small blind) folded before Flop
Seat 6: 4ert966 (big blind) folded before Flop



PokerStars Hand #222963130045:  Hold'em No Limit ($0.05/$0.10 USD) - 2021/01/23 13:15:53 ET
Table 'Stephano III' 6-max Seat #5 is the button
Seat 1: pondax ($10 in chips) 
Seat 3: eldar919 ($17.03 in chips) 
Seat 4: legendasheff ($15.50 in chips) 
Seat 5: Impostore1988 ($16.18 in chips) 
Seat 6: 4ert966 ($12.84 in chips) 
4ert966: posts small blind $0.05
pondax: posts big blind $0.10
*** HOLE CARDS ***
eldar919: folds 
legendasheff: raises $0.15 to $0.25
Impostore1988: folds 
4ert966: folds 
pondax: folds 
Uncalled bet ($0.15) returned to legendasheff
legendasheff collected $0.25 from pot
legendasheff: doesn't show hand 
*** SUMMARY ***
Total pot $0.25 | Rake $0 
Seat 1: pondax (big blind) folded before Flop
Seat 3: eldar919 folded before Flop (didn't bet)
Seat 4: legendasheff collected ($0.25)
Seat 5: Impostore1988 (button) folded before Flop (didn't bet)
Seat 6: 4ert966 (small blind) folded before Flop



PokerStars Hand #222963143993:  Hold'em No Limit ($0.05/$0.10 USD) - 2021/01/23 13:16:12 ET
Table 'Stephano III' 6-max Seat #6 is the button
Seat 1: pondax ($9.90 in chips) 
Seat 5: Impostore1988 ($16.18 in chips) 
Seat 6: 4ert966 ($12.79 in chips) 
pondax: posts small blind $0.05
eldar919: is sitting out 
legendasheff: is sitting out 
legendasheff leaves the table
Impostore1988: posts big blind $0.10
*** HOLE CARDS ***
4ert966: folds 
pondax: raises $0.20 to $0.30
Impostore1988: folds 
Uncalled bet ($0.20) returned to pondax
pondax collected $0.20 from pot
pondax: doesn't show hand 
*** SUMMARY ***
Total pot $0.20 | Rake $0 
Seat 1: pondax (small blind) collected ($0.20)
Seat 5: Impostore1988 (big blind) folded before Flop
Seat 6: 4ert966 (button) folded before Flop (didn't bet)



PokerStars Hand #222963153968:  Hold'em No Limit ($0.05/$0.10 USD) - 2021/01/23 13:16:25 ET
Table 'Stephano III' 6-max Seat #5 is the button
Seat 1: pondax ($10 in chips) 
Seat 5: Impostore1988 ($16.08 in chips) 
Impostore1988: posts small blind $0.05
pondax: posts big blind $0.10
*** HOLE CARDS ***
eldar919 leaves the table
Impostore1988: raises $0.20 to $0.30
pondax: folds 
Uncalled bet ($0.20) returned to Impostore1988
Impostore1988 collected $0.20 from pot
Impostore1988: doesn't show hand 
*** SUMMARY ***
Total pot $0.20 | Rake $0 
Seat 1: pondax (big blind) folded before Flop
Seat 5: Impostore1988 (button) (small blind) collected ($0.20)



PokerStars Hand #222963274960:  Hold'em No Limit ($0.05/$0.10 USD) - 2021/01/23 13:18:57 ET
Table 'Stephano III' 6-max Seat #2 is the button
Seat 2: Timakas ($4 in chips) 
Seat 3: DimaLesnoy ($10 in chips) 
Timakas: posts small blind $0.05
DimaLesnoy: posts big blind $0.10
*** HOLE CARDS ***
Timakas: calls $0.05
DimaLesnoy: checks 
*** FLOP *** [3h 3c 7s]
DimaLesnoy: checks 
Timakas: checks 
*** TURN *** [3h 3c 7s] [6d]
DimaLesnoy: bets $0.13
Timakas: calls $0.13
*** RIVER *** [3h 3c 7s 6d] [2s]
DimaLesnoy: checks 
Timakas: bets $0.40
DimaLesnoy: folds 
Uncalled bet ($0.40) returned to Timakas
Timakas collected $0.44 from pot
Timakas: doesn't show hand 
*** SUMMARY ***
Total pot $0.46 | Rake $0.02 
Board [3h 3c 7s 6d 2s]
Seat 2: Timakas (button) (small blind) collected ($0.44)
Seat 3: DimaLesnoy (big blind) folded on the River



PokerStars Hand #222963298962:  Hold'em No Limit ($0.05/$0.10 USD) - 2021/01/23 13:19:29 ET
Table 'Stephano III' 6-max Seat #3 is the button
Seat 2: Timakas ($4.21 in chips) 
Seat 3: DimaLesnoy ($10 in chips) 
DimaLesnoy: posts small blind $0.05
Timakas: posts big blind $0.10
*** HOLE CARDS ***
DimaLesnoy: folds 
Uncalled bet ($0.05) returned to Timakas
Timakas collected $0.10 from pot
Timakas: doesn't show hand 
*** SUMMARY ***
Total pot $0.10 | Rake $0 
Seat 2: Timakas (big blind) collected ($0.10)
Seat 3: DimaLesnoy (button) (small blind) folded before Flop



PokerStars Hand #222963301637:  Hold'em No Limit ($0.05/$0.10 USD) - 2021/01/23 13:19:33 ET
Table 'Stephano III' 6-max Seat #2 is the button
Seat 2: Timakas ($4.26 in chips) 
Seat 3: DimaLesnoy ($10 in chips) 
Timakas: posts small blind $0.05
DimaLesnoy: posts big blind $0.10
*** HOLE CARDS ***
Timakas: calls $0.05
DimaLesnoy: checks 
*** FLOP *** [Qs 2d 7h]
DimaLesnoy: checks 
Timakas: checks 
*** TURN *** [Qs 2d 7h] [Jh]
DimaLesnoy: checks 
Timakas: bets $0.20
DimaLesnoy: folds 
Uncalled bet ($0.20) returned to Timakas
Timakas collected $0.19 from pot
Timakas: doesn't show hand 
*** SUMMARY ***
Total pot $0.20 | Rake $0.01 
Board [Qs 2d 7h Jh]
Seat 2: Timakas (button) (small blind) collected ($0.19)
Seat 3: DimaLesnoy (big blind) folded on the Turn



PokerStars Hand #222963314371:  Hold'em No Limit ($0.05/$0.10 USD) - 2021/01/23 13:19:50 ET
Table 'Stephano III' 6-max Seat #3 is the button
Seat 2: Timakas ($4.35 in chips) 
Seat 3: DimaLesnoy ($10 in chips) 
DimaLesnoy: posts small blind $0.05
Timakas: posts big blind $0.10
*** HOLE CARDS ***
DimaLesnoy: raises $0.20 to $0.30
Timakas: calls $0.20
*** FLOP *** [4c 8h 8d]
Timakas: bets $0.10
DimaLesnoy: calls $0.10
*** TURN *** [4c 8h 8d] [9d]
Timakas: bets $0.10
DimaLesnoy: folds 
Uncalled bet ($0.10) returned to Timakas
Timakas collected $0.76 from pot
Timakas: doesn't show hand 
*** SUMMARY ***
Total pot $0.80 | Rake $0.04 
Board [4c 8h 8d 9d]
Seat 2: Timakas (big blind) collected ($0.76)
Seat 3: DimaLesnoy (button) (small blind) folded on the Turn



PokerStars Hand #222963326323:  Hold'em No Limit ($0.05/$0.10 USD) - 2021/01/23 13:20:06 ET
Table 'Stephano III' 6-max Seat #2 is the button
Seat 2: Timakas ($4.71 in chips) 
Seat 3: DimaLesnoy ($10 in chips) 
Timakas: posts small blind $0.05
DimaLesnoy: posts big blind $0.10
*** HOLE CARDS ***
Timakas: raises $0.10 to $0.20
DimaLesnoy: folds 
Uncalled bet ($0.10) returned to Timakas
Timakas collected $0.20 from pot
Timakas: doesn't show hand 
*** SUMMARY ***
Total pot $0.20 | Rake $0 
Seat 2: Timakas (button) (small blind) collected ($0.20)
Seat 3: DimaLesnoy (big blind) folded before Flop



PokerStars Hand #222963330494:  Hold'em No Limit ($0.05/$0.10 USD) - 2021/01/23 13:20:11 ET
Table 'Stephano III' 6-max Seat #3 is the button
Seat 2: Timakas ($4.81 in chips) 
Seat 3: DimaLesnoy ($10 in chips) 
DimaLesnoy: posts small blind $0.05
Timakas: posts big blind $0.10
*** HOLE CARDS ***
DimaLesnoy: raises $0.20 to $0.30
Timakas: folds 
Uncalled bet ($0.20) returned to DimaLesnoy
DiskoDancer joins the table at seat #4 
DimaLesnoy collected $0.20 from pot
DimaLesnoy: doesn't show hand 
*** SUMMARY ***
Total pot $0.20 | Rake $0 
Seat 2: Timakas (big blind) folded before Flop
Seat 3: DimaLesnoy (button) (small blind) collected ($0.20)



PokerStars Hand #222963334544:  Hold'em No Limit ($0.05/$0.10 USD) - 2021/01/23 13:20:17 ET
Table 'Stephano III' 6-max Seat #2 is the button
Seat 2: Timakas ($4.71 in chips) 
Seat 3: DimaLesnoy ($10.10 in chips) 
Seat 4: DiskoDancer ($10 in chips) 
DimaLesnoy: posts small blind $0.05
DiskoDancer: posts big blind $0.10
*** HOLE CARDS ***
Timakas: raises $0.10 to $0.20
DimaLesnoy: folds 
DiskoDancer: folds 
Uncalled bet ($0.10) returned to Timakas
Timakas collected $0.25 from pot
Timakas: doesn't show hand 
*** SUMMARY ***
Total pot $0.25 | Rake $0 
Seat 2: Timakas (button) collected ($0.25)
Seat 3: DimaLesnoy (small blind) folded before Flop
Seat 4: DiskoDancer (big blind) folded before Flop



PokerStars Hand #222963339555:  Hold'em No Limit ($0.05/$0.10 USD) - 2021/01/23 13:20:23 ET
Table 'Stephano III' 6-max Seat #3 is the button
Seat 2: Timakas ($4.86 in chips) 
Seat 3: DimaLesnoy ($10.05 in chips) 
Seat 4: DiskoDancer ($10 in chips) 
DiskoDancer: posts small blind $0.05
Timakas: posts big blind $0.10
*** HOLE CARDS ***
DimaLesnoy: folds 
DiskoDancer: raises $0.20 to $0.30
Timakas: folds 
Uncalled bet ($0.20) returned to DiskoDancer
DiskoDancer collected $0.20 from pot
DiskoDancer: doesn't show hand 
*** SUMMARY ***
Total pot $0.20 | Rake $0 
Seat 2: Timakas (big blind) folded before Flop
Seat 3: DimaLesnoy (button) folded before Flop (didn't bet)
Seat 4: DiskoDancer (small blind) collected ($0.20)



PokerStars Hand #222963348006:  Hold'em No Limit ($0.05/$0.10 USD) - 2021/01/23 13:20:35 ET
Table 'Stephano III' 6-max Seat #4 is the button
Seat 2: Timakas ($4.76 in chips) 
Seat 3: DimaLesnoy ($10.05 in chips) 
Seat 4: DiskoDancer ($10.10 in chips) 
Timakas: posts small blind $0.05
DimaLesnoy: posts big blind $0.10
*** HOLE CARDS ***
DiskoDancer: raises $0.20 to $0.30
Timakas: calls $0.25
DimaLesnoy: raises $1.10 to $1.40
DiskoDancer: folds 
Timakas: calls $1.10
*** FLOP *** [Th As Js]
Hollseg joins the table at seat #5 
Timakas: bets $3.36 and is all-in
DimaLesnoy: calls $3.36
*** TURN *** [Th As Js] [9s]
*** RIVER *** [Th As Js 9s] [Ac]
*** SHOW DOWN ***
Timakas: shows [Jd 4d] (two pair, Aces and Jacks)
DimaLesnoy: shows [Ts Td] (a full house, Tens full of Aces)
DimaLesnoy collected $9.38 from pot
*** SUMMARY ***
Total pot $9.82 | Rake $0.44 
Board [Th As Js 9s Ac]
Seat 2: Timakas (small blind) showed [Jd 4d] and lost with two pair, Aces and Jacks
Seat 3: DimaLesnoy (big blind) showed [Ts Td] and won ($9.38) with a full house, Tens full of Aces
Seat 4: DiskoDancer (button) folded before Flop



PokerStars Hand #222963375969:  Hold'em No Limit ($0.05/$0.10 USD) - 2021/01/23 13:21:12 ET
Table 'Stephano III' 6-max Seat #3 is the button
Seat 3: DimaLesnoy ($14.67 in chips) 
Seat 4: DiskoDancer ($10 in chips) 
DimaLesnoy: posts small blind $0.05
DiskoDancer: posts big blind $0.10
*** HOLE CARDS ***
DimaLesnoy: folds 
Uncalled bet ($0.05) returned to DiskoDancer
DiskoDancer collected $0.10 from pot
DiskoDancer: doesn't show hand 
*** SUMMARY ***
Total pot $0.10 | Rake $0 
Seat 3: DimaLesnoy (button) (small blind) folded before Flop
Seat 4: DiskoDancer (big blind) collected ($0.10)



PokerStars Hand #222963379869:  Hold'em No Limit ($0.05/$0.10 USD) - 2021/01/23 13:21:17 ET
Table 'Stephano III' 6-max Seat #3 is the button
Seat 2: Timakas ($4 in chips) 
Seat 3: DimaLesnoy ($14.62 in chips) 
Seat 4: DiskoDancer ($10.05 in chips) 
DiskoDancer: posts small blind $0.05
Timakas: posts big blind $0.10
*** HOLE CARDS ***
DimaLesnoy: raises $0.12 to $0.22
tab1988242 joins the table at seat #1 
Vakula[BLR] joins the table at seat #6 
DiskoDancer: calls $0.17
Timakas: calls $0.12
*** FLOP *** [4d 3d 3c]
DiskoDancer: checks 
Timakas: checks 
DimaLesnoy: checks 
*** TURN *** [4d 3d 3c] [Jd]
DiskoDancer: checks 
Timakas: bets $0.10
DimaLesnoy: folds 
DiskoDancer: calls $0.10
*** RIVER *** [4d 3d 3c Jd] [8c]
DiskoDancer: checks 
Timakas: bets $0.30
DiskoDancer: calls $0.30
*** SHOW DOWN ***
Timakas: shows [9s Kh] (a pair of Threes)
DiskoDancer: shows [7d 7s] (two pair, Sevens and Threes)
DiskoDancer collected $1.39 from pot
*** SUMMARY ***
Total pot $1.46 | Rake $0.07 
Board [4d 3d 3c Jd 8c]
Seat 2: Timakas (big blind) showed [9s Kh] and lost with a pair of Threes
Seat 3: DimaLesnoy (button) folded on the Turn
Seat 4: DiskoDancer (small blind) showed [7d 7s] and won ($1.39) with two pair, Sevens and Threes



PokerStars Hand #222963415683:  Hold'em No Limit ($0.05/$0.10 USD) - 2021/01/23 13:22:05 ET
Table 'Stephano III' 6-max Seat #4 is the button
Seat 2: Timakas ($3.38 in chips) 
Seat 3: DimaLesnoy ($14.40 in chips) 
Seat 4: DiskoDancer ($10.82 in chips) 
Timakas: posts small blind $0.05
DimaLesnoy: posts big blind $0.10
*** HOLE CARDS ***
DiskoDancer: folds 
Timakas: raises $0.10 to $0.20
DimaLesnoy: folds 
Uncalled bet ($0.10) returned to Timakas
Timakas collected $0.20 from pot
Timakas: doesn't show hand 
*** SUMMARY ***
Total pot $0.20 | Rake $0 
Seat 2: Timakas (small blind) collected ($0.20)
Seat 3: DimaLesnoy (big blind) folded before Flop
Seat 4: DiskoDancer (button) folded before Flop (didn't bet)



PokerStars Hand #222963422579:  Hold'em No Limit ($0.05/$0.10 USD) - 2021/01/23 13:22:14 ET
Table 'Stephano III' 6-max Seat #2 is the button
Seat 2: Timakas ($3.48 in chips) 
Seat 3: DimaLesnoy ($14.30 in chips) 
Seat 4: DiskoDancer ($10.82 in chips) 
DimaLesnoy: posts small blind $0.05
DiskoDancer: posts big blind $0.10
Hollseg: sits out 
Vakula[BLR]: sits out 
tab1988242: sits out 
*** HOLE CARDS ***
Timakas: raises $0.10 to $0.20
DimaLesnoy: folds 
DiskoDancer: folds 
Uncalled bet ($0.10) returned to Timakas
Timakas collected $0.25 from pot
Timakas: doesn't show hand 
*** SUMMARY ***
Total pot $0.25 | Rake $0 
Seat 2: Timakas (button) collected ($0.25)
Seat 3: DimaLesnoy (small blind) folded before Flop
Seat 4: DiskoDancer (big blind) folded before Flop



PokerStars Hand #222963428228:  Hold'em No Limit ($0.05/$0.10 USD) - 2021/01/23 13:22:22 ET
Table 'Stephano III' 6-max Seat #3 is the button
Seat 2: Timakas ($3.63 in chips) 
Seat 3: DimaLesnoy ($14.25 in chips) 
Seat 4: DiskoDancer ($10.72 in chips) 
Seat 5: Hollseg ($19.37 in chips) 
DiskoDancer: posts small blind $0.05
Hollseg: posts big blind $0.10
Vakula[BLR]: sits out 
tab1988242: sits out 
*** HOLE CARDS ***
Timakas: raises $0.10 to $0.20
DimaLesnoy: raises $0.40 to $0.60
DiskoDancer: folds 
Hollseg: raises $1.30 to $1.90
Timakas: folds 
DimaLesnoy: folds 
Uncalled bet ($1.30) returned to Hollseg
Hollseg collected $1.45 from pot
Hollseg: doesn't show hand 
*** SUMMARY ***
Total pot $1.45 | Rake $0 
Seat 2: Timakas folded before Flop
Seat 3: DimaLesnoy (button) folded before Flop
Seat 4: DiskoDancer (small blind) folded before Flop
Seat 5: Hollseg (big blind) collected ($1.45)



PokerStars Hand #222963449239:  Hold'em No Limit ($0.05/$0.10 USD) - 2021/01/23 13:22:49 ET
Table 'Stephano III' 6-max Seat #4 is the button
Seat 2: Timakas ($3.43 in chips) 
Seat 3: DimaLesnoy ($13.65 in chips) 
Seat 4: DiskoDancer ($10.67 in chips) 
Seat 5: Hollseg ($20.22 in chips) 
Seat 6: Vakula[BLR] ($10 in chips) 
Hollseg: posts small blind $0.05
Vakula[BLR]: posts big blind $0.10
tab1988242: sits out 
*** HOLE CARDS ***
Timakas: folds 
DimaLesnoy: raises $0.15 to $0.25
DiskoDancer: folds 
Hollseg: folds 
Vakula[BLR]: raises $0.75 to $1
DimaLesnoy: folds 
Uncalled bet ($0.75) returned to Vakula[BLR]
Vakula[BLR] collected $0.55 from pot
Vakula[BLR]: doesn't show hand 
*** SUMMARY ***
Total pot $0.55 | Rake $0 
Seat 2: Timakas folded before Flop (didn't bet)
Seat 3: DimaLesnoy folded before Flop
Seat 4: DiskoDancer (button) folded before Flop (didn't bet)
Seat 5: Hollseg (small blind) folded before Flop
Seat 6: Vakula[BLR] (big blind) collected ($0.55)



PokerStars Hand #222963467077:  Hold'em No Limit ($0.05/$0.10 USD) - 2021/01/23 13:23:13 ET
Table 'Stephano III' 6-max Seat #5 is the button
Seat 1: tab1988242 ($10 in chips) 
Seat 2: Timakas ($3.43 in chips) 
Seat 3: DimaLesnoy ($13.40 in chips) 
Seat 4: DiskoDancer ($10.67 in chips) 
Seat 5: Hollseg ($20.17 in chips) 
Seat 6: Vakula[BLR] ($10.30 in chips) 
Vakula[BLR]: posts small blind $0.05
tab1988242: posts big blind $0.10
*** HOLE CARDS ***
Timakas: folds 
DimaLesnoy: folds 
DiskoDancer: folds 
Hollseg: folds 
Vakula[BLR]: folds 
Uncalled bet ($0.05) returned to tab1988242
tab1988242 collected $0.10 from pot
tab1988242: doesn't show hand 
*** SUMMARY ***
Total pot $0.10 | Rake $0 
Seat 1: tab1988242 (big blind) collected ($0.10)
Seat 2: Timakas folded before Flop (didn't bet)
Seat 3: DimaLesnoy folded before Flop (didn't bet)
Seat 4: DiskoDancer folded before Flop (didn't bet)
Seat 5: Hollseg (button) folded before Flop (didn't bet)
Seat 6: Vakula[BLR] (small blind) folded before Flop



PokerStars Hand #222963478512:  Hold'em No Limit ($0.05/$0.10 USD) - 2021/01/23 13:23:28 ET
Table 'Stephano III' 6-max Seat #6 is the button
Seat 1: tab1988242 ($10.05 in chips) 
Seat 2: Timakas ($3.43 in chips) 
Seat 3: DimaLesnoy ($13.40 in chips) 
Seat 4: DiskoDancer ($10.67 in chips) 
Seat 5: Hollseg ($20.17 in chips) 
Seat 6: Vakula[BLR] ($10.25 in chips) 
tab1988242: posts small blind $0.05
Timakas: posts big blind $0.10
*** HOLE CARDS ***
DimaLesnoy: raises $0.20 to $0.30
DiskoDancer: folds 
Hollseg: folds 
Vakula[BLR]: folds 
tab1988242: folds 
Timakas: calls $0.20
*** FLOP *** [6h 2c 8d]
Timakas: bets $0.80
DimaLesnoy: folds 
Uncalled bet ($0.80) returned to Timakas
Timakas collected $0.62 from pot
Timakas: doesn't show hand 
*** SUMMARY ***
Total pot $0.65 | Rake $0.03 
Board [6h 2c 8d]
Seat 1: tab1988242 (small blind) folded before Flop
Seat 2: Timakas (big blind) collected ($0.62)
Seat 3: DimaLesnoy folded on the Flop
Seat 4: DiskoDancer folded before Flop (didn't bet)
Seat 5: Hollseg folded before Flop (didn't bet)
Seat 6: Vakula[BLR] (button) folded before Flop (didn't bet)



PokerStars Hand #222963496100:  Hold'em No Limit ($0.05/$0.10 USD) - 2021/01/23 13:23:51 ET
Table 'Stephano III' 6-max Seat #1 is the button
Seat 1: tab1988242 ($10 in chips) 
Seat 2: Timakas ($3.75 in chips) 
Seat 3: DimaLesnoy ($13.10 in chips) 
Seat 4: DiskoDancer ($10.67 in chips) 
Seat 5: Hollseg ($20.17 in chips) 
Seat 6: Vakula[BLR] ($10.25 in chips) 
Timakas: posts small blind $0.05
DimaLesnoy: posts big blind $0.10
*** HOLE CARDS ***
DiskoDancer: folds 
Hollseg: folds 
Vakula[BLR]: raises $0.15 to $0.25
tab1988242: folds 
Timakas: raises $0.95 to $1.20
DimaLesnoy: folds 
Vakula[BLR]: calls $0.95
*** FLOP *** [5c Ac 2h]
Timakas: bets $2.55 and is all-in
Vakula[BLR]: folds 
Uncalled bet ($2.55) returned to Timakas
Timakas collected $2.39 from pot
Timakas: doesn't show hand 
*** SUMMARY ***
Total pot $2.50 | Rake $0.11 
Board [5c Ac 2h]
Seat 1: tab1988242 (button) folded before Flop (didn't bet)
Seat 2: Timakas (small blind) collected ($2.39)
Seat 3: DimaLesnoy (big blind) folded before Flop
Seat 4: DiskoDancer folded before Flop (didn't bet)
Seat 5: Hollseg folded before Flop (didn't bet)
Seat 6: Vakula[BLR] folded on the Flop



PokerStars Hand #222963525058:  Hold'em No Limit ($0.05/$0.10 USD) - 2021/01/23 13:24:29 ET
Table 'Stephano III' 6-max Seat #2 is the button
Seat 1: tab1988242 ($10 in chips) 
Seat 2: Timakas ($4.94 in chips) 
Seat 3: DimaLesnoy ($13 in chips) 
Seat 4: DiskoDancer ($10.67 in chips) 
Seat 5: Hollseg ($20.17 in chips) 
Seat 6: Vakula[BLR] ($10 in chips) 
DimaLesnoy: posts small blind $0.05
DiskoDancer: posts big blind $0.10
*** HOLE CARDS ***
Hollseg: folds 
Vakula[BLR]: folds 
tab1988242: folds 
Timakas: raises $0.10 to $0.20
DimaLesnoy: folds 
DiskoDancer: folds 
Uncalled bet ($0.10) returned to Timakas
Timakas collected $0.25 from pot
Timakas: doesn't show hand 
*** SUMMARY ***
Total pot $0.25 | Rake $0 
Seat 1: tab1988242 folded before Flop (didn't bet)
Seat 2: Timakas (button) collected ($0.25)
Seat 3: DimaLesnoy (small blind) folded before Flop
Seat 4: DiskoDancer (big blind) folded before Flop
Seat 5: Hollseg folded before Flop (didn't bet)
Seat 6: Vakula[BLR] folded before Flop (didn't bet)



PokerStars Hand #222963533160:  Hold'em No Limit ($0.05/$0.10 USD) - 2021/01/23 13:24:40 ET
Table 'Stephano III' 6-max Seat #3 is the button
Seat 1: tab1988242 ($10 in chips) 
Seat 2: Timakas ($5.09 in chips) 
Seat 3: DimaLesnoy ($12.95 in chips) 
Seat 4: DiskoDancer ($10.57 in chips) 
Seat 5: Hollseg ($20.17 in chips) 
Seat 6: Vakula[BLR] ($10 in chips) 
DiskoDancer: posts small blind $0.05
Hollseg: posts big blind $0.10
*** HOLE CARDS ***
Vakula[BLR]: folds 
tab1988242: folds 
Timakas: raises $0.10 to $0.20
DimaLesnoy: raises $0.40 to $0.60
DiskoDancer: folds 
Hollseg: folds 
Timakas: calls $0.40
*** FLOP *** [Js Jd Jc]
Timakas: bets $0.40
DimaLesnoy: calls $0.40
*** TURN *** [Js Jd Jc] [Ks]
Timakas: bets $4.09 and is all-in
DimaLesnoy: calls $4.09
*** RIVER *** [Js Jd Jc Ks] [5h]
*** SHOW DOWN ***
Timakas: shows [Kd 9h] (a full house, Jacks full of Kings)
DimaLesnoy: shows [Ac Kh] (a full house, Jacks full of Kings)
Timakas collected $4.94 from pot
DimaLesnoy collected $4.93 from pot
*** SUMMARY ***
Total pot $10.33 | Rake $0.46 
Board [Js Jd Jc Ks 5h]
Seat 1: tab1988242 folded before Flop (didn't bet)
Seat 2: Timakas showed [Kd 9h] and won ($4.94) with a full house, Jacks full of Kings
Seat 3: DimaLesnoy (button) showed [Ac Kh] and won ($4.93) with a full house, Jacks full of Kings
Seat 4: DiskoDancer (small blind) folded before Flop
Seat 5: Hollseg (big blind) folded before Flop
Seat 6: Vakula[BLR] folded before Flop (didn't bet)



PokerStars Hand #222963564082:  Hold'em No Limit ($0.05/$0.10 USD) - 2021/01/23 13:25:21 ET
Table 'Stephano III' 6-max Seat #4 is the button
Seat 1: tab1988242 ($10 in chips) 
Seat 2: Timakas ($4.94 in chips) 
Seat 3: DimaLesnoy ($12.79 in chips) 
Seat 4: DiskoDancer ($10.52 in chips) 
Seat 5: Hollseg ($20.07 in chips) 
Hollseg: posts small blind $0.05
Vakula[BLR]: is sitting out 
tab1988242: posts big blind $0.10
*** HOLE CARDS ***
Timakas: folds 
DimaLesnoy: folds 
DiskoDancer: raises $0.15 to $0.25
Hollseg: folds 
tab1988242: raises $0.55 to $0.80
DiskoDancer: folds 
Uncalled bet ($0.55) returned to tab1988242
tab1988242 collected $0.55 from pot
tab1988242: doesn't show hand 
*** SUMMARY ***
Total pot $0.55 | Rake $0 
Seat 1: tab1988242 (big blind) collected ($0.55)
Seat 2: Timakas folded before Flop (didn't bet)
Seat 3: DimaLesnoy folded before Flop (didn't bet)
Seat 4: DiskoDancer (button) folded before Flop
Seat 5: Hollseg (small blind) folded before Flop



PokerStars Hand #222963593675:  Hold'em No Limit ($0.05/$0.10 USD) - 2021/01/23 13:26:00 ET
Table 'Stephano III' 6-max Seat #5 is the button
Seat 1: tab1988242 ($10.30 in chips) 
Seat 2: Timakas ($4.94 in chips) 
Seat 3: DimaLesnoy ($12.79 in chips) 
Seat 4: DiskoDancer ($10.27 in chips) 
Seat 5: Hollseg ($20.02 in chips) 
tab1988242: posts small blind $0.05
Timakas: posts big blind $0.10
*** HOLE CARDS ***
DimaLesnoy: folds 
DiskoDancer: folds 
Hollseg: raises $0.15 to $0.25
tab1988242: folds 
Timakas: calls $0.15
*** FLOP *** [Qh Qs 5c]
Timakas: checks 
Hollseg: checks 
*** TURN *** [Qh Qs 5c] [6h]
Timakas: bets $0.20
Hollseg: calls $0.20
*** RIVER *** [Qh Qs 5c 6h] [5h]
Timakas: bets $0.40
Hollseg: calls $0.40
*** SHOW DOWN ***
Timakas: shows [3d 8s] (two pair, Queens and Fives)
Hollseg: shows [5d 7d] (a full house, Fives full of Queens)
Hollseg collected $1.67 from pot
*** SUMMARY ***
Total pot $1.75 | Rake $0.08 
Board [Qh Qs 5c 6h 5h]
Seat 1: tab1988242 (small blind) folded before Flop
Seat 2: Timakas (big blind) showed [3d 8s] and lost with two pair, Queens and Fives
Seat 3: DimaLesnoy folded before Flop (didn't bet)
Seat 4: DiskoDancer folded before Flop (didn't bet)
Seat 5: Hollseg (button) showed [5d 7d] and won ($1.67) with a full house, Fives full of Queens



PokerStars Hand #222963624712:  Hold'em No Limit ($0.05/$0.10 USD) - 2021/01/23 13:26:41 ET
Table 'Stephano III' 6-max Seat #1 is the button
Seat 1: tab1988242 ($10.25 in chips) 
Seat 2: Timakas ($4.09 in chips) 
Seat 3: DimaLesnoy ($12.79 in chips) 
Seat 4: DiskoDancer ($10.27 in chips) 
Seat 5: Hollseg ($20.84 in chips) 
Timakas: posts small blind $0.05
DimaLesnoy: posts big blind $0.10
Vakula[BLR]: sits out 
*** HOLE CARDS ***
DiskoDancer: raises $0.15 to $0.25
Hollseg: folds 
tab1988242: calls $0.25
Timakas: folds 
DimaLesnoy: folds 
*** FLOP *** [5s 3h 3d]
DiskoDancer: checks 
tab1988242: bets $0.47
DiskoDancer: calls $0.47
*** TURN *** [5s 3h 3d] [Ad]
DiskoDancer: checks 
tab1988242: checks 
*** RIVER *** [5s 3h 3d Ad] [Qs]
DiskoDancer: checks 
tab1988242: bets $0.46
DiskoDancer: calls $0.46
*** SHOW DOWN ***
tab1988242: shows [7s As] (two pair, Aces and Threes)
DiskoDancer: shows [Ac Kh] (two pair, Aces and Threes - King kicker)
DiskoDancer collected $2.40 from pot
*** SUMMARY ***
Total pot $2.51 | Rake $0.11 
Board [5s 3h 3d Ad Qs]
Seat 1: tab1988242 (button) showed [7s As] and lost with two pair, Aces and Threes
Seat 2: Timakas (small blind) folded before Flop
Seat 3: DimaLesnoy (big blind) folded before Flop
Seat 4: DiskoDancer showed [Ac Kh] and won ($2.40) with two pair, Aces and Threes
Seat 5: Hollseg folded before Flop (didn't bet)



PokerStars Hand #222963676748:  Hold'em No Limit ($0.05/$0.10 USD) - 2021/01/23 13:27:50 ET
Table 'Stephano III' 6-max Seat #2 is the button
Seat 1: tab1988242 ($10 in chips) 
Seat 2: Timakas ($4.04 in chips) 
Seat 3: DimaLesnoy ($12.69 in chips) 
Seat 4: DiskoDancer ($11.49 in chips) 
Seat 5: Hollseg ($20.84 in chips) 
DimaLesnoy: posts small blind $0.05
DiskoDancer: posts big blind $0.10
Vakula[BLR]: sits out 
*** HOLE CARDS ***
Hollseg: folds 
tab1988242: folds 
Timakas: raises $0.20 to $0.30
DimaLesnoy: calls $0.25
DiskoDancer: folds 
*** FLOP *** [Qh Qs 5s]
DimaLesnoy: checks 
Timakas: checks 
*** TURN *** [Qh Qs 5s] [2s]
DimaLesnoy: checks 
Timakas: bets $0.50
DimaLesnoy: calls $0.50
*** RIVER *** [Qh Qs 5s 2s] [4d]
DimaLesnoy: checks 
Timakas: bets $1.20
DimaLesnoy: folds 
Uncalled bet ($1.20) returned to Timakas
Timakas collected $1.62 from pot
Timakas: doesn't show hand 
*** SUMMARY ***
Total pot $1.70 | Rake $0.08 
Board [Qh Qs 5s 2s 4d]
Seat 1: tab1988242 folded before Flop (didn't bet)
Seat 2: Timakas (button) collected ($1.62)
Seat 3: DimaLesnoy (small blind) folded on the River
Seat 4: DiskoDancer (big blind) folded before Flop
Seat 5: Hollseg folded before Flop (didn't bet)



PokerStars Hand #222963713824:  Hold'em No Limit ($0.05/$0.10 USD) - 2021/01/23 13:28:39 ET
Table 'Stephano III' 6-max Seat #3 is the button
Seat 1: tab1988242 ($10 in chips) 
Seat 2: Timakas ($4.86 in chips) 
Seat 3: DimaLesnoy ($11.89 in chips) 
Seat 4: DiskoDancer ($11.39 in chips) 
Seat 5: Hollseg ($20.84 in chips) 
DiskoDancer: posts small blind $0.05
Hollseg: posts big blind $0.10
Vakula[BLR]: sits out 
*** HOLE CARDS ***
tab1988242: folds 
Timakas: raises $0.10 to $0.20
DimaLesnoy: folds 
tab1988242 leaves the table
pondax joins the table at seat #1 
DiskoDancer: raises $0.45 to $0.65
Hollseg: folds 
Timakas: calls $0.45
*** FLOP *** [9s Th 6h]
DiskoDancer: checks 
Timakas: bets $1
DiskoDancer: folds 
Uncalled bet ($1) returned to Timakas
Timakas collected $1.34 from pot
Timakas: doesn't show hand 
*** SUMMARY ***
Total pot $1.40 | Rake $0.06 
Board [9s Th 6h]
Seat 1: tab1988242 folded before Flop (didn't bet)
Seat 2: Timakas collected ($1.34)
Seat 3: DimaLesnoy (button) folded before Flop (didn't bet)
Seat 4: DiskoDancer (small blind) folded on the Flop
Seat 5: Hollseg (big blind) folded before Flop



PokerStars Hand #222963739550:  Hold'em No Limit ($0.05/$0.10 USD) - 2021/01/23 13:29:13 ET
Table 'Stephano III' 6-max Seat #4 is the button
Seat 2: Timakas ($5.55 in chips) 
Seat 3: DimaLesnoy ($11.89 in chips) 
Seat 4: DiskoDancer ($10.74 in chips) 
Seat 5: Hollseg ($20.74 in chips) 
Seat 6: Vakula[BLR] ($10 in chips) 
Hollseg: posts small blind $0.05
Vakula[BLR]: posts big blind $0.10
pondax: sits out 
*** HOLE CARDS ***
Timakas: raises $0.10 to $0.20
DimaLesnoy: folds 
DiskoDancer: folds 
Hollseg: folds 
Vakula[BLR]: raises $0.50 to $0.70
Timakas: calls $0.50
*** FLOP *** [8d 9s 4h]
Vakula[BLR]: checks 
Timakas: bets $0.10
Vakula[BLR]: calls $0.10
*** TURN *** [8d 9s 4h] [Jd]
Vakula[BLR]: checks 
Timakas: bets $0.70
Vakula[BLR]: calls $0.70
*** RIVER *** [8d 9s 4h Jd] [3h]
Vakula[BLR]: checks 
Timakas: bets $1.50
Vakula[BLR]: folds 
Uncalled bet ($1.50) returned to Timakas
Timakas collected $2.91 from pot
Timakas: doesn't show hand 
*** SUMMARY ***
Total pot $3.05 | Rake $0.14 
Board [8d 9s 4h Jd 3h]
Seat 2: Timakas collected ($2.91)
Seat 3: DimaLesnoy folded before Flop (didn't bet)
Seat 4: DiskoDancer (button) folded before Flop (didn't bet)
Seat 5: Hollseg (small blind) folded before Flop
Seat 6: Vakula[BLR] (big blind) folded on the River



PokerStars Hand #222963778409:  Hold'em No Limit ($0.05/$0.10 USD) - 2021/01/23 13:30:04 ET
Table 'Stephano III' 6-max Seat #5 is the button
Seat 1: pondax ($10 in chips) 
Seat 2: Timakas ($6.96 in chips) 
Seat 3: DimaLesnoy ($11.89 in chips) 
Seat 4: DiskoDancer ($10.74 in chips) 
Seat 5: Hollseg ($20.69 in chips) 
Seat 6: Vakula[BLR] ($10 in chips) 
Vakula[BLR]: posts small blind $0.05
pondax: posts big blind $0.10
*** HOLE CARDS ***
Timakas: raises $0.10 to $0.20
DimaLesnoy: folds 
DiskoDancer: folds 
Hollseg: folds 
Vakula[BLR]: raises $0.60 to $0.80
pondax: folds 
Timakas: calls $0.60
*** FLOP *** [3d 4h 7h]
Vakula[BLR]: checks 
Timakas: checks 
*** TURN *** [3d 4h 7h] [Kd]
Vakula[BLR]: checks 
Timakas: checks 
*** RIVER *** [3d 4h 7h Kd] [2d]
Vakula[BLR]: checks 
Timakas: bets $0.10
Vakula[BLR]: raises $0.75 to $0.85
Timakas: folds 
Uncalled bet ($0.75) returned to Vakula[BLR]
Vakula[BLR] collected $1.81 from pot
Vakula[BLR]: doesn't show hand 
*** SUMMARY ***
Total pot $1.90 | Rake $0.09 
Board [3d 4h 7h Kd 2d]
Seat 1: pondax (big blind) folded before Flop
Seat 2: Timakas folded on the River
Seat 3: DimaLesnoy folded before Flop (didn't bet)
Seat 4: DiskoDancer folded before Flop (didn't bet)
Seat 5: Hollseg (button) folded before Flop (didn't bet)
Seat 6: Vakula[BLR] (small blind) collected ($1.81)



PokerStars Hand #222963810990:  Hold'em No Limit ($0.05/$0.10 USD) - 2021/01/23 13:30:46 ET
Table 'Stephano III' 6-max Seat #6 is the button
Seat 1: pondax ($9.90 in chips) 
Seat 2: Timakas ($6.06 in chips) 
Seat 3: DimaLesnoy ($11.89 in chips) 
Seat 4: DiskoDancer ($10.74 in chips) 
Seat 5: Hollseg ($20.69 in chips) 
Seat 6: Vakula[BLR] ($10.91 in chips) 
pondax: posts small blind $0.05
Timakas: posts big blind $0.10
*** HOLE CARDS ***
DimaLesnoy: folds 
DiskoDancer: folds 
Hollseg: folds 
Vakula[BLR]: raises $0.15 to $0.25
pondax: folds 
Timakas: calls $0.15
*** FLOP *** [Ts 2c 8c]
Timakas: bets $0.20
Vakula[BLR]: folds 
Uncalled bet ($0.20) returned to Timakas
Timakas collected $0.53 from pot
Timakas: doesn't show hand 
*** SUMMARY ***
Total pot $0.55 | Rake $0.02 
Board [Ts 2c 8c]
Seat 1: pondax (small blind) folded before Flop
Seat 2: Timakas (big blind) collected ($0.53)
Seat 3: DimaLesnoy folded before Flop (didn't bet)
Seat 4: DiskoDancer folded before Flop (didn't bet)
Seat 5: Hollseg folded before Flop (didn't bet)
Seat 6: Vakula[BLR] (button) folded on the Flop



PokerStars Hand #222963825474:  Hold'em No Limit ($0.05/$0.10 USD) - 2021/01/23 13:31:05 ET
Table 'Stephano III' 6-max Seat #1 is the button
Seat 1: pondax ($10 in chips) 
Seat 2: Timakas ($6.34 in chips) 
Seat 3: DimaLesnoy ($11.89 in chips) 
Seat 4: DiskoDancer ($10.74 in chips) 
Seat 5: Hollseg ($20.69 in chips) 
Seat 6: Vakula[BLR] ($10.66 in chips) 
Timakas: posts small blind $0.05
DimaLesnoy: posts big blind $0.10
*** HOLE CARDS ***
DiskoDancer: folds 
Hollseg: folds 
Vakula[BLR]: folds 
pondax: raises $0.20 to $0.30
Timakas: folds 
DimaLesnoy: calls $0.20
*** FLOP *** [Td 5c 2c]
DimaLesnoy: checks 
pondax: checks 
*** TURN *** [Td 5c 2c] [Kh]
DimaLesnoy: checks 
pondax: bets $0.41
DimaLesnoy: folds 
Uncalled bet ($0.41) returned to pondax
pondax collected $0.62 from pot
pondax: doesn't show hand 
*** SUMMARY ***
Total pot $0.65 | Rake $0.03 
Board [Td 5c 2c Kh]
Seat 1: pondax (button) collected ($0.62)
Seat 2: Timakas (small blind) folded before Flop
Seat 3: DimaLesnoy (big blind) folded on the Turn
Seat 4: DiskoDancer folded before Flop (didn't bet)
Seat 5: Hollseg folded before Flop (didn't bet)
Seat 6: Vakula[BLR] folded before Flop (didn't bet)



PokerStars Hand #222963868345:  Hold'em No Limit ($0.05/$0.10 USD) - 2021/01/23 13:32:00 ET
Table 'Stephano III' 6-max Seat #2 is the button
Seat 1: pondax ($10.32 in chips) 
Seat 2: Timakas ($6.29 in chips) 
Seat 3: DimaLesnoy ($11.59 in chips) 
Seat 4: DiskoDancer ($10.74 in chips) 
Seat 5: Hollseg ($20.69 in chips) 
Seat 6: Vakula[BLR] ($10.66 in chips) 
DimaLesnoy: posts small blind $0.05
DiskoDancer: posts big blind $0.10
*** HOLE CARDS ***
Hollseg: folds 
Vakula[BLR]: folds 
pondax: folds 
Timakas: folds 
Timakas leaves the table
DimaLesnoy: folds 
Uncalled bet ($0.05) returned to DiskoDancer
DiskoDancer collected $0.10 from pot
DiskoDancer: doesn't show hand 
*** SUMMARY ***
Total pot $0.10 | Rake $0 
Seat 1: pondax folded before Flop (didn't bet)
Seat 2: Timakas (button) folded before Flop (didn't bet)
Seat 3: DimaLesnoy (small blind) folded before Flop
Seat 4: DiskoDancer (big blind) collected ($0.10)
Seat 5: Hollseg folded before Flop (didn't bet)
Seat 6: Vakula[BLR] folded before Flop (didn't bet)



PokerStars Hand #222963876101:  Hold'em No Limit ($0.05/$0.10 USD) - 2021/01/23 13:32:10 ET
Table 'Stephano III' 6-max Seat #3 is the button
Seat 1: pondax ($10.32 in chips) 
Seat 3: DimaLesnoy ($11.54 in chips) 
Seat 4: DiskoDancer ($10.79 in chips) 
Seat 5: Hollseg ($20.69 in chips) 
Seat 6: Vakula[BLR] ($10.66 in chips) 
DiskoDancer: posts small blind $0.05
Hollseg: posts big blind $0.10
*** HOLE CARDS ***
Vakula[BLR]: folds 
Vakula[BLR] leaves the table
pondax: raises $0.20 to $0.30
DimaLesnoy: folds 
DiskoDancer: folds 
Hollseg: calls $0.20
*** FLOP *** [4d 7c Kd]
Hollseg: checks 
pondax: bets $0.20
namemattbark joins the table at seat #6 
Hollseg: calls $0.20
*** TURN *** [4d 7c Kd] [9h]
Hollseg: checks 
pondax: checks 
*** RIVER *** [4d 7c Kd 9h] [5h]
barbos2 joins the table at seat #2 
Hollseg: checks 
pondax: bets $1
Hollseg: calls $1
*** SHOW DOWN ***
pondax: shows [Jh As] (high card Ace)
Hollseg: shows [9c Ad] (a pair of Nines)
Hollseg collected $2.91 from pot
*** SUMMARY ***
Total pot $3.05 | Rake $0.14 
Board [4d 7c Kd 9h 5h]
Seat 1: pondax showed [Jh As] and lost with high card Ace
Seat 3: DimaLesnoy (button) folded before Flop (didn't bet)
Seat 4: DiskoDancer (small blind) folded before Flop
Seat 5: Hollseg (big blind) showed [9c Ad] and won ($2.91) with a pair of Nines
Seat 6: Vakula[BLR] folded before Flop (didn't bet)



PokerStars Hand #222963911877:  Hold'em No Limit ($0.05/$0.10 USD) - 2021/01/23 13:32:55 ET
Table 'Stephano III' 6-max Seat #4 is the button
Seat 1: pondax ($10 in chips) 
Seat 3: DimaLesnoy ($11.54 in chips) 
Seat 4: DiskoDancer ($10.74 in chips) 
Seat 5: Hollseg ($22.10 in chips) 
Seat 6: namemattbark ($10 in chips) 
Hollseg: posts small blind $0.05
namemattbark: posts big blind $0.10
barbos2: sits out 
*** HOLE CARDS ***
pondax: folds 
DimaLesnoy: folds 
DiskoDancer: raises $0.15 to $0.25
Hollseg: folds 
namemattbark: calls $0.15
*** FLOP *** [Jc 8s 6c]
namemattbark: checks 
DiskoDancer: bets $0.28
namemattbark: calls $0.28
*** TURN *** [Jc 8s 6c] [9c]
namemattbark: bets $0.80
DiskoDancer: calls $0.80
*** RIVER *** [Jc 8s 6c 9c] [5d]
namemattbark: bets $1.94
DiskoDancer: calls $1.94
*** SHOW DOWN ***
namemattbark: shows [Qc Th] (a straight, Eight to Queen)
DiskoDancer: shows [7c 5c] (a flush, Jack high)
DiskoDancer collected $6.29 from pot
*** SUMMARY ***
Total pot $6.59 | Rake $0.30 
Board [Jc 8s 6c 9c 5d]
Seat 1: pondax folded before Flop (didn't bet)
Seat 3: DimaLesnoy folded before Flop (didn't bet)
Seat 4: DiskoDancer (button) showed [7c 5c] and won ($6.29) with a flush, Jack high
Seat 5: Hollseg (small blind) folded before Flop
Seat 6: namemattbark (big blind) showed [Qc Th] and lost with a straight, Eight to Queen



PokerStars Hand #222963963329:  Hold'em No Limit ($0.05/$0.10 USD) - 2021/01/23 13:34:01 ET
Table 'Stephano III' 6-max Seat #5 is the button
Seat 1: pondax ($10 in chips) 
Seat 3: DimaLesnoy ($11.54 in chips) 
Seat 4: DiskoDancer ($13.76 in chips) 
Seat 5: Hollseg ($22.05 in chips) 
Seat 6: namemattbark ($6.73 in chips) 
namemattbark: posts small blind $0.05
pondax: posts big blind $0.10
barbos2: sits out 
*** HOLE CARDS ***
DimaLesnoy: folds 
DiskoDancer: folds 
Hollseg: folds 
namemattbark: folds 
Uncalled bet ($0.05) returned to pondax
pondax collected $0.10 from pot
pondax: doesn't show hand 
*** SUMMARY ***
Total pot $0.10 | Rake $0 
Seat 1: pondax (big blind) collected ($0.10)
Seat 3: DimaLesnoy folded before Flop (didn't bet)
Seat 4: DiskoDancer folded before Flop (didn't bet)
Seat 5: Hollseg (button) folded before Flop (didn't bet)
Seat 6: namemattbark (small blind) folded before Flop



PokerStars Hand #222963969256:  Hold'em No Limit ($0.05/$0.10 USD) - 2021/01/23 13:34:09 ET
Table 'Stephano III' 6-max Seat #6 is the button
Seat 1: pondax ($10.05 in chips) 
Seat 2: barbos2 ($10 in chips) 
Seat 3: DimaLesnoy ($11.54 in chips) 
Seat 4: DiskoDancer ($13.76 in chips) 
Seat 5: Hollseg ($22.05 in chips) 
Seat 6: namemattbark ($6.68 in chips) 
pondax: posts small blind $0.05
barbos2: posts big blind $0.10
*** HOLE CARDS ***
DimaLesnoy: raises $0.20 to $0.30
DiskoDancer: folds 
Hollseg: folds 
namemattbark: folds 
pondax: folds 
barbos2: folds 
Uncalled bet ($0.20) returned to DimaLesnoy
DimaLesnoy collected $0.25 from pot
DimaLesnoy: doesn't show hand 
*** SUMMARY ***
Total pot $0.25 | Rake $0 
Seat 1: pondax (small blind) folded before Flop
Seat 2: barbos2 (big blind) folded before Flop
Seat 3: DimaLesnoy collected ($0.25)
Seat 4: DiskoDancer folded before Flop (didn't bet)
Seat 5: Hollseg folded before Flop (didn't bet)
Seat 6: namemattbark (button) folded before Flop (didn't bet)



PokerStars Hand #222963990021:  Hold'em No Limit ($0.05/$0.10 USD) - 2021/01/23 13:34:36 ET
Table 'Stephano III' 6-max Seat #1 is the button
Seat 1: pondax ($10 in chips) 
Seat 2: barbos2 ($10 in chips) 
Seat 3: DimaLesnoy ($11.69 in chips) 
Seat 4: DiskoDancer ($13.76 in chips) 
Seat 5: Hollseg ($22.05 in chips) 
Seat 6: namemattbark ($6.68 in chips) 
barbos2: posts small blind $0.05
DimaLesnoy: posts big blind $0.10
*** HOLE CARDS ***
DiskoDancer: folds 
DiskoDancer leaves the table
Hollseg: folds 
namemattbark: folds 
pondax: raises $0.20 to $0.30
barbos2: folds 
DimaLesnoy: calls $0.20
*** FLOP *** [6s 8d 7h]
DimaLesnoy: checks 
pondax: checks 
*** TURN *** [6s 8d 7h] [4c]
DimaLesnoy: checks 
MD_207 joins the table at seat #4 
pondax: checks 
*** RIVER *** [6s 8d 7h 4c] [9d]
DimaLesnoy: checks 
pondax: checks 
*** SHOW DOWN ***
DimaLesnoy: shows [7c Ad] (a pair of Sevens)
pondax: mucks hand 
DimaLesnoy collected $0.62 from pot
*** SUMMARY ***
Total pot $0.65 | Rake $0.03 
Board [6s 8d 7h 4c 9d]
Seat 1: pondax (button) mucked
Seat 2: barbos2 (small blind) folded before Flop
Seat 3: DimaLesnoy (big blind) showed [7c Ad] and won ($0.62) with a pair of Sevens
Seat 4: DiskoDancer folded before Flop (didn't bet)
Seat 5: Hollseg folded before Flop (didn't bet)
Seat 6: namemattbark folded before Flop (didn't bet)



PokerStars Hand #222964033292:  Hold'em No Limit ($0.05/$0.10 USD) - 2021/01/23 13:35:31 ET
Table 'Stephano III' 6-max Seat #2 is the button
Seat 1: pondax ($10 in chips) 
Seat 2: barbos2 ($10 in chips) 
Seat 3: DimaLesnoy ($12.01 in chips) 
Seat 4: MD_207 ($4 in chips) 
Seat 5: Hollseg ($22.05 in chips) 
Seat 6: namemattbark ($6.68 in chips) 
DimaLesnoy: posts small blind $0.05
MD_207: posts big blind $0.10
*** HOLE CARDS ***
Hollseg: folds 
namemattbark: folds 
pondax: folds 
barbos2: folds 
DimaLesnoy: raises $0.20 to $0.30
MD_207: folds 
Uncalled bet ($0.20) returned to DimaLesnoy
DimaLesnoy collected $0.20 from pot
DimaLesnoy: doesn't show hand 
*** SUMMARY ***
Total pot $0.20 | Rake $0 
Seat 1: pondax folded before Flop (didn't bet)
Seat 2: barbos2 (button) folded before Flop (didn't bet)
Seat 3: DimaLesnoy (small blind) collected ($0.20)
Seat 4: MD_207 (big blind) folded before Flop
Seat 5: Hollseg folded before Flop (didn't bet)
Seat 6: namemattbark folded before Flop (didn't bet)



PokerStars Hand #222964049274:  Hold'em No Limit ($0.05/$0.10 USD) - 2021/01/23 13:35:52 ET
Table 'Stephano III' 6-max Seat #3 is the button
Seat 1: pondax ($10 in chips) 
Seat 2: barbos2 ($10 in chips) 
Seat 3: DimaLesnoy ($12.11 in chips) 
Seat 4: MD_207 ($3.90 in chips) 
Seat 5: Hollseg ($22.05 in chips) 
Seat 6: namemattbark ($6.68 in chips) 
MD_207: posts small blind $0.05
Hollseg: posts big blind $0.10
*** HOLE CARDS ***
namemattbark: folds 
pondax: folds 
barbos2: raises $0.15 to $0.25
DimaLesnoy: folds 
MD_207: folds 
Hollseg: folds 
Uncalled bet ($0.15) returned to barbos2
barbos2 collected $0.25 from pot
barbos2: doesn't show hand 
*** SUMMARY ***
Total pot $0.25 | Rake $0 
Seat 1: pondax folded before Flop (didn't bet)
Seat 2: barbos2 collected ($0.25)
Seat 3: DimaLesnoy (button) folded before Flop (didn't bet)
Seat 4: MD_207 (small blind) folded before Flop
Seat 5: Hollseg (big blind) folded before Flop
Seat 6: namemattbark folded before Flop (didn't bet)



PokerStars Hand #222964062003:  Hold'em No Limit ($0.05/$0.10 USD) - 2021/01/23 13:36:08 ET
Table 'Stephano III' 6-max Seat #4 is the button
Seat 1: pondax ($10 in chips) 
Seat 2: barbos2 ($10.15 in chips) 
Seat 3: DimaLesnoy ($12.11 in chips) 
Seat 4: MD_207 ($3.85 in chips) 
Seat 5: Hollseg ($21.95 in chips) 
Seat 6: namemattbark ($6.68 in chips) 
Hollseg: posts small blind $0.05
namemattbark: posts big blind $0.10
*** HOLE CARDS ***
pondax: folds 
barbos2: folds 
DimaLesnoy: raises $0.15 to $0.25
MD_207: calls $0.25
Hollseg: raises $0.95 to $1.20
namemattbark: folds 
DimaLesnoy: folds 
MD_207: calls $0.95
*** FLOP *** [Tc 4s 3d]
Hollseg: checks 
MD_207: checks 
*** TURN *** [Tc 4s 3d] [7s]
Hollseg: bets $1
MD_207: calls $1
*** RIVER *** [Tc 4s 3d 7s] [6d]
Hollseg: bets $1.70
MD_207: calls $1.65 and is all-in
Uncalled bet ($0.05) returned to Hollseg
*** SHOW DOWN ***
Hollseg: shows [Th Td] (three of a kind, Tens)
MD_207: shows [Ks 6s] (a pair of Sixes)
Hollseg collected $7.69 from pot
*** SUMMARY ***
Total pot $8.05 | Rake $0.36 
Board [Tc 4s 3d 7s 6d]
Seat 1: pondax folded before Flop (didn't bet)
Seat 2: barbos2 folded before Flop (didn't bet)
Seat 3: DimaLesnoy folded before Flop
Seat 4: MD_207 (button) showed [Ks 6s] and lost with a pair of Sixes
Seat 5: Hollseg (small blind) showed [Th Td] and won ($7.69) with three of a kind, Tens
Seat 6: namemattbark (big blind) folded before Flop



PokerStars Hand #222964099637:  Hold'em No Limit ($0.05/$0.10 USD) - 2021/01/23 13:36:57 ET
Table 'Stephano III' 6-max Seat #5 is the button
Seat 1: pondax ($10 in chips) 
Seat 2: barbos2 ($10.15 in chips) 
Seat 3: DimaLesnoy ($11.86 in chips) 
Seat 5: Hollseg ($25.79 in chips) 
Seat 6: namemattbark ($6.58 in chips) 
namemattbark: posts small blind $0.05
pondax: posts big blind $0.10
*** HOLE CARDS ***
barbos2: raises $0.15 to $0.25
DimaLesnoy: folds 
Hollseg: folds 
namemattbark: folds 
pondax: folds 
Uncalled bet ($0.15) returned to barbos2
barbos2 collected $0.25 from pot
barbos2: doesn't show hand 
*** SUMMARY ***
Total pot $0.25 | Rake $0 
Seat 1: pondax (big blind) folded before Flop
Seat 2: barbos2 collected ($0.25)
Seat 3: DimaLesnoy folded before Flop (didn't bet)
Seat 5: Hollseg (button) folded before Flop (didn't bet)
Seat 6: namemattbark (small blind) folded before Flop



PokerStars Hand #222964112001:  Hold'em No Limit ($0.05/$0.10 USD) - 2021/01/23 13:37:13 ET
Table 'Stephano III' 6-max Seat #1 is the button
Seat 1: pondax ($9.90 in chips) 
Seat 2: barbos2 ($10.30 in chips) 
Seat 3: DimaLesnoy ($11.86 in chips) 
Seat 5: Hollseg ($25.79 in chips) 
barbos2: posts small blind $0.05
DimaLesnoy: posts big blind $0.10
*** HOLE CARDS ***
Hollseg: raises $0.15 to $0.25
MD_207 leaves the table
namemattbark leaves the table
pondax: folds 
barbos2: folds 
DimaLesnoy: calls $0.15
*** FLOP *** [Qd 2h 3c]
DimaLesnoy: checks 
Hollseg: bets $0.20
DimaLesnoy: folds 
Uncalled bet ($0.20) returned to Hollseg
Hollseg collected $0.53 from pot
Hollseg: doesn't show hand 
*** SUMMARY ***
Total pot $0.55 | Rake $0.02 
Board [Qd 2h 3c]
Seat 1: pondax (button) folded before Flop (didn't bet)
Seat 2: barbos2 (small blind) folded before Flop
Seat 3: DimaLesnoy (big blind) folded on the Flop
Seat 5: Hollseg collected ($0.53)



PokerStars Hand #222964129550:  Hold'em No Limit ($0.05/$0.10 USD) - 2021/01/23 13:37:36 ET
Table 'Stephano III' 6-max Seat #2 is the button
Seat 1: pondax ($9.90 in chips) 
Seat 2: barbos2 ($10.25 in chips) 
Seat 3: DimaLesnoy ($11.61 in chips) 
DimaLesnoy: posts small blind $0.05
Hollseg: is sitting out 
pondax: posts big blind $0.10
*** HOLE CARDS ***
barbos2: raises $0.15 to $0.25
DimaLesnoy: folds 
Impostore1988 joins the table at seat #4 
pondax: calls $0.15
*** FLOP *** [8d 5c 4d]
Hollseg leaves the table
pondax: checks 
whell11 joins the table at seat #5 
DrLevty joins the table at seat #6 
barbos2: checks 
*** TURN *** [8d 5c 4d] [3h]
pondax: checks 
barbos2: checks 
*** RIVER *** [8d 5c 4d 3h] [7h]
pondax: bets $0.53
barbos2: folds 
Uncalled bet ($0.53) returned to pondax
pondax collected $0.53 from pot
pondax: doesn't show hand 
*** SUMMARY ***
Total pot $0.55 | Rake $0.02 
Board [8d 5c 4d 3h 7h]
Seat 1: pondax (big blind) collected ($0.53)
Seat 2: barbos2 (button) folded on the River
Seat 3: DimaLesnoy (small blind) folded before Flop



PokerStars Hand #222964165720:  Hold'em No Limit ($0.05/$0.10 USD) - 2021/01/23 13:38:22 ET
Table 'Stephano III' 6-max Seat #3 is the button
Seat 1: pondax ($10.18 in chips) 
Seat 2: barbos2 ($10 in chips) 
Seat 3: DimaLesnoy ($11.56 in chips) 
pondax: posts small blind $0.05
barbos2: posts big blind $0.10
*** HOLE CARDS ***
DimaLesnoy: folds 
pondax: raises $0.20 to $0.30
barbos2: folds 
Uncalled bet ($0.20) returned to pondax
pondax collected $0.20 from pot
pondax: doesn't show hand 
*** SUMMARY ***
Total pot $0.20 | Rake $0 
Seat 1: pondax (small blind) collected ($0.20)
Seat 2: barbos2 (big blind) folded before Flop
Seat 3: DimaLesnoy (button) folded before Flop (didn't bet)



PokerStars Hand #222964171816:  Hold'em No Limit ($0.05/$0.10 USD) - 2021/01/23 13:38:30 ET
Table 'Stephano III' 6-max Seat #1 is the button
Seat 1: pondax ($10.28 in chips) 
Seat 2: barbos2 ($10 in chips) 
Seat 4: Impostore1988 ($16.18 in chips) 
barbos2: posts small blind $0.05
DimaLesnoy: is sitting out 
Impostore1988: posts big blind $0.10
whell11: sits out 
DrLevty: sits out 
*** HOLE CARDS ***
pondax: folds 
DimaLesnoy leaves the table
barbos2: raises $0.15 to $0.25
Impostore1988: folds 
Uncalled bet ($0.15) returned to barbos2
Impostore1988 leaves the table
barbos2 collected $0.20 from pot
barbos2: doesn't show hand 
meteor9867 joins the table at seat #3 
*** SUMMARY ***
Total pot $0.20 | Rake $0 
Seat 1: pondax (button) folded before Flop (didn't bet)
Seat 2: barbos2 (small blind) collected ($0.20)
Seat 4: Impostore1988 (big blind) folded before Flop



PokerStars Hand #222964187834:  Hold'em No Limit ($0.05/$0.10 USD) - 2021/01/23 13:38:51 ET
Table 'Stephano III' 6-max Seat #2 is the button
Seat 1: pondax ($10.28 in chips) 
Seat 2: barbos2 ($10.10 in chips) 
barbos2: posts small blind $0.05
pondax: posts big blind $0.10
*** HOLE CARDS ***
barbos2: raises $0.10 to $0.20
pondax: folds 
Uncalled bet ($0.10) returned to barbos2
barbos2 collected $0.20 from pot
barbos2: doesn't show hand 
*** SUMMARY ***
Total pot $0.20 | Rake $0 
Seat 1: pondax (big blind) folded before Flop
Seat 2: barbos2 (button) (small blind) collected ($0.20)



PokerStars Hand #222964197099:  Hold'em No Limit ($0.05/$0.10 USD) - 2021/01/23 13:39:03 ET
Table 'Stephano III' 6-max Seat #1 is the button
Seat 1: pondax ($10.18 in chips) 
Seat 2: barbos2 ($10.20 in chips) 
Seat 3: meteor9867 ($10 in chips) 
barbos2: posts small blind $0.05
meteor9867: posts big blind $0.10
whell11: sits out 
DrLevty: sits out 
*** HOLE CARDS ***
pondax: folds 
barbos2: raises $0.15 to $0.25
meteor9867: folds 
Uncalled bet ($0.15) returned to barbos2
barbos2 collected $0.20 from pot
barbos2: doesn't show hand 
*** SUMMARY ***
Total pot $0.20 | Rake $0 
Seat 1: pondax (button) folded before Flop (didn't bet)
Seat 2: barbos2 (small blind) collected ($0.20)
Seat 3: meteor9867 (big blind) folded before Flop



PokerStars Hand #222964206863:  Hold'em No Limit ($0.05/$0.10 USD) - 2021/01/23 13:39:15 ET
Table 'Stephano III' 6-max Seat #2 is the button
Seat 1: pondax ($10.18 in chips) 
Seat 2: barbos2 ($10.30 in chips) 
Seat 3: meteor9867 ($10 in chips) 
Seat 5: whell11 ($10 in chips) 
meteor9867: posts small blind $0.05
whell11: posts big blind $0.10
DrLevty: sits out 
*** HOLE CARDS ***
pondax: folds 
barbos2: folds 
meteor9867: folds 
Uncalled bet ($0.05) returned to whell11
whell11 collected $0.10 from pot
whell11: doesn't show hand 
*** SUMMARY ***
Total pot $0.10 | Rake $0 
Seat 1: pondax folded before Flop (didn't bet)
Seat 2: barbos2 (button) folded before Flop (didn't bet)
Seat 3: meteor9867 (small blind) folded before Flop
Seat 5: whell11 (big blind) collected ($0.10)



PokerStars Hand #222964217436:  Hold'em No Limit ($0.05/$0.10 USD) - 2021/01/23 13:39:29 ET
Table 'Stephano III' 6-max Seat #3 is the button
Seat 1: pondax ($10.18 in chips) 
Seat 2: barbos2 ($10.30 in chips) 
Seat 3: meteor9867 ($10 in chips) 
Seat 5: whell11 ($10.05 in chips) 
Seat 6: DrLevty ($10 in chips) 
whell11: posts small blind $0.05
DrLevty: posts big blind $0.10
*** HOLE CARDS ***
pondax: folds 
barbos2: folds 
meteor9867: raises $0.15 to $0.25
whell11: folds 
DrLevty: calls $0.15
*** FLOP *** [8c 4c 2h]
DrLevty: checks 
meteor9867: checks 
*** TURN *** [8c 4c 2h] [Jd]
DrLevty: bets $0.47
ramseskat joins the table at seat #4 
meteor9867: calls $0.47
*** RIVER *** [8c 4c 2h Jd] [Kd]
DrLevty: checks 
meteor9867: bets $0.71
DrLevty: folds 
Uncalled bet ($0.71) returned to meteor9867
meteor9867 collected $1.42 from pot
meteor9867: doesn't show hand 
*** SUMMARY ***
Total pot $1.49 | Rake $0.07 
Board [8c 4c 2h Jd Kd]
Seat 1: pondax folded before Flop (didn't bet)
Seat 2: barbos2 folded before Flop (didn't bet)
Seat 3: meteor9867 (button) collected ($1.42)
Seat 5: whell11 (small blind) folded before Flop
Seat 6: DrLevty (big blind) folded on the River



PokerStars Hand #222964285347:  Hold'em No Limit ($0.05/$0.10 USD) - 2021/01/23 13:40:57 ET
Table 'Stephano III' 6-max Seat #5 is the button
Seat 1: pondax ($10.18 in chips) 
Seat 2: barbos2 ($10.30 in chips) 
Seat 3: meteor9867 ($10.70 in chips) 
Seat 5: whell11 ($10 in chips) 
Seat 6: DrLevty ($10 in chips) 
DrLevty: posts small blind $0.05
pondax: posts big blind $0.10
ramseskat: sits out 
*** HOLE CARDS ***
barbos2: folds 
meteor9867: folds 
whell11: raises $0.15 to $0.25
DrLevty: folds 
pondax: calls $0.15
*** FLOP *** [Ah 3s 5c]
pondax: checks 
whell11: checks 
*** TURN *** [Ah 3s 5c] [4c]
pondax: checks 
whell11: bets $0.35
pondax: calls $0.35
*** RIVER *** [Ah 3s 5c 4c] [3h]
pondax: checks 
whell11: checks 
*** SHOW DOWN ***
pondax: shows [6s 6h] (two pair, Sixes and Threes)
whell11: mucks hand 
pondax collected $1.19 from pot
*** SUMMARY ***
Total pot $1.25 | Rake $0.06 
Board [Ah 3s 5c 4c 3h]
Seat 1: pondax (big blind) showed [6s 6h] and won ($1.19) with two pair, Sixes and Threes
Seat 2: barbos2 folded before Flop (didn't bet)
Seat 3: meteor9867 folded before Flop (didn't bet)
Seat 5: whell11 (button) mucked
Seat 6: DrLevty (small blind) folded before Flop



PokerStars Hand #222964335707:  Hold'em No Limit ($0.05/$0.10 USD) - 2021/01/23 13:42:02 ET
Table 'Stephano III' 6-max Seat #6 is the button
Seat 2: barbos2 ($10.30 in chips) 
Seat 3: meteor9867 ($10.70 in chips) 
Seat 5: whell11 ($10 in chips) 
Seat 6: DrLevty ($10 in chips) 
barbos2: posts small blind $0.05
meteor9867: posts big blind $0.10
ramseskat: sits out 
*** HOLE CARDS ***
whell11: folds 
DrLevty: folds 
Jesus Ololo joins the table at seat #1 
barbos2: raises $0.25 to $0.35
meteor9867: folds 
Uncalled bet ($0.25) returned to barbos2
barbos2 collected $0.20 from pot
barbos2: doesn't show hand 
*** SUMMARY ***
Total pot $0.20 | Rake $0 
Seat 2: barbos2 (small blind) collected ($0.20)
Seat 3: meteor9867 (big blind) folded before Flop
Seat 5: whell11 folded before Flop (didn't bet)
Seat 6: DrLevty (button) folded before Flop (didn't bet)



PokerStars Hand #222964354740:  Hold'em No Limit ($0.05/$0.10 USD) - 2021/01/23 13:42:27 ET
Table 'Stephano III' 6-max Seat #2 is the button
Seat 2: barbos2 ($10.40 in chips) 
Seat 3: meteor9867 ($10.60 in chips) 
Seat 4: ramseskat ($10 in chips) 
Seat 5: whell11 ($10 in chips) 
Seat 6: DrLevty ($10 in chips) 
meteor9867: posts small blind $0.05
ramseskat: posts big blind $0.10
Jesus Ololo: sits out 
*** HOLE CARDS ***
whell11: folds 
DrLevty: folds 
whell11 leaves the table
barbos2: folds 
meteor9867: raises $0.15 to $0.25
ramseskat: raises $0.65 to $0.90
reini85xxx joins the table at seat #5 
meteor9867: folds 
Uncalled bet ($0.65) returned to ramseskat
ramseskat collected $0.50 from pot
ramseskat: doesn't show hand 
*** SUMMARY ***
Total pot $0.50 | Rake $0 
Seat 2: barbos2 (button) folded before Flop (didn't bet)
Seat 3: meteor9867 (small blind) folded before Flop
Seat 4: ramseskat (big blind) collected ($0.50)
Seat 5: whell11 folded before Flop (didn't bet)
Seat 6: DrLevty folded before Flop (didn't bet)



PokerStars Hand #222964390251:  Hold'em No Limit ($0.05/$0.10 USD) - 2021/01/23 13:43:12 ET
Table 'Stephano III' 6-max Seat #3 is the button
Seat 2: barbos2 ($10.40 in chips) 
Seat 3: meteor9867 ($10.35 in chips) 
Seat 4: ramseskat ($10.25 in chips) 
Seat 6: DrLevty ($10 in chips) 
ramseskat: posts small blind $0.05
DrLevty: posts big blind $0.10
Jesus Ololo: sits out 
*** HOLE CARDS ***
barbos2: folds 
meteor9867: folds 
ramseskat: calls $0.05
DrLevty: raises $0.20 to $0.30
ramseskat: calls $0.20
*** FLOP *** [Qs 3d 5d]
ramseskat: checks 
DrLevty: bets $0.19
ramseskat: raises $0.31 to $0.50
DrLevty: calls $0.31
*** TURN *** [Qs 3d 5d] [7c]
ramseskat: bets $1.05
DrLevty: calls $1.05
*** RIVER *** [Qs 3d 5d 7c] [Kh]
ramseskat: bets $2.30
DrLevty: calls $2.30
*** SHOW DOWN ***
ramseskat: shows [3c 5c] (two pair, Fives and Threes)
DrLevty: mucks hand 
ramseskat collected $7.93 from pot
*** SUMMARY ***
Total pot $8.30 | Rake $0.37 
Board [Qs 3d 5d 7c Kh]
Seat 2: barbos2 folded before Flop (didn't bet)
Seat 3: meteor9867 (button) folded before Flop (didn't bet)
Seat 4: ramseskat (small blind) showed [3c 5c] and won ($7.93) with two pair, Fives and Threes
Seat 6: DrLevty (big blind) mucked



PokerStars Hand #222964432620:  Hold'em No Limit ($0.05/$0.10 USD) - 2021/01/23 13:43:59 ET
Table 'Stephano III' 6-max Seat #4 is the button
Seat 1: Jesus Ololo ($10 in chips) 
Seat 2: barbos2 ($10.40 in chips) 
Seat 3: meteor9867 ($10.35 in chips) 
Seat 4: ramseskat ($14.03 in chips) 
Seat 6: DrLevty ($10 in chips) 
DrLevty: posts small blind $0.05
Jesus Ololo: posts big blind $0.10
*** HOLE CARDS ***
barbos2: folds 
meteor9867: folds 
ramseskat: folds 
DrLevty: folds 
Uncalled bet ($0.05) returned to Jesus Ololo
Jesus Ololo collected $0.10 from pot
*** SUMMARY ***
Total pot $0.10 | Rake $0 
Seat 1: Jesus Ololo (big blind) collected ($0.10)
Seat 2: barbos2 folded before Flop (didn't bet)
Seat 3: meteor9867 folded before Flop (didn't bet)
Seat 4: ramseskat (button) folded before Flop (didn't bet)
Seat 6: DrLevty (small blind) folded before Flop



PokerStars Hand #222964439701:  Hold'em No Limit ($0.05/$0.10 USD) - 2021/01/23 13:44:09 ET
Table 'Stephano III' 6-max Seat #6 is the button
Seat 1: Jesus Ololo ($10.05 in chips) 
Seat 2: barbos2 ($10.40 in chips) 
Seat 3: meteor9867 ($10.35 in chips) 
Seat 4: ramseskat ($14.03 in chips) 
Seat 6: DrLevty ($10 in chips) 
Jesus Ololo: posts small blind $0.05
barbos2: posts big blind $0.10
*** HOLE CARDS ***
meteor9867: folds 
ramseskat: folds 
DrLevty: raises $0.20 to $0.30
Jesus Ololo: folds 
barbos2: folds 
Uncalled bet ($0.20) returned to DrLevty
DrLevty collected $0.25 from pot
DrLevty: doesn't show hand 
*** SUMMARY ***
Total pot $0.25 | Rake $0 
Seat 1: Jesus Ololo (small blind) folded before Flop
Seat 2: barbos2 (big blind) folded before Flop
Seat 3: meteor9867 folded before Flop (didn't bet)
Seat 4: ramseskat folded before Flop (didn't bet)
Seat 6: DrLevty (button) collected ($0.25)



PokerStars Hand #222964449558:  Hold'em No Limit ($0.05/$0.10 USD) - 2021/01/23 13:44:22 ET
Table 'Stephano III' 6-max Seat #1 is the button
Seat 1: Jesus Ololo ($10 in chips) 
Seat 2: barbos2 ($10.30 in chips) 
Seat 3: meteor9867 ($10.35 in chips) 
Seat 4: ramseskat ($14.03 in chips) 
Seat 6: DrLevty ($10.15 in chips) 
barbos2: posts small blind $0.05
meteor9867: posts big blind $0.10
*** HOLE CARDS ***
ramseskat: folds 
DrLevty: folds 
Jesus Ololo: folds 
barbos2: raises $0.25 to $0.35
meteor9867: folds 
Uncalled bet ($0.25) returned to barbos2
barbos2 collected $0.20 from pot
barbos2: doesn't show hand 
*** SUMMARY ***
Total pot $0.20 | Rake $0 
Seat 1: Jesus Ololo (button) folded before Flop (didn't bet)
Seat 2: barbos2 (small blind) collected ($0.20)
Seat 3: meteor9867 (big blind) folded before Flop
Seat 4: ramseskat folded before Flop (didn't bet)
Seat 6: DrLevty folded before Flop (didn't bet)



PokerStars Hand #222964467793:  Hold'em No Limit ($0.05/$0.10 USD) - 2021/01/23 13:44:45 ET
Table 'Stephano III' 6-max Seat #2 is the button
Seat 1: Jesus Ololo ($10 in chips) 
Seat 2: barbos2 ($10.40 in chips) 
Seat 3: meteor9867 ($10.25 in chips) 
Seat 4: ramseskat ($14.03 in chips) 
Seat 6: DrLevty ($10.15 in chips) 
meteor9867: posts small blind $0.05
ramseskat: posts big blind $0.10
*** HOLE CARDS ***
DrLevty: folds 
Jesus Ololo: raises $0.15 to $0.25
barbos2: folds 
meteor9867: folds 
ramseskat: folds 
Uncalled bet ($0.15) returned to Jesus Ololo
Jesus Ololo collected $0.25 from pot
*** SUMMARY ***
Total pot $0.25 | Rake $0 
Seat 1: Jesus Ololo collected ($0.25)
Seat 2: barbos2 (button) folded before Flop (didn't bet)
Seat 3: meteor9867 (small blind) folded before Flop
Seat 4: ramseskat (big blind) folded before Flop
Seat 6: DrLevty folded before Flop (didn't bet)



PokerStars Hand #222964478570:  Hold'em No Limit ($0.05/$0.10 USD) - 2021/01/23 13:44:59 ET
Table 'Stephano III' 6-max Seat #3 is the button
Seat 1: Jesus Ololo ($10.15 in chips) 
Seat 2: barbos2 ($10.40 in chips) 
Seat 3: meteor9867 ($10.20 in chips) 
Seat 4: ramseskat ($13.93 in chips) 
Seat 5: reini85xxx ($8 in chips) 
Seat 6: DrLevty ($10.15 in chips) 
ramseskat: posts small blind $0.05
reini85xxx: posts big blind $0.10
*** HOLE CARDS ***
DrLevty: raises $0.20 to $0.30
Jesus Ololo: calls $0.30
barbos2: folds 
meteor9867: folds 
ramseskat: folds 
reini85xxx: calls $0.20
*** FLOP *** [Jh 4h 7d]
reini85xxx: checks 
DrLevty: checks 
Jesus Ololo: bets $0.45
reini85xxx: folds 
DrLevty: folds 
Uncalled bet ($0.45) returned to Jesus Ololo
Jesus Ololo collected $0.91 from pot
*** SUMMARY ***
Total pot $0.95 | Rake $0.04 
Board [Jh 4h 7d]
Seat 1: Jesus Ololo collected ($0.91)
Seat 2: barbos2 folded before Flop (didn't bet)
Seat 3: meteor9867 (button) folded before Flop (didn't bet)
Seat 4: ramseskat (small blind) folded before Flop
Seat 5: reini85xxx (big blind) folded on the Flop
Seat 6: DrLevty folded on the Flop



PokerStars Hand #222964499402:  Hold'em No Limit ($0.05/$0.10 USD) - 2021/01/23 13:45:26 ET
Table 'Stephano III' 6-max Seat #4 is the button
Seat 1: Jesus Ololo ($10.76 in chips) 
Seat 2: barbos2 ($10.40 in chips) 
Seat 3: meteor9867 ($10.20 in chips) 
Seat 4: ramseskat ($13.88 in chips) 
Seat 5: reini85xxx ($7.70 in chips) 
Seat 6: DrLevty ($10 in chips) 
reini85xxx: posts small blind $0.05
DrLevty: posts big blind $0.10
*** HOLE CARDS ***
Jesus Ololo: folds 
barbos2: folds 
meteor9867: folds 
ramseskat: folds 
reini85xxx: calls $0.05
DrLevty: checks 
*** FLOP *** [Qd As 3c]
reini85xxx: checks 
DrLevty: checks 
*** TURN *** [Qd As 3c] [6h]
reini85xxx: checks 
DrLevty: checks 
*** RIVER *** [Qd As 3c 6h] [6s]
reini85xxx: bets $0.10
DrLevty: calls $0.10
*** SHOW DOWN ***
reini85xxx: shows [7d Ks] (a pair of Sixes)
DrLevty: shows [Ts 3h] (two pair, Sixes and Threes)
DrLevty collected $0.38 from pot
*** SUMMARY ***
Total pot $0.40 | Rake $0.02 
Board [Qd As 3c 6h 6s]
Seat 1: Jesus Ololo folded before Flop (didn't bet)
Seat 2: barbos2 folded before Flop (didn't bet)
Seat 3: meteor9867 folded before Flop (didn't bet)
Seat 4: ramseskat (button) folded before Flop (didn't bet)
Seat 5: reini85xxx (small blind) showed [7d Ks] and lost with a pair of Sixes
Seat 6: DrLevty (big blind) showed [Ts 3h] and won ($0.38) with two pair, Sixes and Threes



PokerStars Hand #222964522860:  Hold'em No Limit ($0.05/$0.10 USD) - 2021/01/23 13:45:57 ET
Table 'Stephano III' 6-max Seat #5 is the button
Seat 1: Jesus Ololo ($10.76 in chips) 
Seat 2: barbos2 ($10.40 in chips) 
Seat 3: meteor9867 ($10.20 in chips) 
Seat 4: ramseskat ($13.88 in chips) 
Seat 5: reini85xxx ($7.50 in chips) 
Seat 6: DrLevty ($10.18 in chips) 
DrLevty: posts small blind $0.05
Jesus Ololo: posts big blind $0.10
*** HOLE CARDS ***
barbos2: raises $0.15 to $0.25
meteor9867: folds 
ramseskat: folds 
reini85xxx: calls $0.25
DrLevty: calls $0.20
Jesus Ololo: folds 
*** FLOP *** [2c Kh 3h]
DrLevty: checks 
barbos2: checks 
reini85xxx: bets $0.70
DrLevty: folds 
barbos2: folds 
Uncalled bet ($0.70) returned to reini85xxx
reini85xxx collected $0.81 from pot
reini85xxx: doesn't show hand 
*** SUMMARY ***
Total pot $0.85 | Rake $0.04 
Board [2c Kh 3h]
Seat 1: Jesus Ololo (big blind) folded before Flop
Seat 2: barbos2 folded on the Flop
Seat 3: meteor9867 folded before Flop (didn't bet)
Seat 4: ramseskat folded before Flop (didn't bet)
Seat 5: reini85xxx (button) collected ($0.81)
Seat 6: DrLevty (small blind) folded on the Flop



PokerStars Hand #222964549976:  Hold'em No Limit ($0.05/$0.10 USD) - 2021/01/23 13:46:32 ET
Table 'Stephano III' 6-max Seat #6 is the button
Seat 1: Jesus Ololo ($10.66 in chips) 
Seat 2: barbos2 ($10.15 in chips) 
Seat 3: meteor9867 ($10.20 in chips) 
Seat 4: ramseskat ($13.88 in chips) 
Seat 5: reini85xxx ($8.06 in chips) 
Seat 6: DrLevty ($10 in chips) 
Jesus Ololo: posts small blind $0.05
barbos2: posts big blind $0.10
*** HOLE CARDS ***
meteor9867: folds 
ramseskat: folds 
reini85xxx: calls $0.10
DrLevty: raises $0.40 to $0.50
Jesus Ololo: folds 
barbos2: folds 
reini85xxx: calls $0.40
*** FLOP *** [6s 8c 6d]
reini85xxx: checks 
DrLevty: checks 
*** TURN *** [6s 8c 6d] [Jd]
reini85xxx: checks 
DrLevty: bets $0.61
reini85xxx: folds 
Uncalled bet ($0.61) returned to DrLevty
DrLevty collected $1.10 from pot
DrLevty: doesn't show hand 
*** SUMMARY ***
Total pot $1.15 | Rake $0.05 
Board [6s 8c 6d Jd]
Seat 1: Jesus Ololo (small blind) folded before Flop
Seat 2: barbos2 (big blind) folded before Flop
Seat 3: meteor9867 folded before Flop (didn't bet)
Seat 4: ramseskat folded before Flop (didn't bet)
Seat 5: reini85xxx folded on the Turn
Seat 6: DrLevty (button) collected ($1.10)



PokerStars Hand #222964574015:  Hold'em No Limit ($0.05/$0.10 USD) - 2021/01/23 13:47:04 ET
Table 'Stephano III' 6-max Seat #1 is the button
Seat 1: Jesus Ololo ($10.61 in chips) 
Seat 2: barbos2 ($10.05 in chips) 
Seat 3: meteor9867 ($10.20 in chips) 
Seat 4: ramseskat ($13.88 in chips) 
Seat 5: reini85xxx ($7.56 in chips) 
Seat 6: DrLevty ($10.60 in chips) 
barbos2: posts small blind $0.05
meteor9867: posts big blind $0.10
*** HOLE CARDS ***
ramseskat: folds 
reini85xxx: folds 
DrLevty: raises $0.20 to $0.30
Jesus Ololo: folds 
barbos2: folds 
meteor9867: folds 
Uncalled bet ($0.20) returned to DrLevty
DrLevty collected $0.25 from pot
DrLevty: doesn't show hand 
*** SUMMARY ***
Total pot $0.25 | Rake $0 
Seat 1: Jesus Ololo (button) folded before Flop (didn't bet)
Seat 2: barbos2 (small blind) folded before Flop
Seat 3: meteor9867 (big blind) folded before Flop
Seat 4: ramseskat folded before Flop (didn't bet)
Seat 5: reini85xxx folded before Flop (didn't bet)
Seat 6: DrLevty collected ($0.25)



PokerStars Hand #222964584643:  Hold'em No Limit ($0.05/$0.10 USD) - 2021/01/23 13:47:18 ET
Table 'Stephano III' 6-max Seat #2 is the button
Seat 1: Jesus Ololo ($10.61 in chips) 
Seat 2: barbos2 ($10 in chips) 
Seat 3: meteor9867 ($10.10 in chips) 
Seat 4: ramseskat ($13.88 in chips) 
Seat 5: reini85xxx ($7.56 in chips) 
Seat 6: DrLevty ($10.75 in chips) 
meteor9867: posts small blind $0.05
ramseskat: posts big blind $0.10
*** HOLE CARDS ***
reini85xxx: calls $0.10
DrLevty: raises $0.20 to $0.30
Jesus Ololo: folds 
barbos2: folds 
meteor9867: calls $0.25
ramseskat: folds 
reini85xxx: raises $1 to $1.30
DrLevty: calls $1
meteor9867: folds 
*** FLOP *** [5h 7h 8s]
reini85xxx: bets $1.43
DrLevty: calls $1.43
*** TURN *** [5h 7h 8s] [9d]
reini85xxx: bets $4.83 and is all-in
DrLevty: calls $4.83
*** RIVER *** [5h 7h 8s 9d] [Kh]
*** SHOW DOWN ***
reini85xxx: shows [Ah Th] (a flush, Ace high)
DrLevty: shows [9c 9s] (three of a kind, Nines)
reini85xxx collected $14.82 from pot
DrLevty cashed out the hand for $10.34 | Cash Out Fee $0.10
*** SUMMARY ***
Total pot $15.52 | Rake $0.70 
Board [5h 7h 8s 9d Kh]
Seat 1: Jesus Ololo folded before Flop (didn't bet)
Seat 2: barbos2 (button) folded before Flop (didn't bet)
Seat 3: meteor9867 (small blind) folded before Flop
Seat 4: ramseskat (big blind) folded before Flop
Seat 5: reini85xxx showed [Ah Th] and won ($14.82) with a flush, Ace high
Seat 6: DrLevty showed [9c 9s] and lost with three of a kind, Nines (cashed out).



PokerStars Hand #222964620801:  Hold'em No Limit ($0.05/$0.10 USD) - 2021/01/23 13:48:05 ET
Table 'Stephano III' 6-max Seat #3 is the button
Seat 1: Jesus Ololo ($10.61 in chips) 
Seat 2: barbos2 ($10 in chips) 
Seat 3: meteor9867 ($10 in chips) 
Seat 4: ramseskat ($13.78 in chips) 
Seat 5: reini85xxx ($14.82 in chips) 
Seat 6: DrLevty ($13.53 in chips) 
ramseskat: posts small blind $0.05
reini85xxx: posts big blind $0.10
*** HOLE CARDS ***
DrLevty: folds 
Jesus Ololo: folds 
barbos2: folds 
meteor9867: raises $0.15 to $0.25
ramseskat: folds 
reini85xxx: calls $0.15
*** FLOP *** [Jd 7d 7s]
reini85xxx: checks 
meteor9867: bets $0.22
reini85xxx: calls $0.22
*** TURN *** [Jd 7d 7s] [Kd]
reini85xxx: checks 
meteor9867: bets $0.48
reini85xxx: raises $1.91 to $2.39
meteor9867: folds 
Uncalled bet ($1.91) returned to reini85xxx
reini85xxx collected $1.86 from pot
reini85xxx: doesn't show hand 
*** SUMMARY ***
Total pot $1.95 | Rake $0.09 
Board [Jd 7d 7s Kd]
Seat 1: Jesus Ololo folded before Flop (didn't bet)
Seat 2: barbos2 folded before Flop (didn't bet)
Seat 3: meteor9867 (button) folded on the Turn
Seat 4: ramseskat (small blind) folded before Flop
Seat 5: reini85xxx (big blind) collected ($1.86)
Seat 6: DrLevty folded before Flop (didn't bet)



PokerStars Hand #222964665286:  Hold'em No Limit ($0.05/$0.10 USD) - 2021/01/23 13:49:04 ET
Table 'Stephano III' 6-max Seat #4 is the button
Seat 1: Jesus Ololo ($10.61 in chips) 
Seat 2: barbos2 ($10 in chips) 
Seat 3: meteor9867 ($10 in chips) 
Seat 4: ramseskat ($13.73 in chips) 
Seat 5: reini85xxx ($15.73 in chips) 
Seat 6: DrLevty ($13.53 in chips) 
reini85xxx: posts small blind $0.05
DrLevty: posts big blind $0.10
*** HOLE CARDS ***
Jesus Ololo: folds 
barbos2: folds 
meteor9867: folds 
ramseskat: folds 
reini85xxx: folds 
Uncalled bet ($0.05) returned to DrLevty
DrLevty collected $0.10 from pot
DrLevty: doesn't show hand 
*** SUMMARY ***
Total pot $0.10 | Rake $0 
Seat 1: Jesus Ololo folded before Flop (didn't bet)
Seat 2: barbos2 folded before Flop (didn't bet)
Seat 3: meteor9867 folded before Flop (didn't bet)
Seat 4: ramseskat (button) folded before Flop (didn't bet)
Seat 5: reini85xxx (small blind) folded before Flop
Seat 6: DrLevty (big blind) collected ($0.10)



PokerStars Hand #222964672599:  Hold'em No Limit ($0.05/$0.10 USD) - 2021/01/23 13:49:13 ET
Table 'Stephano III' 6-max Seat #5 is the button
Seat 1: Jesus Ololo ($10.61 in chips) 
Seat 2: barbos2 ($10 in chips) 
Seat 3: meteor9867 ($10 in chips) 
Seat 4: ramseskat ($13.73 in chips) 
Seat 5: reini85xxx ($15.68 in chips) 
Seat 6: DrLevty ($13.58 in chips) 
DrLevty: posts small blind $0.05
Jesus Ololo: posts big blind $0.10
*** HOLE CARDS ***
barbos2: folds 
meteor9867: raises $0.15 to $0.25
ramseskat: folds 
reini85xxx: folds 
DrLevty: folds 
Jesus Ololo: folds 
Uncalled bet ($0.15) returned to meteor9867
meteor9867 collected $0.25 from pot
meteor9867: doesn't show hand 
*** SUMMARY ***
Total pot $0.25 | Rake $0 
Seat 1: Jesus Ololo (big blind) folded before Flop
Seat 2: barbos2 folded before Flop (didn't bet)
Seat 3: meteor9867 collected ($0.25)
Seat 4: ramseskat folded before Flop (didn't bet)
Seat 5: reini85xxx (button) folded before Flop (didn't bet)
Seat 6: DrLevty (small blind) folded before Flop



PokerStars Hand #222964684746:  Hold'em No Limit ($0.05/$0.10 USD) - 2021/01/23 13:49:29 ET
Table 'Stephano III' 6-max Seat #6 is the button
Seat 1: Jesus Ololo ($10.51 in chips) 
Seat 2: barbos2 ($10 in chips) 
Seat 3: meteor9867 ($10.15 in chips) 
Seat 4: ramseskat ($13.73 in chips) 
Seat 5: reini85xxx ($15.68 in chips) 
Seat 6: DrLevty ($13.53 in chips) 
Jesus Ololo: posts small blind $0.05
barbos2: posts big blind $0.10
*** HOLE CARDS ***
meteor9867: folds 
ramseskat: folds 
reini85xxx: calls $0.10
DrLevty: raises $0.40 to $0.50
Jesus Ololo: folds 
barbos2: folds 
reini85xxx: folds 
Uncalled bet ($0.40) returned to DrLevty
DrLevty collected $0.35 from pot
DrLevty: doesn't show hand 
*** SUMMARY ***
Total pot $0.35 | Rake $0 
Seat 1: Jesus Ololo (small blind) folded before Flop
Seat 2: barbos2 (big blind) folded before Flop
Seat 3: meteor9867 folded before Flop (didn't bet)
Seat 4: ramseskat folded before Flop (didn't bet)
Seat 5: reini85xxx folded before Flop
Seat 6: DrLevty (button) collected ($0.35)



PokerStars Hand #222964706545:  Hold'em No Limit ($0.05/$0.10 USD) - 2021/01/23 13:49:58 ET
Table 'Stephano III' 6-max Seat #1 is the button
Seat 1: Jesus Ololo ($10.46 in chips) 
Seat 2: barbos2 ($10 in chips) 
Seat 3: meteor9867 ($10.15 in chips) 
Seat 4: ramseskat ($13.73 in chips) 
Seat 5: reini85xxx ($15.58 in chips) 
Seat 6: DrLevty ($13.78 in chips) 
barbos2: posts small blind $0.05
meteor9867: posts big blind $0.10
*** HOLE CARDS ***
ramseskat: folds 
reini85xxx: folds 
DrLevty: folds 
Jesus Ololo: folds 
barbos2: raises $0.25 to $0.35
meteor9867: folds 
Uncalled bet ($0.25) returned to barbos2
barbos2 collected $0.20 from pot
barbos2: doesn't show hand 
*** SUMMARY ***
Total pot $0.20 | Rake $0 
Seat 1: Jesus Ololo (button) folded before Flop (didn't bet)
Seat 2: barbos2 (small blind) collected ($0.20)
Seat 3: meteor9867 (big blind) folded before Flop
Seat 4: ramseskat folded before Flop (didn't bet)
Seat 5: reini85xxx folded before Flop (didn't bet)
Seat 6: DrLevty folded before Flop (didn't bet)



PokerStars Hand #222964722843:  Hold'em No Limit ($0.05/$0.10 USD) - 2021/01/23 13:50:19 ET
Table 'Stephano III' 6-max Seat #2 is the button
Seat 1: Jesus Ololo ($10.46 in chips) 
Seat 2: barbos2 ($10.10 in chips) 
Seat 3: meteor9867 ($10.05 in chips) 
Seat 4: ramseskat ($13.73 in chips) 
Seat 5: reini85xxx ($15.58 in chips) 
Seat 6: DrLevty ($13.78 in chips) 
meteor9867: posts small blind $0.05
ramseskat: posts big blind $0.10
*** HOLE CARDS ***
reini85xxx: folds 
DrLevty: folds 
Jesus Ololo: folds 
reini85xxx leaves the table
barbos2 has timed out
barbos2: folds 
Eduard Gl joins the table at seat #5 
meteor9867: raises $0.15 to $0.25
ramseskat: folds 
Uncalled bet ($0.15) returned to meteor9867
meteor9867 collected $0.20 from pot
meteor9867: doesn't show hand 
*** SUMMARY ***
Total pot $0.20 | Rake $0 
Seat 1: Jesus Ololo folded before Flop (didn't bet)
Seat 2: barbos2 (button) folded before Flop (didn't bet)
Seat 3: meteor9867 (small blind) collected ($0.20)
Seat 4: ramseskat (big blind) folded before Flop
Seat 5: reini85xxx folded before Flop (didn't bet)
Seat 6: DrLevty folded before Flop (didn't bet)



PokerStars Hand #222964739717:  Hold'em No Limit ($0.05/$0.10 USD) - 2021/01/23 13:50:41 ET
Table 'Stephano III' 6-max Seat #3 is the button
Seat 1: Jesus Ololo ($10.46 in chips) 
Seat 2: barbos2 ($10.10 in chips) 
Seat 3: meteor9867 ($10.15 in chips) 
Seat 4: ramseskat ($13.63 in chips) 
Seat 5: Eduard Gl ($10 in chips) 
Seat 6: DrLevty ($13.78 in chips) 
ramseskat: posts small blind $0.05
Eduard Gl: posts big blind $0.10
*** HOLE CARDS ***
DrLevty: folds 
Jesus Ololo: raises $0.15 to $0.25
barbos2: folds 
meteor9867: folds 
ramseskat: calls $0.20
Eduard Gl: calls $0.15
*** FLOP *** [6s 2c 4s]
ramseskat: checks 
Eduard Gl: checks 
Jesus Ololo: checks 
*** TURN *** [6s 2c 4s] [5c]
ramseskat: checks 
Eduard Gl: checks 
Jesus Ololo: checks 
*** RIVER *** [6s 2c 4s 5c] [3h]
ramseskat: checks 
Eduard Gl: bets $0.45
Jesus Ololo: calls $0.45
ramseskat: folds 
*** SHOW DOWN ***
Eduard Gl: shows [8c Td] (a straight, Deuce to Six)
Jesus Ololo: shows [Ah Qs] (a straight, Deuce to Six)
Eduard Gl collected $0.79 from pot
Jesus Ololo collected $0.79 from pot
*** SUMMARY ***
Total pot $1.65 | Rake $0.07 
Board [6s 2c 4s 5c 3h]
Seat 1: Jesus Ololo showed [Ah Qs] and won ($0.79) with a straight, Deuce to Six
Seat 2: barbos2 folded before Flop (didn't bet)
Seat 3: meteor9867 (button) folded before Flop (didn't bet)
Seat 4: ramseskat (small blind) folded on the River
Seat 5: Eduard Gl (big blind) showed [8c Td] and won ($0.79) with a straight, Deuce to Six
Seat 6: DrLevty folded before Flop (didn't bet)



PokerStars Hand #222964773223:  Hold'em No Limit ($0.05/$0.10 USD) - 2021/01/23 13:51:25 ET
Table 'Stephano III' 6-max Seat #4 is the button
Seat 1: Jesus Ololo ($10.55 in chips) 
Seat 2: barbos2 ($10.10 in chips) 
Seat 3: meteor9867 ($10.15 in chips) 
Seat 4: ramseskat ($13.38 in chips) 
Seat 5: Eduard Gl ($10.09 in chips) 
Seat 6: DrLevty ($13.78 in chips) 
Eduard Gl: posts small blind $0.05
DrLevty: posts big blind $0.10
*** HOLE CARDS ***
Jesus Ololo: raises $0.15 to $0.25
barbos2: folds 
meteor9867: folds 
ramseskat: calls $0.25
Eduard Gl: raises $1.05 to $1.30
DrLevty: folds 
Jesus Ololo: folds 
ramseskat: calls $1.05
*** FLOP *** [Ah 3c Jd]
Eduard Gl: checks 
ramseskat: checks 
*** TURN *** [Ah 3c Jd] [7s]
Eduard Gl: bets $1.41
ramseskat: folds 
Uncalled bet ($1.41) returned to Eduard Gl
Eduard Gl collected $2.82 from pot
Eduard Gl: doesn't show hand 
*** SUMMARY ***
Total pot $2.95 | Rake $0.13 
Board [Ah 3c Jd 7s]
Seat 1: Jesus Ololo folded before Flop
Seat 2: barbos2 folded before Flop (didn't bet)
Seat 3: meteor9867 folded before Flop (didn't bet)
Seat 4: ramseskat (button) folded on the Turn
Seat 5: Eduard Gl (small blind) collected ($2.82)
Seat 6: DrLevty (big blind) folded before Flop



PokerStars Hand #222964796169:  Hold'em No Limit ($0.05/$0.10 USD) - 2021/01/23 13:51:55 ET
Table 'Stephano III' 6-max Seat #5 is the button
Seat 1: Jesus Ololo ($10.30 in chips) 
Seat 2: barbos2 ($10.10 in chips) 
Seat 3: meteor9867 ($10.15 in chips) 
Seat 4: ramseskat ($12.08 in chips) 
Seat 5: Eduard Gl ($11.61 in chips) 
Seat 6: DrLevty ($13.68 in chips) 
DrLevty: posts small blind $0.05
Jesus Ololo: posts big blind $0.10
*** HOLE CARDS ***
barbos2: folds 
meteor9867: folds 
ramseskat: raises $0.20 to $0.30
Eduard Gl: folds 
DrLevty: folds 
Jesus Ololo: folds 
Uncalled bet ($0.20) returned to ramseskat
ramseskat collected $0.25 from pot
ramseskat: doesn't show hand 
*** SUMMARY ***
Total pot $0.25 | Rake $0 
Seat 1: Jesus Ololo (big blind) folded before Flop
Seat 2: barbos2 folded before Flop (didn't bet)
Seat 3: meteor9867 folded before Flop (didn't bet)
Seat 4: ramseskat collected ($0.25)
Seat 5: Eduard Gl (button) folded before Flop (didn't bet)
Seat 6: DrLevty (small blind) folded before Flop



PokerStars Hand #222964807391:  Hold'em No Limit ($0.05/$0.10 USD) - 2021/01/23 13:52:10 ET
Table 'Stephano III' 6-max Seat #6 is the button
Seat 1: Jesus Ololo ($10.20 in chips) 
Seat 2: barbos2 ($10.10 in chips) 
Seat 3: meteor9867 ($10.15 in chips) 
Seat 4: ramseskat ($12.23 in chips) 
Seat 5: Eduard Gl ($11.61 in chips) 
Seat 6: DrLevty ($13.63 in chips) 
Jesus Ololo: posts small blind $0.05
barbos2: posts big blind $0.10
*** HOLE CARDS ***
meteor9867: folds 
ramseskat: raises $0.20 to $0.30
Eduard Gl: folds 
DrLevty: folds 
Jesus Ololo: folds 
barbos2: folds 
Uncalled bet ($0.20) returned to ramseskat
ramseskat collected $0.25 from pot
ramseskat: doesn't show hand 
*** SUMMARY ***
Total pot $0.25 | Rake $0 
Seat 1: Jesus Ololo (small blind) folded before Flop
Seat 2: barbos2 (big blind) folded before Flop
Seat 3: meteor9867 folded before Flop (didn't bet)
Seat 4: ramseskat collected ($0.25)
Seat 5: Eduard Gl folded before Flop (didn't bet)
Seat 6: DrLevty (button) folded before Flop (didn't bet)



PokerStars Hand #222964822543:  Hold'em No Limit ($0.05/$0.10 USD) - 2021/01/23 13:52:29 ET
Table 'Stephano III' 6-max Seat #1 is the button
Seat 1: Jesus Ololo ($10.15 in chips) 
Seat 2: barbos2 ($10 in chips) 
Seat 4: ramseskat ($12.38 in chips) 
Seat 5: Eduard Gl ($11.61 in chips) 
Seat 6: DrLevty ($13.63 in chips) 
barbos2: posts small blind $0.05
meteor9867: is sitting out 
meteor9867 leaves the table
ramseskat: posts big blind $0.10
*** HOLE CARDS ***
Eduard Gl: raises $0.20 to $0.30
DrLevty: raises $0.60 to $0.90
Jesus Ololo: folds 
barbos2: folds 
ramseskat: folds 
Eduard Gl: calls $0.60
*** FLOP *** [7s Tc Ac]
Eduard Gl: checks 
tmWudzy joins the table at seat #3 
tmWudzy leaves the table
DrLevty: checks 
*** TURN *** [7s Tc Ac] [Th]
Eduard Gl: bets $0.93
DrLevty: folds 
Uncalled bet ($0.93) returned to Eduard Gl
Eduard Gl collected $1.86 from pot
Eduard Gl: doesn't show hand 
*** SUMMARY ***
Total pot $1.95 | Rake $0.09 
Board [7s Tc Ac Th]
Seat 1: Jesus Ololo (button) folded before Flop (didn't bet)
Seat 2: barbos2 (small blind) folded before Flop
Seat 4: ramseskat (big blind) folded before Flop
Seat 5: Eduard Gl collected ($1.86)
Seat 6: DrLevty folded on the Turn



PokerStars Hand #222964844407:  Hold'em No Limit ($0.05/$0.10 USD) - 2021/01/23 13:52:58 ET
Table 'Stephano III' 6-max Seat #2 is the button
Seat 1: Jesus Ololo ($10.15 in chips) 
Seat 2: barbos2 ($10 in chips) 
Seat 4: ramseskat ($12.28 in chips) 
Seat 5: Eduard Gl ($12.57 in chips) 
Seat 6: DrLevty ($12.73 in chips) 
ramseskat: posts small blind $0.05
Eduard Gl: posts big blind $0.10
*** HOLE CARDS ***
DrLevty: folds 
Jesus Ololo: folds 
barbos2: raises $0.15 to $0.25
ramseskat: folds 
Eduard Gl: folds 
Uncalled bet ($0.15) returned to barbos2
barbos2 collected $0.25 from pot
barbos2: doesn't show hand 
*** SUMMARY ***
Total pot $0.25 | Rake $0 
Seat 1: Jesus Ololo folded before Flop (didn't bet)
Seat 2: barbos2 (button) collected ($0.25)
Seat 4: ramseskat (small blind) folded before Flop
Seat 5: Eduard Gl (big blind) folded before Flop
Seat 6: DrLevty folded before Flop (didn't bet)



PokerStars Hand #222964858563:  Hold'em No Limit ($0.05/$0.10 USD) - 2021/01/23 13:53:17 ET
Table 'Stephano III' 6-max Seat #4 is the button
Seat 1: Jesus Ololo ($10.15 in chips) 
Seat 2: barbos2 ($10.15 in chips) 
Seat 4: ramseskat ($12.23 in chips) 
Seat 5: Eduard Gl ($12.47 in chips) 
Seat 6: DrLevty ($12.73 in chips) 
Eduard Gl: posts small blind $0.05
DrLevty: posts big blind $0.10
*** HOLE CARDS ***
Jesus Ololo: raises $0.15 to $0.25
mattl1990 joins the table at seat #3 
barbos2: raises $0.55 to $0.80
ramseskat: folds 
Eduard Gl: folds 
DrLevty: folds 
Jesus Ololo: folds 
Uncalled bet ($0.55) returned to barbos2
barbos2 collected $0.65 from pot
barbos2: doesn't show hand 
*** SUMMARY ***
Total pot $0.65 | Rake $0 
Seat 1: Jesus Ololo folded before Flop
Seat 2: barbos2 collected ($0.65)
Seat 4: ramseskat (button) folded before Flop (didn't bet)
Seat 5: Eduard Gl (small blind) folded before Flop
Seat 6: DrLevty (big blind) folded before Flop



PokerStars Hand #222964881422:  Hold'em No Limit ($0.05/$0.10 USD) - 2021/01/23 13:53:47 ET
Table 'Stephano III' 6-max Seat #5 is the button
Seat 2: barbos2 ($10.55 in chips) 
Seat 4: ramseskat ($12.23 in chips) 
Seat 5: Eduard Gl ($12.42 in chips) 
Seat 6: DrLevty ($12.63 in chips) 
DrLevty: posts small blind $0.05
Jesus Ololo: is sitting out 
barbos2: posts big blind $0.10
mattl1990: sits out 
*** HOLE CARDS ***
ramseskat: folds 
Jesus Ololo leaves the table
Eduard Gl: raises $0.10 to $0.20
DrLevty: folds 
barbos2: folds 
Uncalled bet ($0.10) returned to Eduard Gl
Eduard Gl collected $0.25 from pot
Eduard Gl: doesn't show hand 
*** SUMMARY ***
Total pot $0.25 | Rake $0 
Seat 2: barbos2 (big blind) folded before Flop
Seat 4: ramseskat folded before Flop (didn't bet)
Seat 5: Eduard Gl (button) collected ($0.25)
Seat 6: DrLevty (small blind) folded before Flop



PokerStars Hand #222964889574:  Hold'em No Limit ($0.05/$0.10 USD) - 2021/01/23 13:53:58 ET
Table 'Stephano III' 6-max Seat #6 is the button
Seat 2: barbos2 ($10.45 in chips) 
Seat 3: mattl1990 ($10 in chips) 
Seat 4: ramseskat ($12.23 in chips) 
Seat 5: Eduard Gl ($12.57 in chips) 
Seat 6: DrLevty ($12.58 in chips) 
barbos2: posts small blind $0.05
mattl1990: posts big blind $0.10
*** HOLE CARDS ***
ramseskat: folds 
Eduard Gl: folds 
DrLevty: folds 
barbos2: raises $0.25 to $0.35
Jesus Ololo joins the table at seat #1 
mattl1990: folds 
Uncalled bet ($0.25) returned to barbos2
barbos2 collected $0.20 from pot
barbos2: doesn't show hand 
*** SUMMARY ***
Total pot $0.20 | Rake $0 
Seat 2: barbos2 (small blind) collected ($0.20)
Seat 3: mattl1990 (big blind) folded before Flop
Seat 4: ramseskat folded before Flop (didn't bet)
Seat 5: Eduard Gl folded before Flop (didn't bet)
Seat 6: DrLevty (button) folded before Flop (didn't bet)



PokerStars Hand #222964902865:  Hold'em No Limit ($0.05/$0.10 USD) - 2021/01/23 13:54:15 ET
Table 'Stephano III' 6-max Seat #2 is the button
Seat 2: barbos2 ($10.55 in chips) 
Seat 3: mattl1990 ($9.90 in chips) 
Seat 4: ramseskat ($12.23 in chips) 
Seat 5: Eduard Gl ($12.57 in chips) 
Seat 6: DrLevty ($12.58 in chips) 
mattl1990: posts small blind $0.05
ramseskat: posts big blind $0.10
Jesus Ololo: sits out 
*** HOLE CARDS ***
Eduard Gl: folds 
DrLevty: raises $0.20 to $0.30
barbos2: raises $0.70 to $1
mattl1990: folds 
ramseskat: folds 
DrLevty: folds 
Uncalled bet ($0.70) returned to barbos2
barbos2 collected $0.75 from pot
barbos2: doesn't show hand 
*** SUMMARY ***
Total pot $0.75 | Rake $0 
Seat 2: barbos2 (button) collected ($0.75)
Seat 3: mattl1990 (small blind) folded before Flop
Seat 4: ramseskat (big blind) folded before Flop
Seat 5: Eduard Gl folded before Flop (didn't bet)
Seat 6: DrLevty folded before Flop



PokerStars Hand #222964917547:  Hold'em No Limit ($0.05/$0.10 USD) - 2021/01/23 13:54:35 ET
Table 'Stephano III' 6-max Seat #3 is the button
Seat 2: barbos2 ($11 in chips) 
Seat 3: mattl1990 ($9.85 in chips) 
Seat 4: ramseskat ($12.13 in chips) 
Seat 5: Eduard Gl ($12.57 in chips) 
Seat 6: DrLevty ($12.28 in chips) 
ramseskat: posts small blind $0.05
Eduard Gl: posts big blind $0.10
Jesus Ololo: sits out 
*** HOLE CARDS ***
DrLevty: folds 
barbos2: folds 
mattl1990: calls $0.10
ramseskat: folds 
Eduard Gl: raises $0.40 to $0.50
mattl1990: folds 
Uncalled bet ($0.40) returned to Eduard Gl
Eduard Gl collected $0.25 from pot
Eduard Gl: doesn't show hand 
*** SUMMARY ***
Total pot $0.25 | Rake $0 
Seat 2: barbos2 folded before Flop (didn't bet)
Seat 3: mattl1990 (button) folded before Flop
Seat 4: ramseskat (small blind) folded before Flop
Seat 5: Eduard Gl (big blind) collected ($0.25)
Seat 6: DrLevty folded before Flop (didn't bet)



PokerStars Hand #222964930838:  Hold'em No Limit ($0.05/$0.10 USD) - 2021/01/23 13:54:52 ET
Table 'Stephano III' 6-max Seat #4 is the button
Seat 2: barbos2 ($11 in chips) 
Seat 3: mattl1990 ($9.75 in chips) 
Seat 4: ramseskat ($12.08 in chips) 
Seat 5: Eduard Gl ($12.72 in chips) 
Seat 6: DrLevty ($12.28 in chips) 
Eduard Gl: posts small blind $0.05
DrLevty: posts big blind $0.10
Jesus Ololo: sits out 
*** HOLE CARDS ***
barbos2: raises $0.20 to $0.30
mattl1990: calls $0.30
ramseskat: folds 
Eduard Gl: raises $1 to $1.30
DrLevty: folds 
barbos2: folds 
mattl1990: calls $1
*** FLOP *** [Qd 6d 3h]
Eduard Gl: bets $1.65
mattl1990: calls $1.65
*** TURN *** [Qd 6d 3h] [As]
Eduard Gl: bets $3.01
mattl1990: folds 
Uncalled bet ($3.01) returned to Eduard Gl
Eduard Gl collected $6.02 from pot
Eduard Gl: doesn't show hand 
*** SUMMARY ***
Total pot $6.30 | Rake $0.28 
Board [Qd 6d 3h As]
Seat 2: barbos2 folded before Flop
Seat 3: mattl1990 folded on the Turn
Seat 4: ramseskat (button) folded before Flop (didn't bet)
Seat 5: Eduard Gl (small blind) collected ($6.02)
Seat 6: DrLevty (big blind) folded before Flop



PokerStars Hand #222964955768:  Hold'em No Limit ($0.05/$0.10 USD) - 2021/01/23 13:55:35 ET
Table 'Stephano III' 6-max Seat #5 is the button
Seat 1: Jesus Ololo ($10 in chips) 
Seat 2: barbos2 ($10.70 in chips) 
Seat 3: mattl1990 ($6.80 in chips) 
Seat 4: ramseskat ($12.08 in chips) 
Seat 5: Eduard Gl ($15.79 in chips) 
Seat 6: DrLevty ($12.18 in chips) 
DrLevty: posts small blind $0.05
Jesus Ololo: posts big blind $0.10
*** HOLE CARDS ***
barbos2 has timed out
barbos2: folds 
mattl1990: raises $0.50 to $0.60
ramseskat: folds 
Eduard Gl: folds 
DrLevty: folds 
Jesus Ololo: folds 
Uncalled bet ($0.50) returned to mattl1990
mattl1990 collected $0.25 from pot
mattl1990: doesn't show hand 
*** SUMMARY ***
Total pot $0.25 | Rake $0 
Seat 1: Jesus Ololo (big blind) folded before Flop
Seat 2: barbos2 folded before Flop (didn't bet)
Seat 3: mattl1990 collected ($0.25)
Seat 4: ramseskat folded before Flop (didn't bet)
Seat 5: Eduard Gl (button) folded before Flop (didn't bet)
Seat 6: DrLevty (small blind) folded before Flop



PokerStars Hand #222964965468:  Hold'em No Limit ($0.05/$0.10 USD) - 2021/01/23 13:55:55 ET
Table 'Stephano III' 6-max Seat #6 is the button
Seat 1: Jesus Ololo ($10 in chips) 
Seat 3: mattl1990 ($6.95 in chips) 
Seat 4: ramseskat ($12.08 in chips) 
Seat 5: Eduard Gl ($15.79 in chips) 
Seat 6: DrLevty ($12.13 in chips) 
Jesus Ololo: posts small blind $0.05
mattl1990: posts big blind $0.10
*** HOLE CARDS ***
ramseskat: folds 
Eduard Gl: folds 
DrLevty: raises $0.20 to $0.30
Jesus Ololo: raises $0.90 to $1.20
mattl1990: folds 
DrLevty: folds 
Uncalled bet ($0.90) returned to Jesus Ololo
Jesus Ololo collected $0.70 from pot
*** SUMMARY ***
Total pot $0.70 | Rake $0 
Seat 1: Jesus Ololo (small blind) collected ($0.70)
Seat 3: mattl1990 (big blind) folded before Flop
Seat 4: ramseskat folded before Flop (didn't bet)
Seat 5: Eduard Gl folded before Flop (didn't bet)
Seat 6: DrLevty (button) folded before Flop



PokerStars Hand #222964971329:  Hold'em No Limit ($0.05/$0.10 USD) - 2021/01/23 13:56:07 ET
Table 'Stephano III' 6-max Seat #1 is the button
Seat 1: Jesus Ololo ($10.40 in chips) 
Seat 3: mattl1990 ($6.85 in chips) 
Seat 4: ramseskat ($12.08 in chips) 
Seat 5: Eduard Gl ($15.79 in chips) 
Seat 6: DrLevty ($11.83 in chips) 
mattl1990: posts small blind $0.05
ramseskat: posts big blind $0.10
*** HOLE CARDS ***
Eduard Gl: folds 
DrLevty: folds 
Jesus Ololo: raises $0.15 to $0.25
mattl1990: calls $0.20
ramseskat: calls $0.15
*** FLOP *** [3d 5h Jc]
mattl1990: checks 
ramseskat: checks 
Jesus Ololo: bets $0.35
mattl1990: folds 
ramseskat: folds 
Uncalled bet ($0.35) returned to Jesus Ololo
Jesus Ololo collected $0.72 from pot
*** SUMMARY ***
Total pot $0.75 | Rake $0.03 
Board [3d 5h Jc]
Seat 1: Jesus Ololo (button) collected ($0.72)
Seat 3: mattl1990 (small blind) folded on the Flop
Seat 4: ramseskat (big blind) folded on the Flop
Seat 5: Eduard Gl folded before Flop (didn't bet)
Seat 6: DrLevty folded before Flop (didn't bet)



PokerStars Hand #222964982725:  Hold'em No Limit ($0.05/$0.10 USD) - 2021/01/23 13:56:31 ET
Table 'Stephano III' 6-max Seat #3 is the button
Seat 1: Jesus Ololo ($10.87 in chips) 
Seat 3: mattl1990 ($6.60 in chips) 
Seat 4: ramseskat ($11.83 in chips) 
Seat 5: Eduard Gl ($15.79 in chips) 
Seat 6: DrLevty ($11.83 in chips) 
ramseskat: posts small blind $0.05
Eduard Gl: posts big blind $0.10
barbos2: sits out 
*** HOLE CARDS ***
DrLevty: folds 
Jesus Ololo: folds 
mattl1990: calls $0.10
ramseskat: folds 
Eduard Gl: checks 
*** FLOP *** [9d Kh 3h]
Eduard Gl: checks 
mattl1990: checks 
*** TURN *** [9d Kh 3h] [6s]
Eduard Gl: checks 
mattl1990: checks 
*** RIVER *** [9d Kh 3h 6s] [Ks]
Eduard Gl: checks 
mattl1990: checks 
*** SHOW DOWN ***
Eduard Gl: shows [4d Qh] (a pair of Kings)
mattl1990: shows [8s Ah] (a pair of Kings - Ace kicker)
mattl1990 collected $0.24 from pot
*** SUMMARY ***
Total pot $0.25 | Rake $0.01 
Board [9d Kh 3h 6s Ks]
Seat 1: Jesus Ololo folded before Flop (didn't bet)
Seat 3: mattl1990 (button) showed [8s Ah] and won ($0.24) with a pair of Kings
Seat 4: ramseskat (small blind) folded before Flop
Seat 5: Eduard Gl (big blind) showed [4d Qh] and lost with a pair of Kings
Seat 6: DrLevty folded before Flop (didn't bet)



PokerStars Hand #222964994519:  Hold'em No Limit ($0.05/$0.10 USD) - 2021/01/23 13:56:56 ET
Table 'Stephano III' 6-max Seat #4 is the button
Seat 1: Jesus Ololo ($10.87 in chips) 
Seat 3: mattl1990 ($6.74 in chips) 
Seat 4: ramseskat ($11.78 in chips) 
Seat 5: Eduard Gl ($15.69 in chips) 
Seat 6: DrLevty ($11.83 in chips) 
Eduard Gl: posts small blind $0.05
DrLevty: posts big blind $0.10
barbos2: sits out 
*** HOLE CARDS ***
Jesus Ololo: folds 
mattl1990: calls $0.10
ramseskat: folds 
Eduard Gl: folds 
DrLevty: checks 
*** FLOP *** [7d 4s 8c]
DrLevty: bets $0.20
mattl1990: folds 
Uncalled bet ($0.20) returned to DrLevty
DrLevty collected $0.24 from pot
DrLevty: doesn't show hand 
*** SUMMARY ***
Total pot $0.25 | Rake $0.01 
Board [7d 4s 8c]
Seat 1: Jesus Ololo folded before Flop (didn't bet)
Seat 3: mattl1990 folded on the Flop
Seat 4: ramseskat (button) folded before Flop (didn't bet)
Seat 5: Eduard Gl (small blind) folded before Flop
Seat 6: DrLevty (big blind) collected ($0.24)



PokerStars Hand #222965002598:  Hold'em No Limit ($0.05/$0.10 USD) - 2021/01/23 13:57:12 ET
Table 'Stephano III' 6-max Seat #5 is the button
Seat 1: Jesus Ololo ($10.87 in chips) 
Seat 3: mattl1990 ($6.64 in chips) 
Seat 4: ramseskat ($11.78 in chips) 
Seat 5: Eduard Gl ($15.64 in chips) 
Seat 6: DrLevty ($11.97 in chips) 
DrLevty: posts small blind $0.05
Jesus Ololo: posts big blind $0.10
barbos2: sits out 
*** HOLE CARDS ***
mattl1990: calls $0.10
ramseskat: raises $0.35 to $0.45
Eduard Gl: folds 
DrLevty: folds 
Jesus Ololo: folds 
mattl1990: calls $0.35
*** FLOP *** [Ts 7s 8s]
mattl1990: checks 
ramseskat: bets $0.65
mattl1990: folds 
Uncalled bet ($0.65) returned to ramseskat
ramseskat collected $1 from pot
ramseskat: doesn't show hand 
*** SUMMARY ***
Total pot $1.05 | Rake $0.05 
Board [Ts 7s 8s]
Seat 1: Jesus Ololo (big blind) folded before Flop
Seat 3: mattl1990 folded on the Flop
Seat 4: ramseskat collected ($1)
Seat 5: Eduard Gl (button) folded before Flop (didn't bet)
Seat 6: DrLevty (small blind) folded before Flop



PokerStars Hand #222965020771:  Hold'em No Limit ($0.05/$0.10 USD) - 2021/01/23 13:57:49 ET
Table 'Stephano III' 6-max Seat #6 is the button
Seat 1: Jesus Ololo ($10.77 in chips) 
Seat 2: barbos2 ($10.70 in chips) 
Seat 3: mattl1990 ($6.19 in chips) 
Seat 4: ramseskat ($12.33 in chips) 
Seat 5: Eduard Gl ($15.64 in chips) 
Seat 6: DrLevty ($11.92 in chips) 
Jesus Ololo: posts small blind $0.05
barbos2: posts big blind $0.10
*** HOLE CARDS ***
mattl1990: calls $0.10
ramseskat: folds 
Eduard Gl: folds 
DrLevty: folds 
Jesus Ololo: raises $0.40 to $0.50
barbos2: folds 
mattl1990: calls $0.40
*** FLOP *** [Kh 2d Qs]
Jesus Ololo: bets $0.60
mattl1990: calls $0.60
*** TURN *** [Kh 2d Qs] [5h]
Jesus Ololo: bets $1.80
mattl1990: raises $3.29 to $5.09 and is all-in
Jesus Ololo: calls $3.29
*** RIVER *** [Kh 2d Qs 5h] [5s]
*** SHOW DOWN ***
Jesus Ololo: shows [Kd Qh] (two pair, Kings and Queens)
mattl1990: shows [Ah Ad] (two pair, Aces and Fives)
mattl1990 collected $11.92 from pot
*** SUMMARY ***
Total pot $12.48 | Rake $0.56 
Board [Kh 2d Qs 5h 5s]
Seat 1: Jesus Ololo (small blind) showed [Kd Qh] and lost with two pair, Kings and Queens
Seat 2: barbos2 (big blind) folded before Flop
Seat 3: mattl1990 showed [Ah Ad] and won ($11.92) with two pair, Aces and Fives
Seat 4: ramseskat folded before Flop (didn't bet)
Seat 5: Eduard Gl folded before Flop (didn't bet)
Seat 6: DrLevty (button) folded before Flop (didn't bet)



PokerStars Hand #222965043409:  Hold'em No Limit ($0.05/$0.10 USD) - 2021/01/23 13:58:35 ET
Table 'Stephano III' 6-max Seat #1 is the button
Seat 1: Jesus Ololo ($10 in chips) 
Seat 2: barbos2 ($10.60 in chips) 
Seat 3: mattl1990 ($11.92 in chips) 
Seat 4: ramseskat ($12.33 in chips) 
Seat 5: Eduard Gl ($15.64 in chips) 
Seat 6: DrLevty ($11.92 in chips) 
barbos2: posts small blind $0.05
mattl1990: posts big blind $0.10
*** HOLE CARDS ***
ramseskat: raises $0.20 to $0.30
Eduard Gl: folds 
DrLevty: folds 
Jesus Ololo: folds 
barbos2: folds 
mattl1990: calls $0.20
*** FLOP *** [3d 5s 8d]
mattl1990: checks 
ramseskat: checks 
*** TURN *** [3d 5s 8d] [2h]
mattl1990: checks 
ramseskat: checks 
*** RIVER *** [3d 5s 8d 2h] [Ks]
mattl1990: checks 
ramseskat: checks 
*** SHOW DOWN ***
mattl1990: shows [7c 3c] (a pair of Threes)
ramseskat: mucks hand 
mattl1990 collected $0.62 from pot
*** SUMMARY ***
Total pot $0.65 | Rake $0.03 
Board [3d 5s 8d 2h Ks]
Seat 1: Jesus Ololo (button) folded before Flop (didn't bet)
Seat 2: barbos2 (small blind) folded before Flop
Seat 3: mattl1990 (big blind) showed [7c 3c] and won ($0.62) with a pair of Threes
Seat 4: ramseskat mucked
Seat 5: Eduard Gl folded before Flop (didn't bet)
Seat 6: DrLevty folded before Flop (didn't bet)



PokerStars Hand #222965063070:  Hold'em No Limit ($0.05/$0.10 USD) - 2021/01/23 13:59:16 ET
Table 'Stephano III' 6-max Seat #2 is the button
Seat 1: Jesus Ololo ($10 in chips) 
Seat 2: barbos2 ($10.55 in chips) 
Seat 3: mattl1990 ($12.24 in chips) 
Seat 4: ramseskat ($12.03 in chips) 
Seat 5: Eduard Gl ($15.64 in chips) 
Seat 6: DrLevty ($11.92 in chips) 
mattl1990: posts small blind $0.05
ramseskat: posts big blind $0.10
*** HOLE CARDS ***
Eduard Gl: folds 
DrLevty: raises $0.20 to $0.30
Jesus Ololo: folds 
barbos2: calls $0.30
mattl1990: folds 
ramseskat: calls $0.20
*** FLOP *** [Ad 7d Qc]
ramseskat: checks 
DrLevty: checks 
barbos2: checks 
*** TURN *** [Ad 7d Qc] [Qd]
ramseskat: checks 
DrLevty: checks 
barbos2: checks 
*** RIVER *** [Ad 7d Qc Qd] [6s]
ramseskat: bets $0.46
DrLevty: folds 
barbos2: folds 
Uncalled bet ($0.46) returned to ramseskat
ramseskat collected $0.91 from pot
ramseskat: doesn't show hand 
*** SUMMARY ***
Total pot $0.95 | Rake $0.04 
Board [Ad 7d Qc Qd 6s]
Seat 1: Jesus Ololo folded before Flop (didn't bet)
Seat 2: barbos2 (button) folded on the River
Seat 3: mattl1990 (small blind) folded before Flop
Seat 4: ramseskat (big blind) collected ($0.91)
Seat 5: Eduard Gl folded before Flop (didn't bet)
Seat 6: DrLevty folded on the River



PokerStars Hand #222965097327:  Hold'em No Limit ($0.05/$0.10 USD) - 2021/01/23 14:00:22 ET
Table 'Stephano III' 6-max Seat #3 is the button
Seat 1: Jesus Ololo ($10 in chips) 
Seat 2: barbos2 ($10.25 in chips) 
Seat 3: mattl1990 ($12.19 in chips) 
Seat 4: ramseskat ($12.64 in chips) 
Seat 5: Eduard Gl ($15.64 in chips) 
Seat 6: DrLevty ($11.62 in chips) 
ramseskat: posts small blind $0.05
Eduard Gl: posts big blind $0.10
*** HOLE CARDS ***
DrLevty: folds 
Jesus Ololo: folds 
barbos2: raises $0.20 to $0.30
mattl1990: calls $0.30
ramseskat: folds 
Eduard Gl: folds 
*** FLOP *** [5c 7c 3c]
barbos2: checks 
mattl1990: checks 
*** TURN *** [5c 7c 3c] [2c]
barbos2: checks 
mattl1990: checks 
*** RIVER *** [5c 7c 3c 2c] [8c]
barbos2: bets $0.54
mattl1990: folds 
Uncalled bet ($0.54) returned to barbos2
barbos2 collected $0.72 from pot
barbos2: doesn't show hand 
*** SUMMARY ***
Total pot $0.75 | Rake $0.03 
Board [5c 7c 3c 2c 8c]
Seat 1: Jesus Ololo folded before Flop (didn't bet)
Seat 2: barbos2 collected ($0.72)
Seat 3: mattl1990 (button) folded on the River
Seat 4: ramseskat (small blind) folded before Flop
Seat 5: Eduard Gl (big blind) folded before Flop
Seat 6: DrLevty folded before Flop (didn't bet)



PokerStars Hand #222965113332:  Hold'em No Limit ($0.05/$0.10 USD) - 2021/01/23 14:00:52 ET
Table 'Stephano III' 6-max Seat #4 is the button
Seat 1: Jesus Ololo ($10 in chips) 
Seat 2: barbos2 ($10.67 in chips) 
Seat 3: mattl1990 ($11.89 in chips) 
Seat 4: ramseskat ($12.59 in chips) 
Seat 5: Eduard Gl ($15.54 in chips) 
Seat 6: DrLevty ($11.62 in chips) 
Eduard Gl: posts small blind $0.05
DrLevty: posts big blind $0.10
*** HOLE CARDS ***
Jesus Ololo: raises $0.15 to $0.25
barbos2: folds 
mattl1990: calls $0.25
ramseskat: calls $0.25
Eduard Gl: raises $1.30 to $1.55
DrLevty: folds 
Jesus Ololo: calls $1.30
mattl1990: folds 
ramseskat: raises $11.04 to $12.59 and is all-in
Eduard Gl: folds 
Jesus Ololo: folds 
Uncalled bet ($11.04) returned to ramseskat
ramseskat collected $5 from pot
ramseskat: doesn't show hand 
*** SUMMARY ***
Total pot $5 | Rake $0 
Seat 1: Jesus Ololo folded before Flop
Seat 2: barbos2 folded before Flop (didn't bet)
Seat 3: mattl1990 folded before Flop
Seat 4: ramseskat (button) collected ($5)
Seat 5: Eduard Gl (small blind) folded before Flop
Seat 6: DrLevty (big blind) folded before Flop



PokerStars Hand #222965154206:  Hold'em No Limit ($0.05/$0.10 USD) - 2021/01/23 14:01:52 ET
Table 'Stephano III' 6-max Seat #5 is the button
Seat 1: Jesus Ololo ($10 in chips) 
Seat 2: barbos2 ($10.67 in chips) 
Seat 3: mattl1990 ($11.64 in chips) 
Seat 4: ramseskat ($16.04 in chips) 
Seat 5: Eduard Gl ($13.99 in chips) 
Seat 6: DrLevty ($11.52 in chips) 
DrLevty: posts small blind $0.05
Jesus Ololo: posts big blind $0.10
*** HOLE CARDS ***
barbos2: folds 
mattl1990: calls $0.10
ramseskat: folds 
Eduard Gl: folds 
DrLevty: raises $0.40 to $0.50
Jesus Ololo: folds 
mattl1990: calls $0.40
*** FLOP *** [6c Ad Qc]
DrLevty: bets $0.35
mattl1990: raises $0.35 to $0.70
DrLevty: calls $0.35
*** TURN *** [6c Ad Qc] [Th]
DrLevty: checks 
mattl1990: bets $0.30
DrLevty: calls $0.30
*** RIVER *** [6c Ad Qc Th] [5s]
DrLevty: checks 
mattl1990: checks 
*** SHOW DOWN ***
DrLevty: shows [Jd Td] (a pair of Tens)
mattl1990: shows [8c Ac] (a pair of Aces)
mattl1990 collected $2.96 from pot
*** SUMMARY ***
Total pot $3.10 | Rake $0.14 
Board [6c Ad Qc Th 5s]
Seat 1: Jesus Ololo (big blind) folded before Flop
Seat 2: barbos2 folded before Flop (didn't bet)
Seat 3: mattl1990 showed [8c Ac] and won ($2.96) with a pair of Aces
Seat 4: ramseskat folded before Flop (didn't bet)
Seat 5: Eduard Gl (button) folded before Flop (didn't bet)
Seat 6: DrLevty (small blind) showed [Jd Td] and lost with a pair of Tens



PokerStars Hand #222965184860:  Hold'em No Limit ($0.05/$0.10 USD) - 2021/01/23 14:02:25 ET
Table 'Stephano III' 6-max Seat #6 is the button
Seat 1: Jesus Ololo ($10 in chips) 
Seat 2: barbos2 ($10.67 in chips) 
Seat 3: mattl1990 ($13.10 in chips) 
Seat 4: ramseskat ($16.04 in chips) 
Seat 5: Eduard Gl ($13.99 in chips) 
Seat 6: DrLevty ($10.02 in chips) 
Jesus Ololo: posts small blind $0.05
barbos2: posts big blind $0.10
*** HOLE CARDS ***
mattl1990: folds 
ramseskat: folds 
Eduard Gl: folds 
DrLevty: raises $0.20 to $0.30
Jesus Ololo: folds 
barbos2: raises $1 to $1.30
DrLevty: calls $1
*** FLOP *** [Th Ks Kd]
barbos2: bets $0.80
DrLevty: folds 
Uncalled bet ($0.80) returned to barbos2
barbos2 collected $2.53 from pot
barbos2: doesn't show hand 
*** SUMMARY ***
Total pot $2.65 | Rake $0.12 
Board [Th Ks Kd]
Seat 1: Jesus Ololo (small blind) folded before Flop
Seat 2: barbos2 (big blind) collected ($2.53)
Seat 3: mattl1990 folded before Flop (didn't bet)
Seat 4: ramseskat folded before Flop (didn't bet)
Seat 5: Eduard Gl folded before Flop (didn't bet)
Seat 6: DrLevty (button) folded on the Flop



PokerStars Hand #222965220153:  Hold'em No Limit ($0.05/$0.10 USD) - 2021/01/23 14:03:10 ET
Table 'Stephano III' 6-max Seat #1 is the button
Seat 1: Jesus Ololo ($10 in chips) 
Seat 2: barbos2 ($11.90 in chips) 
Seat 3: mattl1990 ($13.10 in chips) 
Seat 4: ramseskat ($16.04 in chips) 
Seat 5: Eduard Gl ($13.99 in chips) 
Seat 6: DrLevty ($10 in chips) 
barbos2: posts small blind $0.05
mattl1990: posts big blind $0.10
*** HOLE CARDS ***
ramseskat: folds 
Eduard Gl: folds 
DrLevty: folds 
Jesus Ololo: raises $0.15 to $0.25
barbos2: folds 
mattl1990: folds 
Uncalled bet ($0.15) returned to Jesus Ololo
Jesus Ololo collected $0.25 from pot
*** SUMMARY ***
Total pot $0.25 | Rake $0 
Seat 1: Jesus Ololo (button) collected ($0.25)
Seat 2: barbos2 (small blind) folded before Flop
Seat 3: mattl1990 (big blind) folded before Flop
Seat 4: ramseskat folded before Flop (didn't bet)
Seat 5: Eduard Gl folded before Flop (didn't bet)
Seat 6: DrLevty folded before Flop (didn't bet)



PokerStars Hand #222965235299:  Hold'em No Limit ($0.05/$0.10 USD) - 2021/01/23 14:03:30 ET
Table 'Stephano III' 6-max Seat #2 is the button
Seat 1: Jesus Ololo ($10.15 in chips) 
Seat 2: barbos2 ($11.85 in chips) 
Seat 3: mattl1990 ($13 in chips) 
Seat 4: ramseskat ($16.04 in chips) 
Seat 5: Eduard Gl ($13.99 in chips) 
Seat 6: DrLevty ($10 in chips) 
mattl1990: posts small blind $0.05
ramseskat: posts big blind $0.10
*** HOLE CARDS ***
Eduard Gl: folds 
DrLevty: folds 
Jesus Ololo: folds 
barbos2: folds 
mattl1990: folds 
Uncalled bet ($0.05) returned to ramseskat
ramseskat collected $0.10 from pot
ramseskat: doesn't show hand 
*** SUMMARY ***
Total pot $0.10 | Rake $0 
Seat 1: Jesus Ololo folded before Flop (didn't bet)
Seat 2: barbos2 (button) folded before Flop (didn't bet)
Seat 3: mattl1990 (small blind) folded before Flop
Seat 4: ramseskat (big blind) collected ($0.10)
Seat 5: Eduard Gl folded before Flop (didn't bet)
Seat 6: DrLevty folded before Flop (didn't bet)



PokerStars Hand #222965247465:  Hold'em No Limit ($0.05/$0.10 USD) - 2021/01/23 14:03:45 ET
Table 'Stephano III' 6-max Seat #3 is the button
Seat 1: Jesus Ololo ($10.15 in chips) 
Seat 2: barbos2 ($11.85 in chips) 
Seat 3: mattl1990 ($12.95 in chips) 
Seat 4: ramseskat ($16.09 in chips) 
Seat 5: Eduard Gl ($13.99 in chips) 
Seat 6: DrLevty ($10 in chips) 
ramseskat: posts small blind $0.05
Eduard Gl: posts big blind $0.10
*** HOLE CARDS ***
DrLevty: folds 
Jesus Ololo: folds 
barbos2: folds 
mattl1990: calls $0.10
ramseskat: calls $0.05
Eduard Gl: checks 
*** FLOP *** [2s Jh 8c]
ramseskat: checks 
Eduard Gl: checks 
mattl1990: checks 
*** TURN *** [2s Jh 8c] [9h]
ramseskat: checks 
Eduard Gl: bets $0.20
mattl1990: folds 
ramseskat: calls $0.20
*** RIVER *** [2s Jh 8c 9h] [As]
ramseskat: checks 
Eduard Gl: checks 
*** SHOW DOWN ***
ramseskat: shows [8s 7s] (a pair of Eights)
Eduard Gl: shows [9s Ks] (a pair of Nines)
Eduard Gl collected $0.67 from pot
*** SUMMARY ***
Total pot $0.70 | Rake $0.03 
Board [2s Jh 8c 9h As]
Seat 1: Jesus Ololo folded before Flop (didn't bet)
Seat 2: barbos2 folded before Flop (didn't bet)
Seat 3: mattl1990 (button) folded on the Turn
Seat 4: ramseskat (small blind) showed [8s 7s] and lost with a pair of Eights
Seat 5: Eduard Gl (big blind) showed [9s Ks] and won ($0.67) with a pair of Nines
Seat 6: DrLevty folded before Flop (didn't bet)



PokerStars Hand #222965277424:  Hold'em No Limit ($0.05/$0.10 USD) - 2021/01/23 14:04:24 ET
Table 'Stephano III' 6-max Seat #4 is the button
Seat 1: Jesus Ololo ($10.15 in chips) 
Seat 2: barbos2 ($11.85 in chips) 
Seat 3: mattl1990 ($12.85 in chips) 
Seat 4: ramseskat ($15.79 in chips) 
Seat 5: Eduard Gl ($14.36 in chips) 
Seat 6: DrLevty ($10 in chips) 
Eduard Gl: posts small blind $0.05
DrLevty: posts big blind $0.10
*** HOLE CARDS ***
Jesus Ololo: folds 
barbos2 has timed out
barbos2: folds 
mattl1990: folds 
ramseskat: folds 
Eduard Gl: folds 
Uncalled bet ($0.05) returned to DrLevty
DrLevty collected $0.10 from pot
DrLevty: doesn't show hand 
*** SUMMARY ***
Total pot $0.10 | Rake $0 
Seat 1: Jesus Ololo folded before Flop (didn't bet)
Seat 2: barbos2 folded before Flop (didn't bet)
Seat 3: mattl1990 folded before Flop (didn't bet)
Seat 4: ramseskat (button) folded before Flop (didn't bet)
Seat 5: Eduard Gl (small blind) folded before Flop
Seat 6: DrLevty (big blind) collected ($0.10)



PokerStars Hand #222965289544:  Hold'em No Limit ($0.05/$0.10 USD) - 2021/01/23 14:04:39 ET
Table 'Stephano III' 6-max Seat #5 is the button
Seat 1: Jesus Ololo ($10.15 in chips) 
Seat 3: mattl1990 ($12.85 in chips) 
Seat 4: ramseskat ($15.79 in chips) 
Seat 5: Eduard Gl ($14.31 in chips) 
Seat 6: DrLevty ($10.05 in chips) 
DrLevty: posts small blind $0.05
Jesus Ololo: posts big blind $0.10
*** HOLE CARDS ***
mattl1990: calls $0.10
ramseskat: folds 
Eduard Gl: folds 
DrLevty: raises $0.40 to $0.50
Jesus Ololo: folds 
mattl1990: calls $0.40
*** FLOP *** [3d 5h 3h]
DrLevty: bets $0.35
mattl1990: calls $0.35
*** TURN *** [3d 5h 3h] [6s]
DrLevty: bets $0.57
mattl1990: calls $0.57
*** RIVER *** [3d 5h 3h 6s] [Tc]
DrLevty: checks 
mattl1990: checks 
*** SHOW DOWN ***
DrLevty: shows [8h Ah] (a pair of Threes)
mattl1990: shows [9h 6h] (two pair, Sixes and Threes)
mattl1990 collected $2.81 from pot
*** SUMMARY ***
Total pot $2.94 | Rake $0.13 
Board [3d 5h 3h 6s Tc]
Seat 1: Jesus Ololo (big blind) folded before Flop
Seat 3: mattl1990 showed [9h 6h] and won ($2.81) with two pair, Sixes and Threes
Seat 4: ramseskat folded before Flop (didn't bet)
Seat 5: Eduard Gl (button) folded before Flop (didn't bet)
Seat 6: DrLevty (small blind) showed [8h Ah] and lost with a pair of Threes



PokerStars Hand #222965322973:  Hold'em No Limit ($0.05/$0.10 USD) - 2021/01/23 14:05:21 ET
Table 'Stephano III' 6-max Seat #6 is the button
Seat 1: Jesus Ololo ($10.05 in chips) 
Seat 2: barbos2 ($11.85 in chips) 
Seat 3: mattl1990 ($14.24 in chips) 
Seat 4: ramseskat ($15.79 in chips) 
Seat 5: Eduard Gl ($14.31 in chips) 
Seat 6: DrLevty ($10 in chips) 
Jesus Ololo: posts small blind $0.05
barbos2: posts big blind $0.10
*** HOLE CARDS ***
mattl1990: calls $0.10
ramseskat: calls $0.10
Eduard Gl: folds 
DrLevty: folds 
Jesus Ololo: calls $0.05
barbos2: checks 
*** FLOP *** [3s 3c 9c]
Jesus Ololo: checks 
barbos2: checks 
mattl1990: checks 
ramseskat: checks 
*** TURN *** [3s 3c 9c] [Ah]
Jesus Ololo: bets $0.21
barbos2: folds 
mattl1990: folds 
ramseskat: folds 
Uncalled bet ($0.21) returned to Jesus Ololo
Jesus Ololo collected $0.38 from pot
*** SUMMARY ***
Total pot $0.40 | Rake $0.02 
Board [3s 3c 9c Ah]
Seat 1: Jesus Ololo (small blind) collected ($0.38)
Seat 2: barbos2 (big blind) folded on the Turn
Seat 3: mattl1990 folded on the Turn
Seat 4: ramseskat folded on the Turn
Seat 5: Eduard Gl folded before Flop (didn't bet)
Seat 6: DrLevty (button) folded before Flop (didn't bet)



PokerStars Hand #222965345214:  Hold'em No Limit ($0.05/$0.10 USD) - 2021/01/23 14:05:49 ET
Table 'Stephano III' 6-max Seat #1 is the button
Seat 1: Jesus Ololo ($10.33 in chips) 
Seat 2: barbos2 ($11.75 in chips) 
Seat 3: mattl1990 ($14.14 in chips) 
Seat 4: ramseskat ($15.69 in chips) 
Seat 5: Eduard Gl ($14.31 in chips) 
Seat 6: DrLevty ($10 in chips) 
barbos2: posts small blind $0.05
mattl1990: posts big blind $0.10
*** HOLE CARDS ***
ramseskat: folds 
Eduard Gl: raises $0.15 to $0.25
DrLevty: folds 
Jesus Ololo: calls $0.25
barbos2: folds 
mattl1990: calls $0.15
*** FLOP *** [Kh Ad Qd]
mattl1990: checks 
Eduard Gl: checks 
Jesus Ololo: bets $0.57
mattl1990: folds 
Eduard Gl: folds 
Uncalled bet ($0.57) returned to Jesus Ololo
Jesus Ololo collected $0.76 from pot
*** SUMMARY ***
Total pot $0.80 | Rake $0.04 
Board [Kh Ad Qd]
Seat 1: Jesus Ololo (button) collected ($0.76)
Seat 2: barbos2 (small blind) folded before Flop
Seat 3: mattl1990 (big blind) folded on the Flop
Seat 4: ramseskat folded before Flop (didn't bet)
Seat 5: Eduard Gl folded on the Flop
Seat 6: DrLevty folded before Flop (didn't bet)



PokerStars Hand #222965371084:  Hold'em No Limit ($0.05/$0.10 USD) - 2021/01/23 14:06:22 ET
Table 'Stephano III' 6-max Seat #2 is the button
Seat 1: Jesus Ololo ($10.84 in chips) 
Seat 2: barbos2 ($11.70 in chips) 
Seat 3: mattl1990 ($13.89 in chips) 
Seat 4: ramseskat ($15.69 in chips) 
Seat 5: Eduard Gl ($14.06 in chips) 
Seat 6: DrLevty ($10 in chips) 
mattl1990: posts small blind $0.05
ramseskat: posts big blind $0.10
*** HOLE CARDS ***
Eduard Gl: folds 
DrLevty: folds 
Jesus Ololo: folds 
barbos2: folds 
mattl1990: calls $0.05
ramseskat: checks 
*** FLOP *** [7c Tc 3s]
mattl1990: checks 
ramseskat: checks 
*** TURN *** [7c Tc 3s] [5d]
mattl1990: checks 
ramseskat: bets $0.13
mattl1990: calls $0.13
*** RIVER *** [7c Tc 3s 5d] [2c]
mattl1990: checks 
ramseskat: checks 
*** SHOW DOWN ***
mattl1990: shows [Qc 3h] (a pair of Threes)
ramseskat: shows [4c Td] (a pair of Tens)
ramseskat collected $0.44 from pot
*** SUMMARY ***
Total pot $0.46 | Rake $0.02 
Board [7c Tc 3s 5d 2c]
Seat 1: Jesus Ololo folded before Flop (didn't bet)
Seat 2: barbos2 (button) folded before Flop (didn't bet)
Seat 3: mattl1990 (small blind) showed [Qc 3h] and lost with a pair of Threes
Seat 4: ramseskat (big blind) showed [4c Td] and won ($0.44) with a pair of Tens
Seat 5: Eduard Gl folded before Flop (didn't bet)
Seat 6: DrLevty folded before Flop (didn't bet)



PokerStars Hand #222965397557:  Hold'em No Limit ($0.05/$0.10 USD) - 2021/01/23 14:06:55 ET
Table 'Stephano III' 6-max Seat #3 is the button
Seat 1: Jesus Ololo ($10.84 in chips) 
Seat 2: barbos2 ($11.70 in chips) 
Seat 3: mattl1990 ($13.66 in chips) 
Seat 4: ramseskat ($15.90 in chips) 
Seat 5: Eduard Gl ($14.06 in chips) 
Seat 6: DrLevty ($10 in chips) 
ramseskat: posts small blind $0.05
Eduard Gl: posts big blind $0.10
*** HOLE CARDS ***
DrLevty: folds 
Jesus Ololo: raises $0.20 to $0.30
barbos2: folds 
mattl1990: folds 
ramseskat: folds 
Eduard Gl: folds 
Uncalled bet ($0.20) returned to Jesus Ololo
Jesus Ololo collected $0.25 from pot
*** SUMMARY ***
Total pot $0.25 | Rake $0 
Seat 1: Jesus Ololo collected ($0.25)
Seat 2: barbos2 folded before Flop (didn't bet)
Seat 3: mattl1990 (button) folded before Flop (didn't bet)
Seat 4: ramseskat (small blind) folded before Flop
Seat 5: Eduard Gl (big blind) folded before Flop
Seat 6: DrLevty folded before Flop (didn't bet)



PokerStars Hand #222965407704:  Hold'em No Limit ($0.05/$0.10 USD) - 2021/01/23 14:07:08 ET
Table 'Stephano III' 6-max Seat #4 is the button
Seat 1: Jesus Ololo ($10.99 in chips) 
Seat 2: barbos2 ($11.70 in chips) 
Seat 3: mattl1990 ($13.66 in chips) 
Seat 4: ramseskat ($15.85 in chips) 
Seat 5: Eduard Gl ($13.96 in chips) 
Seat 6: DrLevty ($10 in chips) 
Eduard Gl: posts small blind $0.05
DrLevty: posts big blind $0.10
*** HOLE CARDS ***
Jesus Ololo: folds 
barbos2: folds 
mattl1990: calls $0.10
ramseskat: folds 
Eduard Gl: raises $0.50 to $0.60
DrLevty: folds 
mattl1990: calls $0.50
*** FLOP *** [3d 5c Ks]
Eduard Gl: bets $0.90
mattl1990: folds 
Uncalled bet ($0.90) returned to Eduard Gl
Eduard Gl collected $1.24 from pot
Eduard Gl: doesn't show hand 
*** SUMMARY ***
Total pot $1.30 | Rake $0.06 
Board [3d 5c Ks]
Seat 1: Jesus Ololo folded before Flop (didn't bet)
Seat 2: barbos2 folded before Flop (didn't bet)
Seat 3: mattl1990 folded on the Flop
Seat 4: ramseskat (button) folded before Flop (didn't bet)
Seat 5: Eduard Gl (small blind) collected ($1.24)
Seat 6: DrLevty (big blind) folded before Flop



PokerStars Hand #222965424400:  Hold'em No Limit ($0.05/$0.10 USD) - 2021/01/23 14:07:29 ET
Table 'Stephano III' 6-max Seat #5 is the button
Seat 1: Jesus Ololo ($10.99 in chips) 
Seat 2: barbos2 ($11.70 in chips) 
Seat 3: mattl1990 ($13.06 in chips) 
Seat 4: ramseskat ($15.85 in chips) 
Seat 5: Eduard Gl ($14.60 in chips) 
Seat 6: DrLevty ($10 in chips) 
DrLevty: posts small blind $0.05
Jesus Ololo: posts big blind $0.10
*** HOLE CARDS ***
barbos2: folds 
mattl1990: folds 
ramseskat: folds 
Eduard Gl: raises $0.10 to $0.20
DrLevty: folds 
Jesus Ololo: folds 
Uncalled bet ($0.10) returned to Eduard Gl
Eduard Gl collected $0.25 from pot
Eduard Gl: doesn't show hand 
*** SUMMARY ***
Total pot $0.25 | Rake $0 
Seat 1: Jesus Ololo (big blind) folded before Flop
Seat 2: barbos2 folded before Flop (didn't bet)
Seat 3: mattl1990 folded before Flop (didn't bet)
Seat 4: ramseskat folded before Flop (didn't bet)
Seat 5: Eduard Gl (button) collected ($0.25)
Seat 6: DrLevty (small blind) folded before Flop



PokerStars Hand #222965435602:  Hold'em No Limit ($0.05/$0.10 USD) - 2021/01/23 14:07:43 ET
Table 'Stephano III' 6-max Seat #6 is the button
Seat 1: Jesus Ololo ($10.89 in chips) 
Seat 2: barbos2 ($11.70 in chips) 
Seat 3: mattl1990 ($13.06 in chips) 
Seat 4: ramseskat ($15.85 in chips) 
Seat 5: Eduard Gl ($14.75 in chips) 
Seat 6: DrLevty ($10 in chips) 
Jesus Ololo: posts small blind $0.05
barbos2: posts big blind $0.10
*** HOLE CARDS ***
mattl1990: folds 
ramseskat: folds 
Eduard Gl: raises $0.15 to $0.25
DrLevty: folds 
Jesus Ololo: folds 
barbos2: folds 
Uncalled bet ($0.15) returned to Eduard Gl
Eduard Gl collected $0.25 from pot
Eduard Gl: doesn't show hand 
*** SUMMARY ***
Total pot $0.25 | Rake $0 
Seat 1: Jesus Ololo (small blind) folded before Flop
Seat 2: barbos2 (big blind) folded before Flop
Seat 3: mattl1990 folded before Flop (didn't bet)
Seat 4: ramseskat folded before Flop (didn't bet)
Seat 5: Eduard Gl collected ($0.25)
Seat 6: DrLevty (button) folded before Flop (didn't bet)



PokerStars Hand #222965446994:  Hold'em No Limit ($0.05/$0.10 USD) - 2021/01/23 14:07:58 ET
Table 'Stephano III' 6-max Seat #1 is the button
Seat 1: Jesus Ololo ($10.84 in chips) 
Seat 2: barbos2 ($11.60 in chips) 
Seat 3: mattl1990 ($13.06 in chips) 
Seat 4: ramseskat ($15.85 in chips) 
Seat 5: Eduard Gl ($14.90 in chips) 
Seat 6: DrLevty ($10 in chips) 
barbos2: posts small blind $0.05
mattl1990: posts big blind $0.10
*** HOLE CARDS ***
ramseskat: folds 
Eduard Gl: folds 
DrLevty: folds 
Jesus Ololo: raises $0.15 to $0.25
barbos2: folds 
mattl1990: calls $0.15
*** FLOP *** [6d Th Ac]
mattl1990: checks 
Jesus Ololo: bets $0.29
mattl1990: folds 
Uncalled bet ($0.29) returned to Jesus Ololo
Jesus Ololo collected $0.53 from pot
*** SUMMARY ***
Total pot $0.55 | Rake $0.02 
Board [6d Th Ac]
Seat 1: Jesus Ololo (button) collected ($0.53)
Seat 2: barbos2 (small blind) folded before Flop
Seat 3: mattl1990 (big blind) folded on the Flop
Seat 4: ramseskat folded before Flop (didn't bet)
Seat 5: Eduard Gl folded before Flop (didn't bet)
Seat 6: DrLevty folded before Flop (didn't bet)



PokerStars Hand #222965468500:  Hold'em No Limit ($0.05/$0.10 USD) - 2021/01/23 14:08:25 ET
Table 'Stephano III' 6-max Seat #2 is the button
Seat 1: Jesus Ololo ($11.12 in chips) 
Seat 2: barbos2 ($11.55 in chips) 
Seat 3: mattl1990 ($12.81 in chips) 
Seat 4: ramseskat ($15.85 in chips) 
Seat 5: Eduard Gl ($14.90 in chips) 
Seat 6: DrLevty ($10 in chips) 
mattl1990: posts small blind $0.05
ramseskat: posts big blind $0.10
*** HOLE CARDS ***
Eduard Gl: folds 
DrLevty: folds 
Jesus Ololo: folds 
barbos2: folds 
mattl1990: calls $0.05
ramseskat: checks 
*** FLOP *** [Qh 4h Ks]
mattl1990: checks 
ramseskat: checks 
*** TURN *** [Qh 4h Ks] [8h]
mattl1990: checks 
ramseskat: checks 
*** RIVER *** [Qh 4h Ks 8h] [Qd]
mattl1990: checks 
ramseskat: bets $0.10
mattl1990: folds 
Uncalled bet ($0.10) returned to ramseskat
ramseskat collected $0.19 from pot
ramseskat: doesn't show hand 
*** SUMMARY ***
Total pot $0.20 | Rake $0.01 
Board [Qh 4h Ks 8h Qd]
Seat 1: Jesus Ololo folded before Flop (didn't bet)
Seat 2: barbos2 (button) folded before Flop (didn't bet)
Seat 3: mattl1990 (small blind) folded on the River
Seat 4: ramseskat (big blind) collected ($0.19)
Seat 5: Eduard Gl folded before Flop (didn't bet)
Seat 6: DrLevty folded before Flop (didn't bet)



PokerStars Hand #222965498525:  Hold'em No Limit ($0.05/$0.10 USD) - 2021/01/23 14:09:02 ET
Table 'Stephano III' 6-max Seat #3 is the button
Seat 1: Jesus Ololo ($11.12 in chips) 
Seat 2: barbos2 ($11.55 in chips) 
Seat 3: mattl1990 ($12.71 in chips) 
Seat 4: ramseskat ($15.94 in chips) 
Seat 5: Eduard Gl ($14.90 in chips) 
Seat 6: DrLevty ($10 in chips) 
ramseskat: posts small blind $0.05
Eduard Gl: posts big blind $0.10
*** HOLE CARDS ***
DrLevty: folds 
Jesus Ololo: folds 
barbos2: raises $0.15 to $0.25
mattl1990: folds 
ramseskat: folds 
Eduard Gl: folds 
Uncalled bet ($0.15) returned to barbos2
barbos2 collected $0.25 from pot
barbos2: doesn't show hand 
*** SUMMARY ***
Total pot $0.25 | Rake $0 
Seat 1: Jesus Ololo folded before Flop (didn't bet)
Seat 2: barbos2 collected ($0.25)
Seat 3: mattl1990 (button) folded before Flop (didn't bet)
Seat 4: ramseskat (small blind) folded before Flop
Seat 5: Eduard Gl (big blind) folded before Flop
Seat 6: DrLevty folded before Flop (didn't bet)



PokerStars Hand #222965505236:  Hold'em No Limit ($0.05/$0.10 USD) - 2021/01/23 14:09:11 ET
Table 'Stephano III' 6-max Seat #4 is the button
Seat 1: Jesus Ololo ($11.12 in chips) 
Seat 2: barbos2 ($11.70 in chips) 
Seat 3: mattl1990 ($12.71 in chips) 
Seat 4: ramseskat ($15.89 in chips) 
Seat 5: Eduard Gl ($14.80 in chips) 
Seat 6: DrLevty ($10 in chips) 
Eduard Gl: posts small blind $0.05
DrLevty: posts big blind $0.10
*** HOLE CARDS ***
Jesus Ololo: folds 
barbos2: folds 
mattl1990: folds 
ramseskat: folds 
Eduard Gl: folds 
Uncalled bet ($0.05) returned to DrLevty
DrLevty collected $0.10 from pot
DrLevty: doesn't show hand 
*** SUMMARY ***
Total pot $0.10 | Rake $0 
Seat 1: Jesus Ololo folded before Flop (didn't bet)
Seat 2: barbos2 folded before Flop (didn't bet)
Seat 3: mattl1990 folded before Flop (didn't bet)
Seat 4: ramseskat (button) folded before Flop (didn't bet)
Seat 5: Eduard Gl (small blind) folded before Flop
Seat 6: DrLevty (big blind) collected ($0.10)



PokerStars Hand #222965515281:  Hold'em No Limit ($0.05/$0.10 USD) - 2021/01/23 14:09:23 ET
Table 'Stephano III' 6-max Seat #5 is the button
Seat 1: Jesus Ololo ($11.12 in chips) 
Seat 2: barbos2 ($11.70 in chips) 
Seat 3: mattl1990 ($12.71 in chips) 
Seat 4: ramseskat ($15.89 in chips) 
Seat 5: Eduard Gl ($14.75 in chips) 
Seat 6: DrLevty ($10.05 in chips) 
DrLevty: posts small blind $0.05
Jesus Ololo: posts big blind $0.10
*** HOLE CARDS ***
barbos2: folds 
mattl1990: calls $0.10
ramseskat: folds 
Eduard Gl: folds 
DrLevty: folds 
Jesus Ololo: checks 
*** FLOP *** [2h Qc 4s]
Jesus Ololo: checks 
mattl1990: checks 
*** TURN *** [2h Qc 4s] [Kh]
Jesus Ololo: checks 
mattl1990: checks 
*** RIVER *** [2h Qc 4s Kh] [Qd]
Jesus Ololo: checks 
mattl1990: bets $0.50
Jesus Ololo: folds 
Uncalled bet ($0.50) returned to mattl1990
mattl1990 collected $0.24 from pot
mattl1990: doesn't show hand 
*** SUMMARY ***
Total pot $0.25 | Rake $0.01 
Board [2h Qc 4s Kh Qd]
Seat 1: Jesus Ololo (big blind) folded on the River
Seat 2: barbos2 folded before Flop (didn't bet)
Seat 3: mattl1990 collected ($0.24)
Seat 4: ramseskat folded before Flop (didn't bet)
Seat 5: Eduard Gl (button) folded before Flop (didn't bet)
Seat 6: DrLevty (small blind) folded before Flop



PokerStars Hand #222965543275:  Hold'em No Limit ($0.05/$0.10 USD) - 2021/01/23 14:09:59 ET
Table 'Stephano III' 6-max Seat #6 is the button
Seat 1: Jesus Ololo ($11.02 in chips) 
Seat 2: barbos2 ($11.70 in chips) 
Seat 3: mattl1990 ($12.85 in chips) 
Seat 4: ramseskat ($15.89 in chips) 
Seat 5: Eduard Gl ($14.75 in chips) 
Seat 6: DrLevty ($10 in chips) 
Jesus Ololo: posts small blind $0.05
barbos2: posts big blind $0.10
*** HOLE CARDS ***
mattl1990: raises $0.10 to $0.20
ramseskat: folds 
Eduard Gl: folds 
DrLevty: folds 
Jesus Ololo: folds 
barbos2: calls $0.10
*** FLOP *** [Td Ad 7c]
barbos2: checks 
mattl1990: checks 
*** TURN *** [Td Ad 7c] [Qc]
barbos2: checks 
mattl1990: bets $0.40
barbos2: calls $0.40
*** RIVER *** [Td Ad 7c Qc] [Jc]
barbos2: checks 
mattl1990: bets $1.19
barbos2: folds 
Uncalled bet ($1.19) returned to mattl1990
mattl1990 collected $1.19 from pot
mattl1990: doesn't show hand 
*** SUMMARY ***
Total pot $1.25 | Rake $0.06 
Board [Td Ad 7c Qc Jc]
Seat 1: Jesus Ololo (small blind) folded before Flop
Seat 2: barbos2 (big blind) folded on the River
Seat 3: mattl1990 collected ($1.19)
Seat 4: ramseskat folded before Flop (didn't bet)
Seat 5: Eduard Gl folded before Flop (didn't bet)
Seat 6: DrLevty (button) folded before Flop (didn't bet)



PokerStars Hand #222965577836:  Hold'em No Limit ($0.05/$0.10 USD) - 2021/01/23 14:10:43 ET
Table 'Stephano III' 6-max Seat #1 is the button
Seat 1: Jesus Ololo ($10.97 in chips) 
Seat 2: barbos2 ($11.10 in chips) 
Seat 3: mattl1990 ($13.44 in chips) 
Seat 4: ramseskat ($15.89 in chips) 
Seat 5: Eduard Gl ($14.75 in chips) 
Seat 6: DrLevty ($10 in chips) 
barbos2: posts small blind $0.05
mattl1990: posts big blind $0.10
*** HOLE CARDS ***
ramseskat: folds 
Eduard Gl: folds 
DrLevty: folds 
Jesus Ololo: folds 
barbos2: calls $0.05
mattl1990: checks 
*** FLOP *** [Th 7h 9c]
barbos2: checks 
mattl1990: checks 
*** TURN *** [Th 7h 9c] [3c]
barbos2: bets $0.20
mattl1990: folds 
Uncalled bet ($0.20) returned to barbos2
barbos2 collected $0.19 from pot
barbos2: doesn't show hand 
*** SUMMARY ***
Total pot $0.20 | Rake $0.01 
Board [Th 7h 9c 3c]
Seat 1: Jesus Ololo (button) folded before Flop (didn't bet)
Seat 2: barbos2 (small blind) collected ($0.19)
Seat 3: mattl1990 (big blind) folded on the Turn
Seat 4: ramseskat folded before Flop (didn't bet)
Seat 5: Eduard Gl folded before Flop (didn't bet)
Seat 6: DrLevty folded before Flop (didn't bet)



PokerStars Hand #222965611665:  Hold'em No Limit ($0.05/$0.10 USD) - 2021/01/23 14:11:26 ET
Table 'Stephano III' 6-max Seat #2 is the button
Seat 1: Jesus Ololo ($10.97 in chips) 
Seat 2: barbos2 ($11.19 in chips) 
Seat 3: mattl1990 ($13.34 in chips) 
Seat 4: ramseskat ($15.89 in chips) 
Seat 5: Eduard Gl ($14.75 in chips) 
Seat 6: DrLevty ($10 in chips) 
mattl1990: posts small blind $0.05
ramseskat: posts big blind $0.10
*** HOLE CARDS ***
Eduard Gl: folds 
DrLevty: raises $0.20 to $0.30
Jesus Ololo: folds 
barbos2: folds 
mattl1990: calls $0.25
ramseskat: folds 
*** FLOP *** [5c 8s 2d]
mattl1990: checks 
DrLevty: bets $0.45
mattl1990: folds 
Uncalled bet ($0.45) returned to DrLevty
DrLevty collected $0.67 from pot
DrLevty: doesn't show hand 
*** SUMMARY ***
Total pot $0.70 | Rake $0.03 
Board [5c 8s 2d]
Seat 1: Jesus Ololo folded before Flop (didn't bet)
Seat 2: barbos2 (button) folded before Flop (didn't bet)
Seat 3: mattl1990 (small blind) folded on the Flop
Seat 4: ramseskat (big blind) folded before Flop
Seat 5: Eduard Gl folded before Flop (didn't bet)
Seat 6: DrLevty collected ($0.67)



PokerStars Hand #222965640405:  Hold'em No Limit ($0.05/$0.10 USD) - 2021/01/23 14:12:02 ET
Table 'Stephano III' 6-max Seat #3 is the button
Seat 1: Jesus Ololo ($10.97 in chips) 
Seat 2: barbos2 ($11.19 in chips) 
Seat 3: mattl1990 ($13.04 in chips) 
Seat 4: ramseskat ($15.79 in chips) 
Seat 5: Eduard Gl ($14.75 in chips) 
Seat 6: DrLevty ($10.37 in chips) 
ramseskat: posts small blind $0.05
Eduard Gl: posts big blind $0.10
*** HOLE CARDS ***
DrLevty: folds 
Jesus Ololo: raises $0.15 to $0.25
barbos2: folds 
mattl1990: calls $0.25
ramseskat: folds 
Eduard Gl: folds 
*** FLOP *** [2s Td 9c]
Jesus Ololo: bets $0.30
mattl1990: folds 
Uncalled bet ($0.30) returned to Jesus Ololo
Jesus Ololo collected $0.62 from pot
*** SUMMARY ***
Total pot $0.65 | Rake $0.03 
Board [2s Td 9c]
Seat 1: Jesus Ololo collected ($0.62)
Seat 2: barbos2 folded before Flop (didn't bet)
Seat 3: mattl1990 (button) folded on the Flop
Seat 4: ramseskat (small blind) folded before Flop
Seat 5: Eduard Gl (big blind) folded before Flop
Seat 6: DrLevty folded before Flop (didn't bet)



PokerStars Hand #222965664779:  Hold'em No Limit ($0.05/$0.10 USD) - 2021/01/23 14:12:33 ET
Table 'Stephano III' 6-max Seat #4 is the button
Seat 1: Jesus Ololo ($11.34 in chips) 
Seat 2: barbos2 ($11.19 in chips) 
Seat 3: mattl1990 ($12.79 in chips) 
Seat 4: ramseskat ($15.74 in chips) 
Seat 5: Eduard Gl ($14.65 in chips) 
Seat 6: DrLevty ($10.37 in chips) 
Eduard Gl: posts small blind $0.05
DrLevty: posts big blind $0.10
*** HOLE CARDS ***
Jesus Ololo: folds 
barbos2: folds 
mattl1990: calls $0.10
ramseskat: raises $0.35 to $0.45
Eduard Gl: raises $0.80 to $1.25
DrLevty: folds 
mattl1990: folds 
ramseskat: raises $2.80 to $4.05
Eduard Gl: folds 
Uncalled bet ($2.80) returned to ramseskat
ramseskat collected $2.70 from pot
ramseskat: doesn't show hand 
*** SUMMARY ***
Total pot $2.70 | Rake $0 
Seat 1: Jesus Ololo folded before Flop (didn't bet)
Seat 2: barbos2 folded before Flop (didn't bet)
Seat 3: mattl1990 folded before Flop
Seat 4: ramseskat (button) collected ($2.70)
Seat 5: Eduard Gl (small blind) folded before Flop
Seat 6: DrLevty (big blind) folded before Flop



PokerStars Hand #222965689154:  Hold'em No Limit ($0.05/$0.10 USD) - 2021/01/23 14:13:03 ET
Table 'Stephano III' 6-max Seat #5 is the button
Seat 1: Jesus Ololo ($11.34 in chips) 
Seat 2: barbos2 ($11.19 in chips) 
Seat 3: mattl1990 ($12.69 in chips) 
Seat 4: ramseskat ($17.19 in chips) 
Seat 5: Eduard Gl ($13.40 in chips) 
Seat 6: DrLevty ($10.27 in chips) 
DrLevty: posts small blind $0.05
Jesus Ololo: posts big blind $0.10
*** HOLE CARDS ***
barbos2: folds 
mattl1990: calls $0.10
ramseskat: folds 
Eduard Gl: folds 
DrLevty: folds 
Jesus Ololo: checks 
*** FLOP *** [Qs Jc 7s]
Jesus Ololo: checks 
mattl1990: checks 
*** TURN *** [Qs Jc 7s] [4d]
Jesus Ololo: bets $0.10
mattl1990: folds 
Uncalled bet ($0.10) returned to Jesus Ololo
Jesus Ololo collected $0.24 from pot
*** SUMMARY ***
Total pot $0.25 | Rake $0.01 
Board [Qs Jc 7s 4d]
Seat 1: Jesus Ololo (big blind) collected ($0.24)
Seat 2: barbos2 folded before Flop (didn't bet)
Seat 3: mattl1990 folded on the Turn
Seat 4: ramseskat folded before Flop (didn't bet)
Seat 5: Eduard Gl (button) folded before Flop (didn't bet)
Seat 6: DrLevty (small blind) folded before Flop



PokerStars Hand #222965715813:  Hold'em No Limit ($0.05/$0.10 USD) - 2021/01/23 14:13:37 ET
Table 'Stephano III' 6-max Seat #6 is the button
Seat 1: Jesus Ololo ($11.48 in chips) 
Seat 2: barbos2 ($11.19 in chips) 
Seat 3: mattl1990 ($12.59 in chips) 
Seat 4: ramseskat ($17.19 in chips) 
Seat 5: Eduard Gl ($13.40 in chips) 
Seat 6: DrLevty ($10.22 in chips) 
Jesus Ololo: posts small blind $0.05
barbos2: posts big blind $0.10
*** HOLE CARDS ***
mattl1990: calls $0.10
ramseskat: folds 
Eduard Gl: folds 
DrLevty: folds 
Jesus Ololo: folds 
barbos2: checks 
*** FLOP *** [Kh 7d 5s]
barbos2: checks 
mattl1990: checks 
*** TURN *** [Kh 7d 5s] [Kc]
barbos2: bets $0.18
mattl1990: folds 
Uncalled bet ($0.18) returned to barbos2
barbos2 collected $0.24 from pot
barbos2: doesn't show hand 
*** SUMMARY ***
Total pot $0.25 | Rake $0.01 
Board [Kh 7d 5s Kc]
Seat 1: Jesus Ololo (small blind) folded before Flop
Seat 2: barbos2 (big blind) collected ($0.24)
Seat 3: mattl1990 folded on the Turn
Seat 4: ramseskat folded before Flop (didn't bet)
Seat 5: Eduard Gl folded before Flop (didn't bet)
Seat 6: DrLevty (button) folded before Flop (didn't bet)



PokerStars Hand #222965744906:  Hold'em No Limit ($0.05/$0.10 USD) - 2021/01/23 14:14:14 ET
Table 'Stephano III' 6-max Seat #1 is the button
Seat 1: Jesus Ololo ($11.43 in chips) 
Seat 2: barbos2 ($11.33 in chips) 
Seat 3: mattl1990 ($12.49 in chips) 
Seat 4: ramseskat ($17.19 in chips) 
Seat 5: Eduard Gl ($13.40 in chips) 
Seat 6: DrLevty ($10.22 in chips) 
barbos2: posts small blind $0.05
mattl1990: posts big blind $0.10
*** HOLE CARDS ***
ramseskat: folds 
Eduard Gl: folds 
DrLevty: folds 
Jesus Ololo: raises $0.15 to $0.25
barbos2: calls $0.20
mattl1990: calls $0.15
*** FLOP *** [Qh Jc 6h]
barbos2: checks 
mattl1990: checks 
Jesus Ololo: bets $0.25
barbos2: folds 
mattl1990: calls $0.25
*** TURN *** [Qh Jc 6h] [7h]
mattl1990: checks 
Jesus Ololo: checks 
*** RIVER *** [Qh Jc 6h 7h] [Ks]
mattl1990: checks 
Jesus Ololo: bets $0.95
mattl1990: calls $0.95
*** SHOW DOWN ***
Jesus Ololo: shows [Kc Ac] (a pair of Kings)
mattl1990: mucks hand 
Jesus Ololo collected $3.01 from pot
*** SUMMARY ***
Total pot $3.15 | Rake $0.14 
Board [Qh Jc 6h 7h Ks]
Seat 1: Jesus Ololo (button) showed [Kc Ac] and won ($3.01) with a pair of Kings
Seat 2: barbos2 (small blind) folded on the Flop
Seat 3: mattl1990 (big blind) mucked
Seat 4: ramseskat folded before Flop (didn't bet)
Seat 5: Eduard Gl folded before Flop (didn't bet)
Seat 6: DrLevty folded before Flop (didn't bet)



PokerStars Hand #222965773101:  Hold'em No Limit ($0.05/$0.10 USD) - 2021/01/23 14:14:50 ET
Table 'Stephano III' 6-max Seat #2 is the button
Seat 1: Jesus Ololo ($12.99 in chips) 
Seat 2: barbos2 ($11.08 in chips) 
Seat 3: mattl1990 ($11.04 in chips) 
Seat 5: Eduard Gl ($13.40 in chips) 
Seat 6: DrLevty ($10.22 in chips) 
mattl1990: posts small blind $0.05
ramseskat: is sitting out 
Eduard Gl: posts big blind $0.10
*** HOLE CARDS ***
DrLevty: folds 
Jesus Ololo: folds 
barbos2: raises $0.15 to $0.25
mattl1990: calls $0.20
ramseskat leaves the table
Eduard Gl: folds 
*** FLOP *** [3c Kh 6d]
mattl1990: checks 
barbos2: checks 
*** TURN *** [3c Kh 6d] [3s]
mattl1990: checks 
barbos2: bets $0.43
Mijail Rz joins the table at seat #4 
mattl1990: calls $0.43
*** RIVER *** [3c Kh 6d 3s] [4d]
mattl1990: checks 
barbos2: bets $1
mattl1990: calls $1
*** SHOW DOWN ***
barbos2: shows [8s Ts] (a pair of Threes)
mattl1990: shows [Qs Qd] (two pair, Queens and Threes)
mattl1990 collected $3.30 from pot
*** SUMMARY ***
Total pot $3.46 | Rake $0.16 
Board [3c Kh 6d 3s 4d]
Seat 1: Jesus Ololo folded before Flop (didn't bet)
Seat 2: barbos2 (button) showed [8s Ts] and lost with a pair of Threes
Seat 3: mattl1990 (small blind) showed [Qs Qd] and won ($3.30) with two pair, Queens and Threes
Seat 5: Eduard Gl (big blind) folded before Flop
Seat 6: DrLevty folded before Flop (didn't bet)



PokerStars Hand #222965830883:  Hold'em No Limit ($0.05/$0.10 USD) - 2021/01/23 14:16:02 ET
Table 'Stephano III' 6-max Seat #3 is the button
Seat 1: Jesus Ololo ($12.99 in chips) 
Seat 2: barbos2 ($10 in chips) 
Seat 3: mattl1990 ($12.66 in chips) 
Seat 5: Eduard Gl ($13.30 in chips) 
Seat 6: DrLevty ($10.22 in chips) 
Eduard Gl: posts small blind $0.05
DrLevty: posts big blind $0.10
*** HOLE CARDS ***
Jesus Ololo: folds 
barbos2: folds 
mattl1990: calls $0.10
Eduard Gl: folds 
DrLevty: checks 
*** FLOP *** [Tc 6c 7h]
DrLevty: checks 
mattl1990: bets $0.40
DrLevty: folds 
Uncalled bet ($0.40) returned to mattl1990
mattl1990 collected $0.24 from pot
mattl1990: doesn't show hand 
*** SUMMARY ***
Total pot $0.25 | Rake $0.01 
Board [Tc 6c 7h]
Seat 1: Jesus Ololo folded before Flop (didn't bet)
Seat 2: barbos2 folded before Flop (didn't bet)
Seat 3: mattl1990 (button) collected ($0.24)
Seat 5: Eduard Gl (small blind) folded before Flop
Seat 6: DrLevty (big blind) folded on the Flop



PokerStars Hand #222965853252:  Hold'em No Limit ($0.05/$0.10 USD) - 2021/01/23 14:16:28 ET
Table 'Stephano III' 6-max Seat #5 is the button
Seat 1: Jesus Ololo ($12.99 in chips) 
Seat 2: barbos2 ($10 in chips) 
Seat 3: mattl1990 ($12.80 in chips) 
Seat 5: Eduard Gl ($13.25 in chips) 
Seat 6: DrLevty ($10.12 in chips) 
DrLevty: posts small blind $0.05
Jesus Ololo: posts big blind $0.10
Mijail Rz: sits out 
*** HOLE CARDS ***
barbos2: folds 
mattl1990: calls $0.10
Eduard Gl: folds 
DrLevty: folds 
Jesus Ololo: checks 
*** FLOP *** [9s 5h 9h]
Jesus Ololo: checks 
mattl1990: checks 
*** TURN *** [9s 5h 9h] [7h]
Jesus Ololo: checks 
mattl1990: checks 
*** RIVER *** [9s 5h 9h 7h] [5s]
Jesus Ololo: checks 
mattl1990: checks 
*** SHOW DOWN ***
Jesus Ololo: shows [8c Ad] (two pair, Nines and Fives)
mattl1990: mucks hand 
Jesus Ololo collected $0.24 from pot
*** SUMMARY ***
Total pot $0.25 | Rake $0.01 
Board [9s 5h 9h 7h 5s]
Seat 1: Jesus Ololo (big blind) showed [8c Ad] and won ($0.24) with two pair, Nines and Fives
Seat 2: barbos2 folded before Flop (didn't bet)
Seat 3: mattl1990 mucked
Seat 5: Eduard Gl (button) folded before Flop (didn't bet)
Seat 6: DrLevty (small blind) folded before Flop



PokerStars Hand #222965872938:  Hold'em No Limit ($0.05/$0.10 USD) - 2021/01/23 14:16:53 ET
Table 'Stephano III' 6-max Seat #6 is the button
Seat 1: Jesus Ololo ($13.13 in chips) 
Seat 2: barbos2 ($10 in chips) 
Seat 3: mattl1990 ($12.70 in chips) 
Seat 5: Eduard Gl ($13.25 in chips) 
Seat 6: DrLevty ($10.07 in chips) 
Jesus Ololo: posts small blind $0.05
barbos2: posts big blind $0.10
Mijail Rz: sits out 
*** HOLE CARDS ***
mattl1990: folds 
Eduard Gl: raises $0.20 to $0.30
DrLevty: folds 
Jesus Ololo: folds 
barbos2: folds 
Uncalled bet ($0.20) returned to Eduard Gl
Eduard Gl collected $0.25 from pot
Eduard Gl: doesn't show hand 
*** SUMMARY ***
Total pot $0.25 | Rake $0 
Seat 1: Jesus Ololo (small blind) folded before Flop
Seat 2: barbos2 (big blind) folded before Flop
Seat 3: mattl1990 folded before Flop (didn't bet)
Seat 5: Eduard Gl collected ($0.25)
Seat 6: DrLevty (button) folded before Flop (didn't bet)



PokerStars Hand #222965884035:  Hold'em No Limit ($0.05/$0.10 USD) - 2021/01/23 14:17:07 ET
Table 'Stephano III' 6-max Seat #1 is the button
Seat 1: Jesus Ololo ($13.08 in chips) 
Seat 2: barbos2 ($10 in chips) 
Seat 3: mattl1990 ($12.70 in chips) 
Seat 5: Eduard Gl ($13.40 in chips) 
Seat 6: DrLevty ($10.07 in chips) 
barbos2: posts small blind $0.05
mattl1990: posts big blind $0.10
Mijail Rz: sits out 
*** HOLE CARDS ***
Eduard Gl: folds 
DrLevty: folds 
Jesus Ololo: raises $0.25 to $0.35
barbos2: folds 
mattl1990: folds 
Uncalled bet ($0.25) returned to Jesus Ololo
Jesus Ololo collected $0.25 from pot
*** SUMMARY ***
Total pot $0.25 | Rake $0 
Seat 1: Jesus Ololo (button) collected ($0.25)
Seat 2: barbos2 (small blind) folded before Flop
Seat 3: mattl1990 (big blind) folded before Flop
Seat 5: Eduard Gl folded before Flop (didn't bet)
Seat 6: DrLevty folded before Flop (didn't bet)



PokerStars Hand #222965892886:  Hold'em No Limit ($0.05/$0.10 USD) - 2021/01/23 14:17:18 ET
Table 'Stephano III' 6-max Seat #2 is the button
Seat 1: Jesus Ololo ($13.23 in chips) 
Seat 2: barbos2 ($10 in chips) 
Seat 3: mattl1990 ($12.60 in chips) 
Seat 4: Mijail Rz ($10 in chips) 
Seat 5: Eduard Gl ($13.40 in chips) 
Seat 6: DrLevty ($10.07 in chips) 
mattl1990: posts small blind $0.05
Mijail Rz: posts big blind $0.10
*** HOLE CARDS ***
Eduard Gl: folds 
DrLevty: folds 
Jesus Ololo: raises $0.25 to $0.35
barbos2: folds 
mattl1990: calls $0.30
Mijail Rz: folds 
*** FLOP *** [4c As Td]
mattl1990: checks 
Jesus Ololo: checks 
*** TURN *** [4c As Td] [5c]
mattl1990: checks 
Jesus Ololo: checks 
*** RIVER *** [4c As Td 5c] [8h]
mattl1990: checks 
Jesus Ololo: bets $0.20
mattl1990: folds 
Uncalled bet ($0.20) returned to Jesus Ololo
Jesus Ololo collected $0.76 from pot
*** SUMMARY ***
Total pot $0.80 | Rake $0.04 
Board [4c As Td 5c 8h]
Seat 1: Jesus Ololo collected ($0.76)
Seat 2: barbos2 (button) folded before Flop (didn't bet)
Seat 3: mattl1990 (small blind) folded on the River
Seat 4: Mijail Rz (big blind) folded before Flop
Seat 5: Eduard Gl folded before Flop (didn't bet)
Seat 6: DrLevty folded before Flop (didn't bet)



PokerStars Hand #222965924908:  Hold'em No Limit ($0.05/$0.10 USD) - 2021/01/23 14:17:58 ET
Table 'Stephano III' 6-max Seat #3 is the button
Seat 1: Jesus Ololo ($13.64 in chips) 
Seat 2: barbos2 ($10 in chips) 
Seat 3: mattl1990 ($12.25 in chips) 
Seat 4: Mijail Rz ($10 in chips) 
Seat 5: Eduard Gl ($13.40 in chips) 
Seat 6: DrLevty ($10.07 in chips) 
Mijail Rz: posts small blind $0.05
Eduard Gl: posts big blind $0.10
*** HOLE CARDS ***
DrLevty: folds 
Jesus Ololo: raises $0.15 to $0.25
barbos2: folds 
mattl1990: folds 
mattl1990 leaves the table
Mijail Rz: raises $0.75 to $1
Eduard Gl: folds 
Jesus Ololo: folds 
Uncalled bet ($0.75) returned to Mijail Rz
Mijail Rz collected $0.60 from pot
Mijail Rz: doesn't show hand 
*** SUMMARY ***
Total pot $0.60 | Rake $0 
Seat 1: Jesus Ololo folded before Flop
Seat 2: barbos2 folded before Flop (didn't bet)
Seat 3: mattl1990 (button) folded before Flop (didn't bet)
Seat 4: Mijail Rz (small blind) collected ($0.60)
Seat 5: Eduard Gl (big blind) folded before Flop
Seat 6: DrLevty folded before Flop (didn't bet)



PokerStars Hand #222965941814:  Hold'em No Limit ($0.05/$0.10 USD) - 2021/01/23 14:18:20 ET
Table 'Stephano III' 6-max Seat #4 is the button
Seat 1: Jesus Ololo ($13.39 in chips) 
Seat 2: barbos2 ($10 in chips) 
Seat 4: Mijail Rz ($10.35 in chips) 
Seat 5: Eduard Gl ($13.30 in chips) 
Seat 6: DrLevty ($10.07 in chips) 
Eduard Gl: posts small blind $0.05
DrLevty: posts big blind $0.10
*** HOLE CARDS ***
Jesus Ololo: folds 
barbos2: folds 
Mijail Rz: raises $0.15 to $0.25
Eduard Gl: raises $0.60 to $0.85
DrLevty: folds 
Mijail Rz: folds 
Uncalled bet ($0.60) returned to Eduard Gl
Eduard Gl collected $0.60 from pot
Eduard Gl: doesn't show hand 
*** SUMMARY ***
Total pot $0.60 | Rake $0 
Seat 1: Jesus Ololo folded before Flop (didn't bet)
Seat 2: barbos2 folded before Flop (didn't bet)
Seat 4: Mijail Rz (button) folded before Flop
Seat 5: Eduard Gl (small blind) collected ($0.60)
Seat 6: DrLevty (big blind) folded before Flop



PokerStars Hand #222965955236:  Hold'em No Limit ($0.05/$0.10 USD) - 2021/01/23 14:18:37 ET
Table 'Stephano III' 6-max Seat #5 is the button
Seat 4: Mijail Rz ($10.10 in chips) 
Seat 5: Eduard Gl ($13.65 in chips) 
Seat 6: DrLevty ($10 in chips) 
DrLevty: posts small blind $0.05
Jesus Ololo: is sitting out 
barbos2: is sitting out 
Mijail Rz: posts big blind $0.10
*** HOLE CARDS ***
barbos2 leaves the table
Eduard Gl: raises $0.10 to $0.20
DrLevty: raises $0.70 to $0.90
Mijail Rz: folds 
Jesus Ololo leaves the table
Eduard Gl: folds 
Uncalled bet ($0.70) returned to DrLevty
DrLevty collected $0.50 from pot
DrLevty: doesn't show hand 
*** SUMMARY ***
Total pot $0.50 | Rake $0 
Seat 4: Mijail Rz (big blind) folded before Flop
Seat 5: Eduard Gl (button) folded before Flop
Seat 6: DrLevty (small blind) collected ($0.50)



PokerStars Hand #222965969164:  Hold'em No Limit ($0.05/$0.10 USD) - 2021/01/23 14:18:54 ET
Table 'Stephano III' 6-max Seat #6 is the button
Seat 4: Mijail Rz ($10 in chips) 
Seat 5: Eduard Gl ($13.45 in chips) 
Seat 6: DrLevty ($10.30 in chips) 
Mijail Rz: posts small blind $0.05
Eduard Gl: posts big blind $0.10
*** HOLE CARDS ***
DrLevty: raises $0.20 to $0.30
Mijail Rz: folds 
Eduard Gl: folds 
Uncalled bet ($0.20) returned to DrLevty
DrLevty collected $0.25 from pot
DrLevty: doesn't show hand 
*** SUMMARY ***
Total pot $0.25 | Rake $0 
Seat 4: Mijail Rz (small blind) folded before Flop
Seat 5: Eduard Gl (big blind) folded before Flop
Seat 6: DrLevty (button) collected ($0.25)



PokerStars Hand #222965975814:  Hold'em No Limit ($0.05/$0.10 USD) - 2021/01/23 14:19:03 ET
Table 'Stephano III' 6-max Seat #5 is the button
Seat 4: Mijail Rz ($10 in chips) 
Seat 5: Eduard Gl ($13.35 in chips) 
Eduard Gl: posts small blind $0.05
DrLevty: is sitting out 
Mijail Rz: posts big blind $0.10
*** HOLE CARDS ***
Eduard Gl: raises $0.10 to $0.20
Mijail Rz: folds 
Uncalled bet ($0.10) returned to Eduard Gl
Eduard Gl collected $0.20 from pot
Eduard Gl: doesn't show hand 
*** SUMMARY ***
Total pot $0.20 | Rake $0 
Seat 4: Mijail Rz (big blind) folded before Flop
Seat 5: Eduard Gl (button) (small blind) collected ($0.20)



PokerStars Hand #222965985140:  Hold'em No Limit ($0.05/$0.10 USD) - 2021/01/23 14:19:15 ET
Table 'Stephano III' 6-max Seat #4 is the button
Seat 4: Mijail Rz ($10 in chips) 
Seat 5: Eduard Gl ($13.45 in chips) 
Mijail Rz: posts small blind $0.05
Eduard Gl: posts big blind $0.10
*** HOLE CARDS ***
Mijail Rz: folds 
Uncalled bet ($0.05) returned to Eduard Gl
Mijail Rz leaves the table
Eduard Gl collected $0.10 from pot
Eduard Gl: doesn't show hand 
*** SUMMARY ***
Total pot $0.10 | Rake $0 
Seat 4: Mijail Rz (button) (small blind) folded before Flop
Seat 5: Eduard Gl (big blind) collected ($0.10)



PokerStars Hand #222966154414:  Hold'em No Limit ($0.05/$0.10 USD) - 2021/01/23 14:22:47 ET
Table 'Stephano III' 6-max Seat #1 is the button
Seat 1: xiled90 ($10 in chips) 
Seat 2: James Auger ($5.90 in chips) 
Seat 3: 0nix770 ($10 in chips) 
James Auger: posts small blind $0.05
0nix770: posts big blind $0.10
*** HOLE CARDS ***
Tomirlan8 joins the table at seat #4 
Rat1o joins the table at seat #5 
xiled90: raises $0.15 to $0.25
James Auger: calls $0.20
0nix770: calls $0.15
*** FLOP *** [5c Qd Jc]
RUMJO joins the table at seat #6 
James Auger: checks 
0nix770: checks 
xiled90: checks 
*** TURN *** [5c Qd Jc] [4d]
James Auger: checks 
0nix770: bets $0.42
xiled90: folds 
James Auger: calls $0.42
*** RIVER *** [5c Qd Jc 4d] [2s]
James Auger: checks 
0nix770: bets $1.88
James Auger: folds 
Uncalled bet ($1.88) returned to 0nix770
0nix770 collected $1.52 from pot
0nix770: doesn't show hand 
*** SUMMARY ***
Total pot $1.59 | Rake $0.07 
Board [5c Qd Jc 4d 2s]
Seat 1: xiled90 (button) folded on the Turn
Seat 2: James Auger (small blind) folded on the River
Seat 3: 0nix770 (big blind) collected ($1.52)



PokerStars Hand #222966191688:  Hold'em No Limit ($0.05/$0.10 USD) - 2021/01/23 14:23:34 ET
Table 'Stephano III' 6-max Seat #2 is the button
Seat 1: xiled90 ($10 in chips) 
Seat 2: James Auger ($5.23 in chips) 
Seat 3: 0nix770 ($10.85 in chips) 
Seat 4: Tomirlan8 ($10 in chips) 
0nix770: posts small blind $0.05
Tomirlan8: posts big blind $0.10
Rat1o: sits out 
RUMJO: sits out 
*** HOLE CARDS ***
xiled90: folds 
James Auger: folds 
0nix770: folds 
Uncalled bet ($0.05) returned to Tomirlan8
Tomirlan8 collected $0.10 from pot
Tomirlan8: doesn't show hand 
*** SUMMARY ***
Total pot $0.10 | Rake $0 
Seat 1: xiled90 folded before Flop (didn't bet)
Seat 2: James Auger (button) folded before Flop (didn't bet)
Seat 3: 0nix770 (small blind) folded before Flop
Seat 4: Tomirlan8 (big blind) collected ($0.10)



PokerStars Hand #222966198888:  Hold'em No Limit ($0.05/$0.10 USD) - 2021/01/23 14:23:44 ET
Table 'Stephano III' 6-max Seat #3 is the button
Seat 1: xiled90 ($10 in chips) 
Seat 2: James Auger ($5.23 in chips) 
Seat 3: 0nix770 ($10.80 in chips) 
Seat 4: Tomirlan8 ($10.05 in chips) 
Seat 5: Rat1o ($10 in chips) 
Tomirlan8: posts small blind $0.05
Rat1o: posts big blind $0.10
RUMJO: sits out 
*** HOLE CARDS ***
xiled90: raises $0.20 to $0.30
James Auger: calls $0.30
0nix770: folds 
Tomirlan8: folds 
Rat1o: raises $1 to $1.30
xiled90: calls $1
James Auger: calls $1
*** FLOP *** [6s Ac 3s]
Rat1o: bets $1.24
xiled90: folds 
James Auger: calls $1.24
*** TURN *** [6s Ac 3s] [4h]
Rat1o: bets $3.07
James Auger: calls $2.69 and is all-in
Uncalled bet ($0.38) returned to Rat1o
*** RIVER *** [6s Ac 3s 4h] [9d]
*** SHOW DOWN ***
Rat1o: shows [As Ks] (a pair of Aces)
James Auger: shows [Kc Th] (high card Ace)
Rat1o collected $11.28 from pot
*** SUMMARY ***
Total pot $11.81 | Rake $0.53 
Board [6s Ac 3s 4h 9d]
Seat 1: xiled90 folded on the Flop
Seat 2: James Auger showed [Kc Th] and lost with high card Ace
Seat 3: 0nix770 (button) folded before Flop (didn't bet)
Seat 4: Tomirlan8 (small blind) folded before Flop
Seat 5: Rat1o (big blind) showed [As Ks] and won ($11.28) with a pair of Aces



PokerStars Hand #222966231695:  Hold'em No Limit ($0.05/$0.10 USD) - 2021/01/23 14:24:26 ET
Table 'Stephano III' 6-max Seat #4 is the button
Seat 1: xiled90 ($10 in chips) 
Seat 3: 0nix770 ($10.80 in chips) 
Seat 4: Tomirlan8 ($10 in chips) 
Seat 5: Rat1o ($16.05 in chips) 
Seat 6: RUMJO ($8 in chips) 
Rat1o: posts small blind $0.05
RUMJO: posts big blind $0.10
*** HOLE CARDS ***
xiled90: folds 
0nix770: raises $0.15 to $0.25
James Auger leaves the table
Tomirlan8: folds 
Rat1o: folds 
romanromanro joins the table at seat #2 
RUMJO: folds 
Uncalled bet ($0.15) returned to 0nix770
0nix770 collected $0.25 from pot
0nix770: doesn't show hand 
*** SUMMARY ***
Total pot $0.25 | Rake $0 
Seat 1: xiled90 folded before Flop (didn't bet)
Seat 3: 0nix770 collected ($0.25)
Seat 4: Tomirlan8 (button) folded before Flop (didn't bet)
Seat 5: Rat1o (small blind) folded before Flop
Seat 6: RUMJO (big blind) folded before Flop



PokerStars Hand #222966247311:  Hold'em No Limit ($0.05/$0.10 USD) - 2021/01/23 14:24:45 ET
Table 'Stephano III' 6-max Seat #5 is the button
Seat 1: xiled90 ($10 in chips) 
Seat 3: 0nix770 ($10.95 in chips) 
Seat 4: Tomirlan8 ($10 in chips) 
Seat 5: Rat1o ($16 in chips) 
Seat 6: RUMJO ($7.90 in chips) 
RUMJO: posts small blind $0.05
xiled90: posts big blind $0.10
romanromanro: sits out 
*** HOLE CARDS ***
0nix770: raises $0.20 to $0.30
Tomirlan8: folds 
Rat1o: folds 
RUMJO: folds 
xiled90: folds 
Uncalled bet ($0.20) returned to 0nix770
0nix770 collected $0.25 from pot
0nix770: doesn't show hand 
*** SUMMARY ***
Total pot $0.25 | Rake $0 
Seat 1: xiled90 (big blind) folded before Flop
Seat 3: 0nix770 collected ($0.25)
Seat 4: Tomirlan8 folded before Flop (didn't bet)
Seat 5: Rat1o (button) folded before Flop (didn't bet)
Seat 6: RUMJO (small blind) folded before Flop



PokerStars Hand #222966259710:  Hold'em No Limit ($0.05/$0.10 USD) - 2021/01/23 14:25:01 ET
Table 'Stephano III' 6-max Seat #6 is the button
Seat 1: xiled90 ($10 in chips) 
Seat 2: romanromanro ($10 in chips) 
Seat 3: 0nix770 ($11.10 in chips) 
Seat 4: Tomirlan8 ($10 in chips) 
Seat 5: Rat1o ($16 in chips) 
Seat 6: RUMJO ($9.95 in chips) 
xiled90: posts small blind $0.05
romanromanro: posts big blind $0.10
*** HOLE CARDS ***
0nix770: folds 
Tomirlan8: raises $0.16 to $0.26
Rat1o: raises $0.64 to $0.90
RUMJO: folds 
xiled90: folds 
romanromanro: folds 
Tomirlan8: raises $1.60 to $2.50
Rat1o: calls $1.60
*** FLOP *** [3s Ks 8c]
Tomirlan8: bets $1.62
Rat1o: calls $1.62
*** TURN *** [3s Ks 8c] [2c]
Tomirlan8: bets $5.88 and is all-in
Rat1o: calls $5.88
*** FIRST RIVER *** [3s Ks 8c 2c] [4c]
*** SECOND RIVER *** [3s Ks 8c 2c] [8s]
*** FIRST SHOW DOWN ***
Tomirlan8: shows [Th Ah] (high card Ace)
Rat1o: shows [Ad As] (a pair of Aces)
Rat1o collected $9.62 from pot
*** SECOND SHOW DOWN ***
Tomirlan8: shows [Th Ah] (a pair of Eights)
Rat1o: shows [Ad As] (two pair, Aces and Eights)
Rat1o collected $9.62 from pot
*** SUMMARY ***
Total pot $20.15 | Rake $0.91 
Hand was run twice
FIRST Board [3s Ks 8c 2c 4c]
SECOND Board [3s Ks 8c 2c 8s]
Seat 1: xiled90 (small blind) folded before Flop
Seat 2: romanromanro (big blind) folded before Flop
Seat 3: 0nix770 folded before Flop (didn't bet)
Seat 4: Tomirlan8 showed [Th Ah] and lost with high card Ace, and lost with a pair of Eights
Seat 5: Rat1o showed [Ad As] and won ($9.62) with a pair of Aces, and won ($9.62) with two pair, Aces and Eights
Seat 6: RUMJO (button) folded before Flop (didn't bet)



PokerStars Hand #222966310475:  Hold'em No Limit ($0.05/$0.10 USD) - 2021/01/23 14:26:06 ET
Table 'Stephano III' 6-max Seat #1 is the button
Seat 1: xiled90 ($10 in chips) 
Seat 2: romanromanro ($10 in chips) 
Seat 5: Rat1o ($25.24 in chips) 
Seat 6: RUMJO ($9.95 in chips) 
romanromanro: posts small blind $0.05
0nix770: is sitting out 
Tomirlan8: is sitting out 
0nix770 leaves the table
Rat1o: posts big blind $0.10
*** HOLE CARDS ***
RUMJO: folds 
xiled90: folds 
romanromanro: calls $0.05
Rat1o: raises $0.30 to $0.40
romanromanro: calls $0.30
*** FLOP *** [3c 8s 5h]
romanromanro: checks 
Rat1o: bets $0.38
Juanchopb79 joins the table at seat #3 
romanromanro: folds 
Uncalled bet ($0.38) returned to Rat1o
Rat1o collected $0.76 from pot
Rat1o: doesn't show hand 
*** SUMMARY ***
Total pot $0.80 | Rake $0.04 
Board [3c 8s 5h]
Seat 1: xiled90 (button) folded before Flop (didn't bet)
Seat 2: romanromanro (small blind) folded on the Flop
Seat 5: Rat1o (big blind) collected ($0.76)
Seat 6: RUMJO folded before Flop (didn't bet)



PokerStars Hand #222966332884:  Hold'em No Limit ($0.05/$0.10 USD) - 2021/01/23 14:26:36 ET
Table 'Stephano III' 6-max Seat #2 is the button
Seat 1: xiled90 ($10 in chips) 
Seat 2: romanromanro ($10 in chips) 
Seat 5: Rat1o ($25.60 in chips) 
Seat 6: RUMJO ($9.95 in chips) 
Rat1o: posts small blind $0.05
RUMJO: posts big blind $0.10
*** HOLE CARDS ***
xiled90: folds 
romanromanro: raises $0.12 to $0.22
Tomirlan8 leaves the table
Rat1o: folds 
RUMJO: calls $0.12
*** FLOP *** [8d 4d 9s]
RUMJO: checks 
romanromanro: bets $0.24
McMartin73 joins the table at seat #4 
RUMJO: folds 
Uncalled bet ($0.24) returned to romanromanro
romanromanro collected $0.47 from pot
romanromanro: doesn't show hand 
*** SUMMARY ***
Total pot $0.49 | Rake $0.02 
Board [8d 4d 9s]
Seat 1: xiled90 folded before Flop (didn't bet)
Seat 2: romanromanro (button) collected ($0.47)
Seat 5: Rat1o (small blind) folded before Flop
Seat 6: RUMJO (big blind) folded on the Flop



PokerStars Hand #222966352182:  Hold'em No Limit ($0.05/$0.10 USD) - 2021/01/23 14:27:01 ET
Table 'Stephano III' 6-max Seat #5 is the button
Seat 1: xiled90 ($10 in chips) 
Seat 2: romanromanro ($10.25 in chips) 
Seat 5: Rat1o ($25.55 in chips) 
Seat 6: RUMJO ($9.73 in chips) 
RUMJO: posts small blind $0.05
xiled90: posts big blind $0.10
McMartin73: sits out 
*** HOLE CARDS ***
romanromanro: folds 
Rat1o: raises $0.20 to $0.30
RUMJO: folds 
xiled90: folds 
Uncalled bet ($0.20) returned to Rat1o
Rat1o collected $0.25 from pot
Rat1o: doesn't show hand 
*** SUMMARY ***
Total pot $0.25 | Rake $0 
Seat 1: xiled90 (big blind) folded before Flop
Seat 2: romanromanro folded before Flop (didn't bet)
Seat 5: Rat1o (button) collected ($0.25)
Seat 6: RUMJO (small blind) folded before Flop



PokerStars Hand #222966360956:  Hold'em No Limit ($0.05/$0.10 USD) - 2021/01/23 14:27:12 ET
Table 'Stephano III' 6-max Seat #6 is the button
Seat 1: xiled90 ($10 in chips) 
Seat 2: romanromanro ($10.25 in chips) 
Seat 4: McMartin73 ($8 in chips) 
Seat 5: Rat1o ($25.70 in chips) 
Seat 6: RUMJO ($9.68 in chips) 
xiled90: posts small blind $0.05
romanromanro: posts big blind $0.10
McMartin73: posts big blind $0.10
*** HOLE CARDS ***
McMartin73: checks 
Rat1o: folds 
RUMJO: folds 
xiled90: folds 
romanromanro: raises $0.25 to $0.35
McMartin73: calls $0.25
*** FLOP *** [Qs 6c 4s]
romanromanro: checks 
McMartin73: checks 
*** TURN *** [Qs 6c 4s] [Ah]
romanromanro: checks 
McMartin73: checks 
*** RIVER *** [Qs 6c 4s Ah] [Ac]
romanromanro: bets $0.17
McMartin73: raises $0.17 to $0.34
romanromanro: folds 
Uncalled bet ($0.17) returned to McMartin73
McMartin73 collected $1.04 from pot
McMartin73: doesn't show hand 
*** SUMMARY ***
Total pot $1.09 | Rake $0.05 
Board [Qs 6c 4s Ah Ac]
Seat 1: xiled90 (small blind) folded before Flop
Seat 2: romanromanro (big blind) folded on the River
Seat 4: McMartin73 collected ($1.04)
Seat 5: Rat1o folded before Flop (didn't bet)
Seat 6: RUMJO (button) folded before Flop (didn't bet)



PokerStars Hand #222966408513:  Hold'em No Limit ($0.05/$0.10 USD) - 2021/01/23 14:28:06 ET
Table 'Stephano III' 6-max Seat #1 is the button
Seat 1: xiled90 ($10 in chips) 
Seat 2: romanromanro ($10 in chips) 
Seat 3: Juanchopb79 ($10 in chips) 
Seat 4: McMartin73 ($8.52 in chips) 
Seat 5: Rat1o ($25.70 in chips) 
Seat 6: RUMJO ($9.68 in chips) 
romanromanro: posts small blind $0.05
Juanchopb79: posts big blind $0.10
*** HOLE CARDS ***
McMartin73: folds 
Rat1o: raises $0.20 to $0.30
RUMJO: folds 
xiled90: folds 
romanromanro: folds 
Juanchopb79: folds 
Uncalled bet ($0.20) returned to Rat1o
Rat1o collected $0.25 from pot
Rat1o: doesn't show hand 
*** SUMMARY ***
Total pot $0.25 | Rake $0 
Seat 1: xiled90 (button) folded before Flop (didn't bet)
Seat 2: romanromanro (small blind) folded before Flop
Seat 3: Juanchopb79 (big blind) folded before Flop
Seat 4: McMartin73 folded before Flop (didn't bet)
Seat 5: Rat1o collected ($0.25)
Seat 6: RUMJO folded before Flop (didn't bet)



PokerStars Hand #222966416320:  Hold'em No Limit ($0.05/$0.10 USD) - 2021/01/23 14:28:16 ET
Table 'Stephano III' 6-max Seat #2 is the button
Seat 1: xiled90 ($10 in chips) 
Seat 2: romanromanro ($10 in chips) 
Seat 3: Juanchopb79 ($10 in chips) 
Seat 4: McMartin73 ($8.52 in chips) 
Seat 5: Rat1o ($25.85 in chips) 
Seat 6: RUMJO ($9.68 in chips) 
Juanchopb79: posts small blind $0.05
McMartin73: posts big blind $0.10
*** HOLE CARDS ***
Rat1o: folds 
RUMJO: folds 
xiled90: folds 
romanromanro: raises $0.10 to $0.20
Juanchopb79: folds 
McMartin73: calls $0.10
*** FLOP *** [2h 8s Kc]
McMartin73: checks 
romanromanro: bets $0.14
McMartin73: calls $0.14
*** TURN *** [2h 8s Kc] [Qd]
McMartin73: checks 
romanromanro: checks 
*** RIVER *** [2h 8s Kc Qd] [8h]
McMartin73: bets $0.50
romanromanro: folds 
Uncalled bet ($0.50) returned to McMartin73
McMartin73 collected $0.70 from pot
McMartin73: doesn't show hand 
*** SUMMARY ***
Total pot $0.73 | Rake $0.03 
Board [2h 8s Kc Qd 8h]
Seat 1: xiled90 folded before Flop (didn't bet)
Seat 2: romanromanro (button) folded on the River
Seat 3: Juanchopb79 (small blind) folded before Flop
Seat 4: McMartin73 (big blind) collected ($0.70)
Seat 5: Rat1o folded before Flop (didn't bet)
Seat 6: RUMJO folded before Flop (didn't bet)



PokerStars Hand #222966455169:  Hold'em No Limit ($0.05/$0.10 USD) - 2021/01/23 14:29:06 ET
Table 'Stephano III' 6-max Seat #3 is the button
Seat 1: xiled90 ($10 in chips) 
Seat 2: romanromanro ($10 in chips) 
Seat 3: Juanchopb79 ($10 in chips) 
Seat 4: McMartin73 ($8.88 in chips) 
Seat 5: Rat1o ($25.85 in chips) 
Seat 6: RUMJO ($9.68 in chips) 
McMartin73: posts small blind $0.05
Rat1o: posts big blind $0.10
*** HOLE CARDS ***
RUMJO: folds 
xiled90: folds 
romanromanro: folds 
Juanchopb79: folds 
McMartin73: raises $0.10 to $0.20
Rat1o: calls $0.10
*** FLOP *** [4d Td 2d]
McMartin73: bets $0.40
Rat1o: folds 
Uncalled bet ($0.40) returned to McMartin73
McMartin73 collected $0.38 from pot
McMartin73: doesn't show hand 
*** SUMMARY ***
Total pot $0.40 | Rake $0.02 
Board [4d Td 2d]
Seat 1: xiled90 folded before Flop (didn't bet)
Seat 2: romanromanro folded before Flop (didn't bet)
Seat 3: Juanchopb79 (button) folded before Flop (didn't bet)
Seat 4: McMartin73 (small blind) collected ($0.38)
Seat 5: Rat1o (big blind) folded on the Flop
Seat 6: RUMJO folded before Flop (didn't bet)



PokerStars Hand #222966472653:  Hold'em No Limit ($0.05/$0.10 USD) - 2021/01/23 14:29:29 ET
Table 'Stephano III' 6-max Seat #4 is the button
Seat 1: xiled90 ($10 in chips) 
Seat 2: romanromanro ($10 in chips) 
Seat 3: Juanchopb79 ($10 in chips) 
Seat 4: McMartin73 ($9.06 in chips) 
Seat 5: Rat1o ($25.65 in chips) 
Seat 6: RUMJO ($9.68 in chips) 
Rat1o: posts small blind $0.05
RUMJO: posts big blind $0.10
*** HOLE CARDS ***
xiled90: folds 
romanromanro: folds 
Juanchopb79: raises $0.20 to $0.30
McMartin73: folds 
Rat1o: folds 
RUMJO: calls $0.20
*** FLOP *** [4c 8s Qc]
RUMJO: checks 
Juanchopb79: bets $0.20
RUMJO: calls $0.20
*** TURN *** [4c 8s Qc] [4h]
RUMJO: checks 
Juanchopb79: checks 
*** RIVER *** [4c 8s Qc 4h] [Tc]
RUMJO: checks 
Juanchopb79: checks 
*** SHOW DOWN ***
RUMJO: shows [8d Ah] (two pair, Eights and Fours)
Juanchopb79: mucks hand 
RUMJO collected $1 from pot
*** SUMMARY ***
Total pot $1.05 | Rake $0.05 
Board [4c 8s Qc 4h Tc]
Seat 1: xiled90 folded before Flop (didn't bet)
Seat 2: romanromanro folded before Flop (didn't bet)
Seat 3: Juanchopb79 mucked
Seat 4: McMartin73 (button) folded before Flop (didn't bet)
Seat 5: Rat1o (small blind) folded before Flop
Seat 6: RUMJO (big blind) showed [8d Ah] and won ($1) with two pair, Eights and Fours



PokerStars Hand #222966523280:  Hold'em No Limit ($0.05/$0.10 USD) - 2021/01/23 14:30:22 ET
Table 'Stephano III' 6-max Seat #5 is the button
Seat 1: xiled90 ($10 in chips) 
Seat 2: romanromanro ($10 in chips) 
Seat 3: Juanchopb79 ($10 in chips) 
Seat 4: McMartin73 ($9.06 in chips) 
Seat 5: Rat1o ($25.60 in chips) 
Seat 6: RUMJO ($10.18 in chips) 
RUMJO: posts small blind $0.05
xiled90: posts big blind $0.10
*** HOLE CARDS ***
romanromanro: folds 
Juanchopb79: raises $0.20 to $0.30
McMartin73: folds 
Rat1o: folds 
RUMJO: folds 
xiled90: folds 
Uncalled bet ($0.20) returned to Juanchopb79
Juanchopb79 collected $0.25 from pot
Juanchopb79: doesn't show hand 
*** SUMMARY ***
Total pot $0.25 | Rake $0 
Seat 1: xiled90 (big blind) folded before Flop
Seat 2: romanromanro folded before Flop (didn't bet)
Seat 3: Juanchopb79 collected ($0.25)
Seat 4: McMartin73 folded before Flop (didn't bet)
Seat 5: Rat1o (button) folded before Flop (didn't bet)
Seat 6: RUMJO (small blind) folded before Flop



PokerStars Hand #222966537259:  Hold'em No Limit ($0.05/$0.10 USD) - 2021/01/23 14:30:40 ET
Table 'Stephano III' 6-max Seat #6 is the button
Seat 1: xiled90 ($10 in chips) 
Seat 2: romanromanro ($10 in chips) 
Seat 3: Juanchopb79 ($10.15 in chips) 
Seat 4: McMartin73 ($9.06 in chips) 
Seat 5: Rat1o ($25.60 in chips) 
Seat 6: RUMJO ($10.13 in chips) 
xiled90: posts small blind $0.05
romanromanro: posts big blind $0.10
*** HOLE CARDS ***
Juanchopb79: folds 
McMartin73: folds 
Rat1o: folds 
RUMJO: folds 
xiled90: folds 
Uncalled bet ($0.05) returned to romanromanro
romanromanro collected $0.10 from pot
romanromanro: doesn't show hand 
*** SUMMARY ***
Total pot $0.10 | Rake $0 
Seat 1: xiled90 (small blind) folded before Flop
Seat 2: romanromanro (big blind) collected ($0.10)
Seat 3: Juanchopb79 folded before Flop (didn't bet)
Seat 4: McMartin73 folded before Flop (didn't bet)
Seat 5: Rat1o folded before Flop (didn't bet)
Seat 6: RUMJO (button) folded before Flop (didn't bet)



PokerStars Hand #222966553711:  Hold'em No Limit ($0.05/$0.10 USD) - 2021/01/23 14:31:02 ET
Table 'Stephano III' 6-max Seat #1 is the button
Seat 1: xiled90 ($10 in chips) 
Seat 2: romanromanro ($10.05 in chips) 
Seat 3: Juanchopb79 ($10.15 in chips) 
Seat 4: McMartin73 ($9.06 in chips) 
Seat 5: Rat1o ($25.60 in chips) 
Seat 6: RUMJO ($10.13 in chips) 
romanromanro: posts small blind $0.05
Juanchopb79: posts big blind $0.10
*** HOLE CARDS ***
McMartin73: folds 
Rat1o: folds 
RUMJO: folds 
xiled90: folds 
romanromanro: raises $0.15 to $0.25
Juanchopb79: calls $0.15
*** FLOP *** [8s 6c As]
romanromanro: bets $0.16
Juanchopb79: calls $0.16
*** TURN *** [8s 6c As] [3d]
romanromanro: checks 
Juanchopb79: checks 
*** RIVER *** [8s 6c As 3d] [Qs]
romanromanro: checks 
Juanchopb79: bets $0.59
romanromanro: folds 
Uncalled bet ($0.59) returned to Juanchopb79
Juanchopb79 collected $0.78 from pot
Juanchopb79: doesn't show hand 
*** SUMMARY ***
Total pot $0.82 | Rake $0.04 
Board [8s 6c As 3d Qs]
Seat 1: xiled90 (button) folded before Flop (didn't bet)
Seat 2: romanromanro (small blind) folded on the River
Seat 3: Juanchopb79 (big blind) collected ($0.78)
Seat 4: McMartin73 folded before Flop (didn't bet)
Seat 5: Rat1o folded before Flop (didn't bet)
Seat 6: RUMJO folded before Flop (didn't bet)



PokerStars Hand #222966590691:  Hold'em No Limit ($0.05/$0.10 USD) - 2021/01/23 14:31:49 ET
Table 'Stephano III' 6-max Seat #2 is the button
Seat 1: xiled90 ($10 in chips) 
Seat 2: romanromanro ($10 in chips) 
Seat 3: Juanchopb79 ($10.52 in chips) 
Seat 4: McMartin73 ($9.06 in chips) 
Seat 5: Rat1o ($25.60 in chips) 
Seat 6: RUMJO ($10.13 in chips) 
Juanchopb79: posts small blind $0.05
McMartin73: posts big blind $0.10
*** HOLE CARDS ***
Rat1o: folds 
RUMJO: folds 
xiled90: raises $0.20 to $0.30
romanromanro: folds 
Juanchopb79: folds 
McMartin73: folds 
Uncalled bet ($0.20) returned to xiled90
xiled90 collected $0.25 from pot
xiled90: doesn't show hand 
*** SUMMARY ***
Total pot $0.25 | Rake $0 
Seat 1: xiled90 collected ($0.25)
Seat 2: romanromanro (button) folded before Flop (didn't bet)
Seat 3: Juanchopb79 (small blind) folded before Flop
Seat 4: McMartin73 (big blind) folded before Flop
Seat 5: Rat1o folded before Flop (didn't bet)
Seat 6: RUMJO folded before Flop (didn't bet)



PokerStars Hand #222966606246:  Hold'em No Limit ($0.05/$0.10 USD) - 2021/01/23 14:32:09 ET
Table 'Stephano III' 6-max Seat #3 is the button
Seat 1: xiled90 ($10.15 in chips) 
Seat 2: romanromanro ($10 in chips) 
Seat 3: Juanchopb79 ($10.47 in chips) 
Seat 4: McMartin73 ($8.96 in chips) 
Seat 5: Rat1o ($25.60 in chips) 
Seat 6: RUMJO ($10.13 in chips) 
McMartin73: posts small blind $0.05
Rat1o: posts big blind $0.10
*** HOLE CARDS ***
RUMJO: raises $0.15 to $0.25
xiled90: folds 
romanromanro: folds 
Juanchopb79: folds 
McMartin73: folds 
Rat1o: folds 
Uncalled bet ($0.15) returned to RUMJO
RUMJO collected $0.25 from pot
RUMJO: doesn't show hand 
*** SUMMARY ***
Total pot $0.25 | Rake $0 
Seat 1: xiled90 folded before Flop (didn't bet)
Seat 2: romanromanro folded before Flop (didn't bet)
Seat 3: Juanchopb79 (button) folded before Flop (didn't bet)
Seat 4: McMartin73 (small blind) folded before Flop
Seat 5: Rat1o (big blind) folded before Flop
Seat 6: RUMJO collected ($0.25)



PokerStars Hand #222966625244:  Hold'em No Limit ($0.05/$0.10 USD) - 2021/01/23 14:32:32 ET
Table 'Stephano III' 6-max Seat #4 is the button
Seat 1: xiled90 ($10.15 in chips) 
Seat 2: romanromanro ($10 in chips) 
Seat 3: Juanchopb79 ($10.47 in chips) 
Seat 4: McMartin73 ($8.91 in chips) 
Seat 5: Rat1o ($25.50 in chips) 
Seat 6: RUMJO ($10.28 in chips) 
Rat1o: posts small blind $0.05
RUMJO: posts big blind $0.10
*** HOLE CARDS ***
xiled90: folds 
romanromanro: folds 
Juanchopb79: raises $0.20 to $0.30
McMartin73: folds 
Rat1o: folds 
RUMJO: folds 
Uncalled bet ($0.20) returned to Juanchopb79
Juanchopb79 collected $0.25 from pot
Juanchopb79: doesn't show hand 
*** SUMMARY ***
Total pot $0.25 | Rake $0 
Seat 1: xiled90 folded before Flop (didn't bet)
Seat 2: romanromanro folded before Flop (didn't bet)
Seat 3: Juanchopb79 collected ($0.25)
Seat 4: McMartin73 (button) folded before Flop (didn't bet)
Seat 5: Rat1o (small blind) folded before Flop
Seat 6: RUMJO (big blind) folded before Flop



PokerStars Hand #222966640171:  Hold'em No Limit ($0.05/$0.10 USD) - 2021/01/23 14:32:52 ET
Table 'Stephano III' 6-max Seat #5 is the button
Seat 1: xiled90 ($10.15 in chips) 
Seat 2: romanromanro ($10 in chips) 
Seat 3: Juanchopb79 ($10.62 in chips) 
Seat 4: McMartin73 ($8.91 in chips) 
Seat 5: Rat1o ($25.45 in chips) 
Seat 6: RUMJO ($10.18 in chips) 
RUMJO: posts small blind $0.05
xiled90: posts big blind $0.10
*** HOLE CARDS ***
romanromanro: folds 
Juanchopb79: folds 
McMartin73: calls $0.10
romanromanro was removed from the table for failing to post
romanromanro leaves the table
Rat1o: raises $0.30 to $0.40
RUMJO: folds 
xiled90: folds 
teddyKK joins the table at seat #2 
McMartin73: calls $0.30
*** FLOP *** [Jh 5h 3c]
McMartin73: checks 
Rat1o: bets $0.30
McMartin73: calls $0.30
*** TURN *** [Jh 5h 3c] [2s]
McMartin73: checks 
Rat1o: checks 
*** RIVER *** [Jh 5h 3c 2s] [Js]
McMartin73: bets $0.30
Rat1o: folds 
Uncalled bet ($0.30) returned to McMartin73
McMartin73 collected $1.48 from pot
McMartin73: doesn't show hand 
*** SUMMARY ***
Total pot $1.55 | Rake $0.07 
Board [Jh 5h 3c 2s Js]
Seat 1: xiled90 (big blind) folded before Flop
Seat 2: romanromanro folded before Flop (didn't bet)
Seat 3: Juanchopb79 folded before Flop (didn't bet)
Seat 4: McMartin73 collected ($1.48)
Seat 5: Rat1o (button) folded on the River
Seat 6: RUMJO (small blind) folded before Flop



PokerStars Hand #222966689137:  Hold'em No Limit ($0.05/$0.10 USD) - 2021/01/23 14:33:54 ET
Table 'Stephano III' 6-max Seat #6 is the button
Seat 1: xiled90 ($10.05 in chips) 
Seat 2: teddyKK ($10 in chips) 
Seat 3: Juanchopb79 ($10.62 in chips) 
Seat 4: McMartin73 ($9.69 in chips) 
Seat 5: Rat1o ($24.75 in chips) 
Seat 6: RUMJO ($10.13 in chips) 
xiled90: posts small blind $0.05
teddyKK: posts big blind $0.10
*** HOLE CARDS ***
Juanchopb79: folds 
McMartin73: folds 
Rat1o: folds 
RUMJO: raises $0.15 to $0.25
xiled90: folds 
teddyKK: folds 
Uncalled bet ($0.15) returned to RUMJO
RUMJO collected $0.25 from pot
RUMJO: doesn't show hand 
*** SUMMARY ***
Total pot $0.25 | Rake $0 
Seat 1: xiled90 (small blind) folded before Flop
Seat 2: teddyKK (big blind) folded before Flop
Seat 3: Juanchopb79 folded before Flop (didn't bet)
Seat 4: McMartin73 folded before Flop (didn't bet)
Seat 5: Rat1o folded before Flop (didn't bet)
Seat 6: RUMJO (button) collected ($0.25)



PokerStars Hand #222966706960:  Hold'em No Limit ($0.05/$0.10 USD) - 2021/01/23 14:34:17 ET
Table 'Stephano III' 6-max Seat #1 is the button
Seat 1: xiled90 ($10 in chips) 
Seat 2: teddyKK ($10 in chips) 
Seat 3: Juanchopb79 ($10.62 in chips) 
Seat 4: McMartin73 ($9.69 in chips) 
Seat 5: Rat1o ($24.75 in chips) 
Seat 6: RUMJO ($10.28 in chips) 
teddyKK: posts small blind $0.05
Juanchopb79: posts big blind $0.10
*** HOLE CARDS ***
McMartin73: calls $0.10
Rat1o: raises $0.30 to $0.40
RUMJO: folds 
xiled90: raises $0.80 to $1.20
teddyKK: folds 
Juanchopb79: folds 
McMartin73: calls $1.10
Rat1o: folds 
*** FLOP *** [Qs Ac Qc]
McMartin73: bets $8.49 and is all-in
xiled90: calls $8.49
*** TURN *** [Qs Ac Qc] [6s]
*** RIVER *** [Qs Ac Qc 6s] [9h]
*** SHOW DOWN ***
McMartin73: shows [Jh Ad] (two pair, Aces and Queens)
xiled90: shows [Kd As] (two pair, Aces and Queens - King kicker)
xiled90 collected $19.03 from pot
*** SUMMARY ***
Total pot $19.93 | Rake $0.90 
Board [Qs Ac Qc 6s 9h]
Seat 1: xiled90 (button) showed [Kd As] and won ($19.03) with two pair, Aces and Queens
Seat 2: teddyKK (small blind) folded before Flop
Seat 3: Juanchopb79 (big blind) folded before Flop
Seat 4: McMartin73 showed [Jh Ad] and lost with two pair, Aces and Queens
Seat 5: Rat1o folded before Flop
Seat 6: RUMJO folded before Flop (didn't bet)



PokerStars Hand #222966782609:  Hold'em No Limit ($0.05/$0.10 USD) - 2021/01/23 14:35:54 ET
Table 'Stephano III' 6-max Seat #2 is the button
Seat 1: xiled90 ($19.34 in chips) 
Seat 2: teddyKK ($10 in chips) 
Seat 3: Juanchopb79 ($10.52 in chips) 
Seat 5: Rat1o ($24.35 in chips) 
Seat 6: RUMJO ($10.28 in chips) 
Juanchopb79: posts small blind $0.05
Rat1o: posts big blind $0.10
*** HOLE CARDS ***
RUMJO: folds 
xiled90: folds 
teddyKK: folds 
McMartin73 leaves the table
Juanchopb79: folds 
Uncalled bet ($0.05) returned to Rat1o
Rat1o collected $0.10 from pot
Rat1o: doesn't show hand 
*** SUMMARY ***
Total pot $0.10 | Rake $0 
Seat 1: xiled90 folded before Flop (didn't bet)
Seat 2: teddyKK (button) folded before Flop (didn't bet)
Seat 3: Juanchopb79 (small blind) folded before Flop
Seat 5: Rat1o (big blind) collected ($0.10)
Seat 6: RUMJO folded before Flop (didn't bet)



PokerStars Hand #222966792127:  Hold'em No Limit ($0.05/$0.10 USD) - 2021/01/23 14:36:06 ET
Table 'Stephano III' 6-max Seat #3 is the button
Seat 1: xiled90 ($19.34 in chips) 
Seat 2: teddyKK ($10 in chips) 
Seat 3: Juanchopb79 ($10.47 in chips) 
Seat 5: Rat1o ($24.40 in chips) 
Seat 6: RUMJO ($10.28 in chips) 
Rat1o: posts small blind $0.05
RUMJO: posts big blind $0.10
*** HOLE CARDS ***
swietek23 joins the table at seat #4 
xiled90: folds 
teddyKK: folds 
Juanchopb79: folds 
Rat1o: raises $0.20 to $0.30
RUMJO: folds 
Uncalled bet ($0.20) returned to Rat1o
Rat1o collected $0.20 from pot
Rat1o: doesn't show hand 
*** SUMMARY ***
Total pot $0.20 | Rake $0 
Seat 1: xiled90 folded before Flop (didn't bet)
Seat 2: teddyKK folded before Flop (didn't bet)
Seat 3: Juanchopb79 (button) folded before Flop (didn't bet)
Seat 5: Rat1o (small blind) collected ($0.20)
Seat 6: RUMJO (big blind) folded before Flop



PokerStars Hand #222966804184:  Hold'em No Limit ($0.05/$0.10 USD) - 2021/01/23 14:36:21 ET
Table 'Stephano III' 6-max Seat #5 is the button
Seat 1: xiled90 ($19.34 in chips) 
Seat 2: teddyKK ($10 in chips) 
Seat 3: Juanchopb79 ($10.47 in chips) 
Seat 5: Rat1o ($24.50 in chips) 
Seat 6: RUMJO ($10.18 in chips) 
RUMJO: posts small blind $0.05
xiled90: posts big blind $0.10
swietek23: sits out 
*** HOLE CARDS ***
teddyKK: folds 
Juanchopb79: folds 
Rat1o: folds 
RUMJO: folds 
Uncalled bet ($0.05) returned to xiled90
xiled90 collected $0.10 from pot
xiled90: doesn't show hand 
*** SUMMARY ***
Total pot $0.10 | Rake $0 
Seat 1: xiled90 (big blind) collected ($0.10)
Seat 2: teddyKK folded before Flop (didn't bet)
Seat 3: Juanchopb79 folded before Flop (didn't bet)
Seat 5: Rat1o (button) folded before Flop (didn't bet)
Seat 6: RUMJO (small blind) folded before Flop



PokerStars Hand #222966813115:  Hold'em No Limit ($0.05/$0.10 USD) - 2021/01/23 14:36:32 ET
Table 'Stephano III' 6-max Seat #6 is the button
Seat 1: xiled90 ($19.39 in chips) 
Seat 2: teddyKK ($10 in chips) 
Seat 3: Juanchopb79 ($10.47 in chips) 
Seat 5: Rat1o ($24.50 in chips) 
Seat 6: RUMJO ($10.13 in chips) 
xiled90: posts small blind $0.05
teddyKK: posts big blind $0.10
swietek23: sits out 
*** HOLE CARDS ***
swietek23 leaves the table
Juanchopb79: folds 
Rat1o: folds 
zeljkonovakov joins the table at seat #4 
RUMJO: folds 
xiled90: raises $0.20 to $0.30
teddyKK: folds 
Uncalled bet ($0.20) returned to xiled90
xiled90 collected $0.20 from pot
xiled90: doesn't show hand 
*** SUMMARY ***
Total pot $0.20 | Rake $0 
Seat 1: xiled90 (small blind) collected ($0.20)
Seat 2: teddyKK (big blind) folded before Flop
Seat 3: Juanchopb79 folded before Flop (didn't bet)
Seat 5: Rat1o folded before Flop (didn't bet)
Seat 6: RUMJO (button) folded before Flop (didn't bet)



PokerStars Hand #222966830589:  Hold'em No Limit ($0.05/$0.10 USD) - 2021/01/23 14:36:54 ET
Table 'Stephano III' 6-max Seat #1 is the button
Seat 1: xiled90 ($19.49 in chips) 
Seat 2: teddyKK ($10 in chips) 
Seat 3: Juanchopb79 ($10.47 in chips) 
Seat 5: Rat1o ($24.50 in chips) 
Seat 6: RUMJO ($10.13 in chips) 
teddyKK: posts small blind $0.05
Juanchopb79: posts big blind $0.10
zeljkonovakov: sits out 
*** HOLE CARDS ***
Rat1o: folds 
RUMJO: raises $0.15 to $0.25
xiled90: folds 
teddyKK: folds 
Juanchopb79: folds 
Uncalled bet ($0.15) returned to RUMJO
RUMJO collected $0.25 from pot
RUMJO: doesn't show hand 
*** SUMMARY ***
Total pot $0.25 | Rake $0 
Seat 1: xiled90 (button) folded before Flop (didn't bet)
Seat 2: teddyKK (small blind) folded before Flop
Seat 3: Juanchopb79 (big blind) folded before Flop
Seat 5: Rat1o folded before Flop (didn't bet)
Seat 6: RUMJO collected ($0.25)



PokerStars Hand #222966841111:  Hold'em No Limit ($0.05/$0.10 USD) - 2021/01/23 14:37:08 ET
Table 'Stephano III' 6-max Seat #2 is the button
Seat 1: xiled90 ($19.49 in chips) 
Seat 2: teddyKK ($10 in chips) 
Seat 3: Juanchopb79 ($10.37 in chips) 
Seat 4: zeljkonovakov ($4 in chips) 
Seat 5: Rat1o ($24.50 in chips) 
Seat 6: RUMJO ($10.28 in chips) 
Juanchopb79: posts small blind $0.05
zeljkonovakov: posts big blind $0.10
*** HOLE CARDS ***
Rat1o: folds 
RUMJO: folds 
xiled90: folds 
teddyKK: folds 
Juanchopb79: raises $0.20 to $0.30
zeljkonovakov: calls $0.20
*** FLOP *** [Qs Ks 6h]
Juanchopb79: bets $0.20
zeljkonovakov: folds 
Uncalled bet ($0.20) returned to Juanchopb79
Juanchopb79 collected $0.57 from pot
Juanchopb79: doesn't show hand 
*** SUMMARY ***
Total pot $0.60 | Rake $0.03 
Board [Qs Ks 6h]
Seat 1: xiled90 folded before Flop (didn't bet)
Seat 2: teddyKK (button) folded before Flop (didn't bet)
Seat 3: Juanchopb79 (small blind) collected ($0.57)
Seat 4: zeljkonovakov (big blind) folded on the Flop
Seat 5: Rat1o folded before Flop (didn't bet)
Seat 6: RUMJO folded before Flop (didn't bet)



PokerStars Hand #222966861206:  Hold'em No Limit ($0.05/$0.10 USD) - 2021/01/23 14:37:34 ET
Table 'Stephano III' 6-max Seat #3 is the button
Seat 1: xiled90 ($19.49 in chips) 
Seat 2: teddyKK ($10 in chips) 
Seat 3: Juanchopb79 ($10.64 in chips) 
Seat 4: zeljkonovakov ($3.70 in chips) 
Seat 5: Rat1o ($24.50 in chips) 
Seat 6: RUMJO ($10.28 in chips) 
zeljkonovakov: posts small blind $0.05
Rat1o: posts big blind $0.10
*** HOLE CARDS ***
RUMJO: folds 
xiled90: folds 
teddyKK: folds 
Juanchopb79: folds 
zeljkonovakov: calls $0.05
Rat1o: raises $0.30 to $0.40
zeljkonovakov: calls $0.30
*** FLOP *** [2c 3c 5h]
zeljkonovakov: checks 
Rat1o: bets $0.20
zeljkonovakov: calls $0.20
*** TURN *** [2c 3c 5h] [Td]
zeljkonovakov: bets $0.40
Rat1o: folds 
Uncalled bet ($0.40) returned to zeljkonovakov
zeljkonovakov collected $1.15 from pot
zeljkonovakov: doesn't show hand 
*** SUMMARY ***
Total pot $1.20 | Rake $0.05 
Board [2c 3c 5h Td]
Seat 1: xiled90 folded before Flop (didn't bet)
Seat 2: teddyKK folded before Flop (didn't bet)
Seat 3: Juanchopb79 (button) folded before Flop (didn't bet)
Seat 4: zeljkonovakov (small blind) collected ($1.15)
Seat 5: Rat1o (big blind) folded on the Turn
Seat 6: RUMJO folded before Flop (didn't bet)



PokerStars Hand #222966886742:  Hold'em No Limit ($0.05/$0.10 USD) - 2021/01/23 14:38:06 ET
Table 'Stephano III' 6-max Seat #4 is the button
Seat 1: xiled90 ($19.49 in chips) 
Seat 2: teddyKK ($10 in chips) 
Seat 3: Juanchopb79 ($10.64 in chips) 
Seat 4: zeljkonovakov ($4.25 in chips) 
Seat 5: Rat1o ($23.90 in chips) 
Seat 6: RUMJO ($10.28 in chips) 
Rat1o: posts small blind $0.05
RUMJO: posts big blind $0.10
*** HOLE CARDS ***
xiled90: folds 
teddyKK: folds 
Juanchopb79: folds 
zeljkonovakov: raises $0.50 to $0.60
Rat1o: folds 
RUMJO: folds 
Uncalled bet ($0.50) returned to zeljkonovakov
zeljkonovakov collected $0.25 from pot
zeljkonovakov: doesn't show hand 
*** SUMMARY ***
Total pot $0.25 | Rake $0 
Seat 1: xiled90 folded before Flop (didn't bet)
Seat 2: teddyKK folded before Flop (didn't bet)
Seat 3: Juanchopb79 folded before Flop (didn't bet)
Seat 4: zeljkonovakov (button) collected ($0.25)
Seat 5: Rat1o (small blind) folded before Flop
Seat 6: RUMJO (big blind) folded before Flop



PokerStars Hand #222966897870:  Hold'em No Limit ($0.05/$0.10 USD) - 2021/01/23 14:38:21 ET
Table 'Stephano III' 6-max Seat #5 is the button
Seat 2: teddyKK ($10 in chips) 
Seat 3: Juanchopb79 ($10.64 in chips) 
Seat 4: zeljkonovakov ($4.40 in chips) 
Seat 5: Rat1o ($23.85 in chips) 
Seat 6: RUMJO ($10.18 in chips) 
RUMJO: posts small blind $0.05
xiled90: is sitting out 
xiled90 leaves the table
teddyKK: posts big blind $0.10
*** HOLE CARDS ***
Juanchopb79: folds 
zeljkonovakov: raises $0.10 to $0.20
Rat1o: folds 
RUMJO: folds 
SenorDottore joins the table at seat #1 
teddyKK: folds 
Uncalled bet ($0.10) returned to zeljkonovakov
zeljkonovakov collected $0.25 from pot
*** SUMMARY ***
Total pot $0.25 | Rake $0 
Seat 2: teddyKK (big blind) folded before Flop
Seat 3: Juanchopb79 folded before Flop (didn't bet)
Seat 4: zeljkonovakov collected ($0.25)
Seat 5: Rat1o (button) folded before Flop (didn't bet)
Seat 6: RUMJO (small blind) folded before Flop



PokerStars Hand #222966907375:  Hold'em No Limit ($0.05/$0.10 USD) - 2021/01/23 14:38:32 ET
Table 'Stephano III' 6-max Seat #6 is the button
Seat 2: teddyKK ($10 in chips) 
Seat 3: Juanchopb79 ($10.64 in chips) 
Seat 4: zeljkonovakov ($4.55 in chips) 
Seat 5: Rat1o ($23.85 in chips) 
Seat 6: RUMJO ($10.13 in chips) 
teddyKK: posts small blind $0.05
Juanchopb79: posts big blind $0.10
*** HOLE CARDS ***
zeljkonovakov: raises $0.10 to $0.20
Rat1o: folds 
RUMJO: folds 
teddyKK: folds 
Juanchopb79: folds 
Uncalled bet ($0.10) returned to zeljkonovakov
zeljkonovakov collected $0.25 from pot
zeljkonovakov: doesn't show hand 
*** SUMMARY ***
Total pot $0.25 | Rake $0 
Seat 2: teddyKK (small blind) folded before Flop
Seat 3: Juanchopb79 (big blind) folded before Flop
Seat 4: zeljkonovakov collected ($0.25)
Seat 5: Rat1o folded before Flop (didn't bet)
Seat 6: RUMJO (button) folded before Flop (didn't bet)



PokerStars Hand #222966920483:  Hold'em No Limit ($0.05/$0.10 USD) - 2021/01/23 14:38:50 ET
Table 'Stephano III' 6-max Seat #2 is the button
Seat 2: teddyKK ($10 in chips) 
Seat 3: Juanchopb79 ($10.54 in chips) 
Seat 4: zeljkonovakov ($4.70 in chips) 
Seat 5: Rat1o ($23.85 in chips) 
Seat 6: RUMJO ($10.13 in chips) 
Juanchopb79: posts small blind $0.05
zeljkonovakov: posts big blind $0.10
SenorDottore: sits out 
*** HOLE CARDS ***
Rat1o: raises $0.20 to $0.30
RUMJO: folds 
teddyKK: calls $0.30
Juanchopb79: folds 
zeljkonovakov: raises $0.20 to $0.50
Rat1o: calls $0.20
teddyKK: calls $0.20
*** FLOP *** [Ts 6h 4s]
zeljkonovakov: checks 
Rat1o: bets $0.80
teddyKK: calls $0.80
zeljkonovakov: folds 
*** TURN *** [Ts 6h 4s] [Th]
Rat1o: checks 
teddyKK: bets $2
Rat1o: calls $2
*** RIVER *** [Ts 6h 4s Th] [3c]
Rat1o: checks 
teddyKK: bets $6.70 and is all-in
Rat1o: calls $6.70
*** SHOW DOWN ***
teddyKK: shows [Js 9s] (a pair of Tens)
Rat1o: shows [Qs Td] (three of a kind, Tens)
Rat1o collected $19.63 from pot
*** SUMMARY ***
Total pot $20.55 | Rake $0.92 
Board [Ts 6h 4s Th 3c]
Seat 2: teddyKK (button) showed [Js 9s] and lost with a pair of Tens
Seat 3: Juanchopb79 (small blind) folded before Flop
Seat 4: zeljkonovakov (big blind) folded on the Flop
Seat 5: Rat1o showed [Qs Td] and won ($19.63) with three of a kind, Tens
Seat 6: RUMJO folded before Flop (didn't bet)



PokerStars Hand #222966992073:  Hold'em No Limit ($0.05/$0.10 USD) - 2021/01/23 14:40:21 ET
Table 'Stephano III' 6-max Seat #3 is the button
Seat 2: teddyKK ($10 in chips) 
Seat 3: Juanchopb79 ($10.49 in chips) 
Seat 4: zeljkonovakov ($4.20 in chips) 
Seat 5: Rat1o ($33.48 in chips) 
Seat 6: RUMJO ($10.13 in chips) 
zeljkonovakov: posts small blind $0.05
Rat1o: posts big blind $0.10
SenorDottore: sits out 
*** HOLE CARDS ***
RUMJO: folds 
teddyKK: raises $0.20 to $0.30
Juanchopb79: raises $0.60 to $0.90
zeljkonovakov: folds 
Rat1o: folds 
teddyKK: calls $0.60
*** FLOP *** [2h Qd 2c]
teddyKK: checks 
Juanchopb79: bets $0.93
teddyKK: folds 
Uncalled bet ($0.93) returned to Juanchopb79
Juanchopb79 collected $1.86 from pot
*** SUMMARY ***
Total pot $1.95 | Rake $0.09 
Board [2h Qd 2c]
Seat 2: teddyKK folded on the Flop
Seat 3: Juanchopb79 (button) collected ($1.86)
Seat 4: zeljkonovakov (small blind) folded before Flop
Seat 5: Rat1o (big blind) folded before Flop
Seat 6: RUMJO folded before Flop (didn't bet)



PokerStars Hand #222967020698:  Hold'em No Limit ($0.05/$0.10 USD) - 2021/01/23 14:40:58 ET
Table 'Stephano III' 6-max Seat #4 is the button
Seat 2: teddyKK ($10 in chips) 
Seat 3: Juanchopb79 ($11.45 in chips) 
Seat 4: zeljkonovakov ($4.15 in chips) 
Seat 5: Rat1o ($33.38 in chips) 
Seat 6: RUMJO ($10.13 in chips) 
Rat1o: posts small blind $0.05
RUMJO: posts big blind $0.10
SenorDottore: sits out 
*** HOLE CARDS ***
teddyKK: folds 
Juanchopb79: folds 
zeljkonovakov: calls $0.10
Rat1o: folds 
RUMJO: checks 
*** FLOP *** [2s 4c As]
RUMJO: checks 
zeljkonovakov: bets $0.40
RUMJO: folds 
Uncalled bet ($0.40) returned to zeljkonovakov
zeljkonovakov collected $0.24 from pot
zeljkonovakov: doesn't show hand 
*** SUMMARY ***
Total pot $0.25 | Rake $0.01 
Board [2s 4c As]
Seat 2: teddyKK folded before Flop (didn't bet)
Seat 3: Juanchopb79 folded before Flop (didn't bet)
Seat 4: zeljkonovakov (button) collected ($0.24)
Seat 5: Rat1o (small blind) folded before Flop
Seat 6: RUMJO (big blind) folded on the Flop



PokerStars Hand #222967045565:  Hold'em No Limit ($0.05/$0.10 USD) - 2021/01/23 14:41:29 ET
Table 'Stephano III' 6-max Seat #5 is the button
Seat 1: SenorDottore ($10 in chips) 
Seat 2: teddyKK ($10 in chips) 
Seat 3: Juanchopb79 ($11.45 in chips) 
Seat 4: zeljkonovakov ($4.29 in chips) 
Seat 5: Rat1o ($33.33 in chips) 
Seat 6: RUMJO ($10.03 in chips) 
RUMJO: posts small blind $0.05
SenorDottore: posts big blind $0.10
*** HOLE CARDS ***
teddyKK: folds 
Juanchopb79: folds 
zeljkonovakov: raises $0.10 to $0.20
Rat1o: folds 
RUMJO: folds 
SenorDottore: calls $0.10
*** FLOP *** [Jh 2s 4s]
SenorDottore: checks 
zeljkonovakov: bets $0.20
SenorDottore: folds 
Uncalled bet ($0.20) returned to zeljkonovakov
zeljkonovakov collected $0.43 from pot
zeljkonovakov: doesn't show hand 
*** SUMMARY ***
Total pot $0.45 | Rake $0.02 
Board [Jh 2s 4s]
Seat 1: SenorDottore (big blind) folded on the Flop
Seat 2: teddyKK folded before Flop (didn't bet)
Seat 3: Juanchopb79 folded before Flop (didn't bet)
Seat 4: zeljkonovakov collected ($0.43)
Seat 5: Rat1o (button) folded before Flop (didn't bet)
Seat 6: RUMJO (small blind) folded before Flop



PokerStars Hand #222967061901:  Hold'em No Limit ($0.05/$0.10 USD) - 2021/01/23 14:41:50 ET
Table 'Stephano III' 6-max Seat #6 is the button
Seat 1: SenorDottore ($10 in chips) 
Seat 2: teddyKK ($10 in chips) 
Seat 3: Juanchopb79 ($11.45 in chips) 
Seat 4: zeljkonovakov ($4.52 in chips) 
Seat 5: Rat1o ($33.33 in chips) 
Seat 6: RUMJO ($9.98 in chips) 
SenorDottore: posts small blind $0.05
teddyKK: posts big blind $0.10
*** HOLE CARDS ***
Juanchopb79: folds 
zeljkonovakov: raises $0.40 to $0.50
Rat1o: folds 
RUMJO: folds 
SenorDottore: folds 
teddyKK: folds 
Uncalled bet ($0.40) returned to zeljkonovakov
zeljkonovakov collected $0.25 from pot
zeljkonovakov: doesn't show hand 
*** SUMMARY ***
Total pot $0.25 | Rake $0 
Seat 1: SenorDottore (small blind) folded before Flop
Seat 2: teddyKK (big blind) folded before Flop
Seat 3: Juanchopb79 folded before Flop (didn't bet)
Seat 4: zeljkonovakov collected ($0.25)
Seat 5: Rat1o folded before Flop (didn't bet)
Seat 6: RUMJO (button) folded before Flop (didn't bet)



PokerStars Hand #222967078917:  Hold'em No Limit ($0.05/$0.10 USD) - 2021/01/23 14:42:12 ET
Table 'Stephano III' 6-max Seat #1 is the button
Seat 1: SenorDottore ($10 in chips) 
Seat 2: teddyKK ($10 in chips) 
Seat 3: Juanchopb79 ($11.45 in chips) 
Seat 4: zeljkonovakov ($4.67 in chips) 
Seat 5: Rat1o ($33.33 in chips) 
Seat 6: RUMJO ($9.98 in chips) 
teddyKK: posts small blind $0.05
Juanchopb79: posts big blind $0.10
*** HOLE CARDS ***
zeljkonovakov: raises $0.30 to $0.40
Rat1o: folds 
RUMJO: folds 
SenorDottore: raises $0.70 to $1.10
teddyKK: folds 
Juanchopb79: folds 
zeljkonovakov: calls $0.70
*** FLOP *** [7d Jc Jh]
zeljkonovakov: checks 
SenorDottore: bets $0.74
zeljkonovakov: calls $0.74
*** TURN *** [7d Jc Jh] [3h]
zeljkonovakov: checks 
SenorDottore: bets $1.21
zeljkonovakov: calls $1.21
*** RIVER *** [7d Jc Jh 3h] [5c]
zeljkonovakov: checks 
SenorDottore: checks 
*** SHOW DOWN ***
zeljkonovakov: shows [Ac Tc] (a pair of Jacks)
SenorDottore: shows [Th Ah] (a pair of Jacks)
zeljkonovakov collected $2.99 from pot
SenorDottore collected $2.98 from pot
*** SUMMARY ***
Total pot $6.25 | Rake $0.28 
Board [7d Jc Jh 3h 5c]
Seat 1: SenorDottore (button) showed [Th Ah] and won ($2.98) with a pair of Jacks
Seat 2: teddyKK (small blind) folded before Flop
Seat 3: Juanchopb79 (big blind) folded before Flop
Seat 4: zeljkonovakov showed [Ac Tc] and won ($2.99) with a pair of Jacks
Seat 5: Rat1o folded before Flop (didn't bet)
Seat 6: RUMJO folded before Flop (didn't bet)



PokerStars Hand #222967118301:  Hold'em No Limit ($0.05/$0.10 USD) - 2021/01/23 14:43:02 ET
Table 'Stephano III' 6-max Seat #2 is the button
Seat 1: SenorDottore ($10 in chips) 
Seat 2: teddyKK ($10 in chips) 
Seat 3: Juanchopb79 ($11.35 in chips) 
Seat 4: zeljkonovakov ($4.61 in chips) 
Seat 5: Rat1o ($33.33 in chips) 
Seat 6: RUMJO ($9.98 in chips) 
Juanchopb79: posts small blind $0.05
zeljkonovakov: posts big blind $0.10
*** HOLE CARDS ***
Rat1o: folds 
RUMJO: folds 
SenorDottore: folds 
teddyKK: folds 
Juanchopb79: folds 
Uncalled bet ($0.05) returned to zeljkonovakov
zeljkonovakov collected $0.10 from pot
zeljkonovakov: doesn't show hand 
*** SUMMARY ***
Total pot $0.10 | Rake $0 
Seat 1: SenorDottore folded before Flop (didn't bet)
Seat 2: teddyKK (button) folded before Flop (didn't bet)
Seat 3: Juanchopb79 (small blind) folded before Flop
Seat 4: zeljkonovakov (big blind) collected ($0.10)
Seat 5: Rat1o folded before Flop (didn't bet)
Seat 6: RUMJO folded before Flop (didn't bet)



PokerStars Hand #222967130437:  Hold'em No Limit ($0.05/$0.10 USD) - 2021/01/23 14:43:18 ET
Table 'Stephano III' 6-max Seat #3 is the button
Seat 1: SenorDottore ($10 in chips) 
Seat 2: teddyKK ($10 in chips) 
Seat 3: Juanchopb79 ($11.30 in chips) 
Seat 4: zeljkonovakov ($4.66 in chips) 
Seat 5: Rat1o ($33.33 in chips) 
Seat 6: RUMJO ($9.98 in chips) 
zeljkonovakov: posts small blind $0.05
Rat1o: posts big blind $0.10
*** HOLE CARDS ***
RUMJO: folds 
SenorDottore: folds 
teddyKK: folds 
Juanchopb79: raises $0.15 to $0.25
zeljkonovakov: raises $0.15 to $0.40
Rat1o: folds 
Juanchopb79: calls $0.15
*** FLOP *** [4c Jd Qs]
zeljkonovakov: bets $0.40
Juanchopb79: folds 
Uncalled bet ($0.40) returned to zeljkonovakov
zeljkonovakov collected $0.86 from pot
*** SUMMARY ***
Total pot $0.90 | Rake $0.04 
Board [4c Jd Qs]
Seat 1: SenorDottore folded before Flop (didn't bet)
Seat 2: teddyKK folded before Flop (didn't bet)
Seat 3: Juanchopb79 (button) folded on the Flop
Seat 4: zeljkonovakov (small blind) collected ($0.86)
Seat 5: Rat1o (big blind) folded before Flop
Seat 6: RUMJO folded before Flop (didn't bet)



PokerStars Hand #222967158418:  Hold'em No Limit ($0.05/$0.10 USD) - 2021/01/23 14:43:54 ET
Table 'Stephano III' 6-max Seat #4 is the button
Seat 1: SenorDottore ($10 in chips) 
Seat 2: teddyKK ($10 in chips) 
Seat 3: Juanchopb79 ($10.90 in chips) 
Seat 4: zeljkonovakov ($5.12 in chips) 
Seat 5: Rat1o ($33.23 in chips) 
Seat 6: RUMJO ($9.98 in chips) 
Rat1o: posts small blind $0.05
RUMJO: posts big blind $0.10
*** HOLE CARDS ***
SenorDottore: folds 
teddyKK: folds 
Juanchopb79: folds 
zeljkonovakov: raises $0.10 to $0.20
Rat1o: folds 
RUMJO: folds 
Uncalled bet ($0.10) returned to zeljkonovakov
zeljkonovakov collected $0.25 from pot
*** SUMMARY ***
Total pot $0.25 | Rake $0 
Seat 1: SenorDottore folded before Flop (didn't bet)
Seat 2: teddyKK folded before Flop (didn't bet)
Seat 3: Juanchopb79 folded before Flop (didn't bet)
Seat 4: zeljkonovakov (button) collected ($0.25)
Seat 5: Rat1o (small blind) folded before Flop
Seat 6: RUMJO (big blind) folded before Flop



PokerStars Hand #222967175101:  Hold'em No Limit ($0.05/$0.10 USD) - 2021/01/23 14:44:15 ET
Table 'Stephano III' 6-max Seat #5 is the button
Seat 1: SenorDottore ($10 in chips) 
Seat 2: teddyKK ($10 in chips) 
Seat 3: Juanchopb79 ($10.90 in chips) 
Seat 4: zeljkonovakov ($5.27 in chips) 
Seat 5: Rat1o ($33.18 in chips) 
Seat 6: RUMJO ($9.88 in chips) 
RUMJO: posts small blind $0.05
SenorDottore: posts big blind $0.10
*** HOLE CARDS ***
teddyKK: raises $0.20 to $0.30
Juanchopb79: folds 
zeljkonovakov: folds 
zeljkonovakov leaves the table
Rat1o: folds 
RUMJO: folds 
SenorDottore: calls $0.20
*** FLOP *** [3c 8c Kd]
PhilJahnz joins the table at seat #4 
SenorDottore: checks 
PhilJahnz leaves the table
naroyb joins the table at seat #4 
teddyKK: checks 
*** TURN *** [3c 8c Kd] [2c]
SenorDottore: checks 
teddyKK: checks 
*** RIVER *** [3c 8c Kd 2c] [Ad]
SenorDottore: checks 
teddyKK: bets $0.40
SenorDottore: folds 
Uncalled bet ($0.40) returned to teddyKK
teddyKK collected $0.62 from pot
teddyKK: doesn't show hand 
*** SUMMARY ***
Total pot $0.65 | Rake $0.03 
Board [3c 8c Kd 2c Ad]
Seat 1: SenorDottore (big blind) folded on the River
Seat 2: teddyKK collected ($0.62)
Seat 3: Juanchopb79 folded before Flop (didn't bet)
Seat 4: zeljkonovakov folded before Flop (didn't bet)
Seat 5: Rat1o (button) folded before Flop (didn't bet)
Seat 6: RUMJO (small blind) folded before Flop



PokerStars Hand #222967216219:  Hold'em No Limit ($0.05/$0.10 USD) - 2021/01/23 14:45:08 ET
Table 'Stephano III' 6-max Seat #6 is the button
Seat 1: SenorDottore ($10 in chips) 
Seat 2: teddyKK ($10.32 in chips) 
Seat 3: Juanchopb79 ($10.90 in chips) 
Seat 5: Rat1o ($33.18 in chips) 
Seat 6: RUMJO ($9.83 in chips) 
SenorDottore: posts small blind $0.05
teddyKK: posts big blind $0.10
naroyb: sits out 
*** HOLE CARDS ***
Juanchopb79: folds 
Rat1o: raises $0.20 to $0.30
RUMJO: folds 
SenorDottore: folds 
teddyKK: folds 
Uncalled bet ($0.20) returned to Rat1o
Rat1o collected $0.25 from pot
Rat1o: doesn't show hand 
*** SUMMARY ***
Total pot $0.25 | Rake $0 
Seat 1: SenorDottore (small blind) folded before Flop
Seat 2: teddyKK (big blind) folded before Flop
Seat 3: Juanchopb79 folded before Flop (didn't bet)
Seat 5: Rat1o collected ($0.25)
Seat 6: RUMJO (button) folded before Flop (didn't bet)



PokerStars Hand #222967229206:  Hold'em No Limit ($0.05/$0.10 USD) - 2021/01/23 14:45:24 ET
Table 'Stephano III' 6-max Seat #1 is the button
Seat 1: SenorDottore ($10 in chips) 
Seat 2: teddyKK ($10.22 in chips) 
Seat 3: Juanchopb79 ($10.90 in chips) 
Seat 5: Rat1o ($33.33 in chips) 
Seat 6: RUMJO ($9.83 in chips) 
teddyKK: posts small blind $0.05
Juanchopb79: posts big blind $0.10
naroyb: sits out 
*** HOLE CARDS ***
Rat1o: folds 
RUMJO: raises $0.15 to $0.25
SenorDottore: folds 
teddyKK: folds 
Juanchopb79: folds 
Uncalled bet ($0.15) returned to RUMJO
RUMJO collected $0.25 from pot
RUMJO: doesn't show hand 
*** SUMMARY ***
Total pot $0.25 | Rake $0 
Seat 1: SenorDottore (button) folded before Flop (didn't bet)
Seat 2: teddyKK (small blind) folded before Flop
Seat 3: Juanchopb79 (big blind) folded before Flop
Seat 5: Rat1o folded before Flop (didn't bet)
Seat 6: RUMJO collected ($0.25)



PokerStars Hand #222967237588:  Hold'em No Limit ($0.05/$0.10 USD) - 2021/01/23 14:45:35 ET
Table 'Stephano III' 6-max Seat #2 is the button
Seat 1: SenorDottore ($10 in chips) 
Seat 2: teddyKK ($10.17 in chips) 
Seat 3: Juanchopb79 ($10.80 in chips) 
Seat 4: naroyb ($10 in chips) 
Seat 5: Rat1o ($33.33 in chips) 
Seat 6: RUMJO ($9.98 in chips) 
Juanchopb79: posts small blind $0.05
naroyb: posts big blind $0.10
*** HOLE CARDS ***
Rat1o: folds 
RUMJO: folds 
SenorDottore: folds 
teddyKK: folds 
Juanchopb79: folds 
Uncalled bet ($0.05) returned to naroyb
naroyb collected $0.10 from pot
naroyb: doesn't show hand 
*** SUMMARY ***
Total pot $0.10 | Rake $0 
Seat 1: SenorDottore folded before Flop (didn't bet)
Seat 2: teddyKK (button) folded before Flop (didn't bet)
Seat 3: Juanchopb79 (small blind) folded before Flop
Seat 4: naroyb (big blind) collected ($0.10)
Seat 5: Rat1o folded before Flop (didn't bet)
Seat 6: RUMJO folded before Flop (didn't bet)



PokerStars Hand #222967251851:  Hold'em No Limit ($0.05/$0.10 USD) - 2021/01/23 14:45:53 ET
Table 'Stephano III' 6-max Seat #3 is the button
Seat 1: SenorDottore ($10 in chips) 
Seat 2: teddyKK ($10.17 in chips) 
Seat 3: Juanchopb79 ($10.75 in chips) 
Seat 4: naroyb ($10.05 in chips) 
Seat 6: RUMJO ($9.98 in chips) 
naroyb: posts small blind $0.05
Rat1o: is sitting out 
RUMJO: posts big blind $0.10
*** HOLE CARDS ***
SenorDottore: raises $0.15 to $0.25
teddyKK: calls $0.25
Juanchopb79: folds 
naroyb: folds 
RUMJO: calls $0.15
*** FLOP *** [Jh 3s 7h]
RUMJO: checks 
SenorDottore: checks 
teddyKK: checks 
*** TURN *** [Jh 3s 7h] [3c]
RUMJO: checks 
SenorDottore: checks 
teddyKK: bets $0.40
RUMJO: folds 
SenorDottore: folds 
Uncalled bet ($0.40) returned to teddyKK
teddyKK collected $0.76 from pot
teddyKK: doesn't show hand 
*** SUMMARY ***
Total pot $0.80 | Rake $0.04 
Board [Jh 3s 7h 3c]
Seat 1: SenorDottore folded on the Turn
Seat 2: teddyKK collected ($0.76)
Seat 3: Juanchopb79 (button) folded before Flop (didn't bet)
Seat 4: naroyb (small blind) folded before Flop
Seat 6: RUMJO (big blind) folded on the Turn



PokerStars Hand #222967291607:  Hold'em No Limit ($0.05/$0.10 USD) - 2021/01/23 14:46:45 ET
Table 'Stephano III' 6-max Seat #4 is the button
Seat 1: SenorDottore ($10 in chips) 
Seat 2: teddyKK ($10.68 in chips) 
Seat 3: Juanchopb79 ($10.75 in chips) 
Seat 4: naroyb ($10 in chips) 
Seat 6: RUMJO ($9.73 in chips) 
RUMJO: posts small blind $0.05
SenorDottore: posts big blind $0.10
*** HOLE CARDS ***
teddyKK: folds 
Juanchopb79: raises $0.20 to $0.30
naroyb: calls $0.30
RUMJO: folds 
SenorDottore: folds 
*** FLOP *** [6s 6c 9d]
Juanchopb79: bets $0.36
naroyb: calls $0.36
*** TURN *** [6s 6c 9d] [Ts]
Juanchopb79: checks 
naroyb: bets $0.70
Juanchopb79: folds 
Uncalled bet ($0.70) returned to naroyb
naroyb collected $1.40 from pot
naroyb: doesn't show hand 
*** SUMMARY ***
Total pot $1.47 | Rake $0.07 
Board [6s 6c 9d Ts]
Seat 1: SenorDottore (big blind) folded before Flop
Seat 2: teddyKK folded before Flop (didn't bet)
Seat 3: Juanchopb79 folded on the Turn
Seat 4: naroyb (button) collected ($1.40)
Seat 6: RUMJO (small blind) folded before Flop



PokerStars Hand #222967331409:  Hold'em No Limit ($0.05/$0.10 USD) - 2021/01/23 14:47:36 ET
Table 'Stephano III' 6-max Seat #6 is the button
Seat 1: SenorDottore ($10 in chips) 
Seat 2: teddyKK ($10.68 in chips) 
Seat 3: Juanchopb79 ($10.09 in chips) 
Seat 4: naroyb ($10.74 in chips) 
Seat 6: RUMJO ($9.68 in chips) 
SenorDottore: posts small blind $0.05
teddyKK: posts big blind $0.10
Rat1o: sits out 
*** HOLE CARDS ***
Juanchopb79: raises $0.20 to $0.30
naroyb: folds 
RUMJO has timed out
RUMJO: folds 
SenorDottore: folds 
teddyKK: folds 
Uncalled bet ($0.20) returned to Juanchopb79
Juanchopb79 collected $0.25 from pot
Juanchopb79: doesn't show hand 
*** SUMMARY ***
Total pot $0.25 | Rake $0 
Seat 1: SenorDottore (small blind) folded before Flop
Seat 2: teddyKK (big blind) folded before Flop
Seat 3: Juanchopb79 collected ($0.25)
Seat 4: naroyb folded before Flop (didn't bet)
Seat 6: RUMJO (button) folded before Flop (didn't bet)



PokerStars Hand #222967356742:  Hold'em No Limit ($0.05/$0.10 USD) - 2021/01/23 14:48:09 ET
Table 'Stephano III' 6-max Seat #1 is the button
Seat 1: SenorDottore ($10 in chips) 
Seat 2: teddyKK ($10.58 in chips) 
Seat 3: Juanchopb79 ($10.24 in chips) 
Seat 4: naroyb ($10.74 in chips) 
Seat 6: RUMJO ($9.68 in chips) 
teddyKK: posts small blind $0.05
Juanchopb79: posts big blind $0.10
Rat1o: sits out 
*** HOLE CARDS ***
naroyb: folds 
RUMJO: folds 
SenorDottore: raises $0.20 to $0.30
teddyKK: folds 
Juanchopb79: calls $0.20
*** FLOP *** [5h 2h Ah]
Juanchopb79: checks 
SenorDottore: bets $0.31
Juanchopb79: folds 
Uncalled bet ($0.31) returned to SenorDottore
SenorDottore collected $0.62 from pot
*** SUMMARY ***
Total pot $0.65 | Rake $0.03 
Board [5h 2h Ah]
Seat 1: SenorDottore (button) collected ($0.62)
Seat 2: teddyKK (small blind) folded before Flop
Seat 3: Juanchopb79 (big blind) folded on the Flop
Seat 4: naroyb folded before Flop (didn't bet)
Seat 6: RUMJO folded before Flop (didn't bet)



PokerStars Hand #222967387689:  Hold'em No Limit ($0.05/$0.10 USD) - 2021/01/23 14:48:49 ET
Table 'Stephano III' 6-max Seat #2 is the button
Seat 1: SenorDottore ($10.32 in chips) 
Seat 2: teddyKK ($10.53 in chips) 
Seat 3: Juanchopb79 ($10 in chips) 
Seat 4: naroyb ($10.74 in chips) 
Seat 6: RUMJO ($9.68 in chips) 
Juanchopb79: posts small blind $0.05
naroyb: posts big blind $0.10
Rat1o: sits out 
*** HOLE CARDS ***
RUMJO: folds 
SenorDottore: raises $0.15 to $0.25
teddyKK: folds 
Juanchopb79: folds 
naroyb: folds 
Uncalled bet ($0.15) returned to SenorDottore
SenorDottore collected $0.25 from pot
*** SUMMARY ***
Total pot $0.25 | Rake $0 
Seat 1: SenorDottore collected ($0.25)
Seat 2: teddyKK (button) folded before Flop (didn't bet)
Seat 3: Juanchopb79 (small blind) folded before Flop
Seat 4: naroyb (big blind) folded before Flop
Seat 6: RUMJO folded before Flop (didn't bet)



PokerStars Hand #222967400838:  Hold'em No Limit ($0.05/$0.10 USD) - 2021/01/23 14:49:06 ET
Table 'Stephano III' 6-max Seat #3 is the button
Seat 1: SenorDottore ($10.47 in chips) 
Seat 2: teddyKK ($10.53 in chips) 
Seat 3: Juanchopb79 ($10 in chips) 
Seat 4: naroyb ($10.64 in chips) 
Seat 5: Rat1o ($33.33 in chips) 
Seat 6: RUMJO ($9.68 in chips) 
naroyb: posts small blind $0.05
Rat1o: posts big blind $0.10
*** HOLE CARDS ***
RUMJO: folds 
SenorDottore: folds 
teddyKK: folds 
Juanchopb79: raises $0.15 to $0.25
naroyb: folds 
Rat1o: folds 
Uncalled bet ($0.15) returned to Juanchopb79
Juanchopb79 collected $0.25 from pot
Juanchopb79: doesn't show hand 
*** SUMMARY ***
Total pot $0.25 | Rake $0 
Seat 1: SenorDottore folded before Flop (didn't bet)
Seat 2: teddyKK folded before Flop (didn't bet)
Seat 3: Juanchopb79 (button) collected ($0.25)
Seat 4: naroyb (small blind) folded before Flop
Seat 5: Rat1o (big blind) folded before Flop
Seat 6: RUMJO folded before Flop (didn't bet)



PokerStars Hand #222967412088:  Hold'em No Limit ($0.05/$0.10 USD) - 2021/01/23 14:49:20 ET
Table 'Stephano III' 6-max Seat #4 is the button
Seat 1: SenorDottore ($10.47 in chips) 
Seat 2: teddyKK ($10.53 in chips) 
Seat 3: Juanchopb79 ($10.15 in chips) 
Seat 4: naroyb ($10.59 in chips) 
Seat 5: Rat1o ($33.23 in chips) 
Seat 6: RUMJO ($9.68 in chips) 
Rat1o: posts small blind $0.05
RUMJO: posts big blind $0.10
*** HOLE CARDS ***
SenorDottore: folds 
teddyKK: folds 
Juanchopb79: folds 
naroyb: raises $0.10 to $0.20
Rat1o: folds 
RUMJO: calls $0.10
*** FLOP *** [4c Js 8s]
RUMJO: checks 
naroyb: bets $0.22
RUMJO: folds 
Uncalled bet ($0.22) returned to naroyb
naroyb collected $0.43 from pot
naroyb: doesn't show hand 
*** SUMMARY ***
Total pot $0.45 | Rake $0.02 
Board [4c Js 8s]
Seat 1: SenorDottore folded before Flop (didn't bet)
Seat 2: teddyKK folded before Flop (didn't bet)
Seat 3: Juanchopb79 folded before Flop (didn't bet)
Seat 4: naroyb (button) collected ($0.43)
Seat 5: Rat1o (small blind) folded before Flop
Seat 6: RUMJO (big blind) folded on the Flop



PokerStars Hand #222967429786:  Hold'em No Limit ($0.05/$0.10 USD) - 2021/01/23 14:49:43 ET
Table 'Stephano III' 6-max Seat #5 is the button
Seat 1: SenorDottore ($10.47 in chips) 
Seat 2: teddyKK ($10.53 in chips) 
Seat 3: Juanchopb79 ($10.15 in chips) 
Seat 4: naroyb ($10.82 in chips) 
Seat 5: Rat1o ($33.18 in chips) 
Seat 6: RUMJO ($9.48 in chips) 
RUMJO: posts small blind $0.05
SenorDottore: posts big blind $0.10
*** HOLE CARDS ***
teddyKK: raises $0.20 to $0.30
Juanchopb79: folds 
naroyb: folds 
Rat1o: folds 
RUMJO: folds 
SenorDottore: folds 
Uncalled bet ($0.20) returned to teddyKK
teddyKK collected $0.25 from pot
teddyKK: doesn't show hand 
*** SUMMARY ***
Total pot $0.25 | Rake $0 
Seat 1: SenorDottore (big blind) folded before Flop
Seat 2: teddyKK collected ($0.25)
Seat 3: Juanchopb79 folded before Flop (didn't bet)
Seat 4: naroyb folded before Flop (didn't bet)
Seat 5: Rat1o (button) folded before Flop (didn't bet)
Seat 6: RUMJO (small blind) folded before Flop



PokerStars Hand #222967436857:  Hold'em No Limit ($0.05/$0.10 USD) - 2021/01/23 14:49:52 ET
Table 'Stephano III' 6-max Seat #6 is the button
Seat 1: SenorDottore ($10.37 in chips) 
Seat 2: teddyKK ($10.68 in chips) 
Seat 3: Juanchopb79 ($10.15 in chips) 
Seat 4: naroyb ($10.82 in chips) 
Seat 5: Rat1o ($33.18 in chips) 
Seat 6: RUMJO ($9.43 in chips) 
SenorDottore: posts small blind $0.05
teddyKK: posts big blind $0.10
*** HOLE CARDS ***
Juanchopb79: raises $0.20 to $0.30
naroyb: calls $0.30
Rat1o: folds 
RUMJO: folds 
SenorDottore: folds 
teddyKK: folds 
*** FLOP *** [8c 6s 7s]
Juanchopb79: checks 
naroyb: checks 
*** TURN *** [8c 6s 7s] [9h]
Juanchopb79: checks 
naroyb: checks 
*** RIVER *** [8c 6s 7s 9h] [Kc]
Juanchopb79: checks 
naroyb: checks 
*** SHOW DOWN ***
Juanchopb79: shows [Kd Jd] (a pair of Kings)
naroyb: mucks hand 
Juanchopb79 collected $0.72 from pot
*** SUMMARY ***
Total pot $0.75 | Rake $0.03 
Board [8c 6s 7s 9h Kc]
Seat 1: SenorDottore (small blind) folded before Flop
Seat 2: teddyKK (big blind) folded before Flop
Seat 3: Juanchopb79 showed [Kd Jd] and won ($0.72) with a pair of Kings
Seat 4: naroyb mucked
Seat 5: Rat1o folded before Flop (didn't bet)
Seat 6: RUMJO (button) folded before Flop (didn't bet)



PokerStars Hand #222967468355:  Hold'em No Limit ($0.05/$0.10 USD) - 2021/01/23 14:50:33 ET
Table 'Stephano III' 6-max Seat #1 is the button
Seat 1: SenorDottore ($10.32 in chips) 
Seat 2: teddyKK ($10.58 in chips) 
Seat 3: Juanchopb79 ($10.57 in chips) 
Seat 4: naroyb ($10.52 in chips) 
Seat 5: Rat1o ($33.18 in chips) 
Seat 6: RUMJO ($9.43 in chips) 
teddyKK: posts small blind $0.05
Juanchopb79: posts big blind $0.10
*** HOLE CARDS ***
naroyb: calls $0.10
Rat1o: folds 
RUMJO: folds 
SenorDottore: folds 
teddyKK: folds 
Juanchopb79: checks 
*** FLOP *** [Jd 5c Qh]
Juanchopb79: checks 
naroyb: bets $0.24
Juanchopb79: calls $0.24
*** TURN *** [Jd 5c Qh] [4h]
Juanchopb79: checks 
naroyb: bets $0.40
Juanchopb79: folds 
Uncalled bet ($0.40) returned to naroyb
naroyb collected $0.70 from pot
naroyb: doesn't show hand 
*** SUMMARY ***
Total pot $0.73 | Rake $0.03 
Board [Jd 5c Qh 4h]
Seat 1: SenorDottore (button) folded before Flop (didn't bet)
Seat 2: teddyKK (small blind) folded before Flop
Seat 3: Juanchopb79 (big blind) folded on the Turn
Seat 4: naroyb collected ($0.70)
Seat 5: Rat1o folded before Flop (didn't bet)
Seat 6: RUMJO folded before Flop (didn't bet)



PokerStars Hand #222967510630:  Hold'em No Limit ($0.05/$0.10 USD) - 2021/01/23 14:51:28 ET
Table 'Stephano III' 6-max Seat #2 is the button
Seat 1: SenorDottore ($10.32 in chips) 
Seat 2: teddyKK ($10.53 in chips) 
Seat 3: Juanchopb79 ($10.23 in chips) 
Seat 4: naroyb ($10.88 in chips) 
Seat 5: Rat1o ($33.18 in chips) 
Seat 6: RUMJO ($9.43 in chips) 
Juanchopb79: posts small blind $0.05
naroyb: posts big blind $0.10
*** HOLE CARDS ***
Rat1o: folds 
RUMJO: folds 
SenorDottore: folds 
teddyKK: folds 
Juanchopb79: raises $0.20 to $0.30
naroyb: folds 
Uncalled bet ($0.20) returned to Juanchopb79
Juanchopb79 collected $0.20 from pot
Juanchopb79: doesn't show hand 
*** SUMMARY ***
Total pot $0.20 | Rake $0 
Seat 1: SenorDottore folded before Flop (didn't bet)
Seat 2: teddyKK (button) folded before Flop (didn't bet)
Seat 3: Juanchopb79 (small blind) collected ($0.20)
Seat 4: naroyb (big blind) folded before Flop
Seat 5: Rat1o folded before Flop (didn't bet)
Seat 6: RUMJO folded before Flop (didn't bet)



PokerStars Hand #222967528109:  Hold'em No Limit ($0.05/$0.10 USD) - 2021/01/23 14:51:51 ET
Table 'Stephano III' 6-max Seat #3 is the button
Seat 1: SenorDottore ($10.32 in chips) 
Seat 2: teddyKK ($10.53 in chips) 
Seat 3: Juanchopb79 ($10.33 in chips) 
Seat 4: naroyb ($10.78 in chips) 
Seat 5: Rat1o ($33.18 in chips) 
Seat 6: RUMJO ($9.43 in chips) 
naroyb: posts small blind $0.05
Rat1o: posts big blind $0.10
*** HOLE CARDS ***
RUMJO: raises $0.15 to $0.25
SenorDottore: folds 
teddyKK: folds 
Juanchopb79: folds 
naroyb: folds 
Rat1o: folds 
Uncalled bet ($0.15) returned to RUMJO
RUMJO collected $0.25 from pot
RUMJO: doesn't show hand 
*** SUMMARY ***
Total pot $0.25 | Rake $0 
Seat 1: SenorDottore folded before Flop (didn't bet)
Seat 2: teddyKK folded before Flop (didn't bet)
Seat 3: Juanchopb79 (button) folded before Flop (didn't bet)
Seat 4: naroyb (small blind) folded before Flop
Seat 5: Rat1o (big blind) folded before Flop
Seat 6: RUMJO collected ($0.25)



PokerStars Hand #222967541368:  Hold'em No Limit ($0.05/$0.10 USD) - 2021/01/23 14:52:08 ET
Table 'Stephano III' 6-max Seat #4 is the button
Seat 1: SenorDottore ($10.32 in chips) 
Seat 2: teddyKK ($10.53 in chips) 
Seat 3: Juanchopb79 ($10.33 in chips) 
Seat 4: naroyb ($10.73 in chips) 
Seat 5: Rat1o ($33.08 in chips) 
Seat 6: RUMJO ($9.58 in chips) 
Rat1o: posts small blind $0.05
RUMJO: posts big blind $0.10
*** HOLE CARDS ***
SenorDottore: folds 
teddyKK: folds 
Juanchopb79: folds 
naroyb: raises $0.20 to $0.30
Rat1o: folds 
RUMJO: calls $0.20
*** FLOP *** [Td 4h 8d]
RUMJO: checks 
naroyb: bets $0.31
RUMJO: folds 
Uncalled bet ($0.31) returned to naroyb
naroyb collected $0.62 from pot
naroyb: doesn't show hand 
*** SUMMARY ***
Total pot $0.65 | Rake $0.03 
Board [Td 4h 8d]
Seat 1: SenorDottore folded before Flop (didn't bet)
Seat 2: teddyKK folded before Flop (didn't bet)
Seat 3: Juanchopb79 folded before Flop (didn't bet)
Seat 4: naroyb (button) collected ($0.62)
Seat 5: Rat1o (small blind) folded before Flop
Seat 6: RUMJO (big blind) folded on the Flop



PokerStars Hand #222967572115:  Hold'em No Limit ($0.05/$0.10 USD) - 2021/01/23 14:52:48 ET
Table 'Stephano III' 6-max Seat #5 is the button
Seat 1: SenorDottore ($10.32 in chips) 
Seat 2: teddyKK ($10.53 in chips) 
Seat 3: Juanchopb79 ($10.33 in chips) 
Seat 4: naroyb ($11.05 in chips) 
Seat 5: Rat1o ($33.03 in chips) 
Seat 6: RUMJO ($9.28 in chips) 
RUMJO: posts small blind $0.05
SenorDottore: posts big blind $0.10
*** HOLE CARDS ***
teddyKK: folds 
Juanchopb79: folds 
naroyb: calls $0.10
Rat1o: folds 
RUMJO: folds 
SenorDottore: raises $0.50 to $0.60
naroyb: folds 
Uncalled bet ($0.50) returned to SenorDottore
SenorDottore collected $0.25 from pot
*** SUMMARY ***
Total pot $0.25 | Rake $0 
Seat 1: SenorDottore (big blind) collected ($0.25)
Seat 2: teddyKK folded before Flop (didn't bet)
Seat 3: Juanchopb79 folded before Flop (didn't bet)
Seat 4: naroyb folded before Flop
Seat 5: Rat1o (button) folded before Flop (didn't bet)
Seat 6: RUMJO (small blind) folded before Flop



PokerStars Hand #222967586223:  Hold'em No Limit ($0.05/$0.10 USD) - 2021/01/23 14:53:07 ET
Table 'Stephano III' 6-max Seat #6 is the button
Seat 1: SenorDottore ($10.47 in chips) 
Seat 2: teddyKK ($10.53 in chips) 
Seat 3: Juanchopb79 ($10.33 in chips) 
Seat 4: naroyb ($10.95 in chips) 
Seat 5: Rat1o ($33.03 in chips) 
Seat 6: RUMJO ($9.23 in chips) 
SenorDottore: posts small blind $0.05
teddyKK: posts big blind $0.10
*** HOLE CARDS ***
Juanchopb79: folds 
naroyb: raises $0.10 to $0.20
Rat1o: folds 
RUMJO: folds 
SenorDottore: folds 
teddyKK: folds 
Uncalled bet ($0.10) returned to naroyb
naroyb collected $0.25 from pot
naroyb: doesn't show hand 
*** SUMMARY ***
Total pot $0.25 | Rake $0 
Seat 1: SenorDottore (small blind) folded before Flop
Seat 2: teddyKK (big blind) folded before Flop
Seat 3: Juanchopb79 folded before Flop (didn't bet)
Seat 4: naroyb collected ($0.25)
Seat 5: Rat1o folded before Flop (didn't bet)
Seat 6: RUMJO (button) folded before Flop (didn't bet)



PokerStars Hand #222967602974:  Hold'em No Limit ($0.05/$0.10 USD) - 2021/01/23 14:53:28 ET
Table 'Stephano III' 6-max Seat #1 is the button
Seat 1: SenorDottore ($10.42 in chips) 
Seat 2: teddyKK ($10.43 in chips) 
Seat 3: Juanchopb79 ($10.33 in chips) 
Seat 4: naroyb ($11.10 in chips) 
Seat 5: Rat1o ($33.03 in chips) 
Seat 6: RUMJO ($9.23 in chips) 
teddyKK: posts small blind $0.05
Juanchopb79: posts big blind $0.10
*** HOLE CARDS ***
naroyb: raises $0.10 to $0.20
Rat1o: folds 
RUMJO: folds 
SenorDottore: raises $0.40 to $0.60
teddyKK: folds 
Juanchopb79: folds 
naroyb: calls $0.40
*** FLOP *** [9c Kd Jc]
naroyb: bets $0.65
SenorDottore: calls $0.65
*** TURN *** [9c Kd Jc] [4d]
naroyb: bets $1.27
SenorDottore: folds 
Uncalled bet ($1.27) returned to naroyb
naroyb collected $2.53 from pot
naroyb: doesn't show hand 
*** SUMMARY ***
Total pot $2.65 | Rake $0.12 
Board [9c Kd Jc 4d]
Seat 1: SenorDottore (button) folded on the Turn
Seat 2: teddyKK (small blind) folded before Flop
Seat 3: Juanchopb79 (big blind) folded before Flop
Seat 4: naroyb collected ($2.53)
Seat 5: Rat1o folded before Flop (didn't bet)
Seat 6: RUMJO folded before Flop (didn't bet)



PokerStars Hand #222967644945:  Hold'em No Limit ($0.05/$0.10 USD) - 2021/01/23 14:54:14 ET
Table 'Stephano III' 6-max Seat #2 is the button
Seat 1: SenorDottore ($10 in chips) 
Seat 2: teddyKK ($10.38 in chips) 
Seat 3: Juanchopb79 ($10.23 in chips) 
Seat 4: naroyb ($12.38 in chips) 
Seat 5: Rat1o ($33.03 in chips) 
Seat 6: RUMJO ($9.23 in chips) 
Juanchopb79: posts small blind $0.05
naroyb: posts big blind $0.10
*** HOLE CARDS ***
Rat1o has timed out
Rat1o: folds 
RUMJO: folds 
SenorDottore: raises $0.15 to $0.25
teddyKK: folds 
Juanchopb79: folds 
naroyb: calls $0.15
*** FLOP *** [5s 4h 6d]
naroyb: checks 
SenorDottore: bets $0.40
naroyb: calls $0.40
*** TURN *** [5s 4h 6d] [Ac]
naroyb: checks 
SenorDottore: bets $0.97
naroyb: folds 
Uncalled bet ($0.97) returned to SenorDottore
SenorDottore collected $1.29 from pot
*** SUMMARY ***
Total pot $1.35 | Rake $0.06 
Board [5s 4h 6d Ac]
Seat 1: SenorDottore collected ($1.29)
Seat 2: teddyKK (button) folded before Flop (didn't bet)
Seat 3: Juanchopb79 (small blind) folded before Flop
Seat 4: naroyb (big blind) folded on the Turn
Seat 5: Rat1o folded before Flop (didn't bet)
Seat 6: RUMJO folded before Flop (didn't bet)



PokerStars Hand #222967679695:  Hold'em No Limit ($0.05/$0.10 USD) - 2021/01/23 14:55:00 ET
Table 'Stephano III' 6-max Seat #3 is the button
Seat 1: SenorDottore ($10.64 in chips) 
Seat 2: teddyKK ($10.38 in chips) 
Seat 3: Juanchopb79 ($10.18 in chips) 
Seat 4: naroyb ($11.73 in chips) 
Seat 5: Rat1o ($33.03 in chips) 
Seat 6: RUMJO ($9.23 in chips) 
naroyb: posts small blind $0.05
Rat1o: posts big blind $0.10
*** HOLE CARDS ***
RUMJO has timed out
RUMJO: folds 
SenorDottore: raises $0.15 to $0.25
teddyKK: folds 
Juanchopb79: folds 
naroyb: folds 
Rat1o: folds 
Uncalled bet ($0.15) returned to SenorDottore
SenorDottore collected $0.25 from pot
*** SUMMARY ***
Total pot $0.25 | Rake $0 
Seat 1: SenorDottore collected ($0.25)
Seat 2: teddyKK folded before Flop (didn't bet)
Seat 3: Juanchopb79 (button) folded before Flop (didn't bet)
Seat 4: naroyb (small blind) folded before Flop
Seat 5: Rat1o (big blind) folded before Flop
Seat 6: RUMJO folded before Flop (didn't bet)



PokerStars Hand #222967692210:  Hold'em No Limit ($0.05/$0.10 USD) - 2021/01/23 14:55:20 ET
Table 'Stephano III' 6-max Seat #4 is the button
Seat 1: SenorDottore ($10.79 in chips) 
Seat 2: teddyKK ($10.38 in chips) 
Seat 3: Juanchopb79 ($10.18 in chips) 
Seat 4: naroyb ($11.68 in chips) 
Seat 5: Rat1o ($32.93 in chips) 
Rat1o: posts small blind $0.05
SenorDottore: posts big blind $0.10
*** HOLE CARDS ***
teddyKK: folds 
Juanchopb79: folds 
naroyb: folds 
Rat1o: folds 
Uncalled bet ($0.05) returned to SenorDottore
SenorDottore collected $0.10 from pot
*** SUMMARY ***
Total pot $0.10 | Rake $0 
Seat 1: SenorDottore (big blind) collected ($0.10)
Seat 2: teddyKK folded before Flop (didn't bet)
Seat 3: Juanchopb79 folded before Flop (didn't bet)
Seat 4: naroyb (button) folded before Flop (didn't bet)
Seat 5: Rat1o (small blind) folded before Flop



PokerStars Hand #222967698620:  Hold'em No Limit ($0.05/$0.10 USD) - 2021/01/23 14:55:32 ET
Table 'Stephano III' 6-max Seat #5 is the button
Seat 1: SenorDottore ($10.84 in chips) 
Seat 2: teddyKK ($10.38 in chips) 
Seat 3: Juanchopb79 ($10.18 in chips) 
Seat 4: naroyb ($11.68 in chips) 
Seat 5: Rat1o ($32.88 in chips) 
SenorDottore: posts small blind $0.05
teddyKK: posts big blind $0.10
*** HOLE CARDS ***
Juanchopb79: folds 
naroyb: folds 
Rat1o: folds 
SenorDottore: raises $0.20 to $0.30
teddyKK: folds 
Uncalled bet ($0.20) returned to SenorDottore
SenorDottore collected $0.20 from pot
*** SUMMARY ***
Total pot $0.20 | Rake $0 
Seat 1: SenorDottore (small blind) collected ($0.20)
Seat 2: teddyKK (big blind) folded before Flop
Seat 3: Juanchopb79 folded before Flop (didn't bet)
Seat 4: naroyb folded before Flop (didn't bet)
Seat 5: Rat1o (button) folded before Flop (didn't bet)



PokerStars Hand #222967706955:  Hold'em No Limit ($0.05/$0.10 USD) - 2021/01/23 14:55:47 ET
Table 'Stephano III' 6-max Seat #1 is the button
Seat 1: SenorDottore ($10.94 in chips) 
Seat 2: teddyKK ($10.28 in chips) 
Seat 3: Juanchopb79 ($10.18 in chips) 
Seat 4: naroyb ($11.68 in chips) 
Seat 5: Rat1o ($32.88 in chips) 
teddyKK: posts small blind $0.05
Juanchopb79: posts big blind $0.10
*** HOLE CARDS ***
naroyb: folds 
Rat1o: folds 
SenorDottore: folds 
teddyKK: folds 
Uncalled bet ($0.05) returned to Juanchopb79
Juanchopb79 collected $0.10 from pot
Juanchopb79: doesn't show hand 
*** SUMMARY ***
Total pot $0.10 | Rake $0 
Seat 1: SenorDottore (button) folded before Flop (didn't bet)
Seat 2: teddyKK (small blind) folded before Flop
Seat 3: Juanchopb79 (big blind) collected ($0.10)
Seat 4: naroyb folded before Flop (didn't bet)
Seat 5: Rat1o folded before Flop (didn't bet)



PokerStars Hand #222967711838:  Hold'em No Limit ($0.05/$0.10 USD) - 2021/01/23 14:55:56 ET
Table 'Stephano III' 6-max Seat #2 is the button
Seat 1: SenorDottore ($10.94 in chips) 
Seat 2: teddyKK ($10.23 in chips) 
Seat 3: Juanchopb79 ($10.23 in chips) 
Seat 4: naroyb ($11.68 in chips) 
Seat 5: Rat1o ($32.88 in chips) 
Juanchopb79: posts small blind $0.05
naroyb: posts big blind $0.10
*** HOLE CARDS ***
Rat1o: folds 
SenorDottore: folds 
teddyKK: folds 
Juanchopb79: raises $0.20 to $0.30
naroyb: calls $0.20
*** FLOP *** [8d 9d 2h]
Juanchopb79: bets $0.29
naroyb: folds 
Uncalled bet ($0.29) returned to Juanchopb79
Juanchopb79 collected $0.57 from pot
Juanchopb79: doesn't show hand 
*** SUMMARY ***
Total pot $0.60 | Rake $0.03 
Board [8d 9d 2h]
Seat 1: SenorDottore folded before Flop (didn't bet)
Seat 2: teddyKK (button) folded before Flop (didn't bet)
Seat 3: Juanchopb79 (small blind) collected ($0.57)
Seat 4: naroyb (big blind) folded on the Flop
Seat 5: Rat1o folded before Flop (didn't bet)



PokerStars Hand #222967726537:  Hold'em No Limit ($0.05/$0.10 USD) - 2021/01/23 14:56:24 ET
Table 'Stephano III' 6-max Seat #3 is the button
Seat 1: SenorDottore ($10.94 in chips) 
Seat 2: teddyKK ($10.23 in chips) 
Seat 3: Juanchopb79 ($10.50 in chips) 
Seat 4: naroyb ($11.38 in chips) 
Seat 6: RUMJO ($9.23 in chips) 
naroyb: posts small blind $0.05
Rat1o: is sitting out 
RUMJO: posts big blind $0.10
*** HOLE CARDS ***
Rat1o leaves the table
SenorDottore: folds 
teddyKK: folds 
4Skill joins the table at seat #5 
Juanchopb79: folds 
naroyb: raises $0.10 to $0.20
RUMJO: calls $0.10
*** FLOP *** [4s 9c 9h]
naroyb: bets $0.38
RUMJO: folds 
Uncalled bet ($0.38) returned to naroyb
naroyb collected $0.38 from pot
naroyb: doesn't show hand 
*** SUMMARY ***
Total pot $0.40 | Rake $0.02 
Board [4s 9c 9h]
Seat 1: SenorDottore folded before Flop (didn't bet)
Seat 2: teddyKK folded before Flop (didn't bet)
Seat 3: Juanchopb79 (button) folded before Flop (didn't bet)
Seat 4: naroyb (small blind) collected ($0.38)
Seat 6: RUMJO (big blind) folded on the Flop



PokerStars Hand #222967740605:  Hold'em No Limit ($0.05/$0.10 USD) - 2021/01/23 14:56:51 ET
Table 'Stephano III' 6-max Seat #4 is the button
Seat 1: SenorDottore ($10.94 in chips) 
Seat 2: teddyKK ($10.23 in chips) 
Seat 3: Juanchopb79 ($10.50 in chips) 
Seat 4: naroyb ($11.56 in chips) 
Seat 6: RUMJO ($9.03 in chips) 
RUMJO: posts small blind $0.05
SenorDottore: posts big blind $0.10
*** HOLE CARDS ***
teddyKK: folds 
Juanchopb79: folds 
naroyb: raises $0.10 to $0.20
RUMJO: folds 
SenorDottore: folds 
Uncalled bet ($0.10) returned to naroyb
naroyb collected $0.25 from pot
naroyb: doesn't show hand 
*** SUMMARY ***
Total pot $0.25 | Rake $0 
Seat 1: SenorDottore (big blind) folded before Flop
Seat 2: teddyKK folded before Flop (didn't bet)
Seat 3: Juanchopb79 folded before Flop (didn't bet)
Seat 4: naroyb (button) collected ($0.25)
Seat 6: RUMJO (small blind) folded before Flop



PokerStars Hand #222967746540:  Hold'em No Limit ($0.05/$0.10 USD) - 2021/01/23 14:57:01 ET
Table 'Stephano III' 6-max Seat #6 is the button
Seat 1: SenorDottore ($10.84 in chips) 
Seat 2: teddyKK ($10.23 in chips) 
Seat 3: Juanchopb79 ($10.50 in chips) 
Seat 4: naroyb ($11.71 in chips) 
Seat 6: RUMJO ($8.98 in chips) 
SenorDottore: posts small blind $0.05
teddyKK: posts big blind $0.10
4Skill: sits out 
*** HOLE CARDS ***
Juanchopb79: folds 
naroyb: raises $0.10 to $0.20
RUMJO: folds 
SenorDottore: folds 
teddyKK: folds 
Uncalled bet ($0.10) returned to naroyb
naroyb collected $0.25 from pot
naroyb: doesn't show hand 
*** SUMMARY ***
Total pot $0.25 | Rake $0 
Seat 1: SenorDottore (small blind) folded before Flop
Seat 2: teddyKK (big blind) folded before Flop
Seat 3: Juanchopb79 folded before Flop (didn't bet)
Seat 4: naroyb collected ($0.25)
Seat 6: RUMJO (button) folded before Flop (didn't bet)



PokerStars Hand #222967753419:  Hold'em No Limit ($0.05/$0.10 USD) - 2021/01/23 14:57:14 ET
Table 'Stephano III' 6-max Seat #1 is the button
Seat 1: SenorDottore ($10.79 in chips) 
Seat 2: teddyKK ($10.13 in chips) 
Seat 3: Juanchopb79 ($10.50 in chips) 
Seat 4: naroyb ($11.86 in chips) 
Seat 6: RUMJO ($8.98 in chips) 
teddyKK: posts small blind $0.05
Juanchopb79: posts big blind $0.10
4Skill: sits out 
*** HOLE CARDS ***
naroyb: calls $0.10
RUMJO: folds 
SenorDottore: folds 
teddyKK: folds 
Juanchopb79: raises $0.40 to $0.50
naroyb: folds 
Uncalled bet ($0.40) returned to Juanchopb79
Juanchopb79 collected $0.25 from pot
Juanchopb79: doesn't show hand 
*** SUMMARY ***
Total pot $0.25 | Rake $0 
Seat 1: SenorDottore (button) folded before Flop (didn't bet)
Seat 2: teddyKK (small blind) folded before Flop
Seat 3: Juanchopb79 (big blind) collected ($0.25)
Seat 4: naroyb folded before Flop
Seat 6: RUMJO folded before Flop (didn't bet)



PokerStars Hand #222967768387:  Hold'em No Limit ($0.05/$0.10 USD) - 2021/01/23 14:57:42 ET
Table 'Stephano III' 6-max Seat #2 is the button
Seat 1: SenorDottore ($10.79 in chips) 
Seat 2: teddyKK ($10.08 in chips) 
Seat 3: Juanchopb79 ($10.65 in chips) 
Seat 4: naroyb ($11.76 in chips) 
Seat 6: RUMJO ($8.98 in chips) 
Juanchopb79: posts small blind $0.05
naroyb: posts big blind $0.10
4Skill: sits out 
*** HOLE CARDS ***
RUMJO: folds 
SenorDottore: folds 
teddyKK: folds 
Juanchopb79: folds 
Uncalled bet ($0.05) returned to naroyb
naroyb collected $0.10 from pot
naroyb: doesn't show hand 
*** SUMMARY ***
Total pot $0.10 | Rake $0 
Seat 1: SenorDottore folded before Flop (didn't bet)
Seat 2: teddyKK (button) folded before Flop (didn't bet)
Seat 3: Juanchopb79 (small blind) folded before Flop
Seat 4: naroyb (big blind) collected ($0.10)
Seat 6: RUMJO folded before Flop (didn't bet)



PokerStars Hand #222967773380:  Hold'em No Limit ($0.05/$0.10 USD) - 2021/01/23 14:57:52 ET
Table 'Stephano III' 6-max Seat #3 is the button
Seat 1: SenorDottore ($10.79 in chips) 
Seat 2: teddyKK ($10.08 in chips) 
Seat 3: Juanchopb79 ($10.60 in chips) 
Seat 4: naroyb ($11.81 in chips) 
Seat 5: 4Skill ($10 in chips) 
Seat 6: RUMJO ($8.98 in chips) 
naroyb: posts small blind $0.05
4Skill: posts big blind $0.10
*** HOLE CARDS ***
RUMJO: folds 
SenorDottore: folds 
teddyKK: folds 
Juanchopb79: raises $0.15 to $0.25
naroyb: folds 
4Skill: folds 
Uncalled bet ($0.15) returned to Juanchopb79
Juanchopb79 collected $0.25 from pot
Juanchopb79: doesn't show hand 
*** SUMMARY ***
Total pot $0.25 | Rake $0 
Seat 1: SenorDottore folded before Flop (didn't bet)
Seat 2: teddyKK folded before Flop (didn't bet)
Seat 3: Juanchopb79 (button) collected ($0.25)
Seat 4: naroyb (small blind) folded before Flop
Seat 5: 4Skill (big blind) folded before Flop
Seat 6: RUMJO folded before Flop (didn't bet)



PokerStars Hand #222967784539:  Hold'em No Limit ($0.05/$0.10 USD) - 2021/01/23 14:58:13 ET
Table 'Stephano III' 6-max Seat #4 is the button
Seat 1: SenorDottore ($10.79 in chips) 
Seat 2: teddyKK ($10.08 in chips) 
Seat 3: Juanchopb79 ($10.75 in chips) 
Seat 4: naroyb ($11.76 in chips) 
Seat 5: 4Skill ($10 in chips) 
Seat 6: RUMJO ($8.98 in chips) 
4Skill: posts small blind $0.05
RUMJO: posts big blind $0.10
*** HOLE CARDS ***
SenorDottore: raises $0.15 to $0.25
teddyKK: folds 
Juanchopb79: folds 
naroyb: calls $0.25
4Skill: folds 
RUMJO: folds 
*** FLOP *** [As 4c Kc]
SenorDottore: bets $0.47
naroyb: folds 
Uncalled bet ($0.47) returned to SenorDottore
SenorDottore collected $0.62 from pot
*** SUMMARY ***
Total pot $0.65 | Rake $0.03 
Board [As 4c Kc]
Seat 1: SenorDottore collected ($0.62)
Seat 2: teddyKK folded before Flop (didn't bet)
Seat 3: Juanchopb79 folded before Flop (didn't bet)
Seat 4: naroyb (button) folded on the Flop
Seat 5: 4Skill (small blind) folded before Flop
Seat 6: RUMJO (big blind) folded before Flop



PokerStars Hand #222967801779:  Hold'em No Limit ($0.05/$0.10 USD) - 2021/01/23 14:58:45 ET
Table 'Stephano III' 6-max Seat #5 is the button
Seat 1: SenorDottore ($11.16 in chips) 
Seat 2: teddyKK ($10.08 in chips) 
Seat 3: Juanchopb79 ($10.75 in chips) 
Seat 4: naroyb ($11.51 in chips) 
Seat 5: 4Skill ($10 in chips) 
Seat 6: RUMJO ($8.88 in chips) 
RUMJO: posts small blind $0.05
SenorDottore: posts big blind $0.10
*** HOLE CARDS ***
teddyKK: folds 
Juanchopb79: folds 
naroyb: folds 
4Skill: folds 
RUMJO: raises $0.15 to $0.25
SenorDottore: folds 
Uncalled bet ($0.15) returned to RUMJO
RUMJO collected $0.20 from pot
RUMJO: doesn't show hand 
*** SUMMARY ***
Total pot $0.20 | Rake $0 
Seat 1: SenorDottore (big blind) folded before Flop
Seat 2: teddyKK folded before Flop (didn't bet)
Seat 3: Juanchopb79 folded before Flop (didn't bet)
Seat 4: naroyb folded before Flop (didn't bet)
Seat 5: 4Skill (button) folded before Flop (didn't bet)
Seat 6: RUMJO (small blind) collected ($0.20)



PokerStars Hand #222967811133:  Hold'em No Limit ($0.05/$0.10 USD) - 2021/01/23 14:59:02 ET
Table 'Stephano III' 6-max Seat #6 is the button
Seat 1: SenorDottore ($11.06 in chips) 
Seat 2: teddyKK ($10.08 in chips) 
Seat 3: Juanchopb79 ($10.75 in chips) 
Seat 4: naroyb ($11.51 in chips) 
Seat 5: 4Skill ($10 in chips) 
Seat 6: RUMJO ($8.98 in chips) 
SenorDottore: posts small blind $0.05
teddyKK: posts big blind $0.10
*** HOLE CARDS ***
Juanchopb79: folds 
naroyb: raises $0.10 to $0.20
4Skill: folds 
RUMJO: folds 
SenorDottore: folds 
teddyKK: folds 
Uncalled bet ($0.10) returned to naroyb
naroyb collected $0.25 from pot
naroyb: doesn't show hand 
*** SUMMARY ***
Total pot $0.25 | Rake $0 
Seat 1: SenorDottore (small blind) folded before Flop
Seat 2: teddyKK (big blind) folded before Flop
Seat 3: Juanchopb79 folded before Flop (didn't bet)
Seat 4: naroyb collected ($0.25)
Seat 5: 4Skill folded before Flop (didn't bet)
Seat 6: RUMJO (button) folded before Flop (didn't bet)



PokerStars Hand #222967819937:  Hold'em No Limit ($0.05/$0.10 USD) - 2021/01/23 14:59:19 ET
Table 'Stephano III' 6-max Seat #1 is the button
Seat 1: SenorDottore ($11.01 in chips) 
Seat 2: teddyKK ($10 in chips) 
Seat 3: Juanchopb79 ($10.75 in chips) 
Seat 4: naroyb ($11.66 in chips) 
Seat 5: 4Skill ($10 in chips) 
Seat 6: RUMJO ($8.98 in chips) 
teddyKK: posts small blind $0.05
Juanchopb79: posts big blind $0.10
*** HOLE CARDS ***
naroyb: raises $0.10 to $0.20
4Skill: folds 
RUMJO: folds 
SenorDottore: folds 
teddyKK: folds 
Juanchopb79: calls $0.10
*** FLOP *** [Th Ac 3d]
Juanchopb79: checks 
naroyb: bets $0.22
Juanchopb79: folds 
Uncalled bet ($0.22) returned to naroyb
naroyb collected $0.43 from pot
naroyb: doesn't show hand 
*** SUMMARY ***
Total pot $0.45 | Rake $0.02 
Board [Th Ac 3d]
Seat 1: SenorDottore (button) folded before Flop (didn't bet)
Seat 2: teddyKK (small blind) folded before Flop
Seat 3: Juanchopb79 (big blind) folded on the Flop
Seat 4: naroyb collected ($0.43)
Seat 5: 4Skill folded before Flop (didn't bet)
Seat 6: RUMJO folded before Flop (didn't bet)



PokerStars Hand #222967836450:  Hold'em No Limit ($0.05/$0.10 USD) - 2021/01/23 14:59:49 ET
Table 'Stephano III' 6-max Seat #2 is the button
Seat 1: SenorDottore ($11.01 in chips) 
Seat 2: teddyKK ($10 in chips) 
Seat 3: Juanchopb79 ($10.55 in chips) 
Seat 4: naroyb ($11.89 in chips) 
Seat 5: 4Skill ($10 in chips) 
Seat 6: RUMJO ($8.98 in chips) 
Juanchopb79: posts small blind $0.05
naroyb: posts big blind $0.10
*** HOLE CARDS ***
4Skill: folds 
RUMJO: folds 
SenorDottore: raises $0.15 to $0.25
teddyKK: folds 
Juanchopb79: raises $0.65 to $0.90
naroyb: folds 
SenorDottore: folds 
Uncalled bet ($0.65) returned to Juanchopb79
Juanchopb79 collected $0.60 from pot
Juanchopb79: doesn't show hand 
*** SUMMARY ***
Total pot $0.60 | Rake $0 
Seat 1: SenorDottore folded before Flop
Seat 2: teddyKK (button) folded before Flop (didn't bet)
Seat 3: Juanchopb79 (small blind) collected ($0.60)
Seat 4: naroyb (big blind) folded before Flop
Seat 5: 4Skill folded before Flop (didn't bet)
Seat 6: RUMJO folded before Flop (didn't bet)



PokerStars Hand #222967856127:  Hold'em No Limit ($0.05/$0.10 USD) - 2021/01/23 15:00:24 ET
Table 'Stephano III' 6-max Seat #3 is the button
Seat 1: SenorDottore ($10.76 in chips) 
Seat 2: teddyKK ($10 in chips) 
Seat 3: Juanchopb79 ($10.90 in chips) 
Seat 4: naroyb ($11.79 in chips) 
Seat 5: 4Skill ($10 in chips) 
Seat 6: RUMJO ($8.98 in chips) 
naroyb: posts small blind $0.05
4Skill: posts big blind $0.10
*** HOLE CARDS ***
RUMJO: folds 
SenorDottore: folds 
teddyKK: raises $0.20 to $0.30
Juanchopb79: folds 
naroyb: folds 
4Skill: folds 
Uncalled bet ($0.20) returned to teddyKK
teddyKK collected $0.25 from pot
teddyKK: doesn't show hand 
*** SUMMARY ***
Total pot $0.25 | Rake $0 
Seat 1: SenorDottore folded before Flop (didn't bet)
Seat 2: teddyKK collected ($0.25)
Seat 3: Juanchopb79 (button) folded before Flop (didn't bet)
Seat 4: naroyb (small blind) folded before Flop
Seat 5: 4Skill (big blind) folded before Flop
Seat 6: RUMJO folded before Flop (didn't bet)



PokerStars Hand #222967867282:  Hold'em No Limit ($0.05/$0.10 USD) - 2021/01/23 15:00:43 ET
Table 'Stephano III' 6-max Seat #4 is the button
Seat 1: SenorDottore ($10.76 in chips) 
Seat 2: teddyKK ($10.15 in chips) 
Seat 3: Juanchopb79 ($10.90 in chips) 
Seat 4: naroyb ($11.74 in chips) 
Seat 5: 4Skill ($10 in chips) 
Seat 6: RUMJO ($8.98 in chips) 
4Skill: posts small blind $0.05
RUMJO: posts big blind $0.10
*** HOLE CARDS ***
SenorDottore: raises $0.15 to $0.25
teddyKK: folds 
Juanchopb79: folds 
naroyb: folds 
4Skill: folds 
RUMJO: calls $0.15
*** FLOP *** [9s 5h Ks]
RUMJO: checks 
SenorDottore: bets $0.27
RUMJO: calls $0.27
*** TURN *** [9s 5h Ks] [4h]
RUMJO: checks 
SenorDottore: checks 
*** RIVER *** [9s 5h Ks 4h] [6s]
RUMJO: bets $0.31
SenorDottore: folds 
Uncalled bet ($0.31) returned to RUMJO
RUMJO collected $1.04 from pot
RUMJO: doesn't show hand 
*** SUMMARY ***
Total pot $1.09 | Rake $0.05 
Board [9s 5h Ks 4h 6s]
Seat 1: SenorDottore folded on the River
Seat 2: teddyKK folded before Flop (didn't bet)
Seat 3: Juanchopb79 folded before Flop (didn't bet)
Seat 4: naroyb (button) folded before Flop (didn't bet)
Seat 5: 4Skill (small blind) folded before Flop
Seat 6: RUMJO (big blind) collected ($1.04)



PokerStars Hand #222967915712:  Hold'em No Limit ($0.05/$0.10 USD) - 2021/01/23 15:01:44 ET
Table 'Stephano III' 6-max Seat #5 is the button
Seat 1: SenorDottore ($10.24 in chips) 
Seat 2: teddyKK ($10.15 in chips) 
Seat 3: Juanchopb79 ($10.90 in chips) 
Seat 4: naroyb ($11.74 in chips) 
Seat 5: 4Skill ($10 in chips) 
Seat 6: RUMJO ($9.50 in chips) 
RUMJO: posts small blind $0.05
SenorDottore: posts big blind $0.10
*** HOLE CARDS ***
teddyKK: raises $0.20 to $0.30
Juanchopb79: folds 
naroyb: folds 
4Skill: folds 
RUMJO: folds 
SenorDottore: folds 
Uncalled bet ($0.20) returned to teddyKK
teddyKK collected $0.25 from pot
teddyKK: doesn't show hand 
*** SUMMARY ***
Total pot $0.25 | Rake $0 
Seat 1: SenorDottore (big blind) folded before Flop
Seat 2: teddyKK collected ($0.25)
Seat 3: Juanchopb79 folded before Flop (didn't bet)
Seat 4: naroyb folded before Flop (didn't bet)
Seat 5: 4Skill (button) folded before Flop (didn't bet)
Seat 6: RUMJO (small blind) folded before Flop



PokerStars Hand #222967924314:  Hold'em No Limit ($0.05/$0.10 USD) - 2021/01/23 15:01:56 ET
Table 'Stephano III' 6-max Seat #6 is the button
Seat 1: SenorDottore ($10.14 in chips) 
Seat 2: teddyKK ($10.30 in chips) 
Seat 3: Juanchopb79 ($10.90 in chips) 
Seat 4: naroyb ($11.74 in chips) 
Seat 5: 4Skill ($10 in chips) 
Seat 6: RUMJO ($9.45 in chips) 
SenorDottore: posts small blind $0.05
teddyKK: posts big blind $0.10
*** HOLE CARDS ***
Juanchopb79: folds 
naroyb: calls $0.10
4Skill: raises $0.30 to $0.40
RUMJO has timed out
RUMJO: folds 
SenorDottore: raises $0.80 to $1.20
teddyKK: folds 
naroyb: folds 
4Skill: folds 
Uncalled bet ($0.80) returned to SenorDottore
SenorDottore collected $1 from pot
*** SUMMARY ***
Total pot $1 | Rake $0 
Seat 1: SenorDottore (small blind) collected ($1)
Seat 2: teddyKK (big blind) folded before Flop
Seat 3: Juanchopb79 folded before Flop (didn't bet)
Seat 4: naroyb folded before Flop
Seat 5: 4Skill folded before Flop
Seat 6: RUMJO (button) folded before Flop (didn't bet)



PokerStars Hand #222967957991:  Hold'em No Limit ($0.05/$0.10 USD) - 2021/01/23 15:02:40 ET
Table 'Stephano III' 6-max Seat #1 is the button
Seat 1: SenorDottore ($10.74 in chips) 
Seat 2: teddyKK ($10.20 in chips) 
Seat 3: Juanchopb79 ($10.90 in chips) 
Seat 4: naroyb ($11.64 in chips) 
Seat 5: 4Skill ($10 in chips) 
teddyKK: posts small blind $0.05
Juanchopb79: posts big blind $0.10
*** HOLE CARDS ***
naroyb: raises $0.10 to $0.20
4Skill: folds 
SenorDottore: folds 
teddyKK: calls $0.15
Juanchopb79: folds 
*** FLOP *** [9c Ks Jh]
teddyKK: checks 
naroyb: bets $0.48
teddyKK: calls $0.48
*** TURN *** [9c Ks Jh] [7h]
teddyKK: checks 
naroyb: bets $0.70
teddyKK: calls $0.70
*** RIVER *** [9c Ks Jh 7h] [Tc]
teddyKK: checks 
naroyb: bets $0.90
teddyKK: calls $0.90
*** SHOW DOWN ***
naroyb: shows [4s 3s] (high card King)
teddyKK: shows [Jc Qc] (a straight, Nine to King)
teddyKK collected $4.45 from pot
*** SUMMARY ***
Total pot $4.66 | Rake $0.21 
Board [9c Ks Jh 7h Tc]
Seat 1: SenorDottore (button) folded before Flop (didn't bet)
Seat 2: teddyKK (small blind) showed [Jc Qc] and won ($4.45) with a straight, Nine to King
Seat 3: Juanchopb79 (big blind) folded before Flop
Seat 4: naroyb showed [4s 3s] and lost with high card King
Seat 5: 4Skill folded before Flop (didn't bet)



PokerStars Hand #222968012284:  Hold'em No Limit ($0.05/$0.10 USD) - 2021/01/23 15:03:47 ET
Table 'Stephano III' 6-max Seat #2 is the button
Seat 1: SenorDottore ($10.74 in chips) 
Seat 2: teddyKK ($12.37 in chips) 
Seat 3: Juanchopb79 ($10.80 in chips) 
Seat 4: naroyb ($9.36 in chips) 
Seat 5: 4Skill ($10 in chips) 
Seat 6: RUMJO ($9.45 in chips) 
Juanchopb79: posts small blind $0.05
naroyb: posts big blind $0.10
*** HOLE CARDS ***
4Skill: folds 
RUMJO: folds 
SenorDottore: raises $0.15 to $0.25
teddyKK: raises $0.55 to $0.80
Juanchopb79: folds 
naroyb: folds 
SenorDottore: folds 
Uncalled bet ($0.55) returned to teddyKK
naroyb leaves the table
teddyKK collected $0.65 from pot
teddyKK: doesn't show hand 
*** SUMMARY ***
Total pot $0.65 | Rake $0 
Seat 1: SenorDottore folded before Flop
Seat 2: teddyKK (button) collected ($0.65)
Seat 3: Juanchopb79 (small blind) folded before Flop
Seat 4: naroyb (big blind) folded before Flop
Seat 5: 4Skill folded before Flop (didn't bet)
Seat 6: RUMJO folded before Flop (didn't bet)



PokerStars Hand #222968035376:  Hold'em No Limit ($0.05/$0.10 USD) - 2021/01/23 15:04:15 ET
Table 'Stephano III' 6-max Seat #3 is the button
Seat 1: SenorDottore ($10.49 in chips) 
Seat 2: teddyKK ($12.77 in chips) 
Seat 3: Juanchopb79 ($10.75 in chips) 
Seat 5: 4Skill ($10 in chips) 
Seat 6: RUMJO ($9.45 in chips) 
4Skill: posts small blind $0.05
RUMJO: posts big blind $0.10
*** HOLE CARDS ***
SenorDottore: folds 
teddyKK: folds 
Juanchopb79: raises $0.15 to $0.25
4Skill: raises $0.75 to $1
RUMJO: folds 
Juanchopb79: folds 
Uncalled bet ($0.75) returned to 4Skill
4Skill collected $0.60 from pot
4Skill: doesn't show hand 
*** SUMMARY ***
Total pot $0.60 | Rake $0 
Seat 1: SenorDottore folded before Flop (didn't bet)
Seat 2: teddyKK folded before Flop (didn't bet)
Seat 3: Juanchopb79 (button) folded before Flop
Seat 5: 4Skill (small blind) collected ($0.60)
Seat 6: RUMJO (big blind) folded before Flop



PokerStars Hand #222968052254:  Hold'em No Limit ($0.05/$0.10 USD) - 2021/01/23 15:04:36 ET
Table 'Stephano III' 6-max Seat #5 is the button
Seat 1: SenorDottore ($10.49 in chips) 
Seat 2: teddyKK ($12.77 in chips) 
Seat 3: Juanchopb79 ($10.50 in chips) 
Seat 5: 4Skill ($10.35 in chips) 
Seat 6: RUMJO ($9.35 in chips) 
RUMJO: posts small blind $0.05
SenorDottore: posts big blind $0.10
*** HOLE CARDS ***
teddyKK: folds 
Juanchopb79: folds 
4Skill: folds 
RUMJO: raises $0.15 to $0.25
SenorDottore: calls $0.15
*** FLOP *** [9d Qc Jd]
Ochinev joins the table at seat #4 
RUMJO: checks 
SenorDottore: checks 
*** TURN *** [9d Qc Jd] [4c]
RUMJO: checks 
SenorDottore: checks 
*** RIVER *** [9d Qc Jd 4c] [7c]
RUMJO: checks 
SenorDottore: checks 
*** SHOW DOWN ***
RUMJO: shows [5h Ah] (high card Ace)
SenorDottore: shows [6h 6c] (a pair of Sixes)
SenorDottore collected $0.48 from pot
*** SUMMARY ***
Total pot $0.50 | Rake $0.02 
Board [9d Qc Jd 4c 7c]
Seat 1: SenorDottore (big blind) showed [6h 6c] and won ($0.48) with a pair of Sixes
Seat 2: teddyKK folded before Flop (didn't bet)
Seat 3: Juanchopb79 folded before Flop (didn't bet)
Seat 5: 4Skill (button) folded before Flop (didn't bet)
Seat 6: RUMJO (small blind) showed [5h Ah] and lost with high card Ace



PokerStars Hand #222968085925:  Hold'em No Limit ($0.05/$0.10 USD) - 2021/01/23 15:05:17 ET
Table 'Stephano III' 6-max Seat #6 is the button
Seat 1: SenorDottore ($10.72 in chips) 
Seat 2: teddyKK ($12.77 in chips) 
Seat 3: Juanchopb79 ($10.50 in chips) 
Seat 5: 4Skill ($10.35 in chips) 
Seat 6: RUMJO ($9.10 in chips) 
SenorDottore: posts small blind $0.05
teddyKK: posts big blind $0.10
*** HOLE CARDS ***
Juanchopb79: folds 
4Skill: folds 
RUMJO: raises $0.15 to $0.25
SenorDottore: folds 
teddyKK: calls $0.15
*** FLOP *** [3c Qs 6d]
teddyKK: checks 
RUMJO: checks 
*** TURN *** [3c Qs 6d] [Ts]
teddyKK: checks 
RUMJO: checks 
*** RIVER *** [3c Qs 6d Ts] [Qh]
teddyKK: bets $0.30
RUMJO: folds 
Uncalled bet ($0.30) returned to teddyKK
teddyKK collected $0.53 from pot
teddyKK: doesn't show hand 
*** SUMMARY ***
Total pot $0.55 | Rake $0.02 
Board [3c Qs 6d Ts Qh]
Seat 1: SenorDottore (small blind) folded before Flop
Seat 2: teddyKK (big blind) collected ($0.53)
Seat 3: Juanchopb79 folded before Flop (didn't bet)
Seat 5: 4Skill folded before Flop (didn't bet)
Seat 6: RUMJO (button) folded on the River



PokerStars Hand #222968132613:  Hold'em No Limit ($0.05/$0.10 USD) - 2021/01/23 15:06:12 ET
Table 'Stephano III' 6-max Seat #1 is the button
Seat 1: SenorDottore ($10.67 in chips) 
Seat 2: teddyKK ($13.05 in chips) 
Seat 3: Juanchopb79 ($10.50 in chips) 
Seat 5: 4Skill ($10.35 in chips) 
Seat 6: RUMJO ($8.85 in chips) 
teddyKK: posts small blind $0.05
Juanchopb79: posts big blind $0.10
*** HOLE CARDS ***
4Skill: raises $0.20 to $0.30
RUMJO: raises $0.60 to $0.90
SenorDottore: folds 
teddyKK: folds 
Juanchopb79: folds 
4Skill: calls $0.60
*** FLOP *** [6h 7h Qs]
4Skill: checks 
RUMJO: bets $0.56
4Skill: calls $0.56
*** TURN *** [6h 7h Qs] [2h]
4Skill: checks 
RUMJO: checks 
*** RIVER *** [6h 7h Qs 2h] [4c]
4Skill: bets $1
RUMJO: folds 
Uncalled bet ($1) returned to 4Skill
4Skill collected $2.93 from pot
4Skill: doesn't show hand 
*** SUMMARY ***
Total pot $3.07 | Rake $0.14 
Board [6h 7h Qs 2h 4c]
Seat 1: SenorDottore (button) folded before Flop (didn't bet)
Seat 2: teddyKK (small blind) folded before Flop
Seat 3: Juanchopb79 (big blind) folded before Flop
Seat 5: 4Skill collected ($2.93)
Seat 6: RUMJO folded on the River



PokerStars Hand #222968184716:  Hold'em No Limit ($0.05/$0.10 USD) - 2021/01/23 15:07:14 ET
Table 'Stephano III' 6-max Seat #2 is the button
Seat 1: SenorDottore ($10.67 in chips) 
Seat 2: teddyKK ($13 in chips) 
Seat 3: Juanchopb79 ($10.40 in chips) 
Seat 6: RUMJO ($7.39 in chips) 
Juanchopb79: posts small blind $0.05
4Skill: is sitting out 
RUMJO: posts big blind $0.10
*** HOLE CARDS ***
SenorDottore: folds 
teddyKK: folds 
Juanchopb79: folds 
Uncalled bet ($0.05) returned to RUMJO
RUMJO collected $0.10 from pot
RUMJO: doesn't show hand 
*** SUMMARY ***
Total pot $0.10 | Rake $0 
Seat 1: SenorDottore folded before Flop (didn't bet)
Seat 2: teddyKK (button) folded before Flop (didn't bet)
Seat 3: Juanchopb79 (small blind) folded before Flop
Seat 6: RUMJO (big blind) collected ($0.10)



PokerStars Hand #222968191766:  Hold'em No Limit ($0.05/$0.10 USD) - 2021/01/23 15:07:23 ET
Table 'Stephano III' 6-max Seat #3 is the button
Seat 1: SenorDottore ($10.67 in chips) 
Seat 2: teddyKK ($13 in chips) 
Seat 3: Juanchopb79 ($10.35 in chips) 
Seat 6: RUMJO ($7.44 in chips) 
RUMJO: posts small blind $0.05
SenorDottore: posts big blind $0.10
*** HOLE CARDS ***
4Skill leaves the table
teddyKK: folds 
Juanchopb79: folds 
RUMJO: raises $0.15 to $0.25
SenorDottore: calls $0.15
*** FLOP *** [7c Jc 3d]
RUMJO: bets $0.29
SenorDottore: raises $0.61 to $0.90
RUMJO: folds 
Uncalled bet ($0.61) returned to SenorDottore
SenorDottore collected $1.03 from pot
*** SUMMARY ***
Total pot $1.08 | Rake $0.05 
Board [7c Jc 3d]
Seat 1: SenorDottore (big blind) collected ($1.03)
Seat 2: teddyKK folded before Flop (didn't bet)
Seat 3: Juanchopb79 (button) folded before Flop (didn't bet)
Seat 6: RUMJO (small blind) folded on the Flop



PokerStars Hand #222968210256:  Hold'em No Limit ($0.05/$0.10 USD) - 2021/01/23 15:07:45 ET
Table 'Stephano III' 6-max Seat #6 is the button
Seat 1: SenorDottore ($11.16 in chips) 
Seat 2: teddyKK ($13 in chips) 
Seat 3: Juanchopb79 ($10.35 in chips) 
Seat 6: RUMJO ($6.90 in chips) 
SenorDottore: posts small blind $0.05
teddyKK: posts big blind $0.10
*** HOLE CARDS ***
Juanchopb79: raises $0.20 to $0.30
RUMJO: folds 
SenorDottore: folds 
teddyKK: calls $0.20
*** FLOP *** [5h 2h Jh]
teddyKK: checks 
Juanchopb79: bets $0.31
teddyKK: folds 
Uncalled bet ($0.31) returned to Juanchopb79
Juanchopb79 collected $0.62 from pot
Juanchopb79: doesn't show hand 
*** SUMMARY ***
Total pot $0.65 | Rake $0.03 
Board [5h 2h Jh]
Seat 1: SenorDottore (small blind) folded before Flop
Seat 2: teddyKK (big blind) folded on the Flop
Seat 3: Juanchopb79 collected ($0.62)
Seat 6: RUMJO (button) folded before Flop (didn't bet)



PokerStars Hand #222968237847:  Hold'em No Limit ($0.05/$0.10 USD) - 2021/01/23 15:08:18 ET
Table 'Stephano III' 6-max Seat #1 is the button
Seat 1: SenorDottore ($11.11 in chips) 
Seat 2: teddyKK ($12.70 in chips) 
Seat 3: Juanchopb79 ($10.67 in chips) 
Seat 6: RUMJO ($10 in chips) 
teddyKK: posts small blind $0.05
Juanchopb79: posts big blind $0.10
*** HOLE CARDS ***
RUMJO: folds 
SenorDottore: raises $0.20 to $0.30
picolino995 joins the table at seat #5 
teddyKK: folds 
Juanchopb79: folds 
Uncalled bet ($0.20) returned to SenorDottore
SenorDottore collected $0.25 from pot
*** SUMMARY ***
Total pot $0.25 | Rake $0 
Seat 1: SenorDottore (button) collected ($0.25)
Seat 2: teddyKK (small blind) folded before Flop
Seat 3: Juanchopb79 (big blind) folded before Flop
Seat 6: RUMJO folded before Flop (didn't bet)



PokerStars Hand #222968248761:  Hold'em No Limit ($0.05/$0.10 USD) - 2021/01/23 15:08:31 ET
Table 'Stephano III' 6-max Seat #2 is the button
Seat 1: SenorDottore ($11.26 in chips) 
Seat 2: teddyKK ($12.65 in chips) 
Seat 3: Juanchopb79 ($10.57 in chips) 
Seat 5: picolino995 ($4 in chips) 
Seat 6: RUMJO ($10 in chips) 
Juanchopb79: posts small blind $0.05
picolino995: posts big blind $0.10
*** HOLE CARDS ***
RUMJO: raises $0.15 to $0.25
SenorDottore: folds 
SenorDottore leaves the table
teddyKK: folds 
Juanchopb79: folds 
picolino995: calls $0.15
*** FLOP *** [Kc 3c 4s]
picolino995: checks 
RUMJO: checks 
*** TURN *** [Kc 3c 4s] [Jh]
picolino995: bets $0.26
RUMJO: folds 
Uncalled bet ($0.26) returned to picolino995
picolino995 collected $0.53 from pot
picolino995: doesn't show hand 
*** SUMMARY ***
Total pot $0.55 | Rake $0.02 
Board [Kc 3c 4s Jh]
Seat 1: SenorDottore folded before Flop (didn't bet)
Seat 2: teddyKK (button) folded before Flop (didn't bet)
Seat 3: Juanchopb79 (small blind) folded before Flop
Seat 5: picolino995 (big blind) collected ($0.53)
Seat 6: RUMJO folded on the Turn



PokerStars Hand #222968278037:  Hold'em No Limit ($0.05/$0.10 USD) - 2021/01/23 15:09:06 ET
Table 'Stephano III' 6-max Seat #3 is the button
Seat 2: teddyKK ($12.65 in chips) 
Seat 3: Juanchopb79 ($10.52 in chips) 
Seat 5: picolino995 ($4.28 in chips) 
Seat 6: RUMJO ($9.75 in chips) 
picolino995: posts small blind $0.05
RUMJO: posts big blind $0.10
*** HOLE CARDS ***
teddyKK: folds 
Juanchopb79: raises $0.15 to $0.25
picolino995: calls $0.20
RUMJO: folds 
*** FLOP *** [6c 8d Jc]
picolino995: checks 
Juanchopb79: bets $0.19
picolino995: calls $0.19
*** TURN *** [6c 8d Jc] [Ts]
andrew_yar joins the table at seat #1 
picolino995: checks 
Juanchopb79: checks 
*** RIVER *** [6c 8d Jc Ts] [9h]
picolino995: bets $0.20
Juanchopb79: folds 
Uncalled bet ($0.20) returned to picolino995
picolino995 collected $0.94 from pot
picolino995: doesn't show hand 
*** SUMMARY ***
Total pot $0.98 | Rake $0.04 
Board [6c 8d Jc Ts 9h]
Seat 2: teddyKK folded before Flop (didn't bet)
Seat 3: Juanchopb79 (button) folded on the River
Seat 5: picolino995 (small blind) collected ($0.94)
Seat 6: RUMJO (big blind) folded before Flop



PokerStars Hand #222968318121:  Hold'em No Limit ($0.05/$0.10 USD) - 2021/01/23 15:09:54 ET
Table 'Stephano III' 6-max Seat #5 is the button
Seat 1: andrew_yar ($10 in chips) 
Seat 2: teddyKK ($12.65 in chips) 
Seat 3: Juanchopb79 ($10.08 in chips) 
Seat 5: picolino995 ($4.78 in chips) 
Seat 6: RUMJO ($9.65 in chips) 
RUMJO: posts small blind $0.05
andrew_yar: posts big blind $0.10
*** HOLE CARDS ***
teddyKK: folds 
Juanchopb79: folds 
picolino995 has timed out
picolino995: folds 
RUMJO: folds 
Uncalled bet ($0.05) returned to andrew_yar
andrew_yar collected $0.10 from pot
andrew_yar: doesn't show hand 
*** SUMMARY ***
Total pot $0.10 | Rake $0 
Seat 1: andrew_yar (big blind) collected ($0.10)
Seat 2: teddyKK folded before Flop (didn't bet)
Seat 3: Juanchopb79 folded before Flop (didn't bet)
Seat 5: picolino995 (button) folded before Flop (didn't bet)
Seat 6: RUMJO (small blind) folded before Flop



PokerStars Hand #222968334793:  Hold'em No Limit ($0.05/$0.10 USD) - 2021/01/23 15:10:14 ET
Table 'Stephano III' 6-max Seat #6 is the button
Seat 1: andrew_yar ($10.05 in chips) 
Seat 2: teddyKK ($12.65 in chips) 
Seat 3: Juanchopb79 ($10.08 in chips) 
Seat 5: picolino995 ($4.78 in chips) 
Seat 6: RUMJO ($9.60 in chips) 
andrew_yar: posts small blind $0.05
teddyKK: posts big blind $0.10
*** HOLE CARDS ***
Juanchopb79: folds 
picolino995: folds 
RUMJO: folds 
andrew_yar: raises $0.15 to $0.25
teddyKK: calls $0.15
*** FLOP *** [4c Td 5h]
andrew_yar: bets $0.32
teddyKK: folds 
Uncalled bet ($0.32) returned to andrew_yar
andrew_yar collected $0.48 from pot
andrew_yar: doesn't show hand 
*** SUMMARY ***
Total pot $0.50 | Rake $0.02 
Board [4c Td 5h]
Seat 1: andrew_yar (small blind) collected ($0.48)
Seat 2: teddyKK (big blind) folded on the Flop
Seat 3: Juanchopb79 folded before Flop (didn't bet)
Seat 5: picolino995 folded before Flop (didn't bet)
Seat 6: RUMJO (button) folded before Flop (didn't bet)



PokerStars Hand #222968358534:  Hold'em No Limit ($0.05/$0.10 USD) - 2021/01/23 15:10:42 ET
Table 'Stephano III' 6-max Seat #1 is the button
Seat 1: andrew_yar ($10.28 in chips) 
Seat 2: teddyKK ($12.40 in chips) 
Seat 3: Juanchopb79 ($10.08 in chips) 
Seat 5: picolino995 ($4.78 in chips) 
Seat 6: RUMJO ($9.60 in chips) 
teddyKK: posts small blind $0.05
Juanchopb79: posts big blind $0.10
*** HOLE CARDS ***
picolino995: calls $0.10
RUMJO: folds 
andrew_yar: folds 
teddyKK: folds 
Juanchopb79: raises $0.40 to $0.50
picolino995: folds 
Uncalled bet ($0.40) returned to Juanchopb79
Juanchopb79 collected $0.25 from pot
Juanchopb79: doesn't show hand 
*** SUMMARY ***
Total pot $0.25 | Rake $0 
Seat 1: andrew_yar (button) folded before Flop (didn't bet)
Seat 2: teddyKK (small blind) folded before Flop
Seat 3: Juanchopb79 (big blind) collected ($0.25)
Seat 5: picolino995 folded before Flop
Seat 6: RUMJO folded before Flop (didn't bet)



PokerStars Hand #222968382707:  Hold'em No Limit ($0.05/$0.10 USD) - 2021/01/23 15:11:10 ET
Table 'Stephano III' 6-max Seat #2 is the button
Seat 1: andrew_yar ($10.28 in chips) 
Seat 2: teddyKK ($12.35 in chips) 
Seat 3: Juanchopb79 ($10.23 in chips) 
Seat 5: picolino995 ($4.68 in chips) 
Seat 6: RUMJO ($9.60 in chips) 
Juanchopb79: posts small blind $0.05
picolino995: posts big blind $0.10
*** HOLE CARDS ***
RUMJO: folds 
andrew_yar: raises $0.15 to $0.25
teddyKK: folds 
Juanchopb79: folds 
picolino995: calls $0.15
*** FLOP *** [Kc Ah 4c]
picolino995: checks 
andrew_yar: checks 
*** TURN *** [Kc Ah 4c] [2h]
picolino995: bets $0.26
andrew_yar: folds 
Uncalled bet ($0.26) returned to picolino995
picolino995 collected $0.53 from pot
picolino995: doesn't show hand 
*** SUMMARY ***
Total pot $0.55 | Rake $0.02 
Board [Kc Ah 4c 2h]
Seat 1: andrew_yar folded on the Turn
Seat 2: teddyKK (button) folded before Flop (didn't bet)
Seat 3: Juanchopb79 (small blind) folded before Flop
Seat 5: picolino995 (big blind) collected ($0.53)
Seat 6: RUMJO folded before Flop (didn't bet)



PokerStars Hand #222968415043:  Hold'em No Limit ($0.05/$0.10 USD) - 2021/01/23 15:11:49 ET
Table 'Stephano III' 6-max Seat #3 is the button
Seat 1: andrew_yar ($10.03 in chips) 
Seat 2: teddyKK ($12.35 in chips) 
Seat 3: Juanchopb79 ($10.18 in chips) 
Seat 5: picolino995 ($4.96 in chips) 
Seat 6: RUMJO ($9.60 in chips) 
picolino995: posts small blind $0.05
RUMJO: posts big blind $0.10
*** HOLE CARDS ***
andrew_yar: raises $0.20 to $0.30
teddyKK: folds 
Juanchopb79: folds 
picolino995: folds 
RUMJO: folds 
Uncalled bet ($0.20) returned to andrew_yar
andrew_yar collected $0.25 from pot
andrew_yar: doesn't show hand 
*** SUMMARY ***
Total pot $0.25 | Rake $0 
Seat 1: andrew_yar collected ($0.25)
Seat 2: teddyKK folded before Flop (didn't bet)
Seat 3: Juanchopb79 (button) folded before Flop (didn't bet)
Seat 5: picolino995 (small blind) folded before Flop
Seat 6: RUMJO (big blind) folded before Flop



PokerStars Hand #222968433765:  Hold'em No Limit ($0.05/$0.10 USD) - 2021/01/23 15:12:03 ET
Table 'Stephano III' 6-max Seat #5 is the button
Seat 1: andrew_yar ($10.18 in chips) 
Seat 2: teddyKK ($12.35 in chips) 
Seat 3: Juanchopb79 ($10.18 in chips) 
Seat 5: picolino995 ($4.91 in chips) 
Seat 6: RUMJO ($9.50 in chips) 
RUMJO: posts small blind $0.05
andrew_yar: posts big blind $0.10
*** HOLE CARDS ***
teddyKK: folds 
Juanchopb79: folds 
picolino995: folds 
RUMJO: raises $0.15 to $0.25
andrew_yar: folds 
Uncalled bet ($0.15) returned to RUMJO
RUMJO collected $0.20 from pot
RUMJO: doesn't show hand 
*** SUMMARY ***
Total pot $0.20 | Rake $0 
Seat 1: andrew_yar (big blind) folded before Flop
Seat 2: teddyKK folded before Flop (didn't bet)
Seat 3: Juanchopb79 folded before Flop (didn't bet)
Seat 5: picolino995 (button) folded before Flop (didn't bet)
Seat 6: RUMJO (small blind) collected ($0.20)



PokerStars Hand #222968445084:  Hold'em No Limit ($0.05/$0.10 USD) - 2021/01/23 15:12:17 ET
Table 'Stephano III' 6-max Seat #6 is the button
Seat 1: andrew_yar ($10.08 in chips) 
Seat 2: teddyKK ($12.35 in chips) 
Seat 3: Juanchopb79 ($10.18 in chips) 
Seat 5: picolino995 ($4.91 in chips) 
Seat 6: RUMJO ($9.60 in chips) 
andrew_yar: posts small blind $0.05
teddyKK: posts big blind $0.10
*** HOLE CARDS ***
Juanchopb79: folds 
picolino995: calls $0.10
RUMJO: raises $0.30 to $0.40
andrew_yar: calls $0.35
teddyKK: folds 
picolino995: folds 
*** FLOP *** [Jc Ac 7d]
andrew_yar: checks 
RUMJO: bets $0.40
andrew_yar: folds 
Uncalled bet ($0.40) returned to RUMJO
RUMJO collected $0.96 from pot
RUMJO: doesn't show hand 
*** SUMMARY ***
Total pot $1 | Rake $0.04 
Board [Jc Ac 7d]
Seat 1: andrew_yar (small blind) folded on the Flop
Seat 2: teddyKK (big blind) folded before Flop
Seat 3: Juanchopb79 folded before Flop (didn't bet)
Seat 5: picolino995 folded before Flop
Seat 6: RUMJO (button) collected ($0.96)



PokerStars Hand #222968488640:  Hold'em No Limit ($0.05/$0.10 USD) - 2021/01/23 15:13:08 ET
Table 'Stephano III' 6-max Seat #1 is the button
Seat 1: andrew_yar ($10 in chips) 
Seat 2: teddyKK ($12.25 in chips) 
Seat 3: Juanchopb79 ($10.18 in chips) 
Seat 5: picolino995 ($4.81 in chips) 
Seat 6: RUMJO ($10.16 in chips) 
teddyKK: posts small blind $0.05
Juanchopb79: posts big blind $0.10
*** HOLE CARDS ***
picolino995: folds 
RUMJO: folds 
andrew_yar: folds 
teddyKK: folds 
Uncalled bet ($0.05) returned to Juanchopb79
Juanchopb79 collected $0.10 from pot
Juanchopb79: doesn't show hand 
*** SUMMARY ***
Total pot $0.10 | Rake $0 
Seat 1: andrew_yar (button) folded before Flop (didn't bet)
Seat 2: teddyKK (small blind) folded before Flop
Seat 3: Juanchopb79 (big blind) collected ($0.10)
Seat 5: picolino995 folded before Flop (didn't bet)
Seat 6: RUMJO folded before Flop (didn't bet)



PokerStars Hand #222968501250:  Hold'em No Limit ($0.05/$0.10 USD) - 2021/01/23 15:13:23 ET
Table 'Stephano III' 6-max Seat #2 is the button
Seat 1: andrew_yar ($10 in chips) 
Seat 2: teddyKK ($12.20 in chips) 
Seat 3: Juanchopb79 ($10.23 in chips) 
Seat 5: picolino995 ($4.81 in chips) 
Seat 6: RUMJO ($10.16 in chips) 
Juanchopb79: posts small blind $0.05
picolino995: posts big blind $0.10
*** HOLE CARDS ***
RUMJO: folds 
andrew_yar: folds 
teddyKK: folds 
Juanchopb79: raises $0.20 to $0.30
picolino995: folds 
Uncalled bet ($0.20) returned to Juanchopb79
Juanchopb79 collected $0.20 from pot
Ochinev was removed from the table for failing to post
Ochinev leaves the table
Juanchopb79: doesn't show hand 
*** SUMMARY ***
Total pot $0.20 | Rake $0 
Seat 1: andrew_yar folded before Flop (didn't bet)
Seat 2: teddyKK (button) folded before Flop (didn't bet)
Seat 3: Juanchopb79 (small blind) collected ($0.20)
Seat 5: picolino995 (big blind) folded before Flop
Seat 6: RUMJO folded before Flop (didn't bet)



PokerStars Hand #222968512327:  Hold'em No Limit ($0.05/$0.10 USD) - 2021/01/23 15:13:37 ET
Table 'Stephano III' 6-max Seat #3 is the button
Seat 1: andrew_yar ($10 in chips) 
Seat 2: teddyKK ($12.20 in chips) 
Seat 3: Juanchopb79 ($10.33 in chips) 
Seat 5: picolino995 ($4.71 in chips) 
Seat 6: RUMJO ($10.16 in chips) 
picolino995: posts small blind $0.05
RUMJO: posts big blind $0.10
*** HOLE CARDS ***
KiraLasVegas joins the table at seat #4 
andrew_yar: raises $0.20 to $0.30
KiraLasVegas leaves the table
teddyKK: calls $0.30
Juanchopb79: folds 
picolino995: folds 
RUMJO: folds 
*** FLOP *** [7h Qc 4h]
andrew_yar: bets $0.48
teddyKK: calls $0.48
*** TURN *** [7h Qc 4h] [8s]
andrew_yar: checks 
teddyKK: bets $1.10
Kobert72 joins the table at seat #4 
andrew_yar: calls $1.10
*** RIVER *** [7h Qc 4h 8s] [5c]
andrew_yar: checks 
teddyKK: bets $1.40
andrew_yar: calls $1.40
*** SHOW DOWN ***
teddyKK: shows [Ac 9c] (high card Ace)
andrew_yar: shows [Ad Qh] (a pair of Queens)
andrew_yar collected $6.41 from pot
*** SUMMARY ***
Total pot $6.71 | Rake $0.30 
Board [7h Qc 4h 8s 5c]
Seat 1: andrew_yar showed [Ad Qh] and won ($6.41) with a pair of Queens
Seat 2: teddyKK showed [Ac 9c] and lost with high card Ace
Seat 3: Juanchopb79 (button) folded before Flop (didn't bet)
Seat 5: picolino995 (small blind) folded before Flop
Seat 6: RUMJO (big blind) folded before Flop



PokerStars Hand #222968558786:  Hold'em No Limit ($0.05/$0.10 USD) - 2021/01/23 15:14:32 ET
Table 'Stephano III' 6-max Seat #5 is the button
Seat 1: andrew_yar ($13.13 in chips) 
Seat 2: teddyKK ($8.92 in chips) 
Seat 3: Juanchopb79 ($10.33 in chips) 
Seat 5: picolino995 ($4.66 in chips) 
Seat 6: RUMJO ($10.06 in chips) 
RUMJO: posts small blind $0.05
andrew_yar: posts big blind $0.10
Kobert72: sits out 
*** HOLE CARDS ***
teddyKK: folds 
Juanchopb79: folds 
picolino995: calls $0.10
RUMJO: folds 
andrew_yar: checks 
*** FLOP *** [2h 5h Ac]
andrew_yar: checks 
picolino995: bets $0.10
andrew_yar: folds 
Uncalled bet ($0.10) returned to picolino995
picolino995 collected $0.24 from pot
picolino995: doesn't show hand 
*** SUMMARY ***
Total pot $0.25 | Rake $0.01 
Board [2h 5h Ac]
Seat 1: andrew_yar (big blind) folded on the Flop
Seat 2: teddyKK folded before Flop (didn't bet)
Seat 3: Juanchopb79 folded before Flop (didn't bet)
Seat 5: picolino995 (button) collected ($0.24)
Seat 6: RUMJO (small blind) folded before Flop



PokerStars Hand #222968586369:  Hold'em No Limit ($0.05/$0.10 USD) - 2021/01/23 15:15:05 ET
Table 'Stephano III' 6-max Seat #6 is the button
Seat 1: andrew_yar ($13.03 in chips) 
Seat 2: teddyKK ($8.92 in chips) 
Seat 3: Juanchopb79 ($10.33 in chips) 
Seat 5: picolino995 ($4.80 in chips) 
Seat 6: RUMJO ($10.01 in chips) 
andrew_yar: posts small blind $0.05
teddyKK: posts big blind $0.10
Kobert72: sits out 
*** HOLE CARDS ***
Juanchopb79: folds 
picolino995: raises $0.10 to $0.20
RUMJO: folds 
andrew_yar: folds 
teddyKK: folds 
Uncalled bet ($0.10) returned to picolino995
picolino995 collected $0.25 from pot
picolino995: doesn't show hand 
*** SUMMARY ***
Total pot $0.25 | Rake $0 
Seat 1: andrew_yar (small blind) folded before Flop
Seat 2: teddyKK (big blind) folded before Flop
Seat 3: Juanchopb79 folded before Flop (didn't bet)
Seat 5: picolino995 collected ($0.25)
Seat 6: RUMJO (button) folded before Flop (didn't bet)



PokerStars Hand #222968598644:  Hold'em No Limit ($0.05/$0.10 USD) - 2021/01/23 15:15:19 ET
Table 'Stephano III' 6-max Seat #1 is the button
Seat 1: andrew_yar ($12.98 in chips) 
Seat 2: teddyKK ($8.82 in chips) 
Seat 3: Juanchopb79 ($10.33 in chips) 
Seat 5: picolino995 ($4.95 in chips) 
Seat 6: RUMJO ($10.01 in chips) 
teddyKK: posts small blind $0.05
Juanchopb79: posts big blind $0.10
Kobert72: sits out 
*** HOLE CARDS ***
picolino995: calls $0.10
RUMJO: folds 
andrew_yar: folds 
teddyKK: folds 
Juanchopb79: checks 
*** FLOP *** [7c 8d Td]
Juanchopb79: checks 
picolino995: checks 
*** TURN *** [7c 8d Td] [7s]
Juanchopb79: checks 
picolino995: checks 
*** RIVER *** [7c 8d Td 7s] [Jc]
Juanchopb79: checks 
picolino995: checks 
*** SHOW DOWN ***
Juanchopb79: shows [8s 3d] (two pair, Eights and Sevens)
picolino995: mucks hand 
Juanchopb79 collected $0.24 from pot
*** SUMMARY ***
Total pot $0.25 | Rake $0.01 
Board [7c 8d Td 7s Jc]
Seat 1: andrew_yar (button) folded before Flop (didn't bet)
Seat 2: teddyKK (small blind) folded before Flop
Seat 3: Juanchopb79 (big blind) showed [8s 3d] and won ($0.24) with two pair, Eights and Sevens
Seat 5: picolino995 mucked
Seat 6: RUMJO folded before Flop (didn't bet)



PokerStars Hand #222968648673:  Hold'em No Limit ($0.05/$0.10 USD) - 2021/01/23 15:16:18 ET
Table 'Stephano III' 6-max Seat #2 is the button
Seat 1: andrew_yar ($12.98 in chips) 
Seat 2: teddyKK ($8.77 in chips) 
Seat 3: Juanchopb79 ($10.47 in chips) 
Seat 4: Kobert72 ($10 in chips) 
Seat 5: picolino995 ($4.85 in chips) 
Seat 6: RUMJO ($10.01 in chips) 
Juanchopb79: posts small blind $0.05
Kobert72: posts big blind $0.10
*** HOLE CARDS ***
picolino995: calls $0.10
RUMJO: folds 
andrew_yar: raises $0.35 to $0.45
teddyKK: folds 
Juanchopb79: folds 
Kobert72: folds 
picolino995: folds 
Uncalled bet ($0.35) returned to andrew_yar
andrew_yar collected $0.35 from pot
andrew_yar: doesn't show hand 
*** SUMMARY ***
Total pot $0.35 | Rake $0 
Seat 1: andrew_yar collected ($0.35)
Seat 2: teddyKK (button) folded before Flop (didn't bet)
Seat 3: Juanchopb79 (small blind) folded before Flop
Seat 4: Kobert72 (big blind) folded before Flop
Seat 5: picolino995 folded before Flop
Seat 6: RUMJO folded before Flop (didn't bet)



PokerStars Hand #222968661522:  Hold'em No Limit ($0.05/$0.10 USD) - 2021/01/23 15:16:33 ET
Table 'Stephano III' 6-max Seat #3 is the button
Seat 1: andrew_yar ($13.23 in chips) 
Seat 2: teddyKK ($8.77 in chips) 
Seat 3: Juanchopb79 ($10.42 in chips) 
Seat 4: Kobert72 ($10 in chips) 
Seat 5: picolino995 ($4.75 in chips) 
Seat 6: RUMJO ($10.01 in chips) 
Kobert72: posts small blind $0.05
picolino995: posts big blind $0.10
*** HOLE CARDS ***
RUMJO: raises $0.15 to $0.25
andrew_yar: folds 
teddyKK: folds 
Juanchopb79: folds 
Kobert72: folds 
picolino995: calls $0.15
*** FLOP *** [6h 4s Ts]
picolino995: checks 
RUMJO: checks 
*** TURN *** [6h 4s Ts] [8d]
picolino995: checks 
RUMJO: bets $0.16
picolino995: calls $0.16
*** RIVER *** [6h 4s Ts 8d] [5s]
picolino995: checks 
RUMJO: checks 
*** SHOW DOWN ***
picolino995: shows [Kh 9d] (high card King)
RUMJO: shows [Qs Kd] (high card King - Queen kicker)
RUMJO collected $0.83 from pot
*** SUMMARY ***
Total pot $0.87 | Rake $0.04 
Board [6h 4s Ts 8d 5s]
Seat 1: andrew_yar folded before Flop (didn't bet)
Seat 2: teddyKK folded before Flop (didn't bet)
Seat 3: Juanchopb79 (button) folded before Flop (didn't bet)
Seat 4: Kobert72 (small blind) folded before Flop
Seat 5: picolino995 (big blind) showed [Kh 9d] and lost with high card King
Seat 6: RUMJO showed [Qs Kd] and won ($0.83) with high card King



PokerStars Hand #222968693934:  Hold'em No Limit ($0.05/$0.10 USD) - 2021/01/23 15:17:11 ET
Table 'Stephano III' 6-max Seat #4 is the button
Seat 1: andrew_yar ($13.23 in chips) 
Seat 2: teddyKK ($8.77 in chips) 
Seat 3: Juanchopb79 ($10.42 in chips) 
Seat 4: Kobert72 ($10 in chips) 
Seat 5: picolino995 ($4.34 in chips) 
Seat 6: RUMJO ($10.43 in chips) 
picolino995: posts small blind $0.05
RUMJO: posts big blind $0.10
*** HOLE CARDS ***
andrew_yar: folds 
teddyKK: folds 
Juanchopb79: folds 
Kobert72: folds 
picolino995: folds 
Uncalled bet ($0.05) returned to RUMJO
RUMJO collected $0.10 from pot
RUMJO: doesn't show hand 
*** SUMMARY ***
Total pot $0.10 | Rake $0 
Seat 1: andrew_yar folded before Flop (didn't bet)
Seat 2: teddyKK folded before Flop (didn't bet)
Seat 3: Juanchopb79 folded before Flop (didn't bet)
Seat 4: Kobert72 (button) folded before Flop (didn't bet)
Seat 5: picolino995 (small blind) folded before Flop
Seat 6: RUMJO (big blind) collected ($0.10)



PokerStars Hand #222968709833:  Hold'em No Limit ($0.05/$0.10 USD) - 2021/01/23 15:17:30 ET
Table 'Stephano III' 6-max Seat #5 is the button
Seat 1: andrew_yar ($13.23 in chips) 
Seat 2: teddyKK ($8.77 in chips) 
Seat 3: Juanchopb79 ($10.42 in chips) 
Seat 4: Kobert72 ($10 in chips) 
Seat 5: picolino995 ($4.29 in chips) 
Seat 6: RUMJO ($10.48 in chips) 
RUMJO: posts small blind $0.05
andrew_yar: posts big blind $0.10
*** HOLE CARDS ***
teddyKK: folds 
Juanchopb79: folds 
Kobert72: folds 
picolino995: raises $0.20 to $0.30
RUMJO: folds 
andrew_yar: calls $0.20
*** FLOP *** [8h 9h 5d]
andrew_yar: checks 
picolino995: checks 
*** TURN *** [8h 9h 5d] [6h]
andrew_yar: bets $0.42
picolino995: folds 
Uncalled bet ($0.42) returned to andrew_yar
andrew_yar collected $0.62 from pot
andrew_yar: doesn't show hand 
*** SUMMARY ***
Total pot $0.65 | Rake $0.03 
Board [8h 9h 5d 6h]
Seat 1: andrew_yar (big blind) collected ($0.62)
Seat 2: teddyKK folded before Flop (didn't bet)
Seat 3: Juanchopb79 folded before Flop (didn't bet)
Seat 4: Kobert72 folded before Flop (didn't bet)
Seat 5: picolino995 (button) folded on the Turn
Seat 6: RUMJO (small blind) folded before Flop



PokerStars Hand #222968749859:  Hold'em No Limit ($0.05/$0.10 USD) - 2021/01/23 15:18:16 ET
Table 'Stephano III' 6-max Seat #6 is the button
Seat 1: andrew_yar ($13.55 in chips) 
Seat 2: teddyKK ($8.77 in chips) 
Seat 3: Juanchopb79 ($10.42 in chips) 
Seat 4: Kobert72 ($10 in chips) 
Seat 5: picolino995 ($3.99 in chips) 
Seat 6: RUMJO ($10.43 in chips) 
andrew_yar: posts small blind $0.05
teddyKK: posts big blind $0.10
*** HOLE CARDS ***
Juanchopb79: raises $0.20 to $0.30
Kobert72: folds 
picolino995: calls $0.30
RUMJO: folds 
andrew_yar: folds 
teddyKK: folds 
*** FLOP *** [6c 5d 6h]
Juanchopb79: bets $0.36
picolino995: folds 
Uncalled bet ($0.36) returned to Juanchopb79
Juanchopb79 collected $0.72 from pot
Juanchopb79: doesn't show hand 
*** SUMMARY ***
Total pot $0.75 | Rake $0.03 
Board [6c 5d 6h]
Seat 1: andrew_yar (small blind) folded before Flop
Seat 2: teddyKK (big blind) folded before Flop
Seat 3: Juanchopb79 collected ($0.72)
Seat 4: Kobert72 folded before Flop (didn't bet)
Seat 5: picolino995 folded on the Flop
Seat 6: RUMJO (button) folded before Flop (didn't bet)



PokerStars Hand #222968779997:  Hold'em No Limit ($0.05/$0.10 USD) - 2021/01/23 15:18:52 ET
Table 'Stephano III' 6-max Seat #1 is the button
Seat 1: andrew_yar ($13.50 in chips) 
Seat 2: teddyKK ($8.67 in chips) 
Seat 3: Juanchopb79 ($10.84 in chips) 
Seat 4: Kobert72 ($10 in chips) 
Seat 5: picolino995 ($3.69 in chips) 
Seat 6: RUMJO ($10.43 in chips) 
teddyKK: posts small blind $0.05
Juanchopb79: posts big blind $0.10
*** HOLE CARDS ***
Kobert72: folds 
picolino995: raises $0.20 to $0.30
RUMJO: folds 
andrew_yar: folds 
teddyKK: folds 
Juanchopb79: folds 
Uncalled bet ($0.20) returned to picolino995
picolino995 collected $0.25 from pot
picolino995: doesn't show hand 
*** SUMMARY ***
Total pot $0.25 | Rake $0 
Seat 1: andrew_yar (button) folded before Flop (didn't bet)
Seat 2: teddyKK (small blind) folded before Flop
Seat 3: Juanchopb79 (big blind) folded before Flop
Seat 4: Kobert72 folded before Flop (didn't bet)
Seat 5: picolino995 collected ($0.25)
Seat 6: RUMJO folded before Flop (didn't bet)



PokerStars Hand #222968801340:  Hold'em No Limit ($0.05/$0.10 USD) - 2021/01/23 15:19:17 ET
Table 'Stephano III' 6-max Seat #2 is the button
Seat 1: andrew_yar ($13.50 in chips) 
Seat 2: teddyKK ($8.62 in chips) 
Seat 3: Juanchopb79 ($10.74 in chips) 
Seat 4: Kobert72 ($10 in chips) 
Seat 5: picolino995 ($3.84 in chips) 
Seat 6: RUMJO ($10.43 in chips) 
Juanchopb79: posts small blind $0.05
Kobert72: posts big blind $0.10
*** HOLE CARDS ***
picolino995: folds 
RUMJO: folds 
andrew_yar: folds 
teddyKK: folds 
Juanchopb79: raises $0.20 to $0.30
Kobert72: folds 
Uncalled bet ($0.20) returned to Juanchopb79
Juanchopb79 collected $0.20 from pot
Juanchopb79: doesn't show hand 
*** SUMMARY ***
Total pot $0.20 | Rake $0 
Seat 1: andrew_yar folded before Flop (didn't bet)
Seat 2: teddyKK (button) folded before Flop (didn't bet)
Seat 3: Juanchopb79 (small blind) collected ($0.20)
Seat 4: Kobert72 (big blind) folded before Flop
Seat 5: picolino995 folded before Flop (didn't bet)
Seat 6: RUMJO folded before Flop (didn't bet)



PokerStars Hand #222968817377:  Hold'em No Limit ($0.05/$0.10 USD) - 2021/01/23 15:19:36 ET
Table 'Stephano III' 6-max Seat #3 is the button
Seat 1: andrew_yar ($13.50 in chips) 
Seat 2: teddyKK ($8.62 in chips) 
Seat 3: Juanchopb79 ($10.84 in chips) 
Seat 4: Kobert72 ($10 in chips) 
Seat 5: picolino995 ($3.84 in chips) 
Seat 6: RUMJO ($10.43 in chips) 
Kobert72: posts small blind $0.05
picolino995: posts big blind $0.10
*** HOLE CARDS ***
RUMJO: folds 
andrew_yar: folds 
teddyKK: folds 
Juanchopb79: folds 
Kobert72: folds 
Uncalled bet ($0.05) returned to picolino995
picolino995 collected $0.10 from pot
picolino995: doesn't show hand 
*** SUMMARY ***
Total pot $0.10 | Rake $0 
Seat 1: andrew_yar folded before Flop (didn't bet)
Seat 2: teddyKK folded before Flop (didn't bet)
Seat 3: Juanchopb79 (button) folded before Flop (didn't bet)
Seat 4: Kobert72 (small blind) folded before Flop
Seat 5: picolino995 (big blind) collected ($0.10)
Seat 6: RUMJO folded before Flop (didn't bet)



PokerStars Hand #222968828808:  Hold'em No Limit ($0.05/$0.10 USD) - 2021/01/23 15:19:49 ET
Table 'Stephano III' 6-max Seat #4 is the button
Seat 1: andrew_yar ($13.50 in chips) 
Seat 2: teddyKK ($8.62 in chips) 
Seat 3: Juanchopb79 ($10.84 in chips) 
Seat 4: Kobert72 ($10 in chips) 
Seat 5: picolino995 ($3.89 in chips) 
Seat 6: RUMJO ($10.43 in chips) 
picolino995: posts small blind $0.05
RUMJO: posts big blind $0.10
*** HOLE CARDS ***
andrew_yar: folds 
teddyKK: folds 
Juanchopb79: folds 
Kobert72: folds 
picolino995: folds 
Uncalled bet ($0.05) returned to RUMJO
RUMJO collected $0.10 from pot
RUMJO: doesn't show hand 
*** SUMMARY ***
Total pot $0.10 | Rake $0 
Seat 1: andrew_yar folded before Flop (didn't bet)
Seat 2: teddyKK folded before Flop (didn't bet)
Seat 3: Juanchopb79 folded before Flop (didn't bet)
Seat 4: Kobert72 (button) folded before Flop (didn't bet)
Seat 5: picolino995 (small blind) folded before Flop
Seat 6: RUMJO (big blind) collected ($0.10)



PokerStars Hand #222968835616:  Hold'em No Limit ($0.05/$0.10 USD) - 2021/01/23 15:19:57 ET
Table 'Stephano III' 6-max Seat #5 is the button
Seat 1: andrew_yar ($13.50 in chips) 
Seat 2: teddyKK ($8.62 in chips) 
Seat 3: Juanchopb79 ($10.84 in chips) 
Seat 4: Kobert72 ($10 in chips) 
Seat 5: picolino995 ($3.84 in chips) 
Seat 6: RUMJO ($10.48 in chips) 
RUMJO: posts small blind $0.05
andrew_yar: posts big blind $0.10
*** HOLE CARDS ***
teddyKK: raises $0.20 to $0.30
Juanchopb79: folds 
Kobert72: folds 
picolino995: folds 
RUMJO: folds 
andrew_yar: folds 
Uncalled bet ($0.20) returned to teddyKK
teddyKK collected $0.25 from pot
teddyKK: doesn't show hand 
*** SUMMARY ***
Total pot $0.25 | Rake $0 
Seat 1: andrew_yar (big blind) folded before Flop
Seat 2: teddyKK collected ($0.25)
Seat 3: Juanchopb79 folded before Flop (didn't bet)
Seat 4: Kobert72 folded before Flop (didn't bet)
Seat 5: picolino995 (button) folded before Flop (didn't bet)
Seat 6: RUMJO (small blind) folded before Flop



PokerStars Hand #222968846493:  Hold'em No Limit ($0.05/$0.10 USD) - 2021/01/23 15:20:10 ET
Table 'Stephano III' 6-max Seat #6 is the button
Seat 1: andrew_yar ($13.40 in chips) 
Seat 2: teddyKK ($8.77 in chips) 
Seat 3: Juanchopb79 ($10.84 in chips) 
Seat 4: Kobert72 ($10 in chips) 
Seat 5: picolino995 ($3.84 in chips) 
Seat 6: RUMJO ($10.43 in chips) 
andrew_yar: posts small blind $0.05
teddyKK: posts big blind $0.10
*** HOLE CARDS ***
Juanchopb79: folds 
Kobert72: folds 
picolino995: folds 
RUMJO: raises $0.15 to $0.25
andrew_yar: folds 
teddyKK: folds 
Uncalled bet ($0.15) returned to RUMJO
RUMJO collected $0.25 from pot
RUMJO: doesn't show hand 
*** SUMMARY ***
Total pot $0.25 | Rake $0 
Seat 1: andrew_yar (small blind) folded before Flop
Seat 2: teddyKK (big blind) folded before Flop
Seat 3: Juanchopb79 folded before Flop (didn't bet)
Seat 4: Kobert72 folded before Flop (didn't bet)
Seat 5: picolino995 folded before Flop (didn't bet)
Seat 6: RUMJO (button) collected ($0.25)



PokerStars Hand #222968869871:  Hold'em No Limit ($0.05/$0.10 USD) - 2021/01/23 15:20:37 ET
Table 'Stephano III' 6-max Seat #1 is the button
Seat 1: andrew_yar ($13.35 in chips) 
Seat 2: teddyKK ($8.67 in chips) 
Seat 3: Juanchopb79 ($10.84 in chips) 
Seat 4: Kobert72 ($10 in chips) 
Seat 5: picolino995 ($3.84 in chips) 
Seat 6: RUMJO ($10.58 in chips) 
teddyKK: posts small blind $0.05
Juanchopb79: posts big blind $0.10
*** HOLE CARDS ***
Kobert72: folds 
picolino995: folds 
RUMJO: folds 
andrew_yar: folds 
teddyKK: folds 
Uncalled bet ($0.05) returned to Juanchopb79
Juanchopb79 collected $0.10 from pot
Juanchopb79: doesn't show hand 
*** SUMMARY ***
Total pot $0.10 | Rake $0 
Seat 1: andrew_yar (button) folded before Flop (didn't bet)
Seat 2: teddyKK (small blind) folded before Flop
Seat 3: Juanchopb79 (big blind) collected ($0.10)
Seat 4: Kobert72 folded before Flop (didn't bet)
Seat 5: picolino995 folded before Flop (didn't bet)
Seat 6: RUMJO folded before Flop (didn't bet)



PokerStars Hand #222968881840:  Hold'em No Limit ($0.05/$0.10 USD) - 2021/01/23 15:20:51 ET
Table 'Stephano III' 6-max Seat #2 is the button
Seat 1: andrew_yar ($13.35 in chips) 
Seat 2: teddyKK ($8.62 in chips) 
Seat 3: Juanchopb79 ($10.89 in chips) 
Seat 4: Kobert72 ($10 in chips) 
Seat 5: picolino995 ($3.84 in chips) 
Seat 6: RUMJO ($10.58 in chips) 
Juanchopb79: posts small blind $0.05
Kobert72: posts big blind $0.10
*** HOLE CARDS ***
picolino995: folds 
RUMJO: raises $0.15 to $0.25
andrew_yar: folds 
teddyKK: folds 
Juanchopb79: folds 
Kobert72: folds 
Uncalled bet ($0.15) returned to RUMJO
RUMJO collected $0.25 from pot
RUMJO: doesn't show hand 
*** SUMMARY ***
Total pot $0.25 | Rake $0 
Seat 1: andrew_yar folded before Flop (didn't bet)
Seat 2: teddyKK (button) folded before Flop (didn't bet)
Seat 3: Juanchopb79 (small blind) folded before Flop
Seat 4: Kobert72 (big blind) folded before Flop
Seat 5: picolino995 folded before Flop (didn't bet)
Seat 6: RUMJO collected ($0.25)



PokerStars Hand #222968896294:  Hold'em No Limit ($0.05/$0.10 USD) - 2021/01/23 15:21:07 ET
Table 'Stephano III' 6-max Seat #3 is the button
Seat 1: andrew_yar ($13.35 in chips) 
Seat 2: teddyKK ($8.62 in chips) 
Seat 3: Juanchopb79 ($10.84 in chips) 
Seat 4: Kobert72 ($10 in chips) 
Seat 5: picolino995 ($3.84 in chips) 
Seat 6: RUMJO ($10.73 in chips) 
Kobert72: posts small blind $0.05
picolino995: posts big blind $0.10
*** HOLE CARDS ***
RUMJO: folds 
andrew_yar: folds 
teddyKK: folds 
Juanchopb79: folds 
Kobert72: raises $0.20 to $0.30
picolino995: calls $0.20
*** FLOP *** [3c 8d 6h]
Kobert72: bets $0.19
picolino995: calls $0.19
*** TURN *** [3c 8d 6h] [8s]
Kobert72: checks 
picolino995: bets $0.60
Kobert72: folds 
Uncalled bet ($0.60) returned to picolino995
picolino995 collected $0.94 from pot
picolino995: doesn't show hand 
*** SUMMARY ***
Total pot $0.98 | Rake $0.04 
Board [3c 8d 6h 8s]
Seat 1: andrew_yar folded before Flop (didn't bet)
Seat 2: teddyKK folded before Flop (didn't bet)
Seat 3: Juanchopb79 (button) folded before Flop (didn't bet)
Seat 4: Kobert72 (small blind) folded on the Turn
Seat 5: picolino995 (big blind) collected ($0.94)
Seat 6: RUMJO folded before Flop (didn't bet)



PokerStars Hand #222968925981:  Hold'em No Limit ($0.05/$0.10 USD) - 2021/01/23 15:21:42 ET
Table 'Stephano III' 6-max Seat #4 is the button
Seat 1: andrew_yar ($13.35 in chips) 
Seat 2: teddyKK ($8.62 in chips) 
Seat 3: Juanchopb79 ($10.84 in chips) 
Seat 4: Kobert72 ($10 in chips) 
Seat 5: picolino995 ($4.29 in chips) 
Seat 6: RUMJO ($10.73 in chips) 
picolino995: posts small blind $0.05
RUMJO: posts big blind $0.10
*** HOLE CARDS ***
andrew_yar: folds 
teddyKK: folds 
Juanchopb79: folds 
Kobert72: raises $0.13 to $0.23
picolino995: calls $0.18
RUMJO: folds 
*** FLOP *** [8c 6d 7d]
picolino995: checks 
Kobert72: checks 
*** TURN *** [8c 6d 7d] [7c]
picolino995: checks 
Kobert72: checks 
*** RIVER *** [8c 6d 7d 7c] [Kh]
picolino995: checks 
Kobert72: bets $0.40
picolino995: folds 
Uncalled bet ($0.40) returned to Kobert72
Kobert72 collected $0.53 from pot
Kobert72: doesn't show hand 
*** SUMMARY ***
Total pot $0.56 | Rake $0.03 
Board [8c 6d 7d 7c Kh]
Seat 1: andrew_yar folded before Flop (didn't bet)
Seat 2: teddyKK folded before Flop (didn't bet)
Seat 3: Juanchopb79 folded before Flop (didn't bet)
Seat 4: Kobert72 (button) collected ($0.53)
Seat 5: picolino995 (small blind) folded on the River
Seat 6: RUMJO (big blind) folded before Flop



PokerStars Hand #222968951561:  Hold'em No Limit ($0.05/$0.10 USD) - 2021/01/23 15:22:11 ET
Table 'Stephano III' 6-max Seat #5 is the button
Seat 1: andrew_yar ($13.35 in chips) 
Seat 2: teddyKK ($8.62 in chips) 
Seat 3: Juanchopb79 ($10.84 in chips) 
Seat 4: Kobert72 ($10.30 in chips) 
Seat 5: picolino995 ($4.06 in chips) 
Seat 6: RUMJO ($10.63 in chips) 
RUMJO: posts small blind $0.05
andrew_yar: posts big blind $0.10
*** HOLE CARDS ***
teddyKK: folds 
Juanchopb79: folds 
Kobert72: folds 
picolino995: raises $0.25 to $0.35
RUMJO: folds 
andrew_yar: folds 
Uncalled bet ($0.25) returned to picolino995
picolino995 collected $0.25 from pot
picolino995: doesn't show hand 
*** SUMMARY ***
Total pot $0.25 | Rake $0 
Seat 1: andrew_yar (big blind) folded before Flop
Seat 2: teddyKK folded before Flop (didn't bet)
Seat 3: Juanchopb79 folded before Flop (didn't bet)
Seat 4: Kobert72 folded before Flop (didn't bet)
Seat 5: picolino995 (button) collected ($0.25)
Seat 6: RUMJO (small blind) folded before Flop



PokerStars Hand #222968964526:  Hold'em No Limit ($0.05/$0.10 USD) - 2021/01/23 15:22:26 ET
Table 'Stephano III' 6-max Seat #6 is the button
Seat 1: andrew_yar ($13.25 in chips) 
Seat 2: teddyKK ($8.62 in chips) 
Seat 3: Juanchopb79 ($10.84 in chips) 
Seat 4: Kobert72 ($10.30 in chips) 
Seat 5: picolino995 ($4.21 in chips) 
Seat 6: RUMJO ($10.58 in chips) 
andrew_yar: posts small blind $0.05
teddyKK: posts big blind $0.10
*** HOLE CARDS ***
Juanchopb79: folds 
Kobert72: folds 
picolino995: raises $0.25 to $0.35
RUMJO: folds 
andrew_yar: folds 
teddyKK: folds 
Uncalled bet ($0.25) returned to picolino995
picolino995 collected $0.25 from pot
picolino995: doesn't show hand 
*** SUMMARY ***
Total pot $0.25 | Rake $0 
Seat 1: andrew_yar (small blind) folded before Flop
Seat 2: teddyKK (big blind) folded before Flop
Seat 3: Juanchopb79 folded before Flop (didn't bet)
Seat 4: Kobert72 folded before Flop (didn't bet)
Seat 5: picolino995 collected ($0.25)
Seat 6: RUMJO (button) folded before Flop (didn't bet)



PokerStars Hand #222968978409:  Hold'em No Limit ($0.05/$0.10 USD) - 2021/01/23 15:22:42 ET
Table 'Stephano III' 6-max Seat #1 is the button
Seat 1: andrew_yar ($13.20 in chips) 
Seat 2: teddyKK ($8.52 in chips) 
Seat 3: Juanchopb79 ($10.84 in chips) 
Seat 4: Kobert72 ($10.30 in chips) 
Seat 5: picolino995 ($4.36 in chips) 
Seat 6: RUMJO ($10.58 in chips) 
teddyKK: posts small blind $0.05
Juanchopb79: posts big blind $0.10
*** HOLE CARDS ***
Kobert72: folds 
picolino995: calls $0.10
RUMJO: folds 
andrew_yar: folds 
teddyKK: folds 
Juanchopb79: checks 
*** FLOP *** [Ah Qs 7h]
Juanchopb79: checks 
picolino995: bets $0.10
Juanchopb79: calls $0.10
*** TURN *** [Ah Qs 7h] [Qh]
Juanchopb79: checks 
picolino995: checks 
*** RIVER *** [Ah Qs 7h Qh] [Ts]
Juanchopb79: bets $0.32
picolino995: calls $0.32
*** SHOW DOWN ***
Juanchopb79: shows [9h Qc] (three of a kind, Queens)
picolino995: mucks hand 
Juanchopb79 collected $1.04 from pot
*** SUMMARY ***
Total pot $1.09 | Rake $0.05 
Board [Ah Qs 7h Qh Ts]
Seat 1: andrew_yar (button) folded before Flop (didn't bet)
Seat 2: teddyKK (small blind) folded before Flop
Seat 3: Juanchopb79 (big blind) showed [9h Qc] and won ($1.04) with three of a kind, Queens
Seat 4: Kobert72 folded before Flop (didn't bet)
Seat 5: picolino995 mucked
Seat 6: RUMJO folded before Flop (didn't bet)



PokerStars Hand #222969030117:  Hold'em No Limit ($0.05/$0.10 USD) - 2021/01/23 15:23:42 ET
Table 'Stephano III' 6-max Seat #2 is the button
Seat 1: andrew_yar ($13.20 in chips) 
Seat 2: teddyKK ($8.47 in chips) 
Seat 3: Juanchopb79 ($11.36 in chips) 
Seat 4: Kobert72 ($10.30 in chips) 
Seat 5: picolino995 ($3.84 in chips) 
Seat 6: RUMJO ($10.58 in chips) 
Juanchopb79: posts small blind $0.05
Kobert72: posts big blind $0.10
*** HOLE CARDS ***
picolino995: calls $0.10
RUMJO: folds 
andrew_yar: folds 
teddyKK: folds 
Juanchopb79: folds 
Kobert72: checks 
*** FLOP *** [Ad 5s 9d]
Kobert72: checks 
picolino995: bets $0.10
Kobert72: calls $0.10
*** TURN *** [Ad 5s 9d] [4c]
Kobert72: checks 
picolino995: checks 
*** RIVER *** [Ad 5s 9d 4c] [Js]
Kobert72: checks 
picolino995: checks 
*** SHOW DOWN ***
Kobert72: shows [7c 7d] (a pair of Sevens)
picolino995: mucks hand 
Kobert72 collected $0.43 from pot
*** SUMMARY ***
Total pot $0.45 | Rake $0.02 
Board [Ad 5s 9d 4c Js]
Seat 1: andrew_yar folded before Flop (didn't bet)
Seat 2: teddyKK (button) folded before Flop (didn't bet)
Seat 3: Juanchopb79 (small blind) folded before Flop
Seat 4: Kobert72 (big blind) showed [7c 7d] and won ($0.43) with a pair of Sevens
Seat 5: picolino995 mucked
Seat 6: RUMJO folded before Flop (didn't bet)



PokerStars Hand #222969069280:  Hold'em No Limit ($0.05/$0.10 USD) - 2021/01/23 15:24:28 ET
Table 'Stephano III' 6-max Seat #3 is the button
Seat 1: andrew_yar ($13.20 in chips) 
Seat 2: teddyKK ($8.47 in chips) 
Seat 3: Juanchopb79 ($11.31 in chips) 
Seat 4: Kobert72 ($10.53 in chips) 
Seat 6: RUMJO ($10.58 in chips) 
Kobert72: posts small blind $0.05
picolino995: is sitting out 
RUMJO: posts big blind $0.10
*** HOLE CARDS ***
andrew_yar: folds 
teddyKK: folds 
picolino995 leaves the table
Juanchopb79: folds 
Kobert72: folds 
Uncalled bet ($0.05) returned to RUMJO
RUMJO collected $0.10 from pot
RUMJO: doesn't show hand 
*** SUMMARY ***
Total pot $0.10 | Rake $0 
Seat 1: andrew_yar folded before Flop (didn't bet)
Seat 2: teddyKK folded before Flop (didn't bet)
Seat 3: Juanchopb79 (button) folded before Flop (didn't bet)
Seat 4: Kobert72 (small blind) folded before Flop
Seat 6: RUMJO (big blind) collected ($0.10)



PokerStars Hand #222969077384:  Hold'em No Limit ($0.05/$0.10 USD) - 2021/01/23 15:24:37 ET
Table 'Stephano III' 6-max Seat #4 is the button
Seat 1: andrew_yar ($13.20 in chips) 
Seat 2: teddyKK ($8.47 in chips) 
Seat 3: Juanchopb79 ($11.31 in chips) 
Seat 4: Kobert72 ($10.48 in chips) 
Seat 6: RUMJO ($10.63 in chips) 
RUMJO: posts small blind $0.05
andrew_yar: posts big blind $0.10
*** HOLE CARDS ***
JohnnyVido joins the table at seat #5 
teddyKK: folds 
Juanchopb79: folds 
Kobert72: folds 
RUMJO: folds 
Uncalled bet ($0.05) returned to andrew_yar
andrew_yar collected $0.10 from pot
andrew_yar: doesn't show hand 
*** SUMMARY ***
Total pot $0.10 | Rake $0 
Seat 1: andrew_yar (big blind) collected ($0.10)
Seat 2: teddyKK folded before Flop (didn't bet)
Seat 3: Juanchopb79 folded before Flop (didn't bet)
Seat 4: Kobert72 (button) folded before Flop (didn't bet)
Seat 6: RUMJO (small blind) folded before Flop



PokerStars Hand #222969086832:  Hold'em No Limit ($0.05/$0.10 USD) - 2021/01/23 15:24:48 ET
Table 'Stephano III' 6-max Seat #6 is the button
Seat 1: andrew_yar ($13.25 in chips) 
Seat 2: teddyKK ($8.47 in chips) 
Seat 3: Juanchopb79 ($11.31 in chips) 
Seat 4: Kobert72 ($10.48 in chips) 
Seat 5: JohnnyVido ($10 in chips) 
Seat 6: RUMJO ($10.58 in chips) 
andrew_yar: posts small blind $0.05
teddyKK: posts big blind $0.10
JohnnyVido: posts big blind $0.10
*** HOLE CARDS ***
Juanchopb79: folds 
Kobert72: folds 
JohnnyVido: checks 
RUMJO: folds 
andrew_yar: raises $0.40 to $0.50
teddyKK: folds 
JohnnyVido: calls $0.40
*** FLOP *** [8c 2d 6d]
andrew_yar: checks 
JohnnyVido: checks 
*** TURN *** [8c 2d 6d] [9d]
andrew_yar: checks 
JohnnyVido: checks 
*** RIVER *** [8c 2d 6d 9d] [6c]
andrew_yar: checks 
JohnnyVido: checks 
*** SHOW DOWN ***
andrew_yar: shows [Qd Kh] (a pair of Sixes)
JohnnyVido: shows [Kc 9s] (two pair, Nines and Sixes)
JohnnyVido collected $1.05 from pot
*** SUMMARY ***
Total pot $1.10 | Rake $0.05 
Board [8c 2d 6d 9d 6c]
Seat 1: andrew_yar (small blind) showed [Qd Kh] and lost with a pair of Sixes
Seat 2: teddyKK (big blind) folded before Flop
Seat 3: Juanchopb79 folded before Flop (didn't bet)
Seat 4: Kobert72 folded before Flop (didn't bet)
Seat 5: JohnnyVido showed [Kc 9s] and won ($1.05) with two pair, Nines and Sixes
Seat 6: RUMJO (button) folded before Flop (didn't bet)



PokerStars Hand #222969135918:  Hold'em No Limit ($0.05/$0.10 USD) - 2021/01/23 15:25:46 ET
Table 'Stephano III' 6-max Seat #1 is the button
Seat 1: andrew_yar ($12.75 in chips) 
Seat 2: teddyKK ($8.37 in chips) 
Seat 3: Juanchopb79 ($11.31 in chips) 
Seat 4: Kobert72 ($10.48 in chips) 
Seat 5: JohnnyVido ($10.55 in chips) 
Seat 6: RUMJO ($10.58 in chips) 
teddyKK: posts small blind $0.05
Juanchopb79: posts big blind $0.10
*** HOLE CARDS ***
Kobert72: folds 
JohnnyVido: raises $0.20 to $0.30
RUMJO: folds 
andrew_yar: folds 
teddyKK: folds 
Juanchopb79: calls $0.20
*** FLOP *** [4c 7d Qs]
Juanchopb79: checks 
JohnnyVido: bets $0.62
Juanchopb79: folds 
Uncalled bet ($0.62) returned to JohnnyVido
JohnnyVido collected $0.62 from pot
JohnnyVido: doesn't show hand 
*** SUMMARY ***
Total pot $0.65 | Rake $0.03 
Board [4c 7d Qs]
Seat 1: andrew_yar (button) folded before Flop (didn't bet)
Seat 2: teddyKK (small blind) folded before Flop
Seat 3: Juanchopb79 (big blind) folded on the Flop
Seat 4: Kobert72 folded before Flop (didn't bet)
Seat 5: JohnnyVido collected ($0.62)
Seat 6: RUMJO folded before Flop (didn't bet)



PokerStars Hand #222969173532:  Hold'em No Limit ($0.05/$0.10 USD) - 2021/01/23 15:26:29 ET
Table 'Stephano III' 6-max Seat #2 is the button
Seat 1: andrew_yar ($12.75 in chips) 
Seat 2: teddyKK ($8.32 in chips) 
Seat 3: Juanchopb79 ($11.01 in chips) 
Seat 4: Kobert72 ($10.48 in chips) 
Seat 5: JohnnyVido ($10.87 in chips) 
Seat 6: RUMJO ($10.58 in chips) 
Juanchopb79: posts small blind $0.05
Kobert72: posts big blind $0.10
*** HOLE CARDS ***
JohnnyVido: calls $0.10
RUMJO: folds 
andrew_yar: folds 
teddyKK: folds 
Juanchopb79: folds 
Kobert72: checks 
*** FLOP *** [4h 4d 2d]
Kobert72: checks 
JohnnyVido: bets $0.24
Kobert72: folds 
Uncalled bet ($0.24) returned to JohnnyVido
JohnnyVido collected $0.24 from pot
*** SUMMARY ***
Total pot $0.25 | Rake $0.01 
Board [4h 4d 2d]
Seat 1: andrew_yar folded before Flop (didn't bet)
Seat 2: teddyKK (button) folded before Flop (didn't bet)
Seat 3: Juanchopb79 (small blind) folded before Flop
Seat 4: Kobert72 (big blind) folded on the Flop
Seat 5: JohnnyVido collected ($0.24)
Seat 6: RUMJO folded before Flop (didn't bet)



PokerStars Hand #222969198854:  Hold'em No Limit ($0.05/$0.10 USD) - 2021/01/23 15:26:59 ET
Table 'Stephano III' 6-max Seat #3 is the button
Seat 1: andrew_yar ($12.75 in chips) 
Seat 2: teddyKK ($8.32 in chips) 
Seat 3: Juanchopb79 ($10.96 in chips) 
Seat 4: Kobert72 ($10.38 in chips) 
Seat 5: JohnnyVido ($11.01 in chips) 
Seat 6: RUMJO ($10.58 in chips) 
Kobert72: posts small blind $0.05
JohnnyVido: posts big blind $0.10
*** HOLE CARDS ***
RUMJO: folds 
andrew_yar: folds 
teddyKK: folds 
Juanchopb79: folds 
Kobert72: raises $0.20 to $0.30
JohnnyVido: raises $0.20 to $0.50
Kobert72: calls $0.20
*** FLOP *** [5d Kd 8s]
Kobert72: checks 
JohnnyVido: bets $0.48
Kobert72: folds 
Uncalled bet ($0.48) returned to JohnnyVido
JohnnyVido collected $0.96 from pot
JohnnyVido: doesn't show hand 
*** SUMMARY ***
Total pot $1 | Rake $0.04 
Board [5d Kd 8s]
Seat 1: andrew_yar folded before Flop (didn't bet)
Seat 2: teddyKK folded before Flop (didn't bet)
Seat 3: Juanchopb79 (button) folded before Flop (didn't bet)
Seat 4: Kobert72 (small blind) folded on the Flop
Seat 5: JohnnyVido (big blind) collected ($0.96)
Seat 6: RUMJO folded before Flop (didn't bet)



PokerStars Hand #222969219908:  Hold'em No Limit ($0.05/$0.10 USD) - 2021/01/23 15:27:24 ET
Table 'Stephano III' 6-max Seat #4 is the button
Seat 1: andrew_yar ($12.75 in chips) 
Seat 2: teddyKK ($8.32 in chips) 
Seat 3: Juanchopb79 ($10.96 in chips) 
Seat 4: Kobert72 ($10 in chips) 
Seat 5: JohnnyVido ($11.47 in chips) 
Seat 6: RUMJO ($10.58 in chips) 
JohnnyVido: posts small blind $0.05
RUMJO: posts big blind $0.10
*** HOLE CARDS ***
andrew_yar: folds 
teddyKK: folds 
Juanchopb79: folds 
Kobert72: raises $0.13 to $0.23
JohnnyVido: folds 
RUMJO: folds 
Uncalled bet ($0.13) returned to Kobert72
Kobert72 collected $0.25 from pot
Kobert72: doesn't show hand 
*** SUMMARY ***
Total pot $0.25 | Rake $0 
Seat 1: andrew_yar folded before Flop (didn't bet)
Seat 2: teddyKK folded before Flop (didn't bet)
Seat 3: Juanchopb79 folded before Flop (didn't bet)
Seat 4: Kobert72 (button) collected ($0.25)
Seat 5: JohnnyVido (small blind) folded before Flop
Seat 6: RUMJO (big blind) folded before Flop



PokerStars Hand #222969233146:  Hold'em No Limit ($0.05/$0.10 USD) - 2021/01/23 15:27:39 ET
Table 'Stephano III' 6-max Seat #5 is the button
Seat 1: andrew_yar ($12.75 in chips) 
Seat 2: teddyKK ($8.32 in chips) 
Seat 3: Juanchopb79 ($10.96 in chips) 
Seat 4: Kobert72 ($10.15 in chips) 
Seat 5: JohnnyVido ($11.42 in chips) 
Seat 6: RUMJO ($10.48 in chips) 
RUMJO: posts small blind $0.05
andrew_yar: posts big blind $0.10
*** HOLE CARDS ***
teddyKK: folds 
Juanchopb79: folds 
Kobert72: folds 
JohnnyVido: calls $0.10
RUMJO: folds 
andrew_yar: checks 
*** FLOP *** [7d 3c Qd]
andrew_yar: checks 
JohnnyVido: checks 
*** TURN *** [7d 3c Qd] [3d]
andrew_yar: checks 
JohnnyVido: bets $0.24
andrew_yar: folds 
Uncalled bet ($0.24) returned to JohnnyVido
JohnnyVido collected $0.24 from pot
JohnnyVido: doesn't show hand 
*** SUMMARY ***
Total pot $0.25 | Rake $0.01 
Board [7d 3c Qd 3d]
Seat 1: andrew_yar (big blind) folded on the Turn
Seat 2: teddyKK folded before Flop (didn't bet)
Seat 3: Juanchopb79 folded before Flop (didn't bet)
Seat 4: Kobert72 folded before Flop (didn't bet)
Seat 5: JohnnyVido (button) collected ($0.24)
Seat 6: RUMJO (small blind) folded before Flop



PokerStars Hand #222969255736:  Hold'em No Limit ($0.05/$0.10 USD) - 2021/01/23 15:28:06 ET
Table 'Stephano III' 6-max Seat #6 is the button
Seat 1: andrew_yar ($12.65 in chips) 
Seat 2: teddyKK ($8.32 in chips) 
Seat 3: Juanchopb79 ($10.96 in chips) 
Seat 4: Kobert72 ($10.15 in chips) 
Seat 5: JohnnyVido ($11.56 in chips) 
Seat 6: RUMJO ($10.43 in chips) 
andrew_yar: posts small blind $0.05
teddyKK: posts big blind $0.10
*** HOLE CARDS ***
Juanchopb79: folds 
Kobert72: folds 
JohnnyVido: folds 
RUMJO: folds 
andrew_yar: folds 
Uncalled bet ($0.05) returned to teddyKK
teddyKK collected $0.10 from pot
teddyKK: doesn't show hand 
*** SUMMARY ***
Total pot $0.10 | Rake $0 
Seat 1: andrew_yar (small blind) folded before Flop
Seat 2: teddyKK (big blind) collected ($0.10)
Seat 3: Juanchopb79 folded before Flop (didn't bet)
Seat 4: Kobert72 folded before Flop (didn't bet)
Seat 5: JohnnyVido folded before Flop (didn't bet)
Seat 6: RUMJO (button) folded before Flop (didn't bet)



PokerStars Hand #222969263865:  Hold'em No Limit ($0.05/$0.10 USD) - 2021/01/23 15:28:15 ET
Table 'Stephano III' 6-max Seat #1 is the button
Seat 1: andrew_yar ($12.60 in chips) 
Seat 2: teddyKK ($8.37 in chips) 
Seat 3: Juanchopb79 ($10.96 in chips) 
Seat 4: Kobert72 ($10.15 in chips) 
Seat 5: JohnnyVido ($11.56 in chips) 
Seat 6: RUMJO ($10.43 in chips) 
teddyKK: posts small blind $0.05
Juanchopb79: posts big blind $0.10
*** HOLE CARDS ***
Kobert72: folds 
JohnnyVido: calls $0.10
RUMJO: folds 
andrew_yar: raises $0.35 to $0.45
teddyKK: folds 
Juanchopb79: folds 
JohnnyVido: folds 
Uncalled bet ($0.35) returned to andrew_yar
andrew_yar collected $0.35 from pot
andrew_yar: doesn't show hand 
*** SUMMARY ***
Total pot $0.35 | Rake $0 
Seat 1: andrew_yar (button) collected ($0.35)
Seat 2: teddyKK (small blind) folded before Flop
Seat 3: Juanchopb79 (big blind) folded before Flop
Seat 4: Kobert72 folded before Flop (didn't bet)
Seat 5: JohnnyVido folded before Flop
Seat 6: RUMJO folded before Flop (didn't bet)



PokerStars Hand #222969282698:  Hold'em No Limit ($0.05/$0.10 USD) - 2021/01/23 15:28:37 ET
Table 'Stephano III' 6-max Seat #2 is the button
Seat 1: andrew_yar ($12.85 in chips) 
Seat 2: teddyKK ($8.32 in chips) 
Seat 3: Juanchopb79 ($10.86 in chips) 
Seat 4: Kobert72 ($10.15 in chips) 
Seat 5: JohnnyVido ($11.46 in chips) 
Seat 6: RUMJO ($10.43 in chips) 
Juanchopb79: posts small blind $0.05
Kobert72: posts big blind $0.10
*** HOLE CARDS ***
JohnnyVido: folds 
RUMJO: folds 
andrew_yar: raises $0.15 to $0.25
teddyKK: folds 
Juanchopb79: folds 
Kobert72: raises $0.88 to $1.13
andrew_yar: folds 
Uncalled bet ($0.88) returned to Kobert72
Kobert72 collected $0.55 from pot
Kobert72: doesn't show hand 
*** SUMMARY ***
Total pot $0.55 | Rake $0 
Seat 1: andrew_yar folded before Flop
Seat 2: teddyKK (button) folded before Flop (didn't bet)
Seat 3: Juanchopb79 (small blind) folded before Flop
Seat 4: Kobert72 (big blind) collected ($0.55)
Seat 5: JohnnyVido folded before Flop (didn't bet)
Seat 6: RUMJO folded before Flop (didn't bet)



PokerStars Hand #222969301402:  Hold'em No Limit ($0.05/$0.10 USD) - 2021/01/23 15:28:58 ET
Table 'Stephano III' 6-max Seat #3 is the button
Seat 1: andrew_yar ($12.60 in chips) 
Seat 2: teddyKK ($8.32 in chips) 
Seat 3: Juanchopb79 ($10.81 in chips) 
Seat 4: Kobert72 ($10.45 in chips) 
Seat 5: JohnnyVido ($11.46 in chips) 
Kobert72: posts small blind $0.05
JohnnyVido: posts big blind $0.10
*** HOLE CARDS ***
andrew_yar: folds 
teddyKK has timed out
teddyKK: folds 
Juanchopb79: folds 
Kobert72: raises $0.20 to $0.30
JohnnyVido: folds 
Uncalled bet ($0.20) returned to Kobert72
Kobert72 collected $0.20 from pot
Kobert72: doesn't show hand 
*** SUMMARY ***
Total pot $0.20 | Rake $0 
Seat 1: andrew_yar folded before Flop (didn't bet)
Seat 2: teddyKK folded before Flop (didn't bet)
Seat 3: Juanchopb79 (button) folded before Flop (didn't bet)
Seat 4: Kobert72 (small blind) collected ($0.20)
Seat 5: JohnnyVido (big blind) folded before Flop



PokerStars Hand #222969321281:  Hold'em No Limit ($0.05/$0.10 USD) - 2021/01/23 15:29:22 ET
Table 'Stephano III' 6-max Seat #4 is the button
Seat 1: andrew_yar ($12.60 in chips) 
Seat 2: teddyKK ($8.32 in chips) 
Seat 3: Juanchopb79 ($10.81 in chips) 
Seat 4: Kobert72 ($10.55 in chips) 
Seat 5: JohnnyVido ($11.36 in chips) 
JohnnyVido: posts small blind $0.05
andrew_yar: posts big blind $0.10
*** HOLE CARDS ***
teddyKK: folds 
Juanchopb79: raises $0.20 to $0.30
Kobert72: folds 
JohnnyVido: folds 
andrew_yar: folds 
Uncalled bet ($0.20) returned to Juanchopb79
Juanchopb79 collected $0.25 from pot
Juanchopb79: doesn't show hand 
*** SUMMARY ***
Total pot $0.25 | Rake $0 
Seat 1: andrew_yar (big blind) folded before Flop
Seat 2: teddyKK folded before Flop (didn't bet)
Seat 3: Juanchopb79 collected ($0.25)
Seat 4: Kobert72 (button) folded before Flop (didn't bet)
Seat 5: JohnnyVido (small blind) folded before Flop



PokerStars Hand #222969332832:  Hold'em No Limit ($0.05/$0.10 USD) - 2021/01/23 15:29:35 ET
Table 'Stephano III' 6-max Seat #5 is the button
Seat 1: andrew_yar ($12.50 in chips) 
Seat 2: teddyKK ($8.32 in chips) 
Seat 3: Juanchopb79 ($10.96 in chips) 
Seat 4: Kobert72 ($10.55 in chips) 
Seat 5: JohnnyVido ($11.31 in chips) 
andrew_yar: posts small blind $0.05
teddyKK: posts big blind $0.10
*** HOLE CARDS ***
Juanchopb79: folds 
Kobert72: folds 
JohnnyVido: raises $0.10 to $0.20
andrew_yar: folds 
teddyKK: calls $0.10
*** FLOP *** [4s Qc Ac]
teddyKK: checks 
JohnnyVido: checks 
*** TURN *** [4s Qc Ac] [Tc]
teddyKK: checks 
JohnnyVido: checks 
*** RIVER *** [4s Qc Ac Tc] [Js]
teddyKK: checks 
JohnnyVido: bets $0.10
teddyKK: folds 
Uncalled bet ($0.10) returned to JohnnyVido
JohnnyVido collected $0.43 from pot
JohnnyVido: doesn't show hand 
*** SUMMARY ***
Total pot $0.45 | Rake $0.02 
Board [4s Qc Ac Tc Js]
Seat 1: andrew_yar (small blind) folded before Flop
Seat 2: teddyKK (big blind) folded on the River
Seat 3: Juanchopb79 folded before Flop (didn't bet)
Seat 4: Kobert72 folded before Flop (didn't bet)
Seat 5: JohnnyVido (button) collected ($0.43)



PokerStars Hand #222969350177:  Hold'em No Limit ($0.05/$0.10 USD) - 2021/01/23 15:29:56 ET
Table 'Stephano III' 6-max Seat #1 is the button
Seat 1: andrew_yar ($12.45 in chips) 
Seat 3: Juanchopb79 ($10.96 in chips) 
Seat 4: Kobert72 ($10.55 in chips) 
Seat 5: JohnnyVido ($11.54 in chips) 
Juanchopb79: posts small blind $0.05
Kobert72: posts big blind $0.10
*** HOLE CARDS ***
JohnnyVido: calls $0.10
andrew_yar: folds 
Juanchopb79: calls $0.05
Kobert72: checks 
*** FLOP *** [Ks Th Ah]
Juanchopb79: checks 
Kobert72: checks 
JohnnyVido: bets $0.29
Juanchopb79: folds 
Kobert72: folds 
Uncalled bet ($0.29) returned to JohnnyVido
JohnnyVido collected $0.29 from pot
JohnnyVido: doesn't show hand 
*** SUMMARY ***
Total pot $0.30 | Rake $0.01 
Board [Ks Th Ah]
Seat 1: andrew_yar (button) folded before Flop (didn't bet)
Seat 3: Juanchopb79 (small blind) folded on the Flop
Seat 4: Kobert72 (big blind) folded on the Flop
Seat 5: JohnnyVido collected ($0.29)



PokerStars Hand #222969381093:  Hold'em No Limit ($0.05/$0.10 USD) - 2021/01/23 15:30:31 ET
Table 'Stephano III' 6-max Seat #3 is the button
Seat 1: andrew_yar ($12.45 in chips) 
Seat 3: Juanchopb79 ($10.86 in chips) 
Seat 4: Kobert72 ($10.45 in chips) 
Seat 5: JohnnyVido ($11.73 in chips) 
Kobert72: posts small blind $0.05
JohnnyVido: posts big blind $0.10
*** HOLE CARDS ***
andrew_yar: folds 
Juanchopb79: raises $0.15 to $0.25
Kobert72: folds 
JohnnyVido: calls $0.15
*** FLOP *** [As Ks 7s]
JohnnyVido: checks 
Juanchopb79: bets $0.27
JohnnyVido: folds 
Uncalled bet ($0.27) returned to Juanchopb79
Juanchopb79 collected $0.53 from pot
Juanchopb79: doesn't show hand 
*** SUMMARY ***
Total pot $0.55 | Rake $0.02 
Board [As Ks 7s]
Seat 1: andrew_yar folded before Flop (didn't bet)
Seat 3: Juanchopb79 (button) collected ($0.53)
Seat 4: Kobert72 (small blind) folded before Flop
Seat 5: JohnnyVido (big blind) folded on the Flop



PokerStars Hand #222969400198:  Hold'em No Limit ($0.05/$0.10 USD) - 2021/01/23 15:30:53 ET
Table 'Stephano III' 6-max Seat #4 is the button
Seat 1: andrew_yar ($12.45 in chips) 
Seat 3: Juanchopb79 ($11.14 in chips) 
Seat 4: Kobert72 ($10.40 in chips) 
Seat 5: JohnnyVido ($11.48 in chips) 
JohnnyVido: posts small blind $0.05
andrew_yar: posts big blind $0.10
*** HOLE CARDS ***
Juanchopb79: folds 
Kobert72: raises $0.13 to $0.23
JohnnyVido: calls $0.18
andrew_yar: folds 
*** FLOP *** [4c 3h 7h]
JohnnyVido: bets $0.20
Kobert72: folds 
Uncalled bet ($0.20) returned to JohnnyVido
JohnnyVido collected $0.53 from pot
JohnnyVido: doesn't show hand 
*** SUMMARY ***
Total pot $0.56 | Rake $0.03 
Board [4c 3h 7h]
Seat 1: andrew_yar (big blind) folded before Flop
Seat 3: Juanchopb79 folded before Flop (didn't bet)
Seat 4: Kobert72 (button) folded on the Flop
Seat 5: JohnnyVido (small blind) collected ($0.53)



PokerStars Hand #222969428434:  Hold'em No Limit ($0.05/$0.10 USD) - 2021/01/23 15:31:13 ET
Table 'Stephano III' 6-max Seat #5 is the button
Seat 1: andrew_yar ($12.35 in chips) 
Seat 3: Juanchopb79 ($11.14 in chips) 
Seat 4: Kobert72 ($10.17 in chips) 
Seat 5: JohnnyVido ($11.78 in chips) 
andrew_yar: posts small blind $0.05
Juanchopb79: posts big blind $0.10
*** HOLE CARDS ***
Kobert72: folds 
JohnnyVido has timed out
JohnnyVido: folds 
andrew_yar: raises $0.15 to $0.25
Juanchopb79: calls $0.15
*** FLOP *** [8d 2d 3c]
andrew_yar: bets $0.32
Juanchopb79: calls $0.32
*** TURN *** [8d 2d 3c] [4s]
andrew_yar: checks 
Juanchopb79: bets $0.70
andrew_yar: folds 
Uncalled bet ($0.70) returned to Juanchopb79
Juanchopb79 collected $1.09 from pot
Juanchopb79: doesn't show hand 
*** SUMMARY ***
Total pot $1.14 | Rake $0.05 
Board [8d 2d 3c 4s]
Seat 1: andrew_yar (small blind) folded on the Turn
Seat 3: Juanchopb79 (big blind) collected ($1.09)
Seat 4: Kobert72 folded before Flop (didn't bet)
Seat 5: JohnnyVido (button) folded before Flop (didn't bet)



PokerStars Hand #222969482135:  Hold'em No Limit ($0.05/$0.10 USD) - 2021/01/23 15:32:15 ET
Table 'Stephano III' 6-max Seat #1 is the button
Seat 1: andrew_yar ($11.78 in chips) 
Seat 3: Juanchopb79 ($11.66 in chips) 
Seat 4: Kobert72 ($10.17 in chips) 
Seat 5: JohnnyVido ($11.78 in chips) 
Juanchopb79: posts small blind $0.05
Kobert72: posts big blind $0.10
RUMJO: sits out 
*** HOLE CARDS ***
JohnnyVido: raises $0.10 to $0.20
andrew_yar: folds 
Juanchopb79: folds 
Kobert72: folds 
Uncalled bet ($0.10) returned to JohnnyVido
JohnnyVido collected $0.25 from pot
*** SUMMARY ***
Total pot $0.25 | Rake $0 
Seat 1: andrew_yar (button) folded before Flop (didn't bet)
Seat 3: Juanchopb79 (small blind) folded before Flop
Seat 4: Kobert72 (big blind) folded before Flop
Seat 5: JohnnyVido collected ($0.25)



PokerStars Hand #222969492708:  Hold'em No Limit ($0.05/$0.10 USD) - 2021/01/23 15:32:27 ET
Table 'Stephano III' 6-max Seat #3 is the button
Seat 1: andrew_yar ($11.78 in chips) 
Seat 3: Juanchopb79 ($11.61 in chips) 
Seat 4: Kobert72 ($10.07 in chips) 
Seat 5: JohnnyVido ($11.93 in chips) 
Kobert72: posts small blind $0.05
JohnnyVido: posts big blind $0.10
RUMJO: sits out 
*** HOLE CARDS ***
andrew_yar: raises $0.15 to $0.25
Juanchopb79: folds 
Kobert72: folds 
JohnnyVido: calls $0.15
*** FLOP *** [8h Qh Th]
JohnnyVido: bets $0.10
andrew_yar: folds 
Uncalled bet ($0.10) returned to JohnnyVido
JohnnyVido collected $0.53 from pot
JohnnyVido: doesn't show hand 
*** SUMMARY ***
Total pot $0.55 | Rake $0.02 
Board [8h Qh Th]
Seat 1: andrew_yar folded on the Flop
Seat 3: Juanchopb79 (button) folded before Flop (didn't bet)
Seat 4: Kobert72 (small blind) folded before Flop
Seat 5: JohnnyVido (big blind) collected ($0.53)



PokerStars Hand #222969523356:  Hold'em No Limit ($0.05/$0.10 USD) - 2021/01/23 15:33:03 ET
Table 'Stephano III' 6-max Seat #4 is the button
Seat 1: andrew_yar ($11.53 in chips) 
Seat 3: Juanchopb79 ($11.61 in chips) 
Seat 4: Kobert72 ($10.02 in chips) 
Seat 5: JohnnyVido ($12.21 in chips) 
Seat 6: RUMJO ($10.43 in chips) 
JohnnyVido: posts small blind $0.05
RUMJO: posts big blind $0.10
*** HOLE CARDS ***
andrew_yar: folds 
Juanchopb79: folds 
Kobert72: folds 
JohnnyVido: folds 
Uncalled bet ($0.05) returned to RUMJO
RUMJO collected $0.10 from pot
RUMJO: doesn't show hand 
*** SUMMARY ***
Total pot $0.10 | Rake $0 
Seat 1: andrew_yar folded before Flop (didn't bet)
Seat 3: Juanchopb79 folded before Flop (didn't bet)
Seat 4: Kobert72 (button) folded before Flop (didn't bet)
Seat 5: JohnnyVido (small blind) folded before Flop
Seat 6: RUMJO (big blind) collected ($0.10)



PokerStars Hand #222969531501:  Hold'em No Limit ($0.05/$0.10 USD) - 2021/01/23 15:33:12 ET
Table 'Stephano III' 6-max Seat #5 is the button
Seat 1: andrew_yar ($11.53 in chips) 
Seat 3: Juanchopb79 ($11.61 in chips) 
Seat 4: Kobert72 ($10.02 in chips) 
Seat 5: JohnnyVido ($12.16 in chips) 
Seat 6: RUMJO ($10.48 in chips) 
RUMJO: posts small blind $0.05
andrew_yar: posts big blind $0.10
*** HOLE CARDS ***
Juanchopb79: folds 
Kobert72: folds 
JohnnyVido: folds 
RUMJO: raises $0.15 to $0.25
andrew_yar: raises $0.65 to $0.90
RUMJO: folds 
Uncalled bet ($0.65) returned to andrew_yar
andrew_yar collected $0.50 from pot
andrew_yar: doesn't show hand 
*** SUMMARY ***
Total pot $0.50 | Rake $0 
Seat 1: andrew_yar (big blind) collected ($0.50)
Seat 3: Juanchopb79 folded before Flop (didn't bet)
Seat 4: Kobert72 folded before Flop (didn't bet)
Seat 5: JohnnyVido (button) folded before Flop (didn't bet)
Seat 6: RUMJO (small blind) folded before Flop



PokerStars Hand #222969556623:  Hold'em No Limit ($0.05/$0.10 USD) - 2021/01/23 15:33:42 ET
Table 'Stephano III' 6-max Seat #6 is the button
Seat 1: andrew_yar ($11.78 in chips) 
Seat 3: Juanchopb79 ($11.61 in chips) 
Seat 4: Kobert72 ($10.02 in chips) 
Seat 5: JohnnyVido ($12.16 in chips) 
Seat 6: RUMJO ($10.23 in chips) 
andrew_yar: posts small blind $0.05
Juanchopb79: posts big blind $0.10
*** HOLE CARDS ***
Kobert72: folds 
JohnnyVido: calls $0.10
RUMJO: folds 
andrew_yar: calls $0.05
Juanchopb79: checks 
*** FLOP *** [Td 5s 6h]
andrew_yar: checks 
Juanchopb79: checks 
JohnnyVido: bets $0.30
andrew_yar: folds 
Juanchopb79: folds 
Uncalled bet ($0.30) returned to JohnnyVido
JohnnyVido collected $0.29 from pot
JohnnyVido: doesn't show hand 
*** SUMMARY ***
Total pot $0.30 | Rake $0.01 
Board [Td 5s 6h]
Seat 1: andrew_yar (small blind) folded on the Flop
Seat 3: Juanchopb79 (big blind) folded on the Flop
Seat 4: Kobert72 folded before Flop (didn't bet)
Seat 5: JohnnyVido collected ($0.29)
Seat 6: RUMJO (button) folded before Flop (didn't bet)



PokerStars Hand #222969592570:  Hold'em No Limit ($0.05/$0.10 USD) - 2021/01/23 15:34:23 ET
Table 'Stephano III' 6-max Seat #1 is the button
Seat 1: andrew_yar ($11.68 in chips) 
Seat 3: Juanchopb79 ($11.51 in chips) 
Seat 4: Kobert72 ($10.02 in chips) 
Seat 5: JohnnyVido ($12.35 in chips) 
Seat 6: RUMJO ($10.23 in chips) 
Juanchopb79: posts small blind $0.05
Kobert72: posts big blind $0.10
*** HOLE CARDS ***
JohnnyVido: calls $0.10
RUMJO: raises $0.30 to $0.40
andrew_yar: folds 
Juanchopb79: folds 
Kobert72: folds 
JohnnyVido: folds 
Uncalled bet ($0.30) returned to RUMJO
RUMJO collected $0.35 from pot
RUMJO: doesn't show hand 
*** SUMMARY ***
Total pot $0.35 | Rake $0 
Seat 1: andrew_yar (button) folded before Flop (didn't bet)
Seat 3: Juanchopb79 (small blind) folded before Flop
Seat 4: Kobert72 (big blind) folded before Flop
Seat 5: JohnnyVido folded before Flop
Seat 6: RUMJO collected ($0.35)



PokerStars Hand #222969610765:  Hold'em No Limit ($0.05/$0.10 USD) - 2021/01/23 15:34:44 ET
Table 'Stephano III' 6-max Seat #3 is the button
Seat 1: andrew_yar ($11.68 in chips) 
Seat 3: Juanchopb79 ($11.46 in chips) 
Seat 4: Kobert72 ($10 in chips) 
Seat 5: JohnnyVido ($12.25 in chips) 
Seat 6: RUMJO ($10.48 in chips) 
Kobert72: posts small blind $0.05
JohnnyVido: posts big blind $0.10
*** HOLE CARDS ***
RUMJO: folds 
andrew_yar: raises $0.15 to $0.25
Juanchopb79: folds 
Kobert72: raises $0.73 to $0.98
JohnnyVido: folds 
andrew_yar: folds 
Uncalled bet ($0.73) returned to Kobert72
Kobert72 collected $0.60 from pot
Kobert72: doesn't show hand 
*** SUMMARY ***
Total pot $0.60 | Rake $0 
Seat 1: andrew_yar folded before Flop
Seat 3: Juanchopb79 (button) folded before Flop (didn't bet)
Seat 4: Kobert72 (small blind) collected ($0.60)
Seat 5: JohnnyVido (big blind) folded before Flop
Seat 6: RUMJO folded before Flop (didn't bet)



PokerStars Hand #222969638996:  Hold'em No Limit ($0.05/$0.10 USD) - 2021/01/23 15:35:16 ET
Table 'Stephano III' 6-max Seat #4 is the button
Seat 1: andrew_yar ($11.43 in chips) 
Seat 3: Juanchopb79 ($11.46 in chips) 
Seat 4: Kobert72 ($10.35 in chips) 
Seat 5: JohnnyVido ($12.15 in chips) 
Seat 6: RUMJO ($10.48 in chips) 
JohnnyVido: posts small blind $0.05
RUMJO: posts big blind $0.10
*** HOLE CARDS ***
andrew_yar: folds 
Juanchopb79: raises $0.20 to $0.30
Kobert72: folds 
JohnnyVido: calls $0.25
RUMJO: folds 
*** FLOP *** [4s 9c 6c]
JohnnyVido: checks 
Juanchopb79: checks 
*** TURN *** [4s 9c 6c] [6d]
JohnnyVido: bets $0.34
Juanchopb79: folds 
Uncalled bet ($0.34) returned to JohnnyVido
JohnnyVido collected $0.67 from pot
JohnnyVido: doesn't show hand 
*** SUMMARY ***
Total pot $0.70 | Rake $0.03 
Board [4s 9c 6c 6d]
Seat 1: andrew_yar folded before Flop (didn't bet)
Seat 3: Juanchopb79 folded on the Turn
Seat 4: Kobert72 (button) folded before Flop (didn't bet)
Seat 5: JohnnyVido (small blind) collected ($0.67)
Seat 6: RUMJO (big blind) folded before Flop



PokerStars Hand #222969678052:  Hold'em No Limit ($0.05/$0.10 USD) - 2021/01/23 15:36:02 ET
Table 'Stephano III' 6-max Seat #5 is the button
Seat 1: andrew_yar ($11.43 in chips) 
Seat 3: Juanchopb79 ($11.16 in chips) 
Seat 4: Kobert72 ($10.35 in chips) 
Seat 5: JohnnyVido ($12.52 in chips) 
Seat 6: RUMJO ($10.38 in chips) 
RUMJO: posts small blind $0.05
andrew_yar: posts big blind $0.10
*** HOLE CARDS ***
Juanchopb79: folds 
Kobert72: raises $0.13 to $0.23
JohnnyVido: folds 
RUMJO: folds 
andrew_yar: calls $0.13
*** FLOP *** [Ah Ad 5d]
andrew_yar: checks 
Kobert72: checks 
*** TURN *** [Ah Ad 5d] [3c]
andrew_yar: checks 
Kobert72: bets $0.16
andrew_yar: calls $0.16
*** RIVER *** [Ah Ad 5d 3c] [Kh]
andrew_yar: checks 
Kobert72: bets $0.43
andrew_yar: folds 
Uncalled bet ($0.43) returned to Kobert72
Kobert72 collected $0.79 from pot
Kobert72: doesn't show hand 
*** SUMMARY ***
Total pot $0.83 | Rake $0.04 
Board [Ah Ad 5d 3c Kh]
Seat 1: andrew_yar (big blind) folded on the River
Seat 3: Juanchopb79 folded before Flop (didn't bet)
Seat 4: Kobert72 collected ($0.79)
Seat 5: JohnnyVido (button) folded before Flop (didn't bet)
Seat 6: RUMJO (small blind) folded before Flop



PokerStars Hand #222969710530:  Hold'em No Limit ($0.05/$0.10 USD) - 2021/01/23 15:36:39 ET
Table 'Stephano III' 6-max Seat #6 is the button
Seat 1: andrew_yar ($11.04 in chips) 
Seat 3: Juanchopb79 ($11.16 in chips) 
Seat 4: Kobert72 ($10.75 in chips) 
Seat 5: JohnnyVido ($12.52 in chips) 
Seat 6: RUMJO ($10.33 in chips) 
andrew_yar: posts small blind $0.05
Juanchopb79: posts big blind $0.10
*** HOLE CARDS ***
Kobert72: folds 
JohnnyVido: calls $0.10
RUMJO: folds 
andrew_yar: folds 
Juanchopb79: checks 
*** FLOP *** [7h As 3h]
Juanchopb79: checks 
JohnnyVido: checks 
*** TURN *** [7h As 3h] [5c]
Juanchopb79: checks 
JohnnyVido: checks 
*** RIVER *** [7h As 3h 5c] [5s]
Juanchopb79: checks 
JohnnyVido: bets $0.30
Juanchopb79: folds 
Uncalled bet ($0.30) returned to JohnnyVido
JohnnyVido collected $0.24 from pot
teddyKK was removed from the table for failing to post
teddyKK leaves the table
JohnnyVido: doesn't show hand 
*** SUMMARY ***
Total pot $0.25 | Rake $0.01 
Board [7h As 3h 5c 5s]
Seat 1: andrew_yar (small blind) folded before Flop
Seat 3: Juanchopb79 (big blind) folded on the River
Seat 4: Kobert72 folded before Flop (didn't bet)
Seat 5: JohnnyVido collected ($0.24)
Seat 6: RUMJO (button) folded before Flop (didn't bet)



PokerStars Hand #222969753962:  Hold'em No Limit ($0.05/$0.10 USD) - 2021/01/23 15:37:30 ET
Table 'Stephano III' 6-max Seat #1 is the button
Seat 1: andrew_yar ($10.99 in chips) 
Seat 3: Juanchopb79 ($11.06 in chips) 
Seat 4: Kobert72 ($10.75 in chips) 
Seat 5: JohnnyVido ($12.66 in chips) 
Seat 6: RUMJO ($10.33 in chips) 
Juanchopb79: posts small blind $0.05
Kobert72: posts big blind $0.10
*** HOLE CARDS ***
JohnnyVido: folds 
RUMJO: folds 
andrew_yar: folds 
Juanchopb79: raises $0.20 to $0.30
Kobert72: folds 
Uncalled bet ($0.20) returned to Juanchopb79
Juanchopb79 collected $0.20 from pot
Juanchopb79: doesn't show hand 
*** SUMMARY ***
Total pot $0.20 | Rake $0 
Seat 1: andrew_yar (button) folded before Flop (didn't bet)
Seat 3: Juanchopb79 (small blind) collected ($0.20)
Seat 4: Kobert72 (big blind) folded before Flop
Seat 5: JohnnyVido folded before Flop (didn't bet)
Seat 6: RUMJO folded before Flop (didn't bet)



PokerStars Hand #222969768839:  Hold'em No Limit ($0.05/$0.10 USD) - 2021/01/23 15:37:48 ET
Table 'Stephano III' 6-max Seat #3 is the button
Seat 1: andrew_yar ($10.99 in chips) 
Seat 3: Juanchopb79 ($11.16 in chips) 
Seat 4: Kobert72 ($10.65 in chips) 
Seat 5: JohnnyVido ($12.66 in chips) 
Seat 6: RUMJO ($10.33 in chips) 
Kobert72: posts small blind $0.05
JohnnyVido: posts big blind $0.10
*** HOLE CARDS ***
RUMJO: folds 
andrew_yar: raises $0.15 to $0.25
Juanchopb79: folds 
Kobert72: folds 
JohnnyVido: calls $0.15
*** FLOP *** [Qh 8c Kh]
JohnnyVido: checks 
perespell joins the table at seat #2 
andrew_yar: bets $0.36
JohnnyVido: folds 
Uncalled bet ($0.36) returned to andrew_yar
andrew_yar collected $0.53 from pot
andrew_yar: doesn't show hand 
*** SUMMARY ***
Total pot $0.55 | Rake $0.02 
Board [Qh 8c Kh]
Seat 1: andrew_yar collected ($0.53)
Seat 3: Juanchopb79 (button) folded before Flop (didn't bet)
Seat 4: Kobert72 (small blind) folded before Flop
Seat 5: JohnnyVido (big blind) folded on the Flop
Seat 6: RUMJO folded before Flop (didn't bet)



PokerStars Hand #222969820834:  Hold'em No Limit ($0.05/$0.10 USD) - 2021/01/23 15:38:41 ET
Table 'Stephano III' 6-max Seat #4 is the button
Seat 1: andrew_yar ($11.27 in chips) 
Seat 3: Juanchopb79 ($11.16 in chips) 
Seat 4: Kobert72 ($10.60 in chips) 
Seat 5: JohnnyVido ($12.41 in chips) 
Seat 6: RUMJO ($10.33 in chips) 
JohnnyVido: posts small blind $0.05
RUMJO: posts big blind $0.10
perespell: sits out 
*** HOLE CARDS ***
andrew_yar: folds 
Juanchopb79: folds 
Kobert72: folds 
JohnnyVido: raises $0.20 to $0.30
RUMJO: folds 
Uncalled bet ($0.20) returned to JohnnyVido
JohnnyVido collected $0.20 from pot
JohnnyVido: doesn't show hand 
*** SUMMARY ***
Total pot $0.20 | Rake $0 
Seat 1: andrew_yar folded before Flop (didn't bet)
Seat 3: Juanchopb79 folded before Flop (didn't bet)
Seat 4: Kobert72 (button) folded before Flop (didn't bet)
Seat 5: JohnnyVido (small blind) collected ($0.20)
Seat 6: RUMJO (big blind) folded before Flop



PokerStars Hand #222969835062:  Hold'em No Limit ($0.05/$0.10 USD) - 2021/01/23 15:38:58 ET
Table 'Stephano III' 6-max Seat #5 is the button
Seat 1: andrew_yar ($11.27 in chips) 
Seat 3: Juanchopb79 ($11.16 in chips) 
Seat 4: Kobert72 ($10.60 in chips) 
Seat 5: JohnnyVido ($12.51 in chips) 
Seat 6: RUMJO ($10.23 in chips) 
RUMJO: posts small blind $0.05
andrew_yar: posts big blind $0.10
perespell: sits out 
*** HOLE CARDS ***
Juanchopb79: folds 
Kobert72: raises $0.13 to $0.23
JohnnyVido: folds 
RUMJO: folds 
andrew_yar: folds 
Uncalled bet ($0.13) returned to Kobert72
Kobert72 collected $0.25 from pot
Kobert72: doesn't show hand 
*** SUMMARY ***
Total pot $0.25 | Rake $0 
Seat 1: andrew_yar (big blind) folded before Flop
Seat 3: Juanchopb79 folded before Flop (didn't bet)
Seat 4: Kobert72 collected ($0.25)
Seat 5: JohnnyVido (button) folded before Flop (didn't bet)
Seat 6: RUMJO (small blind) folded before Flop



PokerStars Hand #222969849060:  Hold'em No Limit ($0.05/$0.10 USD) - 2021/01/23 15:39:14 ET
Table 'Stephano III' 6-max Seat #6 is the button
Seat 1: andrew_yar ($11.17 in chips) 
Seat 2: perespell ($10 in chips) 
Seat 3: Juanchopb79 ($11.16 in chips) 
Seat 4: Kobert72 ($10.75 in chips) 
Seat 5: JohnnyVido ($12.51 in chips) 
Seat 6: RUMJO ($10.18 in chips) 
andrew_yar: posts small blind $0.05
perespell: posts big blind $0.10
*** HOLE CARDS ***
Juanchopb79: folds 
Kobert72: folds 
JohnnyVido: calls $0.10
RUMJO: folds 
andrew_yar: folds 
Juanchopb79 leaves the table
perespell: checks 
*** FLOP *** [7d Qd Ad]
perespell: checks 
JohnnyVido: checks 
*** TURN *** [7d Qd Ad] [Jh]
Mark86F joins the table at seat #3 
perespell: checks 
JohnnyVido: checks 
*** RIVER *** [7d Qd Ad Jh] [7h]
perespell: checks 
JohnnyVido: checks 
*** SHOW DOWN ***
perespell: shows [9h 4d] (a pair of Sevens)
JohnnyVido: shows [6s 5s] (a pair of Sevens)
perespell collected $0.12 from pot
JohnnyVido collected $0.12 from pot
*** SUMMARY ***
Total pot $0.25 | Rake $0.01 
Board [7d Qd Ad Jh 7h]
Seat 1: andrew_yar (small blind) folded before Flop
Seat 2: perespell (big blind) showed [9h 4d] and won ($0.12) with a pair of Sevens
Seat 3: Juanchopb79 folded before Flop (didn't bet)
Seat 4: Kobert72 folded before Flop (didn't bet)
Seat 5: JohnnyVido showed [6s 5s] and won ($0.12) with a pair of Sevens
Seat 6: RUMJO (button) folded before Flop (didn't bet)



PokerStars Hand #222972970647:  Hold'em No Limit ($0.05/$0.10 USD) - 2021/01/23 16:42:30 ET
Table 'Stephano III' 6-max Seat #6 is the button
Seat 1: Bino0203 ($10.89 in chips) 
Seat 2: perespell ($11.33 in chips) 
Seat 3: 22888899 ($6.69 in chips) 
Seat 4: marcin116 ($10 in chips) 
Seat 5: dancayamanda ($10 in chips) 
Seat 6: RUMJO ($13.25 in chips) 
Bino0203: posts small blind $0.05
perespell: posts big blind $0.10
*** HOLE CARDS ***
22888899: raises $0.20 to $0.30
marcin116: calls $0.30
dancayamanda: calls $0.30
RUMJO: folds 
Bino0203: folds 
perespell: folds 
*** FLOP *** [6h 4h Qc]
22888899: bets $0.30
marcin116: folds 
dancayamanda: calls $0.30
*** TURN *** [6h 4h Qc] [9d]
22888899: bets $0.69
dancayamanda: folds 
Uncalled bet ($0.69) returned to 22888899
22888899 collected $1.58 from pot
22888899: doesn't show hand 
*** SUMMARY ***
Total pot $1.65 | Rake $0.07 
Board [6h 4h Qc 9d]
Seat 1: Bino0203 (small blind) folded before Flop
Seat 2: perespell (big blind) folded before Flop
Seat 3: 22888899 collected ($1.58)
Seat 4: marcin116 folded on the Flop
Seat 5: dancayamanda folded on the Turn
Seat 6: RUMJO (button) folded before Flop (didn't bet)



PokerStars Hand #222973039792:  Hold'em No Limit ($0.05/$0.10 USD) - 2021/01/23 16:43:54 ET
Table 'Stephano III' 6-max Seat #1 is the button
Seat 1: Bino0203 ($10.84 in chips) 
Seat 2: perespell ($11.23 in chips) 
Seat 3: 22888899 ($7.67 in chips) 
Seat 4: marcin116 ($10 in chips) 
Seat 5: dancayamanda ($10 in chips) 
Seat 6: RUMJO ($13.25 in chips) 
perespell: posts small blind $0.05
22888899: posts big blind $0.10
*** HOLE CARDS ***
marcin116: folds 
dancayamanda: raises $0.15 to $0.25
RUMJO: folds 
Bino0203: folds 
perespell: folds 
22888899: calls $0.15
*** FLOP *** [4h 4d 5c]
22888899: checks 
dancayamanda: bets $0.17
22888899: folds 
Uncalled bet ($0.17) returned to dancayamanda
dancayamanda collected $0.53 from pot
dancayamanda: doesn't show hand 
*** SUMMARY ***
Total pot $0.55 | Rake $0.02 
Board [4h 4d 5c]
Seat 1: Bino0203 (button) folded before Flop (didn't bet)
Seat 2: perespell (small blind) folded before Flop
Seat 3: 22888899 (big blind) folded on the Flop
Seat 4: marcin116 folded before Flop (didn't bet)
Seat 5: dancayamanda collected ($0.53)
Seat 6: RUMJO folded before Flop (didn't bet)



PokerStars Hand #222973067166:  Hold'em No Limit ($0.05/$0.10 USD) - 2021/01/23 16:44:28 ET
Table 'Stephano III' 6-max Seat #2 is the button
Seat 1: Bino0203 ($10.84 in chips) 
Seat 2: perespell ($11.18 in chips) 
Seat 3: 22888899 ($7.42 in chips) 
Seat 4: marcin116 ($10 in chips) 
Seat 5: dancayamanda ($10.28 in chips) 
Seat 6: RUMJO ($13.25 in chips) 
22888899: posts small blind $0.05
marcin116: posts big blind $0.10
*** HOLE CARDS ***
dancayamanda: folds 
RUMJO: folds 
Bino0203: folds 
perespell: raises $0.15 to $0.25
22888899: calls $0.20
marcin116: raises $0.75 to $1
perespell: calls $0.75
22888899: folds 
*** FLOP *** [4s 5c Tc]
marcin116: bets $1.61
perespell: calls $1.61
*** TURN *** [4s 5c Tc] [Kh]
marcin116: bets $3.65
perespell: calls $3.65
*** RIVER *** [4s 5c Tc Kh] [2h]
marcin116: checks 
perespell: checks 
*** SHOW DOWN ***
marcin116: shows [Kd Ah] (a pair of Kings)
perespell: mucks hand 
marcin116 collected $12.20 from pot
*** SUMMARY ***
Total pot $12.77 | Rake $0.57 
Board [4s 5c Tc Kh 2h]
Seat 1: Bino0203 folded before Flop (didn't bet)
Seat 2: perespell (button) mucked
Seat 3: 22888899 (small blind) folded before Flop
Seat 4: marcin116 (big blind) showed [Kd Ah] and won ($12.20) with a pair of Kings
Seat 5: dancayamanda folded before Flop (didn't bet)
Seat 6: RUMJO folded before Flop (didn't bet)



PokerStars Hand #222973106160:  Hold'em No Limit ($0.05/$0.10 USD) - 2021/01/23 16:45:15 ET
Table 'Stephano III' 6-max Seat #3 is the button
Seat 1: Bino0203 ($10.84 in chips) 
Seat 2: perespell ($10 in chips) 
Seat 3: 22888899 ($7.17 in chips) 
Seat 4: marcin116 ($15.94 in chips) 
Seat 5: dancayamanda ($10.28 in chips) 
Seat 6: RUMJO ($13.25 in chips) 
marcin116: posts small blind $0.05
dancayamanda: posts big blind $0.10
*** HOLE CARDS ***
RUMJO: raises $0.15 to $0.25
Bino0203: folds 
perespell: calls $0.25
22888899: calls $0.25
marcin116: folds 
dancayamanda: calls $0.15
*** FLOP *** [Kh 4s Kc]
dancayamanda: checks 
RUMJO: checks 
perespell: checks 
22888899: bets $0.80
dancayamanda: calls $0.80
RUMJO: folds 
perespell: folds 
*** TURN *** [Kh 4s Kc] [As]
dancayamanda: checks 
22888899: checks 
*** RIVER *** [Kh 4s Kc As] [7s]
RUMJO leaves the table
dancayamanda: checks 
22888899: checks 
*** SHOW DOWN ***
dancayamanda: shows [2d Kd] (three of a kind, Kings)
22888899: mucks hand 
dancayamanda collected $2.53 from pot
*** SUMMARY ***
Total pot $2.65 | Rake $0.12 
Board [Kh 4s Kc As 7s]
Seat 1: Bino0203 folded before Flop (didn't bet)
Seat 2: perespell folded on the Flop
Seat 3: 22888899 (button) mucked
Seat 4: marcin116 (small blind) folded before Flop
Seat 5: dancayamanda (big blind) showed [2d Kd] and won ($2.53) with three of a kind, Kings
Seat 6: RUMJO folded on the Flop



PokerStars Hand #222973143772:  Hold'em No Limit ($0.05/$0.10 USD) - 2021/01/23 16:46:01 ET
Table 'Stephano III' 6-max Seat #4 is the button
Seat 1: Bino0203 ($10.84 in chips) 
Seat 2: perespell ($10 in chips) 
Seat 3: 22888899 ($6.12 in chips) 
Seat 4: marcin116 ($15.89 in chips) 
Seat 5: dancayamanda ($11.76 in chips) 
dancayamanda: posts small blind $0.05
Bino0203: posts big blind $0.10
*** HOLE CARDS ***
perespell: folds 
22888899: raises $0.10 to $0.20
marcin116: folds 
dancayamanda: raises $0.60 to $0.80
Bino0203: folds 
casimiro124 joins the table at seat #6 
22888899: calls $0.60
*** FLOP *** [6h Ah Td]
dancayamanda: bets $0.53
22888899: calls $0.53
*** TURN *** [6h Ah Td] [4d]
dancayamanda: bets $3.43
22888899: raises $1.36 to $4.79 and is all-in
dancayamanda: calls $1.36
*** RIVER *** [6h Ah Td 4d] [Qd]
*** SHOW DOWN ***
dancayamanda: shows [Ad Jd] (a flush, Ace high)
22888899: shows [2h 8h] (high card Ace)
dancayamanda collected $11.78 from pot
*** SUMMARY ***
Total pot $12.34 | Rake $0.56 
Board [6h Ah Td 4d Qd]
Seat 1: Bino0203 (big blind) folded before Flop
Seat 2: perespell folded before Flop (didn't bet)
Seat 3: 22888899 showed [2h 8h] and lost with high card Ace
Seat 4: marcin116 (button) folded before Flop (didn't bet)
Seat 5: dancayamanda (small blind) showed [Ad Jd] and won ($11.78) with a flush, Ace high



PokerStars Hand #222973197548:  Hold'em No Limit ($0.05/$0.10 USD) - 2021/01/23 16:47:05 ET
Table 'Stephano III' 6-max Seat #5 is the button
Seat 1: Bino0203 ($10.74 in chips) 
Seat 2: perespell ($10 in chips) 
Seat 4: marcin116 ($15.89 in chips) 
Seat 5: dancayamanda ($17.42 in chips) 
Bino0203: posts small blind $0.05
perespell: posts big blind $0.10
*** HOLE CARDS ***
marcin116: raises $0.25 to $0.35
dancayamanda: folds 
22888899 leaves the table
Bino0203: calls $0.30
ibclm joins the table at seat #3 
perespell: folds 
*** FLOP *** [Qc 3d 9s]
Bino0203: checks 
marcin116: checks 
*** TURN *** [Qc 3d 9s] [Td]
Bino0203: bets $0.10
marcin116: folds 
Uncalled bet ($0.10) returned to Bino0203
Bino0203 collected $0.76 from pot
Bino0203: doesn't show hand 
*** SUMMARY ***
Total pot $0.80 | Rake $0.04 
Board [Qc 3d 9s Td]
Seat 1: Bino0203 (small blind) collected ($0.76)
Seat 2: perespell (big blind) folded before Flop
Seat 4: marcin116 folded on the Turn
Seat 5: dancayamanda (button) folded before Flop (didn't bet)



PokerStars Hand #222973230456:  Hold'em No Limit ($0.05/$0.10 USD) - 2021/01/23 16:47:44 ET
Table 'Stephano III' 6-max Seat #1 is the button
Seat 1: Bino0203 ($11.15 in chips) 
Seat 2: perespell ($10 in chips) 
Seat 3: ibclm ($4 in chips) 
Seat 4: marcin116 ($15.54 in chips) 
Seat 5: dancayamanda ($17.42 in chips) 
perespell: posts small blind $0.05
ibclm: posts big blind $0.10
casimiro124: sits out 
*** HOLE CARDS ***
marcin116: raises $0.25 to $0.35
dancayamanda: folds 
Bino0203: folds 
perespell: folds 
ibclm: folds 
Uncalled bet ($0.25) returned to marcin116
marcin116 collected $0.25 from pot
marcin116: doesn't show hand 
*** SUMMARY ***
Total pot $0.25 | Rake $0 
Seat 1: Bino0203 (button) folded before Flop (didn't bet)
Seat 2: perespell (small blind) folded before Flop
Seat 3: ibclm (big blind) folded before Flop
Seat 4: marcin116 collected ($0.25)
Seat 5: dancayamanda folded before Flop (didn't bet)



PokerStars Hand #222973242306:  Hold'em No Limit ($0.05/$0.10 USD) - 2021/01/23 16:47:58 ET
Table 'Stephano III' 6-max Seat #2 is the button
Seat 1: Bino0203 ($11.15 in chips) 
Seat 2: perespell ($10 in chips) 
Seat 3: ibclm ($3.90 in chips) 
Seat 4: marcin116 ($15.69 in chips) 
Seat 5: dancayamanda ($17.42 in chips) 
ibclm: posts small blind $0.05
marcin116: posts big blind $0.10
casimiro124: sits out 
*** HOLE CARDS ***
dancayamanda: folds 
Bino0203: folds 
perespell: raises $0.15 to $0.25
ibclm: folds 
marcin116: calls $0.15
*** FLOP *** [6d Kh Js]
marcin116: checks 
perespell: checks 
*** TURN *** [6d Kh Js] [Qh]
marcin116: bets $0.37
perespell: folds 
Uncalled bet ($0.37) returned to marcin116
marcin116 collected $0.53 from pot
marcin116: doesn't show hand 
*** SUMMARY ***
Total pot $0.55 | Rake $0.02 
Board [6d Kh Js Qh]
Seat 1: Bino0203 folded before Flop (didn't bet)
Seat 2: perespell (button) folded on the Turn
Seat 3: ibclm (small blind) folded before Flop
Seat 4: marcin116 (big blind) collected ($0.53)
Seat 5: dancayamanda folded before Flop (didn't bet)



PokerStars Hand #222973262854:  Hold'em No Limit ($0.05/$0.10 USD) - 2021/01/23 16:48:23 ET
Table 'Stephano III' 6-max Seat #3 is the button
Seat 1: Bino0203 ($11.15 in chips) 
Seat 2: perespell ($10 in chips) 
Seat 3: ibclm ($3.85 in chips) 
Seat 4: marcin116 ($15.97 in chips) 
Seat 5: dancayamanda ($17.42 in chips) 
marcin116: posts small blind $0.05
dancayamanda: posts big blind $0.10
casimiro124: sits out 
*** HOLE CARDS ***
Bino0203: raises $0.10 to $0.20
perespell: folds 
ibclm: folds 
marcin116: folds 
dancayamanda: folds 
Uncalled bet ($0.10) returned to Bino0203
Bino0203 collected $0.25 from pot
Bino0203: doesn't show hand 
*** SUMMARY ***
Total pot $0.25 | Rake $0 
Seat 1: Bino0203 collected ($0.25)
Seat 2: perespell folded before Flop (didn't bet)
Seat 3: ibclm (button) folded before Flop (didn't bet)
Seat 4: marcin116 (small blind) folded before Flop
Seat 5: dancayamanda (big blind) folded before Flop



PokerStars Hand #222973274127:  Hold'em No Limit ($0.05/$0.10 USD) - 2021/01/23 16:48:36 ET
Table 'Stephano III' 6-max Seat #4 is the button
Seat 1: Bino0203 ($11.30 in chips) 
Seat 2: perespell ($10 in chips) 
Seat 3: ibclm ($3.85 in chips) 
Seat 4: marcin116 ($15.92 in chips) 
Seat 5: dancayamanda ($17.32 in chips) 
Seat 6: casimiro124 ($10 in chips) 
dancayamanda: posts small blind $0.05
casimiro124: posts big blind $0.10
*** HOLE CARDS ***
Bino0203: folds 
perespell: folds 
ibclm: raises $0.10 to $0.20
marcin116: raises $0.55 to $0.75
dancayamanda: folds 
casimiro124: folds 
ibclm: folds 
Uncalled bet ($0.55) returned to marcin116
marcin116 collected $0.55 from pot
marcin116: doesn't show hand 
*** SUMMARY ***
Total pot $0.55 | Rake $0 
Seat 1: Bino0203 folded before Flop (didn't bet)
Seat 2: perespell folded before Flop (didn't bet)
Seat 3: ibclm folded before Flop
Seat 4: marcin116 (button) collected ($0.55)
Seat 5: dancayamanda (small blind) folded before Flop
Seat 6: casimiro124 (big blind) folded before Flop



PokerStars Hand #222973293197:  Hold'em No Limit ($0.05/$0.10 USD) - 2021/01/23 16:48:59 ET
Table 'Stephano III' 6-max Seat #5 is the button
Seat 1: Bino0203 ($11.30 in chips) 
Seat 2: perespell ($10 in chips) 
Seat 3: ibclm ($3.65 in chips) 
Seat 4: marcin116 ($16.27 in chips) 
Seat 5: dancayamanda ($17.27 in chips) 
Seat 6: casimiro124 ($10 in chips) 
casimiro124: posts small blind $0.05
Bino0203: posts big blind $0.10
*** HOLE CARDS ***
perespell: folds 
ibclm: calls $0.10
marcin116: folds 
dancayamanda: raises $0.30 to $0.40
casimiro124: folds 
Bino0203: calls $0.30
ibclm: folds 
*** FLOP *** [Ks 7h Th]
Bino0203: bets $0.45
dancayamanda: raises $1 to $1.45
Bino0203: folds 
Uncalled bet ($1) returned to dancayamanda
dancayamanda collected $1.77 from pot
dancayamanda: doesn't show hand 
*** SUMMARY ***
Total pot $1.85 | Rake $0.08 
Board [Ks 7h Th]
Seat 1: Bino0203 (big blind) folded on the Flop
Seat 2: perespell folded before Flop (didn't bet)
Seat 3: ibclm folded before Flop
Seat 4: marcin116 folded before Flop (didn't bet)
Seat 5: dancayamanda (button) collected ($1.77)
Seat 6: casimiro124 (small blind) folded before Flop



PokerStars Hand #222973345576:  Hold'em No Limit ($0.05/$0.10 USD) - 2021/01/23 16:50:01 ET
Table 'Stephano III' 6-max Seat #6 is the button
Seat 1: Bino0203 ($10.45 in chips) 
Seat 2: perespell ($10 in chips) 
Seat 3: ibclm ($3.55 in chips) 
Seat 4: marcin116 ($16.27 in chips) 
Seat 5: dancayamanda ($18.19 in chips) 
Seat 6: casimiro124 ($10 in chips) 
Bino0203: posts small blind $0.05
perespell: posts big blind $0.10
*** HOLE CARDS ***
ibclm: raises $0.10 to $0.20
marcin116: folds 
dancayamanda: folds 
casimiro124: folds 
Bino0203: raises $0.50 to $0.70
perespell: folds 
ibclm: calls $0.50
*** FLOP *** [8s 7d Qd]
Bino0203: checks 
ibclm: checks 
*** TURN *** [8s 7d Qd] [6d]
Bino0203: bets $1.43
ibclm: folds 
Uncalled bet ($1.43) returned to Bino0203
Bino0203 collected $1.43 from pot
Bino0203: doesn't show hand 
*** SUMMARY ***
Total pot $1.50 | Rake $0.07 
Board [8s 7d Qd 6d]
Seat 1: Bino0203 (small blind) collected ($1.43)
Seat 2: perespell (big blind) folded before Flop
Seat 3: ibclm folded on the Turn
Seat 4: marcin116 folded before Flop (didn't bet)
Seat 5: dancayamanda folded before Flop (didn't bet)
Seat 6: casimiro124 (button) folded before Flop (didn't bet)



PokerStars Hand #222973383790:  Hold'em No Limit ($0.05/$0.10 USD) - 2021/01/23 16:50:47 ET
Table 'Stephano III' 6-max Seat #1 is the button
Seat 1: Bino0203 ($11.18 in chips) 
Seat 2: perespell ($10 in chips) 
Seat 3: ibclm ($2.85 in chips) 
Seat 4: marcin116 ($16.27 in chips) 
Seat 5: dancayamanda ($18.19 in chips) 
Seat 6: casimiro124 ($10 in chips) 
perespell: posts small blind $0.05
ibclm: posts big blind $0.10
*** HOLE CARDS ***
marcin116: raises $0.25 to $0.35
dancayamanda: folds 
casimiro124: folds 
Bino0203: folds 
perespell: folds 
ibclm: calls $0.25
*** FLOP *** [9c Th Js]
ibclm: checks 
marcin116: checks 
*** TURN *** [9c Th Js] [Qh]
ibclm: checks 
marcin116: checks 
*** RIVER *** [9c Th Js Qh] [5s]
ibclm: bets $0.72
marcin116: folds 
Uncalled bet ($0.72) returned to ibclm
ibclm collected $0.72 from pot
ibclm: doesn't show hand 
*** SUMMARY ***
Total pot $0.75 | Rake $0.03 
Board [9c Th Js Qh 5s]
Seat 1: Bino0203 (button) folded before Flop (didn't bet)
Seat 2: perespell (small blind) folded before Flop
Seat 3: ibclm (big blind) collected ($0.72)
Seat 4: marcin116 folded on the River
Seat 5: dancayamanda folded before Flop (didn't bet)
Seat 6: casimiro124 folded before Flop (didn't bet)



PokerStars Hand #222973417062:  Hold'em No Limit ($0.05/$0.10 USD) - 2021/01/23 16:51:26 ET
Table 'Stephano III' 6-max Seat #2 is the button
Seat 1: Bino0203 ($11.18 in chips) 
Seat 2: perespell ($10 in chips) 
Seat 3: ibclm ($3.22 in chips) 
Seat 4: marcin116 ($15.92 in chips) 
Seat 5: dancayamanda ($18.19 in chips) 
Seat 6: casimiro124 ($10 in chips) 
ibclm: posts small blind $0.05
marcin116: posts big blind $0.10
*** HOLE CARDS ***
dancayamanda: folds 
casimiro124: folds 
Bino0203: folds 
perespell: raises $0.15 to $0.25
ibclm: folds 
marcin116: folds 
Uncalled bet ($0.15) returned to perespell
perespell collected $0.25 from pot
perespell: doesn't show hand 
*** SUMMARY ***
Total pot $0.25 | Rake $0 
Seat 1: Bino0203 folded before Flop (didn't bet)
Seat 2: perespell (button) collected ($0.25)
Seat 3: ibclm (small blind) folded before Flop
Seat 4: marcin116 (big blind) folded before Flop
Seat 5: dancayamanda folded before Flop (didn't bet)
Seat 6: casimiro124 folded before Flop (didn't bet)



PokerStars Hand #222973427498:  Hold'em No Limit ($0.05/$0.10 USD) - 2021/01/23 16:51:39 ET
Table 'Stephano III' 6-max Seat #3 is the button
Seat 1: Bino0203 ($11.18 in chips) 
Seat 2: perespell ($10.15 in chips) 
Seat 3: ibclm ($3.17 in chips) 
Seat 4: marcin116 ($15.82 in chips) 
Seat 5: dancayamanda ($18.19 in chips) 
Seat 6: casimiro124 ($10 in chips) 
marcin116: posts small blind $0.05
dancayamanda: posts big blind $0.10
*** HOLE CARDS ***
casimiro124: folds 
Bino0203: raises $0.10 to $0.20
perespell: calls $0.20
ibclm: calls $0.20
marcin116: calls $0.15
dancayamanda: folds 
*** FLOP *** [Kh 7c Qs]
marcin116: checks 
Bino0203: bets $0.86
perespell: folds 
ibclm: folds 
marcin116: folds 
Uncalled bet ($0.86) returned to Bino0203
Bino0203 collected $0.86 from pot
Bino0203: doesn't show hand 
*** SUMMARY ***
Total pot $0.90 | Rake $0.04 
Board [Kh 7c Qs]
Seat 1: Bino0203 collected ($0.86)
Seat 2: perespell folded on the Flop
Seat 3: ibclm (button) folded on the Flop
Seat 4: marcin116 (small blind) folded on the Flop
Seat 5: dancayamanda (big blind) folded before Flop
Seat 6: casimiro124 folded before Flop (didn't bet)



PokerStars Hand #222973450828:  Hold'em No Limit ($0.05/$0.10 USD) - 2021/01/23 16:52:07 ET
Table 'Stephano III' 6-max Seat #4 is the button
Seat 1: Bino0203 ($11.84 in chips) 
Seat 2: perespell ($10 in chips) 
Seat 3: ibclm ($2.97 in chips) 
Seat 4: marcin116 ($15.62 in chips) 
Seat 5: dancayamanda ($18.09 in chips) 
Seat 6: casimiro124 ($10 in chips) 
dancayamanda: posts small blind $0.05
casimiro124: posts big blind $0.10
*** HOLE CARDS ***
Bino0203: raises $0.10 to $0.20
perespell: folds 
ibclm: calls $0.20
marcin116: folds 
dancayamanda: folds 
casimiro124: folds 
*** FLOP *** [9s 2d 3c]
Bino0203: checks 
ibclm: checks 
*** TURN *** [9s 2d 3c] [Th]
Bino0203: checks 
ibclm: bets $0.10
Bino0203: folds 
Uncalled bet ($0.10) returned to ibclm
ibclm collected $0.53 from pot
ibclm: doesn't show hand 
*** SUMMARY ***
Total pot $0.55 | Rake $0.02 
Board [9s 2d 3c Th]
Seat 1: Bino0203 folded on the Turn
Seat 2: perespell folded before Flop (didn't bet)
Seat 3: ibclm collected ($0.53)
Seat 4: marcin116 (button) folded before Flop (didn't bet)
Seat 5: dancayamanda (small blind) folded before Flop
Seat 6: casimiro124 (big blind) folded before Flop



PokerStars Hand #222973478599:  Hold'em No Limit ($0.05/$0.10 USD) - 2021/01/23 16:52:40 ET
Table 'Stephano III' 6-max Seat #5 is the button
Seat 1: Bino0203 ($11.64 in chips) 
Seat 2: perespell ($10 in chips) 
Seat 3: ibclm ($3.30 in chips) 
Seat 4: marcin116 ($15.62 in chips) 
Seat 5: dancayamanda ($18.04 in chips) 
Seat 6: casimiro124 ($10 in chips) 
casimiro124: posts small blind $0.05
Bino0203: posts big blind $0.10
*** HOLE CARDS ***
perespell: folds 
ibclm: calls $0.10
marcin116: raises $0.35 to $0.45
dancayamanda: folds 
casimiro124: folds 
Bino0203: folds 
ibclm: folds 
Uncalled bet ($0.35) returned to marcin116
marcin116 collected $0.35 from pot
marcin116: doesn't show hand 
*** SUMMARY ***
Total pot $0.35 | Rake $0 
Seat 1: Bino0203 (big blind) folded before Flop
Seat 2: perespell folded before Flop (didn't bet)
Seat 3: ibclm folded before Flop
Seat 4: marcin116 collected ($0.35)
Seat 5: dancayamanda (button) folded before Flop (didn't bet)
Seat 6: casimiro124 (small blind) folded before Flop



PokerStars Hand #222973498600:  Hold'em No Limit ($0.05/$0.10 USD) - 2021/01/23 16:53:04 ET
Table 'Stephano III' 6-max Seat #6 is the button
Seat 1: Bino0203 ($11.54 in chips) 
Seat 2: perespell ($10 in chips) 
Seat 3: ibclm ($3.20 in chips) 
Seat 4: marcin116 ($15.87 in chips) 
Seat 5: dancayamanda ($18.04 in chips) 
Seat 6: casimiro124 ($10 in chips) 
Bino0203: posts small blind $0.05
perespell: posts big blind $0.10
*** HOLE CARDS ***
ibclm: folds 
marcin116: folds 
dancayamanda: folds 
casimiro124: raises $0.15 to $0.25
Bino0203: calls $0.20
perespell: folds 
*** FLOP *** [5h 2d Tc]
Bino0203: bets $0.28
casimiro124: folds 
Uncalled bet ($0.28) returned to Bino0203
Bino0203 collected $0.57 from pot
Bino0203: doesn't show hand 
*** SUMMARY ***
Total pot $0.60 | Rake $0.03 
Board [5h 2d Tc]
Seat 1: Bino0203 (small blind) collected ($0.57)
Seat 2: perespell (big blind) folded before Flop
Seat 3: ibclm folded before Flop (didn't bet)
Seat 4: marcin116 folded before Flop (didn't bet)
Seat 5: dancayamanda folded before Flop (didn't bet)
Seat 6: casimiro124 (button) folded on the Flop



PokerStars Hand #222973519181:  Hold'em No Limit ($0.05/$0.10 USD) - 2021/01/23 16:53:28 ET
Table 'Stephano III' 6-max Seat #1 is the button
Seat 1: Bino0203 ($11.86 in chips) 
Seat 2: perespell ($10 in chips) 
Seat 3: ibclm ($3.20 in chips) 
Seat 4: marcin116 ($15.87 in chips) 
Seat 5: dancayamanda ($18.04 in chips) 
Seat 6: casimiro124 ($10 in chips) 
perespell: posts small blind $0.05
ibclm: posts big blind $0.10
*** HOLE CARDS ***
marcin116: raises $0.25 to $0.35
dancayamanda: folds 
casimiro124: folds 
Bino0203: folds 
perespell: folds 
Bino0203 leaves the table
ibclm: raises $0.55 to $0.90
marcin116: calls $0.55
*** FLOP *** [7s 3c 8h]
ibclm: checks 
marcin116: checks 
*** TURN *** [7s 3c 8h] [4s]
ibclm: bets $0.60
marcin116: folds 
Uncalled bet ($0.60) returned to ibclm
ibclm collected $1.77 from pot
ibclm: doesn't show hand 
*** SUMMARY ***
Total pot $1.85 | Rake $0.08 
Board [7s 3c 8h 4s]
Seat 1: Bino0203 (button) folded before Flop (didn't bet)
Seat 2: perespell (small blind) folded before Flop
Seat 3: ibclm (big blind) collected ($1.77)
Seat 4: marcin116 folded on the Turn
Seat 5: dancayamanda folded before Flop (didn't bet)
Seat 6: casimiro124 folded before Flop (didn't bet)



PokerStars Hand #222973550636:  Hold'em No Limit ($0.05/$0.10 USD) - 2021/01/23 16:54:06 ET
Table 'Stephano III' 6-max Seat #2 is the button
Seat 2: perespell ($10 in chips) 
Seat 3: ibclm ($4.07 in chips) 
Seat 4: marcin116 ($14.97 in chips) 
Seat 5: dancayamanda ($18.04 in chips) 
Seat 6: casimiro124 ($10 in chips) 
ibclm: posts small blind $0.05
marcin116: posts big blind $0.10
*** HOLE CARDS ***
dancayamanda: folds 
zzuuqq joins the table at seat #1 
casimiro124: raises $0.15 to $0.25
perespell: raises $0.55 to $0.80
ibclm: folds 
marcin116: folds 
casimiro124: folds 
Uncalled bet ($0.55) returned to perespell
perespell collected $0.65 from pot
perespell: doesn't show hand 
*** SUMMARY ***
Total pot $0.65 | Rake $0 
Seat 2: perespell (button) collected ($0.65)
Seat 3: ibclm (small blind) folded before Flop
Seat 4: marcin116 (big blind) folded before Flop
Seat 5: dancayamanda folded before Flop (didn't bet)
Seat 6: casimiro124 folded before Flop



PokerStars Hand #222973569420:  Hold'em No Limit ($0.05/$0.10 USD) - 2021/01/23 16:54:29 ET
Table 'Stephano III' 6-max Seat #3 is the button
Seat 2: perespell ($10.40 in chips) 
Seat 3: ibclm ($4.02 in chips) 
Seat 4: marcin116 ($14.87 in chips) 
Seat 5: dancayamanda ($18.04 in chips) 
Seat 6: casimiro124 ($10 in chips) 
marcin116: posts small blind $0.05
dancayamanda: posts big blind $0.10
zzuuqq: sits out 
*** HOLE CARDS ***
casimiro124: folds 
perespell: raises $0.15 to $0.25
ibclm: folds 
marcin116: folds 
dancayamanda: calls $0.15
*** FLOP *** [8h 6h Qc]
dancayamanda: checks 
perespell: checks 
*** TURN *** [8h 6h Qc] [Kd]
dancayamanda: checks 
perespell: bets $0.27
dancayamanda: folds 
Uncalled bet ($0.27) returned to perespell
perespell collected $0.53 from pot
perespell: doesn't show hand 
*** SUMMARY ***
Total pot $0.55 | Rake $0.02 
Board [8h 6h Qc Kd]
Seat 2: perespell collected ($0.53)
Seat 3: ibclm (button) folded before Flop (didn't bet)
Seat 4: marcin116 (small blind) folded before Flop
Seat 5: dancayamanda (big blind) folded on the Turn
Seat 6: casimiro124 folded before Flop (didn't bet)



PokerStars Hand #222973598062:  Hold'em No Limit ($0.05/$0.10 USD) - 2021/01/23 16:55:03 ET
Table 'Stephano III' 6-max Seat #4 is the button
Seat 2: perespell ($10.68 in chips) 
Seat 3: ibclm ($4.02 in chips) 
Seat 4: marcin116 ($14.82 in chips) 
Seat 5: dancayamanda ($17.79 in chips) 
Seat 6: casimiro124 ($10 in chips) 
dancayamanda: posts small blind $0.05
casimiro124: posts big blind $0.10
zzuuqq: sits out 
*** HOLE CARDS ***
perespell: folds 
ibclm: folds 
marcin116: folds 
dancayamanda: folds 
Uncalled bet ($0.05) returned to casimiro124
casimiro124 collected $0.10 from pot
casimiro124: doesn't show hand 
*** SUMMARY ***
Total pot $0.10 | Rake $0 
Seat 2: perespell folded before Flop (didn't bet)
Seat 3: ibclm folded before Flop (didn't bet)
Seat 4: marcin116 (button) folded before Flop (didn't bet)
Seat 5: dancayamanda (small blind) folded before Flop
Seat 6: casimiro124 (big blind) collected ($0.10)



PokerStars Hand #222973605562:  Hold'em No Limit ($0.05/$0.10 USD) - 2021/01/23 16:55:14 ET
Table 'Stephano III' 6-max Seat #5 is the button
Seat 1: zzuuqq ($10 in chips) 
Seat 2: perespell ($10.68 in chips) 
Seat 3: ibclm ($4.02 in chips) 
Seat 4: marcin116 ($14.82 in chips) 
Seat 5: dancayamanda ($17.74 in chips) 
Seat 6: casimiro124 ($10.05 in chips) 
casimiro124: posts small blind $0.05
zzuuqq: posts big blind $0.10
*** HOLE CARDS ***
perespell: folds 
ibclm: calls $0.10
marcin116: folds 
dancayamanda: raises $0.30 to $0.40
casimiro124: folds 
zzuuqq: folds 
ibclm: folds 
Uncalled bet ($0.30) returned to dancayamanda
dancayamanda collected $0.35 from pot
dancayamanda: doesn't show hand 
*** SUMMARY ***
Total pot $0.35 | Rake $0 
Seat 1: zzuuqq (big blind) folded before Flop
Seat 2: perespell folded before Flop (didn't bet)
Seat 3: ibclm folded before Flop
Seat 4: marcin116 folded before Flop (didn't bet)
Seat 5: dancayamanda (button) collected ($0.35)
Seat 6: casimiro124 (small blind) folded before Flop



PokerStars Hand #222973618650:  Hold'em No Limit ($0.05/$0.10 USD) - 2021/01/23 16:55:37 ET
Table 'Stephano III' 6-max Seat #6 is the button
Seat 1: zzuuqq ($9.90 in chips) 
Seat 2: perespell ($10.68 in chips) 
Seat 3: ibclm ($3.92 in chips) 
Seat 4: marcin116 ($14.82 in chips) 
Seat 6: casimiro124 ($10 in chips) 
zzuuqq: posts small blind $0.05
perespell: posts big blind $0.10
*** HOLE CARDS ***
ibclm: folds 
marcin116: folds 
casimiro124: raises $0.15 to $0.25
zzuuqq: folds 
perespell: folds 
Uncalled bet ($0.15) returned to casimiro124
casimiro124 collected $0.25 from pot
casimiro124: doesn't show hand 
*** SUMMARY ***
Total pot $0.25 | Rake $0 
Seat 1: zzuuqq (small blind) folded before Flop
Seat 2: perespell (big blind) folded before Flop
Seat 3: ibclm folded before Flop (didn't bet)
Seat 4: marcin116 folded before Flop (didn't bet)
Seat 6: casimiro124 (button) collected ($0.25)



PokerStars Hand #222973629512:  Hold'em No Limit ($0.05/$0.10 USD) - 2021/01/23 16:55:56 ET
Table 'Stephano III' 6-max Seat #1 is the button
Seat 1: zzuuqq ($9.85 in chips) 
Seat 2: perespell ($10.58 in chips) 
Seat 3: ibclm ($3.92 in chips) 
Seat 4: marcin116 ($14.82 in chips) 
Seat 6: casimiro124 ($10.15 in chips) 
perespell: posts small blind $0.05
ibclm: posts big blind $0.10
*** HOLE CARDS ***
marcin116: folds 
casimiro124: folds 
zzuuqq: folds 
zzuuqq leaves the table
perespell: folds 
Uncalled bet ($0.05) returned to ibclm
ibclm collected $0.10 from pot
ibclm: doesn't show hand 
*** SUMMARY ***
Total pot $0.10 | Rake $0 
Seat 1: zzuuqq (button) folded before Flop (didn't bet)
Seat 2: perespell (small blind) folded before Flop
Seat 3: ibclm (big blind) collected ($0.10)
Seat 4: marcin116 folded before Flop (didn't bet)
Seat 6: casimiro124 folded before Flop (didn't bet)



PokerStars Hand #222973633128:  Hold'em No Limit ($0.05/$0.10 USD) - 2021/01/23 16:56:03 ET
Table 'Stephano III' 6-max Seat #2 is the button
Seat 2: perespell ($10.53 in chips) 
Seat 3: ibclm ($3.97 in chips) 
Seat 4: marcin116 ($14.82 in chips) 
Seat 6: casimiro124 ($10.15 in chips) 
ibclm: posts small blind $0.05
marcin116: posts big blind $0.10
*** HOLE CARDS ***
casimiro124: raises $0.15 to $0.25
perespell: calls $0.25
ibclm: folds 
marcin116: folds 
*** FLOP *** [Qs 7s Kh]
casimiro124: bets $0.33
perespell: folds 
Uncalled bet ($0.33) returned to casimiro124
casimiro124 collected $0.62 from pot
casimiro124: doesn't show hand 
*** SUMMARY ***
Total pot $0.65 | Rake $0.03 
Board [Qs 7s Kh]
Seat 2: perespell (button) folded on the Flop
Seat 3: ibclm (small blind) folded before Flop
Seat 4: marcin116 (big blind) folded before Flop
Seat 6: casimiro124 collected ($0.62)



PokerStars Hand #222973644544:  Hold'em No Limit ($0.05/$0.10 USD) - 2021/01/23 16:56:23 ET
Table 'Stephano III' 6-max Seat #3 is the button
Seat 2: perespell ($10.28 in chips) 
Seat 3: ibclm ($3.92 in chips) 
Seat 4: marcin116 ($14.72 in chips) 
Seat 6: casimiro124 ($10.52 in chips) 
marcin116: posts small blind $0.05
casimiro124: posts big blind $0.10
*** HOLE CARDS ***
perespell: folds 
ibclm: raises $0.20 to $0.30
marcin116: folds 
iwinflipld joins the table at seat #1 
casimiro124: folds 
Uncalled bet ($0.20) returned to ibclm
ibclm collected $0.25 from pot
ibclm: doesn't show hand 
*** SUMMARY ***
Total pot $0.25 | Rake $0 
Seat 2: perespell folded before Flop (didn't bet)
Seat 3: ibclm (button) collected ($0.25)
Seat 4: marcin116 (small blind) folded before Flop
Seat 6: casimiro124 (big blind) folded before Flop



PokerStars Hand #222973654301:  Hold'em No Limit ($0.05/$0.10 USD) - 2021/01/23 16:56:40 ET
Table 'Stephano III' 6-max Seat #4 is the button
Seat 1: iwinflipld ($10 in chips) 
Seat 2: perespell ($10.28 in chips) 
Seat 3: ibclm ($4.07 in chips) 
Seat 4: marcin116 ($14.67 in chips) 
Seat 6: casimiro124 ($10.42 in chips) 
casimiro124: posts small blind $0.05
iwinflipld: posts big blind $0.10
*** HOLE CARDS ***
perespell: folds 
ibclm: folds 
marcin116: folds 
casimiro124: raises $0.20 to $0.30
iwinflipld: folds 
Uncalled bet ($0.20) returned to casimiro124
casimiro124 collected $0.20 from pot
casimiro124: doesn't show hand 
*** SUMMARY ***
Total pot $0.20 | Rake $0 
Seat 1: iwinflipld (big blind) folded before Flop
Seat 2: perespell folded before Flop (didn't bet)
Seat 3: ibclm folded before Flop (didn't bet)
Seat 4: marcin116 (button) folded before Flop (didn't bet)
Seat 6: casimiro124 (small blind) collected ($0.20)



PokerStars Hand #222973666282:  Hold'em No Limit ($0.05/$0.10 USD) - 2021/01/23 16:57:01 ET
Table 'Stephano III' 6-max Seat #6 is the button
Seat 1: iwinflipld ($9.90 in chips) 
Seat 2: perespell ($10.28 in chips) 
Seat 3: ibclm ($4.07 in chips) 
Seat 4: marcin116 ($14.67 in chips) 
Seat 6: casimiro124 ($10.52 in chips) 
iwinflipld: posts small blind $0.05
perespell: posts big blind $0.10
*** HOLE CARDS ***
ibclm: calls $0.10
marcin116: folds 
casimiro124: folds 
iwinflipld: folds 
perespell: raises $0.30 to $0.40
ibclm: folds 
Uncalled bet ($0.30) returned to perespell
perespell collected $0.25 from pot
perespell: doesn't show hand 
*** SUMMARY ***
Total pot $0.25 | Rake $0 
Seat 1: iwinflipld (small blind) folded before Flop
Seat 2: perespell (big blind) collected ($0.25)
Seat 3: ibclm folded before Flop
Seat 4: marcin116 folded before Flop (didn't bet)
Seat 6: casimiro124 (button) folded before Flop (didn't bet)



PokerStars Hand #222973678646:  Hold'em No Limit ($0.05/$0.10 USD) - 2021/01/23 16:57:22 ET
Table 'Stephano III' 6-max Seat #1 is the button
Seat 1: iwinflipld ($10 in chips) 
Seat 2: perespell ($10.43 in chips) 
Seat 3: ibclm ($3.97 in chips) 
Seat 4: marcin116 ($14.67 in chips) 
Seat 6: casimiro124 ($10.52 in chips) 
perespell: posts small blind $0.05
ibclm: posts big blind $0.10
*** HOLE CARDS ***
marcin116: folds 
casimiro124: folds 
iwinflipld: folds 
perespell: folds 
Uncalled bet ($0.05) returned to ibclm
ibclm collected $0.10 from pot
ibclm: doesn't show hand 
*** SUMMARY ***
Total pot $0.10 | Rake $0 
Seat 1: iwinflipld (button) folded before Flop (didn't bet)
Seat 2: perespell (small blind) folded before Flop
Seat 3: ibclm (big blind) collected ($0.10)
Seat 4: marcin116 folded before Flop (didn't bet)
Seat 6: casimiro124 folded before Flop (didn't bet)



PokerStars Hand #222973686980:  Hold'em No Limit ($0.05/$0.10 USD) - 2021/01/23 16:57:36 ET
Table 'Stephano III' 6-max Seat #2 is the button
Seat 1: iwinflipld ($10 in chips) 
Seat 2: perespell ($10.38 in chips) 
Seat 3: ibclm ($4.02 in chips) 
Seat 4: marcin116 ($14.67 in chips) 
Seat 6: casimiro124 ($10.52 in chips) 
ibclm: posts small blind $0.05
marcin116: posts big blind $0.10
*** HOLE CARDS ***
casimiro124: folds 
iwinflipld: raises $0.15 to $0.25
perespell: folds 
ibclm: raises $0.15 to $0.40
marcin116: folds 
iwinflipld: calls $0.15
*** FLOP *** [2s 3h 7s]
ibclm: bets $0.20
iwinflipld: calls $0.20
*** TURN *** [2s 3h 7s] [Td]
ibclm: bets $0.62
iwinflipld: folds 
Uncalled bet ($0.62) returned to ibclm
ibclm collected $1.24 from pot
ibclm: doesn't show hand 
*** SUMMARY ***
Total pot $1.30 | Rake $0.06 
Board [2s 3h 7s Td]
Seat 1: iwinflipld folded on the Turn
Seat 2: perespell (button) folded before Flop (didn't bet)
Seat 3: ibclm (small blind) collected ($1.24)
Seat 4: marcin116 (big blind) folded before Flop
Seat 6: casimiro124 folded before Flop (didn't bet)



PokerStars Hand #222973709100:  Hold'em No Limit ($0.05/$0.10 USD) - 2021/01/23 16:58:15 ET
Table 'Stephano III' 6-max Seat #3 is the button
Seat 1: iwinflipld ($10 in chips) 
Seat 2: perespell ($10.38 in chips) 
Seat 3: ibclm ($4.66 in chips) 
Seat 4: marcin116 ($14.57 in chips) 
Seat 6: casimiro124 ($10.52 in chips) 
marcin116: posts small blind $0.05
casimiro124: posts big blind $0.10
*** HOLE CARDS ***
iwinflipld: folds 
perespell: folds 
ibclm: folds 
marcin116: folds 
Uncalled bet ($0.05) returned to casimiro124
casimiro124 collected $0.10 from pot
casimiro124: doesn't show hand 
*** SUMMARY ***
Total pot $0.10 | Rake $0 
Seat 1: iwinflipld folded before Flop (didn't bet)
Seat 2: perespell folded before Flop (didn't bet)
Seat 3: ibclm (button) folded before Flop (didn't bet)
Seat 4: marcin116 (small blind) folded before Flop
Seat 6: casimiro124 (big blind) collected ($0.10)



PokerStars Hand #222973714409:  Hold'em No Limit ($0.05/$0.10 USD) - 2021/01/23 16:58:24 ET
Table 'Stephano III' 6-max Seat #4 is the button
Seat 1: iwinflipld ($10 in chips) 
Seat 2: perespell ($10.38 in chips) 
Seat 3: ibclm ($4.66 in chips) 
Seat 4: marcin116 ($14.52 in chips) 
Seat 6: casimiro124 ($10.57 in chips) 
casimiro124: posts small blind $0.05
iwinflipld: posts big blind $0.10
*** HOLE CARDS ***
perespell: folds 
ibclm: folds 
marcin116: folds 
casimiro124: raises $0.20 to $0.30
iwinflipld: folds 
Uncalled bet ($0.20) returned to casimiro124
casimiro124 collected $0.20 from pot
casimiro124: doesn't show hand 
*** SUMMARY ***
Total pot $0.20 | Rake $0 
Seat 1: iwinflipld (big blind) folded before Flop
Seat 2: perespell folded before Flop (didn't bet)
Seat 3: ibclm folded before Flop (didn't bet)
Seat 4: marcin116 (button) folded before Flop (didn't bet)
Seat 6: casimiro124 (small blind) collected ($0.20)



PokerStars Hand #222973720392:  Hold'em No Limit ($0.05/$0.10 USD) - 2021/01/23 16:58:34 ET
Table 'Stephano III' 6-max Seat #6 is the button
Seat 1: iwinflipld ($9.90 in chips) 
Seat 2: perespell ($10.38 in chips) 
Seat 3: ibclm ($4.66 in chips) 
Seat 4: marcin116 ($14.52 in chips) 
Seat 6: casimiro124 ($10.67 in chips) 
iwinflipld: posts small blind $0.05
perespell: posts big blind $0.10
*** HOLE CARDS ***
ibclm: folds 
marcin116: raises $0.25 to $0.35
casimiro124: folds 
iwinflipld: folds 
perespell: folds 
Uncalled bet ($0.25) returned to marcin116
marcin116 collected $0.25 from pot
marcin116: doesn't show hand 
*** SUMMARY ***
Total pot $0.25 | Rake $0 
Seat 1: iwinflipld (small blind) folded before Flop
Seat 2: perespell (big blind) folded before Flop
Seat 3: ibclm folded before Flop (didn't bet)
Seat 4: marcin116 collected ($0.25)
Seat 6: casimiro124 (button) folded before Flop (didn't bet)



PokerStars Hand #222973734692:  Hold'em No Limit ($0.05/$0.10 USD) - 2021/01/23 16:58:59 ET
Table 'Stephano III' 6-max Seat #1 is the button
Seat 1: iwinflipld ($10 in chips) 
Seat 2: perespell ($10.28 in chips) 
Seat 3: ibclm ($4.66 in chips) 
Seat 4: marcin116 ($14.67 in chips) 
Seat 6: casimiro124 ($10.67 in chips) 
perespell: posts small blind $0.05
ibclm: posts big blind $0.10
*** HOLE CARDS ***
marcin116: folds 
casimiro124: raises $0.15 to $0.25
iwinflipld: folds 
perespell: folds 
ibclm: folds 
Uncalled bet ($0.15) returned to casimiro124
casimiro124 collected $0.25 from pot
casimiro124: doesn't show hand 
*** SUMMARY ***
Total pot $0.25 | Rake $0 
Seat 1: iwinflipld (button) folded before Flop (didn't bet)
Seat 2: perespell (small blind) folded before Flop
Seat 3: ibclm (big blind) folded before Flop
Seat 4: marcin116 folded before Flop (didn't bet)
Seat 6: casimiro124 collected ($0.25)



PokerStars Hand #222973742909:  Hold'em No Limit ($0.05/$0.10 USD) - 2021/01/23 16:59:13 ET
Table 'Stephano III' 6-max Seat #2 is the button
Seat 1: iwinflipld ($10 in chips) 
Seat 2: perespell ($10.23 in chips) 
Seat 3: ibclm ($4.56 in chips) 
Seat 4: marcin116 ($14.67 in chips) 
Seat 6: casimiro124 ($10.82 in chips) 
ibclm: posts small blind $0.05
marcin116: posts big blind $0.10
*** HOLE CARDS ***
casimiro124: folds 
iwinflipld: folds 
perespell: folds 
ibclm: folds 
Uncalled bet ($0.05) returned to marcin116
marcin116 collected $0.10 from pot
marcin116: doesn't show hand 
*** SUMMARY ***
Total pot $0.10 | Rake $0 
Seat 1: iwinflipld folded before Flop (didn't bet)
Seat 2: perespell (button) folded before Flop (didn't bet)
Seat 3: ibclm (small blind) folded before Flop
Seat 4: marcin116 (big blind) collected ($0.10)
Seat 6: casimiro124 folded before Flop (didn't bet)



PokerStars Hand #222973748847:  Hold'em No Limit ($0.05/$0.10 USD) - 2021/01/23 16:59:23 ET
Table 'Stephano III' 6-max Seat #3 is the button
Seat 1: iwinflipld ($10 in chips) 
Seat 2: perespell ($10.23 in chips) 
Seat 3: ibclm ($4.51 in chips) 
Seat 4: marcin116 ($14.72 in chips) 
Seat 6: casimiro124 ($10.82 in chips) 
marcin116: posts small blind $0.05
casimiro124: posts big blind $0.10
*** HOLE CARDS ***
iwinflipld: raises $0.20 to $0.30
perespell: folds 
ibclm: folds 
marcin116: folds 
casimiro124: calls $0.20
*** FLOP *** [8d Tc 5s]
casimiro124: checks 
iwinflipld: bets $0.20
casimiro124: calls $0.20
*** TURN *** [8d Tc 5s] [7s]
casimiro124: checks 
iwinflipld: bets $0.70
casimiro124: folds 
Uncalled bet ($0.70) returned to iwinflipld
iwinflipld collected $1 from pot
*** SUMMARY ***
Total pot $1.05 | Rake $0.05 
Board [8d Tc 5s 7s]
Seat 1: iwinflipld collected ($1)
Seat 2: perespell folded before Flop (didn't bet)
Seat 3: ibclm (button) folded before Flop (didn't bet)
Seat 4: marcin116 (small blind) folded before Flop
Seat 6: casimiro124 (big blind) folded on the Turn



PokerStars Hand #222973780238:  Hold'em No Limit ($0.05/$0.10 USD) - 2021/01/23 17:00:16 ET
Table 'Stephano III' 6-max Seat #4 is the button
Seat 1: iwinflipld ($10.50 in chips) 
Seat 2: perespell ($10.23 in chips) 
Seat 3: ibclm ($4.51 in chips) 
Seat 4: marcin116 ($14.67 in chips) 
Seat 6: casimiro124 ($10.32 in chips) 
casimiro124: posts small blind $0.05
iwinflipld: posts big blind $0.10
*** HOLE CARDS ***
perespell: folds 
ibclm: raises $0.10 to $0.20
marcin116: folds 
casimiro124: folds 
iwinflipld: folds 
Uncalled bet ($0.10) returned to ibclm
ibclm collected $0.25 from pot
ibclm: doesn't show hand 
*** SUMMARY ***
Total pot $0.25 | Rake $0 
Seat 1: iwinflipld (big blind) folded before Flop
Seat 2: perespell folded before Flop (didn't bet)
Seat 3: ibclm collected ($0.25)
Seat 4: marcin116 (button) folded before Flop (didn't bet)
Seat 6: casimiro124 (small blind) folded before Flop



PokerStars Hand #222973789385:  Hold'em No Limit ($0.05/$0.10 USD) - 2021/01/23 17:00:30 ET
Table 'Stephano III' 6-max Seat #6 is the button
Seat 1: iwinflipld ($10.40 in chips) 
Seat 2: perespell ($10.23 in chips) 
Seat 3: ibclm ($4.66 in chips) 
Seat 4: marcin116 ($14.67 in chips) 
Seat 6: casimiro124 ($10.27 in chips) 
iwinflipld: posts small blind $0.05
perespell: posts big blind $0.10
*** HOLE CARDS ***
ibclm: raises $0.10 to $0.20
marcin116: calls $0.20
casimiro124: calls $0.20
iwinflipld: folds 
perespell: calls $0.10
*** FLOP *** [Ad Ts 9c]
perespell: checks 
ibclm: checks 
marcin116: bets $0.61
casimiro124: calls $0.61
perespell: folds 
ibclm: calls $0.61
*** TURN *** [Ad Ts 9c] [7s]
ibclm: checks 
marcin116: checks 
casimiro124: checks 
*** RIVER *** [Ad Ts 9c 7s] [7d]
ibclm: bets $0.40
marcin116: calls $0.40
casimiro124: folds 
*** SHOW DOWN ***
ibclm: shows [Js Ac] (two pair, Aces and Sevens)
marcin116: mucks hand 
ibclm collected $3.32 from pot
*** SUMMARY ***
Total pot $3.48 | Rake $0.16 
Board [Ad Ts 9c 7s 7d]
Seat 1: iwinflipld (small blind) folded before Flop
Seat 2: perespell (big blind) folded on the Flop
Seat 3: ibclm showed [Js Ac] and won ($3.32) with two pair, Aces and Sevens
Seat 4: marcin116 mucked
Seat 6: casimiro124 (button) folded on the River



PokerStars Hand #222973833238:  Hold'em No Limit ($0.05/$0.10 USD) - 2021/01/23 17:01:31 ET
Table 'Stephano III' 6-max Seat #1 is the button
Seat 1: iwinflipld ($10.35 in chips) 
Seat 2: perespell ($10.03 in chips) 
Seat 3: ibclm ($6.77 in chips) 
Seat 4: marcin116 ($13.46 in chips) 
Seat 6: casimiro124 ($10 in chips) 
perespell: posts small blind $0.05
ibclm: posts big blind $0.10
dancayamanda: sits out 
*** HOLE CARDS ***
marcin116: raises $0.25 to $0.35
casimiro124: folds 
iwinflipld: folds 
perespell: folds 
ibclm: raises $0.25 to $0.60
marcin116: calls $0.25
*** FLOP *** [Jd 3c 2s]
ibclm: checks 
marcin116: checks 
*** TURN *** [Jd 3c 2s] [4c]
ibclm: checks 
marcin116: bets $0.83
ibclm: folds 
Uncalled bet ($0.83) returned to marcin116
marcin116 collected $1.19 from pot
marcin116: doesn't show hand 
*** SUMMARY ***
Total pot $1.25 | Rake $0.06 
Board [Jd 3c 2s 4c]
Seat 1: iwinflipld (button) folded before Flop (didn't bet)
Seat 2: perespell (small blind) folded before Flop
Seat 3: ibclm (big blind) folded on the Turn
Seat 4: marcin116 collected ($1.19)
Seat 6: casimiro124 folded before Flop (didn't bet)



PokerStars Hand #222973856311:  Hold'em No Limit ($0.05/$0.10 USD) - 2021/01/23 17:01:59 ET
Table 'Stephano III' 6-max Seat #2 is the button
Seat 1: iwinflipld ($10.35 in chips) 
Seat 2: perespell ($10 in chips) 
Seat 3: ibclm ($6.17 in chips) 
Seat 4: marcin116 ($14.05 in chips) 
Seat 6: casimiro124 ($10 in chips) 
ibclm: posts small blind $0.05
marcin116: posts big blind $0.10
dancayamanda: sits out 
*** HOLE CARDS ***
casimiro124: folds 
iwinflipld: folds 
perespell: raises $0.15 to $0.25
ibclm: calls $0.20
marcin116: calls $0.15
*** FLOP *** [9d Js Qd]
ibclm: checks 
marcin116: checks 
perespell: bets $0.37
ibclm: calls $0.37
marcin116: folds 
*** TURN *** [9d Js Qd] [7c]
ibclm: checks 
perespell: checks 
*** RIVER *** [9d Js Qd 7c] [Td]
ibclm: checks 
perespell: bets $0.72
ibclm: folds 
Uncalled bet ($0.72) returned to perespell
perespell collected $1.42 from pot
perespell: doesn't show hand 
*** SUMMARY ***
Total pot $1.49 | Rake $0.07 
Board [9d Js Qd 7c Td]
Seat 1: iwinflipld folded before Flop (didn't bet)
Seat 2: perespell (button) collected ($1.42)
Seat 3: ibclm (small blind) folded on the River
Seat 4: marcin116 (big blind) folded on the Flop
Seat 6: casimiro124 folded before Flop (didn't bet)



PokerStars Hand #222973898222:  Hold'em No Limit ($0.05/$0.10 USD) - 2021/01/23 17:02:51 ET
Table 'Stephano III' 6-max Seat #3 is the button
Seat 1: iwinflipld ($10.35 in chips) 
Seat 2: perespell ($10.80 in chips) 
Seat 3: ibclm ($5.55 in chips) 
Seat 4: marcin116 ($13.80 in chips) 
Seat 5: dancayamanda ($17.99 in chips) 
Seat 6: casimiro124 ($10 in chips) 
marcin116: posts small blind $0.05
dancayamanda: posts big blind $0.10
*** HOLE CARDS ***
casimiro124: folds 
iwinflipld: folds 
perespell: raises $0.15 to $0.25
ibclm: folds 
marcin116: folds 
dancayamanda: folds 
Uncalled bet ($0.15) returned to perespell
perespell collected $0.25 from pot
perespell: doesn't show hand 
*** SUMMARY ***
Total pot $0.25 | Rake $0 
Seat 1: iwinflipld folded before Flop (didn't bet)
Seat 2: perespell collected ($0.25)
Seat 3: ibclm (button) folded before Flop (didn't bet)
Seat 4: marcin116 (small blind) folded before Flop
Seat 5: dancayamanda (big blind) folded before Flop
Seat 6: casimiro124 folded before Flop (didn't bet)



PokerStars Hand #222973912517:  Hold'em No Limit ($0.05/$0.10 USD) - 2021/01/23 17:03:08 ET
Table 'Stephano III' 6-max Seat #4 is the button
Seat 1: iwinflipld ($10.35 in chips) 
Seat 2: perespell ($10.95 in chips) 
Seat 3: ibclm ($5.55 in chips) 
Seat 4: marcin116 ($13.75 in chips) 
Seat 5: dancayamanda ($17.89 in chips) 
Seat 6: casimiro124 ($10 in chips) 
dancayamanda: posts small blind $0.05
casimiro124: posts big blind $0.10
*** HOLE CARDS ***
iwinflipld: raises $0.20 to $0.30
perespell: folds 
ibclm: folds 
marcin116: folds 
dancayamanda: folds 
casimiro124: folds 
Uncalled bet ($0.20) returned to iwinflipld
iwinflipld collected $0.25 from pot
*** SUMMARY ***
Total pot $0.25 | Rake $0 
Seat 1: iwinflipld collected ($0.25)
Seat 2: perespell folded before Flop (didn't bet)
Seat 3: ibclm folded before Flop (didn't bet)
Seat 4: marcin116 (button) folded before Flop (didn't bet)
Seat 5: dancayamanda (small blind) folded before Flop
Seat 6: casimiro124 (big blind) folded before Flop



PokerStars Hand #222973929330:  Hold'em No Limit ($0.05/$0.10 USD) - 2021/01/23 17:03:28 ET
Table 'Stephano III' 6-max Seat #5 is the button
Seat 1: iwinflipld ($10.50 in chips) 
Seat 2: perespell ($10.95 in chips) 
Seat 3: ibclm ($5.55 in chips) 
Seat 4: marcin116 ($13.75 in chips) 
Seat 5: dancayamanda ($17.84 in chips) 
Seat 6: casimiro124 ($10 in chips) 
casimiro124: posts small blind $0.05
iwinflipld: posts big blind $0.10
*** HOLE CARDS ***
perespell: folds 
ibclm: calls $0.10
marcin116: folds 
dancayamanda: folds 
casimiro124: raises $0.40 to $0.50
iwinflipld: folds 
ibclm: folds 
Uncalled bet ($0.40) returned to casimiro124
casimiro124 collected $0.30 from pot
casimiro124: doesn't show hand 
*** SUMMARY ***
Total pot $0.30 | Rake $0 
Seat 1: iwinflipld (big blind) folded before Flop
Seat 2: perespell folded before Flop (didn't bet)
Seat 3: ibclm folded before Flop
Seat 4: marcin116 folded before Flop (didn't bet)
Seat 5: dancayamanda (button) folded before Flop (didn't bet)
Seat 6: casimiro124 (small blind) collected ($0.30)



PokerStars Hand #222973943528:  Hold'em No Limit ($0.05/$0.10 USD) - 2021/01/23 17:03:45 ET
Table 'Stephano III' 6-max Seat #6 is the button
Seat 1: iwinflipld ($10.40 in chips) 
Seat 2: perespell ($10.95 in chips) 
Seat 3: ibclm ($5.45 in chips) 
Seat 4: marcin116 ($13.75 in chips) 
Seat 5: dancayamanda ($17.84 in chips) 
Seat 6: casimiro124 ($10.20 in chips) 
iwinflipld: posts small blind $0.05
perespell: posts big blind $0.10
*** HOLE CARDS ***
ibclm: calls $0.10
marcin116: folds 
dancayamanda: folds 
casimiro124: raises $0.30 to $0.40
iwinflipld: folds 
perespell: folds 
ibclm: folds 
Uncalled bet ($0.30) returned to casimiro124
casimiro124 collected $0.35 from pot
casimiro124: doesn't show hand 
*** SUMMARY ***
Total pot $0.35 | Rake $0 
Seat 1: iwinflipld (small blind) folded before Flop
Seat 2: perespell (big blind) folded before Flop
Seat 3: ibclm folded before Flop
Seat 4: marcin116 folded before Flop (didn't bet)
Seat 5: dancayamanda folded before Flop (didn't bet)
Seat 6: casimiro124 (button) collected ($0.35)



PokerStars Hand #222973967801:  Hold'em No Limit ($0.05/$0.10 USD) - 2021/01/23 17:04:02 ET
Table 'Stephano III' 6-max Seat #1 is the button
Seat 1: iwinflipld ($10.35 in chips) 
Seat 2: perespell ($10.85 in chips) 
Seat 3: ibclm ($5.35 in chips) 
Seat 4: marcin116 ($13.75 in chips) 
Seat 5: dancayamanda ($17.84 in chips) 
Seat 6: casimiro124 ($10.45 in chips) 
perespell: posts small blind $0.05
ibclm: posts big blind $0.10
*** HOLE CARDS ***
marcin116: folds 
dancayamanda: folds 
casimiro124: raises $0.15 to $0.25
iwinflipld: folds 
perespell: folds 
ibclm: calls $0.15
*** FLOP *** [8s Js 9s]
ibclm: checks 
casimiro124: bets $0.28
ibclm: folds 
Uncalled bet ($0.28) returned to casimiro124
casimiro124 collected $0.53 from pot
casimiro124: doesn't show hand 
*** SUMMARY ***
Total pot $0.55 | Rake $0.02 
Board [8s Js 9s]
Seat 1: iwinflipld (button) folded before Flop (didn't bet)
Seat 2: perespell (small blind) folded before Flop
Seat 3: ibclm (big blind) folded on the Flop
Seat 4: marcin116 folded before Flop (didn't bet)
Seat 5: dancayamanda folded before Flop (didn't bet)
Seat 6: casimiro124 collected ($0.53)



PokerStars Hand #222974001771:  Hold'em No Limit ($0.05/$0.10 USD) - 2021/01/23 17:04:31 ET
Table 'Stephano III' 6-max Seat #2 is the button
Seat 1: iwinflipld ($10.35 in chips) 
Seat 2: perespell ($10.80 in chips) 
Seat 3: ibclm ($5.10 in chips) 
Seat 5: dancayamanda ($17.84 in chips) 
Seat 6: casimiro124 ($10.73 in chips) 
ibclm: posts small blind $0.05
marcin116: is sitting out 
marcin116 leaves the table
dancayamanda: posts big blind $0.10
*** HOLE CARDS ***
casimiro124: raises $0.20 to $0.30
iwinflipld: folds 
perespell: folds 
Nickh147 joins the table at seat #4 
ibclm: calls $0.25
dancayamanda: folds 
*** FLOP *** [4d 9d Ah]
ibclm: checks 
casimiro124: checks 
*** TURN *** [4d 9d Ah] [Qd]
ibclm: checks 
casimiro124: checks 
*** RIVER *** [4d 9d Ah Qd] [Ts]
ibclm: checks 
casimiro124: checks 
*** SHOW DOWN ***
ibclm: shows [5s Ks] (high card Ace)
casimiro124: shows [2d 2c] (a pair of Deuces)
casimiro124 collected $0.67 from pot
*** SUMMARY ***
Total pot $0.70 | Rake $0.03 
Board [4d 9d Ah Qd Ts]
Seat 1: iwinflipld folded before Flop (didn't bet)
Seat 2: perespell (button) folded before Flop (didn't bet)
Seat 3: ibclm (small blind) showed [5s Ks] and lost with high card Ace
Seat 5: dancayamanda (big blind) folded before Flop
Seat 6: casimiro124 showed [2d 2c] and won ($0.67) with a pair of Deuces



PokerStars Hand #222974026252:  Hold'em No Limit ($0.05/$0.10 USD) - 2021/01/23 17:05:00 ET
Table 'Stephano III' 6-max Seat #3 is the button
Seat 1: iwinflipld ($10.35 in chips) 
Seat 2: perespell ($10.80 in chips) 
Seat 3: ibclm ($4.80 in chips) 
Seat 5: dancayamanda ($17.74 in chips) 
Seat 6: casimiro124 ($11.10 in chips) 
dancayamanda: posts small blind $0.05
casimiro124: posts big blind $0.10
*** HOLE CARDS ***
iwinflipld: folds 
perespell: folds 
ibclm: calls $0.10
dancayamanda: folds 
casimiro124: checks 
*** FLOP *** [Jd 9c Td]
casimiro124: checks 
ibclm: checks 
*** TURN *** [Jd 9c Td] [4h]
casimiro124: checks 
ibclm: checks 
*** RIVER *** [Jd 9c Td 4h] [Qd]
casimiro124: bets $0.19
ibclm: calls $0.19
*** SHOW DOWN ***
casimiro124: shows [2s Ks] (a straight, Nine to King)
ibclm: mucks hand 
casimiro124 collected $0.60 from pot
*** SUMMARY ***
Total pot $0.63 | Rake $0.03 
Board [Jd 9c Td 4h Qd]
Seat 1: iwinflipld folded before Flop (didn't bet)
Seat 2: perespell folded before Flop (didn't bet)
Seat 3: ibclm (button) mucked
Seat 5: dancayamanda (small blind) folded before Flop
Seat 6: casimiro124 (big blind) showed [2s Ks] and won ($0.60) with a straight, Nine to King



PokerStars Hand #222974048821:  Hold'em No Limit ($0.05/$0.10 USD) - 2021/01/23 17:05:27 ET
Table 'Stephano III' 6-max Seat #5 is the button
Seat 1: iwinflipld ($10.35 in chips) 
Seat 2: perespell ($10.80 in chips) 
Seat 3: ibclm ($4.51 in chips) 
Seat 5: dancayamanda ($17.69 in chips) 
Seat 6: casimiro124 ($11.41 in chips) 
casimiro124: posts small blind $0.05
iwinflipld: posts big blind $0.10
Nickh147: sits out 
*** HOLE CARDS ***
perespell: raises $0.15 to $0.25
ibclm: folds 
dancayamanda: folds 
casimiro124: folds 
iwinflipld: folds 
Uncalled bet ($0.15) returned to perespell
perespell collected $0.25 from pot
perespell: doesn't show hand 
*** SUMMARY ***
Total pot $0.25 | Rake $0 
Seat 1: iwinflipld (big blind) folded before Flop
Seat 2: perespell collected ($0.25)
Seat 3: ibclm folded before Flop (didn't bet)
Seat 5: dancayamanda (button) folded before Flop (didn't bet)
Seat 6: casimiro124 (small blind) folded before Flop



PokerStars Hand #222974058328:  Hold'em No Limit ($0.05/$0.10 USD) - 2021/01/23 17:05:38 ET
Table 'Stephano III' 6-max Seat #6 is the button
Seat 1: iwinflipld ($10.25 in chips) 
Seat 2: perespell ($10.95 in chips) 
Seat 3: ibclm ($4.51 in chips) 
Seat 5: dancayamanda ($17.69 in chips) 
Seat 6: casimiro124 ($11.36 in chips) 
iwinflipld: posts small blind $0.05
perespell: posts big blind $0.10
Nickh147: sits out 
*** HOLE CARDS ***
ibclm: folds 
dancayamanda: raises $0.15 to $0.25
casimiro124: folds 
iwinflipld: folds 
perespell: folds 
Uncalled bet ($0.15) returned to dancayamanda
dancayamanda collected $0.25 from pot
dancayamanda: doesn't show hand 
*** SUMMARY ***
Total pot $0.25 | Rake $0 
Seat 1: iwinflipld (small blind) folded before Flop
Seat 2: perespell (big blind) folded before Flop
Seat 3: ibclm folded before Flop (didn't bet)
Seat 5: dancayamanda collected ($0.25)
Seat 6: casimiro124 (button) folded before Flop (didn't bet)



PokerStars Hand #222974067810:  Hold'em No Limit ($0.05/$0.10 USD) - 2021/01/23 17:05:49 ET
Table 'Stephano III' 6-max Seat #1 is the button
Seat 1: iwinflipld ($10.20 in chips) 
Seat 2: perespell ($10.85 in chips) 
Seat 3: ibclm ($4.51 in chips) 
Seat 5: dancayamanda ($17.84 in chips) 
Seat 6: casimiro124 ($11.36 in chips) 
perespell: posts small blind $0.05
ibclm: posts big blind $0.10
Nickh147: sits out 
*** HOLE CARDS ***
dancayamanda: folds 
casimiro124: folds 
iwinflipld: folds 
perespell: folds 
Uncalled bet ($0.05) returned to ibclm
ibclm collected $0.10 from pot
ibclm: doesn't show hand 
*** SUMMARY ***
Total pot $0.10 | Rake $0 
Seat 1: iwinflipld (button) folded before Flop (didn't bet)
Seat 2: perespell (small blind) folded before Flop
Seat 3: ibclm (big blind) collected ($0.10)
Seat 5: dancayamanda folded before Flop (didn't bet)
Seat 6: casimiro124 folded before Flop (didn't bet)



PokerStars Hand #222974075554:  Hold'em No Limit ($0.05/$0.10 USD) - 2021/01/23 17:05:59 ET
Table 'Stephano III' 6-max Seat #2 is the button
Seat 1: iwinflipld ($10.20 in chips) 
Seat 2: perespell ($10.80 in chips) 
Seat 3: ibclm ($4.56 in chips) 
Seat 4: Nickh147 ($10 in chips) 
Seat 5: dancayamanda ($17.84 in chips) 
Seat 6: casimiro124 ($11.36 in chips) 
ibclm: posts small blind $0.05
Nickh147: posts big blind $0.10
*** HOLE CARDS ***
dancayamanda: folds 
casimiro124: raises $0.20 to $0.30
iwinflipld: raises $0.60 to $0.90
perespell: folds 
ibclm: folds 
Nickh147: folds 
casimiro124: folds 
Uncalled bet ($0.60) returned to iwinflipld
iwinflipld collected $0.75 from pot
*** SUMMARY ***
Total pot $0.75 | Rake $0 
Seat 1: iwinflipld collected ($0.75)
Seat 2: perespell (button) folded before Flop (didn't bet)
Seat 3: ibclm (small blind) folded before Flop
Seat 4: Nickh147 (big blind) folded before Flop
Seat 5: dancayamanda folded before Flop (didn't bet)
Seat 6: casimiro124 folded before Flop



PokerStars Hand #222974095469:  Hold'em No Limit ($0.05/$0.10 USD) - 2021/01/23 17:06:23 ET
Table 'Stephano III' 6-max Seat #3 is the button
Seat 1: iwinflipld ($10.65 in chips) 
Seat 2: perespell ($10.80 in chips) 
Seat 3: ibclm ($4.51 in chips) 
Seat 4: Nickh147 ($10 in chips) 
Seat 5: dancayamanda ($17.84 in chips) 
Seat 6: casimiro124 ($11.06 in chips) 
Nickh147: posts small blind $0.05
dancayamanda: posts big blind $0.10
*** HOLE CARDS ***
casimiro124: folds 
iwinflipld: raises $0.20 to $0.30
perespell: folds 
ibclm: folds 
Nickh147: folds 
dancayamanda: folds 
Uncalled bet ($0.20) returned to iwinflipld
iwinflipld collected $0.25 from pot
*** SUMMARY ***
Total pot $0.25 | Rake $0 
Seat 1: iwinflipld collected ($0.25)
Seat 2: perespell folded before Flop (didn't bet)
Seat 3: ibclm (button) folded before Flop (didn't bet)
Seat 4: Nickh147 (small blind) folded before Flop
Seat 5: dancayamanda (big blind) folded before Flop
Seat 6: casimiro124 folded before Flop (didn't bet)



PokerStars Hand #222974110793:  Hold'em No Limit ($0.05/$0.10 USD) - 2021/01/23 17:06:41 ET
Table 'Stephano III' 6-max Seat #4 is the button
Seat 1: iwinflipld ($10.80 in chips) 
Seat 2: perespell ($10.80 in chips) 
Seat 3: ibclm ($4.51 in chips) 
Seat 4: Nickh147 ($10 in chips) 
Seat 5: dancayamanda ($17.74 in chips) 
Seat 6: casimiro124 ($11.06 in chips) 
dancayamanda: posts small blind $0.05
casimiro124: posts big blind $0.10
*** HOLE CARDS ***
iwinflipld: folds 
perespell: raises $0.15 to $0.25
iwinflipld leaves the table
ibclm: calls $0.25
Nickh147: folds 
dancayamanda: folds 
casimiro124: folds 
*** FLOP *** [4h 8h 7h]
perespell: bets $0.19
ibclm: folds 
Uncalled bet ($0.19) returned to perespell
perespell collected $0.62 from pot
perespell: doesn't show hand 
*** SUMMARY ***
Total pot $0.65 | Rake $0.03 
Board [4h 8h 7h]
Seat 1: iwinflipld folded before Flop (didn't bet)
Seat 2: perespell collected ($0.62)
Seat 3: ibclm folded on the Flop
Seat 4: Nickh147 (button) folded before Flop (didn't bet)
Seat 5: dancayamanda (small blind) folded before Flop
Seat 6: casimiro124 (big blind) folded before Flop



PokerStars Hand #222974128973:  Hold'em No Limit ($0.05/$0.10 USD) - 2021/01/23 17:07:03 ET
Table 'Stephano III' 6-max Seat #5 is the button
Seat 2: perespell ($11.17 in chips) 
Seat 3: ibclm ($4.26 in chips) 
Seat 4: Nickh147 ($10 in chips) 
Seat 5: dancayamanda ($17.69 in chips) 
Seat 6: casimiro124 ($10.96 in chips) 
casimiro124: posts small blind $0.05
perespell: posts big blind $0.10
*** HOLE CARDS ***
ibclm: folds 
Nickh147: folds 
Miele3 joins the table at seat #1 
dancayamanda: folds 
casimiro124: raises $0.20 to $0.30
perespell: folds 
Uncalled bet ($0.20) returned to casimiro124
casimiro124 collected $0.20 from pot
casimiro124: doesn't show hand 
*** SUMMARY ***
Total pot $0.20 | Rake $0 
Seat 2: perespell (big blind) folded before Flop
Seat 3: ibclm folded before Flop (didn't bet)
Seat 4: Nickh147 folded before Flop (didn't bet)
Seat 5: dancayamanda (button) folded before Flop (didn't bet)
Seat 6: casimiro124 (small blind) collected ($0.20)



PokerStars Hand #222974142644:  Hold'em No Limit ($0.05/$0.10 USD) - 2021/01/23 17:07:19 ET
Table 'Stephano III' 6-max Seat #6 is the button
Seat 2: perespell ($11.07 in chips) 
Seat 3: ibclm ($4.26 in chips) 
Seat 4: Nickh147 ($10 in chips) 
Seat 5: dancayamanda ($17.69 in chips) 
Seat 6: casimiro124 ($11.06 in chips) 
perespell: posts small blind $0.05
ibclm: posts big blind $0.10
*** HOLE CARDS ***
Nickh147: raises $0.17 to $0.27
dancayamanda: raises $0.53 to $0.80
casimiro124: folds 
perespell: folds 
ibclm: folds 
Nickh147: folds 
Uncalled bet ($0.53) returned to dancayamanda
dancayamanda collected $0.69 from pot
dancayamanda: doesn't show hand 
*** SUMMARY ***
Total pot $0.69 | Rake $0 
Seat 2: perespell (small blind) folded before Flop
Seat 3: ibclm (big blind) folded before Flop
Seat 4: Nickh147 folded before Flop
Seat 5: dancayamanda collected ($0.69)
Seat 6: casimiro124 (button) folded before Flop (didn't bet)



PokerStars Hand #222974160708:  Hold'em No Limit ($0.05/$0.10 USD) - 2021/01/23 17:07:41 ET
Table 'Stephano III' 6-max Seat #2 is the button
Seat 1: Miele3 ($10 in chips) 
Seat 2: perespell ($11.02 in chips) 
Seat 3: ibclm ($4.16 in chips) 
Seat 4: Nickh147 ($10 in chips) 
Seat 5: dancayamanda ($18.11 in chips) 
Seat 6: casimiro124 ($11.06 in chips) 
ibclm: posts small blind $0.05
Nickh147: posts big blind $0.10
Miele3: posts big blind $0.10
*** HOLE CARDS ***
dancayamanda: folds 
casimiro124: folds 
Miele3: raises $0.20 to $0.30
perespell: calls $0.30
ibclm: calls $0.25
Nickh147: folds 
*** FLOP *** [6c 6d Jc]
ibclm: checks 
Miele3: bets $0.50
perespell: calls $0.50
ibclm: calls $0.50
*** TURN *** [6c 6d Jc] [8s]
ibclm: checks 
Miele3: bets $1
perespell: calls $1
ibclm: folds 
*** RIVER *** [6c 6d Jc 8s] [4s]
Miele3: bets $2.10
perespell: calls $2.10
*** SHOW DOWN ***
Miele3: shows [Kh Ks] (two pair, Kings and Sixes)
perespell: mucks hand 
Miele3 collected $8.31 from pot
*** SUMMARY ***
Total pot $8.70 | Rake $0.39 
Board [6c 6d Jc 8s 4s]
Seat 1: Miele3 showed [Kh Ks] and won ($8.31) with two pair, Kings and Sixes
Seat 2: perespell (button) mucked
Seat 3: ibclm (small blind) folded on the Turn
Seat 4: Nickh147 (big blind) folded before Flop
Seat 5: dancayamanda folded before Flop (didn't bet)
Seat 6: casimiro124 folded before Flop (didn't bet)



PokerStars Hand #222974224914:  Hold'em No Limit ($0.05/$0.10 USD) - 2021/01/23 17:08:58 ET
Table 'Stephano III' 6-max Seat #3 is the button
Seat 1: Miele3 ($14.41 in chips) 
Seat 2: perespell ($10 in chips) 
Seat 3: ibclm ($3.36 in chips) 
Seat 4: Nickh147 ($10 in chips) 
Seat 5: dancayamanda ($18.11 in chips) 
Seat 6: casimiro124 ($11.06 in chips) 
Nickh147: posts small blind $0.05
dancayamanda: posts big blind $0.10
*** HOLE CARDS ***
casimiro124: raises $0.20 to $0.30
Miele3: calls $0.30
perespell: folds 
ibclm: folds 
Nickh147: folds 
dancayamanda: folds 
*** FLOP *** [4s 8h Kc]
casimiro124: bets $0.38
Miele3: folds 
Uncalled bet ($0.38) returned to casimiro124
casimiro124 collected $0.72 from pot
casimiro124: doesn't show hand 
*** SUMMARY ***
Total pot $0.75 | Rake $0.03 
Board [4s 8h Kc]
Seat 1: Miele3 folded on the Flop
Seat 2: perespell folded before Flop (didn't bet)
Seat 3: ibclm (button) folded before Flop (didn't bet)
Seat 4: Nickh147 (small blind) folded before Flop
Seat 5: dancayamanda (big blind) folded before Flop
Seat 6: casimiro124 collected ($0.72)



PokerStars Hand #222974245527:  Hold'em No Limit ($0.05/$0.10 USD) - 2021/01/23 17:09:23 ET
Table 'Stephano III' 6-max Seat #4 is the button
Seat 1: Miele3 ($14.11 in chips) 
Seat 2: perespell ($10 in chips) 
Seat 3: ibclm ($3.36 in chips) 
Seat 4: Nickh147 ($10 in chips) 
Seat 5: dancayamanda ($18.01 in chips) 
Seat 6: casimiro124 ($11.48 in chips) 
dancayamanda: posts small blind $0.05
casimiro124: posts big blind $0.10
*** HOLE CARDS ***
Miele3: calls $0.10
perespell: folds 
ibclm: raises $0.10 to $0.20
Nickh147: raises $0.42 to $0.62
dancayamanda: folds 
casimiro124: folds 
Miele3: folds 
ibclm: calls $0.42
*** FLOP *** [3c Ah 6d]
ibclm: checks 
Nickh147: bets $0.80
ibclm: calls $0.80
*** TURN *** [3c Ah 6d] [2s]
ibclm: checks 
Nickh147: bets $1.40
ibclm: calls $1.40
*** RIVER *** [3c Ah 6d 2s] [9s]
ibclm: checks 
Nickh147: bets $1.35
ibclm: calls $0.54 and is all-in
Uncalled bet ($0.81) returned to Nickh147
*** SHOW DOWN ***
Nickh147: shows [Ac Qs] (a pair of Aces)
ibclm: shows [Ad Jh] (a pair of Aces - lower kicker)
Nickh147 collected $6.66 from pot
*** SUMMARY ***
Total pot $6.97 | Rake $0.31 
Board [3c Ah 6d 2s 9s]
Seat 1: Miele3 folded before Flop
Seat 2: perespell folded before Flop (didn't bet)
Seat 3: ibclm showed [Ad Jh] and lost with a pair of Aces
Seat 4: Nickh147 (button) showed [Ac Qs] and won ($6.66) with a pair of Aces
Seat 5: dancayamanda (small blind) folded before Flop
Seat 6: casimiro124 (big blind) folded before Flop



PokerStars Hand #222974298543:  Hold'em No Limit ($0.05/$0.10 USD) - 2021/01/23 17:10:27 ET
Table 'Stephano III' 6-max Seat #5 is the button
Seat 1: Miele3 ($14.01 in chips) 
Seat 2: perespell ($10 in chips) 
Seat 4: Nickh147 ($13.30 in chips) 
Seat 5: dancayamanda ($17.96 in chips) 
Seat 6: casimiro124 ($11.38 in chips) 
casimiro124: posts small blind $0.05
Miele3: posts big blind $0.10
*** HOLE CARDS ***
perespell: folds 
Nickh147: raises $0.14 to $0.24
ibclm leaves the table
dancayamanda: folds 
casimiro124: folds 
Miele3: calls $0.14
*** FLOP *** [As 3h 4c]
Miele3: checks 
jammer35983 joins the table at seat #3 
Nickh147: checks 
*** TURN *** [As 3h 4c] [2c]
Miele3: bets $0.30
Nickh147: folds 
Uncalled bet ($0.30) returned to Miele3
Miele3 collected $0.51 from pot
Miele3: doesn't show hand 
*** SUMMARY ***
Total pot $0.53 | Rake $0.02 
Board [As 3h 4c 2c]
Seat 1: Miele3 (big blind) collected ($0.51)
Seat 2: perespell folded before Flop (didn't bet)
Seat 4: Nickh147 folded on the Turn
Seat 5: dancayamanda (button) folded before Flop (didn't bet)
Seat 6: casimiro124 (small blind) folded before Flop



PokerStars Hand #222974330963:  Hold'em No Limit ($0.05/$0.10 USD) - 2021/01/23 17:11:06 ET
Table 'Stephano III' 6-max Seat #6 is the button
Seat 1: Miele3 ($14.28 in chips) 
Seat 2: perespell ($10 in chips) 
Seat 4: Nickh147 ($13.06 in chips) 
Seat 5: dancayamanda ($17.96 in chips) 
Seat 6: casimiro124 ($11.33 in chips) 
Miele3: posts small blind $0.05
perespell: posts big blind $0.10
jammer35983: sits out 
*** HOLE CARDS ***
Nickh147: raises $0.17 to $0.27
dancayamanda: folds 
casimiro124: folds 
Miele3: folds 
perespell: calls $0.17
*** FLOP *** [2d 3s Qs]
perespell: checks 
Nickh147: bets $0.30
perespell: folds 
Uncalled bet ($0.30) returned to Nickh147
Nickh147 collected $0.56 from pot
*** SUMMARY ***
Total pot $0.59 | Rake $0.03 
Board [2d 3s Qs]
Seat 1: Miele3 (small blind) folded before Flop
Seat 2: perespell (big blind) folded on the Flop
Seat 4: Nickh147 collected ($0.56)
Seat 5: dancayamanda folded before Flop (didn't bet)
Seat 6: casimiro124 (button) folded before Flop (didn't bet)



PokerStars Hand #222974347968:  Hold'em No Limit ($0.05/$0.10 USD) - 2021/01/23 17:11:26 ET
Table 'Stephano III' 6-max Seat #1 is the button
Seat 1: Miele3 ($14.23 in chips) 
Seat 2: perespell ($10 in chips) 
Seat 3: jammer35983 ($10 in chips) 
Seat 4: Nickh147 ($13.35 in chips) 
Seat 5: dancayamanda ($17.96 in chips) 
Seat 6: casimiro124 ($11.33 in chips) 
perespell: posts small blind $0.05
jammer35983: posts big blind $0.10
*** HOLE CARDS ***
Nickh147: folds 
dancayamanda: folds 
casimiro124: folds 
Miele3: raises $0.10 to $0.20
perespell: folds 
jammer35983: calls $0.10
*** FLOP *** [Kh 8h Ah]
jammer35983: checks 
Miele3: checks 
*** TURN *** [Kh 8h Ah] [2d]
jammer35983: bets $0.43
Miele3: calls $0.43
*** RIVER *** [Kh 8h Ah 2d] [3d]
jammer35983: bets $1.25
Miele3: calls $1.25
*** SHOW DOWN ***
jammer35983: shows [2h Kc] (two pair, Kings and Deuces)
Miele3: mucks hand 
jammer35983 collected $3.64 from pot
*** SUMMARY ***
Total pot $3.81 | Rake $0.17 
Board [Kh 8h Ah 2d 3d]
Seat 1: Miele3 (button) mucked
Seat 2: perespell (small blind) folded before Flop
Seat 3: jammer35983 (big blind) showed [2h Kc] and won ($3.64) with two pair, Kings and Deuces
Seat 4: Nickh147 folded before Flop (didn't bet)
Seat 5: dancayamanda folded before Flop (didn't bet)
Seat 6: casimiro124 folded before Flop (didn't bet)



PokerStars Hand #222974393073:  Hold'em No Limit ($0.05/$0.10 USD) - 2021/01/23 17:12:21 ET
Table 'Stephano III' 6-max Seat #2 is the button
Seat 1: Miele3 ($12.35 in chips) 
Seat 2: perespell ($10 in chips) 
Seat 3: jammer35983 ($11.76 in chips) 
Seat 4: Nickh147 ($13.35 in chips) 
Seat 5: dancayamanda ($17.96 in chips) 
Seat 6: casimiro124 ($11.33 in chips) 
jammer35983: posts small blind $0.05
Nickh147: posts big blind $0.10
*** HOLE CARDS ***
dancayamanda: folds 
casimiro124: folds 
Miele3: folds 
perespell: folds 
jammer35983: calls $0.05
Nickh147: checks 
*** FLOP *** [2s 6c 3c]
jammer35983: bets $0.19
Nickh147: calls $0.19
*** TURN *** [2s 6c 3c] [Th]
jammer35983: checks 
Nickh147: checks 
*** RIVER *** [2s 6c 3c Th] [Ah]
jammer35983: checks 
Nickh147: checks 
*** SHOW DOWN ***
jammer35983: shows [2d Qh] (a pair of Deuces)
Nickh147: shows [Qd 3h] (a pair of Threes)
Nickh147 collected $0.55 from pot
*** SUMMARY ***
Total pot $0.58 | Rake $0.03 
Board [2s 6c 3c Th Ah]
Seat 1: Miele3 folded before Flop (didn't bet)
Seat 2: perespell (button) folded before Flop (didn't bet)
Seat 3: jammer35983 (small blind) showed [2d Qh] and lost with a pair of Deuces
Seat 4: Nickh147 (big blind) showed [Qd 3h] and won ($0.55) with a pair of Threes
Seat 5: dancayamanda folded before Flop (didn't bet)
Seat 6: casimiro124 folded before Flop (didn't bet)



PokerStars Hand #222974422384:  Hold'em No Limit ($0.05/$0.10 USD) - 2021/01/23 17:12:56 ET
Table 'Stephano III' 6-max Seat #3 is the button
Seat 1: Miele3 ($12.35 in chips) 
Seat 2: perespell ($10 in chips) 
Seat 3: jammer35983 ($11.47 in chips) 
Seat 4: Nickh147 ($13.61 in chips) 
Seat 5: dancayamanda ($17.96 in chips) 
Seat 6: casimiro124 ($11.33 in chips) 
Nickh147: posts small blind $0.05
dancayamanda: posts big blind $0.10
*** HOLE CARDS ***
casimiro124: folds 
Miele3: folds 
perespell has timed out
perespell: folds 
jammer35983: calls $0.10
Nickh147: calls $0.05
dancayamanda: checks 
*** FLOP *** [Js Ah Ks]
Nickh147: checks 
dancayamanda: checks 
jammer35983: checks 
*** TURN *** [Js Ah Ks] [5s]
Miele3 leaves the table
Nickh147: bets $0.20
OSTAINES98 joins the table at seat #1 
dancayamanda: folds 
jammer35983: calls $0.20
*** RIVER *** [Js Ah Ks 5s] [3h]
Nickh147: bets $0.42
jammer35983: calls $0.42
*** SHOW DOWN ***
Nickh147: shows [7s 8s] (a flush, King high)
jammer35983: mucks hand 
Nickh147 collected $1.47 from pot
*** SUMMARY ***
Total pot $1.54 | Rake $0.07 
Board [Js Ah Ks 5s 3h]
Seat 1: Miele3 folded before Flop (didn't bet)
Seat 2: perespell folded before Flop (didn't bet)
Seat 3: jammer35983 (button) mucked
Seat 4: Nickh147 (small blind) showed [7s 8s] and won ($1.47) with a flush, King high
Seat 5: dancayamanda (big blind) folded on the Turn
Seat 6: casimiro124 folded before Flop (didn't bet)



PokerStars Hand #222974470965:  Hold'em No Limit ($0.05/$0.10 USD) - 2021/01/23 17:13:56 ET
Table 'Stephano III' 6-max Seat #4 is the button
Seat 2: perespell ($10 in chips) 
Seat 3: jammer35983 ($10.75 in chips) 
Seat 4: Nickh147 ($14.36 in chips) 
Seat 5: dancayamanda ($17.86 in chips) 
Seat 6: casimiro124 ($11.33 in chips) 
dancayamanda: posts small blind $0.05
casimiro124: posts big blind $0.10
OSTAINES98: sits out 
*** HOLE CARDS ***
perespell: raises $0.15 to $0.25
jammer35983: calls $0.25
Nickh147: folds 
dancayamanda: folds 
casimiro124: calls $0.15
*** FLOP *** [Ad 7h Qs]
casimiro124: checks 
perespell: checks 
jammer35983: checks 
*** TURN *** [Ad 7h Qs] [Th]
casimiro124: checks 
perespell: bets $0.58
jammer35983: folds 
casimiro124: folds 
Uncalled bet ($0.58) returned to perespell
perespell collected $0.76 from pot
perespell: doesn't show hand 
*** SUMMARY ***
Total pot $0.80 | Rake $0.04 
Board [Ad 7h Qs Th]
Seat 2: perespell collected ($0.76)
Seat 3: jammer35983 folded on the Turn
Seat 4: Nickh147 (button) folded before Flop (didn't bet)
Seat 5: dancayamanda (small blind) folded before Flop
Seat 6: casimiro124 (big blind) folded on the Turn



PokerStars Hand #222974514847:  Hold'em No Limit ($0.05/$0.10 USD) - 2021/01/23 17:14:49 ET
Table 'Stephano III' 6-max Seat #5 is the button
Seat 1: OSTAINES98 ($8 in chips) 
Seat 2: perespell ($10.51 in chips) 
Seat 3: jammer35983 ($10.50 in chips) 
Seat 4: Nickh147 ($14.36 in chips) 
Seat 5: dancayamanda ($17.81 in chips) 
Seat 6: casimiro124 ($11.08 in chips) 
casimiro124: posts small blind $0.05
OSTAINES98: posts big blind $0.10
*** HOLE CARDS ***
perespell: folds 
jammer35983: raises $0.10 to $0.20
Nickh147: folds 
dancayamanda: folds 
casimiro124: calls $0.15
OSTAINES98: calls $0.10
*** FLOP *** [8h 7c Qs]
casimiro124: checks 
OSTAINES98: bets $0.10
jammer35983: calls $0.10
casimiro124: calls $0.10
*** TURN *** [8h 7c Qs] [2h]
casimiro124: checks 
OSTAINES98: bets $0.30
jammer35983: folds 
casimiro124: calls $0.30
*** RIVER *** [8h 7c Qs 2h] [8c]
casimiro124: checks 
OSTAINES98: bets $0.50
casimiro124: folds 
Uncalled bet ($0.50) returned to OSTAINES98
OSTAINES98 collected $1.43 from pot
OSTAINES98: doesn't show hand 
*** SUMMARY ***
Total pot $1.50 | Rake $0.07 
Board [8h 7c Qs 2h 8c]
Seat 1: OSTAINES98 (big blind) collected ($1.43)
Seat 2: perespell folded before Flop (didn't bet)
Seat 3: jammer35983 folded on the Turn
Seat 4: Nickh147 folded before Flop (didn't bet)
Seat 5: dancayamanda (button) folded before Flop (didn't bet)
Seat 6: casimiro124 (small blind) folded on the River



PokerStars Hand #222974568098:  Hold'em No Limit ($0.05/$0.10 USD) - 2021/01/23 17:15:54 ET
Table 'Stephano III' 6-max Seat #6 is the button
Seat 1: OSTAINES98 ($8.83 in chips) 
Seat 2: perespell ($10.51 in chips) 
Seat 3: jammer35983 ($10.20 in chips) 
Seat 4: Nickh147 ($14.36 in chips) 
Seat 5: dancayamanda ($17.81 in chips) 
Seat 6: casimiro124 ($10.48 in chips) 
OSTAINES98: posts small blind $0.05
perespell: posts big blind $0.10
*** HOLE CARDS ***
jammer35983: calls $0.10
Nickh147: folds 
dancayamanda: folds 
casimiro124: folds 
OSTAINES98: calls $0.05
perespell: checks 
*** FLOP *** [Kc Kd Ah]
OSTAINES98: checks 
perespell: checks 
jammer35983: checks 
*** TURN *** [Kc Kd Ah] [Ac]
OSTAINES98: bets $0.60
perespell: folds 
jammer35983: folds 
Uncalled bet ($0.60) returned to OSTAINES98
OSTAINES98 collected $0.29 from pot
OSTAINES98: doesn't show hand 
*** SUMMARY ***
Total pot $0.30 | Rake $0.01 
Board [Kc Kd Ah Ac]
Seat 1: OSTAINES98 (small blind) collected ($0.29)
Seat 2: perespell (big blind) folded on the Turn
Seat 3: jammer35983 folded on the Turn
Seat 4: Nickh147 folded before Flop (didn't bet)
Seat 5: dancayamanda folded before Flop (didn't bet)
Seat 6: casimiro124 (button) folded before Flop (didn't bet)



PokerStars Hand #222974609741:  Hold'em No Limit ($0.05/$0.10 USD) - 2021/01/23 17:16:44 ET
Table 'Stephano III' 6-max Seat #1 is the button
Seat 1: OSTAINES98 ($9.02 in chips) 
Seat 2: perespell ($10.41 in chips) 
Seat 3: jammer35983 ($10.10 in chips) 
Seat 4: Nickh147 ($14.36 in chips) 
Seat 5: dancayamanda ($17.81 in chips) 
Seat 6: casimiro124 ($10.48 in chips) 
perespell: posts small blind $0.05
jammer35983: posts big blind $0.10
*** HOLE CARDS ***
Nickh147: folds 
dancayamanda: folds 
casimiro124: folds 
OSTAINES98: calls $0.10
perespell: folds 
jammer35983: checks 
*** FLOP *** [7d 8d Ks]
jammer35983: checks 
OSTAINES98: bets $0.10
jammer35983: folds 
Uncalled bet ($0.10) returned to OSTAINES98
OSTAINES98 collected $0.24 from pot
OSTAINES98: doesn't show hand 
*** SUMMARY ***
Total pot $0.25 | Rake $0.01 
Board [7d 8d Ks]
Seat 1: OSTAINES98 (button) collected ($0.24)
Seat 2: perespell (small blind) folded before Flop
Seat 3: jammer35983 (big blind) folded on the Flop
Seat 4: Nickh147 folded before Flop (didn't bet)
Seat 5: dancayamanda folded before Flop (didn't bet)
Seat 6: casimiro124 folded before Flop (didn't bet)



PokerStars Hand #222974632158:  Hold'em No Limit ($0.05/$0.10 USD) - 2021/01/23 17:17:11 ET
Table 'Stephano III' 6-max Seat #2 is the button
Seat 1: OSTAINES98 ($9.16 in chips) 
Seat 2: perespell ($10.36 in chips) 
Seat 3: jammer35983 ($10 in chips) 
Seat 4: Nickh147 ($14.36 in chips) 
Seat 5: dancayamanda ($17.81 in chips) 
Seat 6: casimiro124 ($10.48 in chips) 
jammer35983: posts small blind $0.05
Nickh147: posts big blind $0.10
*** HOLE CARDS ***
dancayamanda: folds 
casimiro124: folds 
OSTAINES98: calls $0.10
perespell: calls $0.10
jammer35983: calls $0.05
Nickh147: checks 
*** FLOP *** [2d Kc 8d]
jammer35983: checks 
Nickh147: checks 
OSTAINES98: checks 
perespell: checks 
*** TURN *** [2d Kc 8d] [Th]
jammer35983: bets $0.19
Nickh147: folds 
OSTAINES98: folds 
perespell: folds 
Uncalled bet ($0.19) returned to jammer35983
jammer35983 collected $0.38 from pot
jammer35983: doesn't show hand 
*** SUMMARY ***
Total pot $0.40 | Rake $0.02 
Board [2d Kc 8d Th]
Seat 1: OSTAINES98 folded on the Turn
Seat 2: perespell (button) folded on the Turn
Seat 3: jammer35983 (small blind) collected ($0.38)
Seat 4: Nickh147 (big blind) folded on the Turn
Seat 5: dancayamanda folded before Flop (didn't bet)
Seat 6: casimiro124 folded before Flop (didn't bet)



PokerStars Hand #222974662215:  Hold'em No Limit ($0.05/$0.10 USD) - 2021/01/23 17:17:48 ET
Table 'Stephano III' 6-max Seat #3 is the button
Seat 1: OSTAINES98 ($9.06 in chips) 
Seat 2: perespell ($10.26 in chips) 
Seat 3: jammer35983 ($10.28 in chips) 
Seat 4: Nickh147 ($14.26 in chips) 
Seat 5: dancayamanda ($17.81 in chips) 
Seat 6: casimiro124 ($10.48 in chips) 
Nickh147: posts small blind $0.05
dancayamanda: posts big blind $0.10
*** HOLE CARDS ***
casimiro124: folds 
OSTAINES98: calls $0.10
perespell: folds 
jammer35983: calls $0.10
Nickh147: calls $0.05
dancayamanda: checks 
*** FLOP *** [4d 8s Qs]
Nickh147: checks 
dancayamanda: checks 
OSTAINES98: checks 
jammer35983: checks 
*** TURN *** [4d 8s Qs] [6s]
Nickh147: checks 
dancayamanda: checks 
OSTAINES98: checks 
jammer35983: bets $0.38
Nickh147: calls $0.38
dancayamanda: folds 
OSTAINES98: calls $0.38
*** RIVER *** [4d 8s Qs 6s] [8d]
Nickh147: checks 
OSTAINES98: checks 
jammer35983: bets $1.47
Nickh147: folds 
OSTAINES98: folds 
Uncalled bet ($1.47) returned to jammer35983
jammer35983 collected $1.47 from pot
jammer35983: doesn't show hand 
*** SUMMARY ***
Total pot $1.54 | Rake $0.07 
Board [4d 8s Qs 6s 8d]
Seat 1: OSTAINES98 folded on the River
Seat 2: perespell folded before Flop (didn't bet)
Seat 3: jammer35983 (button) collected ($1.47)
Seat 4: Nickh147 (small blind) folded on the River
Seat 5: dancayamanda (big blind) folded on the Turn
Seat 6: casimiro124 folded before Flop (didn't bet)



PokerStars Hand #222974724371:  Hold'em No Limit ($0.05/$0.10 USD) - 2021/01/23 17:19:03 ET
Table 'Stephano III' 6-max Seat #4 is the button
Seat 1: OSTAINES98 ($8.58 in chips) 
Seat 2: perespell ($10.26 in chips) 
Seat 3: jammer35983 ($11.27 in chips) 
Seat 4: Nickh147 ($13.78 in chips) 
Seat 5: dancayamanda ($17.71 in chips) 
Seat 6: casimiro124 ($10.48 in chips) 
dancayamanda: posts small blind $0.05
casimiro124: posts big blind $0.10
*** HOLE CARDS ***
OSTAINES98: folds 
perespell: folds 
jammer35983: folds 
Nickh147: folds 
dancayamanda: folds 
Uncalled bet ($0.05) returned to casimiro124
casimiro124 collected $0.10 from pot
casimiro124: doesn't show hand 
*** SUMMARY ***
Total pot $0.10 | Rake $0 
Seat 1: OSTAINES98 folded before Flop (didn't bet)
Seat 2: perespell folded before Flop (didn't bet)
Seat 3: jammer35983 folded before Flop (didn't bet)
Seat 4: Nickh147 (button) folded before Flop (didn't bet)
Seat 5: dancayamanda (small blind) folded before Flop
Seat 6: casimiro124 (big blind) collected ($0.10)



PokerStars Hand #222974733993:  Hold'em No Limit ($0.05/$0.10 USD) - 2021/01/23 17:19:15 ET
Table 'Stephano III' 6-max Seat #5 is the button
Seat 1: OSTAINES98 ($8.58 in chips) 
Seat 2: perespell ($10.26 in chips) 
Seat 3: jammer35983 ($11.27 in chips) 
Seat 4: Nickh147 ($13.78 in chips) 
Seat 5: dancayamanda ($17.66 in chips) 
Seat 6: casimiro124 ($10.53 in chips) 
casimiro124: posts small blind $0.05
OSTAINES98: posts big blind $0.10
*** HOLE CARDS ***
perespell: raises $0.15 to $0.25
jammer35983: calls $0.25
Nickh147: folds 
dancayamanda: folds 
casimiro124: folds 
OSTAINES98: calls $0.15
*** FLOP *** [6s Kh Qs]
OSTAINES98: checks 
perespell: checks 
jammer35983: bets $0.38
OSTAINES98: folds 
perespell: folds 
Uncalled bet ($0.38) returned to jammer35983
jammer35983 collected $0.76 from pot
jammer35983: doesn't show hand 
*** SUMMARY ***
Total pot $0.80 | Rake $0.04 
Board [6s Kh Qs]
Seat 1: OSTAINES98 (big blind) folded on the Flop
Seat 2: perespell folded on the Flop
Seat 3: jammer35983 collected ($0.76)
Seat 4: Nickh147 folded before Flop (didn't bet)
Seat 5: dancayamanda (button) folded before Flop (didn't bet)
Seat 6: casimiro124 (small blind) folded before Flop



PokerStars Hand #222974766342:  Hold'em No Limit ($0.05/$0.10 USD) - 2021/01/23 17:19:55 ET
Table 'Stephano III' 6-max Seat #6 is the button
Seat 1: OSTAINES98 ($8.33 in chips) 
Seat 2: perespell ($10.01 in chips) 
Seat 3: jammer35983 ($11.78 in chips) 
Seat 4: Nickh147 ($13.78 in chips) 
Seat 5: dancayamanda ($17.66 in chips) 
Seat 6: casimiro124 ($10.48 in chips) 
OSTAINES98: posts small blind $0.05
perespell: posts big blind $0.10
*** HOLE CARDS ***
jammer35983: folds 
Nickh147: raises $0.17 to $0.27
dancayamanda: folds 
casimiro124: folds 
OSTAINES98: calls $0.22
perespell: folds 
*** FLOP *** [Qh 4d 8h]
OSTAINES98: checks 
Nickh147: bets $0.33
OSTAINES98: raises $0.33 to $0.66
Nickh147: calls $0.33
*** TURN *** [Qh 4d 8h] [8c]
OSTAINES98: bets $0.10
Nickh147: calls $0.10
*** RIVER *** [Qh 4d 8h 8c] [2s]
OSTAINES98: bets $1
Nickh147: calls $1
*** SHOW DOWN ***
OSTAINES98: shows [Jh Ah] (a pair of Eights)
Nickh147: shows [Kd Ad] (a pair of Eights - Ace+King kicker)
Nickh147 collected $3.97 from pot
*** SUMMARY ***
Total pot $4.16 | Rake $0.19 
Board [Qh 4d 8h 8c 2s]
Seat 1: OSTAINES98 (small blind) showed [Jh Ah] and lost with a pair of Eights
Seat 2: perespell (big blind) folded before Flop
Seat 3: jammer35983 folded before Flop (didn't bet)
Seat 4: Nickh147 showed [Kd Ad] and won ($3.97) with a pair of Eights
Seat 5: dancayamanda folded before Flop (didn't bet)
Seat 6: casimiro124 (button) folded before Flop (didn't bet)



PokerStars Hand #222974824791:  Hold'em No Limit ($0.05/$0.10 USD) - 2021/01/23 17:21:07 ET
Table 'Stephano III' 6-max Seat #1 is the button
Seat 1: OSTAINES98 ($6.30 in chips) 
Seat 2: perespell ($10 in chips) 
Seat 3: jammer35983 ($11.78 in chips) 
Seat 4: Nickh147 ($15.72 in chips) 
Seat 5: dancayamanda ($17.66 in chips) 
Seat 6: casimiro124 ($10.48 in chips) 
perespell: posts small blind $0.05
jammer35983: posts big blind $0.10
*** HOLE CARDS ***
Nickh147: folds 
dancayamanda: raises $0.15 to $0.25
casimiro124: folds 
OSTAINES98: calls $0.25
perespell: folds 
jammer35983: calls $0.15
*** FLOP *** [2d 5h Qh]
jammer35983: checks 
dancayamanda: checks 
OSTAINES98: checks 
*** TURN *** [2d 5h Qh] [8s]
jammer35983: checks 
dancayamanda: checks 
OSTAINES98: checks 
*** RIVER *** [2d 5h Qh 8s] [Kc]
jammer35983: bets $0.76
dancayamanda: raises $0.76 to $1.52
OSTAINES98: folds 
jammer35983: calls $0.76
*** SHOW DOWN ***
dancayamanda: shows [Kd As] (a pair of Kings)
jammer35983: mucks hand 
dancayamanda collected $3.67 from pot
*** SUMMARY ***
Total pot $3.84 | Rake $0.17 
Board [2d 5h Qh 8s Kc]
Seat 1: OSTAINES98 (button) folded on the River
Seat 2: perespell (small blind) folded before Flop
Seat 3: jammer35983 (big blind) mucked
Seat 4: Nickh147 folded before Flop (didn't bet)
Seat 5: dancayamanda showed [Kd As] and won ($3.67) with a pair of Kings
Seat 6: casimiro124 folded before Flop (didn't bet)



PokerStars Hand #222974879805:  Hold'em No Limit ($0.05/$0.10 USD) - 2021/01/23 17:22:14 ET
Table 'Stephano III' 6-max Seat #2 is the button
Seat 1: OSTAINES98 ($6.05 in chips) 
Seat 2: perespell ($10 in chips) 
Seat 3: jammer35983 ($10.01 in chips) 
Seat 4: Nickh147 ($15.72 in chips) 
Seat 5: dancayamanda ($19.56 in chips) 
Seat 6: casimiro124 ($10.48 in chips) 
jammer35983: posts small blind $0.05
Nickh147: posts big blind $0.10
*** HOLE CARDS ***
dancayamanda: folds 
casimiro124: folds 
OSTAINES98: calls $0.10
perespell: folds 
jammer35983: folds 
Nickh147: checks 
*** FLOP *** [2h Jd 2d]
Nickh147: checks 
OSTAINES98: checks 
*** TURN *** [2h Jd 2d] [6h]
Nickh147: checks 
OSTAINES98: checks 
*** RIVER *** [2h Jd 2d 6h] [5s]
Nickh147: bets $0.10
OSTAINES98: raises $0.80 to $0.90
Nickh147: folds 
Uncalled bet ($0.80) returned to OSTAINES98
OSTAINES98 collected $0.43 from pot
OSTAINES98: doesn't show hand 
*** SUMMARY ***
Total pot $0.45 | Rake $0.02 
Board [2h Jd 2d 6h 5s]
Seat 1: OSTAINES98 collected ($0.43)
Seat 2: perespell (button) folded before Flop (didn't bet)
Seat 3: jammer35983 (small blind) folded before Flop
Seat 4: Nickh147 (big blind) folded on the River
Seat 5: dancayamanda folded before Flop (didn't bet)
Seat 6: casimiro124 folded before Flop (didn't bet)



PokerStars Hand #222974910271:  Hold'em No Limit ($0.05/$0.10 USD) - 2021/01/23 17:22:52 ET
Table 'Stephano III' 6-max Seat #3 is the button
Seat 1: OSTAINES98 ($6.28 in chips) 
Seat 2: perespell ($10 in chips) 
Seat 3: jammer35983 ($9.96 in chips) 
Seat 4: Nickh147 ($15.52 in chips) 
Seat 5: dancayamanda ($19.56 in chips) 
Seat 6: casimiro124 ($10.48 in chips) 
Nickh147: posts small blind $0.05
dancayamanda: posts big blind $0.10
*** HOLE CARDS ***
casimiro124: folds 
OSTAINES98: calls $0.10
perespell: raises $0.15 to $0.25
jammer35983: calls $0.25
Nickh147: calls $0.20
dancayamanda: calls $0.15
OSTAINES98: folds 
*** FLOP *** [2c Js Kh]
Nickh147: checks 
dancayamanda: checks 
perespell: checks 
jammer35983: checks 
*** TURN *** [2c Js Kh] [2h]
Nickh147: checks 
dancayamanda: checks 
perespell: checks 
jammer35983: checks 
*** RIVER *** [2c Js Kh 2h] [7h]
Nickh147: checks 
dancayamanda: bets $0.53
perespell: folds 
jammer35983: folds 
Nickh147: folds 
Uncalled bet ($0.53) returned to dancayamanda
dancayamanda collected $1.05 from pot
dancayamanda: doesn't show hand 
*** SUMMARY ***
Total pot $1.10 | Rake $0.05 
Board [2c Js Kh 2h 7h]
Seat 1: OSTAINES98 folded before Flop
Seat 2: perespell folded on the River
Seat 3: jammer35983 (button) folded on the River
Seat 4: Nickh147 (small blind) folded on the River
Seat 5: dancayamanda (big blind) collected ($1.05)
Seat 6: casimiro124 folded before Flop (didn't bet)



PokerStars Hand #222974967300:  Hold'em No Limit ($0.05/$0.10 USD) - 2021/01/23 17:24:02 ET
Table 'Stephano III' 6-max Seat #4 is the button
Seat 1: OSTAINES98 ($6.18 in chips) 
Seat 2: perespell ($10 in chips) 
Seat 3: jammer35983 ($9.71 in chips) 
Seat 4: Nickh147 ($15.27 in chips) 
Seat 5: dancayamanda ($20.36 in chips) 
Seat 6: casimiro124 ($10.48 in chips) 
dancayamanda: posts small blind $0.05
casimiro124: posts big blind $0.10
*** HOLE CARDS ***
OSTAINES98: calls $0.10
perespell: folds 
jammer35983: raises $0.20 to $0.30
Nickh147: raises $0.69 to $0.99
dancayamanda: folds 
casimiro124: folds 
OSTAINES98: folds 
jammer35983: calls $0.69
*** FLOP *** [8d Qh Kh]
jammer35983: checks 
Nickh147: bets $1.10
jammer35983: folds 
Uncalled bet ($1.10) returned to Nickh147
Nickh147 collected $2.13 from pot
Nickh147: doesn't show hand 
*** SUMMARY ***
Total pot $2.23 | Rake $0.10 
Board [8d Qh Kh]
Seat 1: OSTAINES98 folded before Flop
Seat 2: perespell folded before Flop (didn't bet)
Seat 3: jammer35983 folded on the Flop
Seat 4: Nickh147 (button) collected ($2.13)
Seat 5: dancayamanda (small blind) folded before Flop
Seat 6: casimiro124 (big blind) folded before Flop



PokerStars Hand #222974996821:  Hold'em No Limit ($0.05/$0.10 USD) - 2021/01/23 17:24:39 ET
Table 'Stephano III' 6-max Seat #5 is the button
Seat 1: OSTAINES98 ($6.08 in chips) 
Seat 2: perespell ($10 in chips) 
Seat 3: jammer35983 ($8.72 in chips) 
Seat 4: Nickh147 ($16.41 in chips) 
Seat 5: dancayamanda ($20.31 in chips) 
Seat 6: casimiro124 ($10.38 in chips) 
casimiro124: posts small blind $0.05
OSTAINES98: posts big blind $0.10
*** HOLE CARDS ***
perespell: raises $0.15 to $0.25
jammer35983: folds 
Nickh147: calls $0.25
dancayamanda: folds 
casimiro124: folds 
OSTAINES98: calls $0.15
*** FLOP *** [7d 4c Ad]
OSTAINES98: bets $0.10
perespell: raises $0.49 to $0.59
Nickh147: folds 
OSTAINES98: calls $0.49
*** TURN *** [7d 4c Ad] [2c]
OSTAINES98: bets $0.10
perespell: raises $0.70 to $0.80
OSTAINES98: calls $0.70
*** RIVER *** [7d 4c Ad 2c] [7s]
OSTAINES98: checks 
perespell: checks 
*** SHOW DOWN ***
OSTAINES98: shows [Ah 5s] (two pair, Aces and Sevens)
perespell: shows [As Th] (two pair, Aces and Sevens - Ten kicker)
perespell collected $3.42 from pot
*** SUMMARY ***
Total pot $3.58 | Rake $0.16 
Board [7d 4c Ad 2c 7s]
Seat 1: OSTAINES98 (big blind) showed [Ah 5s] and lost with two pair, Aces and Sevens
Seat 2: perespell showed [As Th] and won ($3.42) with two pair, Aces and Sevens
Seat 3: jammer35983 folded before Flop (didn't bet)
Seat 4: Nickh147 folded on the Flop
Seat 5: dancayamanda (button) folded before Flop (didn't bet)
Seat 6: casimiro124 (small blind) folded before Flop



PokerStars Hand #222975039996:  Hold'em No Limit ($0.05/$0.10 USD) - 2021/01/23 17:25:32 ET
Table 'Stephano III' 6-max Seat #6 is the button
Seat 1: OSTAINES98 ($4.44 in chips) 
Seat 2: perespell ($11.78 in chips) 
Seat 3: jammer35983 ($8.72 in chips) 
Seat 4: Nickh147 ($16.16 in chips) 
Seat 5: dancayamanda ($20.31 in chips) 
Seat 6: casimiro124 ($10.33 in chips) 
OSTAINES98: posts small blind $0.05
perespell: posts big blind $0.10
*** HOLE CARDS ***
jammer35983: raises $0.10 to $0.20
Nickh147: folds 
dancayamanda: folds 
casimiro124: calls $0.20
OSTAINES98: calls $0.15
perespell: folds 
*** FLOP *** [Ts 5d 9c]
OSTAINES98: checks 
jammer35983: checks 
casimiro124: checks 
*** TURN *** [Ts 5d 9c] [Js]
OSTAINES98: checks 
jammer35983: checks 
casimiro124: checks 
*** RIVER *** [Ts 5d 9c Js] [8h]
OSTAINES98: bets $0.40
jammer35983: folds 
casimiro124: folds 
Uncalled bet ($0.40) returned to OSTAINES98
OSTAINES98 collected $0.67 from pot
OSTAINES98: doesn't show hand 
*** SUMMARY ***
Total pot $0.70 | Rake $0.03 
Board [Ts 5d 9c Js 8h]
Seat 1: OSTAINES98 (small blind) collected ($0.67)
Seat 2: perespell (big blind) folded before Flop
Seat 3: jammer35983 folded on the River
Seat 4: Nickh147 folded before Flop (didn't bet)
Seat 5: dancayamanda folded before Flop (didn't bet)
Seat 6: casimiro124 (button) folded on the River



PokerStars Hand #222975078557:  Hold'em No Limit ($0.05/$0.10 USD) - 2021/01/23 17:26:21 ET
Table 'Stephano III' 6-max Seat #1 is the button
Seat 1: OSTAINES98 ($4.91 in chips) 
Seat 2: perespell ($11.68 in chips) 
Seat 3: jammer35983 ($8.52 in chips) 
Seat 4: Nickh147 ($16.16 in chips) 
Seat 5: dancayamanda ($20.31 in chips) 
Seat 6: casimiro124 ($10.13 in chips) 
perespell: posts small blind $0.05
jammer35983: posts big blind $0.10
*** HOLE CARDS ***
Nickh147: folds 
dancayamanda: folds 
casimiro124: raises $0.15 to $0.25
OSTAINES98: calls $0.25
perespell: folds 
jammer35983: calls $0.15
*** FLOP *** [3h 2c 6h]
jammer35983: checks 
casimiro124: bets $0.40
OSTAINES98: raises $0.50 to $0.90
jammer35983: calls $0.90
casimiro124: calls $0.50
*** TURN *** [3h 2c 6h] [Kc]
jammer35983: checks 
casimiro124: checks 
OSTAINES98: checks 
*** RIVER *** [3h 2c 6h Kc] [5c]
jammer35983: bets $1.67
casimiro124: raises $7.31 to $8.98 and is all-in
OSTAINES98: folds 
jammer35983: folds 
Uncalled bet ($7.31) returned to casimiro124
casimiro124 collected $6.53 from pot
casimiro124: doesn't show hand 
*** SUMMARY ***
Total pot $6.84 | Rake $0.31 
Board [3h 2c 6h Kc 5c]
Seat 1: OSTAINES98 (button) folded on the River
Seat 2: perespell (small blind) folded before Flop
Seat 3: jammer35983 (big blind) folded on the River
Seat 4: Nickh147 folded before Flop (didn't bet)
Seat 5: dancayamanda folded before Flop (didn't bet)
Seat 6: casimiro124 collected ($6.53)



PokerStars Hand #222975139867:  Hold'em No Limit ($0.05/$0.10 USD) - 2021/01/23 17:27:37 ET
Table 'Stephano III' 6-max Seat #2 is the button
Seat 1: OSTAINES98 ($3.76 in chips) 
Seat 2: perespell ($11.63 in chips) 
Seat 3: jammer35983 ($5.70 in chips) 
Seat 4: Nickh147 ($16.16 in chips) 
Seat 5: dancayamanda ($20.31 in chips) 
Seat 6: casimiro124 ($13.84 in chips) 
jammer35983: posts small blind $0.05
Nickh147: posts big blind $0.10
*** HOLE CARDS ***
dancayamanda: folds 
casimiro124: folds 
OSTAINES98: calls $0.10
perespell: raises $0.15 to $0.25
jammer35983: folds 
Nickh147: folds 
OSTAINES98: calls $0.15
*** FLOP *** [8d Jc 2c]
OSTAINES98: checks 
perespell: checks 
*** TURN *** [8d Jc 2c] [7c]
OSTAINES98: bets $0.10
perespell: calls $0.10
*** RIVER *** [8d Jc 2c 7c] [Kc]
OSTAINES98: bets $0.50
perespell: folds 
Uncalled bet ($0.50) returned to OSTAINES98
OSTAINES98 collected $0.81 from pot
OSTAINES98: doesn't show hand 
*** SUMMARY ***
Total pot $0.85 | Rake $0.04 
Board [8d Jc 2c 7c Kc]
Seat 1: OSTAINES98 collected ($0.81)
Seat 2: perespell (button) folded on the River
Seat 3: jammer35983 (small blind) folded before Flop
Seat 4: Nickh147 (big blind) folded before Flop
Seat 5: dancayamanda folded before Flop (didn't bet)
Seat 6: casimiro124 folded before Flop (didn't bet)



PokerStars Hand #222975172202:  Hold'em No Limit ($0.05/$0.10 USD) - 2021/01/23 17:28:14 ET
Table 'Stephano III' 6-max Seat #3 is the button
Seat 1: OSTAINES98 ($4.22 in chips) 
Seat 2: perespell ($11.28 in chips) 
Seat 3: jammer35983 ($5.65 in chips) 
Seat 4: Nickh147 ($16.06 in chips) 
Seat 5: dancayamanda ($20.31 in chips) 
Seat 6: casimiro124 ($13.84 in chips) 
Nickh147: posts small blind $0.05
dancayamanda: posts big blind $0.10
*** HOLE CARDS ***
casimiro124: folds 
OSTAINES98: calls $0.10
perespell: raises $0.30 to $0.40
jammer35983: folds 
Nickh147: folds 
dancayamanda: folds 
OSTAINES98: folds 
Uncalled bet ($0.30) returned to perespell
perespell collected $0.35 from pot
perespell: doesn't show hand 
*** SUMMARY ***
Total pot $0.35 | Rake $0 
Seat 1: OSTAINES98 folded before Flop
Seat 2: perespell collected ($0.35)
Seat 3: jammer35983 (button) folded before Flop (didn't bet)
Seat 4: Nickh147 (small blind) folded before Flop
Seat 5: dancayamanda (big blind) folded before Flop
Seat 6: casimiro124 folded before Flop (didn't bet)



PokerStars Hand #222975196069:  Hold'em No Limit ($0.05/$0.10 USD) - 2021/01/23 17:28:44 ET
Table 'Stephano III' 6-max Seat #4 is the button
Seat 1: OSTAINES98 ($4.12 in chips) 
Seat 2: perespell ($11.53 in chips) 
Seat 3: jammer35983 ($5.65 in chips) 
Seat 4: Nickh147 ($16.01 in chips) 
Seat 5: dancayamanda ($20.21 in chips) 
Seat 6: casimiro124 ($13.84 in chips) 
dancayamanda: posts small blind $0.05
casimiro124: posts big blind $0.10
*** HOLE CARDS ***
OSTAINES98: calls $0.10
perespell: folds 
jammer35983: folds 
Nickh147: calls $0.10
dancayamanda: folds 
casimiro124: checks 
*** FLOP *** [6c As 8s]
casimiro124: checks 
OSTAINES98: checks 
Nickh147: checks 
*** TURN *** [6c As 8s] [Jh]
casimiro124: checks 
OSTAINES98: checks 
Nickh147: bets $0.14
casimiro124: folds 
OSTAINES98: calls $0.14
*** RIVER *** [6c As 8s Jh] [7s]
OSTAINES98: checks 
Nickh147: checks 
*** SHOW DOWN ***
OSTAINES98: shows [Qs 2d] (high card Ace)
Nickh147: shows [7c 4c] (a pair of Sevens)
Nickh147 collected $0.60 from pot
*** SUMMARY ***
Total pot $0.63 | Rake $0.03 
Board [6c As 8s Jh 7s]
Seat 1: OSTAINES98 showed [Qs 2d] and lost with high card Ace
Seat 2: perespell folded before Flop (didn't bet)
Seat 3: jammer35983 folded before Flop (didn't bet)
Seat 4: Nickh147 (button) showed [7c 4c] and won ($0.60) with a pair of Sevens
Seat 5: dancayamanda (small blind) folded before Flop
Seat 6: casimiro124 (big blind) folded on the Turn



PokerStars Hand #222975228700:  Hold'em No Limit ($0.05/$0.10 USD) - 2021/01/23 17:29:25 ET
Table 'Stephano III' 6-max Seat #5 is the button
Seat 1: OSTAINES98 ($3.88 in chips) 
Seat 2: perespell ($11.53 in chips) 
Seat 3: jammer35983 ($5.65 in chips) 
Seat 4: Nickh147 ($16.37 in chips) 
Seat 5: dancayamanda ($20.16 in chips) 
Seat 6: casimiro124 ($13.74 in chips) 
casimiro124: posts small blind $0.05
OSTAINES98: posts big blind $0.10
*** HOLE CARDS ***
perespell: folds 
jammer35983: calls $0.10
Nickh147: folds 
dancayamanda: folds 
casimiro124: folds 
OSTAINES98: checks 
*** FLOP *** [3s 3c 9s]
OSTAINES98: checks 
jammer35983: checks 
*** TURN *** [3s 3c 9s] [Kh]
OSTAINES98: checks 
jammer35983: checks 
*** RIVER *** [3s 3c 9s Kh] [8d]
OSTAINES98: checks 
jammer35983: checks 
*** SHOW DOWN ***
OSTAINES98: shows [Jd 4h] (a pair of Threes)
jammer35983: shows [2d Qc] (a pair of Threes - King+Queen kicker)
jammer35983 collected $0.24 from pot
*** SUMMARY ***
Total pot $0.25 | Rake $0.01 
Board [3s 3c 9s Kh 8d]
Seat 1: OSTAINES98 (big blind) showed [Jd 4h] and lost with a pair of Threes
Seat 2: perespell folded before Flop (didn't bet)
Seat 3: jammer35983 showed [2d Qc] and won ($0.24) with a pair of Threes
Seat 4: Nickh147 folded before Flop (didn't bet)
Seat 5: dancayamanda (button) folded before Flop (didn't bet)
Seat 6: casimiro124 (small blind) folded before Flop



PokerStars Hand #222975248377:  Hold'em No Limit ($0.05/$0.10 USD) - 2021/01/23 17:29:50 ET
Table 'Stephano III' 6-max Seat #6 is the button
Seat 1: OSTAINES98 ($3.78 in chips) 
Seat 2: perespell ($11.53 in chips) 
Seat 3: jammer35983 ($5.79 in chips) 
Seat 4: Nickh147 ($16.37 in chips) 
Seat 5: dancayamanda ($20.16 in chips) 
Seat 6: casimiro124 ($13.69 in chips) 
OSTAINES98: posts small blind $0.05
perespell: posts big blind $0.10
*** HOLE CARDS ***
jammer35983: calls $0.10
Nickh147: folds 
dancayamanda: folds 
casimiro124: raises $0.40 to $0.50
OSTAINES98: folds 
perespell: folds 
jammer35983: calls $0.40
*** FLOP *** [9h As Th]
jammer35983: checks 
casimiro124: bets $0.58
jammer35983: folds 
Uncalled bet ($0.58) returned to casimiro124
casimiro124 collected $1.10 from pot
casimiro124: doesn't show hand 
*** SUMMARY ***
Total pot $1.15 | Rake $0.05 
Board [9h As Th]
Seat 1: OSTAINES98 (small blind) folded before Flop
Seat 2: perespell (big blind) folded before Flop
Seat 3: jammer35983 folded on the Flop
Seat 4: Nickh147 folded before Flop (didn't bet)
Seat 5: dancayamanda folded before Flop (didn't bet)
Seat 6: casimiro124 (button) collected ($1.10)



PokerStars Hand #222975276739:  Hold'em No Limit ($0.05/$0.10 USD) - 2021/01/23 17:30:25 ET
Table 'Stephano III' 6-max Seat #1 is the button
Seat 1: OSTAINES98 ($3.73 in chips) 
Seat 2: perespell ($11.43 in chips) 
Seat 3: jammer35983 ($5.29 in chips) 
Seat 4: Nickh147 ($16.37 in chips) 
Seat 5: dancayamanda ($20.16 in chips) 
Seat 6: casimiro124 ($14.29 in chips) 
perespell: posts small blind $0.05
jammer35983: posts big blind $0.10
*** HOLE CARDS ***
Nickh147: folds 
dancayamanda: folds 
casimiro124: raises $0.15 to $0.25
OSTAINES98: calls $0.25
perespell: calls $0.20
jammer35983: calls $0.15
*** FLOP *** [As Th 8c]
perespell: checks 
jammer35983: checks 
casimiro124: checks 
OSTAINES98: checks 
*** TURN *** [As Th 8c] [2c]
perespell: checks 
jammer35983: checks 
casimiro124: checks 
OSTAINES98: checks 
*** RIVER *** [As Th 8c 2c] [Ad]
perespell: checks 
jammer35983: bets $0.48
casimiro124: calls $0.48
OSTAINES98: folds 
perespell: folds 
*** SHOW DOWN ***
jammer35983: shows [Ac Ts] (a full house, Aces full of Tens)
casimiro124: mucks hand 
jammer35983 collected $1.87 from pot
*** SUMMARY ***
Total pot $1.96 | Rake $0.09 
Board [As Th 8c 2c Ad]
Seat 1: OSTAINES98 (button) folded on the River
Seat 2: perespell (small blind) folded on the River
Seat 3: jammer35983 (big blind) showed [Ac Ts] and won ($1.87) with a full house, Aces full of Tens
Seat 4: Nickh147 folded before Flop (didn't bet)
Seat 5: dancayamanda folded before Flop (didn't bet)
Seat 6: casimiro124 mucked



PokerStars Hand #222975327935:  Hold'em No Limit ($0.05/$0.10 USD) - 2021/01/23 17:31:30 ET
Table 'Stephano III' 6-max Seat #2 is the button
Seat 1: OSTAINES98 ($3.48 in chips) 
Seat 2: perespell ($11.18 in chips) 
Seat 3: jammer35983 ($6.43 in chips) 
Seat 4: Nickh147 ($16.37 in chips) 
Seat 5: dancayamanda ($20.16 in chips) 
Seat 6: casimiro124 ($13.56 in chips) 
jammer35983: posts small blind $0.05
Nickh147: posts big blind $0.10
*** HOLE CARDS ***
dancayamanda: folds 
casimiro124: folds 
OSTAINES98: calls $0.10
perespell: folds 
jammer35983: calls $0.05
Nickh147: checks 
*** FLOP *** [Ac 7c 4d]
jammer35983: checks 
Nickh147: checks 
OSTAINES98: checks 
*** TURN *** [Ac 7c 4d] [2h]
jammer35983: checks 
Nickh147: bets $0.20
OSTAINES98: calls $0.20
jammer35983: folds 
*** RIVER *** [Ac 7c 4d 2h] [7s]
Nickh147: bets $1
OSTAINES98: calls $1
*** SHOW DOWN ***
Nickh147: shows [7h Ad] (a full house, Sevens full of Aces)
OSTAINES98: mucks hand 
Nickh147 collected $2.58 from pot
*** SUMMARY ***
Total pot $2.70 | Rake $0.12 
Board [Ac 7c 4d 2h 7s]
Seat 1: OSTAINES98 mucked
Seat 2: perespell (button) folded before Flop (didn't bet)
Seat 3: jammer35983 (small blind) folded on the Turn
Seat 4: Nickh147 (big blind) showed [7h Ad] and won ($2.58) with a full house, Sevens full of Aces
Seat 5: dancayamanda folded before Flop (didn't bet)
Seat 6: casimiro124 folded before Flop (didn't bet)



PokerStars Hand #222975386114:  Hold'em No Limit ($0.05/$0.10 USD) - 2021/01/23 17:32:44 ET
Table 'Stephano III' 6-max Seat #3 is the button
Seat 1: OSTAINES98 ($2.18 in chips) 
Seat 2: perespell ($11.18 in chips) 
Seat 3: jammer35983 ($6.33 in chips) 
Seat 4: Nickh147 ($17.65 in chips) 
Seat 5: dancayamanda ($20.16 in chips) 
Seat 6: casimiro124 ($13.56 in chips) 
Nickh147: posts small blind $0.05
dancayamanda: posts big blind $0.10
*** HOLE CARDS ***
casimiro124: folds 
OSTAINES98: calls $0.10
perespell: raises $0.30 to $0.40
jammer35983: calls $0.40
Nickh147: folds 
dancayamanda: folds 
OSTAINES98: folds 
*** FLOP *** [5c Ks 6c]
perespell: checks 
jammer35983: checks 
*** TURN *** [5c Ks 6c] [2h]
perespell: bets $0.31
jammer35983: calls $0.31
*** RIVER *** [5c Ks 6c 2h] [7s]
perespell: checks 
jammer35983: bets $0.79
perespell: calls $0.79
*** SHOW DOWN ***
jammer35983: shows [Ad 7h] (a pair of Sevens)
perespell: shows [Jc Js] (a pair of Jacks)
perespell collected $3.10 from pot
*** SUMMARY ***
Total pot $3.25 | Rake $0.15 
Board [5c Ks 6c 2h 7s]
Seat 1: OSTAINES98 folded before Flop
Seat 2: perespell showed [Jc Js] and won ($3.10) with a pair of Jacks
Seat 3: jammer35983 (button) showed [Ad 7h] and lost with a pair of Sevens
Seat 4: Nickh147 (small blind) folded before Flop
Seat 5: dancayamanda (big blind) folded before Flop
Seat 6: casimiro124 folded before Flop (didn't bet)



PokerStars Hand #222975418739:  Hold'em No Limit ($0.05/$0.10 USD) - 2021/01/23 17:33:26 ET
Table 'Stephano III' 6-max Seat #4 is the button
Seat 1: OSTAINES98 ($2.08 in chips) 
Seat 2: perespell ($12.78 in chips) 
Seat 3: jammer35983 ($4.83 in chips) 
Seat 4: Nickh147 ($17.60 in chips) 
Seat 5: dancayamanda ($20.06 in chips) 
Seat 6: casimiro124 ($13.56 in chips) 
dancayamanda: posts small blind $0.05
casimiro124: posts big blind $0.10
*** HOLE CARDS ***
OSTAINES98: calls $0.10
perespell: raises $0.20 to $0.30
jammer35983: calls $0.30
Nickh147: folds 
dancayamanda: folds 
casimiro124: folds 
OSTAINES98: folds 
*** FLOP *** [Jc 9c 9d]
perespell: bets $0.41
jammer35983: calls $0.41
*** TURN *** [Jc 9c 9d] [Kc]
perespell: bets $0.49
jammer35983: raises $1.29 to $1.78
perespell: calls $1.29
*** RIVER *** [Jc 9c 9d Kc] [Tc]
perespell: bets $2.54
jammer35983: folds 
Uncalled bet ($2.54) returned to perespell
perespell collected $4.99 from pot
perespell: doesn't show hand 
*** SUMMARY ***
Total pot $5.23 | Rake $0.24 
Board [Jc 9c 9d Kc Tc]
Seat 1: OSTAINES98 folded before Flop
Seat 2: perespell collected ($4.99)
Seat 3: jammer35983 folded on the River
Seat 4: Nickh147 (button) folded before Flop (didn't bet)
Seat 5: dancayamanda (small blind) folded before Flop
Seat 6: casimiro124 (big blind) folded before Flop



PokerStars Hand #222975478901:  Hold'em No Limit ($0.05/$0.10 USD) - 2021/01/23 17:34:42 ET
Table 'Stephano III' 6-max Seat #5 is the button
Seat 1: OSTAINES98 ($1.98 in chips) 
Seat 2: perespell ($15.28 in chips) 
Seat 3: jammer35983 ($2.34 in chips) 
Seat 4: Nickh147 ($17.60 in chips) 
Seat 5: dancayamanda ($20.01 in chips) 
Seat 6: casimiro124 ($13.46 in chips) 
casimiro124: posts small blind $0.05
OSTAINES98: posts big blind $0.10
*** HOLE CARDS ***
perespell: folds 
jammer35983: calls $0.10
Nickh147: raises $0.25 to $0.35
dancayamanda: folds 
casimiro124: folds 
OSTAINES98: folds 
jammer35983: calls $0.25
*** FLOP *** [Ac 3h 2s]
jammer35983: checks 
Nickh147: bets $0.40
jammer35983: calls $0.40
*** TURN *** [Ac 3h 2s] [4d]
jammer35983: checks 
Nickh147: checks 
*** RIVER *** [Ac 3h 2s 4d] [Kd]
jammer35983: bets $1.59 and is all-in
Nickh147: folds 
Uncalled bet ($1.59) returned to jammer35983
jammer35983 collected $1.58 from pot
jammer35983: doesn't show hand 
*** SUMMARY ***
Total pot $1.65 | Rake $0.07 
Board [Ac 3h 2s 4d Kd]
Seat 1: OSTAINES98 (big blind) folded before Flop
Seat 2: perespell folded before Flop (didn't bet)
Seat 3: jammer35983 collected ($1.58)
Seat 4: Nickh147 folded on the River
Seat 5: dancayamanda (button) folded before Flop (didn't bet)
Seat 6: casimiro124 (small blind) folded before Flop



PokerStars Hand #222975536637:  Hold'em No Limit ($0.05/$0.10 USD) - 2021/01/23 17:35:44 ET
Table 'Stephano III' 6-max Seat #6 is the button
Seat 1: OSTAINES98 ($1.88 in chips) 
Seat 2: perespell ($15.28 in chips) 
Seat 3: jammer35983 ($3.17 in chips) 
Seat 4: Nickh147 ($16.85 in chips) 
Seat 5: dancayamanda ($20.01 in chips) 
Seat 6: casimiro124 ($13.41 in chips) 
OSTAINES98: posts small blind $0.05
perespell: posts big blind $0.10
*** HOLE CARDS ***
jammer35983: calls $0.10
Nickh147: folds 
dancayamanda: folds 
casimiro124: folds 
OSTAINES98: calls $0.05
perespell: checks 
*** FLOP *** [Ks 7d 9h]
OSTAINES98: checks 
perespell: checks 
jammer35983: checks 
*** TURN *** [Ks 7d 9h] [7s]
OSTAINES98: bets $0.30
perespell: calls $0.30
jammer35983: folds 
*** RIVER *** [Ks 7d 9h 7s] [5s]
OSTAINES98: checks 
perespell: bets $0.44
OSTAINES98: folds 
Uncalled bet ($0.44) returned to perespell
perespell collected $0.86 from pot
perespell: doesn't show hand 
*** SUMMARY ***
Total pot $0.90 | Rake $0.04 
Board [Ks 7d 9h 7s 5s]
Seat 1: OSTAINES98 (small blind) folded on the River
Seat 2: perespell (big blind) collected ($0.86)
Seat 3: jammer35983 folded on the Turn
Seat 4: Nickh147 folded before Flop (didn't bet)
Seat 5: dancayamanda folded before Flop (didn't bet)
Seat 6: casimiro124 (button) folded before Flop (didn't bet)



PokerStars Hand #222975567451:  Hold'em No Limit ($0.05/$0.10 USD) - 2021/01/23 17:36:24 ET
Table 'Stephano III' 6-max Seat #1 is the button
Seat 1: OSTAINES98 ($1.48 in chips) 
Seat 2: perespell ($15.74 in chips) 
Seat 3: jammer35983 ($3.07 in chips) 
Seat 4: Nickh147 ($16.85 in chips) 
Seat 5: dancayamanda ($20.01 in chips) 
Seat 6: casimiro124 ($13.41 in chips) 
perespell: posts small blind $0.05
jammer35983: posts big blind $0.10
*** HOLE CARDS ***
Nickh147: folds 
dancayamanda: folds 
casimiro124: raises $0.15 to $0.25
OSTAINES98: calls $0.25
perespell: calls $0.20
jammer35983: folds 
*** FLOP *** [2d Td 9d]
perespell: checks 
casimiro124: checks 
OSTAINES98: bets $0.30
perespell: folds 
casimiro124: folds 
Uncalled bet ($0.30) returned to OSTAINES98
OSTAINES98 collected $0.81 from pot
OSTAINES98: doesn't show hand 
*** SUMMARY ***
Total pot $0.85 | Rake $0.04 
Board [2d Td 9d]
Seat 1: OSTAINES98 (button) collected ($0.81)
Seat 2: perespell (small blind) folded on the Flop
Seat 3: jammer35983 (big blind) folded before Flop
Seat 4: Nickh147 folded before Flop (didn't bet)
Seat 5: dancayamanda folded before Flop (didn't bet)
Seat 6: casimiro124 folded on the Flop



PokerStars Hand #222975609107:  Hold'em No Limit ($0.05/$0.10 USD) - 2021/01/23 17:37:18 ET
Table 'Stephano III' 6-max Seat #2 is the button
Seat 1: OSTAINES98 ($2.04 in chips) 
Seat 2: perespell ($15.49 in chips) 
Seat 3: jammer35983 ($2.97 in chips) 
Seat 5: dancayamanda ($20.01 in chips) 
Seat 6: casimiro124 ($13.16 in chips) 
jammer35983: posts small blind $0.05
Nickh147: is sitting out 
dancayamanda: posts big blind $0.10
*** HOLE CARDS ***
casimiro124: folds 
OSTAINES98: calls $0.10
perespell: folds 
jammer35983: raises $0.10 to $0.20
dancayamanda: folds 
OSTAINES98: calls $0.10
*** FLOP *** [Kc 6c 3h]
jammer35983: checks 
OSTAINES98: bets $0.40
jammer35983: calls $0.40
*** TURN *** [Kc 6c 3h] [6s]
jammer35983: checks 
Nickh147 leaves the table
OSTAINES98: bets $0.40
jammer35983: calls $0.40
*** RIVER *** [Kc 6c 3h 6s] [3s]
jammer35983: checks 
kimmarusa joins the table at seat #4 
OSTAINES98: bets $1.04 and is all-in
jammer35983: folds 
Uncalled bet ($1.04) returned to OSTAINES98
OSTAINES98 collected $2.01 from pot
OSTAINES98: doesn't show hand 
*** SUMMARY ***
Total pot $2.10 | Rake $0.09 
Board [Kc 6c 3h 6s 3s]
Seat 1: OSTAINES98 collected ($2.01)
Seat 2: perespell (button) folded before Flop (didn't bet)
Seat 3: jammer35983 (small blind) folded on the River
Seat 5: dancayamanda (big blind) folded before Flop
Seat 6: casimiro124 folded before Flop (didn't bet)



PokerStars Hand #222975640913:  Hold'em No Limit ($0.05/$0.10 USD) - 2021/01/23 17:37:59 ET
Table 'Stephano III' 6-max Seat #3 is the button
Seat 1: OSTAINES98 ($3.05 in chips) 
Seat 2: perespell ($15.49 in chips) 
Seat 3: jammer35983 ($1.97 in chips) 
Seat 5: dancayamanda ($19.91 in chips) 
Seat 6: casimiro124 ($13.16 in chips) 
dancayamanda: posts small blind $0.05
casimiro124: posts big blind $0.10
*** HOLE CARDS ***
OSTAINES98: calls $0.10
perespell: folds 
jammer35983: calls $0.10
dancayamanda: folds 
casimiro124: checks 
*** FLOP *** [Jh Kc Ah]
casimiro124: checks 
OSTAINES98: checks 
jammer35983: checks 
*** TURN *** [Jh Kc Ah] [Ts]
casimiro124: checks 
OSTAINES98: checks 
jammer35983: checks 
*** RIVER *** [Jh Kc Ah Ts] [Kd]
casimiro124: checks 
OSTAINES98: checks 
jammer35983: checks 
*** SHOW DOWN ***
casimiro124: shows [Jc 8s] (two pair, Kings and Jacks)
OSTAINES98: mucks hand 
jammer35983: mucks hand 
casimiro124 collected $0.33 from pot
*** SUMMARY ***
Total pot $0.35 | Rake $0.02 
Board [Jh Kc Ah Ts Kd]
Seat 1: OSTAINES98 mucked
Seat 2: perespell folded before Flop (didn't bet)
Seat 3: jammer35983 (button) mucked
Seat 5: dancayamanda (small blind) folded before Flop
Seat 6: casimiro124 (big blind) showed [Jc 8s] and won ($0.33) with two pair, Kings and Jacks



PokerStars Hand #222975675241:  Hold'em No Limit ($0.05/$0.10 USD) - 2021/01/23 17:38:44 ET
Table 'Stephano III' 6-max Seat #5 is the button
Seat 1: OSTAINES98 ($2.95 in chips) 
Seat 2: perespell ($15.49 in chips) 
Seat 3: jammer35983 ($1.87 in chips) 
Seat 5: dancayamanda ($19.86 in chips) 
Seat 6: casimiro124 ($13.39 in chips) 
casimiro124: posts small blind $0.05
OSTAINES98: posts big blind $0.10
kimmarusa: sits out 
*** HOLE CARDS ***
perespell: raises $0.15 to $0.25
jammer35983: calls $0.25
dancayamanda: folds 
casimiro124: folds 
OSTAINES98: calls $0.15
*** FLOP *** [As 8h Jh]
OSTAINES98: checks 
perespell: checks 
jammer35983: checks 
*** TURN *** [As 8h Jh] [Jc]
OSTAINES98: checks 
perespell: checks 
jammer35983: checks 
*** RIVER *** [As 8h Jh Jc] [Jd]
OSTAINES98: bets $0.40
perespell: calls $0.40
jammer35983: folds 
*** SHOW DOWN ***
OSTAINES98: shows [7s Ks] (three of a kind, Jacks)
perespell: shows [Qh Qc] (a full house, Jacks full of Queens)
perespell collected $1.53 from pot
*** SUMMARY ***
Total pot $1.60 | Rake $0.07 
Board [As 8h Jh Jc Jd]
Seat 1: OSTAINES98 (big blind) showed [7s Ks] and lost with three of a kind, Jacks
Seat 2: perespell showed [Qh Qc] and won ($1.53) with a full house, Jacks full of Queens
Seat 3: jammer35983 folded on the River
Seat 5: dancayamanda (button) folded before Flop (didn't bet)
Seat 6: casimiro124 (small blind) folded before Flop



PokerStars Hand #222975714217:  Hold'em No Limit ($0.05/$0.10 USD) - 2021/01/23 17:39:35 ET
Table 'Stephano III' 6-max Seat #6 is the button
Seat 1: OSTAINES98 ($2.30 in chips) 
Seat 2: perespell ($16.37 in chips) 
Seat 3: jammer35983 ($1.62 in chips) 
Seat 5: dancayamanda ($19.86 in chips) 
Seat 6: casimiro124 ($13.34 in chips) 
OSTAINES98: posts small blind $0.05
perespell: posts big blind $0.10
kimmarusa: sits out 
*** HOLE CARDS ***
jammer35983: calls $0.10
dancayamanda: folds 
casimiro124: folds 
OSTAINES98: calls $0.05
perespell: checks 
*** FLOP *** [2s Jd 6d]
OSTAINES98: checks 
perespell: checks 
jammer35983: checks 
*** TURN *** [2s Jd 6d] [Jh]
OSTAINES98: checks 
perespell: bets $0.10
jammer35983: folds 
OSTAINES98: calls $0.10
*** RIVER *** [2s Jd 6d Jh] [Kd]
OSTAINES98: checks 
perespell: checks 
*** SHOW DOWN ***
OSTAINES98: shows [Qd Ah] (a pair of Jacks)
perespell: shows [3s 6s] (two pair, Jacks and Sixes)
perespell collected $0.48 from pot
*** SUMMARY ***
Total pot $0.50 | Rake $0.02 
Board [2s Jd 6d Jh Kd]
Seat 1: OSTAINES98 (small blind) showed [Qd Ah] and lost with a pair of Jacks
Seat 2: perespell (big blind) showed [3s 6s] and won ($0.48) with two pair, Jacks and Sixes
Seat 3: jammer35983 folded on the Turn
Seat 5: dancayamanda folded before Flop (didn't bet)
Seat 6: casimiro124 (button) folded before Flop (didn't bet)



PokerStars Hand #222975755920:  Hold'em No Limit ($0.05/$0.10 USD) - 2021/01/23 17:40:29 ET
Table 'Stephano III' 6-max Seat #1 is the button
Seat 1: OSTAINES98 ($2.10 in chips) 
Seat 2: perespell ($16.65 in chips) 
Seat 3: jammer35983 ($1.52 in chips) 
Seat 5: dancayamanda ($19.86 in chips) 
Seat 6: casimiro124 ($13.34 in chips) 
perespell: posts small blind $0.05
jammer35983: posts big blind $0.10
kimmarusa: sits out 
*** HOLE CARDS ***
dancayamanda: folds 
casimiro124: folds 
OSTAINES98: calls $0.10
perespell: folds 
jammer35983: checks 
*** FLOP *** [Jd Ah Ks]
jammer35983: checks 
OSTAINES98 is disconnected 
OSTAINES98 has timed out while disconnected
OSTAINES98: checks 
*** TURN *** [Jd Ah Ks] [3c]
jammer35983: checks 
OSTAINES98 has timed out while disconnected
OSTAINES98: checks 
*** RIVER *** [Jd Ah Ks 3c] [Qs]
jammer35983: checks 
OSTAINES98 has timed out while disconnected
OSTAINES98: checks 
*** SHOW DOWN ***
jammer35983: shows [6h 8c] (high card Ace)
OSTAINES98: shows [Jh 8d] (a pair of Jacks)
OSTAINES98 collected $0.24 from pot
*** SUMMARY ***
Total pot $0.25 | Rake $0.01 
Board [Jd Ah Ks 3c Qs]
Seat 1: OSTAINES98 (button) showed [Jh 8d] and won ($0.24) with a pair of Jacks
Seat 2: perespell (small blind) folded before Flop
Seat 3: jammer35983 (big blind) showed [6h 8c] and lost with high card Ace
Seat 5: dancayamanda folded before Flop (didn't bet)
Seat 6: casimiro124 folded before Flop (didn't bet)



PokerStars Hand #222969882097:  Hold'em No Limit ($0.05/$0.10 USD) - 2021/01/23 15:39:53 ET
Table 'Stephano III' 6-max Seat #1 is the button
Seat 1: andrew_yar ($11.12 in chips) 
Seat 2: perespell ($10.02 in chips) 
Seat 3: Mark86F ($8 in chips) 
Seat 4: Kobert72 ($10.75 in chips) 
Seat 5: JohnnyVido ($12.53 in chips) 
Seat 6: RUMJO ($10.18 in chips) 
perespell: posts small blind $0.05
Mark86F: posts big blind $0.10
*** HOLE CARDS ***
Kobert72: folds 
JohnnyVido: calls $0.10
RUMJO: folds 
andrew_yar: folds 
perespell: raises $0.30 to $0.40
Mark86F: folds 
JohnnyVido: calls $0.30
*** FLOP *** [4h 7s 5s]
perespell: checks 
JohnnyVido: checks 
*** TURN *** [4h 7s 5s] [2s]
perespell: bets $0.44
JohnnyVido: calls $0.44
*** RIVER *** [4h 7s 5s 2s] [Kh]
perespell: bets $0.87
JohnnyVido: folds 
Uncalled bet ($0.87) returned to perespell
perespell collected $1.70 from pot
perespell: doesn't show hand 
*** SUMMARY ***
Total pot $1.78 | Rake $0.08 
Board [4h 7s 5s 2s Kh]
Seat 1: andrew_yar (button) folded before Flop (didn't bet)
Seat 2: perespell (small blind) collected ($1.70)
Seat 3: Mark86F (big blind) folded before Flop
Seat 4: Kobert72 folded before Flop (didn't bet)
Seat 5: JohnnyVido folded on the River
Seat 6: RUMJO folded before Flop (didn't bet)



PokerStars Hand #222969942422:  Hold'em No Limit ($0.05/$0.10 USD) - 2021/01/23 15:41:05 ET
Table 'Stephano III' 6-max Seat #2 is the button
Seat 1: andrew_yar ($11.12 in chips) 
Seat 2: perespell ($10.88 in chips) 
Seat 3: Mark86F ($7.90 in chips) 
Seat 4: Kobert72 ($10.75 in chips) 
Seat 5: JohnnyVido ($11.69 in chips) 
Seat 6: RUMJO ($10.18 in chips) 
Mark86F: posts small blind $0.05
Kobert72: posts big blind $0.10
*** HOLE CARDS ***
JohnnyVido: folds 
RUMJO: folds 
andrew_yar: folds 
perespell: folds 
Mark86F: raises $0.10 to $0.20
Kobert72: folds 
Uncalled bet ($0.10) returned to Mark86F
Mark86F collected $0.20 from pot
Mark86F: doesn't show hand 
*** SUMMARY ***
Total pot $0.20 | Rake $0 
Seat 1: andrew_yar folded before Flop (didn't bet)
Seat 2: perespell (button) folded before Flop (didn't bet)
Seat 3: Mark86F (small blind) collected ($0.20)
Seat 4: Kobert72 (big blind) folded before Flop
Seat 5: JohnnyVido folded before Flop (didn't bet)
Seat 6: RUMJO folded before Flop (didn't bet)



PokerStars Hand #222969957936:  Hold'em No Limit ($0.05/$0.10 USD) - 2021/01/23 15:41:23 ET
Table 'Stephano III' 6-max Seat #3 is the button
Seat 1: andrew_yar ($11.12 in chips) 
Seat 2: perespell ($10.88 in chips) 
Seat 3: Mark86F ($8 in chips) 
Seat 4: Kobert72 ($10.65 in chips) 
Seat 5: JohnnyVido ($11.69 in chips) 
Seat 6: RUMJO ($10.18 in chips) 
Kobert72: posts small blind $0.05
JohnnyVido: posts big blind $0.10
*** HOLE CARDS ***
RUMJO: folds 
andrew_yar: folds 
perespell: folds 
Mark86F: raises $0.10 to $0.20
Kobert72: raises $0.78 to $0.98
JohnnyVido: folds 
Mark86F: calls $0.78
*** FLOP *** [Jh 8h 2h]
Kobert72: checks 
Mark86F: checks 
*** TURN *** [Jh 8h 2h] [Tc]
Kobert72: checks 
Mark86F: checks 
*** RIVER *** [Jh 8h 2h Tc] [9c]
Kobert72: bets $0.65
Mark86F: raises $0.65 to $1.30
Kobert72: calls $0.65
*** SHOW DOWN ***
Mark86F: shows [Kd Qs] (a straight, Nine to King)
Kobert72: mucks hand 
Mark86F collected $4.45 from pot
*** SUMMARY ***
Total pot $4.66 | Rake $0.21 
Board [Jh 8h 2h Tc 9c]
Seat 1: andrew_yar folded before Flop (didn't bet)
Seat 2: perespell folded before Flop (didn't bet)
Seat 3: Mark86F (button) showed [Kd Qs] and won ($4.45) with a straight, Nine to King
Seat 4: Kobert72 (small blind) mucked
Seat 5: JohnnyVido (big blind) folded before Flop
Seat 6: RUMJO folded before Flop (didn't bet)



PokerStars Hand #222970005477:  Hold'em No Limit ($0.05/$0.10 USD) - 2021/01/23 15:42:20 ET
Table 'Stephano III' 6-max Seat #4 is the button
Seat 1: andrew_yar ($11.12 in chips) 
Seat 2: perespell ($10.88 in chips) 
Seat 3: Mark86F ($10.17 in chips) 
Seat 4: Kobert72 ($10 in chips) 
Seat 5: JohnnyVido ($11.59 in chips) 
Seat 6: RUMJO ($10.18 in chips) 
JohnnyVido: posts small blind $0.05
RUMJO: posts big blind $0.10
*** HOLE CARDS ***
andrew_yar: folds 
perespell: raises $0.15 to $0.25
Mark86F: calls $0.25
Kobert72: folds 
JohnnyVido: folds 
RUMJO: folds 
*** FLOP *** [Qc 4d 4h]
perespell: checks 
Mark86F: checks 
*** TURN *** [Qc 4d 4h] [Kc]
perespell: bets $0.32
Mark86F: calls $0.32
*** RIVER *** [Qc 4d 4h Kc] [7h]
perespell: checks 
Mark86F: checks 
*** SHOW DOWN ***
perespell: shows [Th Jd] (a pair of Fours)
Mark86F: shows [As Td] (a pair of Fours - Ace kicker)
Mark86F collected $1.23 from pot
*** SUMMARY ***
Total pot $1.29 | Rake $0.06 
Board [Qc 4d 4h Kc 7h]
Seat 1: andrew_yar folded before Flop (didn't bet)
Seat 2: perespell showed [Th Jd] and lost with a pair of Fours
Seat 3: Mark86F showed [As Td] and won ($1.23) with a pair of Fours
Seat 4: Kobert72 (button) folded before Flop (didn't bet)
Seat 5: JohnnyVido (small blind) folded before Flop
Seat 6: RUMJO (big blind) folded before Flop



PokerStars Hand #222970064604:  Hold'em No Limit ($0.05/$0.10 USD) - 2021/01/23 15:43:30 ET
Table 'Stephano III' 6-max Seat #5 is the button
Seat 1: andrew_yar ($11.12 in chips) 
Seat 2: perespell ($10.31 in chips) 
Seat 3: Mark86F ($10.83 in chips) 
Seat 4: Kobert72 ($10 in chips) 
Seat 5: JohnnyVido ($11.54 in chips) 
Seat 6: RUMJO ($10.08 in chips) 
RUMJO: posts small blind $0.05
andrew_yar: posts big blind $0.10
*** HOLE CARDS ***
perespell has timed out
perespell: folds 
Mark86F has timed out
Mark86F: folds 
Kobert72: raises $0.13 to $0.23
JohnnyVido: raises $0.13 to $0.36
RUMJO: folds 
andrew_yar: folds 
Kobert72: calls $0.13
*** FLOP *** [7h Ac Js]
Kobert72: checks 
JohnnyVido: bets $0.83
Kobert72: folds 
Uncalled bet ($0.83) returned to JohnnyVido
JohnnyVido collected $0.83 from pot
JohnnyVido: doesn't show hand 
*** SUMMARY ***
Total pot $0.87 | Rake $0.04 
Board [7h Ac Js]
Seat 1: andrew_yar (big blind) folded before Flop
Seat 2: perespell folded before Flop (didn't bet)
Seat 3: Mark86F folded before Flop (didn't bet)
Seat 4: Kobert72 folded on the Flop
Seat 5: JohnnyVido (button) collected ($0.83)
Seat 6: RUMJO (small blind) folded before Flop



PokerStars Hand #222970115097:  Hold'em No Limit ($0.05/$0.10 USD) - 2021/01/23 15:44:30 ET
Table 'Stephano III' 6-max Seat #6 is the button
Seat 1: andrew_yar ($11.02 in chips) 
Seat 2: perespell ($10.31 in chips) 
Seat 3: Mark86F ($10.83 in chips) 
Seat 4: Kobert72 ($10 in chips) 
Seat 5: JohnnyVido ($12.01 in chips) 
Seat 6: RUMJO ($10.03 in chips) 
andrew_yar: posts small blind $0.05
perespell: posts big blind $0.10
*** HOLE CARDS ***
Mark86F: calls $0.10
Kobert72: folds 
JohnnyVido: raises $0.20 to $0.30
RUMJO has timed out
RUMJO: folds 
andrew_yar: folds 
perespell: folds 
Mark86F: folds 
Uncalled bet ($0.20) returned to JohnnyVido
JohnnyVido collected $0.35 from pot
JohnnyVido: doesn't show hand 
*** SUMMARY ***
Total pot $0.35 | Rake $0 
Seat 1: andrew_yar (small blind) folded before Flop
Seat 2: perespell (big blind) folded before Flop
Seat 3: Mark86F folded before Flop
Seat 4: Kobert72 folded before Flop (didn't bet)
Seat 5: JohnnyVido collected ($0.35)
Seat 6: RUMJO (button) folded before Flop (didn't bet)



PokerStars Hand #222970141307:  Hold'em No Limit ($0.05/$0.10 USD) - 2021/01/23 15:45:01 ET
Table 'Stephano III' 6-max Seat #1 is the button
Seat 1: andrew_yar ($10.97 in chips) 
Seat 2: perespell ($10.21 in chips) 
Seat 3: Mark86F ($10.73 in chips) 
Seat 4: Kobert72 ($10 in chips) 
Seat 5: JohnnyVido ($12.26 in chips) 
Seat 6: RUMJO ($10.03 in chips) 
perespell: posts small blind $0.05
Mark86F: posts big blind $0.10
*** HOLE CARDS ***
Kobert72: folds 
JohnnyVido: calls $0.10
RUMJO: raises $0.40 to $0.50
andrew_yar: calls $0.50
perespell: folds 
Mark86F: folds 
JohnnyVido: folds 
*** FLOP *** [4s 2c 2d]
RUMJO: bets $0.40
andrew_yar: folds 
Uncalled bet ($0.40) returned to RUMJO
RUMJO collected $1.19 from pot
RUMJO: doesn't show hand 
*** SUMMARY ***
Total pot $1.25 | Rake $0.06 
Board [4s 2c 2d]
Seat 1: andrew_yar (button) folded on the Flop
Seat 2: perespell (small blind) folded before Flop
Seat 3: Mark86F (big blind) folded before Flop
Seat 4: Kobert72 folded before Flop (didn't bet)
Seat 5: JohnnyVido folded before Flop
Seat 6: RUMJO collected ($1.19)



PokerStars Hand #222970176805:  Hold'em No Limit ($0.05/$0.10 USD) - 2021/01/23 15:45:43 ET
Table 'Stephano III' 6-max Seat #2 is the button
Seat 1: andrew_yar ($10.47 in chips) 
Seat 2: perespell ($10.16 in chips) 
Seat 3: Mark86F ($10.63 in chips) 
Seat 4: Kobert72 ($10 in chips) 
Seat 5: JohnnyVido ($12.16 in chips) 
Seat 6: RUMJO ($10.72 in chips) 
Mark86F: posts small blind $0.05
Kobert72: posts big blind $0.10
*** HOLE CARDS ***
JohnnyVido: folds 
RUMJO: folds 
andrew_yar: raises $0.15 to $0.25
perespell: folds 
Mark86F: folds 
Kobert72: folds 
Uncalled bet ($0.15) returned to andrew_yar
andrew_yar collected $0.25 from pot
andrew_yar: doesn't show hand 
*** SUMMARY ***
Total pot $0.25 | Rake $0 
Seat 1: andrew_yar collected ($0.25)
Seat 2: perespell (button) folded before Flop (didn't bet)
Seat 3: Mark86F (small blind) folded before Flop
Seat 4: Kobert72 (big blind) folded before Flop
Seat 5: JohnnyVido folded before Flop (didn't bet)
Seat 6: RUMJO folded before Flop (didn't bet)



PokerStars Hand #222970193703:  Hold'em No Limit ($0.05/$0.10 USD) - 2021/01/23 15:46:03 ET
Table 'Stephano III' 6-max Seat #3 is the button
Seat 1: andrew_yar ($10.62 in chips) 
Seat 2: perespell ($10.16 in chips) 
Seat 3: Mark86F ($10.58 in chips) 
Seat 4: Kobert72 ($10 in chips) 
Seat 5: JohnnyVido ($12.16 in chips) 
Seat 6: RUMJO ($10.72 in chips) 
Kobert72: posts small blind $0.05
JohnnyVido: posts big blind $0.10
*** HOLE CARDS ***
RUMJO: raises $0.15 to $0.25
andrew_yar: folds 
perespell: folds 
Mark86F: folds 
Kobert72: folds 
JohnnyVido: folds 
Uncalled bet ($0.15) returned to RUMJO
RUMJO collected $0.25 from pot
RUMJO: doesn't show hand 
*** SUMMARY ***
Total pot $0.25 | Rake $0 
Seat 1: andrew_yar folded before Flop (didn't bet)
Seat 2: perespell folded before Flop (didn't bet)
Seat 3: Mark86F (button) folded before Flop (didn't bet)
Seat 4: Kobert72 (small blind) folded before Flop
Seat 5: JohnnyVido (big blind) folded before Flop
Seat 6: RUMJO collected ($0.25)



PokerStars Hand #222970205155:  Hold'em No Limit ($0.05/$0.10 USD) - 2021/01/23 15:46:17 ET
Table 'Stephano III' 6-max Seat #4 is the button
Seat 1: andrew_yar ($10.62 in chips) 
Seat 2: perespell ($10.16 in chips) 
Seat 3: Mark86F ($10.58 in chips) 
Seat 4: Kobert72 ($10 in chips) 
Seat 5: JohnnyVido ($12.06 in chips) 
Seat 6: RUMJO ($10.87 in chips) 
JohnnyVido: posts small blind $0.05
RUMJO: posts big blind $0.10
*** HOLE CARDS ***
andrew_yar: folds 
perespell: folds 
Mark86F: raises $0.10 to $0.20
Kobert72: folds 
JohnnyVido: folds 
RUMJO: folds 
Uncalled bet ($0.10) returned to Mark86F
Mark86F collected $0.25 from pot
Mark86F: doesn't show hand 
*** SUMMARY ***
Total pot $0.25 | Rake $0 
Seat 1: andrew_yar folded before Flop (didn't bet)
Seat 2: perespell folded before Flop (didn't bet)
Seat 3: Mark86F collected ($0.25)
Seat 4: Kobert72 (button) folded before Flop (didn't bet)
Seat 5: JohnnyVido (small blind) folded before Flop
Seat 6: RUMJO (big blind) folded before Flop



PokerStars Hand #222970218721:  Hold'em No Limit ($0.05/$0.10 USD) - 2021/01/23 15:46:33 ET
Table 'Stephano III' 6-max Seat #5 is the button
Seat 1: andrew_yar ($10.62 in chips) 
Seat 2: perespell ($10.16 in chips) 
Seat 3: Mark86F ($10.73 in chips) 
Seat 4: Kobert72 ($10 in chips) 
Seat 5: JohnnyVido ($12.01 in chips) 
Seat 6: RUMJO ($10.77 in chips) 
RUMJO: posts small blind $0.05
andrew_yar: posts big blind $0.10
*** HOLE CARDS ***
perespell: folds 
Mark86F: raises $0.10 to $0.20
Kobert72: folds 
JohnnyVido: calls $0.20
RUMJO: folds 
andrew_yar: folds 
*** FLOP *** [5h As 3h]
Mark86F: bets $0.10
JohnnyVido: calls $0.10
*** TURN *** [5h As 3h] [4d]
Mark86F: bets $0.20
JohnnyVido: calls $0.20
*** RIVER *** [5h As 3h 4d] [9s]
Mark86F: checks 
JohnnyVido: bets $0.55
Mark86F: calls $0.55
*** SHOW DOWN ***
JohnnyVido: shows [4s 3s] (two pair, Fours and Threes)
Mark86F: mucks hand 
JohnnyVido collected $2.15 from pot
*** SUMMARY ***
Total pot $2.25 | Rake $0.10 
Board [5h As 3h 4d 9s]
Seat 1: andrew_yar (big blind) folded before Flop
Seat 2: perespell folded before Flop (didn't bet)
Seat 3: Mark86F mucked
Seat 4: Kobert72 folded before Flop (didn't bet)
Seat 5: JohnnyVido (button) showed [4s 3s] and won ($2.15) with two pair, Fours and Threes
Seat 6: RUMJO (small blind) folded before Flop



PokerStars Hand #222970258240:  Hold'em No Limit ($0.05/$0.10 USD) - 2021/01/23 15:47:20 ET
Table 'Stephano III' 6-max Seat #6 is the button
Seat 1: andrew_yar ($10.52 in chips) 
Seat 2: perespell ($10.16 in chips) 
Seat 3: Mark86F ($9.68 in chips) 
Seat 4: Kobert72 ($10 in chips) 
Seat 5: JohnnyVido ($13.11 in chips) 
Seat 6: RUMJO ($10.72 in chips) 
andrew_yar: posts small blind $0.05
perespell: posts big blind $0.10
*** HOLE CARDS ***
Mark86F: raises $0.10 to $0.20
Kobert72: folds 
JohnnyVido: folds 
RUMJO: folds 
andrew_yar: calls $0.15
perespell: folds 
*** FLOP *** [3d 9c Ts]
andrew_yar: checks 
Mark86F: checks 
*** TURN *** [3d 9c Ts] [Ad]
andrew_yar: bets $0.32
Mark86F: calls $0.32
*** RIVER *** [3d 9c Ts Ad] [2s]
andrew_yar: bets $0.73
Mark86F: calls $0.73
*** SHOW DOWN ***
andrew_yar: shows [3s 3c] (three of a kind, Threes)
Mark86F: mucks hand 
andrew_yar collected $2.48 from pot
*** SUMMARY ***
Total pot $2.60 | Rake $0.12 
Board [3d 9c Ts Ad 2s]
Seat 1: andrew_yar (small blind) showed [3s 3c] and won ($2.48) with three of a kind, Threes
Seat 2: perespell (big blind) folded before Flop
Seat 3: Mark86F mucked
Seat 4: Kobert72 folded before Flop (didn't bet)
Seat 5: JohnnyVido folded before Flop (didn't bet)
Seat 6: RUMJO (button) folded before Flop (didn't bet)



PokerStars Hand #222970303662:  Hold'em No Limit ($0.05/$0.10 USD) - 2021/01/23 15:48:15 ET
Table 'Stephano III' 6-max Seat #1 is the button
Seat 1: andrew_yar ($11.75 in chips) 
Seat 2: perespell ($10.06 in chips) 
Seat 3: Mark86F ($8.43 in chips) 
Seat 4: Kobert72 ($10 in chips) 
Seat 5: JohnnyVido ($13.11 in chips) 
Seat 6: RUMJO ($10.72 in chips) 
perespell: posts small blind $0.05
Mark86F: posts big blind $0.10
*** HOLE CARDS ***
Kobert72: raises $0.13 to $0.23
JohnnyVido: folds 
RUMJO: folds 
andrew_yar: folds 
perespell: folds 
Mark86F: calls $0.13
*** FLOP *** [8h 4h 9d]
Mark86F: checks 
Kobert72: bets $0.37
Mark86F: folds 
Uncalled bet ($0.37) returned to Kobert72
Kobert72 collected $0.49 from pot
Kobert72: doesn't show hand 
*** SUMMARY ***
Total pot $0.51 | Rake $0.02 
Board [8h 4h 9d]
Seat 1: andrew_yar (button) folded before Flop (didn't bet)
Seat 2: perespell (small blind) folded before Flop
Seat 3: Mark86F (big blind) folded on the Flop
Seat 4: Kobert72 collected ($0.49)
Seat 5: JohnnyVido folded before Flop (didn't bet)
Seat 6: RUMJO folded before Flop (didn't bet)



PokerStars Hand #222970327028:  Hold'em No Limit ($0.05/$0.10 USD) - 2021/01/23 15:48:43 ET
Table 'Stephano III' 6-max Seat #2 is the button
Seat 1: andrew_yar ($11.75 in chips) 
Seat 2: perespell ($10.01 in chips) 
Seat 3: Mark86F ($8.20 in chips) 
Seat 4: Kobert72 ($10.26 in chips) 
Seat 5: JohnnyVido ($13.11 in chips) 
Seat 6: RUMJO ($10.72 in chips) 
Mark86F: posts small blind $0.05
Kobert72: posts big blind $0.10
*** HOLE CARDS ***
JohnnyVido: raises $0.25 to $0.35
RUMJO: folds 
andrew_yar: folds 
perespell: folds 
Mark86F: calls $0.30
Kobert72: folds 
*** FLOP *** [Td 9s 3s]
Mark86F: checks 
JohnnyVido: bets $0.38
Mark86F: calls $0.38
*** TURN *** [Td 9s 3s] [4d]
Mark86F: checks 
JohnnyVido: bets $0.80
Mark86F: folds 
Uncalled bet ($0.80) returned to JohnnyVido
JohnnyVido collected $1.49 from pot
JohnnyVido: doesn't show hand 
*** SUMMARY ***
Total pot $1.56 | Rake $0.07 
Board [Td 9s 3s 4d]
Seat 1: andrew_yar folded before Flop (didn't bet)
Seat 2: perespell (button) folded before Flop (didn't bet)
Seat 3: Mark86F (small blind) folded on the Turn
Seat 4: Kobert72 (big blind) folded before Flop
Seat 5: JohnnyVido collected ($1.49)
Seat 6: RUMJO folded before Flop (didn't bet)



PokerStars Hand #222970366897:  Hold'em No Limit ($0.05/$0.10 USD) - 2021/01/23 15:49:31 ET
Table 'Stephano III' 6-max Seat #3 is the button
Seat 1: andrew_yar ($11.75 in chips) 
Seat 2: perespell ($10.01 in chips) 
Seat 3: Mark86F ($7.47 in chips) 
Seat 4: Kobert72 ($10.16 in chips) 
Seat 5: JohnnyVido ($13.87 in chips) 
Seat 6: RUMJO ($10.72 in chips) 
Kobert72: posts small blind $0.05
JohnnyVido: posts big blind $0.10
*** HOLE CARDS ***
RUMJO: folds 
andrew_yar: raises $0.20 to $0.30
perespell: folds 
Mark86F: folds 
Kobert72: folds 
JohnnyVido: raises $0.70 to $1
andrew_yar: folds 
Uncalled bet ($0.70) returned to JohnnyVido
JohnnyVido collected $0.65 from pot
JohnnyVido: doesn't show hand 
*** SUMMARY ***
Total pot $0.65 | Rake $0 
Seat 1: andrew_yar folded before Flop
Seat 2: perespell folded before Flop (didn't bet)
Seat 3: Mark86F (button) folded before Flop (didn't bet)
Seat 4: Kobert72 (small blind) folded before Flop
Seat 5: JohnnyVido (big blind) collected ($0.65)
Seat 6: RUMJO folded before Flop (didn't bet)



PokerStars Hand #222970379304:  Hold'em No Limit ($0.05/$0.10 USD) - 2021/01/23 15:49:46 ET
Table 'Stephano III' 6-max Seat #4 is the button
Seat 1: andrew_yar ($11.45 in chips) 
Seat 2: perespell ($10.01 in chips) 
Seat 3: Mark86F ($7.47 in chips) 
Seat 4: Kobert72 ($10.11 in chips) 
Seat 5: JohnnyVido ($14.22 in chips) 
Seat 6: RUMJO ($10.72 in chips) 
JohnnyVido: posts small blind $0.05
RUMJO: posts big blind $0.10
*** HOLE CARDS ***
andrew_yar: folds 
perespell: folds 
Mark86F: folds 
Kobert72: folds 
JohnnyVido: folds 
Uncalled bet ($0.05) returned to RUMJO
RUMJO collected $0.10 from pot
RUMJO: doesn't show hand 
*** SUMMARY ***
Total pot $0.10 | Rake $0 
Seat 1: andrew_yar folded before Flop (didn't bet)
Seat 2: perespell folded before Flop (didn't bet)
Seat 3: Mark86F folded before Flop (didn't bet)
Seat 4: Kobert72 (button) folded before Flop (didn't bet)
Seat 5: JohnnyVido (small blind) folded before Flop
Seat 6: RUMJO (big blind) collected ($0.10)



PokerStars Hand #222970390380:  Hold'em No Limit ($0.05/$0.10 USD) - 2021/01/23 15:49:59 ET
Table 'Stephano III' 6-max Seat #5 is the button
Seat 1: andrew_yar ($11.45 in chips) 
Seat 2: perespell ($10.01 in chips) 
Seat 3: Mark86F ($7.47 in chips) 
Seat 4: Kobert72 ($10.11 in chips) 
Seat 5: JohnnyVido ($14.17 in chips) 
Seat 6: RUMJO ($10.77 in chips) 
RUMJO: posts small blind $0.05
andrew_yar: posts big blind $0.10
*** HOLE CARDS ***
perespell: folds 
Mark86F: calls $0.10
Kobert72: folds 
JohnnyVido: folds 
RUMJO: raises $0.30 to $0.40
andrew_yar: folds 
Mark86F: calls $0.30
*** FLOP *** [7s 4d 4s]
RUMJO: checks 
Mark86F: checks 
*** TURN *** [7s 4d 4s] [6h]
RUMJO: checks 
Mark86F: bets $0.20
RUMJO: raises $0.50 to $0.70
Mark86F: folds 
Uncalled bet ($0.50) returned to RUMJO
RUMJO collected $1.24 from pot
RUMJO: doesn't show hand 
*** SUMMARY ***
Total pot $1.30 | Rake $0.06 
Board [7s 4d 4s 6h]
Seat 1: andrew_yar (big blind) folded before Flop
Seat 2: perespell folded before Flop (didn't bet)
Seat 3: Mark86F folded on the Turn
Seat 4: Kobert72 folded before Flop (didn't bet)
Seat 5: JohnnyVido (button) folded before Flop (didn't bet)
Seat 6: RUMJO (small blind) collected ($1.24)



PokerStars Hand #222970424123:  Hold'em No Limit ($0.05/$0.10 USD) - 2021/01/23 15:50:40 ET
Table 'Stephano III' 6-max Seat #6 is the button
Seat 1: andrew_yar ($11.35 in chips) 
Seat 2: perespell ($10.01 in chips) 
Seat 3: Mark86F ($6.87 in chips) 
Seat 4: Kobert72 ($10.11 in chips) 
Seat 5: JohnnyVido ($14.17 in chips) 
Seat 6: RUMJO ($11.41 in chips) 
andrew_yar: posts small blind $0.05
perespell: posts big blind $0.10
*** HOLE CARDS ***
Mark86F: folds 
Kobert72: folds 
Mark86F leaves the table
JohnnyVido: folds 
RUMJO: raises $0.15 to $0.25
andrew_yar: folds 
perespell: folds 
Uncalled bet ($0.15) returned to RUMJO
RUMJO collected $0.25 from pot
RUMJO: doesn't show hand 
*** SUMMARY ***
Total pot $0.25 | Rake $0 
Seat 1: andrew_yar (small blind) folded before Flop
Seat 2: perespell (big blind) folded before Flop
Seat 3: Mark86F folded before Flop (didn't bet)
Seat 4: Kobert72 folded before Flop (didn't bet)
Seat 5: JohnnyVido folded before Flop (didn't bet)
Seat 6: RUMJO (button) collected ($0.25)



PokerStars Hand #222970436935:  Hold'em No Limit ($0.05/$0.10 USD) - 2021/01/23 15:50:55 ET
Table 'Stephano III' 6-max Seat #1 is the button
Seat 1: andrew_yar ($11.30 in chips) 
Seat 2: perespell ($10 in chips) 
Seat 4: Kobert72 ($10.11 in chips) 
Seat 5: JohnnyVido ($14.17 in chips) 
Seat 6: RUMJO ($11.56 in chips) 
perespell: posts small blind $0.05
Kobert72: posts big blind $0.10
*** HOLE CARDS ***
JohnnyVido: raises $0.10 to $0.20
RUMJO: folds 
andrew_yar: folds 
perespell: calls $0.15
Kobert72: folds 
*** FLOP *** [2d 7h Js]
perespell: checks 
JohnnyVido: bets $0.24
perespell: folds 
Uncalled bet ($0.24) returned to JohnnyVido
JohnnyVido collected $0.48 from pot
JohnnyVido: doesn't show hand 
*** SUMMARY ***
Total pot $0.50 | Rake $0.02 
Board [2d 7h Js]
Seat 1: andrew_yar (button) folded before Flop (didn't bet)
Seat 2: perespell (small blind) folded on the Flop
Seat 4: Kobert72 (big blind) folded before Flop
Seat 5: JohnnyVido collected ($0.48)
Seat 6: RUMJO folded before Flop (didn't bet)



PokerStars Hand #222970458556:  Hold'em No Limit ($0.05/$0.10 USD) - 2021/01/23 15:51:21 ET
Table 'Stephano III' 6-max Seat #2 is the button
Seat 1: andrew_yar ($11.30 in chips) 
Seat 2: perespell ($10 in chips) 
Seat 4: Kobert72 ($10.01 in chips) 
Seat 5: JohnnyVido ($14.45 in chips) 
Seat 6: RUMJO ($11.56 in chips) 
Kobert72: posts small blind $0.05
JohnnyVido: posts big blind $0.10
*** HOLE CARDS ***
RUMJO: folds 
andrew_yar: folds 
perespell: raises $0.15 to $0.25
Kobert72: folds 
JohnnyVido: calls $0.15
*** FLOP *** [Jh 5s 3s]
JohnnyVido: checks 
perespell: bets $0.30
JohnnyVido: calls $0.30
*** TURN *** [Jh 5s 3s] [2d]
JohnnyVido: checks 
22888899 joins the table at seat #3 
perespell: bets $0.84
JohnnyVido: folds 
Uncalled bet ($0.84) returned to perespell
perespell collected $1.10 from pot
perespell: doesn't show hand 
*** SUMMARY ***
Total pot $1.15 | Rake $0.05 
Board [Jh 5s 3s 2d]
Seat 1: andrew_yar folded before Flop (didn't bet)
Seat 2: perespell (button) collected ($1.10)
Seat 4: Kobert72 (small blind) folded before Flop
Seat 5: JohnnyVido (big blind) folded on the Turn
Seat 6: RUMJO folded before Flop (didn't bet)



PokerStars Hand #222970481079:  Hold'em No Limit ($0.05/$0.10 USD) - 2021/01/23 15:51:48 ET
Table 'Stephano III' 6-max Seat #4 is the button
Seat 1: andrew_yar ($11.30 in chips) 
Seat 2: perespell ($10.55 in chips) 
Seat 4: Kobert72 ($10 in chips) 
Seat 5: JohnnyVido ($13.90 in chips) 
Seat 6: RUMJO ($11.56 in chips) 
JohnnyVido: posts small blind $0.05
RUMJO: posts big blind $0.10
22888899: sits out 
*** HOLE CARDS ***
andrew_yar: folds 
perespell: folds 
Kobert72: raises $0.13 to $0.23
JohnnyVido: calls $0.18
RUMJO: folds 
*** FLOP *** [Qd 5h 9d]
JohnnyVido: checks 
Kobert72: bets $0.40
JohnnyVido: folds 
Uncalled bet ($0.40) returned to Kobert72
Kobert72 collected $0.53 from pot
Kobert72: doesn't show hand 
*** SUMMARY ***
Total pot $0.56 | Rake $0.03 
Board [Qd 5h 9d]
Seat 1: andrew_yar folded before Flop (didn't bet)
Seat 2: perespell folded before Flop (didn't bet)
Seat 4: Kobert72 (button) collected ($0.53)
Seat 5: JohnnyVido (small blind) folded on the Flop
Seat 6: RUMJO (big blind) folded before Flop



PokerStars Hand #222970499866:  Hold'em No Limit ($0.05/$0.10 USD) - 2021/01/23 15:52:10 ET
Table 'Stephano III' 6-max Seat #5 is the button
Seat 1: andrew_yar ($11.30 in chips) 
Seat 2: perespell ($10.55 in chips) 
Seat 3: 22888899 ($4 in chips) 
Seat 4: Kobert72 ($10.30 in chips) 
Seat 5: JohnnyVido ($13.67 in chips) 
Seat 6: RUMJO ($11.46 in chips) 
RUMJO: posts small blind $0.05
andrew_yar: posts big blind $0.10
22888899: posts big blind $0.10
*** HOLE CARDS ***
perespell: raises $0.30 to $0.40
22888899: calls $0.30
Kobert72: folds 
JohnnyVido: calls $0.40
RUMJO: folds 
andrew_yar: folds 
*** FLOP *** [Kh 4d 6s]
perespell: checks 
22888899: bets $0.64
JohnnyVido: calls $0.64
perespell: calls $0.64
*** TURN *** [Kh 4d 6s] [9d]
perespell: checks 
22888899: bets $2.96 and is all-in
JohnnyVido: folds 
perespell: calls $2.96
*** RIVER *** [Kh 4d 6s 9d] [4s]
*** SHOW DOWN ***
perespell: shows [Qs Ks] (two pair, Kings and Fours)
22888899: shows [2d Kc] (two pair, Kings and Fours - lower kicker)
perespell cashed out the hand for $8.11 | Cash Out Fee $0.08
*** SUMMARY ***
Total pot $9.19 | Rake $0.41 
Board [Kh 4d 6s 9d 4s]
Seat 1: andrew_yar (big blind) folded before Flop
Seat 2: perespell showed [Qs Ks] and won ($8.78) with two pair, Kings and Fours (pot not awarded as player cashed out)
Seat 3: 22888899 showed [2d Kc] and lost with two pair, Kings and Fours
Seat 4: Kobert72 folded before Flop (didn't bet)
Seat 5: JohnnyVido (button) folded on the Turn
Seat 6: RUMJO (small blind) folded before Flop



PokerStars Hand #222970539172:  Hold'em No Limit ($0.05/$0.10 USD) - 2021/01/23 15:52:57 ET
Table 'Stephano III' 6-max Seat #6 is the button
Seat 1: andrew_yar ($11.20 in chips) 
Seat 2: perespell ($14.66 in chips) 
Seat 4: Kobert72 ($10.30 in chips) 
Seat 5: JohnnyVido ($12.63 in chips) 
Seat 6: RUMJO ($11.41 in chips) 
andrew_yar: posts small blind $0.05
perespell: posts big blind $0.10
*** HOLE CARDS ***
Kobert72: raises $0.13 to $0.23
JohnnyVido: calls $0.23
RUMJO: folds 
andrew_yar: calls $0.18
perespell: calls $0.13
*** FLOP *** [Jc 7d Td]
andrew_yar: checks 
perespell: checks 
Kobert72: checks 
JohnnyVido: bets $0.88
andrew_yar: folds 
perespell: folds 
Kobert72: calls $0.88
*** TURN *** [Jc 7d Td] [7c]
Kobert72: checks 
JohnnyVido: bets $1.28
Kobert72: calls $1.28
*** RIVER *** [Jc 7d Td 7c] [Js]
Kobert72: checks 
JohnnyVido: checks 
*** SHOW DOWN ***
Kobert72: shows [8c Tc] (two pair, Jacks and Tens)
JohnnyVido: shows [Kh Kc] (two pair, Kings and Jacks)
JohnnyVido collected $5 from pot
*** SUMMARY ***
Total pot $5.24 | Rake $0.24 
Board [Jc 7d Td 7c Js]
Seat 1: andrew_yar (small blind) folded on the Flop
Seat 2: perespell (big blind) folded on the Flop
Seat 4: Kobert72 showed [8c Tc] and lost with two pair, Jacks and Tens
Seat 5: JohnnyVido showed [Kh Kc] and won ($5) with two pair, Kings and Jacks
Seat 6: RUMJO (button) folded before Flop (didn't bet)



PokerStars Hand #222970588260:  Hold'em No Limit ($0.05/$0.10 USD) - 2021/01/23 15:53:56 ET
Table 'Stephano III' 6-max Seat #1 is the button
Seat 1: andrew_yar ($10.97 in chips) 
Seat 2: perespell ($14.43 in chips) 
Seat 3: 22888899 ($4 in chips) 
Seat 4: Kobert72 ($10 in chips) 
Seat 5: JohnnyVido ($15.24 in chips) 
Seat 6: RUMJO ($11.41 in chips) 
perespell: posts small blind $0.05
22888899: posts big blind $0.10
*** HOLE CARDS ***
Kobert72: folds 
JohnnyVido: folds 
RUMJO: folds 
andrew_yar: raises $0.15 to $0.25
perespell: calls $0.20
22888899: calls $0.15
*** FLOP *** [3h Js Jd]
perespell: checks 
22888899: checks 
andrew_yar: checks 
*** TURN *** [3h Js Jd] [3c]
perespell: checks 
22888899: checks 
andrew_yar: checks 
*** RIVER *** [3h Js Jd 3c] [5s]
perespell: checks 
22888899: checks 
andrew_yar: checks 
*** SHOW DOWN ***
perespell: shows [5c Kc] (two pair, Jacks and Fives)
22888899: mucks hand 
andrew_yar: mucks hand 
perespell collected $0.72 from pot
*** SUMMARY ***
Total pot $0.75 | Rake $0.03 
Board [3h Js Jd 3c 5s]
Seat 1: andrew_yar (button) mucked
Seat 2: perespell (small blind) showed [5c Kc] and won ($0.72) with two pair, Jacks and Fives
Seat 3: 22888899 (big blind) mucked
Seat 4: Kobert72 folded before Flop (didn't bet)
Seat 5: JohnnyVido folded before Flop (didn't bet)
Seat 6: RUMJO folded before Flop (didn't bet)



PokerStars Hand #222970623039:  Hold'em No Limit ($0.05/$0.10 USD) - 2021/01/23 15:54:39 ET
Table 'Stephano III' 6-max Seat #2 is the button
Seat 1: andrew_yar ($10.72 in chips) 
Seat 2: perespell ($14.90 in chips) 
Seat 3: 22888899 ($3.75 in chips) 
Seat 4: Kobert72 ($10 in chips) 
Seat 5: JohnnyVido ($15.24 in chips) 
Seat 6: RUMJO ($11.41 in chips) 
22888899: posts small blind $0.05
Kobert72: posts big blind $0.10
*** HOLE CARDS ***
JohnnyVido: folds 
RUMJO: folds 
andrew_yar: folds 
perespell: folds 
22888899: calls $0.05
Kobert72: checks 
*** FLOP *** [4s 8c 4c]
22888899: checks 
Kobert72: checks 
*** TURN *** [4s 8c 4c] [8h]
22888899: checks 
Kobert72: bets $0.10
22888899: folds 
Uncalled bet ($0.10) returned to Kobert72
Kobert72 collected $0.19 from pot
Kobert72: doesn't show hand 
*** SUMMARY ***
Total pot $0.20 | Rake $0.01 
Board [4s 8c 4c 8h]
Seat 1: andrew_yar folded before Flop (didn't bet)
Seat 2: perespell (button) folded before Flop (didn't bet)
Seat 3: 22888899 (small blind) folded on the Turn
Seat 4: Kobert72 (big blind) collected ($0.19)
Seat 5: JohnnyVido folded before Flop (didn't bet)
Seat 6: RUMJO folded before Flop (didn't bet)



PokerStars Hand #222970659831:  Hold'em No Limit ($0.05/$0.10 USD) - 2021/01/23 15:55:30 ET
Table 'Stephano III' 6-max Seat #3 is the button
Seat 1: andrew_yar ($10.72 in chips) 
Seat 2: perespell ($14.90 in chips) 
Seat 3: 22888899 ($3.65 in chips) 
Seat 4: Kobert72 ($10.09 in chips) 
Seat 5: JohnnyVido ($15.24 in chips) 
Seat 6: RUMJO ($11.41 in chips) 
Kobert72: posts small blind $0.05
JohnnyVido: posts big blind $0.10
*** HOLE CARDS ***
RUMJO: folds 
andrew_yar: folds 
perespell: folds 
22888899: raises $0.25 to $0.35
Kobert72: folds 
JohnnyVido: folds 
Uncalled bet ($0.25) returned to 22888899
22888899 collected $0.25 from pot
22888899: doesn't show hand 
*** SUMMARY ***
Total pot $0.25 | Rake $0 
Seat 1: andrew_yar folded before Flop (didn't bet)
Seat 2: perespell folded before Flop (didn't bet)
Seat 3: 22888899 (button) collected ($0.25)
Seat 4: Kobert72 (small blind) folded before Flop
Seat 5: JohnnyVido (big blind) folded before Flop
Seat 6: RUMJO folded before Flop (didn't bet)



PokerStars Hand #222970667228:  Hold'em No Limit ($0.05/$0.10 USD) - 2021/01/23 15:55:44 ET
Table 'Stephano III' 6-max Seat #4 is the button
Seat 1: andrew_yar ($10.72 in chips) 
Seat 2: perespell ($14.90 in chips) 
Seat 3: 22888899 ($3.80 in chips) 
Seat 4: Kobert72 ($10.04 in chips) 
Seat 5: JohnnyVido ($15.14 in chips) 
Seat 6: RUMJO ($11.41 in chips) 
JohnnyVido: posts small blind $0.05
RUMJO: posts big blind $0.10
*** HOLE CARDS ***
andrew_yar: folds 
perespell: folds 
22888899: raises $3.70 to $3.80 and is all-in
Kobert72: folds 
JohnnyVido: folds 
RUMJO: folds 
Uncalled bet ($3.70) returned to 22888899
22888899 collected $0.25 from pot
22888899: doesn't show hand 
*** SUMMARY ***
Total pot $0.25 | Rake $0 
Seat 1: andrew_yar folded before Flop (didn't bet)
Seat 2: perespell folded before Flop (didn't bet)
Seat 3: 22888899 collected ($0.25)
Seat 4: Kobert72 (button) folded before Flop (didn't bet)
Seat 5: JohnnyVido (small blind) folded before Flop
Seat 6: RUMJO (big blind) folded before Flop



PokerStars Hand #222970681318:  Hold'em No Limit ($0.05/$0.10 USD) - 2021/01/23 15:55:59 ET
Table 'Stephano III' 6-max Seat #5 is the button
Seat 1: andrew_yar ($10.72 in chips) 
Seat 2: perespell ($14.90 in chips) 
Seat 3: 22888899 ($3.95 in chips) 
Seat 4: Kobert72 ($10.04 in chips) 
Seat 5: JohnnyVido ($15.09 in chips) 
Seat 6: RUMJO ($11.31 in chips) 
RUMJO: posts small blind $0.05
andrew_yar: posts big blind $0.10
*** HOLE CARDS ***
perespell: folds 
22888899: folds 
Kobert72: folds 
JohnnyVido: folds 
RUMJO: folds 
Uncalled bet ($0.05) returned to andrew_yar
andrew_yar collected $0.10 from pot
andrew_yar: doesn't show hand 
*** SUMMARY ***
Total pot $0.10 | Rake $0 
Seat 1: andrew_yar (big blind) collected ($0.10)
Seat 2: perespell folded before Flop (didn't bet)
Seat 3: 22888899 folded before Flop (didn't bet)
Seat 4: Kobert72 folded before Flop (didn't bet)
Seat 5: JohnnyVido (button) folded before Flop (didn't bet)
Seat 6: RUMJO (small blind) folded before Flop



PokerStars Hand #222970685675:  Hold'em No Limit ($0.05/$0.10 USD) - 2021/01/23 15:56:07 ET
Table 'Stephano III' 6-max Seat #6 is the button
Seat 1: andrew_yar ($10.77 in chips) 
Seat 2: perespell ($14.90 in chips) 
Seat 3: 22888899 ($3.95 in chips) 
Seat 4: Kobert72 ($10.04 in chips) 
Seat 5: JohnnyVido ($15.09 in chips) 
Seat 6: RUMJO ($11.26 in chips) 
andrew_yar: posts small blind $0.05
perespell: posts big blind $0.10
*** HOLE CARDS ***
22888899: folds 
Kobert72: raises $0.13 to $0.23
JohnnyVido: calls $0.23
RUMJO: folds 
andrew_yar: calls $0.18
perespell: folds 
*** FLOP *** [3d 5h 9h]
andrew_yar: checks 
Kobert72: checks 
JohnnyVido: bets $0.38
andrew_yar: calls $0.38
Kobert72: calls $0.38
*** TURN *** [3d 5h 9h] [4c]
andrew_yar: checks 
Kobert72: checks 
JohnnyVido: checks 
*** RIVER *** [3d 5h 9h 4c] [8s]
andrew_yar: bets $0.92
Kobert72: calls $0.92
JohnnyVido: folds 
*** SHOW DOWN ***
andrew_yar: shows [6d 7d] (a straight, Five to Nine)
Kobert72: mucks hand 
andrew_yar collected $3.60 from pot
*** SUMMARY ***
Total pot $3.77 | Rake $0.17 
Board [3d 5h 9h 4c 8s]
Seat 1: andrew_yar (small blind) showed [6d 7d] and won ($3.60) with a straight, Five to Nine
Seat 2: perespell (big blind) folded before Flop
Seat 3: 22888899 folded before Flop (didn't bet)
Seat 4: Kobert72 mucked
Seat 5: JohnnyVido folded on the River
Seat 6: RUMJO (button) folded before Flop (didn't bet)



PokerStars Hand #222970713014:  Hold'em No Limit ($0.05/$0.10 USD) - 2021/01/23 15:56:55 ET
Table 'Stephano III' 6-max Seat #1 is the button
Seat 1: andrew_yar ($12.84 in chips) 
Seat 2: perespell ($14.80 in chips) 
Seat 3: 22888899 ($3.95 in chips) 
Seat 4: Kobert72 ($10 in chips) 
Seat 5: JohnnyVido ($14.48 in chips) 
Seat 6: RUMJO ($11.26 in chips) 
perespell: posts small blind $0.05
22888899: posts big blind $0.10
*** HOLE CARDS ***
Kobert72: folds 
JohnnyVido: folds 
RUMJO: raises $0.15 to $0.25
andrew_yar: folds 
perespell: calls $0.20
22888899: raises $0.75 to $1
RUMJO: folds 
perespell: folds 
Uncalled bet ($0.75) returned to 22888899
22888899 collected $0.75 from pot
22888899: doesn't show hand 
*** SUMMARY ***
Total pot $0.75 | Rake $0 
Seat 1: andrew_yar (button) folded before Flop (didn't bet)
Seat 2: perespell (small blind) folded before Flop
Seat 3: 22888899 (big blind) collected ($0.75)
Seat 4: Kobert72 folded before Flop (didn't bet)
Seat 5: JohnnyVido folded before Flop (didn't bet)
Seat 6: RUMJO folded before Flop



PokerStars Hand #222970725083:  Hold'em No Limit ($0.05/$0.10 USD) - 2021/01/23 15:57:17 ET
Table 'Stephano III' 6-max Seat #2 is the button
Seat 1: andrew_yar ($12.84 in chips) 
Seat 2: perespell ($14.55 in chips) 
Seat 3: 22888899 ($4.45 in chips) 
Seat 4: Kobert72 ($10 in chips) 
Seat 5: JohnnyVido ($14.48 in chips) 
Seat 6: RUMJO ($11.01 in chips) 
22888899: posts small blind $0.05
Kobert72: posts big blind $0.10
*** HOLE CARDS ***
JohnnyVido: calls $0.10
RUMJO: folds 
andrew_yar: folds 
perespell: raises $0.30 to $0.40
22888899: folds 
Kobert72: folds 
JohnnyVido: folds 
Uncalled bet ($0.30) returned to perespell
perespell collected $0.35 from pot
perespell: doesn't show hand 
*** SUMMARY ***
Total pot $0.35 | Rake $0 
Seat 1: andrew_yar folded before Flop (didn't bet)
Seat 2: perespell (button) collected ($0.35)
Seat 3: 22888899 (small blind) folded before Flop
Seat 4: Kobert72 (big blind) folded before Flop
Seat 5: JohnnyVido folded before Flop
Seat 6: RUMJO folded before Flop (didn't bet)



PokerStars Hand #222970737141:  Hold'em No Limit ($0.05/$0.10 USD) - 2021/01/23 15:57:38 ET
Table 'Stephano III' 6-max Seat #3 is the button
Seat 1: andrew_yar ($12.84 in chips) 
Seat 2: perespell ($14.80 in chips) 
Seat 3: 22888899 ($4.40 in chips) 
Seat 4: Kobert72 ($10 in chips) 
Seat 5: JohnnyVido ($14.38 in chips) 
Seat 6: RUMJO ($11.01 in chips) 
Kobert72: posts small blind $0.05
JohnnyVido: posts big blind $0.10
*** HOLE CARDS ***
RUMJO: raises $0.15 to $0.25
andrew_yar: folds 
perespell: calls $0.25
22888899: calls $0.25
Kobert72: folds 
JohnnyVido: calls $0.15
*** FLOP *** [Td 8d 2s]
JohnnyVido: checks 
RUMJO: checks 
perespell: checks 
22888899: checks 
*** TURN *** [Td 8d 2s] [6h]
JohnnyVido: bets $0.10
RUMJO: raises $0.40 to $0.50
perespell: folds 
22888899: folds 
JohnnyVido: folds 
Uncalled bet ($0.40) returned to RUMJO
RUMJO collected $1.19 from pot
RUMJO: doesn't show hand 
*** SUMMARY ***
Total pot $1.25 | Rake $0.06 
Board [Td 8d 2s 6h]
Seat 1: andrew_yar folded before Flop (didn't bet)
Seat 2: perespell folded on the Turn
Seat 3: 22888899 (button) folded on the Turn
Seat 4: Kobert72 (small blind) folded before Flop
Seat 5: JohnnyVido (big blind) folded on the Turn
Seat 6: RUMJO collected ($1.19)



PokerStars Hand #222970765484:  Hold'em No Limit ($0.05/$0.10 USD) - 2021/01/23 15:58:28 ET
Table 'Stephano III' 6-max Seat #4 is the button
Seat 1: andrew_yar ($12.84 in chips) 
Seat 2: perespell ($14.55 in chips) 
Seat 3: 22888899 ($4.15 in chips) 
Seat 4: Kobert72 ($10 in chips) 
Seat 5: JohnnyVido ($14.03 in chips) 
Seat 6: RUMJO ($11.85 in chips) 
JohnnyVido: posts small blind $0.05
RUMJO: posts big blind $0.10
*** HOLE CARDS ***
andrew_yar: folds 
perespell: raises $0.15 to $0.25
22888899: folds 
Kobert72: calls $0.25
JohnnyVido: calls $0.20
RUMJO: folds 
*** FLOP *** [9c 7c 2s]
JohnnyVido: checks 
perespell: checks 
Kobert72: checks 
*** TURN *** [9c 7c 2s] [5h]
JohnnyVido: checks 
perespell: checks 
Kobert72: checks 
*** RIVER *** [9c 7c 2s 5h] [Jc]
JohnnyVido: checks 
perespell: checks 
Kobert72: checks 
*** SHOW DOWN ***
JohnnyVido: shows [Ad 8s] (high card Ace)
perespell: shows [Td Ac] (high card Ace - Jack+Ten kicker)
Kobert72: shows [4c 4d] (a pair of Fours)
Kobert72 collected $0.81 from pot
*** SUMMARY ***
Total pot $0.85 | Rake $0.04 
Board [9c 7c 2s 5h Jc]
Seat 1: andrew_yar folded before Flop (didn't bet)
Seat 2: perespell showed [Td Ac] and lost with high card Ace
Seat 3: 22888899 folded before Flop (didn't bet)
Seat 4: Kobert72 (button) showed [4c 4d] and won ($0.81) with a pair of Fours
Seat 5: JohnnyVido (small blind) showed [Ad 8s] and lost with high card Ace
Seat 6: RUMJO (big blind) folded before Flop



PokerStars Hand #222970786693:  Hold'em No Limit ($0.05/$0.10 USD) - 2021/01/23 15:59:05 ET
Table 'Stephano III' 6-max Seat #5 is the button
Seat 1: andrew_yar ($12.84 in chips) 
Seat 2: perespell ($14.30 in chips) 
Seat 3: 22888899 ($4.15 in chips) 
Seat 4: Kobert72 ($10.56 in chips) 
Seat 5: JohnnyVido ($13.78 in chips) 
Seat 6: RUMJO ($11.75 in chips) 
RUMJO: posts small blind $0.05
andrew_yar: posts big blind $0.10
*** HOLE CARDS ***
perespell: folds 
22888899: folds 
Kobert72: folds 
JohnnyVido: folds 
RUMJO: folds 
Uncalled bet ($0.05) returned to andrew_yar
andrew_yar collected $0.10 from pot
andrew_yar: doesn't show hand 
*** SUMMARY ***
Total pot $0.10 | Rake $0 
Seat 1: andrew_yar (big blind) collected ($0.10)
Seat 2: perespell folded before Flop (didn't bet)
Seat 3: 22888899 folded before Flop (didn't bet)
Seat 4: Kobert72 folded before Flop (didn't bet)
Seat 5: JohnnyVido (button) folded before Flop (didn't bet)
Seat 6: RUMJO (small blind) folded before Flop



PokerStars Hand #222970791162:  Hold'em No Limit ($0.05/$0.10 USD) - 2021/01/23 15:59:13 ET
Table 'Stephano III' 6-max Seat #6 is the button
Seat 1: andrew_yar ($12.89 in chips) 
Seat 2: perespell ($14.30 in chips) 
Seat 3: 22888899 ($4.15 in chips) 
Seat 4: Kobert72 ($10.56 in chips) 
Seat 5: JohnnyVido ($13.78 in chips) 
Seat 6: RUMJO ($11.70 in chips) 
andrew_yar: posts small blind $0.05
perespell: posts big blind $0.10
*** HOLE CARDS ***
22888899: calls $0.10
Kobert72: folds 
JohnnyVido: folds 
RUMJO: folds 
andrew_yar: calls $0.05
perespell: checks 
*** FLOP *** [4c Ah Qc]
andrew_yar: checks 
perespell: checks 
22888899: checks 
*** TURN *** [4c Ah Qc] [8d]
andrew_yar: checks 
perespell: checks 
22888899: checks 
*** RIVER *** [4c Ah Qc 8d] [Qh]
andrew_yar: checks 
perespell: checks 
22888899: checks 
*** SHOW DOWN ***
andrew_yar: shows [9d Th] (a pair of Queens)
perespell: shows [Kd 9c] (a pair of Queens - Ace+King kicker)
22888899: mucks hand 
perespell collected $0.29 from pot
*** SUMMARY ***
Total pot $0.30 | Rake $0.01 
Board [4c Ah Qc 8d Qh]
Seat 1: andrew_yar (small blind) showed [9d Th] and lost with a pair of Queens
Seat 2: perespell (big blind) showed [Kd 9c] and won ($0.29) with a pair of Queens
Seat 3: 22888899 mucked
Seat 4: Kobert72 folded before Flop (didn't bet)
Seat 5: JohnnyVido folded before Flop (didn't bet)
Seat 6: RUMJO (button) folded before Flop (didn't bet)



PokerStars Hand #222970811607:  Hold'em No Limit ($0.05/$0.10 USD) - 2021/01/23 15:59:49 ET
Table 'Stephano III' 6-max Seat #1 is the button
Seat 1: andrew_yar ($12.79 in chips) 
Seat 2: perespell ($14.49 in chips) 
Seat 3: 22888899 ($4.05 in chips) 
Seat 4: Kobert72 ($10.56 in chips) 
Seat 5: JohnnyVido ($13.78 in chips) 
Seat 6: RUMJO ($11.70 in chips) 
perespell: posts small blind $0.05
22888899: posts big blind $0.10
*** HOLE CARDS ***
Kobert72: folds 
JohnnyVido: folds 
RUMJO: folds 
andrew_yar: folds 
perespell: folds 
Uncalled bet ($0.05) returned to 22888899
22888899 collected $0.10 from pot
22888899: doesn't show hand 
*** SUMMARY ***
Total pot $0.10 | Rake $0 
Seat 1: andrew_yar (button) folded before Flop (didn't bet)
Seat 2: perespell (small blind) folded before Flop
Seat 3: 22888899 (big blind) collected ($0.10)
Seat 4: Kobert72 folded before Flop (didn't bet)
Seat 5: JohnnyVido folded before Flop (didn't bet)
Seat 6: RUMJO folded before Flop (didn't bet)



PokerStars Hand #222970821275:  Hold'em No Limit ($0.05/$0.10 USD) - 2021/01/23 16:00:05 ET
Table 'Stephano III' 6-max Seat #2 is the button
Seat 1: andrew_yar ($12.79 in chips) 
Seat 2: perespell ($14.44 in chips) 
Seat 3: 22888899 ($4.10 in chips) 
Seat 4: Kobert72 ($10.56 in chips) 
Seat 5: JohnnyVido ($13.78 in chips) 
Seat 6: RUMJO ($11.70 in chips) 
22888899: posts small blind $0.05
Kobert72: posts big blind $0.10
*** HOLE CARDS ***
JohnnyVido: folds 
RUMJO: folds 
andrew_yar: folds 
perespell: raises $0.15 to $0.25
22888899: raises $0.60 to $0.85
Kobert72: folds 
perespell: folds 
Uncalled bet ($0.60) returned to 22888899
22888899 collected $0.60 from pot
22888899: doesn't show hand 
*** SUMMARY ***
Total pot $0.60 | Rake $0 
Seat 1: andrew_yar folded before Flop (didn't bet)
Seat 2: perespell (button) folded before Flop
Seat 3: 22888899 (small blind) collected ($0.60)
Seat 4: Kobert72 (big blind) folded before Flop
Seat 5: JohnnyVido folded before Flop (didn't bet)
Seat 6: RUMJO folded before Flop (didn't bet)



PokerStars Hand #222970834693:  Hold'em No Limit ($0.05/$0.10 USD) - 2021/01/23 16:00:27 ET
Table 'Stephano III' 6-max Seat #3 is the button
Seat 1: andrew_yar ($12.79 in chips) 
Seat 2: perespell ($14.19 in chips) 
Seat 3: 22888899 ($4.45 in chips) 
Seat 4: Kobert72 ($10.46 in chips) 
Seat 5: JohnnyVido ($13.78 in chips) 
Seat 6: RUMJO ($11.70 in chips) 
Kobert72: posts small blind $0.05
JohnnyVido: posts big blind $0.10
*** HOLE CARDS ***
RUMJO: folds 
andrew_yar: folds 
perespell: raises $0.15 to $0.25
22888899: raises $0.65 to $0.90
Kobert72: folds 
JohnnyVido: calls $0.80
perespell: folds 
*** FLOP *** [5h 7c Qh]
JohnnyVido: checks 
22888899: bets $1
JohnnyVido: calls $1
*** TURN *** [5h 7c Qh] [2c]
JohnnyVido: checks 
22888899: bets $2.55 and is all-in
JohnnyVido: folds 
Uncalled bet ($2.55) returned to 22888899
22888899 collected $3.92 from pot
22888899: doesn't show hand 
*** SUMMARY ***
Total pot $4.10 | Rake $0.18 
Board [5h 7c Qh 2c]
Seat 1: andrew_yar folded before Flop (didn't bet)
Seat 2: perespell folded before Flop
Seat 3: 22888899 (button) collected ($3.92)
Seat 4: Kobert72 (small blind) folded before Flop
Seat 5: JohnnyVido (big blind) folded on the Turn
Seat 6: RUMJO folded before Flop (didn't bet)



PokerStars Hand #222970853249:  Hold'em No Limit ($0.05/$0.10 USD) - 2021/01/23 16:00:56 ET
Table 'Stephano III' 6-max Seat #4 is the button
Seat 1: andrew_yar ($12.79 in chips) 
Seat 2: perespell ($13.94 in chips) 
Seat 3: 22888899 ($6.47 in chips) 
Seat 4: Kobert72 ($10.41 in chips) 
Seat 5: JohnnyVido ($11.88 in chips) 
Seat 6: RUMJO ($11.70 in chips) 
JohnnyVido: posts small blind $0.05
RUMJO: posts big blind $0.10
*** HOLE CARDS ***
andrew_yar: folds 
perespell: folds 
22888899: folds 
Kobert72: folds 
JohnnyVido: raises $0.10 to $0.20
RUMJO: calls $0.10
*** FLOP *** [4d Qd 7d]
JohnnyVido: bets $0.10
RUMJO: folds 
Uncalled bet ($0.10) returned to JohnnyVido
JohnnyVido collected $0.38 from pot
JohnnyVido: doesn't show hand 
*** SUMMARY ***
Total pot $0.40 | Rake $0.02 
Board [4d Qd 7d]
Seat 1: andrew_yar folded before Flop (didn't bet)
Seat 2: perespell folded before Flop (didn't bet)
Seat 3: 22888899 folded before Flop (didn't bet)
Seat 4: Kobert72 (button) folded before Flop (didn't bet)
Seat 5: JohnnyVido (small blind) collected ($0.38)
Seat 6: RUMJO (big blind) folded on the Flop



PokerStars Hand #222970864885:  Hold'em No Limit ($0.05/$0.10 USD) - 2021/01/23 16:01:14 ET
Table 'Stephano III' 6-max Seat #5 is the button
Seat 1: andrew_yar ($12.79 in chips) 
Seat 2: perespell ($13.94 in chips) 
Seat 3: 22888899 ($6.47 in chips) 
Seat 4: Kobert72 ($10.41 in chips) 
Seat 5: JohnnyVido ($12.06 in chips) 
Seat 6: RUMJO ($11.50 in chips) 
RUMJO: posts small blind $0.05
andrew_yar: posts big blind $0.10
*** HOLE CARDS ***
perespell: folds 
22888899: calls $0.10
Kobert72: folds 
JohnnyVido: folds 
RUMJO: folds 
andrew_yar: checks 
*** FLOP *** [8c Ac 5c]
andrew_yar: checks 
22888899: checks 
*** TURN *** [8c Ac 5c] [Ks]
andrew_yar: bets $0.16
22888899: folds 
Uncalled bet ($0.16) returned to andrew_yar
andrew_yar collected $0.24 from pot
andrew_yar: doesn't show hand 
*** SUMMARY ***
Total pot $0.25 | Rake $0.01 
Board [8c Ac 5c Ks]
Seat 1: andrew_yar (big blind) collected ($0.24)
Seat 2: perespell folded before Flop (didn't bet)
Seat 3: 22888899 folded on the Turn
Seat 4: Kobert72 folded before Flop (didn't bet)
Seat 5: JohnnyVido (button) folded before Flop (didn't bet)
Seat 6: RUMJO (small blind) folded before Flop



PokerStars Hand #222970880180:  Hold'em No Limit ($0.05/$0.10 USD) - 2021/01/23 16:01:35 ET
Table 'Stephano III' 6-max Seat #6 is the button
Seat 1: andrew_yar ($12.93 in chips) 
Seat 2: perespell ($13.94 in chips) 
Seat 3: 22888899 ($6.37 in chips) 
Seat 4: Kobert72 ($10.41 in chips) 
Seat 5: JohnnyVido ($12.06 in chips) 
Seat 6: RUMJO ($11.45 in chips) 
andrew_yar: posts small blind $0.05
perespell: posts big blind $0.10
*** HOLE CARDS ***
22888899: calls $0.10
Kobert72: folds 
JohnnyVido: folds 
RUMJO: folds 
andrew_yar: calls $0.05
perespell: checks 
*** FLOP *** [9c 3s 2d]
andrew_yar: checks 
perespell: checks 
22888899: checks 
*** TURN *** [9c 3s 2d] [Tc]
andrew_yar: checks 
perespell: checks 
22888899: bets $0.10
andrew_yar: calls $0.10
perespell: calls $0.10
*** RIVER *** [9c 3s 2d Tc] [9s]
andrew_yar: checks 
perespell: checks 
22888899: bets $0.28
andrew_yar: calls $0.28
perespell: folds 
*** SHOW DOWN ***
22888899: shows [4d Td] (two pair, Tens and Nines)
andrew_yar: shows [Ts 8d] (two pair, Tens and Nines - Eight kicker)
andrew_yar collected $1.11 from pot
*** SUMMARY ***
Total pot $1.16 | Rake $0.05 
Board [9c 3s 2d Tc 9s]
Seat 1: andrew_yar (small blind) showed [Ts 8d] and won ($1.11) with two pair, Tens and Nines
Seat 2: perespell (big blind) folded on the River
Seat 3: 22888899 showed [4d Td] and lost with two pair, Tens and Nines
Seat 4: Kobert72 folded before Flop (didn't bet)
Seat 5: JohnnyVido folded before Flop (didn't bet)
Seat 6: RUMJO (button) folded before Flop (didn't bet)



PokerStars Hand #222970937751:  Hold'em No Limit ($0.05/$0.10 USD) - 2021/01/23 16:02:49 ET
Table 'Stephano III' 6-max Seat #1 is the button
Seat 1: andrew_yar ($13.56 in chips) 
Seat 2: perespell ($13.74 in chips) 
Seat 3: 22888899 ($5.89 in chips) 
Seat 4: Kobert72 ($10.41 in chips) 
Seat 5: JohnnyVido ($12.06 in chips) 
Seat 6: RUMJO ($11.45 in chips) 
perespell: posts small blind $0.05
22888899: posts big blind $0.10
*** HOLE CARDS ***
Kobert72: folds 
JohnnyVido: folds 
RUMJO: folds 
andrew_yar: folds 
perespell: folds 
Uncalled bet ($0.05) returned to 22888899
22888899 collected $0.10 from pot
22888899: doesn't show hand 
*** SUMMARY ***
Total pot $0.10 | Rake $0 
Seat 1: andrew_yar (button) folded before Flop (didn't bet)
Seat 2: perespell (small blind) folded before Flop
Seat 3: 22888899 (big blind) collected ($0.10)
Seat 4: Kobert72 folded before Flop (didn't bet)
Seat 5: JohnnyVido folded before Flop (didn't bet)
Seat 6: RUMJO folded before Flop (didn't bet)



PokerStars Hand #222970944846:  Hold'em No Limit ($0.05/$0.10 USD) - 2021/01/23 16:02:58 ET
Table 'Stephano III' 6-max Seat #2 is the button
Seat 1: andrew_yar ($13.56 in chips) 
Seat 2: perespell ($13.69 in chips) 
Seat 3: 22888899 ($5.94 in chips) 
Seat 4: Kobert72 ($10.41 in chips) 
Seat 5: JohnnyVido ($12.06 in chips) 
Seat 6: RUMJO ($11.45 in chips) 
22888899: posts small blind $0.05
Kobert72: posts big blind $0.10
*** HOLE CARDS ***
JohnnyVido: folds 
RUMJO: raises $0.15 to $0.25
andrew_yar: folds 
perespell: folds 
22888899: calls $0.20
Kobert72: folds 
*** FLOP *** [Ts 9s 3c]
22888899: checks 
RUMJO: bets $0.34
22888899: calls $0.34
*** TURN *** [Ts 9s 3c] [Js]
22888899: checks 
RUMJO: bets $0.73
22888899: raises $0.73 to $1.46
RUMJO: calls $0.73
*** RIVER *** [Ts 9s 3c Js] [8s]
22888899: checks 
RUMJO: checks 
*** SHOW DOWN ***
22888899: shows [4s 5s] (a flush, Jack high)
RUMJO: shows [Ks Kh] (a flush, King high)
RUMJO collected $4.01 from pot
*** SUMMARY ***
Total pot $4.20 | Rake $0.19 
Board [Ts 9s 3c Js 8s]
Seat 1: andrew_yar folded before Flop (didn't bet)
Seat 2: perespell (button) folded before Flop (didn't bet)
Seat 3: 22888899 (small blind) showed [4s 5s] and lost with a flush, Jack high
Seat 4: Kobert72 (big blind) folded before Flop
Seat 5: JohnnyVido folded before Flop (didn't bet)
Seat 6: RUMJO showed [Ks Kh] and won ($4.01) with a flush, King high



PokerStars Hand #222970971998:  Hold'em No Limit ($0.05/$0.10 USD) - 2021/01/23 16:03:32 ET
Table 'Stephano III' 6-max Seat #3 is the button
Seat 1: andrew_yar ($13.56 in chips) 
Seat 2: perespell ($13.69 in chips) 
Seat 3: 22888899 ($3.89 in chips) 
Seat 4: Kobert72 ($10.31 in chips) 
Seat 5: JohnnyVido ($12.06 in chips) 
Seat 6: RUMJO ($13.41 in chips) 
Kobert72: posts small blind $0.05
JohnnyVido: posts big blind $0.10
*** HOLE CARDS ***
RUMJO: folds 
andrew_yar: folds 
perespell: raises $0.15 to $0.25
22888899: raises $0.65 to $0.90
Kobert72: folds 
JohnnyVido: folds 
perespell: folds 
Uncalled bet ($0.65) returned to 22888899
22888899 collected $0.65 from pot
22888899: doesn't show hand 
*** SUMMARY ***
Total pot $0.65 | Rake $0 
Seat 1: andrew_yar folded before Flop (didn't bet)
Seat 2: perespell folded before Flop
Seat 3: 22888899 (button) collected ($0.65)
Seat 4: Kobert72 (small blind) folded before Flop
Seat 5: JohnnyVido (big blind) folded before Flop
Seat 6: RUMJO folded before Flop (didn't bet)



PokerStars Hand #222970985716:  Hold'em No Limit ($0.05/$0.10 USD) - 2021/01/23 16:03:49 ET
Table 'Stephano III' 6-max Seat #4 is the button
Seat 1: andrew_yar ($13.56 in chips) 
Seat 2: perespell ($13.44 in chips) 
Seat 3: 22888899 ($4.29 in chips) 
Seat 4: Kobert72 ($10.26 in chips) 
Seat 5: JohnnyVido ($11.96 in chips) 
Seat 6: RUMJO ($13.41 in chips) 
JohnnyVido: posts small blind $0.05
RUMJO: posts big blind $0.10
*** HOLE CARDS ***
andrew_yar: folds 
perespell: folds 
22888899: calls $0.10
Kobert72: folds 
JohnnyVido: calls $0.05
RUMJO: checks 
*** FLOP *** [4s 9d 5d]
JohnnyVido: checks 
RUMJO: checks 
22888899: checks 
*** TURN *** [4s 9d 5d] [Kc]
JohnnyVido: checks 
RUMJO: checks 
22888899: checks 
*** RIVER *** [4s 9d 5d Kc] [Qc]
JohnnyVido: bets $0.29
RUMJO: folds 
22888899: folds 
Uncalled bet ($0.29) returned to JohnnyVido
JohnnyVido collected $0.29 from pot
*** SUMMARY ***
Total pot $0.30 | Rake $0.01 
Board [4s 9d 5d Kc Qc]
Seat 1: andrew_yar folded before Flop (didn't bet)
Seat 2: perespell folded before Flop (didn't bet)
Seat 3: 22888899 folded on the River
Seat 4: Kobert72 (button) folded before Flop (didn't bet)
Seat 5: JohnnyVido (small blind) collected ($0.29)
Seat 6: RUMJO (big blind) folded on the River



PokerStars Hand #222971020344:  Hold'em No Limit ($0.05/$0.10 USD) - 2021/01/23 16:04:30 ET
Table 'Stephano III' 6-max Seat #5 is the button
Seat 1: andrew_yar ($13.56 in chips) 
Seat 2: perespell ($13.44 in chips) 
Seat 3: 22888899 ($4.19 in chips) 
Seat 4: Kobert72 ($10.26 in chips) 
Seat 5: JohnnyVido ($12.15 in chips) 
Seat 6: RUMJO ($13.31 in chips) 
RUMJO: posts small blind $0.05
andrew_yar: posts big blind $0.10
*** HOLE CARDS ***
perespell: folds 
22888899: raises $0.10 to $0.20
Kobert72: folds 
JohnnyVido: folds 
RUMJO: folds 
andrew_yar: calls $0.10
*** FLOP *** [Tc Qs Qc]
andrew_yar: checks 
22888899: bets $0.21
andrew_yar: folds 
Uncalled bet ($0.21) returned to 22888899
22888899 collected $0.43 from pot
22888899: doesn't show hand 
*** SUMMARY ***
Total pot $0.45 | Rake $0.02 
Board [Tc Qs Qc]
Seat 1: andrew_yar (big blind) folded on the Flop
Seat 2: perespell folded before Flop (didn't bet)
Seat 3: 22888899 collected ($0.43)
Seat 4: Kobert72 folded before Flop (didn't bet)
Seat 5: JohnnyVido (button) folded before Flop (didn't bet)
Seat 6: RUMJO (small blind) folded before Flop



PokerStars Hand #222971050535:  Hold'em No Limit ($0.05/$0.10 USD) - 2021/01/23 16:05:06 ET
Table 'Stephano III' 6-max Seat #6 is the button
Seat 1: andrew_yar ($13.36 in chips) 
Seat 2: perespell ($13.44 in chips) 
Seat 3: 22888899 ($4.42 in chips) 
Seat 4: Kobert72 ($10.26 in chips) 
Seat 5: JohnnyVido ($12.15 in chips) 
Seat 6: RUMJO ($13.26 in chips) 
andrew_yar: posts small blind $0.05
perespell: posts big blind $0.10
*** HOLE CARDS ***
22888899: calls $0.10
Kobert72: folds 
JohnnyVido: folds 
RUMJO: calls $0.10
andrew_yar: folds 
perespell: checks 
*** FLOP *** [5d Ks 2s]
perespell: checks 
22888899: checks 
RUMJO: checks 
*** TURN *** [5d Ks 2s] [9s]
perespell: checks 
22888899: checks 
RUMJO: checks 
*** RIVER *** [5d Ks 2s 9s] [Js]
perespell: bets $0.17
22888899: folds 
RUMJO: folds 
Uncalled bet ($0.17) returned to perespell
perespell collected $0.33 from pot
perespell: doesn't show hand 
*** SUMMARY ***
Total pot $0.35 | Rake $0.02 
Board [5d Ks 2s 9s Js]
Seat 1: andrew_yar (small blind) folded before Flop
Seat 2: perespell (big blind) collected ($0.33)
Seat 3: 22888899 folded on the River
Seat 4: Kobert72 folded before Flop (didn't bet)
Seat 5: JohnnyVido folded before Flop (didn't bet)
Seat 6: RUMJO (button) folded on the River



PokerStars Hand #222971071859:  Hold'em No Limit ($0.05/$0.10 USD) - 2021/01/23 16:05:31 ET
Table 'Stephano III' 6-max Seat #1 is the button
Seat 1: andrew_yar ($13.31 in chips) 
Seat 2: perespell ($13.67 in chips) 
Seat 3: 22888899 ($4.32 in chips) 
Seat 4: Kobert72 ($10.26 in chips) 
Seat 5: JohnnyVido ($12.15 in chips) 
Seat 6: RUMJO ($13.16 in chips) 
perespell: posts small blind $0.05
22888899: posts big blind $0.10
*** HOLE CARDS ***
Kobert72: folds 
JohnnyVido: calls $0.10
RUMJO: folds 
andrew_yar: raises $0.35 to $0.45
perespell: folds 
22888899: folds 
JohnnyVido: folds 
Uncalled bet ($0.35) returned to andrew_yar
andrew_yar collected $0.35 from pot
andrew_yar: doesn't show hand 
*** SUMMARY ***
Total pot $0.35 | Rake $0 
Seat 1: andrew_yar (button) collected ($0.35)
Seat 2: perespell (small blind) folded before Flop
Seat 3: 22888899 (big blind) folded before Flop
Seat 4: Kobert72 folded before Flop (didn't bet)
Seat 5: JohnnyVido folded before Flop
Seat 6: RUMJO folded before Flop (didn't bet)



PokerStars Hand #222971085272:  Hold'em No Limit ($0.05/$0.10 USD) - 2021/01/23 16:05:48 ET
Table 'Stephano III' 6-max Seat #2 is the button
Seat 1: andrew_yar ($13.56 in chips) 
Seat 2: perespell ($13.62 in chips) 
Seat 3: 22888899 ($4.22 in chips) 
Seat 4: Kobert72 ($10.26 in chips) 
Seat 5: JohnnyVido ($12.05 in chips) 
Seat 6: RUMJO ($13.16 in chips) 
22888899: posts small blind $0.05
Kobert72: posts big blind $0.10
*** HOLE CARDS ***
JohnnyVido: calls $0.10
RUMJO: folds 
andrew_yar: folds 
perespell: folds 
22888899: raises $0.10 to $0.20
Kobert72: folds 
JohnnyVido: calls $0.10
*** FLOP *** [3c Kc Jc]
22888899: checks 
JohnnyVido: checks 
*** TURN *** [3c Kc Jc] [Qh]
22888899: checks 
JohnnyVido: bets $0.10
22888899: folds 
Uncalled bet ($0.10) returned to JohnnyVido
JohnnyVido collected $0.48 from pot
JohnnyVido: doesn't show hand 
*** SUMMARY ***
Total pot $0.50 | Rake $0.02 
Board [3c Kc Jc Qh]
Seat 1: andrew_yar folded before Flop (didn't bet)
Seat 2: perespell (button) folded before Flop (didn't bet)
Seat 3: 22888899 (small blind) folded on the Turn
Seat 4: Kobert72 (big blind) folded before Flop
Seat 5: JohnnyVido collected ($0.48)
Seat 6: RUMJO folded before Flop (didn't bet)



PokerStars Hand #222971102898:  Hold'em No Limit ($0.05/$0.10 USD) - 2021/01/23 16:06:09 ET
Table 'Stephano III' 6-max Seat #3 is the button
Seat 1: andrew_yar ($13.56 in chips) 
Seat 2: perespell ($13.62 in chips) 
Seat 3: 22888899 ($4.02 in chips) 
Seat 4: Kobert72 ($10.16 in chips) 
Seat 5: JohnnyVido ($12.33 in chips) 
Seat 6: RUMJO ($13.16 in chips) 
Kobert72: posts small blind $0.05
JohnnyVido: posts big blind $0.10
*** HOLE CARDS ***
RUMJO: folds 
andrew_yar: folds 
perespell: folds 
22888899: raises $0.20 to $0.30
Kobert72: raises $0.68 to $0.98
JohnnyVido: folds 
22888899: calls $0.68
*** FLOP *** [Qc 5c 8c]
Kobert72: bets $0.65
22888899: folds 
Uncalled bet ($0.65) returned to Kobert72
Kobert72 collected $1.97 from pot
Kobert72: doesn't show hand 
*** SUMMARY ***
Total pot $2.06 | Rake $0.09 
Board [Qc 5c 8c]
Seat 1: andrew_yar folded before Flop (didn't bet)
Seat 2: perespell folded before Flop (didn't bet)
Seat 3: 22888899 (button) folded on the Flop
Seat 4: Kobert72 (small blind) collected ($1.97)
Seat 5: JohnnyVido (big blind) folded before Flop
Seat 6: RUMJO folded before Flop (didn't bet)



PokerStars Hand #222971123892:  Hold'em No Limit ($0.05/$0.10 USD) - 2021/01/23 16:06:34 ET
Table 'Stephano III' 6-max Seat #4 is the button
Seat 1: andrew_yar ($13.56 in chips) 
Seat 2: perespell ($13.62 in chips) 
Seat 3: 22888899 ($3.04 in chips) 
Seat 4: Kobert72 ($11.15 in chips) 
Seat 5: JohnnyVido ($12.23 in chips) 
Seat 6: RUMJO ($13.16 in chips) 
JohnnyVido: posts small blind $0.05
RUMJO: posts big blind $0.10
*** HOLE CARDS ***
andrew_yar: raises $0.20 to $0.30
perespell: calls $0.30
22888899: calls $0.30
Kobert72: folds 
JohnnyVido: folds 
RUMJO: folds 
*** FLOP *** [4s 5d 5h]
andrew_yar: checks 
perespell: checks 
22888899: bets $0.50
andrew_yar: folds 
perespell: folds 
Uncalled bet ($0.50) returned to 22888899
22888899 collected $1 from pot
22888899: doesn't show hand 
*** SUMMARY ***
Total pot $1.05 | Rake $0.05 
Board [4s 5d 5h]
Seat 1: andrew_yar folded on the Flop
Seat 2: perespell folded on the Flop
Seat 3: 22888899 collected ($1)
Seat 4: Kobert72 (button) folded before Flop (didn't bet)
Seat 5: JohnnyVido (small blind) folded before Flop
Seat 6: RUMJO (big blind) folded before Flop



PokerStars Hand #222971155910:  Hold'em No Limit ($0.05/$0.10 USD) - 2021/01/23 16:07:12 ET
Table 'Stephano III' 6-max Seat #5 is the button
Seat 1: andrew_yar ($13.26 in chips) 
Seat 2: perespell ($13.32 in chips) 
Seat 3: 22888899 ($3.74 in chips) 
Seat 4: Kobert72 ($11.15 in chips) 
Seat 5: JohnnyVido ($12.18 in chips) 
Seat 6: RUMJO ($13.06 in chips) 
RUMJO: posts small blind $0.05
andrew_yar: posts big blind $0.10
*** HOLE CARDS ***
perespell: folds 
22888899: calls $0.10
Kobert72: folds 
JohnnyVido: raises $0.10 to $0.20
RUMJO: folds 
andrew_yar: calls $0.10
22888899: calls $0.10
*** FLOP *** [Jc 3c 9h]
andrew_yar: checks 
22888899: checks 
JohnnyVido: bets $0.10
andrew_yar: folds 
22888899: calls $0.10
*** TURN *** [Jc 3c 9h] [6c]
22888899: checks 
JohnnyVido: bets $0.41
22888899: folds 
Uncalled bet ($0.41) returned to JohnnyVido
JohnnyVido collected $0.81 from pot
JohnnyVido: doesn't show hand 
*** SUMMARY ***
Total pot $0.85 | Rake $0.04 
Board [Jc 3c 9h 6c]
Seat 1: andrew_yar (big blind) folded on the Flop
Seat 2: perespell folded before Flop (didn't bet)
Seat 3: 22888899 folded on the Turn
Seat 4: Kobert72 folded before Flop (didn't bet)
Seat 5: JohnnyVido (button) collected ($0.81)
Seat 6: RUMJO (small blind) folded before Flop



PokerStars Hand #222971182575:  Hold'em No Limit ($0.05/$0.10 USD) - 2021/01/23 16:07:44 ET
Table 'Stephano III' 6-max Seat #6 is the button
Seat 1: andrew_yar ($13.06 in chips) 
Seat 2: perespell ($13.32 in chips) 
Seat 3: 22888899 ($3.44 in chips) 
Seat 4: Kobert72 ($11.15 in chips) 
Seat 5: JohnnyVido ($12.69 in chips) 
Seat 6: RUMJO ($13.01 in chips) 
andrew_yar: posts small blind $0.05
perespell: posts big blind $0.10
*** HOLE CARDS ***
22888899: raises $0.20 to $0.30
Kobert72: folds 
JohnnyVido: folds 
RUMJO: folds 
andrew_yar: folds 
perespell: raises $0.50 to $0.80
22888899: raises $2.64 to $3.44 and is all-in
perespell: calls $2.64
*** FLOP *** [6c 8c 3h]
*** TURN *** [6c 8c 3h] [5d]
*** RIVER *** [6c 8c 3h 5d] [7h]
*** SHOW DOWN ***
perespell: shows [Qs Ah] (high card Ace)
22888899: shows [6h 6s] (three of a kind, Sixes)
22888899 collected $6.62 from pot
*** SUMMARY ***
Total pot $6.93 | Rake $0.31 
Board [6c 8c 3h 5d 7h]
Seat 1: andrew_yar (small blind) folded before Flop
Seat 2: perespell (big blind) showed [Qs Ah] and lost with high card Ace
Seat 3: 22888899 showed [6h 6s] and won ($6.62) with three of a kind, Sixes
Seat 4: Kobert72 folded before Flop (didn't bet)
Seat 5: JohnnyVido folded before Flop (didn't bet)
Seat 6: RUMJO (button) folded before Flop (didn't bet)



PokerStars Hand #222971210250:  Hold'em No Limit ($0.05/$0.10 USD) - 2021/01/23 16:08:18 ET
Table 'Stephano III' 6-max Seat #1 is the button
Seat 1: andrew_yar ($13.01 in chips) 
Seat 2: perespell ($10 in chips) 
Seat 3: 22888899 ($6.62 in chips) 
Seat 4: Kobert72 ($11.15 in chips) 
Seat 5: JohnnyVido ($12.69 in chips) 
Seat 6: RUMJO ($13.01 in chips) 
perespell: posts small blind $0.05
22888899: posts big blind $0.10
*** HOLE CARDS ***
Kobert72: folds 
JohnnyVido: calls $0.10
RUMJO: folds 
andrew_yar: folds 
perespell: folds 
22888899: raises $0.10 to $0.20
JohnnyVido: calls $0.10
*** FLOP *** [5c 4c Tc]
22888899: bets $0.21
JohnnyVido: calls $0.21
*** TURN *** [5c 4c Tc] [Js]
22888899: bets $0.31
JohnnyVido: folds 
Uncalled bet ($0.31) returned to 22888899
22888899 collected $0.83 from pot
22888899: doesn't show hand 
*** SUMMARY ***
Total pot $0.87 | Rake $0.04 
Board [5c 4c Tc Js]
Seat 1: andrew_yar (button) folded before Flop (didn't bet)
Seat 2: perespell (small blind) folded before Flop
Seat 3: 22888899 (big blind) collected ($0.83)
Seat 4: Kobert72 folded before Flop (didn't bet)
Seat 5: JohnnyVido folded on the Turn
Seat 6: RUMJO folded before Flop (didn't bet)



PokerStars Hand #222971230788:  Hold'em No Limit ($0.05/$0.10 USD) - 2021/01/23 16:08:42 ET
Table 'Stephano III' 6-max Seat #2 is the button
Seat 1: andrew_yar ($13.01 in chips) 
Seat 2: perespell ($10 in chips) 
Seat 3: 22888899 ($7.04 in chips) 
Seat 4: Kobert72 ($11.15 in chips) 
Seat 5: JohnnyVido ($12.28 in chips) 
Seat 6: RUMJO ($13.01 in chips) 
22888899: posts small blind $0.05
Kobert72: posts big blind $0.10
*** HOLE CARDS ***
JohnnyVido: calls $0.10
RUMJO: folds 
andrew_yar: folds 
perespell: raises $0.30 to $0.40
22888899: calls $0.35
Kobert72: calls $0.30
JohnnyVido: calls $0.30
*** FLOP *** [2d 3s 9c]
22888899: checks 
Kobert72: checks 
JohnnyVido: checks 
perespell: bets $0.78
22888899: folds 
Kobert72: folds 
JohnnyVido: calls $0.78
*** TURN *** [2d 3s 9c] [8s]
JohnnyVido: checks 
perespell: checks 
*** RIVER *** [2d 3s 9c 8s] [3c]
JohnnyVido: bets $3.02
perespell: folds 
Uncalled bet ($3.02) returned to JohnnyVido
JohnnyVido collected $3.02 from pot
JohnnyVido: doesn't show hand 
*** SUMMARY ***
Total pot $3.16 | Rake $0.14 
Board [2d 3s 9c 8s 3c]
Seat 1: andrew_yar folded before Flop (didn't bet)
Seat 2: perespell (button) folded on the River
Seat 3: 22888899 (small blind) folded on the Flop
Seat 4: Kobert72 (big blind) folded on the Flop
Seat 5: JohnnyVido collected ($3.02)
Seat 6: RUMJO folded before Flop (didn't bet)



PokerStars Hand #222971294020:  Hold'em No Limit ($0.05/$0.10 USD) - 2021/01/23 16:09:58 ET
Table 'Stephano III' 6-max Seat #3 is the button
Seat 1: andrew_yar ($13.01 in chips) 
Seat 2: perespell ($10 in chips) 
Seat 3: 22888899 ($6.64 in chips) 
Seat 4: Kobert72 ($10.75 in chips) 
Seat 5: JohnnyVido ($14.12 in chips) 
Seat 6: RUMJO ($13.01 in chips) 
Kobert72: posts small blind $0.05
JohnnyVido: posts big blind $0.10
*** HOLE CARDS ***
RUMJO: folds 
andrew_yar: folds 
perespell: folds 
22888899: calls $0.10
Kobert72: folds 
JohnnyVido: checks 
*** FLOP *** [2h Ks Td]
JohnnyVido: checks 
22888899: bets $0.10
JohnnyVido: folds 
Uncalled bet ($0.10) returned to 22888899
22888899 collected $0.24 from pot
22888899: doesn't show hand 
*** SUMMARY ***
Total pot $0.25 | Rake $0.01 
Board [2h Ks Td]
Seat 1: andrew_yar folded before Flop (didn't bet)
Seat 2: perespell folded before Flop (didn't bet)
Seat 3: 22888899 (button) collected ($0.24)
Seat 4: Kobert72 (small blind) folded before Flop
Seat 5: JohnnyVido (big blind) folded on the Flop
Seat 6: RUMJO folded before Flop (didn't bet)



PokerStars Hand #222971310215:  Hold'em No Limit ($0.05/$0.10 USD) - 2021/01/23 16:10:18 ET
Table 'Stephano III' 6-max Seat #4 is the button
Seat 1: andrew_yar ($13.01 in chips) 
Seat 2: perespell ($10 in chips) 
Seat 3: 22888899 ($6.78 in chips) 
Seat 4: Kobert72 ($10.70 in chips) 
Seat 5: JohnnyVido ($14.02 in chips) 
Seat 6: RUMJO ($13.01 in chips) 
JohnnyVido: posts small blind $0.05
RUMJO: posts big blind $0.10
*** HOLE CARDS ***
andrew_yar: folds 
perespell: folds 
22888899: raises $0.20 to $0.30
Kobert72: raises $0.43 to $0.73
JohnnyVido: folds 
RUMJO: folds 
22888899: raises $0.43 to $1.16
Kobert72: folds 
Uncalled bet ($0.43) returned to 22888899
22888899 collected $1.61 from pot
22888899: doesn't show hand 
*** SUMMARY ***
Total pot $1.61 | Rake $0 
Seat 1: andrew_yar folded before Flop (didn't bet)
Seat 2: perespell folded before Flop (didn't bet)
Seat 3: 22888899 collected ($1.61)
Seat 4: Kobert72 (button) folded before Flop
Seat 5: JohnnyVido (small blind) folded before Flop
Seat 6: RUMJO (big blind) folded before Flop



PokerStars Hand #222971328302:  Hold'em No Limit ($0.05/$0.10 USD) - 2021/01/23 16:10:38 ET
Table 'Stephano III' 6-max Seat #5 is the button
Seat 1: andrew_yar ($13.01 in chips) 
Seat 2: perespell ($10 in chips) 
Seat 3: 22888899 ($7.66 in chips) 
Seat 4: Kobert72 ($10 in chips) 
Seat 5: JohnnyVido ($13.97 in chips) 
Seat 6: RUMJO ($12.91 in chips) 
RUMJO: posts small blind $0.05
andrew_yar: posts big blind $0.10
*** HOLE CARDS ***
perespell: raises $0.15 to $0.25
22888899: calls $0.25
Kobert72: folds 
JohnnyVido: raises $0.55 to $0.80
RUMJO: folds 
andrew_yar: folds 
perespell: calls $0.55
22888899: calls $0.55
*** FLOP *** [4c Ah 2d]
perespell: checks 
22888899: checks 
JohnnyVido: bets $2.44
perespell: folds 
22888899: calls $2.44
*** TURN *** [4c Ah 2d] [Qc]
22888899: checks 
JohnnyVido: checks 
*** RIVER *** [4c Ah 2d Qc] [2h]
22888899: bets $4.42 and is all-in
JohnnyVido: calls $4.42
*** SHOW DOWN ***
22888899: shows [7h Ac] (two pair, Aces and Deuces)
JohnnyVido: shows [Jc Ad] (two pair, Aces and Deuces)
22888899 collected $7.77 from pot
JohnnyVido collected $7.77 from pot
*** SUMMARY ***
Total pot $16.27 | Rake $0.73 
Board [4c Ah 2d Qc 2h]
Seat 1: andrew_yar (big blind) folded before Flop
Seat 2: perespell folded on the Flop
Seat 3: 22888899 showed [7h Ac] and won ($7.77) with two pair, Aces and Deuces
Seat 4: Kobert72 folded before Flop (didn't bet)
Seat 5: JohnnyVido (button) showed [Jc Ad] and won ($7.77) with two pair, Aces and Deuces
Seat 6: RUMJO (small blind) folded before Flop



PokerStars Hand #222971372411:  Hold'em No Limit ($0.05/$0.10 USD) - 2021/01/23 16:11:32 ET
Table 'Stephano III' 6-max Seat #6 is the button
Seat 1: andrew_yar ($12.91 in chips) 
Seat 2: perespell ($10 in chips) 
Seat 3: 22888899 ($7.77 in chips) 
Seat 4: Kobert72 ($10 in chips) 
Seat 5: JohnnyVido ($14.08 in chips) 
Seat 6: RUMJO ($12.86 in chips) 
andrew_yar: posts small blind $0.05
perespell: posts big blind $0.10
*** HOLE CARDS ***
22888899: raises $0.10 to $0.20
Kobert72: folds 
JohnnyVido: folds 
RUMJO: raises $0.40 to $0.60
andrew_yar: folds 
perespell: folds 
22888899: calls $0.40
*** FLOP *** [4s Ah Kh]
22888899: checks 
RUMJO: bets $0.39
22888899: folds 
Uncalled bet ($0.39) returned to RUMJO
RUMJO collected $1.29 from pot
RUMJO: doesn't show hand 
*** SUMMARY ***
Total pot $1.35 | Rake $0.06 
Board [4s Ah Kh]
Seat 1: andrew_yar (small blind) folded before Flop
Seat 2: perespell (big blind) folded before Flop
Seat 3: 22888899 folded on the Flop
Seat 4: Kobert72 folded before Flop (didn't bet)
Seat 5: JohnnyVido folded before Flop (didn't bet)
Seat 6: RUMJO (button) collected ($1.29)



PokerStars Hand #222971391898:  Hold'em No Limit ($0.05/$0.10 USD) - 2021/01/23 16:11:56 ET
Table 'Stephano III' 6-max Seat #1 is the button
Seat 1: andrew_yar ($12.86 in chips) 
Seat 2: perespell ($10 in chips) 
Seat 3: 22888899 ($7.17 in chips) 
Seat 4: Kobert72 ($10 in chips) 
Seat 5: JohnnyVido ($14.08 in chips) 
Seat 6: RUMJO ($13.55 in chips) 
perespell: posts small blind $0.05
22888899: posts big blind $0.10
*** HOLE CARDS ***
Kobert72: raises $0.13 to $0.23
JohnnyVido: folds 
RUMJO: folds 
andrew_yar: folds 
perespell: folds 
22888899: calls $0.13
*** FLOP *** [6c Qc 8d]
22888899: checks 
Kobert72: checks 
*** TURN *** [6c Qc 8d] [As]
22888899: checks 
Kobert72: bets $0.37
22888899: calls $0.37
*** RIVER *** [6c Qc 8d As] [3d]
22888899: checks 
Kobert72: checks 
*** SHOW DOWN ***
22888899: shows [2c Ah] (a pair of Aces)
Kobert72: shows [Jc Ac] (a pair of Aces - Queen+Jack kicker)
Kobert72 collected $1.19 from pot
*** SUMMARY ***
Total pot $1.25 | Rake $0.06 
Board [6c Qc 8d As 3d]
Seat 1: andrew_yar (button) folded before Flop (didn't bet)
Seat 2: perespell (small blind) folded before Flop
Seat 3: 22888899 (big blind) showed [2c Ah] and lost with a pair of Aces
Seat 4: Kobert72 showed [Jc Ac] and won ($1.19) with a pair of Aces
Seat 5: JohnnyVido folded before Flop (didn't bet)
Seat 6: RUMJO folded before Flop (didn't bet)



PokerStars Hand #222971417606:  Hold'em No Limit ($0.05/$0.10 USD) - 2021/01/23 16:12:27 ET
Table 'Stephano III' 6-max Seat #2 is the button
Seat 1: andrew_yar ($12.86 in chips) 
Seat 2: perespell ($10 in chips) 
Seat 3: 22888899 ($6.57 in chips) 
Seat 4: Kobert72 ($10.59 in chips) 
Seat 5: JohnnyVido ($14.08 in chips) 
Seat 6: RUMJO ($13.55 in chips) 
22888899: posts small blind $0.05
Kobert72: posts big blind $0.10
*** HOLE CARDS ***
JohnnyVido: folds 
RUMJO: folds 
andrew_yar: folds 
perespell: folds 
22888899: calls $0.05
Kobert72: raises $0.30 to $0.40
22888899: calls $0.30
*** FLOP *** [Ad Ah Jc]
22888899: checks 
Kobert72: checks 
*** TURN *** [Ad Ah Jc] [5d]
22888899: bets $0.38
Kobert72: calls $0.38
*** RIVER *** [Ad Ah Jc 5d] [Qs]
22888899: bets $0.74
Kobert72: calls $0.74
*** SHOW DOWN ***
22888899: shows [2d 5s] (two pair, Aces and Fives)
Kobert72: shows [Kc Kd] (two pair, Aces and Kings)
Kobert72 collected $2.90 from pot
*** SUMMARY ***
Total pot $3.04 | Rake $0.14 
Board [Ad Ah Jc 5d Qs]
Seat 1: andrew_yar folded before Flop (didn't bet)
Seat 2: perespell (button) folded before Flop (didn't bet)
Seat 3: 22888899 (small blind) showed [2d 5s] and lost with two pair, Aces and Fives
Seat 4: Kobert72 (big blind) showed [Kc Kd] and won ($2.90) with two pair, Aces and Kings
Seat 5: JohnnyVido folded before Flop (didn't bet)
Seat 6: RUMJO folded before Flop (didn't bet)



PokerStars Hand #222971453078:  Hold'em No Limit ($0.05/$0.10 USD) - 2021/01/23 16:13:01 ET
Table 'Stephano III' 6-max Seat #3 is the button
Seat 1: andrew_yar ($12.86 in chips) 
Seat 2: perespell ($10 in chips) 
Seat 3: 22888899 ($5.05 in chips) 
Seat 4: Kobert72 ($11.97 in chips) 
Seat 5: JohnnyVido ($14.08 in chips) 
Seat 6: RUMJO ($13.55 in chips) 
Kobert72: posts small blind $0.05
JohnnyVido: posts big blind $0.10
*** HOLE CARDS ***
RUMJO: raises $0.15 to $0.25
andrew_yar: folds 
perespell: folds 
22888899: calls $0.25
Kobert72: folds 
JohnnyVido: calls $0.15
*** FLOP *** [6d Jh 2s]
JohnnyVido: checks 
RUMJO: bets $0.23
22888899: calls $0.23
JohnnyVido: calls $0.23
*** TURN *** [6d Jh 2s] [9s]
JohnnyVido: checks 
RUMJO: checks 
22888899: bets $0.71
JohnnyVido: folds 
RUMJO: folds 
Uncalled bet ($0.71) returned to 22888899
22888899 collected $1.42 from pot
22888899: doesn't show hand 
*** SUMMARY ***
Total pot $1.49 | Rake $0.07 
Board [6d Jh 2s 9s]
Seat 1: andrew_yar folded before Flop (didn't bet)
Seat 2: perespell folded before Flop (didn't bet)
Seat 3: 22888899 (button) collected ($1.42)
Seat 4: Kobert72 (small blind) folded before Flop
Seat 5: JohnnyVido (big blind) folded on the Turn
Seat 6: RUMJO folded on the Turn



PokerStars Hand #222971483187:  Hold'em No Limit ($0.05/$0.10 USD) - 2021/01/23 16:13:37 ET
Table 'Stephano III' 6-max Seat #4 is the button
Seat 1: andrew_yar ($12.86 in chips) 
Seat 2: perespell ($10 in chips) 
Seat 3: 22888899 ($5.99 in chips) 
Seat 4: Kobert72 ($11.92 in chips) 
Seat 5: JohnnyVido ($13.60 in chips) 
Seat 6: RUMJO ($13.07 in chips) 
JohnnyVido: posts small blind $0.05
RUMJO: posts big blind $0.10
*** HOLE CARDS ***
andrew_yar: folds 
perespell: folds 
22888899: raises $0.10 to $0.20
Kobert72: folds 
JohnnyVido: calls $0.15
RUMJO: calls $0.10
*** FLOP *** [Ad 8s Kd]
JohnnyVido: checks 
RUMJO: checks 
22888899: checks 
*** TURN *** [Ad 8s Kd] [3s]
JohnnyVido: bets $0.10
RUMJO: raises $0.20 to $0.30
22888899: folds 
JohnnyVido: calls $0.20
*** RIVER *** [Ad 8s Kd 3s] [7s]
JohnnyVido: checks 
RUMJO: bets $0.69
JohnnyVido: folds 
Uncalled bet ($0.69) returned to RUMJO
RUMJO collected $1.15 from pot
RUMJO: doesn't show hand 
*** SUMMARY ***
Total pot $1.20 | Rake $0.05 
Board [Ad 8s Kd 3s 7s]
Seat 1: andrew_yar folded before Flop (didn't bet)
Seat 2: perespell folded before Flop (didn't bet)
Seat 3: 22888899 folded on the Turn
Seat 4: Kobert72 (button) folded before Flop (didn't bet)
Seat 5: JohnnyVido (small blind) folded on the River
Seat 6: RUMJO (big blind) collected ($1.15)



PokerStars Hand #222971512377:  Hold'em No Limit ($0.05/$0.10 USD) - 2021/01/23 16:14:13 ET
Table 'Stephano III' 6-max Seat #5 is the button
Seat 1: andrew_yar ($12.86 in chips) 
Seat 2: perespell ($10 in chips) 
Seat 3: 22888899 ($5.79 in chips) 
Seat 4: Kobert72 ($11.92 in chips) 
Seat 5: JohnnyVido ($13.10 in chips) 
Seat 6: RUMJO ($13.72 in chips) 
RUMJO: posts small blind $0.05
andrew_yar: posts big blind $0.10
*** HOLE CARDS ***
perespell has timed out
perespell: folds 
22888899: raises $0.25 to $0.35
Kobert72: folds 
JohnnyVido: calls $0.35
RUMJO: folds 
andrew_yar: folds 
*** FLOP *** [4c 3s 2c]
22888899: bets $0.40
JohnnyVido: calls $0.40
*** TURN *** [4c 3s 2c] [2h]
22888899: bets $0.79
JohnnyVido: calls $0.79
*** RIVER *** [4c 3s 2c 2h] [Td]
22888899: checks 
JohnnyVido: bets $3.08
22888899: folds 
Uncalled bet ($3.08) returned to JohnnyVido
JohnnyVido collected $3.08 from pot
JohnnyVido: doesn't show hand 
*** SUMMARY ***
Total pot $3.23 | Rake $0.15 
Board [4c 3s 2c 2h Td]
Seat 1: andrew_yar (big blind) folded before Flop
Seat 2: perespell folded before Flop (didn't bet)
Seat 3: 22888899 folded on the River
Seat 4: Kobert72 folded before Flop (didn't bet)
Seat 5: JohnnyVido (button) collected ($3.08)
Seat 6: RUMJO (small blind) folded before Flop



PokerStars Hand #222971557644:  Hold'em No Limit ($0.05/$0.10 USD) - 2021/01/23 16:15:07 ET
Table 'Stephano III' 6-max Seat #6 is the button
Seat 1: andrew_yar ($12.76 in chips) 
Seat 2: perespell ($10 in chips) 
Seat 3: 22888899 ($4.25 in chips) 
Seat 4: Kobert72 ($11.92 in chips) 
Seat 5: JohnnyVido ($14.64 in chips) 
Seat 6: RUMJO ($13.67 in chips) 
andrew_yar: posts small blind $0.05
perespell: posts big blind $0.10
*** HOLE CARDS ***
22888899: folds 
Kobert72: folds 
JohnnyVido: calls $0.10
RUMJO: folds 
andrew_yar: calls $0.05
perespell: checks 
*** FLOP *** [Qc 5h Ac]
andrew_yar: checks 
perespell: checks 
JohnnyVido: bets $0.10
andrew_yar: folds 
perespell: calls $0.10
*** TURN *** [Qc 5h Ac] [Ts]
perespell: checks 
JohnnyVido: checks 
*** RIVER *** [Qc 5h Ac Ts] [Jd]
perespell: checks 
JohnnyVido: bets $0.10
perespell: calls $0.10
*** SHOW DOWN ***
JohnnyVido: shows [3h 2h] (high card Ace)
perespell: shows [Ah 2d] (a pair of Aces)
perespell collected $0.67 from pot
*** SUMMARY ***
Total pot $0.70 | Rake $0.03 
Board [Qc 5h Ac Ts Jd]
Seat 1: andrew_yar (small blind) folded on the Flop
Seat 2: perespell (big blind) showed [Ah 2d] and won ($0.67) with a pair of Aces
Seat 3: 22888899 folded before Flop (didn't bet)
Seat 4: Kobert72 folded before Flop (didn't bet)
Seat 5: JohnnyVido showed [3h 2h] and lost with high card Ace
Seat 6: RUMJO (button) folded before Flop (didn't bet)



PokerStars Hand #222971598942:  Hold'em No Limit ($0.05/$0.10 USD) - 2021/01/23 16:15:55 ET
Table 'Stephano III' 6-max Seat #1 is the button
Seat 1: andrew_yar ($12.66 in chips) 
Seat 2: perespell ($10.37 in chips) 
Seat 3: 22888899 ($4.25 in chips) 
Seat 4: Kobert72 ($11.92 in chips) 
Seat 5: JohnnyVido ($14.34 in chips) 
Seat 6: RUMJO ($13.67 in chips) 
perespell: posts small blind $0.05
22888899: posts big blind $0.10
*** HOLE CARDS ***
Kobert72: raises $0.13 to $0.23
JohnnyVido: folds 
RUMJO: folds 
andrew_yar: folds 
perespell: folds 
22888899: calls $0.13
*** FLOP *** [Qh Js Td]
22888899: checks 
Kobert72: bets $0.16
22888899: calls $0.16
*** TURN *** [Qh Js Td] [2c]
22888899: checks 
Kobert72: checks 
*** RIVER *** [Qh Js Td 2c] [2h]
22888899: checks 
Kobert72: checks 
*** SHOW DOWN ***
22888899: shows [Ad 6c] (a pair of Deuces)
Kobert72: shows [7s 7h] (two pair, Sevens and Deuces)
Kobert72 collected $0.79 from pot
*** SUMMARY ***
Total pot $0.83 | Rake $0.04 
Board [Qh Js Td 2c 2h]
Seat 1: andrew_yar (button) folded before Flop (didn't bet)
Seat 2: perespell (small blind) folded before Flop
Seat 3: 22888899 (big blind) showed [Ad 6c] and lost with a pair of Deuces
Seat 4: Kobert72 showed [7s 7h] and won ($0.79) with two pair, Sevens and Deuces
Seat 5: JohnnyVido folded before Flop (didn't bet)
Seat 6: RUMJO folded before Flop (didn't bet)



PokerStars Hand #222971627640:  Hold'em No Limit ($0.05/$0.10 USD) - 2021/01/23 16:16:28 ET
Table 'Stephano III' 6-max Seat #2 is the button
Seat 1: andrew_yar ($12.66 in chips) 
Seat 2: perespell ($10.32 in chips) 
Seat 3: 22888899 ($3.86 in chips) 
Seat 4: Kobert72 ($12.32 in chips) 
Seat 5: JohnnyVido ($14.34 in chips) 
Seat 6: RUMJO ($13.67 in chips) 
22888899: posts small blind $0.05
Kobert72: posts big blind $0.10
*** HOLE CARDS ***
JohnnyVido: calls $0.10
RUMJO: folds 
andrew_yar: folds 
perespell: folds 
22888899: calls $0.05
Kobert72: checks 
*** FLOP *** [4d 3h 5d]
22888899: checks 
Kobert72: checks 
JohnnyVido: bets $0.29
22888899: calls $0.29
Kobert72: folds 
*** TURN *** [4d 3h 5d] [8s]
22888899: checks 
JohnnyVido: checks 
*** RIVER *** [4d 3h 5d 8s] [6h]
22888899: bets $0.84
JohnnyVido: folds 
Uncalled bet ($0.84) returned to 22888899
22888899 collected $0.84 from pot
22888899: doesn't show hand 
*** SUMMARY ***
Total pot $0.88 | Rake $0.04 
Board [4d 3h 5d 8s 6h]
Seat 1: andrew_yar folded before Flop (didn't bet)
Seat 2: perespell (button) folded before Flop (didn't bet)
Seat 3: 22888899 (small blind) collected ($0.84)
Seat 4: Kobert72 (big blind) folded on the Flop
Seat 5: JohnnyVido folded on the River
Seat 6: RUMJO folded before Flop (didn't bet)



PokerStars Hand #222971659853:  Hold'em No Limit ($0.05/$0.10 USD) - 2021/01/23 16:17:06 ET
Table 'Stephano III' 6-max Seat #3 is the button
Seat 1: andrew_yar ($12.66 in chips) 
Seat 2: perespell ($10.32 in chips) 
Seat 3: 22888899 ($4.31 in chips) 
Seat 4: Kobert72 ($12.22 in chips) 
Seat 5: JohnnyVido ($13.95 in chips) 
Seat 6: RUMJO ($13.67 in chips) 
Kobert72: posts small blind $0.05
JohnnyVido: posts big blind $0.10
*** HOLE CARDS ***
RUMJO: folds 
andrew_yar: folds 
perespell: folds 
22888899: calls $0.10
Kobert72: raises $0.30 to $0.40
JohnnyVido: folds 
22888899: calls $0.30
*** FLOP *** [9h 4s 2d]
Kobert72: bets $0.28
22888899: folds 
Uncalled bet ($0.28) returned to Kobert72
Kobert72 collected $0.86 from pot
Kobert72: doesn't show hand 
*** SUMMARY ***
Total pot $0.90 | Rake $0.04 
Board [9h 4s 2d]
Seat 1: andrew_yar folded before Flop (didn't bet)
Seat 2: perespell folded before Flop (didn't bet)
Seat 3: 22888899 (button) folded on the Flop
Seat 4: Kobert72 (small blind) collected ($0.86)
Seat 5: JohnnyVido (big blind) folded before Flop
Seat 6: RUMJO folded before Flop (didn't bet)



PokerStars Hand #222971681669:  Hold'em No Limit ($0.05/$0.10 USD) - 2021/01/23 16:17:31 ET
Table 'Stephano III' 6-max Seat #4 is the button
Seat 1: andrew_yar ($12.66 in chips) 
Seat 2: perespell ($10.32 in chips) 
Seat 3: 22888899 ($3.91 in chips) 
Seat 4: Kobert72 ($12.68 in chips) 
Seat 6: RUMJO ($13.67 in chips) 
JohnnyVido has timed out
JohnnyVido: is sitting out 
RUMJO: posts small blind $0.05
andrew_yar: posts big blind $0.10
*** HOLE CARDS ***
perespell: folds 
22888899: calls $0.10
Kobert72: calls $0.10
RUMJO: calls $0.05
andrew_yar: checks 
*** FLOP *** [5c 2s 2h]
RUMJO: checks 
andrew_yar: checks 
22888899: checks 
Kobert72: checks 
*** TURN *** [5c 2s 2h] [6s]
RUMJO: checks 
andrew_yar: checks 
22888899: checks 
Kobert72: checks 
*** RIVER *** [5c 2s 2h 6s] [3h]
RUMJO: checks 
andrew_yar: checks 
22888899: checks 
Kobert72: checks 
*** SHOW DOWN ***
RUMJO: shows [8c Kc] (a pair of Deuces)
andrew_yar: mucks hand 
22888899: mucks hand 
Kobert72: mucks hand 
RUMJO collected $0.38 from pot
*** SUMMARY ***
Total pot $0.40 | Rake $0.02 
Board [5c 2s 2h 6s 3h]
Seat 1: andrew_yar (big blind) mucked
Seat 2: perespell folded before Flop (didn't bet)
Seat 3: 22888899 mucked
Seat 4: Kobert72 (button) mucked
Seat 6: RUMJO (small blind) showed [8c Kc] and won ($0.38) with a pair of Deuces



PokerStars Hand #222971733263:  Hold'em No Limit ($0.05/$0.10 USD) - 2021/01/23 16:18:31 ET
Table 'Stephano III' 6-max Seat #6 is the button
Seat 1: andrew_yar ($12.56 in chips) 
Seat 2: perespell ($10.32 in chips) 
Seat 3: 22888899 ($3.81 in chips) 
Seat 4: Kobert72 ($12.58 in chips) 
Seat 5: JohnnyVido ($13.85 in chips) 
Seat 6: RUMJO ($13.95 in chips) 
andrew_yar: posts small blind $0.05
perespell: posts big blind $0.10
JohnnyVido: posts small blind $0.05
*** HOLE CARDS ***
22888899: raises $0.10 to $0.20
Kobert72: folds 
JohnnyVido: folds 
RUMJO: folds 
andrew_yar: calls $0.15
perespell: folds 
*** FLOP *** [Js 2c 4d]
andrew_yar: checks 
22888899: bets $0.26
andrew_yar: folds 
Uncalled bet ($0.26) returned to 22888899
22888899 collected $0.53 from pot
22888899: doesn't show hand 
*** SUMMARY ***
Total pot $0.55 | Rake $0.02 
Board [Js 2c 4d]
Seat 1: andrew_yar (small blind) folded on the Flop
Seat 2: perespell (big blind) folded before Flop
Seat 3: 22888899 collected ($0.53)
Seat 4: Kobert72 folded before Flop (didn't bet)
Seat 5: JohnnyVido folded before Flop (didn't bet)
Seat 6: RUMJO (button) folded before Flop (didn't bet)



PokerStars Hand #222971762958:  Hold'em No Limit ($0.05/$0.10 USD) - 2021/01/23 16:19:05 ET
Table 'Stephano III' 6-max Seat #1 is the button
Seat 1: andrew_yar ($12.36 in chips) 
Seat 2: perespell ($10.22 in chips) 
Seat 3: 22888899 ($4.14 in chips) 
Seat 4: Kobert72 ($12.58 in chips) 
Seat 5: JohnnyVido ($13.80 in chips) 
Seat 6: RUMJO ($13.95 in chips) 
perespell: posts small blind $0.05
22888899: posts big blind $0.10
*** HOLE CARDS ***
Kobert72: raises $0.13 to $0.23
JohnnyVido: calls $0.23
RUMJO: folds 
andrew_yar: folds 
perespell: calls $0.18
22888899: calls $0.13
*** FLOP *** [5h As Kh]
perespell: checks 
22888899: checks 
Kobert72: checks 
JohnnyVido: checks 
*** TURN *** [5h As Kh] [2s]
perespell: checks 
22888899: checks 
Kobert72: checks 
JohnnyVido: bets $0.44
perespell: calls $0.44
22888899: folds 
Kobert72: folds 
*** RIVER *** [5h As Kh 2s] [Qs]
perespell: bets $1.31
JohnnyVido: folds 
Uncalled bet ($1.31) returned to perespell
perespell collected $1.72 from pot
perespell: doesn't show hand 
*** SUMMARY ***
Total pot $1.80 | Rake $0.08 
Board [5h As Kh 2s Qs]
Seat 1: andrew_yar (button) folded before Flop (didn't bet)
Seat 2: perespell (small blind) collected ($1.72)
Seat 3: 22888899 (big blind) folded on the Turn
Seat 4: Kobert72 folded on the Turn
Seat 5: JohnnyVido folded on the River
Seat 6: RUMJO folded before Flop (didn't bet)



PokerStars Hand #222971827448:  Hold'em No Limit ($0.05/$0.10 USD) - 2021/01/23 16:20:20 ET
Table 'Stephano III' 6-max Seat #2 is the button
Seat 1: andrew_yar ($12.36 in chips) 
Seat 2: perespell ($11.27 in chips) 
Seat 3: 22888899 ($3.91 in chips) 
Seat 4: Kobert72 ($12.35 in chips) 
Seat 5: JohnnyVido ($13.13 in chips) 
Seat 6: RUMJO ($13.95 in chips) 
22888899: posts small blind $0.05
Kobert72: posts big blind $0.10
*** HOLE CARDS ***
JohnnyVido: raises $0.10 to $0.20
RUMJO: folds 
andrew_yar: folds 
perespell: folds 
22888899: folds 
Kobert72: folds 
Uncalled bet ($0.10) returned to JohnnyVido
JohnnyVido collected $0.25 from pot
JohnnyVido: doesn't show hand 
*** SUMMARY ***
Total pot $0.25 | Rake $0 
Seat 1: andrew_yar folded before Flop (didn't bet)
Seat 2: perespell (button) folded before Flop (didn't bet)
Seat 3: 22888899 (small blind) folded before Flop
Seat 4: Kobert72 (big blind) folded before Flop
Seat 5: JohnnyVido collected ($0.25)
Seat 6: RUMJO folded before Flop (didn't bet)



PokerStars Hand #222971843273:  Hold'em No Limit ($0.05/$0.10 USD) - 2021/01/23 16:20:38 ET
Table 'Stephano III' 6-max Seat #3 is the button
Seat 1: andrew_yar ($12.36 in chips) 
Seat 2: perespell ($11.27 in chips) 
Seat 3: 22888899 ($3.86 in chips) 
Seat 4: Kobert72 ($12.25 in chips) 
Seat 5: JohnnyVido ($13.28 in chips) 
Seat 6: RUMJO ($13.95 in chips) 
Kobert72: posts small blind $0.05
JohnnyVido: posts big blind $0.10
*** HOLE CARDS ***
RUMJO: folds 
andrew_yar: folds 
perespell: folds 
22888899: raises $0.25 to $0.35
Kobert72: raises $0.63 to $0.98
JohnnyVido: calls $0.88
22888899: raises $2.88 to $3.86 and is all-in
Kobert72: folds 
JohnnyVido: calls $2.88
*** FLOP *** [2s 3h 4d]
*** TURN *** [2s 3h 4d] [2d]
*** RIVER *** [2s 3h 4d 2d] [9s]
*** SHOW DOWN ***
JohnnyVido: shows [Kh Tc] (a pair of Deuces)
22888899: shows [Ad Qc] (a pair of Deuces - Ace kicker)
22888899 collected $8.31 from pot
*** SUMMARY ***
Total pot $8.70 | Rake $0.39 
Board [2s 3h 4d 2d 9s]
Seat 1: andrew_yar folded before Flop (didn't bet)
Seat 2: perespell folded before Flop (didn't bet)
Seat 3: 22888899 (button) showed [Ad Qc] and won ($8.31) with a pair of Deuces
Seat 4: Kobert72 (small blind) folded before Flop
Seat 5: JohnnyVido (big blind) showed [Kh Tc] and lost with a pair of Deuces
Seat 6: RUMJO folded before Flop (didn't bet)



PokerStars Hand #222971877750:  Hold'em No Limit ($0.05/$0.10 USD) - 2021/01/23 16:21:18 ET
Table 'Stephano III' 6-max Seat #4 is the button
Seat 1: andrew_yar ($12.36 in chips) 
Seat 2: perespell ($11.27 in chips) 
Seat 3: 22888899 ($8.31 in chips) 
Seat 4: Kobert72 ($11.27 in chips) 
Seat 5: JohnnyVido ($9.42 in chips) 
Seat 6: RUMJO ($13.95 in chips) 
JohnnyVido: posts small blind $0.05
RUMJO: posts big blind $0.10
*** HOLE CARDS ***
andrew_yar: folds 
perespell: folds 
22888899: calls $0.10
Kobert72: raises $0.25 to $0.35
JohnnyVido: folds 
RUMJO: folds 
22888899: calls $0.25
*** FLOP *** [5h Th 9c]
JohnnyVido leaves the table
iqpower joins the table at seat #5 
22888899: checks 
Kobert72: checks 
*** TURN *** [5h Th 9c] [Kh]
22888899: checks 
Kobert72: checks 
*** RIVER *** [5h Th 9c Kh] [Jh]
22888899: bets $0.81
Kobert72: folds 
Uncalled bet ($0.81) returned to 22888899
22888899 collected $0.81 from pot
22888899: doesn't show hand 
*** SUMMARY ***
Total pot $0.85 | Rake $0.04 
Board [5h Th 9c Kh Jh]
Seat 1: andrew_yar folded before Flop (didn't bet)
Seat 2: perespell folded before Flop (didn't bet)
Seat 3: 22888899 collected ($0.81)
Seat 4: Kobert72 (button) folded on the River
Seat 5: JohnnyVido (small blind) folded before Flop
Seat 6: RUMJO (big blind) folded before Flop



PokerStars Hand #222971916048:  Hold'em No Limit ($0.05/$0.10 USD) - 2021/01/23 16:22:03 ET
Table 'Stephano III' 6-max Seat #6 is the button
Seat 1: andrew_yar ($12.36 in chips) 
Seat 2: perespell ($11.27 in chips) 
Seat 3: 22888899 ($8.77 in chips) 
Seat 4: Kobert72 ($10.92 in chips) 
Seat 6: RUMJO ($13.85 in chips) 
andrew_yar: posts small blind $0.05
perespell: posts big blind $0.10
iqpower: sits out 
*** HOLE CARDS ***
22888899: calls $0.10
Kobert72: folds 
RUMJO: folds 
andrew_yar: folds 
perespell: checks 
*** FLOP *** [7c 8d Js]
perespell: checks 
22888899: bets $0.12
perespell: folds 
Uncalled bet ($0.12) returned to 22888899
22888899 collected $0.24 from pot
22888899: doesn't show hand 
*** SUMMARY ***
Total pot $0.25 | Rake $0.01 
Board [7c 8d Js]
Seat 1: andrew_yar (small blind) folded before Flop
Seat 2: perespell (big blind) folded on the Flop
Seat 3: 22888899 collected ($0.24)
Seat 4: Kobert72 folded before Flop (didn't bet)
Seat 6: RUMJO (button) folded before Flop (didn't bet)



PokerStars Hand #222971937765:  Hold'em No Limit ($0.05/$0.10 USD) - 2021/01/23 16:22:28 ET
Table 'Stephano III' 6-max Seat #1 is the button
Seat 1: andrew_yar ($12.31 in chips) 
Seat 2: perespell ($11.17 in chips) 
Seat 3: 22888899 ($8.91 in chips) 
Seat 4: Kobert72 ($10.92 in chips) 
Seat 6: RUMJO ($13.85 in chips) 
perespell: posts small blind $0.05
22888899: posts big blind $0.10
iqpower: sits out 
*** HOLE CARDS ***
Kobert72: folds 
RUMJO: folds 
andrew_yar: raises $0.15 to $0.25
perespell: folds 
22888899: calls $0.15
*** FLOP *** [7c Ac Ks]
22888899: checks 
andrew_yar: bets $0.36
22888899: calls $0.36
*** TURN *** [7c Ac Ks] [Qd]
22888899: checks 
andrew_yar: checks 
*** RIVER *** [7c Ac Ks Qd] [9s]
22888899: checks 
andrew_yar: checks 
*** SHOW DOWN ***
22888899: shows [Tc 3c] (high card Ace)
andrew_yar: shows [8h 9h] (a pair of Nines)
andrew_yar collected $1.21 from pot
*** SUMMARY ***
Total pot $1.27 | Rake $0.06 
Board [7c Ac Ks Qd 9s]
Seat 1: andrew_yar (button) showed [8h 9h] and won ($1.21) with a pair of Nines
Seat 2: perespell (small blind) folded before Flop
Seat 3: 22888899 (big blind) showed [Tc 3c] and lost with high card Ace
Seat 4: Kobert72 folded before Flop (didn't bet)
Seat 6: RUMJO folded before Flop (didn't bet)



PokerStars Hand #222971965985:  Hold'em No Limit ($0.05/$0.10 USD) - 2021/01/23 16:23:01 ET
Table 'Stephano III' 6-max Seat #2 is the button
Seat 1: andrew_yar ($12.91 in chips) 
Seat 2: perespell ($11.12 in chips) 
Seat 3: 22888899 ($8.30 in chips) 
Seat 4: Kobert72 ($10.92 in chips) 
Seat 6: RUMJO ($13.85 in chips) 
22888899: posts small blind $0.05
Kobert72: posts big blind $0.10
iqpower: sits out 
*** HOLE CARDS ***
RUMJO: folds 
andrew_yar: folds 
perespell: folds 
22888899: calls $0.05
Kobert72: checks 
*** FLOP *** [Kd 8d Td]
22888899: bets $0.10
Kobert72: folds 
Uncalled bet ($0.10) returned to 22888899
22888899 collected $0.19 from pot
22888899: doesn't show hand 
*** SUMMARY ***
Total pot $0.20 | Rake $0.01 
Board [Kd 8d Td]
Seat 1: andrew_yar folded before Flop (didn't bet)
Seat 2: perespell (button) folded before Flop (didn't bet)
Seat 3: 22888899 (small blind) collected ($0.19)
Seat 4: Kobert72 (big blind) folded on the Flop
Seat 6: RUMJO folded before Flop (didn't bet)



PokerStars Hand #222971991434:  Hold'em No Limit ($0.05/$0.10 USD) - 2021/01/23 16:23:23 ET
Table 'Stephano III' 6-max Seat #3 is the button
Seat 1: andrew_yar ($12.91 in chips) 
Seat 2: perespell ($11.12 in chips) 
Seat 3: 22888899 ($8.39 in chips) 
Seat 4: Kobert72 ($10.82 in chips) 
Seat 5: iqpower ($10 in chips) 
Seat 6: RUMJO ($13.85 in chips) 
Kobert72: posts small blind $0.05
iqpower: posts big blind $0.10
*** HOLE CARDS ***
RUMJO: folds 
andrew_yar: folds 
perespell: raises $0.15 to $0.25
22888899: raises $0.65 to $0.90
Kobert72: folds 
iqpower: folds 
perespell: folds 
Uncalled bet ($0.65) returned to 22888899
22888899 collected $0.65 from pot
22888899: doesn't show hand 
*** SUMMARY ***
Total pot $0.65 | Rake $0 
Seat 1: andrew_yar folded before Flop (didn't bet)
Seat 2: perespell folded before Flop
Seat 3: 22888899 (button) collected ($0.65)
Seat 4: Kobert72 (small blind) folded before Flop
Seat 5: iqpower (big blind) folded before Flop
Seat 6: RUMJO folded before Flop (didn't bet)



PokerStars Hand #222972010180:  Hold'em No Limit ($0.05/$0.10 USD) - 2021/01/23 16:23:45 ET
Table 'Stephano III' 6-max Seat #4 is the button
Seat 1: andrew_yar ($12.91 in chips) 
Seat 2: perespell ($10.87 in chips) 
Seat 3: 22888899 ($8.79 in chips) 
Seat 4: Kobert72 ($10.77 in chips) 
Seat 5: iqpower ($10 in chips) 
Seat 6: RUMJO ($13.85 in chips) 
iqpower: posts small blind $0.05
RUMJO: posts big blind $0.10
*** HOLE CARDS ***
andrew_yar: raises $0.20 to $0.30
perespell: folds 
22888899: raises $0.75 to $1.05
Kobert72: folds 
iqpower: folds 
RUMJO: folds 
andrew_yar: calls $0.75
*** FLOP *** [Jc 4c 6d]
andrew_yar: checks 
22888899: bets $1.07
andrew_yar: folds 
Uncalled bet ($1.07) returned to 22888899
22888899 collected $2.15 from pot
22888899: doesn't show hand 
*** SUMMARY ***
Total pot $2.25 | Rake $0.10 
Board [Jc 4c 6d]
Seat 1: andrew_yar folded on the Flop
Seat 2: perespell folded before Flop (didn't bet)
Seat 3: 22888899 collected ($2.15)
Seat 4: Kobert72 (button) folded before Flop (didn't bet)
Seat 5: iqpower (small blind) folded before Flop
Seat 6: RUMJO (big blind) folded before Flop



PokerStars Hand #222972045726:  Hold'em No Limit ($0.05/$0.10 USD) - 2021/01/23 16:24:27 ET
Table 'Stephano III' 6-max Seat #5 is the button
Seat 2: perespell ($10.87 in chips) 
Seat 3: 22888899 ($9.89 in chips) 
Seat 4: Kobert72 ($10.77 in chips) 
Seat 5: iqpower ($10 in chips) 
Seat 6: RUMJO ($13.75 in chips) 
RUMJO: posts small blind $0.05
andrew_yar: is sitting out 
perespell: posts big blind $0.10
*** HOLE CARDS ***
andrew_yar leaves the table
Bino0203 joins the table at seat #1 
22888899: calls $0.10
Kobert72: folds 
iqpower: folds 
RUMJO: folds 
perespell: raises $0.15 to $0.25
22888899: calls $0.15
*** FLOP *** [Tc Td 8s]
perespell: checks 
22888899: checks 
*** TURN *** [Tc Td 8s] [3c]
perespell: checks 
22888899: checks 
*** RIVER *** [Tc Td 8s 3c] [6h]
perespell: checks 
22888899: checks 
*** SHOW DOWN ***
perespell: shows [Jc Ah] (a pair of Tens)
22888899: mucks hand 
perespell collected $0.53 from pot
*** SUMMARY ***
Total pot $0.55 | Rake $0.02 
Board [Tc Td 8s 3c 6h]
Seat 2: perespell (big blind) showed [Jc Ah] and won ($0.53) with a pair of Tens
Seat 3: 22888899 mucked
Seat 4: Kobert72 folded before Flop (didn't bet)
Seat 5: iqpower (button) folded before Flop (didn't bet)
Seat 6: RUMJO (small blind) folded before Flop



PokerStars Hand #222972077490:  Hold'em No Limit ($0.05/$0.10 USD) - 2021/01/23 16:25:04 ET
Table 'Stephano III' 6-max Seat #6 is the button
Seat 2: perespell ($11.15 in chips) 
Seat 3: 22888899 ($9.64 in chips) 
Seat 4: Kobert72 ($10.77 in chips) 
Seat 5: iqpower ($10 in chips) 
Seat 6: RUMJO ($13.70 in chips) 
perespell: posts small blind $0.05
22888899: posts big blind $0.10
*** HOLE CARDS ***
Kobert72: folds 
iqpower: folds 
RUMJO: raises $0.15 to $0.25
perespell: folds 
22888899: calls $0.15
*** FLOP *** [9c Ks 3c]
22888899: checks 
RUMJO: checks 
*** TURN *** [9c Ks 3c] [Jh]
22888899: checks 
RUMJO: checks 
*** RIVER *** [9c Ks 3c Jh] [6c]
22888899: bets $0.10
RUMJO: calls $0.10
*** SHOW DOWN ***
22888899: shows [2c 6h] (a pair of Sixes)
RUMJO: shows [Jd 8d] (a pair of Jacks)
RUMJO collected $0.72 from pot
*** SUMMARY ***
Total pot $0.75 | Rake $0.03 
Board [9c Ks 3c Jh 6c]
Seat 2: perespell (small blind) folded before Flop
Seat 3: 22888899 (big blind) showed [2c 6h] and lost with a pair of Sixes
Seat 4: Kobert72 folded before Flop (didn't bet)
Seat 5: iqpower folded before Flop (didn't bet)
Seat 6: RUMJO (button) showed [Jd 8d] and won ($0.72) with a pair of Jacks



PokerStars Hand #222972120627:  Hold'em No Limit ($0.05/$0.10 USD) - 2021/01/23 16:25:55 ET
Table 'Stephano III' 6-max Seat #2 is the button
Seat 1: Bino0203 ($8 in chips) 
Seat 2: perespell ($11.10 in chips) 
Seat 3: 22888899 ($9.29 in chips) 
Seat 4: Kobert72 ($10.77 in chips) 
Seat 5: iqpower ($10 in chips) 
Seat 6: RUMJO ($14.07 in chips) 
22888899: posts small blind $0.05
Kobert72: posts big blind $0.10
Bino0203: posts big blind $0.10
*** HOLE CARDS ***
iqpower has timed out
iqpower: folds 
RUMJO: folds 
Bino0203: raises $0.25 to $0.35
perespell: folds 
22888899: calls $0.30
Kobert72: folds 
*** FLOP *** [4s Th 7s]
22888899: checks 
Bino0203: checks 
*** TURN *** [4s Th 7s] [Tc]
22888899: checks 
Bino0203: checks 
*** RIVER *** [4s Th 7s Tc] [8h]
22888899: checks 
Bino0203: checks 
*** SHOW DOWN ***
22888899: shows [2c Ks] (a pair of Tens)
Bino0203: shows [Jc Ac] (a pair of Tens - Ace kicker)
Bino0203 collected $0.76 from pot
*** SUMMARY ***
Total pot $0.80 | Rake $0.04 
Board [4s Th 7s Tc 8h]
Seat 1: Bino0203 showed [Jc Ac] and won ($0.76) with a pair of Tens
Seat 2: perespell (button) folded before Flop (didn't bet)
Seat 3: 22888899 (small blind) showed [2c Ks] and lost with a pair of Tens
Seat 4: Kobert72 (big blind) folded before Flop
Seat 5: iqpower folded before Flop (didn't bet)
Seat 6: RUMJO folded before Flop (didn't bet)



PokerStars Hand #222972145986:  Hold'em No Limit ($0.05/$0.10 USD) - 2021/01/23 16:26:25 ET
Table 'Stephano III' 6-max Seat #3 is the button
Seat 1: Bino0203 ($8.41 in chips) 
Seat 2: perespell ($11.10 in chips) 
Seat 3: 22888899 ($8.94 in chips) 
Seat 4: Kobert72 ($10.67 in chips) 
Seat 5: iqpower ($10 in chips) 
Seat 6: RUMJO ($14.07 in chips) 
Kobert72: posts small blind $0.05
iqpower: posts big blind $0.10
*** HOLE CARDS ***
RUMJO: folds 
Bino0203: calls $0.10
perespell: folds 
22888899: raises $0.10 to $0.20
Kobert72: folds 
iqpower: folds 
Bino0203: calls $0.10
*** FLOP *** [Ah Qd Qc]
Bino0203: checks 
22888899: bets $0.26
Bino0203: calls $0.26
*** TURN *** [Ah Qd Qc] [3s]
Bino0203: checks 
22888899: checks 
*** RIVER *** [Ah Qd Qc 3s] [Ts]
Bino0203: checks 
22888899: checks 
*** SHOW DOWN ***
Bino0203: shows [Qs 9c] (three of a kind, Queens)
22888899: mucks hand 
Bino0203 collected $1.02 from pot
*** SUMMARY ***
Total pot $1.07 | Rake $0.05 
Board [Ah Qd Qc 3s Ts]
Seat 1: Bino0203 showed [Qs 9c] and won ($1.02) with three of a kind, Queens
Seat 2: perespell folded before Flop (didn't bet)
Seat 3: 22888899 (button) mucked
Seat 4: Kobert72 (small blind) folded before Flop
Seat 5: iqpower (big blind) folded before Flop
Seat 6: RUMJO folded before Flop (didn't bet)



PokerStars Hand #222972167672:  Hold'em No Limit ($0.05/$0.10 USD) - 2021/01/23 16:26:50 ET
Table 'Stephano III' 6-max Seat #4 is the button
Seat 1: Bino0203 ($8.97 in chips) 
Seat 2: perespell ($11.10 in chips) 
Seat 3: 22888899 ($8.48 in chips) 
Seat 4: Kobert72 ($10.62 in chips) 
Seat 5: iqpower ($10 in chips) 
Seat 6: RUMJO ($14.07 in chips) 
iqpower: posts small blind $0.05
RUMJO: posts big blind $0.10
*** HOLE CARDS ***
Bino0203: folds 
perespell: folds 
22888899: raises $0.20 to $0.30
Kobert72: folds 
iqpower: calls $0.25
RUMJO: calls $0.20
*** FLOP *** [3d 3h Qh]
iqpower: checks 
RUMJO: checks 
22888899: checks 
*** TURN *** [3d 3h Qh] [8c]
iqpower: checks 
RUMJO: checks 
22888899: checks 
*** RIVER *** [3d 3h Qh 8c] [9s]
iqpower: checks 
RUMJO: checks 
22888899: checks 
*** SHOW DOWN ***
iqpower: shows [Ts Kd] (a pair of Threes)
RUMJO: shows [2c Ac] (a pair of Threes - Ace kicker)
22888899: mucks hand 
RUMJO collected $0.86 from pot
*** SUMMARY ***
Total pot $0.90 | Rake $0.04 
Board [3d 3h Qh 8c 9s]
Seat 1: Bino0203 folded before Flop (didn't bet)
Seat 2: perespell folded before Flop (didn't bet)
Seat 3: 22888899 mucked
Seat 4: Kobert72 (button) folded before Flop (didn't bet)
Seat 5: iqpower (small blind) showed [Ts Kd] and lost with a pair of Threes
Seat 6: RUMJO (big blind) showed [2c Ac] and won ($0.86) with a pair of Threes



PokerStars Hand #222972197719:  Hold'em No Limit ($0.05/$0.10 USD) - 2021/01/23 16:27:26 ET
Table 'Stephano III' 6-max Seat #5 is the button
Seat 1: Bino0203 ($8.97 in chips) 
Seat 2: perespell ($11.10 in chips) 
Seat 3: 22888899 ($8.18 in chips) 
Seat 4: Kobert72 ($10.62 in chips) 
Seat 5: iqpower ($10 in chips) 
Seat 6: RUMJO ($14.63 in chips) 
RUMJO: posts small blind $0.05
Bino0203: posts big blind $0.10
*** HOLE CARDS ***
perespell: folds 
22888899: calls $0.10
Kobert72: folds 
iqpower: raises $0.35 to $0.45
RUMJO: folds 
Bino0203: calls $0.35
22888899: calls $0.35
*** FLOP *** [Jc 7s 3c]
Bino0203: checks 
22888899: checks 
iqpower: bets $0.80
Bino0203: folds 
22888899: folds 
Uncalled bet ($0.80) returned to iqpower
iqpower collected $1.34 from pot
iqpower: doesn't show hand 
*** SUMMARY ***
Total pot $1.40 | Rake $0.06 
Board [Jc 7s 3c]
Seat 1: Bino0203 (big blind) folded on the Flop
Seat 2: perespell folded before Flop (didn't bet)
Seat 3: 22888899 folded on the Flop
Seat 4: Kobert72 folded before Flop (didn't bet)
Seat 5: iqpower (button) collected ($1.34)
Seat 6: RUMJO (small blind) folded before Flop



PokerStars Hand #222972229590:  Hold'em No Limit ($0.05/$0.10 USD) - 2021/01/23 16:28:03 ET
Table 'Stephano III' 6-max Seat #6 is the button
Seat 1: Bino0203 ($8.52 in chips) 
Seat 2: perespell ($11.10 in chips) 
Seat 3: 22888899 ($7.73 in chips) 
Seat 4: Kobert72 ($10.62 in chips) 
Seat 5: iqpower ($10.89 in chips) 
Seat 6: RUMJO ($14.58 in chips) 
Bino0203: posts small blind $0.05
perespell: posts big blind $0.10
*** HOLE CARDS ***
22888899: raises $0.10 to $0.20
Kobert72: folds 
iqpower: calls $0.20
RUMJO: folds 
Bino0203: folds 
perespell: calls $0.10
*** FLOP *** [6d 3d Td]
perespell: checks 
22888899: checks 
iqpower: checks 
*** TURN *** [6d 3d Td] [Ks]
perespell: bets $0.32
22888899: folds 
iqpower: calls $0.32
*** RIVER *** [6d 3d Td Ks] [8s]
perespell: checks 
iqpower: bets $0.50
perespell: folds 
Uncalled bet ($0.50) returned to iqpower
iqpower collected $1.23 from pot
iqpower: doesn't show hand 
*** SUMMARY ***
Total pot $1.29 | Rake $0.06 
Board [6d 3d Td Ks 8s]
Seat 1: Bino0203 (small blind) folded before Flop
Seat 2: perespell (big blind) folded on the River
Seat 3: 22888899 folded on the Turn
Seat 4: Kobert72 folded before Flop (didn't bet)
Seat 5: iqpower collected ($1.23)
Seat 6: RUMJO (button) folded before Flop (didn't bet)



PokerStars Hand #222972268664:  Hold'em No Limit ($0.05/$0.10 USD) - 2021/01/23 16:28:49 ET
Table 'Stephano III' 6-max Seat #1 is the button
Seat 1: Bino0203 ($8.47 in chips) 
Seat 2: perespell ($10.58 in chips) 
Seat 3: 22888899 ($7.53 in chips) 
Seat 4: Kobert72 ($10.62 in chips) 
Seat 5: iqpower ($11.60 in chips) 
Seat 6: RUMJO ($14.58 in chips) 
perespell: posts small blind $0.05
22888899: posts big blind $0.10
*** HOLE CARDS ***
Kobert72: raises $0.13 to $0.23
iqpower: folds 
RUMJO: folds 
Bino0203: calls $0.23
perespell: folds 
22888899: calls $0.13
*** FLOP *** [Qh Js 7c]
22888899: checks 
Kobert72: checks 
Bino0203: checks 
*** TURN *** [Qh Js 7c] [7h]
22888899: checks 
Kobert72: checks 
Bino0203: checks 
*** RIVER *** [Qh Js 7c 7h] [Tc]
22888899: bets $0.10
Kobert72: folds 
Bino0203: folds 
Uncalled bet ($0.10) returned to 22888899
22888899 collected $0.71 from pot
22888899: doesn't show hand 
*** SUMMARY ***
Total pot $0.74 | Rake $0.03 
Board [Qh Js 7c 7h Tc]
Seat 1: Bino0203 (button) folded on the River
Seat 2: perespell (small blind) folded before Flop
Seat 3: 22888899 (big blind) collected ($0.71)
Seat 4: Kobert72 folded on the River
Seat 5: iqpower folded before Flop (didn't bet)
Seat 6: RUMJO folded before Flop (didn't bet)



PokerStars Hand #222972312633:  Hold'em No Limit ($0.05/$0.10 USD) - 2021/01/23 16:29:41 ET
Table 'Stephano III' 6-max Seat #2 is the button
Seat 1: Bino0203 ($8.24 in chips) 
Seat 2: perespell ($10.53 in chips) 
Seat 3: 22888899 ($8.01 in chips) 
Seat 4: Kobert72 ($10.39 in chips) 
Seat 5: iqpower ($11.60 in chips) 
Seat 6: RUMJO ($14.58 in chips) 
22888899: posts small blind $0.05
Kobert72: posts big blind $0.10
*** HOLE CARDS ***
iqpower: folds 
RUMJO: folds 
Bino0203: folds 
perespell: folds 
22888899: calls $0.05
Kobert72: checks 
*** FLOP *** [Js 2c 6d]
22888899: checks 
Kobert72: checks 
*** TURN *** [Js 2c 6d] [Th]
22888899: checks 
Kobert72: checks 
*** RIVER *** [Js 2c 6d Th] [Ah]
22888899: checks 
Kobert72: checks 
*** SHOW DOWN ***
22888899: shows [Ks 9h] (high card Ace)
Kobert72: shows [7d Td] (a pair of Tens)
Kobert72 collected $0.19 from pot
*** SUMMARY ***
Total pot $0.20 | Rake $0.01 
Board [Js 2c 6d Th Ah]
Seat 1: Bino0203 folded before Flop (didn't bet)
Seat 2: perespell (button) folded before Flop (didn't bet)
Seat 3: 22888899 (small blind) showed [Ks 9h] and lost with high card Ace
Seat 4: Kobert72 (big blind) showed [7d Td] and won ($0.19) with a pair of Tens
Seat 5: iqpower folded before Flop (didn't bet)
Seat 6: RUMJO folded before Flop (didn't bet)



PokerStars Hand #222972348124:  Hold'em No Limit ($0.05/$0.10 USD) - 2021/01/23 16:30:22 ET
Table 'Stephano III' 6-max Seat #3 is the button
Seat 1: Bino0203 ($8.24 in chips) 
Seat 2: perespell ($10.53 in chips) 
Seat 3: 22888899 ($7.91 in chips) 
Seat 4: Kobert72 ($10.48 in chips) 
Seat 5: iqpower ($11.60 in chips) 
Seat 6: RUMJO ($14.58 in chips) 
Kobert72: posts small blind $0.05
iqpower: posts big blind $0.10
*** HOLE CARDS ***
RUMJO: folds 
Bino0203: folds 
perespell: folds 
22888899: folds 
Kobert72: folds 
Uncalled bet ($0.05) returned to iqpower
iqpower collected $0.10 from pot
iqpower: doesn't show hand 
*** SUMMARY ***
Total pot $0.10 | Rake $0 
Seat 1: Bino0203 folded before Flop (didn't bet)
Seat 2: perespell folded before Flop (didn't bet)
Seat 3: 22888899 (button) folded before Flop (didn't bet)
Seat 4: Kobert72 (small blind) folded before Flop
Seat 5: iqpower (big blind) collected ($0.10)
Seat 6: RUMJO folded before Flop (didn't bet)



PokerStars Hand #222972359499:  Hold'em No Limit ($0.05/$0.10 USD) - 2021/01/23 16:30:36 ET
Table 'Stephano III' 6-max Seat #4 is the button
Seat 1: Bino0203 ($8.24 in chips) 
Seat 2: perespell ($10.53 in chips) 
Seat 3: 22888899 ($7.91 in chips) 
Seat 4: Kobert72 ($10.43 in chips) 
Seat 5: iqpower ($11.65 in chips) 
Seat 6: RUMJO ($14.58 in chips) 
iqpower: posts small blind $0.05
RUMJO: posts big blind $0.10
*** HOLE CARDS ***
Bino0203: folds 
perespell: folds 
22888899: calls $0.10
Kobert72: folds 
iqpower: folds 
RUMJO: checks 
*** FLOP *** [5d 4c 6h]
RUMJO: bets $0.14
22888899: calls $0.14
*** TURN *** [5d 4c 6h] [Ad]
RUMJO: bets $0.50
22888899: folds 
Uncalled bet ($0.50) returned to RUMJO
RUMJO collected $0.51 from pot
RUMJO: doesn't show hand 
*** SUMMARY ***
Total pot $0.53 | Rake $0.02 
Board [5d 4c 6h Ad]
Seat 1: Bino0203 folded before Flop (didn't bet)
Seat 2: perespell folded before Flop (didn't bet)
Seat 3: 22888899 folded on the Turn
Seat 4: Kobert72 (button) folded before Flop (didn't bet)
Seat 5: iqpower (small blind) folded before Flop
Seat 6: RUMJO (big blind) collected ($0.51)



PokerStars Hand #222972383402:  Hold'em No Limit ($0.05/$0.10 USD) - 2021/01/23 16:30:59 ET
Table 'Stephano III' 6-max Seat #5 is the button
Seat 1: Bino0203 ($8.24 in chips) 
Seat 2: perespell ($10.53 in chips) 
Seat 3: 22888899 ($7.67 in chips) 
Seat 4: Kobert72 ($10.43 in chips) 
Seat 5: iqpower ($11.60 in chips) 
Seat 6: RUMJO ($14.85 in chips) 
RUMJO: posts small blind $0.05
Bino0203: posts big blind $0.10
*** HOLE CARDS ***
perespell: folds 
22888899: calls $0.10
Kobert72: folds 
iqpower: folds 
RUMJO: folds 
Bino0203: checks 
*** FLOP *** [Ad 8d Td]
Bino0203: checks 
22888899: checks 
*** TURN *** [Ad 8d Td] [Qs]
Bino0203: checks 
22888899: checks 
*** RIVER *** [Ad 8d Td Qs] [5s]
Bino0203: checks 
22888899: checks 
*** SHOW DOWN ***
Bino0203: shows [5h 2d] (a pair of Fives)
22888899: mucks hand 
Bino0203 collected $0.24 from pot
*** SUMMARY ***
Total pot $0.25 | Rake $0.01 
Board [Ad 8d Td Qs 5s]
Seat 1: Bino0203 (big blind) showed [5h 2d] and won ($0.24) with a pair of Fives
Seat 2: perespell folded before Flop (didn't bet)
Seat 3: 22888899 mucked
Seat 4: Kobert72 folded before Flop (didn't bet)
Seat 5: iqpower (button) folded before Flop (didn't bet)
Seat 6: RUMJO (small blind) folded before Flop



PokerStars Hand #222972414755:  Hold'em No Limit ($0.05/$0.10 USD) - 2021/01/23 16:31:36 ET
Table 'Stephano III' 6-max Seat #6 is the button
Seat 1: Bino0203 ($8.38 in chips) 
Seat 2: perespell ($10.53 in chips) 
Seat 3: 22888899 ($7.57 in chips) 
Seat 4: Kobert72 ($10.43 in chips) 
Seat 5: iqpower ($11.60 in chips) 
Seat 6: RUMJO ($14.80 in chips) 
Bino0203: posts small blind $0.05
perespell: posts big blind $0.10
*** HOLE CARDS ***
22888899: raises $0.10 to $0.20
Kobert72: folds 
iqpower: folds 
RUMJO: folds 
Bino0203: calls $0.15
perespell: calls $0.10
*** FLOP *** [Qd 2d Js]
Bino0203: checks 
perespell: checks 
22888899: checks 
*** TURN *** [Qd 2d Js] [9c]
Bino0203: checks 
perespell: checks 
22888899: bets $0.28
Bino0203: folds 
perespell: calls $0.28
*** RIVER *** [Qd 2d Js 9c] [4d]
perespell: checks 
22888899: checks 
*** SHOW DOWN ***
perespell: shows [Jc Th] (a pair of Jacks)
22888899: mucks hand 
perespell collected $1.11 from pot
*** SUMMARY ***
Total pot $1.16 | Rake $0.05 
Board [Qd 2d Js 9c 4d]
Seat 1: Bino0203 (small blind) folded on the Turn
Seat 2: perespell (big blind) showed [Jc Th] and won ($1.11) with a pair of Jacks
Seat 3: 22888899 mucked
Seat 4: Kobert72 folded before Flop (didn't bet)
Seat 5: iqpower folded before Flop (didn't bet)
Seat 6: RUMJO (button) folded before Flop (didn't bet)



PokerStars Hand #222972458720:  Hold'em No Limit ($0.05/$0.10 USD) - 2021/01/23 16:32:28 ET
Table 'Stephano III' 6-max Seat #1 is the button
Seat 1: Bino0203 ($8.18 in chips) 
Seat 2: perespell ($11.16 in chips) 
Seat 3: 22888899 ($7.09 in chips) 
Seat 4: Kobert72 ($10.43 in chips) 
Seat 5: iqpower ($11.60 in chips) 
Seat 6: RUMJO ($14.80 in chips) 
perespell: posts small blind $0.05
22888899: posts big blind $0.10
*** HOLE CARDS ***
Kobert72: folds 
iqpower: raises $0.15 to $0.25
RUMJO: folds 
Bino0203: calls $0.25
perespell: calls $0.20
22888899: calls $0.15
*** FLOP *** [8d 3s 3h]
perespell: checks 
22888899: checks 
iqpower: checks 
Bino0203: checks 
*** TURN *** [8d 3s 3h] [Jc]
perespell: checks 
22888899: checks 
iqpower: checks 
Bino0203: checks 
*** RIVER *** [8d 3s 3h Jc] [Ks]
perespell: checks 
22888899: checks 
iqpower: bets $0.20
Bino0203: calls $0.20
perespell: folds 
22888899: folds 
*** SHOW DOWN ***
iqpower: shows [Kd As] (two pair, Kings and Threes)
Bino0203: shows [Kh Js] (two pair, Kings and Jacks)
Bino0203 collected $1.34 from pot
*** SUMMARY ***
Total pot $1.40 | Rake $0.06 
Board [8d 3s 3h Jc Ks]
Seat 1: Bino0203 (button) showed [Kh Js] and won ($1.34) with two pair, Kings and Jacks
Seat 2: perespell (small blind) folded on the River
Seat 3: 22888899 (big blind) folded on the River
Seat 4: Kobert72 folded before Flop (didn't bet)
Seat 5: iqpower showed [Kd As] and lost with two pair, Kings and Threes
Seat 6: RUMJO folded before Flop (didn't bet)



PokerStars Hand #222972492108:  Hold'em No Limit ($0.05/$0.10 USD) - 2021/01/23 16:33:07 ET
Table 'Stephano III' 6-max Seat #2 is the button
Seat 1: Bino0203 ($9.07 in chips) 
Seat 2: perespell ($10.91 in chips) 
Seat 3: 22888899 ($6.84 in chips) 
Seat 5: iqpower ($11.15 in chips) 
Seat 6: RUMJO ($14.80 in chips) 
22888899: posts small blind $0.05
Kobert72: is sitting out 
iqpower: posts big blind $0.10
*** HOLE CARDS ***
RUMJO: folds 
Bino0203: folds 
Kobert72 leaves the table
perespell: raises $0.15 to $0.25
22888899: calls $0.20
iqpower: folds 
*** FLOP *** [6c 7h Jd]
22888899: checks 
perespell: checks 
*** TURN *** [6c 7h Jd] [Qh]
22888899: checks 
perespell: checks 
*** RIVER *** [6c 7h Jd Qh] [9c]
22888899: checks 
perespell: checks 
*** SHOW DOWN ***
22888899: shows [2h 5s] (high card Queen)
perespell: shows [5d 5c] (a pair of Fives)
perespell collected $0.57 from pot
*** SUMMARY ***
Total pot $0.60 | Rake $0.03 
Board [6c 7h Jd Qh 9c]
Seat 1: Bino0203 folded before Flop (didn't bet)
Seat 2: perespell (button) showed [5d 5c] and won ($0.57) with a pair of Fives
Seat 3: 22888899 (small blind) showed [2h 5s] and lost with high card Queen
Seat 5: iqpower (big blind) folded before Flop
Seat 6: RUMJO folded before Flop (didn't bet)



PokerStars Hand #222972524195:  Hold'em No Limit ($0.05/$0.10 USD) - 2021/01/23 16:33:45 ET
Table 'Stephano III' 6-max Seat #3 is the button
Seat 1: Bino0203 ($9.07 in chips) 
Seat 2: perespell ($11.23 in chips) 
Seat 3: 22888899 ($6.59 in chips) 
Seat 5: iqpower ($11.05 in chips) 
Seat 6: RUMJO ($14.80 in chips) 
iqpower: posts small blind $0.05
RUMJO: posts big blind $0.10
*** HOLE CARDS ***
Bino0203: folds 
perespell: folds 
22888899: raises $0.10 to $0.20
iqpower: folds 
RUMJO: folds 
Uncalled bet ($0.10) returned to 22888899
22888899 collected $0.25 from pot
22888899: doesn't show hand 
*** SUMMARY ***
Total pot $0.25 | Rake $0 
Seat 1: Bino0203 folded before Flop (didn't bet)
Seat 2: perespell folded before Flop (didn't bet)
Seat 3: 22888899 (button) collected ($0.25)
Seat 5: iqpower (small blind) folded before Flop
Seat 6: RUMJO (big blind) folded before Flop



PokerStars Hand #222972543091:  Hold'em No Limit ($0.05/$0.10 USD) - 2021/01/23 16:34:08 ET
Table 'Stephano III' 6-max Seat #5 is the button
Seat 1: Bino0203 ($9.07 in chips) 
Seat 2: perespell ($11.23 in chips) 
Seat 3: 22888899 ($6.74 in chips) 
Seat 5: iqpower ($11 in chips) 
Seat 6: RUMJO ($14.70 in chips) 
RUMJO: posts small blind $0.05
Bino0203: posts big blind $0.10
*** HOLE CARDS ***
perespell: folds 
22888899: folds 
marcin116 joins the table at seat #4 
iqpower: raises $0.10 to $0.20
RUMJO: calls $0.15
Bino0203: calls $0.10
*** FLOP *** [2h Kc 6d]
RUMJO: checks 
Bino0203: checks 
iqpower: bets $0.29
RUMJO: folds 
Bino0203: folds 
Uncalled bet ($0.29) returned to iqpower
iqpower collected $0.57 from pot
iqpower: doesn't show hand 
*** SUMMARY ***
Total pot $0.60 | Rake $0.03 
Board [2h Kc 6d]
Seat 1: Bino0203 (big blind) folded on the Flop
Seat 2: perespell folded before Flop (didn't bet)
Seat 3: 22888899 folded before Flop (didn't bet)
Seat 5: iqpower (button) collected ($0.57)
Seat 6: RUMJO (small blind) folded on the Flop



PokerStars Hand #222972572887:  Hold'em No Limit ($0.05/$0.10 USD) - 2021/01/23 16:34:43 ET
Table 'Stephano III' 6-max Seat #6 is the button
Seat 1: Bino0203 ($8.87 in chips) 
Seat 2: perespell ($11.23 in chips) 
Seat 3: 22888899 ($6.74 in chips) 
Seat 5: iqpower ($11.37 in chips) 
Seat 6: RUMJO ($14.50 in chips) 
Bino0203: posts small blind $0.05
perespell: posts big blind $0.10
marcin116: sits out 
*** HOLE CARDS ***
22888899: raises $0.20 to $0.30
iqpower: folds 
RUMJO: folds 
Bino0203: folds 
perespell: calls $0.20
*** FLOP *** [4d 6d Ks]
perespell: checks 
22888899: bets $0.31
perespell: folds 
Uncalled bet ($0.31) returned to 22888899
22888899 collected $0.62 from pot
22888899: doesn't show hand 
*** SUMMARY ***
Total pot $0.65 | Rake $0.03 
Board [4d 6d Ks]
Seat 1: Bino0203 (small blind) folded before Flop
Seat 2: perespell (big blind) folded on the Flop
Seat 3: 22888899 collected ($0.62)
Seat 5: iqpower folded before Flop (didn't bet)
Seat 6: RUMJO (button) folded before Flop (didn't bet)



PokerStars Hand #222972606883:  Hold'em No Limit ($0.05/$0.10 USD) - 2021/01/23 16:35:24 ET
Table 'Stephano III' 6-max Seat #1 is the button
Seat 1: Bino0203 ($8.82 in chips) 
Seat 2: perespell ($10.93 in chips) 
Seat 3: 22888899 ($7.06 in chips) 
Seat 5: iqpower ($11.37 in chips) 
Seat 6: RUMJO ($14.50 in chips) 
perespell: posts small blind $0.05
22888899: posts big blind $0.10
marcin116: sits out 
*** HOLE CARDS ***
iqpower: folds 
RUMJO: folds 
Bino0203: raises $0.10 to $0.20
perespell: folds 
22888899: raises $0.10 to $0.30
Bino0203: calls $0.10
*** FLOP *** [4h 9s 5h]
22888899: bets $0.31
Bino0203: folds 
Uncalled bet ($0.31) returned to 22888899
22888899 collected $0.62 from pot
22888899: doesn't show hand 
*** SUMMARY ***
Total pot $0.65 | Rake $0.03 
Board [4h 9s 5h]
Seat 1: Bino0203 (button) folded on the Flop
Seat 2: perespell (small blind) folded before Flop
Seat 3: 22888899 (big blind) collected ($0.62)
Seat 5: iqpower folded before Flop (didn't bet)
Seat 6: RUMJO folded before Flop (didn't bet)



PokerStars Hand #222972626540:  Hold'em No Limit ($0.05/$0.10 USD) - 2021/01/23 16:35:47 ET
Table 'Stephano III' 6-max Seat #2 is the button
Seat 1: Bino0203 ($8.52 in chips) 
Seat 2: perespell ($10.88 in chips) 
Seat 3: 22888899 ($7.38 in chips) 
Seat 4: marcin116 ($10 in chips) 
Seat 5: iqpower ($11.37 in chips) 
Seat 6: RUMJO ($14.50 in chips) 
22888899: posts small blind $0.05
marcin116: posts big blind $0.10
*** HOLE CARDS ***
iqpower: folds 
RUMJO: folds 
Bino0203: folds 
perespell: folds 
22888899: raises $0.20 to $0.30
marcin116: calls $0.20
*** FLOP *** [Jd 2s Kd]
22888899: checks 
marcin116: checks 
*** TURN *** [Jd 2s Kd] [6h]
22888899: checks 
marcin116: checks 
*** RIVER *** [Jd 2s Kd 6h] [9h]
22888899: checks 
marcin116: checks 
*** SHOW DOWN ***
22888899: shows [As 4s] (high card Ace)
marcin116: shows [6s Ah] (a pair of Sixes)
marcin116 collected $0.57 from pot
*** SUMMARY ***
Total pot $0.60 | Rake $0.03 
Board [Jd 2s Kd 6h 9h]
Seat 1: Bino0203 folded before Flop (didn't bet)
Seat 2: perespell (button) folded before Flop (didn't bet)
Seat 3: 22888899 (small blind) showed [As 4s] and lost with high card Ace
Seat 4: marcin116 (big blind) showed [6s Ah] and won ($0.57) with a pair of Sixes
Seat 5: iqpower folded before Flop (didn't bet)
Seat 6: RUMJO folded before Flop (didn't bet)



PokerStars Hand #222972658681:  Hold'em No Limit ($0.05/$0.10 USD) - 2021/01/23 16:36:26 ET
Table 'Stephano III' 6-max Seat #3 is the button
Seat 1: Bino0203 ($8.52 in chips) 
Seat 2: perespell ($10.88 in chips) 
Seat 3: 22888899 ($7.08 in chips) 
Seat 4: marcin116 ($10.27 in chips) 
Seat 6: RUMJO ($14.50 in chips) 
marcin116: posts small blind $0.05
iqpower: is sitting out 
RUMJO: posts big blind $0.10
*** HOLE CARDS ***
iqpower leaves the table
Bino0203: calls $0.10
perespell: folds 
22888899: calls $0.10
dancayamanda joins the table at seat #5 
marcin116: folds 
RUMJO: checks 
*** FLOP *** [4c 6c 2s]
RUMJO: checks 
Bino0203: bets $0.16
22888899: folds 
RUMJO: calls $0.16
*** TURN *** [4c 6c 2s] [Qd]
RUMJO: checks 
Bino0203: bets $0.64
RUMJO: folds 
Uncalled bet ($0.64) returned to Bino0203
Bino0203 collected $0.64 from pot
Bino0203: doesn't show hand 
*** SUMMARY ***
Total pot $0.67 | Rake $0.03 
Board [4c 6c 2s Qd]
Seat 1: Bino0203 collected ($0.64)
Seat 2: perespell folded before Flop (didn't bet)
Seat 3: 22888899 (button) folded on the Flop
Seat 4: marcin116 (small blind) folded before Flop
Seat 6: RUMJO (big blind) folded on the Turn



PokerStars Hand #222972681158:  Hold'em No Limit ($0.05/$0.10 USD) - 2021/01/23 16:36:52 ET
Table 'Stephano III' 6-max Seat #4 is the button
Seat 1: Bino0203 ($8.90 in chips) 
Seat 2: perespell ($10.88 in chips) 
Seat 3: 22888899 ($6.98 in chips) 
Seat 4: marcin116 ($10.22 in chips) 
Seat 6: RUMJO ($14.24 in chips) 
RUMJO: posts small blind $0.05
Bino0203: posts big blind $0.10
*** HOLE CARDS ***
perespell: folds 
22888899: calls $0.10
marcin116: folds 
RUMJO: raises $0.30 to $0.40
Bino0203: calls $0.30
22888899: calls $0.30
*** FLOP *** [2c 3s Qs]
RUMJO: checks 
Bino0203: checks 
22888899: checks 
*** TURN *** [2c 3s Qs] [2s]
RUMJO: checks 
Bino0203: bets $0.57
22888899: folds 
RUMJO: folds 
Uncalled bet ($0.57) returned to Bino0203
Bino0203 collected $1.15 from pot
Bino0203: doesn't show hand 
*** SUMMARY ***
Total pot $1.20 | Rake $0.05 
Board [2c 3s Qs 2s]
Seat 1: Bino0203 (big blind) collected ($1.15)
Seat 2: perespell folded before Flop (didn't bet)
Seat 3: 22888899 folded on the Turn
Seat 4: marcin116 (button) folded before Flop (didn't bet)
Seat 6: RUMJO (small blind) folded on the Turn



PokerStars Hand #222972714738:  Hold'em No Limit ($0.05/$0.10 USD) - 2021/01/23 16:37:33 ET
Table 'Stephano III' 6-max Seat #6 is the button
Seat 1: Bino0203 ($9.65 in chips) 
Seat 2: perespell ($10.88 in chips) 
Seat 3: 22888899 ($6.58 in chips) 
Seat 4: marcin116 ($10.22 in chips) 
Seat 6: RUMJO ($13.84 in chips) 
Bino0203: posts small blind $0.05
perespell: posts big blind $0.10
dancayamanda: sits out 
*** HOLE CARDS ***
22888899: raises $0.20 to $0.30
marcin116: folds 
RUMJO: folds 
Bino0203: folds 
perespell: folds 
Uncalled bet ($0.20) returned to 22888899
22888899 collected $0.25 from pot
22888899: doesn't show hand 
*** SUMMARY ***
Total pot $0.25 | Rake $0 
Seat 1: Bino0203 (small blind) folded before Flop
Seat 2: perespell (big blind) folded before Flop
Seat 3: 22888899 collected ($0.25)
Seat 4: marcin116 folded before Flop (didn't bet)
Seat 6: RUMJO (button) folded before Flop (didn't bet)



PokerStars Hand #222972723574:  Hold'em No Limit ($0.05/$0.10 USD) - 2021/01/23 16:37:43 ET
Table 'Stephano III' 6-max Seat #1 is the button
Seat 1: Bino0203 ($9.60 in chips) 
Seat 2: perespell ($10.78 in chips) 
Seat 3: 22888899 ($6.73 in chips) 
Seat 4: marcin116 ($10.22 in chips) 
Seat 6: RUMJO ($13.84 in chips) 
perespell: posts small blind $0.05
22888899: posts big blind $0.10
dancayamanda: sits out 
*** HOLE CARDS ***
marcin116: raises $0.25 to $0.35
RUMJO: folds 
Bino0203: folds 
perespell: folds 
22888899: calls $0.25
*** FLOP *** [7s 8s 2c]
22888899: bets $0.36
marcin116: folds 
Uncalled bet ($0.36) returned to 22888899
22888899 collected $0.72 from pot
22888899: doesn't show hand 
*** SUMMARY ***
Total pot $0.75 | Rake $0.03 
Board [7s 8s 2c]
Seat 1: Bino0203 (button) folded before Flop (didn't bet)
Seat 2: perespell (small blind) folded before Flop
Seat 3: 22888899 (big blind) collected ($0.72)
Seat 4: marcin116 folded on the Flop
Seat 6: RUMJO folded before Flop (didn't bet)



PokerStars Hand #222972739756:  Hold'em No Limit ($0.05/$0.10 USD) - 2021/01/23 16:38:03 ET
Table 'Stephano III' 6-max Seat #2 is the button
Seat 1: Bino0203 ($9.60 in chips) 
Seat 2: perespell ($10.73 in chips) 
Seat 3: 22888899 ($7.10 in chips) 
Seat 4: marcin116 ($10 in chips) 
Seat 6: RUMJO ($13.84 in chips) 
22888899: posts small blind $0.05
marcin116: posts big blind $0.10
dancayamanda: sits out 
*** HOLE CARDS ***
RUMJO: raises $0.15 to $0.25
Bino0203: folds 
perespell: folds 
22888899: calls $0.20
marcin116: folds 
*** FLOP *** [6d Qs 4d]
22888899: checks 
RUMJO: bets $0.17
22888899: folds 
Uncalled bet ($0.17) returned to RUMJO
RUMJO collected $0.57 from pot
RUMJO: doesn't show hand 
*** SUMMARY ***
Total pot $0.60 | Rake $0.03 
Board [6d Qs 4d]
Seat 1: Bino0203 folded before Flop (didn't bet)
Seat 2: perespell (button) folded before Flop (didn't bet)
Seat 3: 22888899 (small blind) folded on the Flop
Seat 4: marcin116 (big blind) folded before Flop
Seat 6: RUMJO collected ($0.57)



PokerStars Hand #222972757852:  Hold'em No Limit ($0.05/$0.10 USD) - 2021/01/23 16:38:24 ET
Table 'Stephano III' 6-max Seat #3 is the button
Seat 1: Bino0203 ($9.60 in chips) 
Seat 2: perespell ($10.73 in chips) 
Seat 3: 22888899 ($6.85 in chips) 
Seat 4: marcin116 ($10 in chips) 
Seat 5: dancayamanda ($10 in chips) 
Seat 6: RUMJO ($14.16 in chips) 
marcin116: posts small blind $0.05
dancayamanda: posts big blind $0.10
*** HOLE CARDS ***
RUMJO: folds 
Bino0203: raises $0.40 to $0.50
perespell: calls $0.50
22888899: folds 
marcin116: folds 
dancayamanda: folds 
*** FLOP *** [Qh Kd 9d]
Bino0203: checks 
perespell: bets $0.56
Bino0203: folds 
Uncalled bet ($0.56) returned to perespell
perespell collected $1.10 from pot
perespell: doesn't show hand 
*** SUMMARY ***
Total pot $1.15 | Rake $0.05 
Board [Qh Kd 9d]
Seat 1: Bino0203 folded on the Flop
Seat 2: perespell collected ($1.10)
Seat 3: 22888899 (button) folded before Flop (didn't bet)
Seat 4: marcin116 (small blind) folded before Flop
Seat 5: dancayamanda (big blind) folded before Flop
Seat 6: RUMJO folded before Flop (didn't bet)



PokerStars Hand #222976032467:  Hold'em No Limit ($0.05/$0.10 USD) - 2021/01/23 17:46:33 ET
Table 'Stephano III' 6-max Seat #4 is the button
Seat 2: perespell ($16.77 in chips) 
Seat 3: jammer35983 ($2.20 in chips) 
Seat 4: kimmarusa ($8.26 in chips) 
Seat 5: dancayamanda ($19.73 in chips) 
Seat 6: Buetch ($8.70 in chips) 
dancayamanda: posts small blind $0.05
Buetch: posts big blind $0.10
*** HOLE CARDS ***
perespell: folds 
jammer35983: calls $0.10
kimmarusa: raises $0.20 to $0.30
dancayamanda: folds 
Buetch: folds 
jammer35983: calls $0.20
*** FLOP *** [3h 3s 5d]
jammer35983: checks 
kimmarusa: checks 
*** TURN *** [3h 3s 5d] [Ad]
jammer35983: checks 
kimmarusa: checks 
*** RIVER *** [3h 3s 5d Ad] [5c]
jammer35983: checks 
kimmarusa: checks 
*** SHOW DOWN ***
jammer35983: shows [7c Jh] (two pair, Fives and Threes)
kimmarusa: shows [Qc Td] (two pair, Fives and Threes)
jammer35983 collected $0.36 from pot
kimmarusa collected $0.36 from pot
*** SUMMARY ***
Total pot $0.75 | Rake $0.03 
Board [3h 3s 5d Ad 5c]
Seat 2: perespell folded before Flop (didn't bet)
Seat 3: jammer35983 showed [7c Jh] and won ($0.36) with two pair, Fives and Threes
Seat 4: kimmarusa (button) showed [Qc Td] and won ($0.36) with two pair, Fives and Threes
Seat 5: dancayamanda (small blind) folded before Flop
Seat 6: Buetch (big blind) folded before Flop



PokerStars Hand #222976072870:  Hold'em No Limit ($0.05/$0.10 USD) - 2021/01/23 17:47:27 ET
Table 'Stephano III' 6-max Seat #5 is the button
Seat 2: perespell ($16.77 in chips) 
Seat 3: jammer35983 ($2.26 in chips) 
Seat 4: kimmarusa ($8.32 in chips) 
Seat 5: dancayamanda ($19.68 in chips) 
Seat 6: Buetch ($8.60 in chips) 
Buetch: posts small blind $0.05
perespell: posts big blind $0.10
*** HOLE CARDS ***
jammer35983: raises $0.10 to $0.20
kimmarusa: raises $0.70 to $0.90
dancayamanda: folds 
Buetch: folds 
perespell: folds 
jammer35983: calls $0.70
*** FLOP *** [5h Jh 9c]
jammer35983: bets $1.36 and is all-in
kimmarusa: calls $1.36
*** TURN *** [5h Jh 9c] [Qd]
*** RIVER *** [5h Jh 9c Qd] [2h]
*** SHOW DOWN ***
jammer35983: shows [Ah 9d] (a pair of Nines)
kimmarusa: shows [Ac Qs] (a pair of Queens)
kimmarusa collected $4.46 from pot
*** SUMMARY ***
Total pot $4.67 | Rake $0.21 
Board [5h Jh 9c Qd 2h]
Seat 2: perespell (big blind) folded before Flop
Seat 3: jammer35983 showed [Ah 9d] and lost with a pair of Nines
Seat 4: kimmarusa showed [Ac Qs] and won ($4.46) with a pair of Queens
Seat 5: dancayamanda (button) folded before Flop (didn't bet)
Seat 6: Buetch (small blind) folded before Flop



PokerStars Hand #222976105828:  Hold'em No Limit ($0.05/$0.10 USD) - 2021/01/23 17:48:12 ET
Table 'Stephano III' 6-max Seat #6 is the button
Seat 2: perespell ($16.67 in chips) 
Seat 4: kimmarusa ($10.52 in chips) 
Seat 5: dancayamanda ($19.68 in chips) 
Seat 6: Buetch ($8.55 in chips) 
perespell: posts small blind $0.05
kimmarusa: posts big blind $0.10
*** HOLE CARDS ***
dancayamanda: folds 
Buetch: raises $0.10 to $0.20
perespell: folds 
kimmarusa: folds 
Uncalled bet ($0.10) returned to Buetch
Buetch collected $0.25 from pot
Buetch: doesn't show hand 
*** SUMMARY ***
Total pot $0.25 | Rake $0 
Seat 2: perespell (small blind) folded before Flop
Seat 4: kimmarusa (big blind) folded before Flop
Seat 5: dancayamanda folded before Flop (didn't bet)
Seat 6: Buetch (button) collected ($0.25)



PokerStars Hand #222976117927:  Hold'em No Limit ($0.05/$0.10 USD) - 2021/01/23 17:48:28 ET
Table 'Stephano III' 6-max Seat #2 is the button
Seat 2: perespell ($16.62 in chips) 
Seat 4: kimmarusa ($10.42 in chips) 
Seat 5: dancayamanda ($19.68 in chips) 
Seat 6: Buetch ($8.70 in chips) 
kimmarusa: posts small blind $0.05
dancayamanda: posts big blind $0.10
*** HOLE CARDS ***
Buetch: calls $0.10
perespell: folds 
kimmarusa: calls $0.05
dancayamanda: checks 
*** FLOP *** [Qh 8s Kh]
kimmarusa: bets $0.20
dancayamanda: folds 
Buetch: calls $0.20
*** TURN *** [Qh 8s Kh] [7h]
kimmarusa: checks 
Buetch: checks 
*** RIVER *** [Qh 8s Kh 7h] [Qd]
kimmarusa: bets $0.40
Buetch: raises $1.60 to $2
kimmarusa: calls $1.60
*** SHOW DOWN ***
Buetch: shows [Qc 9d] (three of a kind, Queens)
kimmarusa: shows [4h Ah] (a flush, Ace high)
kimmarusa collected $4.49 from pot
*** SUMMARY ***
Total pot $4.70 | Rake $0.21 
Board [Qh 8s Kh 7h Qd]
Seat 2: perespell (button) folded before Flop (didn't bet)
Seat 4: kimmarusa (small blind) showed [4h Ah] and won ($4.49) with a flush, Ace high
Seat 5: dancayamanda (big blind) folded on the Flop
Seat 6: Buetch showed [Qc 9d] and lost with three of a kind, Queens



PokerStars Hand #222976165611:  Hold'em No Limit ($0.05/$0.10 USD) - 2021/01/23 17:49:32 ET
Table 'Stephano III' 6-max Seat #4 is the button
Seat 2: perespell ($16.62 in chips) 
Seat 4: kimmarusa ($12.61 in chips) 
Seat 5: dancayamanda ($19.58 in chips) 
Seat 6: Buetch ($6.40 in chips) 
dancayamanda: posts small blind $0.05
Buetch: posts big blind $0.10
*** HOLE CARDS ***
perespell: folds 
kimmarusa: folds 
dancayamanda: folds 
Uncalled bet ($0.05) returned to Buetch
Buetch collected $0.10 from pot
Buetch: doesn't show hand 
*** SUMMARY ***
Total pot $0.10 | Rake $0 
Seat 2: perespell folded before Flop (didn't bet)
Seat 4: kimmarusa (button) folded before Flop (didn't bet)
Seat 5: dancayamanda (small blind) folded before Flop
Seat 6: Buetch (big blind) collected ($0.10)



PokerStars Hand #222976173156:  Hold'em No Limit ($0.05/$0.10 USD) - 2021/01/23 17:49:43 ET
Table 'Stephano III' 6-max Seat #5 is the button
Seat 2: perespell ($16.62 in chips) 
Seat 4: kimmarusa ($12.61 in chips) 
Seat 5: dancayamanda ($19.53 in chips) 
Seat 6: Buetch ($6.45 in chips) 
Buetch: posts small blind $0.05
perespell: posts big blind $0.10
*** HOLE CARDS ***
kimmarusa: raises $0.20 to $0.30
dancayamanda: folds 
Buetch: calls $0.25
perespell: calls $0.20
*** FLOP *** [4h 7s Qh]
Buetch: checks 
perespell: checks 
kimmarusa: bets $0.50
Buetch: folds 
perespell: folds 
Uncalled bet ($0.50) returned to kimmarusa
kimmarusa collected $0.86 from pot
kimmarusa: doesn't show hand 
*** SUMMARY ***
Total pot $0.90 | Rake $0.04 
Board [4h 7s Qh]
Seat 2: perespell (big blind) folded on the Flop
Seat 4: kimmarusa collected ($0.86)
Seat 5: dancayamanda (button) folded before Flop (didn't bet)
Seat 6: Buetch (small blind) folded on the Flop



PokerStars Hand #222976194842:  Hold'em No Limit ($0.05/$0.10 USD) - 2021/01/23 17:50:12 ET
Table 'Stephano III' 6-max Seat #6 is the button
Seat 2: perespell ($16.32 in chips) 
Seat 4: kimmarusa ($13.17 in chips) 
Seat 5: dancayamanda ($19.53 in chips) 
Seat 6: Buetch ($6.15 in chips) 
perespell: posts small blind $0.05
kimmarusa: posts big blind $0.10
*** HOLE CARDS ***
dancayamanda: folds 
Buetch: calls $0.10
perespell: folds 
kimmarusa: raises $0.30 to $0.40
Buetch: folds 
Uncalled bet ($0.30) returned to kimmarusa
kimmarusa collected $0.25 from pot
*** SUMMARY ***
Total pot $0.25 | Rake $0 
Seat 2: perespell (small blind) folded before Flop
Seat 4: kimmarusa (big blind) collected ($0.25)
Seat 5: dancayamanda folded before Flop (didn't bet)
Seat 6: Buetch (button) folded before Flop



PokerStars Hand #222976213605:  Hold'em No Limit ($0.05/$0.10 USD) - 2021/01/23 17:50:38 ET
Table 'Stephano III' 6-max Seat #2 is the button
Seat 2: perespell ($16.27 in chips) 
Seat 4: kimmarusa ($13.32 in chips) 
Seat 5: dancayamanda ($19.53 in chips) 
Seat 6: Buetch ($6.05 in chips) 
kimmarusa: posts small blind $0.05
dancayamanda: posts big blind $0.10
*** HOLE CARDS ***
Buetch: folds 
perespell: raises $0.15 to $0.25
kimmarusa: folds 
dancayamanda: folds 
Uncalled bet ($0.15) returned to perespell
perespell collected $0.25 from pot
perespell: doesn't show hand 
*** SUMMARY ***
Total pot $0.25 | Rake $0 
Seat 2: perespell (button) collected ($0.25)
Seat 4: kimmarusa (small blind) folded before Flop
Seat 5: dancayamanda (big blind) folded before Flop
Seat 6: Buetch folded before Flop (didn't bet)



PokerStars Hand #222976226453:  Hold'em No Limit ($0.05/$0.10 USD) - 2021/01/23 17:50:55 ET
Table 'Stephano III' 6-max Seat #4 is the button
Seat 2: perespell ($16.42 in chips) 
Seat 4: kimmarusa ($13.27 in chips) 
Seat 5: dancayamanda ($19.43 in chips) 
Seat 6: Buetch ($6.05 in chips) 
dancayamanda: posts small blind $0.05
Buetch: posts big blind $0.10
*** HOLE CARDS ***
perespell: folds 
kimmarusa: raises $0.20 to $0.30
dancayamanda: raises $0.80 to $1.10
Buetch: folds 
kimmarusa: raises $1.70 to $2.80
dancayamanda: raises $16.63 to $19.43 and is all-in
kimmarusa: calls $10.47 and is all-in
Uncalled bet ($6.16) returned to dancayamanda
*** FLOP *** [2c Jc Qh]
*** TURN *** [2c Jc Qh] [6h]
*** RIVER *** [2c Jc Qh 6h] [4h]
*** SHOW DOWN ***
dancayamanda: shows [Ks As] (high card Ace)
kimmarusa: shows [Ah Kc] (high card Ace)
dancayamanda collected $12.82 from pot
kimmarusa collected $12.82 from pot
*** SUMMARY ***
Total pot $26.64 | Rake $1 
Board [2c Jc Qh 6h 4h]
Seat 2: perespell folded before Flop (didn't bet)
Seat 4: kimmarusa (button) showed [Ah Kc] and won ($12.82) with high card Ace
Seat 5: dancayamanda (small blind) showed [Ks As] and won ($12.82) with high card Ace
Seat 6: Buetch (big blind) folded before Flop



PokerStars Hand #222976274578:  Hold'em No Limit ($0.05/$0.10 USD) - 2021/01/23 17:52:01 ET
Table 'Stephano III' 6-max Seat #5 is the button
Seat 2: perespell ($16.42 in chips) 
Seat 4: kimmarusa ($12.82 in chips) 
Seat 5: dancayamanda ($18.98 in chips) 
Seat 6: Buetch ($5.95 in chips) 
Buetch: posts small blind $0.05
perespell: posts big blind $0.10
*** HOLE CARDS ***
kimmarusa: folds 
OSTAINES98 was removed from the table for failing to post
OSTAINES98 leaves the table
dancayamanda: folds 
Buetch: calls $0.05
kubancheg joins the table at seat #1 
perespell: checks 
*** FLOP *** [Kd 8d 4h]
Buetch: checks 
perespell: checks 
*** TURN *** [Kd 8d 4h] [Qs]
Buetch: checks 
perespell: bets $0.10
Buetch: folds 
Uncalled bet ($0.10) returned to perespell
perespell collected $0.19 from pot
perespell: doesn't show hand 
*** SUMMARY ***
Total pot $0.20 | Rake $0.01 
Board [Kd 8d 4h Qs]
Seat 2: perespell (big blind) collected ($0.19)
Seat 4: kimmarusa folded before Flop (didn't bet)
Seat 5: dancayamanda (button) folded before Flop (didn't bet)
Seat 6: Buetch (small blind) folded on the Turn



PokerStars Hand #222976300174:  Hold'em No Limit ($0.05/$0.10 USD) - 2021/01/23 17:52:36 ET
Table 'Stephano III' 6-max Seat #6 is the button
Seat 2: perespell ($16.51 in chips) 
Seat 4: kimmarusa ($12.82 in chips) 
Seat 5: dancayamanda ($18.98 in chips) 
Seat 6: Buetch ($5.85 in chips) 
perespell: posts small blind $0.05
kimmarusa: posts big blind $0.10
*** HOLE CARDS ***
dancayamanda: raises $0.15 to $0.25
Buetch: folds 
perespell: folds 
kimmarusa: folds 
Uncalled bet ($0.15) returned to dancayamanda
dancayamanda collected $0.25 from pot
dancayamanda: doesn't show hand 
*** SUMMARY ***
Total pot $0.25 | Rake $0 
Seat 2: perespell (small blind) folded before Flop
Seat 4: kimmarusa (big blind) folded before Flop
Seat 5: dancayamanda collected ($0.25)
Seat 6: Buetch (button) folded before Flop (didn't bet)



PokerStars Hand #222976311724:  Hold'em No Limit ($0.05/$0.10 USD) - 2021/01/23 17:52:52 ET
Table 'Stephano III' 6-max Seat #2 is the button
Seat 2: perespell ($16.46 in chips) 
Seat 4: kimmarusa ($12.72 in chips) 
Seat 5: dancayamanda ($19.13 in chips) 
Seat 6: Buetch ($5.85 in chips) 
kimmarusa: posts small blind $0.05
dancayamanda: posts big blind $0.10
kubancheg: sits out 
*** HOLE CARDS ***
Buetch: folds 
perespell: folds 
kimmarusa: raises $0.20 to $0.30
dancayamanda: folds 
Uncalled bet ($0.20) returned to kimmarusa
kimmarusa collected $0.20 from pot
*** SUMMARY ***
Total pot $0.20 | Rake $0 
Seat 2: perespell (button) folded before Flop (didn't bet)
Seat 4: kimmarusa (small blind) collected ($0.20)
Seat 5: dancayamanda (big blind) folded before Flop
Seat 6: Buetch folded before Flop (didn't bet)



PokerStars Hand #222976326851:  Hold'em No Limit ($0.05/$0.10 USD) - 2021/01/23 17:53:13 ET
Table 'Stephano III' 6-max Seat #4 is the button
Seat 2: perespell ($16.46 in chips) 
Seat 4: kimmarusa ($12.82 in chips) 
Seat 5: dancayamanda ($19.03 in chips) 
Seat 6: Buetch ($5.85 in chips) 
dancayamanda: posts small blind $0.05
Buetch: posts big blind $0.10
kubancheg: sits out 
*** HOLE CARDS ***
perespell: folds 
kimmarusa: raises $0.20 to $0.30
dancayamanda: folds 
Buetch: calls $0.20
*** FLOP *** [7h Qh Ks]
Buetch: bets $0.62
kimmarusa: calls $0.62
*** TURN *** [7h Qh Ks] [4s]
Buetch: bets $1.80
kimmarusa: raises $2.80 to $4.60
Buetch: folds 
Uncalled bet ($2.80) returned to kimmarusa
kimmarusa collected $5.24 from pot
kimmarusa: doesn't show hand 
*** SUMMARY ***
Total pot $5.49 | Rake $0.25 
Board [7h Qh Ks 4s]
Seat 2: perespell folded before Flop (didn't bet)
Seat 4: kimmarusa (button) collected ($5.24)
Seat 5: dancayamanda (small blind) folded before Flop
Seat 6: Buetch (big blind) folded on the Turn



PokerStars Hand #222976371267:  Hold'em No Limit ($0.05/$0.10 USD) - 2021/01/23 17:54:15 ET
Table 'Stephano III' 6-max Seat #5 is the button
Seat 1: kubancheg ($8.26 in chips) 
Seat 2: perespell ($16.46 in chips) 
Seat 4: kimmarusa ($15.34 in chips) 
Seat 5: dancayamanda ($18.98 in chips) 
Seat 6: Buetch ($3.13 in chips) 
Buetch: posts small blind $0.05
kubancheg: posts big blind $0.10
*** HOLE CARDS ***
perespell: folds 
kimmarusa: folds 
dancayamanda: raises $0.15 to $0.25
Buetch: calls $0.20
kubancheg: raises $0.85 to $1.10
dancayamanda: folds 
Buetch: calls $0.85
*** FLOP *** [Jh Tc Ks]
Buetch: checks 
kubancheg: bets $0.50
Buetch: calls $0.50
*** TURN *** [Jh Tc Ks] [2s]
Buetch: checks 
kubancheg: bets $0.90
Buetch: folds 
Uncalled bet ($0.90) returned to kubancheg
kubancheg collected $3.29 from pot
kubancheg: doesn't show hand 
*** SUMMARY ***
Total pot $3.45 | Rake $0.16 
Board [Jh Tc Ks 2s]
Seat 1: kubancheg (big blind) collected ($3.29)
Seat 2: perespell folded before Flop (didn't bet)
Seat 4: kimmarusa folded before Flop (didn't bet)
Seat 5: dancayamanda (button) folded before Flop
Seat 6: Buetch (small blind) folded on the Turn



PokerStars Hand #222976414968:  Hold'em No Limit ($0.05/$0.10 USD) - 2021/01/23 17:55:17 ET
Table 'Stephano III' 6-max Seat #6 is the button
Seat 1: kubancheg ($9.95 in chips) 
Seat 2: perespell ($16.46 in chips) 
Seat 3: jammer35983 ($10 in chips) 
Seat 4: kimmarusa ($15.34 in chips) 
Seat 5: dancayamanda ($18.73 in chips) 
Seat 6: Buetch ($1.53 in chips) 
kubancheg: posts small blind $0.05
perespell: posts big blind $0.10
jammer35983: posts small & big blinds $0.15
*** HOLE CARDS ***
jammer35983: checks 
kimmarusa: folds 
dancayamanda: folds 
Buetch: folds 
Buetch leaves the table
kubancheg: calls $0.05
perespell: checks 
*** FLOP *** [6s Kc 3c]
kubancheg: checks 
perespell: checks 
No1Sparkles joins the table at seat #6 
jammer35983: checks 
*** TURN *** [6s Kc 3c] [3s]
kubancheg: checks 
perespell: checks 
jammer35983: checks 
*** RIVER *** [6s Kc 3c 3s] [4s]
kubancheg: bets $0.33
perespell: folds 
jammer35983: calls $0.33
*** SHOW DOWN ***
kubancheg: shows [2s 4d] (two pair, Fours and Threes)
jammer35983: shows [Qs 4h] (two pair, Fours and Threes)
kubancheg collected $0.48 from pot
jammer35983 collected $0.48 from pot
*** SUMMARY ***
Total pot $1.01 | Rake $0.05 
Board [6s Kc 3c 3s 4s]
Seat 1: kubancheg (small blind) showed [2s 4d] and won ($0.48) with two pair, Fours and Threes
Seat 2: perespell (big blind) folded on the River
Seat 3: jammer35983 showed [Qs 4h] and won ($0.48) with two pair, Fours and Threes
Seat 4: kimmarusa folded before Flop (didn't bet)
Seat 5: dancayamanda folded before Flop (didn't bet)
Seat 6: Buetch (button) folded before Flop (didn't bet)



PokerStars Hand #222976443160:  Hold'em No Limit ($0.05/$0.10 USD) - 2021/01/23 17:56:11 ET
Table 'Stephano III' 6-max Seat #1 is the button
Seat 1: kubancheg ($10 in chips) 
Seat 2: perespell ($16.36 in chips) 
Seat 3: jammer35983 ($10 in chips) 
Seat 4: kimmarusa ($15.34 in chips) 
perespell: posts small blind $0.05
jammer35983: posts big blind $0.10
No1Sparkles: sits out 
*** HOLE CARDS ***
kimmarusa: folds 
kubancheg: folds 
perespell: folds 
Uncalled bet ($0.05) returned to jammer35983
jammer35983 collected $0.10 from pot
jammer35983: doesn't show hand 
*** SUMMARY ***
Total pot $0.10 | Rake $0 
Seat 1: kubancheg (button) folded before Flop (didn't bet)
Seat 2: perespell (small blind) folded before Flop
Seat 3: jammer35983 (big blind) collected ($0.10)
Seat 4: kimmarusa folded before Flop (didn't bet)



PokerStars Hand #222976447875:  Hold'em No Limit ($0.05/$0.10 USD) - 2021/01/23 17:56:20 ET
Table 'Stephano III' 6-max Seat #2 is the button
Seat 1: kubancheg ($10 in chips) 
Seat 2: perespell ($16.31 in chips) 
Seat 3: jammer35983 ($10.05 in chips) 
Seat 4: kimmarusa ($15.34 in chips) 
jammer35983: posts small blind $0.05
kimmarusa: posts big blind $0.10
No1Sparkles: sits out 
*** HOLE CARDS ***
kubancheg: folds 
perespell has timed out
perespell: folds 
jammer35983: raises $0.10 to $0.20
kimmarusa: folds 
Uncalled bet ($0.10) returned to jammer35983
jammer35983 collected $0.20 from pot
jammer35983: doesn't show hand 
*** SUMMARY ***
Total pot $0.20 | Rake $0 
Seat 1: kubancheg folded before Flop (didn't bet)
Seat 2: perespell (button) folded before Flop (didn't bet)
Seat 3: jammer35983 (small blind) collected ($0.20)
Seat 4: kimmarusa (big blind) folded before Flop



PokerStars Hand #222976459332:  Hold'em No Limit ($0.05/$0.10 USD) - 2021/01/23 17:56:41 ET
Table 'Stephano III' 6-max Seat #3 is the button
Seat 1: kubancheg ($10 in chips) 
Seat 2: perespell ($16.31 in chips) 
Seat 3: jammer35983 ($10.15 in chips) 
Seat 4: kimmarusa ($15.24 in chips) 
Seat 6: No1Sparkles ($10 in chips) 
kimmarusa: posts small blind $0.05
No1Sparkles: posts big blind $0.10
*** HOLE CARDS ***
kubancheg: folds 
kubancheg leaves the table
perespell: raises $0.15 to $0.25
jammer35983: folds 
kimmarusa: folds 
No1Sparkles: folds 
Uncalled bet ($0.15) returned to perespell
perespell collected $0.25 from pot
perespell: doesn't show hand 
*** SUMMARY ***
Total pot $0.25 | Rake $0 
Seat 1: kubancheg folded before Flop (didn't bet)
Seat 2: perespell collected ($0.25)
Seat 3: jammer35983 (button) folded before Flop (didn't bet)
Seat 4: kimmarusa (small blind) folded before Flop
Seat 6: No1Sparkles (big blind) folded before Flop



PokerStars Hand #222976467713:  Hold'em No Limit ($0.05/$0.10 USD) - 2021/01/23 17:56:57 ET
Table 'Stephano III' 6-max Seat #4 is the button
Seat 2: perespell ($16.46 in chips) 
Seat 3: jammer35983 ($10.15 in chips) 
Seat 4: kimmarusa ($15.19 in chips) 
Seat 6: No1Sparkles ($10 in chips) 
No1Sparkles: posts small blind $0.05
perespell: posts big blind $0.10
*** HOLE CARDS ***
jammer35983: calls $0.10
tortpoker joins the table at seat #1 
kimmarusa: raises $0.30 to $0.40
No1Sparkles: folds 
perespell: folds 
jammer35983: folds 
Uncalled bet ($0.30) returned to kimmarusa
kimmarusa collected $0.35 from pot
kimmarusa: doesn't show hand 
*** SUMMARY ***
Total pot $0.35 | Rake $0 
Seat 2: perespell (big blind) folded before Flop
Seat 3: jammer35983 folded before Flop
Seat 4: kimmarusa (button) collected ($0.35)
Seat 6: No1Sparkles (small blind) folded before Flop



PokerStars Hand #222976478688:  Hold'em No Limit ($0.05/$0.10 USD) - 2021/01/23 17:57:18 ET
Table 'Stephano III' 6-max Seat #6 is the button
Seat 2: perespell ($16.36 in chips) 
Seat 3: jammer35983 ($10.05 in chips) 
Seat 4: kimmarusa ($15.44 in chips) 
Seat 6: No1Sparkles ($10 in chips) 
perespell: posts small blind $0.05
jammer35983: posts big blind $0.10
*** HOLE CARDS ***
kimmarusa: folds 
kimmarusa leaves the table
No1Sparkles: raises $0.20 to $0.30
perespell: calls $0.25
jammer35983: folds 
*** FLOP *** [7h 7d Jd]
perespell: checks 
TP1780 joins the table at seat #4 
No1Sparkles: bets $0.22
perespell: calls $0.22
*** TURN *** [7h 7d Jd] [9h]
perespell: checks 
TP1780 leaves the table
No1Sparkles: checks 
*** RIVER *** [7h 7d Jd 9h] [9c]
perespell: checks 
No1Sparkles: checks 
*** SHOW DOWN ***
perespell: shows [Ah 8h] (two pair, Nines and Sevens)
No1Sparkles: shows [Ks Ad] (two pair, Nines and Sevens)
nicoguti007 joins the table at seat #4 
perespell collected $0.55 from pot
No1Sparkles collected $0.54 from pot
*** SUMMARY ***
Total pot $1.14 | Rake $0.05 
Board [7h 7d Jd 9h 9c]
Seat 2: perespell (small blind) showed [Ah 8h] and won ($0.55) with two pair, Nines and Sevens
Seat 3: jammer35983 (big blind) folded before Flop
Seat 4: kimmarusa folded before Flop (didn't bet)
Seat 6: No1Sparkles (button) showed [Ks Ad] and won ($0.54) with two pair, Nines and Sevens



PokerStars Hand #222976499387:  Hold'em No Limit ($0.05/$0.10 USD) - 2021/01/23 17:57:57 ET
Table 'Stephano III' 6-max Seat #2 is the button
Seat 2: perespell ($16.39 in chips) 
Seat 3: jammer35983 ($9.95 in chips) 
Seat 4: nicoguti007 ($10 in chips) 
Seat 6: No1Sparkles ($10.02 in chips) 
jammer35983: posts small blind $0.05
nicoguti007: posts big blind $0.10
tortpoker: sits out 
*** HOLE CARDS ***
No1Sparkles: folds 
perespell: folds 
jammer35983: calls $0.05
nicoguti007: checks 
*** FLOP *** [Jc 5h Ks]
jammer35983: checks 
nicoguti007: checks 
*** TURN *** [Jc 5h Ks] [7c]
jammer35983: checks 
nicoguti007: checks 
*** RIVER *** [Jc 5h Ks 7c] [4s]
jammer35983: checks 
nicoguti007: checks 
*** SHOW DOWN ***
jammer35983: shows [9s Qh] (high card King)
nicoguti007: shows [Th 4c] (a pair of Fours)
nicoguti007 collected $0.19 from pot
*** SUMMARY ***
Total pot $0.20 | Rake $0.01 
Board [Jc 5h Ks 7c 4s]
Seat 2: perespell (button) folded before Flop (didn't bet)
Seat 3: jammer35983 (small blind) showed [9s Qh] and lost with high card King
Seat 4: nicoguti007 (big blind) showed [Th 4c] and won ($0.19) with a pair of Fours
Seat 6: No1Sparkles folded before Flop (didn't bet)



PokerStars Hand #222976517058:  Hold'em No Limit ($0.05/$0.10 USD) - 2021/01/23 17:58:30 ET
Table 'Stephano III' 6-max Seat #3 is the button
Seat 1: tortpoker ($10 in chips) 
Seat 2: perespell ($16.39 in chips) 
Seat 3: jammer35983 ($9.85 in chips) 
Seat 6: No1Sparkles ($10.02 in chips) 
No1Sparkles: posts small blind $0.05
tortpoker: posts big blind $0.10
*** HOLE CARDS ***
perespell: folds 
jammer35983: calls $0.10
No1Sparkles: folds 
tortpoker: checks 
*** FLOP *** [7s Qh Ks]
tortpoker: checks 
jammer35983: checks 
*** TURN *** [7s Qh Ks] [8s]
tortpoker: checks 
jammer35983: checks 
*** RIVER *** [7s Qh Ks 8s] [8c]
tortpoker: checks 
jammer35983: checks 
*** SHOW DOWN ***
tortpoker: shows [Js 2c] (a pair of Eights)
jammer35983: shows [Jc 4s] (a pair of Eights)
tortpoker collected $0.12 from pot
jammer35983 collected $0.12 from pot
*** SUMMARY ***
Total pot $0.25 | Rake $0.01 
Board [7s Qh Ks 8s 8c]
Seat 1: tortpoker (big blind) showed [Js 2c] and won ($0.12) with a pair of Eights
Seat 2: perespell folded before Flop (didn't bet)
Seat 3: jammer35983 (button) showed [Jc 4s] and won ($0.12) with a pair of Eights
Seat 6: No1Sparkles (small blind) folded before Flop



PokerStars Hand #222976528764:  Hold'em No Limit ($0.05/$0.10 USD) - 2021/01/23 17:58:52 ET
Table 'Stephano III' 6-max Seat #6 is the button
Seat 1: tortpoker ($10.02 in chips) 
Seat 2: perespell ($16.39 in chips) 
Seat 3: jammer35983 ($9.87 in chips) 
Seat 6: No1Sparkles ($10 in chips) 
tortpoker: posts small blind $0.05
perespell: posts big blind $0.10
*** HOLE CARDS ***
jammer35983 has timed out
jammer35983: folds 
No1Sparkles: folds 
tortpoker: folds 
Uncalled bet ($0.05) returned to perespell
perespell collected $0.10 from pot
perespell: doesn't show hand 
*** SUMMARY ***
Total pot $0.10 | Rake $0 
Seat 1: tortpoker (small blind) folded before Flop
Seat 2: perespell (big blind) collected ($0.10)
Seat 3: jammer35983 folded before Flop (didn't bet)
Seat 6: No1Sparkles (button) folded before Flop (didn't bet)



PokerStars Hand #222976537715:  Hold'em No Limit ($0.05/$0.10 USD) - 2021/01/23 17:59:08 ET
Table 'Stephano III' 6-max Seat #1 is the button
Seat 1: tortpoker ($10 in chips) 
Seat 2: perespell ($16.44 in chips) 
Seat 3: jammer35983 ($9.87 in chips) 
Seat 6: No1Sparkles ($10 in chips) 
perespell: posts small blind $0.05
jammer35983: posts big blind $0.10
*** HOLE CARDS ***
No1Sparkles: folds 
tortpoker: raises $0.20 to $0.30
perespell: folds 
jammer35983: calls $0.20
*** FLOP *** [Jc 5h 9d]
jammer35983: checks 
tortpoker: checks 
*** TURN *** [Jc 5h 9d] [Th]
jammer35983: bets $0.31
tortpoker: calls $0.31
*** RIVER *** [Jc 5h 9d Th] [Ks]
jammer35983: checks 
tortpoker: checks 
*** SHOW DOWN ***
jammer35983: shows [Jh 2s] (a pair of Jacks)
tortpoker: mucks hand 
jammer35983 collected $1.21 from pot
*** SUMMARY ***
Total pot $1.27 | Rake $0.06 
Board [Jc 5h 9d Th Ks]
Seat 1: tortpoker (button) mucked
Seat 2: perespell (small blind) folded before Flop
Seat 3: jammer35983 (big blind) showed [Jh 2s] and won ($1.21) with a pair of Jacks
Seat 6: No1Sparkles folded before Flop (didn't bet)



PokerStars Hand #222976559387:  Hold'em No Limit ($0.05/$0.10 USD) - 2021/01/23 17:59:41 ET
Table 'Stephano III' 6-max Seat #2 is the button
Seat 1: tortpoker ($10 in chips) 
Seat 2: perespell ($16.39 in chips) 
Seat 3: jammer35983 ($10.47 in chips) 
Seat 4: nicoguti007 ($10.09 in chips) 
Seat 6: No1Sparkles ($10 in chips) 
jammer35983: posts small blind $0.05
nicoguti007: posts big blind $0.10
*** HOLE CARDS ***
No1Sparkles: folds 
tortpoker: folds 
perespell: folds 
jammer35983: raises $0.10 to $0.20
nicoguti007: calls $0.10
*** FLOP *** [Jh 7h 7c]
jammer35983: checks 
nicoguti007: bets $0.18
jammer35983: calls $0.18
*** TURN *** [Jh 7h 7c] [8d]
jammer35983: checks 
nicoguti007: bets $0.50
jammer35983: raises $0.50 to $1
nicoguti007: calls $0.50
*** RIVER *** [Jh 7h 7c 8d] [Js]
jammer35983: bets $1.32
nicoguti007: calls $1.32
*** SHOW DOWN ***
jammer35983: shows [Jc Jd] (four of a kind, Jacks)
nicoguti007: mucks hand 
jammer35983 collected $5.16 from pot
*** SUMMARY ***
Total pot $5.40 | Rake $0.24 
Board [Jh 7h 7c 8d Js]
Seat 1: tortpoker folded before Flop (didn't bet)
Seat 2: perespell (button) folded before Flop (didn't bet)
Seat 3: jammer35983 (small blind) showed [Jc Jd] and won ($5.16) with four of a kind, Jacks
Seat 4: nicoguti007 (big blind) mucked
Seat 6: No1Sparkles folded before Flop (didn't bet)



PokerStars Hand #222976583453:  Hold'em No Limit ($0.05/$0.10 USD) - 2021/01/23 18:00:24 ET
Table 'Stephano III' 6-max Seat #3 is the button
Seat 1: tortpoker ($10 in chips) 
Seat 2: perespell ($16.39 in chips) 
Seat 3: jammer35983 ($12.93 in chips) 
Seat 6: No1Sparkles ($10 in chips) 
No1Sparkles: posts small blind $0.05
tortpoker: posts big blind $0.10
*** HOLE CARDS ***
perespell: raises $0.15 to $0.25
jammer35983: calls $0.25
No1Sparkles: calls $0.20
tortpoker: calls $0.15
*** FLOP *** [2s 8h Jh]
No1Sparkles: checks 
tortpoker: checks 
perespell: checks 
jammer35983: checks 
*** TURN *** [2s 8h Jh] [Qd]
No1Sparkles: bets $0.63
tortpoker: folds 
perespell: calls $0.63
jammer35983: folds 
*** RIVER *** [2s 8h Jh Qd] [8s]
No1Sparkles: bets $1.08
perespell: calls $1.08
*** SHOW DOWN ***
No1Sparkles: shows [Kd Td] (a pair of Eights)
perespell: shows [Qc Kh] (two pair, Queens and Eights)
perespell collected $4.22 from pot
*** SUMMARY ***
Total pot $4.42 | Rake $0.20 
Board [2s 8h Jh Qd 8s]
Seat 1: tortpoker (big blind) folded on the Turn
Seat 2: perespell showed [Qc Kh] and won ($4.22) with two pair, Queens and Eights
Seat 3: jammer35983 (button) folded on the Turn
Seat 6: No1Sparkles (small blind) showed [Kd Td] and lost with a pair of Eights



PokerStars Hand #222976615007:  Hold'em No Limit ($0.05/$0.10 USD) - 2021/01/23 18:01:16 ET
Table 'Stephano III' 6-max Seat #6 is the button
Seat 1: tortpoker ($10 in chips) 
Seat 2: perespell ($18.65 in chips) 
Seat 3: jammer35983 ($12.68 in chips) 
Seat 6: No1Sparkles ($10 in chips) 
tortpoker: posts small blind $0.05
perespell: posts big blind $0.10
dancayamanda: sits out 
*** HOLE CARDS ***
jammer35983: calls $0.10
No1Sparkles: folds 
tortpoker: folds 
perespell: checks 
*** FLOP *** [Jc 5d Kh]
perespell: checks 
jammer35983: checks 
*** TURN *** [Jc 5d Kh] [Js]
perespell: checks 
jammer35983: checks 
*** RIVER *** [Jc 5d Kh Js] [5h]
perespell: checks 
Johnny Moth joins the table at seat #4 
jammer35983: bets $0.24
perespell: folds 
Uncalled bet ($0.24) returned to jammer35983
jammer35983 collected $0.24 from pot
jammer35983: doesn't show hand 
*** SUMMARY ***
Total pot $0.25 | Rake $0.01 
Board [Jc 5d Kh Js 5h]
Seat 1: tortpoker (small blind) folded before Flop
Seat 2: perespell (big blind) folded on the River
Seat 3: jammer35983 collected ($0.24)
Seat 6: No1Sparkles (button) folded before Flop (didn't bet)



PokerStars Hand #222976637365:  Hold'em No Limit ($0.05/$0.10 USD) - 2021/01/23 18:01:49 ET
Table 'Stephano III' 6-max Seat #1 is the button
Seat 1: tortpoker ($10 in chips) 
Seat 2: perespell ($18.55 in chips) 
Seat 3: jammer35983 ($12.82 in chips) 
Seat 6: No1Sparkles ($10 in chips) 
perespell: posts small blind $0.05
jammer35983: posts big blind $0.10
Johnny Moth: sits out 
dancayamanda: sits out 
*** HOLE CARDS ***
No1Sparkles: folds 
tortpoker: folds 
perespell: raises $0.15 to $0.25
jammer35983: calls $0.15
*** FLOP *** [7d Js 2c]
perespell: checks 
jammer35983: checks 
*** TURN *** [7d Js 2c] [Ts]
perespell: checks 
jammer35983: checks 
*** RIVER *** [7d Js 2c Ts] [5c]
perespell: checks 
jammer35983: checks 
*** SHOW DOWN ***
perespell: shows [6s Ah] (high card Ace)
jammer35983: mucks hand 
perespell collected $0.48 from pot
*** SUMMARY ***
Total pot $0.50 | Rake $0.02 
Board [7d Js 2c Ts 5c]
Seat 1: tortpoker (button) folded before Flop (didn't bet)
Seat 2: perespell (small blind) showed [6s Ah] and won ($0.48) with high card Ace
Seat 3: jammer35983 (big blind) mucked
Seat 6: No1Sparkles folded before Flop (didn't bet)



PokerStars Hand #222976658346:  Hold'em No Limit ($0.05/$0.10 USD) - 2021/01/23 18:02:21 ET
Table 'Stephano III' 6-max Seat #2 is the button
Seat 1: tortpoker ($10 in chips) 
Seat 2: perespell ($18.78 in chips) 
Seat 3: jammer35983 ($12.57 in chips) 
Seat 4: Johnny Moth ($10 in chips) 
Seat 6: No1Sparkles ($10 in chips) 
jammer35983: posts small blind $0.05
Johnny Moth: posts big blind $0.10
dancayamanda: sits out 
*** HOLE CARDS ***
No1Sparkles: folds 
tortpoker: folds 
perespell: folds 
jammer35983: calls $0.05
Johnny Moth: checks 
*** FLOP *** [6h 4c Jh]
jammer35983: checks 
Johnny Moth: bets $0.40
jammer35983: folds 
Uncalled bet ($0.40) returned to Johnny Moth
Johnny Moth collected $0.19 from pot
Johnny Moth: doesn't show hand 
*** SUMMARY ***
Total pot $0.20 | Rake $0.01 
Board [6h 4c Jh]
Seat 1: tortpoker folded before Flop (didn't bet)
Seat 2: perespell (button) folded before Flop (didn't bet)
Seat 3: jammer35983 (small blind) folded on the Flop
Seat 4: Johnny Moth (big blind) collected ($0.19)
Seat 6: No1Sparkles folded before Flop (didn't bet)



PokerStars Hand #222976673911:  Hold'em No Limit ($0.05/$0.10 USD) - 2021/01/23 18:02:44 ET
Table 'Stephano III' 6-max Seat #3 is the button
Seat 1: tortpoker ($10 in chips) 
Seat 2: perespell ($18.78 in chips) 
Seat 3: jammer35983 ($12.47 in chips) 
Seat 4: Johnny Moth ($10.09 in chips) 
Seat 5: dancayamanda ($18.73 in chips) 
Seat 6: No1Sparkles ($10 in chips) 
Johnny Moth: posts small blind $0.05
dancayamanda: posts big blind $0.10
*** HOLE CARDS ***
No1Sparkles: folds 
tortpoker: folds 
perespell: folds 
jammer35983: raises $0.20 to $0.30
Johnny Moth: calls $0.25
dancayamanda: calls $0.20
*** FLOP *** [Td 2c 5c]
Johnny Moth: bets $0.43
dancayamanda: folds 
jammer35983: folds 
Uncalled bet ($0.43) returned to Johnny Moth
Johnny Moth collected $0.86 from pot
Johnny Moth: doesn't show hand 
*** SUMMARY ***
Total pot $0.90 | Rake $0.04 
Board [Td 2c 5c]
Seat 1: tortpoker folded before Flop (didn't bet)
Seat 2: perespell folded before Flop (didn't bet)
Seat 3: jammer35983 (button) folded on the Flop
Seat 4: Johnny Moth (small blind) collected ($0.86)
Seat 5: dancayamanda (big blind) folded on the Flop
Seat 6: No1Sparkles folded before Flop (didn't bet)



PokerStars Hand #222976698502:  Hold'em No Limit ($0.05/$0.10 USD) - 2021/01/23 18:03:17 ET
Table 'Stephano III' 6-max Seat #4 is the button
Seat 1: tortpoker ($10 in chips) 
Seat 2: perespell ($18.78 in chips) 
Seat 3: jammer35983 ($12.17 in chips) 
Seat 4: Johnny Moth ($10.65 in chips) 
Seat 5: dancayamanda ($18.43 in chips) 
Seat 6: No1Sparkles ($10 in chips) 
dancayamanda: posts small blind $0.05
No1Sparkles: posts big blind $0.10
*** HOLE CARDS ***
tortpoker: folds 
perespell: folds 
jammer35983: folds 
Johnny Moth: calls $0.10
dancayamanda: folds 
No1Sparkles: checks 
*** FLOP *** [5d Ac 3c]
No1Sparkles: checks 
Johnny Moth: checks 
*** TURN *** [5d Ac 3c] [8c]
No1Sparkles: checks 
Johnny Moth: bets $0.10
No1Sparkles: folds 
Uncalled bet ($0.10) returned to Johnny Moth
Johnny Moth collected $0.24 from pot
Johnny Moth: doesn't show hand 
*** SUMMARY ***
Total pot $0.25 | Rake $0.01 
Board [5d Ac 3c 8c]
Seat 1: tortpoker folded before Flop (didn't bet)
Seat 2: perespell folded before Flop (didn't bet)
Seat 3: jammer35983 folded before Flop (didn't bet)
Seat 4: Johnny Moth (button) collected ($0.24)
Seat 5: dancayamanda (small blind) folded before Flop
Seat 6: No1Sparkles (big blind) folded on the Turn



PokerStars Hand #222976716089:  Hold'em No Limit ($0.05/$0.10 USD) - 2021/01/23 18:03:43 ET
Table 'Stephano III' 6-max Seat #5 is the button
Seat 1: tortpoker ($10 in chips) 
Seat 2: perespell ($18.78 in chips) 
Seat 3: jammer35983 ($12.17 in chips) 
Seat 4: Johnny Moth ($10.79 in chips) 
Seat 5: dancayamanda ($18.38 in chips) 
Seat 6: No1Sparkles ($10 in chips) 
No1Sparkles: posts small blind $0.05
tortpoker: posts big blind $0.10
*** HOLE CARDS ***
perespell: raises $0.15 to $0.25
jammer35983: calls $0.25
Johnny Moth: folds 
Johnny Moth leaves the table
dancayamanda: folds 
No1Sparkles: folds 
tortpoker: folds 
*** FLOP *** [3s Jc 5h]
fred00205 joins the table at seat #4 
perespell: checks 
jammer35983: checks 
*** TURN *** [3s Jc 5h] [2h]
perespell: bets $0.35
jammer35983: calls $0.35
*** RIVER *** [3s Jc 5h 2h] [4d]
perespell: bets $0.50
jammer35983: calls $0.50
*** SHOW DOWN ***
perespell: shows [Ad Ah] (a straight, Ace to Five)
jammer35983: mucks hand 
perespell collected $2.24 from pot
*** SUMMARY ***
Total pot $2.35 | Rake $0.11 
Board [3s Jc 5h 2h 4d]
Seat 1: tortpoker (big blind) folded before Flop
Seat 2: perespell showed [Ad Ah] and won ($2.24) with a straight, Ace to Five
Seat 3: jammer35983 mucked
Seat 4: Johnny Moth folded before Flop (didn't bet)
Seat 5: dancayamanda (button) folded before Flop (didn't bet)
Seat 6: No1Sparkles (small blind) folded before Flop



PokerStars Hand #222976745617:  Hold'em No Limit ($0.05/$0.10 USD) - 2021/01/23 18:04:24 ET
Table 'Stephano III' 6-max Seat #6 is the button
Seat 1: tortpoker ($10 in chips) 
Seat 2: perespell ($19.92 in chips) 
Seat 3: jammer35983 ($11.07 in chips) 
Seat 4: fred00205 ($8 in chips) 
Seat 5: dancayamanda ($18.38 in chips) 
Seat 6: No1Sparkles ($10 in chips) 
tortpoker: posts small blind $0.05
perespell: posts big blind $0.10
fred00205: posts big blind $0.10
*** HOLE CARDS ***
jammer35983: calls $0.10
fred00205: checks 
dancayamanda: folds 
No1Sparkles: folds 
tortpoker: folds 
perespell: checks 
*** FLOP *** [6d As 9d]
perespell: checks 
jammer35983: checks 
fred00205: checks 
*** TURN *** [6d As 9d] [Qc]
perespell: checks 
jammer35983: checks 
fred00205: checks 
*** RIVER *** [6d As 9d Qc] [Jh]
perespell: checks 
jammer35983: checks 
fred00205: checks 
*** SHOW DOWN ***
perespell: shows [Jd 5c] (a pair of Jacks)
jammer35983: mucks hand 
fred00205: shows [8h Qd] (a pair of Queens)
fred00205 collected $0.33 from pot
*** SUMMARY ***
Total pot $0.35 | Rake $0.02 
Board [6d As 9d Qc Jh]
Seat 1: tortpoker (small blind) folded before Flop
Seat 2: perespell (big blind) showed [Jd 5c] and lost with a pair of Jacks
Seat 3: jammer35983 mucked
Seat 4: fred00205 showed [8h Qd] and won ($0.33) with a pair of Queens
Seat 5: dancayamanda folded before Flop (didn't bet)
Seat 6: No1Sparkles (button) folded before Flop (didn't bet)



PokerStars Hand #222976785057:  Hold'em No Limit ($0.05/$0.10 USD) - 2021/01/23 18:05:20 ET
Table 'Stephano III' 6-max Seat #1 is the button
Seat 1: tortpoker ($10 in chips) 
Seat 2: perespell ($19.82 in chips) 
Seat 3: jammer35983 ($10.97 in chips) 
Seat 4: fred00205 ($8.23 in chips) 
Seat 5: dancayamanda ($18.38 in chips) 
Seat 6: No1Sparkles ($10 in chips) 
perespell: posts small blind $0.05
jammer35983: posts big blind $0.10
*** HOLE CARDS ***
fred00205: calls $0.10
dancayamanda: folds 
No1Sparkles: folds 
tortpoker: folds 
perespell: folds 
jammer35983: checks 
*** FLOP *** [Qh Qs 8d]
jammer35983: bets $0.24
fred00205: calls $0.24
*** TURN *** [Qh Qs 8d] [3c]
jammer35983: checks 
fred00205: checks 
*** RIVER *** [Qh Qs 8d 3c] [Ac]
jammer35983: checks 
fred00205: checks 
*** SHOW DOWN ***
jammer35983: shows [7d 8c] (two pair, Queens and Eights)
fred00205: mucks hand 
jammer35983 collected $0.70 from pot
*** SUMMARY ***
Total pot $0.73 | Rake $0.03 
Board [Qh Qs 8d 3c Ac]
Seat 1: tortpoker (button) folded before Flop (didn't bet)
Seat 2: perespell (small blind) folded before Flop
Seat 3: jammer35983 (big blind) showed [7d 8c] and won ($0.70) with two pair, Queens and Eights
Seat 4: fred00205 mucked
Seat 5: dancayamanda folded before Flop (didn't bet)
Seat 6: No1Sparkles folded before Flop (didn't bet)



PokerStars Hand #222976825120:  Hold'em No Limit ($0.05/$0.10 USD) - 2021/01/23 18:06:16 ET
Table 'Stephano III' 6-max Seat #2 is the button
Seat 1: tortpoker ($10 in chips) 
Seat 2: perespell ($19.77 in chips) 
Seat 3: jammer35983 ($11.33 in chips) 
Seat 4: fred00205 ($7.89 in chips) 
Seat 5: dancayamanda ($18.38 in chips) 
Seat 6: No1Sparkles ($10 in chips) 
jammer35983: posts small blind $0.05
fred00205: posts big blind $0.10
*** HOLE CARDS ***
dancayamanda: folds 
No1Sparkles has timed out
No1Sparkles: folds 
tortpoker: folds 
perespell: folds 
jammer35983: calls $0.05
fred00205: checks 
*** FLOP *** [Kd 5c Ac]
jammer35983: checks 
fred00205: checks 
*** TURN *** [Kd 5c Ac] [Ah]
jammer35983: checks 
fred00205: checks 
*** RIVER *** [Kd 5c Ac Ah] [3c]
jammer35983: checks 
fred00205: checks 
*** SHOW DOWN ***
jammer35983: shows [2h Qd] (a pair of Aces)
fred00205: mucks hand 
jammer35983 collected $0.19 from pot
*** SUMMARY ***
Total pot $0.20 | Rake $0.01 
Board [Kd 5c Ac Ah 3c]
Seat 1: tortpoker folded before Flop (didn't bet)
Seat 2: perespell (button) folded before Flop (didn't bet)
Seat 3: jammer35983 (small blind) showed [2h Qd] and won ($0.19) with a pair of Aces
Seat 4: fred00205 (big blind) mucked
Seat 5: dancayamanda folded before Flop (didn't bet)
Seat 6: No1Sparkles folded before Flop (didn't bet)



PokerStars Hand #222976856041:  Hold'em No Limit ($0.05/$0.10 USD) - 2021/01/23 18:07:00 ET
Table 'Stephano III' 6-max Seat #3 is the button
Seat 1: tortpoker ($10 in chips) 
Seat 2: perespell ($19.77 in chips) 
Seat 3: jammer35983 ($11.42 in chips) 
Seat 4: fred00205 ($7.79 in chips) 
Seat 5: dancayamanda ($18.38 in chips) 
fred00205: posts small blind $0.05
dancayamanda: posts big blind $0.10
*** HOLE CARDS ***
tortpoker: folds 
perespell: folds 
jammer35983: calls $0.10
fred00205: calls $0.05
dancayamanda: checks 
*** FLOP *** [Ac 4s 4h]
fred00205: checks 
dancayamanda: checks 
jammer35983: checks 
*** TURN *** [Ac 4s 4h] [Ts]
fred00205: checks 
dancayamanda: bets $0.50
jammer35983: folds 
fred00205: calls $0.50
*** RIVER *** [Ac 4s 4h Ts] [2h]
fred00205: checks 
dancayamanda: bets $1
fred00205: calls $1
*** SHOW DOWN ***
dancayamanda: shows [4d Jh] (three of a kind, Fours)
fred00205: mucks hand 
dancayamanda collected $3.15 from pot
*** SUMMARY ***
Total pot $3.30 | Rake $0.15 
Board [Ac 4s 4h Ts 2h]
Seat 1: tortpoker folded before Flop (didn't bet)
Seat 2: perespell folded before Flop (didn't bet)
Seat 3: jammer35983 (button) folded on the Turn
Seat 4: fred00205 (small blind) mucked
Seat 5: dancayamanda (big blind) showed [4d Jh] and won ($3.15) with three of a kind, Fours



PokerStars Hand #222976904044:  Hold'em No Limit ($0.05/$0.10 USD) - 2021/01/23 18:08:09 ET
Table 'Stephano III' 6-max Seat #4 is the button
Seat 1: tortpoker ($10 in chips) 
Seat 2: perespell ($19.77 in chips) 
Seat 3: jammer35983 ($11.32 in chips) 
Seat 4: fred00205 ($6.19 in chips) 
Seat 5: dancayamanda ($19.93 in chips) 
dancayamanda: posts small blind $0.05
tortpoker: posts big blind $0.10
*** HOLE CARDS ***
perespell: folds 
jammer35983: calls $0.10
fred00205: calls $0.10
dancayamanda: folds 
tortpoker: checks 
*** FLOP *** [Js Ks Kd]
tortpoker: checks 
jammer35983: checks 
fred00205: checks 
*** TURN *** [Js Ks Kd] [Ad]
tortpoker: checks 
jammer35983: bets $0.33
fred00205: raises $0.33 to $0.66
tortpoker: folds 
jammer35983: raises $0.33 to $0.99
fred00205: calls $0.33
*** RIVER *** [Js Ks Kd Ad] [Jh]
jammer35983: bets $2.23
fred00205: calls $2.23
*** SHOW DOWN ***
jammer35983: shows [Kc 9s] (a full house, Kings full of Jacks)
fred00205: mucks hand 
jammer35983 collected $6.48 from pot
*** SUMMARY ***
Total pot $6.79 | Rake $0.31 
Board [Js Ks Kd Ad Jh]
Seat 1: tortpoker (big blind) folded on the Turn
Seat 2: perespell folded before Flop (didn't bet)
Seat 3: jammer35983 showed [Kc 9s] and won ($6.48) with a full house, Kings full of Jacks
Seat 4: fred00205 (button) mucked
Seat 5: dancayamanda (small blind) folded before Flop



PokerStars Hand #222976961725:  Hold'em No Limit ($0.05/$0.10 USD) - 2021/01/23 18:09:31 ET
Table 'Stephano III' 6-max Seat #5 is the button
Seat 1: tortpoker ($10 in chips) 
Seat 2: perespell ($19.77 in chips) 
Seat 3: jammer35983 ($14.48 in chips) 
Seat 4: fred00205 ($2.87 in chips) 
Seat 5: dancayamanda ($19.88 in chips) 
tortpoker: posts small blind $0.05
perespell: posts big blind $0.10
*** HOLE CARDS ***
jammer35983: raises $0.10 to $0.20
fred00205: calls $0.20
dancayamanda: folds 
tortpoker: raises $1 to $1.20
perespell: folds 
jammer35983: calls $1
fred00205: folds 
*** FLOP *** [5s 7s 6c]
tortpoker: checks 
jammer35983: checks 
*** TURN *** [5s 7s 6c] [6h]
tortpoker: checks 
jammer35983: checks 
*** RIVER *** [5s 7s 6c 6h] [4s]
tortpoker: checks 
jammer35983: bets $3.80
tortpoker: folds 
Uncalled bet ($3.80) returned to jammer35983
jammer35983 collected $2.58 from pot
jammer35983: doesn't show hand 
*** SUMMARY ***
Total pot $2.70 | Rake $0.12 
Board [5s 7s 6c 6h 4s]
Seat 1: tortpoker (small blind) folded on the River
Seat 2: perespell (big blind) folded before Flop
Seat 3: jammer35983 collected ($2.58)
Seat 4: fred00205 folded before Flop
Seat 5: dancayamanda (button) folded before Flop (didn't bet)



PokerStars Hand #222977005214:  Hold'em No Limit ($0.05/$0.10 USD) - 2021/01/23 18:10:17 ET
Table 'Stephano III' 6-max Seat #1 is the button
Seat 1: tortpoker ($10 in chips) 
Seat 2: perespell ($19.67 in chips) 
Seat 3: jammer35983 ($15.86 in chips) 
Seat 4: fred00205 ($2.67 in chips) 
Seat 5: dancayamanda ($19.88 in chips) 
perespell: posts small blind $0.05
jammer35983: posts big blind $0.10
*** HOLE CARDS ***
fred00205: calls $0.10
dancayamanda: folds 
tortpoker: folds 
perespell: folds 
jammer35983: checks 
*** FLOP *** [Ah 2h 7s]
jammer35983: checks 
fred00205: checks 
*** TURN *** [Ah 2h 7s] [Ac]
jammer35983: checks 
fred00205: checks 
*** RIVER *** [Ah 2h 7s Ac] [9s]
jammer35983: bets $0.24
fred00205: calls $0.24
*** SHOW DOWN ***
jammer35983: shows [Qd 9c] (two pair, Aces and Nines)
fred00205: mucks hand 
jammer35983 collected $0.70 from pot
*** SUMMARY ***
Total pot $0.73 | Rake $0.03 
Board [Ah 2h 7s Ac 9s]
Seat 1: tortpoker (button) folded before Flop (didn't bet)
Seat 2: perespell (small blind) folded before Flop
Seat 3: jammer35983 (big blind) showed [Qd 9c] and won ($0.70) with two pair, Aces and Nines
Seat 4: fred00205 mucked
Seat 5: dancayamanda folded before Flop (didn't bet)



PokerStars Hand #222977023572:  Hold'em No Limit ($0.05/$0.10 USD) - 2021/01/23 18:10:44 ET
Table 'Stephano III' 6-max Seat #2 is the button
Seat 1: tortpoker ($10 in chips) 
Seat 2: perespell ($19.62 in chips) 
Seat 3: jammer35983 ($16.22 in chips) 
Seat 4: fred00205 ($2.33 in chips) 
Seat 5: dancayamanda ($19.88 in chips) 
jammer35983: posts small blind $0.05
fred00205: posts big blind $0.10
*** HOLE CARDS ***
dancayamanda: folds 
tortpoker: folds 
perespell: folds 
jammer35983: raises $0.20 to $0.30
fred00205: calls $0.20
*** FLOP *** [8d Th 4c]
jammer35983: checks 
fred00205: checks 
*** TURN *** [8d Th 4c] [2h]
jammer35983: checks 
fred00205: checks 
*** RIVER *** [8d Th 4c 2h] [Ks]
jammer35983: checks 
fred00205: checks 
*** SHOW DOWN ***
jammer35983: shows [Jh Qd] (high card King)
fred00205: mucks hand 
jammer35983 collected $0.57 from pot
*** SUMMARY ***
Total pot $0.60 | Rake $0.03 
Board [8d Th 4c 2h Ks]
Seat 1: tortpoker folded before Flop (didn't bet)
Seat 2: perespell (button) folded before Flop (didn't bet)
Seat 3: jammer35983 (small blind) showed [Jh Qd] and won ($0.57) with high card King
Seat 4: fred00205 (big blind) mucked
Seat 5: dancayamanda folded before Flop (didn't bet)



PokerStars Hand #222977046142:  Hold'em No Limit ($0.05/$0.10 USD) - 2021/01/23 18:11:17 ET
Table 'Stephano III' 6-max Seat #3 is the button
Seat 1: tortpoker ($10 in chips) 
Seat 2: perespell ($19.62 in chips) 
Seat 3: jammer35983 ($16.49 in chips) 
Seat 4: fred00205 ($2.03 in chips) 
Seat 5: dancayamanda ($19.88 in chips) 
fred00205: posts small blind $0.05
dancayamanda: posts big blind $0.10
*** HOLE CARDS ***
tortpoker: folds 
perespell: raises $0.15 to $0.25
jammer35983: calls $0.25
fred00205: folds 
dancayamanda: calls $0.15
*** FLOP *** [9h 8s Kd]
dancayamanda: checks 
perespell: checks 
jammer35983: checks 
*** TURN *** [9h 8s Kd] [9c]
dancayamanda: checks 
perespell: checks 
jammer35983: checks 
*** RIVER *** [9h 8s Kd 9c] [3d]
dancayamanda: checks 
No1Sparkles leaves the table
perespell: checks 
jammer35983: bets $0.38
dancayamanda: calls $0.38
perespell: calls $0.38
*** SHOW DOWN ***
jammer35983: shows [Js 3h] (two pair, Nines and Threes)
dancayamanda: shows [Ah 8h] (two pair, Nines and Eights)
perespell: shows [Ac 8c] (two pair, Nines and Eights)
dancayamanda collected $0.93 from pot
perespell collected $0.92 from pot
*** SUMMARY ***
Total pot $1.94 | Rake $0.09 
Board [9h 8s Kd 9c 3d]
Seat 1: tortpoker folded before Flop (didn't bet)
Seat 2: perespell showed [Ac 8c] and won ($0.92) with two pair, Nines and Eights
Seat 3: jammer35983 (button) showed [Js 3h] and lost with two pair, Nines and Threes
Seat 4: fred00205 (small blind) folded before Flop
Seat 5: dancayamanda (big blind) showed [Ah 8h] and won ($0.93) with two pair, Nines and Eights



PokerStars Hand #222977115103:  Hold'em No Limit ($0.05/$0.10 USD) - 2021/01/23 18:12:57 ET
Table 'Stephano III' 6-max Seat #4 is the button
Seat 1: tortpoker ($10 in chips) 
Seat 2: perespell ($19.91 in chips) 
Seat 3: jammer35983 ($15.86 in chips) 
Seat 4: fred00205 ($1.98 in chips) 
Seat 5: dancayamanda ($20.18 in chips) 
dancayamanda: posts small blind $0.05
tortpoker: posts big blind $0.10
*** HOLE CARDS ***
perespell: folds 
Hannibal2018 joins the table at seat #6 
jammer35983 has timed out
jammer35983: folds 
fred00205: calls $0.10
dancayamanda: folds 
tortpoker: checks 
*** FLOP *** [4c Jc 5h]
tortpoker: checks 
fred00205: checks 
*** TURN *** [4c Jc 5h] [8d]
tortpoker: bets $0.19
fred00205: calls $0.19
*** RIVER *** [4c Jc 5h 8d] [9d]
tortpoker: bets $0.31
fred00205: calls $0.31
*** SHOW DOWN ***
tortpoker: shows [8h 5d] (two pair, Eights and Fives)
fred00205: mucks hand 
tortpoker collected $1.19 from pot
*** SUMMARY ***
Total pot $1.25 | Rake $0.06 
Board [4c Jc 5h 8d 9d]
Seat 1: tortpoker (big blind) showed [8h 5d] and won ($1.19) with two pair, Eights and Fives
Seat 2: perespell folded before Flop (didn't bet)
Seat 3: jammer35983 folded before Flop (didn't bet)
Seat 4: fred00205 (button) mucked
Seat 5: dancayamanda (small blind) folded before Flop



PokerStars Hand #222977142045:  Hold'em No Limit ($0.05/$0.10 USD) - 2021/01/23 18:13:36 ET
Table 'Stephano III' 6-max Seat #5 is the button
Seat 1: tortpoker ($10.59 in chips) 
Seat 2: perespell ($19.91 in chips) 
Seat 3: jammer35983 ($15.86 in chips) 
Seat 4: fred00205 ($1.38 in chips) 
Seat 5: dancayamanda ($20.13 in chips) 
tortpoker: posts small blind $0.05
perespell: posts big blind $0.10
*** HOLE CARDS ***
jammer35983: raises $0.10 to $0.20
fred00205: raises $0.10 to $0.30
dancayamanda: folds 
tortpoker: folds 
perespell: folds 
jammer35983: calls $0.10
*** FLOP *** [2d Th 8h]
jammer35983: checks 
fred00205: bets $1.08 and is all-in
jammer35983: folds 
Uncalled bet ($1.08) returned to fred00205
fred00205 collected $0.72 from pot
fred00205: doesn't show hand 
*** SUMMARY ***
Total pot $0.75 | Rake $0.03 
Board [2d Th 8h]
Seat 1: tortpoker (small blind) folded before Flop
Seat 2: perespell (big blind) folded before Flop
Seat 3: jammer35983 folded on the Flop
Seat 4: fred00205 collected ($0.72)
Seat 5: dancayamanda (button) folded before Flop (didn't bet)



PokerStars Hand #222977164134:  Hold'em No Limit ($0.05/$0.10 USD) - 2021/01/23 18:14:08 ET
Table 'Stephano III' 6-max Seat #1 is the button
Seat 1: tortpoker ($10.54 in chips) 
Seat 2: perespell ($19.81 in chips) 
Seat 3: jammer35983 ($15.56 in chips) 
Seat 4: fred00205 ($1.80 in chips) 
Seat 5: dancayamanda ($20.13 in chips) 
Seat 6: Hannibal2018 ($10 in chips) 
perespell: posts small blind $0.05
jammer35983: posts big blind $0.10
Hannibal2018: posts big blind $0.10
*** HOLE CARDS ***
fred00205: folds 
dancayamanda: folds 
Hannibal2018: checks 
tortpoker: folds 
perespell: folds 
jammer35983: raises $0.10 to $0.20
Hannibal2018: calls $0.10
*** FLOP *** [Jc 8d Td]
jammer35983: checks 
Hannibal2018: bets $0.21
jammer35983: folds 
Uncalled bet ($0.21) returned to Hannibal2018
Hannibal2018 collected $0.43 from pot
*** SUMMARY ***
Total pot $0.45 | Rake $0.02 
Board [Jc 8d Td]
Seat 1: tortpoker (button) folded before Flop (didn't bet)
Seat 2: perespell (small blind) folded before Flop
Seat 3: jammer35983 (big blind) folded on the Flop
Seat 4: fred00205 folded before Flop (didn't bet)
Seat 5: dancayamanda folded before Flop (didn't bet)
Seat 6: Hannibal2018 collected ($0.43)



PokerStars Hand #222977182781:  Hold'em No Limit ($0.05/$0.10 USD) - 2021/01/23 18:14:35 ET
Table 'Stephano III' 6-max Seat #2 is the button
Seat 1: tortpoker ($10.54 in chips) 
Seat 2: perespell ($19.76 in chips) 
Seat 3: jammer35983 ($15.36 in chips) 
Seat 4: fred00205 ($1.80 in chips) 
Seat 5: dancayamanda ($20.13 in chips) 
Seat 6: Hannibal2018 ($10.23 in chips) 
jammer35983: posts small blind $0.05
fred00205: posts big blind $0.10
*** HOLE CARDS ***
dancayamanda: folds 
Hannibal2018: raises $0.20 to $0.30
tortpoker: folds 
perespell: folds 
jammer35983: calls $0.25
fred00205: calls $0.20
*** FLOP *** [Ks Td 2h]
jammer35983: checks 
fred00205: bets $1.50 and is all-in
Hannibal2018: calls $1.50
jammer35983: folds 
*** TURN *** [Ks Td 2h] [5d]
*** RIVER *** [Ks Td 2h 5d] [5s]
*** SHOW DOWN ***
fred00205: shows [6s Kh] (two pair, Kings and Fives)
Hannibal2018: shows [Jc Kd] (two pair, Kings and Fives - Jack kicker)
Hannibal2018 collected $3.72 from pot
*** SUMMARY ***
Total pot $3.90 | Rake $0.18 
Board [Ks Td 2h 5d 5s]
Seat 1: tortpoker folded before Flop (didn't bet)
Seat 2: perespell (button) folded before Flop (didn't bet)
Seat 3: jammer35983 (small blind) folded on the Flop
Seat 4: fred00205 (big blind) showed [6s Kh] and lost with two pair, Kings and Fives
Seat 5: dancayamanda folded before Flop (didn't bet)
Seat 6: Hannibal2018 showed [Jc Kd] and won ($3.72) with two pair, Kings and Fives



PokerStars Hand #222977224923:  Hold'em No Limit ($0.05/$0.10 USD) - 2021/01/23 18:15:37 ET
Table 'Stephano III' 6-max Seat #3 is the button
Seat 1: tortpoker ($10.54 in chips) 
Seat 2: perespell ($19.76 in chips) 
Seat 3: jammer35983 ($15.06 in chips) 
Seat 5: dancayamanda ($20.13 in chips) 
Seat 6: Hannibal2018 ($12.15 in chips) 
dancayamanda: posts small blind $0.05
Hannibal2018: posts big blind $0.10
*** HOLE CARDS ***
tortpoker: folds 
perespell: raises $0.15 to $0.25
jammer35983: calls $0.25
fred00205 leaves the table
dancayamanda: folds 
Hannibal2018: folds 
*** FLOP *** [Qd As 4d]
pondax joins the table at seat #4 
perespell: bets $0.19
jammer35983: calls $0.19
*** TURN *** [Qd As 4d] [Ad]
perespell: bets $0.30
jammer35983: calls $0.30
*** RIVER *** [Qd As 4d Ad] [8d]
perespell: bets $1.19
jammer35983: folds 
Uncalled bet ($1.19) returned to perespell
perespell collected $1.56 from pot
perespell: doesn't show hand 
*** SUMMARY ***
Total pot $1.63 | Rake $0.07 
Board [Qd As 4d Ad 8d]
Seat 1: tortpoker folded before Flop (didn't bet)
Seat 2: perespell collected ($1.56)
Seat 3: jammer35983 (button) folded on the River
Seat 5: dancayamanda (small blind) folded before Flop
Seat 6: Hannibal2018 (big blind) folded before Flop



PokerStars Hand #222977249135:  Hold'em No Limit ($0.05/$0.10 USD) - 2021/01/23 18:16:12 ET
Table 'Stephano III' 6-max Seat #5 is the button
Seat 1: tortpoker ($10.54 in chips) 
Seat 2: perespell ($20.58 in chips) 
Seat 3: jammer35983 ($14.32 in chips) 
Seat 5: dancayamanda ($20.08 in chips) 
Seat 6: Hannibal2018 ($12.05 in chips) 
Hannibal2018: posts small blind $0.05
tortpoker: posts big blind $0.10
pondax: sits out 
*** HOLE CARDS ***
perespell: folds 
jammer35983: folds 
dancayamanda: raises $0.15 to $0.25
Hannibal2018: folds 
tortpoker: raises $0.75 to $1
dancayamanda: raises $1.40 to $2.40
tortpoker: raises $8.14 to $10.54 and is all-in
dancayamanda: folds 
Uncalled bet ($8.14) returned to tortpoker
tortpoker collected $4.85 from pot
tortpoker: doesn't show hand 
*** SUMMARY ***
Total pot $4.85 | Rake $0 
Seat 1: tortpoker (big blind) collected ($4.85)
Seat 2: perespell folded before Flop (didn't bet)
Seat 3: jammer35983 folded before Flop (didn't bet)
Seat 5: dancayamanda (button) folded before Flop
Seat 6: Hannibal2018 (small blind) folded before Flop



PokerStars Hand #222977286700:  Hold'em No Limit ($0.05/$0.10 USD) - 2021/01/23 18:17:08 ET
Table 'Stephano III' 6-max Seat #6 is the button
Seat 1: tortpoker ($12.99 in chips) 
Seat 2: perespell ($20.58 in chips) 
Seat 3: jammer35983 ($14.32 in chips) 
Seat 5: dancayamanda ($17.68 in chips) 
Seat 6: Hannibal2018 ($12 in chips) 
tortpoker: posts small blind $0.05
perespell: posts big blind $0.10
pondax: sits out 
*** HOLE CARDS ***
jammer35983: calls $0.10
dancayamanda: folds 
Hannibal2018: folds 
tortpoker: folds 
perespell: raises $0.15 to $0.25
jammer35983: calls $0.15
*** FLOP *** [2d 7d 6h]
perespell: checks 
jammer35983: bets $0.53
perespell: folds 
Uncalled bet ($0.53) returned to jammer35983
jammer35983 collected $0.53 from pot
jammer35983: doesn't show hand 
*** SUMMARY ***
Total pot $0.55 | Rake $0.02 
Board [2d 7d 6h]
Seat 1: tortpoker (small blind) folded before Flop
Seat 2: perespell (big blind) folded on the Flop
Seat 3: jammer35983 collected ($0.53)
Seat 5: dancayamanda folded before Flop (didn't bet)
Seat 6: Hannibal2018 (button) folded before Flop (didn't bet)



PokerStars Hand #222977325885:  Hold'em No Limit ($0.05/$0.10 USD) - 2021/01/23 18:18:06 ET
Table 'Stephano III' 6-max Seat #1 is the button
Seat 1: tortpoker ($12.94 in chips) 
Seat 2: perespell ($20.33 in chips) 
Seat 3: jammer35983 ($14.60 in chips) 
Seat 5: dancayamanda ($17.68 in chips) 
Seat 6: Hannibal2018 ($12 in chips) 
perespell: posts small blind $0.05
jammer35983: posts big blind $0.10
pondax: sits out 
*** HOLE CARDS ***
dancayamanda: folds 
Hannibal2018: raises $0.10 to $0.20
tortpoker: folds 
perespell: calls $0.15
jammer35983: calls $0.10
*** FLOP *** [Ad Jc 3c]
perespell: checks 
jammer35983: checks 
Hannibal2018: bets $0.28
perespell: folds 
jammer35983: calls $0.28
*** TURN *** [Ad Jc 3c] [Ah]
jammer35983: checks 
Hannibal2018: bets $0.55
jammer35983: calls $0.55
*** RIVER *** [Ad Jc 3c Ah] [8s]
jammer35983: checks 
Hannibal2018: bets $1.08
jammer35983: calls $1.08
*** SHOW DOWN ***
Hannibal2018: shows [As 9s] (three of a kind, Aces)
jammer35983: mucks hand 
Hannibal2018 collected $4.22 from pot
*** SUMMARY ***
Total pot $4.42 | Rake $0.20 
Board [Ad Jc 3c Ah 8s]
Seat 1: tortpoker (button) folded before Flop (didn't bet)
Seat 2: perespell (small blind) folded on the Flop
Seat 3: jammer35983 (big blind) mucked
Seat 5: dancayamanda folded before Flop (didn't bet)
Seat 6: Hannibal2018 showed [As 9s] and won ($4.22) with three of a kind, Aces



PokerStars Hand #222977360130:  Hold'em No Limit ($0.05/$0.10 USD) - 2021/01/23 18:18:57 ET
Table 'Stephano III' 6-max Seat #2 is the button
Seat 1: tortpoker ($12.94 in chips) 
Seat 2: perespell ($20.13 in chips) 
Seat 3: jammer35983 ($12.49 in chips) 
Seat 4: pondax ($10 in chips) 
Seat 5: dancayamanda ($17.68 in chips) 
Seat 6: Hannibal2018 ($14.11 in chips) 
jammer35983: posts small blind $0.05
pondax: posts big blind $0.10
*** HOLE CARDS ***
dancayamanda: folds 
Hannibal2018: calls $0.10
tortpoker: folds 
perespell: raises $0.15 to $0.25
jammer35983: folds 
pondax: folds 
Hannibal2018: calls $0.15
*** FLOP *** [5h Qh Jd]
Hannibal2018: checks 
perespell: bets $0.47
Hannibal2018: calls $0.47
*** TURN *** [5h Qh Jd] [5c]
Hannibal2018: checks 
perespell: bets $0.78
Hannibal2018: calls $0.78
*** RIVER *** [5h Qh Jd 5c] [2s]
Hannibal2018: bets $1.50
perespell: raises $3 to $4.50
Hannibal2018: folds 
Uncalled bet ($3) returned to perespell
perespell collected $5.87 from pot
perespell: doesn't show hand 
*** SUMMARY ***
Total pot $6.15 | Rake $0.28 
Board [5h Qh Jd 5c 2s]
Seat 1: tortpoker folded before Flop (didn't bet)
Seat 2: perespell (button) collected ($5.87)
Seat 3: jammer35983 (small blind) folded before Flop
Seat 4: pondax (big blind) folded before Flop
Seat 5: dancayamanda folded before Flop (didn't bet)
Seat 6: Hannibal2018 folded on the River



PokerStars Hand #222977410200:  Hold'em No Limit ($0.05/$0.10 USD) - 2021/01/23 18:20:12 ET
Table 'Stephano III' 6-max Seat #3 is the button
Seat 1: tortpoker ($12.94 in chips) 
Seat 2: perespell ($23 in chips) 
Seat 3: jammer35983 ($12.44 in chips) 
Seat 4: pondax ($9.90 in chips) 
Seat 5: dancayamanda ($17.68 in chips) 
Seat 6: Hannibal2018 ($11.11 in chips) 
pondax: posts small blind $0.05
dancayamanda: posts big blind $0.10
*** HOLE CARDS ***
Hannibal2018: raises $0.30 to $0.40
tortpoker: folds 
perespell: folds 
jammer35983: folds 
pondax: folds 
dancayamanda: folds 
Uncalled bet ($0.30) returned to Hannibal2018
Hannibal2018 collected $0.25 from pot
*** SUMMARY ***
Total pot $0.25 | Rake $0 
Seat 1: tortpoker folded before Flop (didn't bet)
Seat 2: perespell folded before Flop (didn't bet)
Seat 3: jammer35983 (button) folded before Flop (didn't bet)
Seat 4: pondax (small blind) folded before Flop
Seat 5: dancayamanda (big blind) folded before Flop
Seat 6: Hannibal2018 collected ($0.25)



PokerStars Hand #222977433969:  Hold'em No Limit ($0.05/$0.10 USD) - 2021/01/23 18:20:48 ET
Table 'Stephano III' 6-max Seat #4 is the button
Seat 1: tortpoker ($12.94 in chips) 
Seat 2: perespell ($23 in chips) 
Seat 3: jammer35983 ($12.44 in chips) 
Seat 4: pondax ($10 in chips) 
Seat 5: dancayamanda ($17.58 in chips) 
Seat 6: Hannibal2018 ($11.26 in chips) 
dancayamanda: posts small blind $0.05
Hannibal2018: posts big blind $0.10
*** HOLE CARDS ***
tortpoker: folds 
perespell: folds 
jammer35983 has timed out
jammer35983: folds 
pondax: folds 
dancayamanda: raises $0.20 to $0.30
Hannibal2018: raises $0.20 to $0.50
dancayamanda: calls $0.20
*** FLOP *** [5c Jd Jh]
dancayamanda: checks 
Hannibal2018: bets $0.68
dancayamanda: folds 
Uncalled bet ($0.68) returned to Hannibal2018
Hannibal2018 collected $0.96 from pot
*** SUMMARY ***
Total pot $1 | Rake $0.04 
Board [5c Jd Jh]
Seat 1: tortpoker folded before Flop (didn't bet)
Seat 2: perespell folded before Flop (didn't bet)
Seat 3: jammer35983 folded before Flop (didn't bet)
Seat 4: pondax (button) folded before Flop (didn't bet)
Seat 5: dancayamanda (small blind) folded on the Flop
Seat 6: Hannibal2018 (big blind) collected ($0.96)



PokerStars Hand #222977472228:  Hold'em No Limit ($0.05/$0.10 USD) - 2021/01/23 18:21:45 ET
Table 'Stephano III' 6-max Seat #5 is the button
Seat 1: tortpoker ($12.94 in chips) 
Seat 2: perespell ($23 in chips) 
Seat 3: jammer35983 ($12.44 in chips) 
Seat 4: pondax ($10 in chips) 
Seat 5: dancayamanda ($17.08 in chips) 
Seat 6: Hannibal2018 ($11.72 in chips) 
Hannibal2018: posts small blind $0.05
tortpoker: posts big blind $0.10
*** HOLE CARDS ***
perespell: folds 
jammer35983: calls $0.10
pondax: folds 
dancayamanda: folds 
Hannibal2018: calls $0.05
tortpoker: checks 
*** FLOP *** [7s Qd As]
Hannibal2018: bets $0.29
tortpoker: folds 
jammer35983: calls $0.29
*** TURN *** [7s Qd As] [6d]
Hannibal2018: bets $0.62
jammer35983: folds 
Uncalled bet ($0.62) returned to Hannibal2018
Hannibal2018 collected $0.84 from pot
*** SUMMARY ***
Total pot $0.88 | Rake $0.04 
Board [7s Qd As 6d]
Seat 1: tortpoker (big blind) folded on the Flop
Seat 2: perespell folded before Flop (didn't bet)
Seat 3: jammer35983 folded on the Turn
Seat 4: pondax folded before Flop (didn't bet)
Seat 5: dancayamanda (button) folded before Flop (didn't bet)
Seat 6: Hannibal2018 (small blind) collected ($0.84)



PokerStars Hand #222977496904:  Hold'em No Limit ($0.05/$0.10 USD) - 2021/01/23 18:22:22 ET
Table 'Stephano III' 6-max Seat #6 is the button
Seat 1: tortpoker ($12.84 in chips) 
Seat 2: perespell ($23 in chips) 
Seat 3: jammer35983 ($12.05 in chips) 
Seat 4: pondax ($10 in chips) 
Seat 5: dancayamanda ($17.08 in chips) 
Seat 6: Hannibal2018 ($12.17 in chips) 
tortpoker: posts small blind $0.05
perespell: posts big blind $0.10
*** HOLE CARDS ***
jammer35983: raises $0.10 to $0.20
pondax: folds 
dancayamanda: folds 
Hannibal2018: calls $0.20
tortpoker: raises $1 to $1.20
perespell: folds 
jammer35983: folds 
Hannibal2018: folds 
Uncalled bet ($1) returned to tortpoker
tortpoker collected $0.70 from pot
tortpoker: doesn't show hand 
*** SUMMARY ***
Total pot $0.70 | Rake $0 
Seat 1: tortpoker (small blind) collected ($0.70)
Seat 2: perespell (big blind) folded before Flop
Seat 3: jammer35983 folded before Flop
Seat 4: pondax folded before Flop (didn't bet)
Seat 5: dancayamanda folded before Flop (didn't bet)
Seat 6: Hannibal2018 (button) folded before Flop



PokerStars Hand #222977524031:  Hold'em No Limit ($0.05/$0.10 USD) - 2021/01/23 18:22:51 ET
Table 'Stephano III' 6-max Seat #1 is the button
Seat 1: tortpoker ($13.34 in chips) 
Seat 2: perespell ($22.90 in chips) 
Seat 3: jammer35983 ($11.85 in chips) 
Seat 4: pondax ($10 in chips) 
Seat 5: dancayamanda ($17.08 in chips) 
Seat 6: Hannibal2018 ($11.97 in chips) 
perespell: posts small blind $0.05
jammer35983: posts big blind $0.10
*** HOLE CARDS ***
pondax: folds 
dancayamanda: folds 
Hannibal2018: raises $0.30 to $0.40
tortpoker: folds 
perespell: folds 
jammer35983: raises $0.30 to $0.70
Hannibal2018: calls $0.30
*** FLOP *** [Td Ac 7c]
jammer35983: checks 
Hannibal2018: bets $0.69
jammer35983: calls $0.69
*** TURN *** [Td Ac 7c] [6h]
jammer35983: checks 
Hannibal2018: bets $2.70
jammer35983: folds 
Uncalled bet ($2.70) returned to Hannibal2018
Hannibal2018 collected $2.70 from pot
*** SUMMARY ***
Total pot $2.83 | Rake $0.13 
Board [Td Ac 7c 6h]
Seat 1: tortpoker (button) folded before Flop (didn't bet)
Seat 2: perespell (small blind) folded before Flop
Seat 3: jammer35983 (big blind) folded on the Turn
Seat 4: pondax folded before Flop (didn't bet)
Seat 5: dancayamanda folded before Flop (didn't bet)
Seat 6: Hannibal2018 collected ($2.70)



PokerStars Hand #222977557263:  Hold'em No Limit ($0.05/$0.10 USD) - 2021/01/23 18:23:41 ET
Table 'Stephano III' 6-max Seat #2 is the button
Seat 1: tortpoker ($13.34 in chips) 
Seat 2: perespell ($22.85 in chips) 
Seat 3: jammer35983 ($10.46 in chips) 
Seat 4: pondax ($10 in chips) 
Seat 5: dancayamanda ($17.08 in chips) 
Seat 6: Hannibal2018 ($13.28 in chips) 
jammer35983: posts small blind $0.05
pondax: posts big blind $0.10
*** HOLE CARDS ***
dancayamanda: folds 
Hannibal2018: raises $0.30 to $0.40
tortpoker: folds 
perespell: calls $0.40
jammer35983: calls $0.35
pondax: calls $0.30
*** FLOP *** [Tc 5d 8h]
jammer35983: checks 
pondax: checks 
Hannibal2018: bets $1.53
perespell: folds 
jammer35983: folds 
pondax has timed out
pondax: folds 
Uncalled bet ($1.53) returned to Hannibal2018
Hannibal2018 collected $1.53 from pot
*** SUMMARY ***
Total pot $1.60 | Rake $0.07 
Board [Tc 5d 8h]
Seat 1: tortpoker folded before Flop (didn't bet)
Seat 2: perespell (button) folded on the Flop
Seat 3: jammer35983 (small blind) folded on the Flop
Seat 4: pondax (big blind) folded on the Flop
Seat 5: dancayamanda folded before Flop (didn't bet)
Seat 6: Hannibal2018 collected ($1.53)



PokerStars Hand #222978361595:  Hold'em No Limit ($0.05/$0.10 USD) - 2021/01/23 18:44:09 ET
Table 'Stephano III' 6-max Seat #5 is the button
Seat 1: tortpoker ($13.09 in chips) 
Seat 5: Mello_Ace ($2.61 in chips) 
Seat 6: Hannibal2018 ($14.85 in chips) 
Hannibal2018: posts small blind $0.05
tortpoker: posts big blind $0.10
*** HOLE CARDS ***
Mello_Ace: calls $0.10
Hannibal2018: raises $0.10 to $0.20
tortpoker: calls $0.10
Mello_Ace: calls $0.10
*** FLOP *** [9s 7s 9c]
Hannibal2018: checks 
tortpoker: bets $0.29
Mello_Ace: calls $0.29
Hannibal2018: folds 
*** TURN *** [9s 7s 9c] [Jc]
tortpoker: checks 
Mello_Ace: bets $2.12 and is all-in
tortpoker: calls $2.12
*** RIVER *** [9s 7s 9c Jc] [4c]
*** SHOW DOWN ***
tortpoker: shows [Ts Jh] (two pair, Jacks and Nines)
Mello_Ace: shows [Th 9d] (three of a kind, Nines)
Mello_Ace collected $5.18 from pot
*** SUMMARY ***
Total pot $5.42 | Rake $0.24 
Board [9s 7s 9c Jc 4c]
Seat 1: tortpoker (big blind) showed [Ts Jh] and lost with two pair, Jacks and Nines
Seat 5: Mello_Ace (button) showed [Th 9d] and won ($5.18) with three of a kind, Nines
Seat 6: Hannibal2018 (small blind) folded on the Flop



PokerStars Hand #222978387154:  Hold'em No Limit ($0.05/$0.10 USD) - 2021/01/23 18:44:50 ET
Table 'Stephano III' 6-max Seat #6 is the button
Seat 1: tortpoker ($10.48 in chips) 
Seat 5: Mello_Ace ($5.18 in chips) 
Seat 6: Hannibal2018 ($14.65 in chips) 
tortpoker: posts small blind $0.05
Mello_Ace: posts big blind $0.10
*** HOLE CARDS ***
Hannibal2018: folds 
tortpoker: folds 
Uncalled bet ($0.05) returned to Mello_Ace
Mello_Ace collected $0.10 from pot
Mello_Ace: doesn't show hand 
*** SUMMARY ***
Total pot $0.10 | Rake $0 
Seat 1: tortpoker (small blind) folded before Flop
Seat 5: Mello_Ace (big blind) collected ($0.10)
Seat 6: Hannibal2018 (button) folded before Flop (didn't bet)



PokerStars Hand #222978393493:  Hold'em No Limit ($0.05/$0.10 USD) - 2021/01/23 18:45:00 ET
Table 'Stephano III' 6-max Seat #1 is the button
Seat 1: tortpoker ($10.43 in chips) 
Seat 5: Mello_Ace ($5.23 in chips) 
Seat 6: Hannibal2018 ($14.65 in chips) 
Mello_Ace: posts small blind $0.05
Hannibal2018: posts big blind $0.10
*** HOLE CARDS ***
tortpoker: folds 
Mello_Ace: calls $0.05
Hannibal2018: checks 
*** FLOP *** [Jd Ah Ac]
Mello_Ace: bets $0.10
Hannibal2018: folds 
Uncalled bet ($0.10) returned to Mello_Ace
Mello_Ace collected $0.19 from pot
Mello_Ace: doesn't show hand 
*** SUMMARY ***
Total pot $0.20 | Rake $0.01 
Board [Jd Ah Ac]
Seat 1: tortpoker (button) folded before Flop (didn't bet)
Seat 5: Mello_Ace (small blind) collected ($0.19)
Seat 6: Hannibal2018 (big blind) folded on the Flop



PokerStars Hand #222978402240:  Hold'em No Limit ($0.05/$0.10 USD) - 2021/01/23 18:45:14 ET
Table 'Stephano III' 6-max Seat #5 is the button
Seat 1: tortpoker ($10.43 in chips) 
Seat 5: Mello_Ace ($5.32 in chips) 
Seat 6: Hannibal2018 ($14.55 in chips) 
Hannibal2018: posts small blind $0.05
tortpoker: posts big blind $0.10
*** HOLE CARDS ***
Mello_Ace: calls $0.10
Hannibal2018: calls $0.05
tortpoker: raises $0.30 to $0.40
Mello_Ace: folds 
M.DiLandro joins the table at seat #2 
Hannibal2018: folds 
Uncalled bet ($0.30) returned to tortpoker
tortpoker collected $0.30 from pot
tortpoker: doesn't show hand 
*** SUMMARY ***
Total pot $0.30 | Rake $0 
Seat 1: tortpoker (big blind) collected ($0.30)
Seat 5: Mello_Ace (button) folded before Flop
Seat 6: Hannibal2018 (small blind) folded before Flop



PokerStars Hand #222978414343:  Hold'em No Limit ($0.05/$0.10 USD) - 2021/01/23 18:45:33 ET
Table 'Stephano III' 6-max Seat #6 is the button
Seat 1: tortpoker ($10.63 in chips) 
Seat 2: M.DiLandro ($8 in chips) 
Seat 5: Mello_Ace ($5.22 in chips) 
Seat 6: Hannibal2018 ($14.45 in chips) 
tortpoker: posts small blind $0.05
M.DiLandro: posts big blind $0.10
*** HOLE CARDS ***
Mello_Ace: calls $0.10
Hannibal2018: folds 
tortpoker: folds 
M.DiLandro: checks 
*** FLOP *** [Ts 3h 3d]
M.DiLandro: checks 
Mello_Ace: checks 
*** TURN *** [Ts 3h 3d] [Th]
M.DiLandro: checks 
zebaztravez joins the table at seat #4 
Mello_Ace: bets $0.12
M.DiLandro: calls $0.12
*** RIVER *** [Ts 3h 3d Th] [6s]
M.DiLandro: checks 
Mello_Ace: bets $0.24
xSkokEx joins the table at seat #3 
M.DiLandro: folds 
Uncalled bet ($0.24) returned to Mello_Ace
Mello_Ace collected $0.47 from pot
Mello_Ace: doesn't show hand 
*** SUMMARY ***
Total pot $0.49 | Rake $0.02 
Board [Ts 3h 3d Th 6s]
Seat 1: tortpoker (small blind) folded before Flop
Seat 2: M.DiLandro (big blind) folded on the River
Seat 5: Mello_Ace collected ($0.47)
Seat 6: Hannibal2018 (button) folded before Flop (didn't bet)



PokerStars Hand #222978442771:  Hold'em No Limit ($0.05/$0.10 USD) - 2021/01/23 18:46:18 ET
Table 'Stephano III' 6-max Seat #1 is the button
Seat 1: tortpoker ($10.58 in chips) 
Seat 2: M.DiLandro ($7.78 in chips) 
Seat 3: xSkokEx ($10 in chips) 
Seat 5: Mello_Ace ($5.47 in chips) 
Seat 6: Hannibal2018 ($14.45 in chips) 
M.DiLandro: posts small blind $0.05
xSkokEx: posts big blind $0.10
zebaztravez: sits out 
*** HOLE CARDS ***
Mello_Ace: calls $0.10
Hannibal2018: folds 
tortpoker: raises $0.40 to $0.50
M.DiLandro: folds 
xSkokEx: calls $0.40
Mello_Ace: folds 
*** FLOP *** [7d 7s 8d]
xSkokEx: checks 
tortpoker: bets $0.36
xSkokEx: raises $0.72 to $1.08
tortpoker: calls $0.72
*** TURN *** [7d 7s 8d] [9h]
xSkokEx: bets $1.26
tortpoker: calls $1.26
*** RIVER *** [7d 7s 8d 9h] [Ts]
xSkokEx: bets $3.73
tortpoker: raises $4.01 to $7.74 and is all-in
xSkokEx: folds 
Uncalled bet ($4.01) returned to tortpoker
tortpoker collected $12.69 from pot
tortpoker: doesn't show hand 
*** SUMMARY ***
Total pot $13.29 | Rake $0.60 
Board [7d 7s 8d 9h Ts]
Seat 1: tortpoker (button) collected ($12.69)
Seat 2: M.DiLandro (small blind) folded before Flop
Seat 3: xSkokEx (big blind) folded on the River
Seat 5: Mello_Ace folded before Flop
Seat 6: Hannibal2018 folded before Flop (didn't bet)



PokerStars Hand #222978472886:  Hold'em No Limit ($0.05/$0.10 USD) - 2021/01/23 18:47:07 ET
Table 'Stephano III' 6-max Seat #2 is the button
Seat 1: tortpoker ($16.70 in chips) 
Seat 2: M.DiLandro ($7.73 in chips) 
Seat 3: xSkokEx ($10 in chips) 
Seat 4: zebaztravez ($10 in chips) 
Seat 5: Mello_Ace ($5.37 in chips) 
Seat 6: Hannibal2018 ($14.45 in chips) 
xSkokEx: posts small blind $0.05
zebaztravez: posts big blind $0.10
*** HOLE CARDS ***
Mello_Ace: folds 
Hannibal2018: folds 
tortpoker: folds 
M.DiLandro: raises $0.20 to $0.30
xSkokEx: folds 
zebaztravez: folds 
Uncalled bet ($0.20) returned to M.DiLandro
M.DiLandro collected $0.25 from pot
M.DiLandro: doesn't show hand 
*** SUMMARY ***
Total pot $0.25 | Rake $0 
Seat 1: tortpoker folded before Flop (didn't bet)
Seat 2: M.DiLandro (button) collected ($0.25)
Seat 3: xSkokEx (small blind) folded before Flop
Seat 4: zebaztravez (big blind) folded before Flop
Seat 5: Mello_Ace folded before Flop (didn't bet)
Seat 6: Hannibal2018 folded before Flop (didn't bet)



PokerStars Hand #222978481202:  Hold'em No Limit ($0.05/$0.10 USD) - 2021/01/23 18:47:20 ET
Table 'Stephano III' 6-max Seat #3 is the button
Seat 1: tortpoker ($16.70 in chips) 
Seat 2: M.DiLandro ($7.88 in chips) 
Seat 3: xSkokEx ($10 in chips) 
Seat 4: zebaztravez ($10 in chips) 
Seat 5: Mello_Ace ($5.37 in chips) 
Seat 6: Hannibal2018 ($14.45 in chips) 
zebaztravez: posts small blind $0.05
Mello_Ace: posts big blind $0.10
*** HOLE CARDS ***
Hannibal2018: calls $0.10
tortpoker: folds 
M.DiLandro: folds 
xSkokEx: folds 
zebaztravez: raises $0.40 to $0.50
Mello_Ace: folds 
Hannibal2018: folds 
Uncalled bet ($0.40) returned to zebaztravez
zebaztravez collected $0.30 from pot
zebaztravez: doesn't show hand 
*** SUMMARY ***
Total pot $0.30 | Rake $0 
Seat 1: tortpoker folded before Flop (didn't bet)
Seat 2: M.DiLandro folded before Flop (didn't bet)
Seat 3: xSkokEx (button) folded before Flop (didn't bet)
Seat 4: zebaztravez (small blind) collected ($0.30)
Seat 5: Mello_Ace (big blind) folded before Flop
Seat 6: Hannibal2018 folded before Flop



PokerStars Hand #222978500179:  Hold'em No Limit ($0.05/$0.10 USD) - 2021/01/23 18:47:50 ET
Table 'Stephano III' 6-max Seat #4 is the button
Seat 1: tortpoker ($16.70 in chips) 
Seat 2: M.DiLandro ($7.88 in chips) 
Seat 3: xSkokEx ($10 in chips) 
Seat 4: zebaztravez ($10.20 in chips) 
Seat 5: Mello_Ace ($5.27 in chips) 
Seat 6: Hannibal2018 ($14.35 in chips) 
Mello_Ace: posts small blind $0.05
Hannibal2018: posts big blind $0.10
*** HOLE CARDS ***
tortpoker: folds 
M.DiLandro: folds 
xSkokEx: folds 
zebaztravez: folds 
Mello_Ace: calls $0.05
Hannibal2018: raises $0.20 to $0.30
Mello_Ace: calls $0.20
*** FLOP *** [3d Jc 5c]
Mello_Ace: checks 
Hannibal2018: checks 
*** TURN *** [3d Jc 5c] [5s]
Mello_Ace: checks 
Hannibal2018: checks 
*** RIVER *** [3d Jc 5c 5s] [Ac]
Mello_Ace: bets $0.10
Hannibal2018: folds 
Uncalled bet ($0.10) returned to Mello_Ace
Mello_Ace collected $0.57 from pot
Mello_Ace: doesn't show hand 
*** SUMMARY ***
Total pot $0.60 | Rake $0.03 
Board [3d Jc 5c 5s Ac]
Seat 1: tortpoker folded before Flop (didn't bet)
Seat 2: M.DiLandro folded before Flop (didn't bet)
Seat 3: xSkokEx folded before Flop (didn't bet)
Seat 4: zebaztravez (button) folded before Flop (didn't bet)
Seat 5: Mello_Ace (small blind) collected ($0.57)
Seat 6: Hannibal2018 (big blind) folded on the River



PokerStars Hand #222978518453:  Hold'em No Limit ($0.05/$0.10 USD) - 2021/01/23 18:48:20 ET
Table 'Stephano III' 6-max Seat #5 is the button
Seat 1: tortpoker ($16.70 in chips) 
Seat 2: M.DiLandro ($7.88 in chips) 
Seat 3: xSkokEx ($10 in chips) 
Seat 4: zebaztravez ($10.20 in chips) 
Seat 5: Mello_Ace ($5.54 in chips) 
Seat 6: Hannibal2018 ($14.05 in chips) 
Hannibal2018: posts small blind $0.05
tortpoker: posts big blind $0.10
*** HOLE CARDS ***
M.DiLandro: calls $0.10
xSkokEx: folds 
zebaztravez: raises $0.30 to $0.40
Mello_Ace: folds 
Hannibal2018: folds 
tortpoker: folds 
M.DiLandro: calls $0.30
*** FLOP *** [Jc 2h Kc]
M.DiLandro: checks 
zebaztravez: bets $0.30
M.DiLandro: calls $0.30
*** TURN *** [Jc 2h Kc] [5c]
M.DiLandro: checks 
zebaztravez: checks 
*** RIVER *** [Jc 2h Kc 5c] [4s]
M.DiLandro: checks 
zebaztravez: checks 
*** SHOW DOWN ***
M.DiLandro: shows [Ts Jd] (a pair of Jacks)
zebaztravez: mucks hand 
M.DiLandro collected $1.48 from pot
*** SUMMARY ***
Total pot $1.55 | Rake $0.07 
Board [Jc 2h Kc 5c 4s]
Seat 1: tortpoker (big blind) folded before Flop
Seat 2: M.DiLandro showed [Ts Jd] and won ($1.48) with a pair of Jacks
Seat 3: xSkokEx folded before Flop (didn't bet)
Seat 4: zebaztravez mucked
Seat 5: Mello_Ace (button) folded before Flop (didn't bet)
Seat 6: Hannibal2018 (small blind) folded before Flop



PokerStars Hand #222978583272:  Hold'em No Limit ($0.05/$0.10 USD) - 2021/01/23 18:50:01 ET
Table 'Stephano III' 6-max Seat #6 is the button
Seat 1: tortpoker ($16.60 in chips) 
Seat 2: M.DiLandro ($8.66 in chips) 
Seat 3: xSkokEx ($10 in chips) 
Seat 4: zebaztravez ($10 in chips) 
Seat 5: Mello_Ace ($5.54 in chips) 
Seat 6: Hannibal2018 ($14 in chips) 
tortpoker: posts small blind $0.05
M.DiLandro: posts big blind $0.10
*** HOLE CARDS ***
xSkokEx: folds 
zebaztravez: raises $0.20 to $0.30
Mello_Ace: folds 
Hannibal2018: folds 
tortpoker: raises $0.90 to $1.20
M.DiLandro: folds 
zebaztravez: folds 
Uncalled bet ($0.90) returned to tortpoker
tortpoker collected $0.70 from pot
tortpoker: doesn't show hand 
*** SUMMARY ***
Total pot $0.70 | Rake $0 
Seat 1: tortpoker (small blind) collected ($0.70)
Seat 2: M.DiLandro (big blind) folded before Flop
Seat 3: xSkokEx folded before Flop (didn't bet)
Seat 4: zebaztravez folded before Flop
Seat 5: Mello_Ace folded before Flop (didn't bet)
Seat 6: Hannibal2018 (button) folded before Flop (didn't bet)



PokerStars Hand #222978608761:  Hold'em No Limit ($0.05/$0.10 USD) - 2021/01/23 18:50:43 ET
Table 'Stephano III' 6-max Seat #1 is the button
Seat 1: tortpoker ($17 in chips) 
Seat 2: M.DiLandro ($8.56 in chips) 
Seat 3: xSkokEx ($10 in chips) 
Seat 4: zebaztravez ($10 in chips) 
Seat 5: Mello_Ace ($5.54 in chips) 
Seat 6: Hannibal2018 ($14 in chips) 
M.DiLandro: posts small blind $0.05
xSkokEx: posts big blind $0.10
*** HOLE CARDS ***
zebaztravez: raises $0.20 to $0.30
Mello_Ace: folds 
Hannibal2018: folds 
tortpoker: folds 
M.DiLandro: folds 
xSkokEx: folds 
Uncalled bet ($0.20) returned to zebaztravez
zebaztravez collected $0.25 from pot
zebaztravez: doesn't show hand 
*** SUMMARY ***
Total pot $0.25 | Rake $0 
Seat 1: tortpoker (button) folded before Flop (didn't bet)
Seat 2: M.DiLandro (small blind) folded before Flop
Seat 3: xSkokEx (big blind) folded before Flop
Seat 4: zebaztravez collected ($0.25)
Seat 5: Mello_Ace folded before Flop (didn't bet)
Seat 6: Hannibal2018 folded before Flop (didn't bet)



PokerStars Hand #222978616887:  Hold'em No Limit ($0.05/$0.10 USD) - 2021/01/23 18:50:56 ET
Table 'Stephano III' 6-max Seat #2 is the button
Seat 1: tortpoker ($17 in chips) 
Seat 2: M.DiLandro ($8.51 in chips) 
Seat 3: xSkokEx ($10 in chips) 
Seat 4: zebaztravez ($10.15 in chips) 
Seat 5: Mello_Ace ($5.54 in chips) 
Seat 6: Hannibal2018 ($14 in chips) 
xSkokEx: posts small blind $0.05
zebaztravez: posts big blind $0.10
*** HOLE CARDS ***
Mello_Ace: folds 
Hannibal2018: folds 
tortpoker: raises $0.20 to $0.30
M.DiLandro: folds 
xSkokEx: folds 
zebaztravez: folds 
Uncalled bet ($0.20) returned to tortpoker
tortpoker collected $0.25 from pot
tortpoker: doesn't show hand 
*** SUMMARY ***
Total pot $0.25 | Rake $0 
Seat 1: tortpoker collected ($0.25)
Seat 2: M.DiLandro (button) folded before Flop (didn't bet)
Seat 3: xSkokEx (small blind) folded before Flop
Seat 4: zebaztravez (big blind) folded before Flop
Seat 5: Mello_Ace folded before Flop (didn't bet)
Seat 6: Hannibal2018 folded before Flop (didn't bet)



PokerStars Hand #222978628978:  Hold'em No Limit ($0.05/$0.10 USD) - 2021/01/23 18:51:16 ET
Table 'Stephano III' 6-max Seat #3 is the button
Seat 1: tortpoker ($17.15 in chips) 
Seat 2: M.DiLandro ($8.51 in chips) 
Seat 3: xSkokEx ($10 in chips) 
Seat 4: zebaztravez ($10.05 in chips) 
Seat 5: Mello_Ace ($5.54 in chips) 
Seat 6: Hannibal2018 ($14 in chips) 
zebaztravez: posts small blind $0.05
Mello_Ace: posts big blind $0.10
*** HOLE CARDS ***
Hannibal2018: raises $0.20 to $0.30
tortpoker: folds 
M.DiLandro: calls $0.30
xSkokEx: folds 
zebaztravez: calls $0.25
Mello_Ace: folds 
*** FLOP *** [7c Th 9s]
zebaztravez: checks 
Hannibal2018: bets $0.48
M.DiLandro: calls $0.48
zebaztravez: raises $1.80 to $2.28
Hannibal2018: folds 
M.DiLandro: folds 
Uncalled bet ($1.80) returned to zebaztravez
zebaztravez collected $2.33 from pot
zebaztravez: doesn't show hand 
*** SUMMARY ***
Total pot $2.44 | Rake $0.11 
Board [7c Th 9s]
Seat 1: tortpoker folded before Flop (didn't bet)
Seat 2: M.DiLandro folded on the Flop
Seat 3: xSkokEx (button) folded before Flop (didn't bet)
Seat 4: zebaztravez (small blind) collected ($2.33)
Seat 5: Mello_Ace (big blind) folded before Flop
Seat 6: Hannibal2018 folded on the Flop



PokerStars Hand #222978664968:  Hold'em No Limit ($0.05/$0.10 USD) - 2021/01/23 18:52:16 ET
Table 'Stephano III' 6-max Seat #4 is the button
Seat 1: tortpoker ($17.15 in chips) 
Seat 2: M.DiLandro ($7.73 in chips) 
Seat 3: xSkokEx ($10 in chips) 
Seat 4: zebaztravez ($11.60 in chips) 
Seat 5: Mello_Ace ($5.44 in chips) 
Seat 6: Hannibal2018 ($13.22 in chips) 
Mello_Ace: posts small blind $0.05
Hannibal2018: posts big blind $0.10
*** HOLE CARDS ***
tortpoker: raises $0.20 to $0.30
M.DiLandro: folds 
xSkokEx: folds 
zebaztravez: folds 
Mello_Ace: calls $0.25
Hannibal2018: calls $0.20
*** FLOP *** [Tc 2s 4s]
Mello_Ace: checks 
Hannibal2018: checks 
tortpoker: checks 
*** TURN *** [Tc 2s 4s] [8s]
Mello_Ace: bets $0.43
Hannibal2018: folds 
tortpoker: folds 
Uncalled bet ($0.43) returned to Mello_Ace
Mello_Ace collected $0.86 from pot
Mello_Ace: doesn't show hand 
*** SUMMARY ***
Total pot $0.90 | Rake $0.04 
Board [Tc 2s 4s 8s]
Seat 1: tortpoker folded on the Turn
Seat 2: M.DiLandro folded before Flop (didn't bet)
Seat 3: xSkokEx folded before Flop (didn't bet)
Seat 4: zebaztravez (button) folded before Flop (didn't bet)
Seat 5: Mello_Ace (small blind) collected ($0.86)
Seat 6: Hannibal2018 (big blind) folded on the Turn



PokerStars Hand #222978693996:  Hold'em No Limit ($0.05/$0.10 USD) - 2021/01/23 18:53:04 ET
Table 'Stephano III' 6-max Seat #5 is the button
Seat 1: tortpoker ($16.85 in chips) 
Seat 2: M.DiLandro ($7.73 in chips) 
Seat 3: xSkokEx ($10 in chips) 
Seat 4: zebaztravez ($11.60 in chips) 
Seat 5: Mello_Ace ($6 in chips) 
Seat 6: Hannibal2018 ($12.92 in chips) 
Hannibal2018: posts small blind $0.05
tortpoker: posts big blind $0.10
*** HOLE CARDS ***
M.DiLandro: calls $0.10
xSkokEx: folds 
zebaztravez: folds 
Mello_Ace: folds 
Hannibal2018: folds 
tortpoker: checks 
*** FLOP *** [6s Ac 9s]
tortpoker: checks 
M.DiLandro: bets $0.18
tortpoker: folds 
Uncalled bet ($0.18) returned to M.DiLandro
M.DiLandro collected $0.24 from pot
M.DiLandro: doesn't show hand 
*** SUMMARY ***
Total pot $0.25 | Rake $0.01 
Board [6s Ac 9s]
Seat 1: tortpoker (big blind) folded on the Flop
Seat 2: M.DiLandro collected ($0.24)
Seat 3: xSkokEx folded before Flop (didn't bet)
Seat 4: zebaztravez folded before Flop (didn't bet)
Seat 5: Mello_Ace (button) folded before Flop (didn't bet)
Seat 6: Hannibal2018 (small blind) folded before Flop



PokerStars Hand #222978710420:  Hold'em No Limit ($0.05/$0.10 USD) - 2021/01/23 18:53:31 ET
Table 'Stephano III' 6-max Seat #6 is the button
Seat 1: tortpoker ($16.75 in chips) 
Seat 2: M.DiLandro ($7.87 in chips) 
Seat 3: xSkokEx ($10 in chips) 
Seat 4: zebaztravez ($11.60 in chips) 
Seat 5: Mello_Ace ($6 in chips) 
Seat 6: Hannibal2018 ($12.87 in chips) 
tortpoker: posts small blind $0.05
M.DiLandro: posts big blind $0.10
*** HOLE CARDS ***
xSkokEx: raises $0.15 to $0.25
zebaztravez: folds 
Mello_Ace: calls $0.25
Hannibal2018: calls $0.25
tortpoker: folds 
M.DiLandro: folds 
*** FLOP *** [Qd 8c Ac]
xSkokEx: checks 
Mello_Ace: bets $0.43
Hannibal2018: folds 
xSkokEx: folds 
Uncalled bet ($0.43) returned to Mello_Ace
Mello_Ace collected $0.86 from pot
Mello_Ace: doesn't show hand 
*** SUMMARY ***
Total pot $0.90 | Rake $0.04 
Board [Qd 8c Ac]
Seat 1: tortpoker (small blind) folded before Flop
Seat 2: M.DiLandro (big blind) folded before Flop
Seat 3: xSkokEx folded on the Flop
Seat 4: zebaztravez folded before Flop (didn't bet)
Seat 5: Mello_Ace collected ($0.86)
Seat 6: Hannibal2018 (button) folded on the Flop



PokerStars Hand #222978732572:  Hold'em No Limit ($0.05/$0.10 USD) - 2021/01/23 18:54:08 ET
Table 'Stephano III' 6-max Seat #1 is the button
Seat 1: tortpoker ($16.70 in chips) 
Seat 2: M.DiLandro ($7.77 in chips) 
Seat 3: xSkokEx ($10 in chips) 
Seat 4: zebaztravez ($11.60 in chips) 
Seat 5: Mello_Ace ($6.61 in chips) 
Seat 6: Hannibal2018 ($12.62 in chips) 
M.DiLandro: posts small blind $0.05
xSkokEx: posts big blind $0.10
*** HOLE CARDS ***
zebaztravez: folds 
Mello_Ace: folds 
Hannibal2018: folds 
tortpoker: raises $0.20 to $0.30
M.DiLandro: folds 
xSkokEx: folds 
Uncalled bet ($0.20) returned to tortpoker
tortpoker collected $0.25 from pot
tortpoker: doesn't show hand 
*** SUMMARY ***
Total pot $0.25 | Rake $0 
Seat 1: tortpoker (button) collected ($0.25)
Seat 2: M.DiLandro (small blind) folded before Flop
Seat 3: xSkokEx (big blind) folded before Flop
Seat 4: zebaztravez folded before Flop (didn't bet)
Seat 5: Mello_Ace folded before Flop (didn't bet)
Seat 6: Hannibal2018 folded before Flop (didn't bet)



PokerStars Hand #222978741684:  Hold'em No Limit ($0.05/$0.10 USD) - 2021/01/23 18:54:23 ET
Table 'Stephano III' 6-max Seat #2 is the button
Seat 1: tortpoker ($16.85 in chips) 
Seat 2: M.DiLandro ($7.72 in chips) 
Seat 3: xSkokEx ($10 in chips) 
Seat 4: zebaztravez ($11.60 in chips) 
Seat 5: Mello_Ace ($6.61 in chips) 
Seat 6: Hannibal2018 ($12.62 in chips) 
xSkokEx: posts small blind $0.05
zebaztravez: posts big blind $0.10
*** HOLE CARDS ***
Mello_Ace: folds 
Hannibal2018: folds 
tortpoker: folds 
M.DiLandro: raises $0.20 to $0.30
xSkokEx: folds 
zebaztravez: calls $0.20
*** FLOP *** [2c 6s Ts]
zebaztravez: checks 
M.DiLandro: checks 
*** TURN *** [2c 6s Ts] [7s]
zebaztravez: checks 
M.DiLandro: bets $0.47
zebaztravez: folds 
Uncalled bet ($0.47) returned to M.DiLandro
M.DiLandro collected $0.62 from pot
M.DiLandro: doesn't show hand 
*** SUMMARY ***
Total pot $0.65 | Rake $0.03 
Board [2c 6s Ts 7s]
Seat 1: tortpoker folded before Flop (didn't bet)
Seat 2: M.DiLandro (button) collected ($0.62)
Seat 3: xSkokEx (small blind) folded before Flop
Seat 4: zebaztravez (big blind) folded on the Turn
Seat 5: Mello_Ace folded before Flop (didn't bet)
Seat 6: Hannibal2018 folded before Flop (didn't bet)



PokerStars Hand #222978768747:  Hold'em No Limit ($0.05/$0.10 USD) - 2021/01/23 18:55:09 ET
Table 'Stephano III' 6-max Seat #3 is the button
Seat 1: tortpoker ($16.85 in chips) 
Seat 2: M.DiLandro ($8.04 in chips) 
Seat 3: xSkokEx ($10 in chips) 
Seat 4: zebaztravez ($11.30 in chips) 
Seat 5: Mello_Ace ($6.61 in chips) 
Seat 6: Hannibal2018 ($12.62 in chips) 
zebaztravez: posts small blind $0.05
Mello_Ace: posts big blind $0.10
*** HOLE CARDS ***
Hannibal2018: folds 
tortpoker: folds 
M.DiLandro: raises $0.20 to $0.30
xSkokEx: calls $0.30
zebaztravez: folds 
Mello_Ace: calls $0.20
*** FLOP *** [3s 9c 5c]
Mello_Ace: checks 
M.DiLandro: checks 
xSkokEx: bets $0.61
Mello_Ace: folds 
M.DiLandro: folds 
Uncalled bet ($0.61) returned to xSkokEx
xSkokEx collected $0.91 from pot
xSkokEx: doesn't show hand 
*** SUMMARY ***
Total pot $0.95 | Rake $0.04 
Board [3s 9c 5c]
Seat 1: tortpoker folded before Flop (didn't bet)
Seat 2: M.DiLandro folded on the Flop
Seat 3: xSkokEx (button) collected ($0.91)
Seat 4: zebaztravez (small blind) folded before Flop
Seat 5: Mello_Ace (big blind) folded on the Flop
Seat 6: Hannibal2018 folded before Flop (didn't bet)



PokerStars Hand #222978789431:  Hold'em No Limit ($0.05/$0.10 USD) - 2021/01/23 18:55:55 ET
Table 'Stephano III' 6-max Seat #4 is the button
Seat 1: tortpoker ($16.85 in chips) 
Seat 2: M.DiLandro ($7.74 in chips) 
Seat 3: xSkokEx ($10.61 in chips) 
Seat 4: zebaztravez ($11.25 in chips) 
Seat 5: Mello_Ace ($6.31 in chips) 
Seat 6: Hannibal2018 ($12.62 in chips) 
Mello_Ace: posts small blind $0.05
Hannibal2018: posts big blind $0.10
*** HOLE CARDS ***
tortpoker: folds 
M.DiLandro: folds 
xSkokEx: folds 
zebaztravez: raises $0.16 to $0.26
Mello_Ace: calls $0.21
Hannibal2018: calls $0.16
*** FLOP *** [6h Js Tc]
Mello_Ace: checks 
Hannibal2018: checks 
zebaztravez: checks 
*** TURN *** [6h Js Tc] [9c]
Mello_Ace: checks 
Hannibal2018: checks 
zebaztravez: bets $0.60
Mello_Ace: calls $0.60
Hannibal2018: calls $0.60
*** RIVER *** [6h Js Tc 9c] [7d]
Mello_Ace: checks 
Hannibal2018: checks 
zebaztravez: checks 
*** SHOW DOWN ***
Mello_Ace: shows [9s Qc] (a pair of Nines)
Hannibal2018: shows [9d 2d] (a pair of Nines - lower kicker)
zebaztravez: mucks hand 
Mello_Ace collected $2.46 from pot
*** SUMMARY ***
Total pot $2.58 | Rake $0.12 
Board [6h Js Tc 9c 7d]
Seat 1: tortpoker folded before Flop (didn't bet)
Seat 2: M.DiLandro folded before Flop (didn't bet)
Seat 3: xSkokEx folded before Flop (didn't bet)
Seat 4: zebaztravez (button) mucked
Seat 5: Mello_Ace (small blind) showed [9s Qc] and won ($2.46) with a pair of Nines
Seat 6: Hannibal2018 (big blind) showed [9d 2d] and lost with a pair of Nines



PokerStars Hand #222978811286:  Hold'em No Limit ($0.05/$0.10 USD) - 2021/01/23 18:56:44 ET
Table 'Stephano III' 6-max Seat #5 is the button
Seat 1: tortpoker ($16.85 in chips) 
Seat 2: M.DiLandro ($7.74 in chips) 
Seat 3: xSkokEx ($10.61 in chips) 
Seat 4: zebaztravez ($10.39 in chips) 
Seat 5: Mello_Ace ($7.91 in chips) 
Seat 6: Hannibal2018 ($11.76 in chips) 
Hannibal2018: posts small blind $0.05
tortpoker: posts big blind $0.10
*** HOLE CARDS ***
M.DiLandro: folds 
xSkokEx: folds 
zebaztravez: raises $0.20 to $0.30
Mello_Ace: calls $0.30
Hannibal2018: calls $0.25
tortpoker: folds 
*** FLOP *** [7d As 7c]
Hannibal2018: checks 
zebaztravez: checks 
Mello_Ace: checks 
*** TURN *** [7d As 7c] [3c]
Hannibal2018: checks 
zebaztravez: bets $0.72
Mello_Ace: folds 
Hannibal2018: folds 
Uncalled bet ($0.72) returned to zebaztravez
zebaztravez collected $0.96 from pot
zebaztravez: doesn't show hand 
*** SUMMARY ***
Total pot $1 | Rake $0.04 
Board [7d As 7c 3c]
Seat 1: tortpoker (big blind) folded before Flop
Seat 2: M.DiLandro folded before Flop (didn't bet)
Seat 3: xSkokEx folded before Flop (didn't bet)
Seat 4: zebaztravez collected ($0.96)
Seat 5: Mello_Ace (button) folded on the Turn
Seat 6: Hannibal2018 (small blind) folded on the Turn



PokerStars Hand #222978827771:  Hold'em No Limit ($0.05/$0.10 USD) - 2021/01/23 18:57:22 ET
Table 'Stephano III' 6-max Seat #6 is the button
Seat 1: tortpoker ($16.75 in chips) 
Seat 2: M.DiLandro ($7.74 in chips) 
Seat 3: xSkokEx ($10.61 in chips) 
Seat 4: zebaztravez ($11.05 in chips) 
Seat 5: Mello_Ace ($7.61 in chips) 
Seat 6: Hannibal2018 ($11.46 in chips) 
tortpoker: posts small blind $0.05
M.DiLandro: posts big blind $0.10
*** HOLE CARDS ***
xSkokEx: raises $0.15 to $0.25
zebaztravez: folds 
Mello_Ace: folds 
Hannibal2018: folds 
tortpoker: folds 
M.DiLandro: folds 
Uncalled bet ($0.15) returned to xSkokEx
xSkokEx collected $0.25 from pot
xSkokEx: doesn't show hand 
*** SUMMARY ***
Total pot $0.25 | Rake $0 
Seat 1: tortpoker (small blind) folded before Flop
Seat 2: M.DiLandro (big blind) folded before Flop
Seat 3: xSkokEx collected ($0.25)
Seat 4: zebaztravez folded before Flop (didn't bet)
Seat 5: Mello_Ace folded before Flop (didn't bet)
Seat 6: Hannibal2018 (button) folded before Flop (didn't bet)



PokerStars Hand #222978833442:  Hold'em No Limit ($0.05/$0.10 USD) - 2021/01/23 18:57:34 ET
Table 'Stephano III' 6-max Seat #1 is the button
Seat 1: tortpoker ($16.70 in chips) 
Seat 2: M.DiLandro ($7.64 in chips) 
Seat 3: xSkokEx ($10.76 in chips) 
Seat 4: zebaztravez ($11.05 in chips) 
Seat 5: Mello_Ace ($7.61 in chips) 
Seat 6: Hannibal2018 ($11.46 in chips) 
M.DiLandro: posts small blind $0.05
xSkokEx: posts big blind $0.10
*** HOLE CARDS ***
zebaztravez: folds 
Mello_Ace: calls $0.10
Hannibal2018: raises $0.40 to $0.50
tortpoker: folds 
M.DiLandro: folds 
xSkokEx: folds 
Mello_Ace: calls $0.40
*** FLOP *** [8h 4s 4h]
Mello_Ace: checks 
Hannibal2018: bets $1.10
Mello_Ace: folds 
Uncalled bet ($1.10) returned to Hannibal2018
Hannibal2018 collected $1.10 from pot
*** SUMMARY ***
Total pot $1.15 | Rake $0.05 
Board [8h 4s 4h]
Seat 1: tortpoker (button) folded before Flop (didn't bet)
Seat 2: M.DiLandro (small blind) folded before Flop
Seat 3: xSkokEx (big blind) folded before Flop
Seat 4: zebaztravez folded before Flop (didn't bet)
Seat 5: Mello_Ace folded on the Flop
Seat 6: Hannibal2018 collected ($1.10)



PokerStars Hand #222978845076:  Hold'em No Limit ($0.05/$0.10 USD) - 2021/01/23 18:58:01 ET
Table 'Stephano III' 6-max Seat #2 is the button
Seat 1: tortpoker ($16.70 in chips) 
Seat 2: M.DiLandro ($7.59 in chips) 
Seat 3: xSkokEx ($10.66 in chips) 
Seat 4: zebaztravez ($11.05 in chips) 
Seat 5: Mello_Ace ($7.11 in chips) 
Seat 6: Hannibal2018 ($12.06 in chips) 
xSkokEx: posts small blind $0.05
zebaztravez: posts big blind $0.10
*** HOLE CARDS ***
Mello_Ace: folds 
Hannibal2018 has timed out
Hannibal2018: folds 
tortpoker: folds 
M.DiLandro: folds 
xSkokEx: raises $0.20 to $0.30
zebaztravez: folds 
Uncalled bet ($0.20) returned to xSkokEx
xSkokEx collected $0.20 from pot
xSkokEx: doesn't show hand 
*** SUMMARY ***
Total pot $0.20 | Rake $0 
Seat 1: tortpoker folded before Flop (didn't bet)
Seat 2: M.DiLandro (button) folded before Flop (didn't bet)
Seat 3: xSkokEx (small blind) collected ($0.20)
Seat 4: zebaztravez (big blind) folded before Flop
Seat 5: Mello_Ace folded before Flop (didn't bet)
Seat 6: Hannibal2018 folded before Flop (didn't bet)



PokerStars Hand #222978855794:  Hold'em No Limit ($0.05/$0.10 USD) - 2021/01/23 18:58:25 ET
Table 'Stephano III' 6-max Seat #3 is the button
Seat 1: tortpoker ($16.70 in chips) 
Seat 2: M.DiLandro ($7.59 in chips) 
Seat 3: xSkokEx ($10.76 in chips) 
Seat 4: zebaztravez ($10.95 in chips) 
Seat 6: Hannibal2018 ($12.06 in chips) 
zebaztravez: posts small blind $0.05
Hannibal2018: posts big blind $0.10
*** HOLE CARDS ***
tortpoker: folds 
M.DiLandro: raises $0.20 to $0.30
xSkokEx: folds 
zebaztravez: folds 
Hannibal2018: folds 
Uncalled bet ($0.20) returned to M.DiLandro
M.DiLandro collected $0.25 from pot
M.DiLandro: doesn't show hand 
*** SUMMARY ***
Total pot $0.25 | Rake $0 
Seat 1: tortpoker folded before Flop (didn't bet)
Seat 2: M.DiLandro collected ($0.25)
Seat 3: xSkokEx (button) folded before Flop (didn't bet)
Seat 4: zebaztravez (small blind) folded before Flop
Seat 6: Hannibal2018 (big blind) folded before Flop



PokerStars Hand #222978870195:  Hold'em No Limit ($0.05/$0.10 USD) - 2021/01/23 18:58:57 ET
Table 'Stephano III' 6-max Seat #4 is the button
Seat 1: tortpoker ($16.70 in chips) 
Seat 2: M.DiLandro ($7.74 in chips) 
Seat 3: xSkokEx ($10.76 in chips) 
Seat 4: zebaztravez ($10.90 in chips) 
Seat 6: Hannibal2018 ($11.96 in chips) 
Hannibal2018: posts small blind $0.05
tortpoker: posts big blind $0.10
*** HOLE CARDS ***
M.DiLandro: calls $0.10
xSkokEx: folds 
zebaztravez: raises $0.30 to $0.40
Hannibal2018: folds 
tortpoker: calls $0.30
M.DiLandro: calls $0.30
*** FLOP *** [3s 5s 7s]
Hannibal2018 leaves the table
tortpoker: checks 
Silv0917 joins the table at seat #6 
M.DiLandro: bets $0.60
zebaztravez: folds 
tortpoker: folds 
Uncalled bet ($0.60) returned to M.DiLandro
M.DiLandro collected $1.19 from pot
M.DiLandro: doesn't show hand 
*** SUMMARY ***
Total pot $1.25 | Rake $0.06 
Board [3s 5s 7s]
Seat 1: tortpoker (big blind) folded on the Flop
Seat 2: M.DiLandro collected ($1.19)
Seat 3: xSkokEx folded before Flop (didn't bet)
Seat 4: zebaztravez (button) folded on the Flop
Seat 6: Hannibal2018 (small blind) folded before Flop



PokerStars Hand #222978884471:  Hold'em No Limit ($0.05/$0.10 USD) - 2021/01/23 18:59:29 ET
Table 'Stephano III' 6-max Seat #1 is the button
Seat 1: tortpoker ($16.30 in chips) 
Seat 2: M.DiLandro ($8.53 in chips) 
Seat 3: xSkokEx ($10.76 in chips) 
Seat 4: zebaztravez ($10.50 in chips) 
Seat 6: Silv0917 ($4 in chips) 
M.DiLandro: posts small blind $0.05
xSkokEx: posts big blind $0.10
Silv0917: posts big blind $0.10
*** HOLE CARDS ***
zebaztravez: folds 
Silv0917: raises $0.20 to $0.30
tortpoker: folds 
M.DiLandro: folds 
xSkokEx: folds 
Uncalled bet ($0.20) returned to Silv0917
Silv0917 collected $0.25 from pot
Silv0917: doesn't show hand 
*** SUMMARY ***
Total pot $0.25 | Rake $0 
Seat 1: tortpoker (button) folded before Flop (didn't bet)
Seat 2: M.DiLandro (small blind) folded before Flop
Seat 3: xSkokEx (big blind) folded before Flop
Seat 4: zebaztravez folded before Flop (didn't bet)
Seat 6: Silv0917 collected ($0.25)



PokerStars Hand #222978893682:  Hold'em No Limit ($0.05/$0.10 USD) - 2021/01/23 18:59:50 ET
Table 'Stephano III' 6-max Seat #2 is the button
Seat 1: tortpoker ($16.30 in chips) 
Seat 2: M.DiLandro ($8.48 in chips) 
Seat 3: xSkokEx ($10.66 in chips) 
Seat 4: zebaztravez ($10.50 in chips) 
Seat 6: Silv0917 ($4.15 in chips) 
xSkokEx: posts small blind $0.05
zebaztravez: posts big blind $0.10
*** HOLE CARDS ***
Silv0917: calls $0.10
tortpoker: folds 
M.DiLandro: folds 
xSkokEx: calls $0.05
zebaztravez: raises $0.40 to $0.50
Silv0917: calls $0.40
xSkokEx: folds 
*** FLOP *** [6s As Th]
zebaztravez: checks 
Silv0917: bets $0.60
zebaztravez: folds 
Uncalled bet ($0.60) returned to Silv0917
Silv0917 collected $1.05 from pot
Silv0917: doesn't show hand 
*** SUMMARY ***
Total pot $1.10 | Rake $0.05 
Board [6s As Th]
Seat 1: tortpoker folded before Flop (didn't bet)
Seat 2: M.DiLandro (button) folded before Flop (didn't bet)
Seat 3: xSkokEx (small blind) folded before Flop
Seat 4: zebaztravez (big blind) folded on the Flop
Seat 6: Silv0917 collected ($1.05)



PokerStars Hand #222978916994:  Hold'em No Limit ($0.05/$0.10 USD) - 2021/01/23 19:00:38 ET
Table 'Stephano III' 6-max Seat #3 is the button
Seat 1: tortpoker ($16.30 in chips) 
Seat 2: M.DiLandro ($8.48 in chips) 
Seat 3: xSkokEx ($10.56 in chips) 
Seat 4: zebaztravez ($10 in chips) 
Seat 5: Mello_Ace ($7.11 in chips) 
Seat 6: Silv0917 ($4.70 in chips) 
zebaztravez: posts small blind $0.05
Mello_Ace: posts big blind $0.10
*** HOLE CARDS ***
Silv0917: folds 
tortpoker: folds 
M.DiLandro: folds 
xSkokEx: raises $0.20 to $0.30
Silv0917 leaves the table
zebaztravez: folds 
Mello_Ace: calls $0.20
*** FLOP *** [Qh Ah Ac]
kätzi<3 joins the table at seat #6 
Mello_Ace: bets $0.31
xSkokEx: calls $0.31
*** TURN *** [Qh Ah Ac] [Qd]
Mello_Ace: checks 
xSkokEx: bets $0.40
Mello_Ace: calls $0.40
*** RIVER *** [Qh Ah Ac Qd] [Td]
Mello_Ace: checks 
xSkokEx: bets $9.55 and is all-in
Mello_Ace: folds 
Uncalled bet ($9.55) returned to xSkokEx
xSkokEx collected $1.98 from pot
xSkokEx: doesn't show hand 
*** SUMMARY ***
Total pot $2.07 | Rake $0.09 
Board [Qh Ah Ac Qd Td]
Seat 1: tortpoker folded before Flop (didn't bet)
Seat 2: M.DiLandro folded before Flop (didn't bet)
Seat 3: xSkokEx (button) collected ($1.98)
Seat 4: zebaztravez (small blind) folded before Flop
Seat 5: Mello_Ace (big blind) folded on the River
Seat 6: Silv0917 folded before Flop (didn't bet)



PokerStars Hand #222978946589:  Hold'em No Limit ($0.05/$0.10 USD) - 2021/01/23 19:01:34 ET
Table 'Stephano III' 6-max Seat #4 is the button
Seat 1: tortpoker ($16.30 in chips) 
Seat 2: M.DiLandro ($8.48 in chips) 
Seat 3: xSkokEx ($11.53 in chips) 
Seat 4: zebaztravez ($10 in chips) 
Seat 5: Mello_Ace ($6.10 in chips) 
Seat 6: kätzi<3 ($8 in chips) 
Mello_Ace: posts small blind $0.05
kätzi<3: posts big blind $0.10
*** HOLE CARDS ***
tortpoker: folds 
M.DiLandro: calls $0.10
xSkokEx: raises $0.30 to $0.40
zebaztravez: folds 
Mello_Ace: folds 
kätzi<3: folds 
M.DiLandro: raises $0.60 to $1
xSkokEx: folds 
Uncalled bet ($0.60) returned to M.DiLandro
M.DiLandro collected $0.95 from pot
M.DiLandro: doesn't show hand 
*** SUMMARY ***
Total pot $0.95 | Rake $0 
Seat 1: tortpoker folded before Flop (didn't bet)
Seat 2: M.DiLandro collected ($0.95)
Seat 3: xSkokEx folded before Flop
Seat 4: zebaztravez (button) folded before Flop (didn't bet)
Seat 5: Mello_Ace (small blind) folded before Flop
Seat 6: kätzi<3 (big blind) folded before Flop



PokerStars Hand #222978956962:  Hold'em No Limit ($0.05/$0.10 USD) - 2021/01/23 19:01:51 ET
Table 'Stephano III' 6-max Seat #5 is the button
Seat 1: tortpoker ($16.30 in chips) 
Seat 2: M.DiLandro ($9.03 in chips) 
Seat 3: xSkokEx ($11.13 in chips) 
Seat 4: zebaztravez ($10 in chips) 
Seat 5: Mello_Ace ($6.05 in chips) 
Seat 6: kätzi<3 ($7.90 in chips) 
kätzi<3: posts small blind $0.05
tortpoker: posts big blind $0.10
*** HOLE CARDS ***
M.DiLandro: folds 
xSkokEx: folds 
zebaztravez: folds 
Mello_Ace: calls $0.10
kätzi<3: folds 
tortpoker: checks 
*** FLOP *** [3c 6d 4d]
tortpoker: bets $0.20
Mello_Ace: calls $0.20
*** TURN *** [3c 6d 4d] [9d]
tortpoker: bets $0.32
Mello_Ace: folds 
Uncalled bet ($0.32) returned to tortpoker
tortpoker collected $0.62 from pot
tortpoker: doesn't show hand 
*** SUMMARY ***
Total pot $0.65 | Rake $0.03 
Board [3c 6d 4d 9d]
Seat 1: tortpoker (big blind) collected ($0.62)
Seat 2: M.DiLandro folded before Flop (didn't bet)
Seat 3: xSkokEx folded before Flop (didn't bet)
Seat 4: zebaztravez folded before Flop (didn't bet)
Seat 5: Mello_Ace (button) folded on the Turn
Seat 6: kätzi<3 (small blind) folded before Flop



PokerStars Hand #222978980706:  Hold'em No Limit ($0.05/$0.10 USD) - 2021/01/23 19:02:32 ET
Table 'Stephano III' 6-max Seat #6 is the button
Seat 1: tortpoker ($16.62 in chips) 
Seat 2: M.DiLandro ($9.03 in chips) 
Seat 3: xSkokEx ($11.13 in chips) 
Seat 4: zebaztravez ($10 in chips) 
Seat 5: Mello_Ace ($5.75 in chips) 
Seat 6: kätzi<3 ($7.85 in chips) 
tortpoker: posts small blind $0.05
M.DiLandro: posts big blind $0.10
*** HOLE CARDS ***
xSkokEx: folds 
zebaztravez: folds 
Mello_Ace: folds 
kätzi<3: raises $0.20 to $0.30
tortpoker: folds 
M.DiLandro: folds 
Uncalled bet ($0.20) returned to kätzi<3
kätzi<3 collected $0.25 from pot
kätzi<3: doesn't show hand 
*** SUMMARY ***
Total pot $0.25 | Rake $0 
Seat 1: tortpoker (small blind) folded before Flop
Seat 2: M.DiLandro (big blind) folded before Flop
Seat 3: xSkokEx folded before Flop (didn't bet)
Seat 4: zebaztravez folded before Flop (didn't bet)
Seat 5: Mello_Ace folded before Flop (didn't bet)
Seat 6: kätzi<3 (button) collected ($0.25)



PokerStars Hand #222978988680:  Hold'em No Limit ($0.05/$0.10 USD) - 2021/01/23 19:02:46 ET
Table 'Stephano III' 6-max Seat #1 is the button
Seat 1: tortpoker ($16.57 in chips) 
Seat 2: M.DiLandro ($8.93 in chips) 
Seat 3: xSkokEx ($11.13 in chips) 
Seat 4: zebaztravez ($10 in chips) 
Seat 5: Mello_Ace ($5.75 in chips) 
Seat 6: kätzi<3 ($8 in chips) 
M.DiLandro: posts small blind $0.05
xSkokEx: posts big blind $0.10
*** HOLE CARDS ***
zebaztravez: folds 
Mello_Ace: folds 
kätzi<3: folds 
tortpoker: folds 
M.DiLandro: calls $0.05
xSkokEx: checks 
*** FLOP *** [9s 5c Ts]
M.DiLandro: checks 
xSkokEx: checks 
*** TURN *** [9s 5c Ts] [Td]
M.DiLandro: checks 
xSkokEx: checks 
*** RIVER *** [9s 5c Ts Td] [Ac]
M.DiLandro: checks 
xSkokEx: checks 
*** SHOW DOWN ***
M.DiLandro: shows [Qd 7d] (a pair of Tens)
xSkokEx: shows [5s 2d] (two pair, Tens and Fives)
xSkokEx collected $0.19 from pot
*** SUMMARY ***
Total pot $0.20 | Rake $0.01 
Board [9s 5c Ts Td Ac]
Seat 1: tortpoker (button) folded before Flop (didn't bet)
Seat 2: M.DiLandro (small blind) showed [Qd 7d] and lost with a pair of Tens
Seat 3: xSkokEx (big blind) showed [5s 2d] and won ($0.19) with two pair, Tens and Fives
Seat 4: zebaztravez folded before Flop (didn't bet)
Seat 5: Mello_Ace folded before Flop (didn't bet)
Seat 6: kätzi<3 folded before Flop (didn't bet)



PokerStars Hand #222979016273:  Hold'em No Limit ($0.05/$0.10 USD) - 2021/01/23 19:03:34 ET
Table 'Stephano III' 6-max Seat #2 is the button
Seat 1: tortpoker ($16.57 in chips) 
Seat 2: M.DiLandro ($8.83 in chips) 
Seat 3: xSkokEx ($11.22 in chips) 
Seat 4: zebaztravez ($10 in chips) 
Seat 5: Mello_Ace ($5.75 in chips) 
Seat 6: kätzi<3 ($8 in chips) 
xSkokEx: posts small blind $0.05
zebaztravez: posts big blind $0.10
*** HOLE CARDS ***
Mello_Ace: raises $0.10 to $0.20
kätzi<3: raises $0.10 to $0.30
tortpoker: calls $0.30
M.DiLandro: calls $0.30
xSkokEx: folds 
zebaztravez: calls $0.20
Mello_Ace: calls $0.10
*** FLOP *** [7c 2c 6c]
zebaztravez: checks 
Mello_Ace: checks 
kätzi<3: checks 
tortpoker: checks 
M.DiLandro: checks 
*** TURN *** [7c 2c 6c] [Qc]
zebaztravez: checks 
Mello_Ace: bets $0.74
kätzi<3: folds 
tortpoker: folds 
M.DiLandro: folds 
zebaztravez: folds 
Uncalled bet ($0.74) returned to Mello_Ace
Mello_Ace collected $1.48 from pot
Mello_Ace: doesn't show hand 
*** SUMMARY ***
Total pot $1.55 | Rake $0.07 
Board [7c 2c 6c Qc]
Seat 1: tortpoker folded on the Turn
Seat 2: M.DiLandro (button) folded on the Turn
Seat 3: xSkokEx (small blind) folded before Flop
Seat 4: zebaztravez (big blind) folded on the Turn
Seat 5: Mello_Ace collected ($1.48)
Seat 6: kätzi<3 folded on the Turn



PokerStars Hand #222979046449:  Hold'em No Limit ($0.05/$0.10 USD) - 2021/01/23 19:04:26 ET
Table 'Stephano III' 6-max Seat #3 is the button
Seat 1: tortpoker ($16.27 in chips) 
Seat 2: M.DiLandro ($8.53 in chips) 
Seat 3: xSkokEx ($11.17 in chips) 
Seat 4: zebaztravez ($10 in chips) 
Seat 5: Mello_Ace ($6.93 in chips) 
Seat 6: kätzi<3 ($7.70 in chips) 
zebaztravez: posts small blind $0.05
Mello_Ace: posts big blind $0.10
*** HOLE CARDS ***
kätzi<3: folds 
tortpoker: folds 
M.DiLandro: folds 
xSkokEx: raises $0.15 to $0.25
zebaztravez: folds 
Mello_Ace: calls $0.15
*** FLOP *** [6d Jc 2h]
Mello_Ace: checks 
xSkokEx: checks 
*** TURN *** [6d Jc 2h] [8s]
Mello_Ace: bets $0.10
xSkokEx: folds 
Uncalled bet ($0.10) returned to Mello_Ace
Mello_Ace collected $0.53 from pot
Mello_Ace: doesn't show hand 
*** SUMMARY ***
Total pot $0.55 | Rake $0.02 
Board [6d Jc 2h 8s]
Seat 1: tortpoker folded before Flop (didn't bet)
Seat 2: M.DiLandro folded before Flop (didn't bet)
Seat 3: xSkokEx (button) folded on the Turn
Seat 4: zebaztravez (small blind) folded before Flop
Seat 5: Mello_Ace (big blind) collected ($0.53)
Seat 6: kätzi<3 folded before Flop (didn't bet)



PokerStars Hand #222979062366:  Hold'em No Limit ($0.05/$0.10 USD) - 2021/01/23 19:04:53 ET
Table 'Stephano III' 6-max Seat #4 is the button
Seat 1: tortpoker ($16.27 in chips) 
Seat 2: M.DiLandro ($8.53 in chips) 
Seat 3: xSkokEx ($10.92 in chips) 
Seat 4: zebaztravez ($10 in chips) 
Seat 5: Mello_Ace ($7.21 in chips) 
Seat 6: kätzi<3 ($7.70 in chips) 
Mello_Ace: posts small blind $0.05
kätzi<3: posts big blind $0.10
*** HOLE CARDS ***
tortpoker: raises $0.20 to $0.30
M.DiLandro: folds 
xSkokEx: folds 
zebaztravez: folds 
Mello_Ace: calls $0.25
kätzi<3: folds 
*** FLOP *** [4s 4c Ac]
Mello_Ace: checks 
tortpoker: bets $0.54
Mello_Ace: calls $0.54
*** TURN *** [4s 4c Ac] [Kh]
Mello_Ace: bets $0.85
tortpoker: raises $1.73 to $2.58
Mello_Ace: calls $1.73
*** RIVER *** [4s 4c Ac Kh] [9h]
Mello_Ace: checks 
tortpoker: bets $3.80
Mello_Ace: folds 
Uncalled bet ($3.80) returned to tortpoker
tortpoker collected $6.63 from pot
tortpoker: doesn't show hand 
*** SUMMARY ***
Total pot $6.94 | Rake $0.31 
Board [4s 4c Ac Kh 9h]
Seat 1: tortpoker collected ($6.63)
Seat 2: M.DiLandro folded before Flop (didn't bet)
Seat 3: xSkokEx folded before Flop (didn't bet)
Seat 4: zebaztravez (button) folded before Flop (didn't bet)
Seat 5: Mello_Ace (small blind) folded on the River
Seat 6: kätzi<3 (big blind) folded before Flop



PokerStars Hand #222979098037:  Hold'em No Limit ($0.05/$0.10 USD) - 2021/01/23 19:05:42 ET
Table 'Stephano III' 6-max Seat #5 is the button
Seat 1: tortpoker ($19.48 in chips) 
Seat 2: M.DiLandro ($8.53 in chips) 
Seat 3: xSkokEx ($10.92 in chips) 
Seat 4: zebaztravez ($10 in chips) 
Seat 5: Mello_Ace ($3.79 in chips) 
Seat 6: kätzi<3 ($7.60 in chips) 
kätzi<3: posts small blind $0.05
tortpoker: posts big blind $0.10
*** HOLE CARDS ***
M.DiLandro: folds 
xSkokEx: folds 
zebaztravez: folds 
Mello_Ace: folds 
kätzi<3: raises $0.20 to $0.30
tortpoker: calls $0.20
*** FLOP *** [9d 9s 3d]
kätzi<3: bets $0.30
tortpoker: folds 
Uncalled bet ($0.30) returned to kätzi<3
kätzi<3 collected $0.57 from pot
kätzi<3: doesn't show hand 
*** SUMMARY ***
Total pot $0.60 | Rake $0.03 
Board [9d 9s 3d]
Seat 1: tortpoker (big blind) folded on the Flop
Seat 2: M.DiLandro folded before Flop (didn't bet)
Seat 3: xSkokEx folded before Flop (didn't bet)
Seat 4: zebaztravez folded before Flop (didn't bet)
Seat 5: Mello_Ace (button) folded before Flop (didn't bet)
Seat 6: kätzi<3 (small blind) collected ($0.57)



PokerStars Hand #222979115322:  Hold'em No Limit ($0.05/$0.10 USD) - 2021/01/23 19:06:12 ET
Table 'Stephano III' 6-max Seat #6 is the button
Seat 1: tortpoker ($19.18 in chips) 
Seat 2: M.DiLandro ($8.53 in chips) 
Seat 3: xSkokEx ($10.92 in chips) 
Seat 4: zebaztravez ($10 in chips) 
Seat 5: Mello_Ace ($3.79 in chips) 
Seat 6: kätzi<3 ($7.87 in chips) 
tortpoker: posts small blind $0.05
M.DiLandro: posts big blind $0.10
*** HOLE CARDS ***
xSkokEx: raises $0.15 to $0.25
zebaztravez: folds 
Mello_Ace: calls $0.25
kätzi<3: folds 
tortpoker: folds 
M.DiLandro: calls $0.15
*** FLOP *** [8s 5d 7d]
M.DiLandro: checks 
xSkokEx: checks 
Mello_Ace: bets $0.38
M.DiLandro: folds 
xSkokEx: folds 
Uncalled bet ($0.38) returned to Mello_Ace
Mello_Ace collected $0.76 from pot
Mello_Ace: doesn't show hand 
*** SUMMARY ***
Total pot $0.80 | Rake $0.04 
Board [8s 5d 7d]
Seat 1: tortpoker (small blind) folded before Flop
Seat 2: M.DiLandro (big blind) folded on the Flop
Seat 3: xSkokEx folded on the Flop
Seat 4: zebaztravez folded before Flop (didn't bet)
Seat 5: Mello_Ace collected ($0.76)
Seat 6: kätzi<3 (button) folded before Flop (didn't bet)



PokerStars Hand #222979135090:  Hold'em No Limit ($0.05/$0.10 USD) - 2021/01/23 19:06:46 ET
Table 'Stephano III' 6-max Seat #1 is the button
Seat 1: tortpoker ($19.13 in chips) 
Seat 2: M.DiLandro ($8.28 in chips) 
Seat 3: xSkokEx ($10.67 in chips) 
Seat 4: zebaztravez ($10 in chips) 
Seat 5: Mello_Ace ($4.30 in chips) 
Seat 6: kätzi<3 ($7.87 in chips) 
M.DiLandro: posts small blind $0.05
xSkokEx: posts big blind $0.10
*** HOLE CARDS ***
zebaztravez: raises $0.20 to $0.30
Mello_Ace: folds 
kätzi<3: folds 
tortpoker: folds 
M.DiLandro: folds 
xSkokEx: folds 
Uncalled bet ($0.20) returned to zebaztravez
zebaztravez collected $0.25 from pot
zebaztravez: doesn't show hand 
*** SUMMARY ***
Total pot $0.25 | Rake $0 
Seat 1: tortpoker (button) folded before Flop (didn't bet)
Seat 2: M.DiLandro (small blind) folded before Flop
Seat 3: xSkokEx (big blind) folded before Flop
Seat 4: zebaztravez collected ($0.25)
Seat 5: Mello_Ace folded before Flop (didn't bet)
Seat 6: kätzi<3 folded before Flop (didn't bet)



PokerStars Hand #222979146801:  Hold'em No Limit ($0.05/$0.10 USD) - 2021/01/23 19:07:06 ET
Table 'Stephano III' 6-max Seat #2 is the button
Seat 1: tortpoker ($19.13 in chips) 
Seat 2: M.DiLandro ($8.23 in chips) 
Seat 3: xSkokEx ($10.57 in chips) 
Seat 4: zebaztravez ($10.15 in chips) 
Seat 5: Mello_Ace ($4.30 in chips) 
Seat 6: kätzi<3 ($7.87 in chips) 
xSkokEx: posts small blind $0.05
zebaztravez: posts big blind $0.10
*** HOLE CARDS ***
Mello_Ace: folds 
kätzi<3: folds 
tortpoker: folds 
M.DiLandro: raises $0.20 to $0.30
xSkokEx: folds 
zebaztravez: folds 
Uncalled bet ($0.20) returned to M.DiLandro
M.DiLandro collected $0.25 from pot
M.DiLandro: doesn't show hand 
*** SUMMARY ***
Total pot $0.25 | Rake $0 
Seat 1: tortpoker folded before Flop (didn't bet)
Seat 2: M.DiLandro (button) collected ($0.25)
Seat 3: xSkokEx (small blind) folded before Flop
Seat 4: zebaztravez (big blind) folded before Flop
Seat 5: Mello_Ace folded before Flop (didn't bet)
Seat 6: kätzi<3 folded before Flop (didn't bet)



PokerStars Hand #222979170641:  Hold'em No Limit ($0.05/$0.10 USD) - 2021/01/23 19:07:31 ET
Table 'Stephano III' 6-max Seat #3 is the button
Seat 1: tortpoker ($19.13 in chips) 
Seat 2: M.DiLandro ($8.38 in chips) 
Seat 3: xSkokEx ($10.52 in chips) 
Seat 4: zebaztravez ($10.05 in chips) 
Seat 5: Mello_Ace ($4.30 in chips) 
Seat 6: kätzi<3 ($7.87 in chips) 
zebaztravez: posts small blind $0.05
Mello_Ace: posts big blind $0.10
*** HOLE CARDS ***
kätzi<3: folds 
tortpoker: folds 
M.DiLandro: raises $0.20 to $0.30
xSkokEx: calls $0.30
zebaztravez: folds 
Mello_Ace: calls $0.20
*** FLOP *** [5d 4c 9d]
Mello_Ace: checks 
M.DiLandro: checks 
xSkokEx: checks 
*** TURN *** [5d 4c 9d] [Kh]
Mello_Ace: checks 
M.DiLandro: bets $0.46
xSkokEx is disconnected 
xSkokEx is connected 
xSkokEx: folds 
Mello_Ace: calls $0.46
*** RIVER *** [5d 4c 9d Kh] [Qc]
Mello_Ace: bets $0.10
M.DiLandro: calls $0.10
*** SHOW DOWN ***
Mello_Ace: shows [Kc Td] (a pair of Kings)
M.DiLandro: mucks hand 
Mello_Ace collected $1.98 from pot
*** SUMMARY ***
Total pot $2.07 | Rake $0.09 
Board [5d 4c 9d Kh Qc]
Seat 1: tortpoker folded before Flop (didn't bet)
Seat 2: M.DiLandro mucked
Seat 3: xSkokEx (button) folded on the Turn
Seat 4: zebaztravez (small blind) folded before Flop
Seat 5: Mello_Ace (big blind) showed [Kc Td] and won ($1.98) with a pair of Kings
Seat 6: kätzi<3 folded before Flop (didn't bet)



PokerStars Hand #222979242337:  Hold'em No Limit ($0.05/$0.10 USD) - 2021/01/23 19:09:39 ET
Table 'Stephano III' 6-max Seat #4 is the button
Seat 1: tortpoker ($19.13 in chips) 
Seat 2: M.DiLandro ($7.52 in chips) 
Seat 3: xSkokEx ($10.22 in chips) 
Seat 4: zebaztravez ($10 in chips) 
Seat 5: Mello_Ace ($5.42 in chips) 
Seat 6: kätzi<3 ($7.87 in chips) 
Mello_Ace: posts small blind $0.05
kätzi<3: posts big blind $0.10
*** HOLE CARDS ***
tortpoker: folds 
M.DiLandro: folds 
xSkokEx: folds 
zebaztravez: raises $0.16 to $0.26
Mello_Ace: folds 
kätzi<3: calls $0.16
*** FLOP *** [Ts Qd 8s]
kätzi<3: bets $0.30
zebaztravez: folds 
Uncalled bet ($0.30) returned to kätzi<3
kätzi<3 collected $0.54 from pot
kätzi<3: doesn't show hand 
*** SUMMARY ***
Total pot $0.57 | Rake $0.03 
Board [Ts Qd 8s]
Seat 1: tortpoker folded before Flop (didn't bet)
Seat 2: M.DiLandro folded before Flop (didn't bet)
Seat 3: xSkokEx folded before Flop (didn't bet)
Seat 4: zebaztravez (button) folded on the Flop
Seat 5: Mello_Ace (small blind) folded before Flop
Seat 6: kätzi<3 (big blind) collected ($0.54)



PokerStars Hand #222979266424:  Hold'em No Limit ($0.05/$0.10 USD) - 2021/01/23 19:10:22 ET
Table 'Stephano III' 6-max Seat #6 is the button
Seat 1: tortpoker ($19.13 in chips) 
Seat 2: M.DiLandro ($7.52 in chips) 
Seat 3: xSkokEx ($10.22 in chips) 
Seat 4: zebaztravez ($10 in chips) 
Seat 6: kätzi<3 ($8.15 in chips) 
tortpoker: posts small blind $0.05
M.DiLandro: posts big blind $0.10
*** HOLE CARDS ***
xSkokEx: folds 
zebaztravez: folds 
kätzi<3: folds 
tortpoker: raises $0.20 to $0.30
M.DiLandro: calls $0.20
*** FLOP *** [3h 3s Qh]
tortpoker: bets $0.19
M.DiLandro: folds 
Uncalled bet ($0.19) returned to tortpoker
tortpoker collected $0.57 from pot
tortpoker: doesn't show hand 
*** SUMMARY ***
Total pot $0.60 | Rake $0.03 
Board [3h 3s Qh]
Seat 1: tortpoker (small blind) collected ($0.57)
Seat 2: M.DiLandro (big blind) folded on the Flop
Seat 3: xSkokEx folded before Flop (didn't bet)
Seat 4: zebaztravez folded before Flop (didn't bet)
Seat 6: kätzi<3 (button) folded before Flop (didn't bet)



PokerStars Hand #222979285634:  Hold'em No Limit ($0.05/$0.10 USD) - 2021/01/23 19:10:56 ET
Table 'Stephano III' 6-max Seat #1 is the button
Seat 1: tortpoker ($19.40 in chips) 
Seat 2: M.DiLandro ($7.22 in chips) 
Seat 3: xSkokEx ($10.22 in chips) 
Seat 4: zebaztravez ($10 in chips) 
Seat 6: kätzi<3 ($8.15 in chips) 
M.DiLandro: posts small blind $0.05
xSkokEx: posts big blind $0.10
*** HOLE CARDS ***
zebaztravez: folds 
kätzi<3: folds 
tortpoker: folds 
M.DiLandro: folds 
Uncalled bet ($0.05) returned to xSkokEx
xSkokEx collected $0.10 from pot
xSkokEx: doesn't show hand 
*** SUMMARY ***
Total pot $0.10 | Rake $0 
Seat 1: tortpoker (button) folded before Flop (didn't bet)
Seat 2: M.DiLandro (small blind) folded before Flop
Seat 3: xSkokEx (big blind) collected ($0.10)
Seat 4: zebaztravez folded before Flop (didn't bet)
Seat 6: kätzi<3 folded before Flop (didn't bet)



PokerStars Hand #222979291335:  Hold'em No Limit ($0.05/$0.10 USD) - 2021/01/23 19:11:06 ET
Table 'Stephano III' 6-max Seat #2 is the button
Seat 1: tortpoker ($19.40 in chips) 
Seat 2: M.DiLandro ($7.17 in chips) 
Seat 3: xSkokEx ($10.27 in chips) 
Seat 4: zebaztravez ($10 in chips) 
Seat 6: kätzi<3 ($8.15 in chips) 
xSkokEx: posts small blind $0.05
zebaztravez: posts big blind $0.10
*** HOLE CARDS ***
kätzi<3: folds 
tortpoker: folds 
M.DiLandro: raises $0.20 to $0.30
xSkokEx: folds 
zebaztravez: calls $0.20
*** FLOP *** [9h As Ad]
zebaztravez: checks 
M.DiLandro: checks 
*** TURN *** [9h As Ad] [Qd]
zebaztravez: checks 
M.DiLandro: bets $0.40
zebaztravez: folds 
Uncalled bet ($0.40) returned to M.DiLandro
M.DiLandro collected $0.62 from pot
M.DiLandro: doesn't show hand 
*** SUMMARY ***
Total pot $0.65 | Rake $0.03 
Board [9h As Ad Qd]
Seat 1: tortpoker folded before Flop (didn't bet)
Seat 2: M.DiLandro (button) collected ($0.62)
Seat 3: xSkokEx (small blind) folded before Flop
Seat 4: zebaztravez (big blind) folded on the Turn
Seat 6: kätzi<3 folded before Flop (didn't bet)



PokerStars Hand #222979317338:  Hold'em No Limit ($0.05/$0.10 USD) - 2021/01/23 19:11:52 ET
Table 'Stephano III' 6-max Seat #3 is the button
Seat 1: tortpoker ($19.40 in chips) 
Seat 2: M.DiLandro ($7.49 in chips) 
Seat 3: xSkokEx ($10.22 in chips) 
Seat 4: zebaztravez ($10 in chips) 
Seat 5: Mello_Ace ($5.37 in chips) 
Seat 6: kätzi<3 ($8.15 in chips) 
zebaztravez: posts small blind $0.05
Mello_Ace: posts big blind $0.10
*** HOLE CARDS ***
kätzi<3: raises $0.20 to $0.30
tortpoker: folds 
M.DiLandro: folds 
xSkokEx: folds 
zebaztravez: folds 
Mello_Ace: calls $0.20
*** FLOP *** [4s Jc Kd]
Mello_Ace: bets $0.31
kätzi<3: raises $0.31 to $0.62
Mello_Ace: folds 
Uncalled bet ($0.31) returned to kätzi<3
kätzi<3 collected $1.21 from pot
kätzi<3: doesn't show hand 
*** SUMMARY ***
Total pot $1.27 | Rake $0.06 
Board [4s Jc Kd]
Seat 1: tortpoker folded before Flop (didn't bet)
Seat 2: M.DiLandro folded before Flop (didn't bet)
Seat 3: xSkokEx (button) folded before Flop (didn't bet)
Seat 4: zebaztravez (small blind) folded before Flop
Seat 5: Mello_Ace (big blind) folded on the Flop
Seat 6: kätzi<3 collected ($1.21)



PokerStars Hand #222979349285:  Hold'em No Limit ($0.05/$0.10 USD) - 2021/01/23 19:12:49 ET
Table 'Stephano III' 6-max Seat #4 is the button
Seat 1: tortpoker ($19.40 in chips) 
Seat 2: M.DiLandro ($7.49 in chips) 
Seat 3: xSkokEx ($10.22 in chips) 
Seat 4: zebaztravez ($10 in chips) 
Seat 5: Mello_Ace ($4.76 in chips) 
Seat 6: kätzi<3 ($8.75 in chips) 
Mello_Ace: posts small blind $0.05
kätzi<3: posts big blind $0.10
*** HOLE CARDS ***
tortpoker: folds 
M.DiLandro: raises $0.20 to $0.30
xSkokEx: folds 
zebaztravez: raises $0.60 to $0.90
Mello_Ace: folds 
kätzi<3: folds 
M.DiLandro: calls $0.60
*** FLOP *** [2h 5s 7s]
M.DiLandro: checks 
zebaztravez: checks 
*** TURN *** [2h 5s 7s] [3s]
M.DiLandro: checks 
zebaztravez: checks 
*** RIVER *** [2h 5s 7s 3s] [9s]
M.DiLandro: checks 
zebaztravez: checks 
*** SHOW DOWN ***
M.DiLandro: shows [Js Qs] (a flush, Queen high)
zebaztravez: mucks hand 
M.DiLandro collected $1.86 from pot
*** SUMMARY ***
Total pot $1.95 | Rake $0.09 
Board [2h 5s 7s 3s 9s]
Seat 1: tortpoker folded before Flop (didn't bet)
Seat 2: M.DiLandro showed [Js Qs] and won ($1.86) with a flush, Queen high
Seat 3: xSkokEx folded before Flop (didn't bet)
Seat 4: zebaztravez (button) mucked
Seat 5: Mello_Ace (small blind) folded before Flop
Seat 6: kätzi<3 (big blind) folded before Flop



PokerStars Hand #222979394599:  Hold'em No Limit ($0.05/$0.10 USD) - 2021/01/23 19:14:11 ET
Table 'Stephano III' 6-max Seat #5 is the button
Seat 1: tortpoker ($19.40 in chips) 
Seat 2: M.DiLandro ($8.45 in chips) 
Seat 3: xSkokEx ($10.22 in chips) 
Seat 4: zebaztravez ($10 in chips) 
Seat 5: Mello_Ace ($4.71 in chips) 
Seat 6: kätzi<3 ($8.65 in chips) 
kätzi<3: posts small blind $0.05
tortpoker: posts big blind $0.10
*** HOLE CARDS ***
M.DiLandro: folds 
xSkokEx: raises $0.15 to $0.25
zebaztravez: folds 
Mello_Ace: calls $0.25
kätzi<3: folds 
tortpoker: calls $0.15
*** FLOP *** [7h As Ah]
tortpoker: checks 
xSkokEx: bets $0.25
Mello_Ace: folds 
tortpoker: folds 
Uncalled bet ($0.25) returned to xSkokEx
xSkokEx collected $0.76 from pot
xSkokEx: doesn't show hand 
*** SUMMARY ***
Total pot $0.80 | Rake $0.04 
Board [7h As Ah]
Seat 1: tortpoker (big blind) folded on the Flop
Seat 2: M.DiLandro folded before Flop (didn't bet)
Seat 3: xSkokEx collected ($0.76)
Seat 4: zebaztravez folded before Flop (didn't bet)
Seat 5: Mello_Ace (button) folded on the Flop
Seat 6: kätzi<3 (small blind) folded before Flop



PokerStars Hand #222979414679:  Hold'em No Limit ($0.05/$0.10 USD) - 2021/01/23 19:14:48 ET
Table 'Stephano III' 6-max Seat #6 is the button
Seat 1: tortpoker ($19.15 in chips) 
Seat 2: M.DiLandro ($8.45 in chips) 
Seat 3: xSkokEx ($10.73 in chips) 
Seat 4: zebaztravez ($10 in chips) 
Seat 5: Mello_Ace ($4.46 in chips) 
Seat 6: kätzi<3 ($8.60 in chips) 
tortpoker: posts small blind $0.05
M.DiLandro: posts big blind $0.10
*** HOLE CARDS ***
xSkokEx: folds 
zebaztravez: raises $0.20 to $0.30
Mello_Ace: folds 
kätzi<3: folds 
tortpoker: folds 
M.DiLandro: folds 
Uncalled bet ($0.20) returned to zebaztravez
zebaztravez collected $0.25 from pot
zebaztravez: doesn't show hand 
*** SUMMARY ***
Total pot $0.25 | Rake $0 
Seat 1: tortpoker (small blind) folded before Flop
Seat 2: M.DiLandro (big blind) folded before Flop
Seat 3: xSkokEx folded before Flop (didn't bet)
Seat 4: zebaztravez collected ($0.25)
Seat 5: Mello_Ace folded before Flop (didn't bet)
Seat 6: kätzi<3 (button) folded before Flop (didn't bet)



PokerStars Hand #222979428465:  Hold'em No Limit ($0.05/$0.10 USD) - 2021/01/23 19:15:13 ET
Table 'Stephano III' 6-max Seat #1 is the button
Seat 1: tortpoker ($19.10 in chips) 
Seat 2: M.DiLandro ($8.35 in chips) 
Seat 3: xSkokEx ($10.73 in chips) 
Seat 4: zebaztravez ($10.15 in chips) 
Seat 5: Mello_Ace ($4.46 in chips) 
Seat 6: kätzi<3 ($8.60 in chips) 
M.DiLandro: posts small blind $0.05
xSkokEx: posts big blind $0.10
*** HOLE CARDS ***
zebaztravez: folds 
Mello_Ace: folds 
kätzi<3: raises $0.20 to $0.30
tortpoker: folds 
M.DiLandro: folds 
xSkokEx: folds 
Uncalled bet ($0.20) returned to kätzi<3
kätzi<3 collected $0.25 from pot
kätzi<3: doesn't show hand 
*** SUMMARY ***
Total pot $0.25 | Rake $0 
Seat 1: tortpoker (button) folded before Flop (didn't bet)
Seat 2: M.DiLandro (small blind) folded before Flop
Seat 3: xSkokEx (big blind) folded before Flop
Seat 4: zebaztravez folded before Flop (didn't bet)
Seat 5: Mello_Ace folded before Flop (didn't bet)
Seat 6: kätzi<3 collected ($0.25)



PokerStars Hand #222979442903:  Hold'em No Limit ($0.05/$0.10 USD) - 2021/01/23 19:15:39 ET
Table 'Stephano III' 6-max Seat #2 is the button
Seat 1: tortpoker ($19.10 in chips) 
Seat 2: M.DiLandro ($8.30 in chips) 
Seat 3: xSkokEx ($10.63 in chips) 
Seat 4: zebaztravez ($10.15 in chips) 
Seat 5: Mello_Ace ($4.46 in chips) 
Seat 6: kätzi<3 ($8.75 in chips) 
xSkokEx: posts small blind $0.05
zebaztravez: posts big blind $0.10
*** HOLE CARDS ***
Mello_Ace: folds 
kätzi<3: folds 
tortpoker: folds 
M.DiLandro: folds 
xSkokEx: folds 
Uncalled bet ($0.05) returned to zebaztravez
zebaztravez collected $0.10 from pot
zebaztravez: doesn't show hand 
*** SUMMARY ***
Total pot $0.10 | Rake $0 
Seat 1: tortpoker folded before Flop (didn't bet)
Seat 2: M.DiLandro (button) folded before Flop (didn't bet)
Seat 3: xSkokEx (small blind) folded before Flop
Seat 4: zebaztravez (big blind) collected ($0.10)
Seat 5: Mello_Ace folded before Flop (didn't bet)
Seat 6: kätzi<3 folded before Flop (didn't bet)



PokerStars Hand #222979452177:  Hold'em No Limit ($0.05/$0.10 USD) - 2021/01/23 19:15:56 ET
Table 'Stephano III' 6-max Seat #3 is the button
Seat 1: tortpoker ($19.10 in chips) 
Seat 2: M.DiLandro ($8.30 in chips) 
Seat 3: xSkokEx ($10.58 in chips) 
Seat 4: zebaztravez ($10.20 in chips) 
Seat 5: Mello_Ace ($4.46 in chips) 
Seat 6: kätzi<3 ($8.75 in chips) 
zebaztravez: posts small blind $0.05
Mello_Ace: posts big blind $0.10
*** HOLE CARDS ***
kätzi<3: raises $0.20 to $0.30
tortpoker: folds 
M.DiLandro: raises $0.60 to $0.90
xSkokEx: folds 
zebaztravez: folds 
Mello_Ace: folds 
kätzi<3: folds 
Uncalled bet ($0.60) returned to M.DiLandro
M.DiLandro collected $0.75 from pot
M.DiLandro: doesn't show hand 
*** SUMMARY ***
Total pot $0.75 | Rake $0 
Seat 1: tortpoker folded before Flop (didn't bet)
Seat 2: M.DiLandro collected ($0.75)
Seat 3: xSkokEx (button) folded before Flop (didn't bet)
Seat 4: zebaztravez (small blind) folded before Flop
Seat 5: Mello_Ace (big blind) folded before Flop
Seat 6: kätzi<3 folded before Flop



PokerStars Hand #222979469404:  Hold'em No Limit ($0.05/$0.10 USD) - 2021/01/23 19:16:27 ET
Table 'Stephano III' 6-max Seat #4 is the button
Seat 1: tortpoker ($19.10 in chips) 
Seat 2: M.DiLandro ($8.75 in chips) 
Seat 3: xSkokEx ($10.58 in chips) 
Seat 4: zebaztravez ($10.15 in chips) 
Seat 5: Mello_Ace ($4.36 in chips) 
Seat 6: kätzi<3 ($8.45 in chips) 
Mello_Ace: posts small blind $0.05
kätzi<3: posts big blind $0.10
*** HOLE CARDS ***
tortpoker: folds 
M.DiLandro: folds 
xSkokEx: folds 
zebaztravez: folds 
Mello_Ace: calls $0.05
kätzi<3: checks 
*** FLOP *** [7h 3d 6s]
Mello_Ace: bets $0.10
kätzi<3: calls $0.10
*** TURN *** [7h 3d 6s] [7c]
Mello_Ace: bets $0.10
kätzi<3: raises $0.20 to $0.30
Mello_Ace: folds 
Uncalled bet ($0.20) returned to kätzi<3
kätzi<3 collected $0.57 from pot
kätzi<3: doesn't show hand 
*** SUMMARY ***
Total pot $0.60 | Rake $0.03 
Board [7h 3d 6s 7c]
Seat 1: tortpoker folded before Flop (didn't bet)
Seat 2: M.DiLandro folded before Flop (didn't bet)
Seat 3: xSkokEx folded before Flop (didn't bet)
Seat 4: zebaztravez (button) folded before Flop (didn't bet)
Seat 5: Mello_Ace (small blind) folded on the Turn
Seat 6: kätzi<3 (big blind) collected ($0.57)



PokerStars Hand #222979492962:  Hold'em No Limit ($0.05/$0.10 USD) - 2021/01/23 19:17:10 ET
Table 'Stephano III' 6-max Seat #5 is the button
Seat 1: tortpoker ($19.10 in chips) 
Seat 2: M.DiLandro ($8.75 in chips) 
Seat 3: xSkokEx ($10.58 in chips) 
Seat 4: zebaztravez ($10.15 in chips) 
Seat 5: Mello_Ace ($4.06 in chips) 
Seat 6: kätzi<3 ($8.72 in chips) 
kätzi<3: posts small blind $0.05
tortpoker: posts big blind $0.10
*** HOLE CARDS ***
M.DiLandro: folds 
xSkokEx: folds 
zebaztravez: folds 
Mello_Ace: calls $0.10
kätzi<3: calls $0.05
tortpoker: checks 
*** FLOP *** [Kd 8d Jd]
kätzi<3: bets $0.29
tortpoker: folds 
Mello_Ace: folds 
Uncalled bet ($0.29) returned to kätzi<3
kätzi<3 collected $0.29 from pot
kätzi<3: doesn't show hand 
*** SUMMARY ***
Total pot $0.30 | Rake $0.01 
Board [Kd 8d Jd]
Seat 1: tortpoker (big blind) folded on the Flop
Seat 2: M.DiLandro folded before Flop (didn't bet)
Seat 3: xSkokEx folded before Flop (didn't bet)
Seat 4: zebaztravez folded before Flop (didn't bet)
Seat 5: Mello_Ace (button) folded on the Flop
Seat 6: kätzi<3 (small blind) collected ($0.29)



PokerStars Hand #222979514543:  Hold'em No Limit ($0.05/$0.10 USD) - 2021/01/23 19:17:50 ET
Table 'Stephano III' 6-max Seat #6 is the button
Seat 1: tortpoker ($19 in chips) 
Seat 2: M.DiLandro ($8.75 in chips) 
Seat 3: xSkokEx ($10.58 in chips) 
Seat 4: zebaztravez ($10.15 in chips) 
Seat 5: Mello_Ace ($3.96 in chips) 
Seat 6: kätzi<3 ($8.91 in chips) 
tortpoker: posts small blind $0.05
M.DiLandro: posts big blind $0.10
*** HOLE CARDS ***
xSkokEx: raises $0.15 to $0.25
zebaztravez: folds 
Mello_Ace: folds 
kätzi<3: folds 
tortpoker: folds 
M.DiLandro: folds 
Uncalled bet ($0.15) returned to xSkokEx
xSkokEx collected $0.25 from pot
xSkokEx: doesn't show hand 
*** SUMMARY ***
Total pot $0.25 | Rake $0 
Seat 1: tortpoker (small blind) folded before Flop
Seat 2: M.DiLandro (big blind) folded before Flop
Seat 3: xSkokEx collected ($0.25)
Seat 4: zebaztravez folded before Flop (didn't bet)
Seat 5: Mello_Ace folded before Flop (didn't bet)
Seat 6: kätzi<3 (button) folded before Flop (didn't bet)



PokerStars Hand #222979524390:  Hold'em No Limit ($0.05/$0.10 USD) - 2021/01/23 19:18:08 ET
Table 'Stephano III' 6-max Seat #1 is the button
Seat 1: tortpoker ($18.95 in chips) 
Seat 2: M.DiLandro ($8.65 in chips) 
Seat 3: xSkokEx ($10.73 in chips) 
Seat 4: zebaztravez ($10.15 in chips) 
Seat 5: Mello_Ace ($3.96 in chips) 
Seat 6: kätzi<3 ($8.91 in chips) 
M.DiLandro: posts small blind $0.05
xSkokEx: posts big blind $0.10
*** HOLE CARDS ***
zebaztravez: raises $0.20 to $0.30
Mello_Ace: calls $0.30
kätzi<3: folds 
tortpoker: folds 
M.DiLandro: folds 
xSkokEx: folds 
*** FLOP *** [Tc 2s 9s]
zebaztravez: bets $0.22
Mello_Ace: calls $0.22
*** TURN *** [Tc 2s 9s] [5c]
zebaztravez: bets $1.10
Mello_Ace: calls $1.10
*** RIVER *** [Tc 2s 9s 5c] [Ah]
zebaztravez: bets $2.43
Mello_Ace: folds 
Uncalled bet ($2.43) returned to zebaztravez
zebaztravez collected $3.24 from pot
zebaztravez: doesn't show hand 
*** SUMMARY ***
Total pot $3.39 | Rake $0.15 
Board [Tc 2s 9s 5c Ah]
Seat 1: tortpoker (button) folded before Flop (didn't bet)
Seat 2: M.DiLandro (small blind) folded before Flop
Seat 3: xSkokEx (big blind) folded before Flop
Seat 4: zebaztravez collected ($3.24)
Seat 5: Mello_Ace folded on the River
Seat 6: kätzi<3 folded before Flop (didn't bet)



PokerStars Hand #222979551770:  Hold'em No Limit ($0.05/$0.10 USD) - 2021/01/23 19:18:59 ET
Table 'Stephano III' 6-max Seat #2 is the button
Seat 1: tortpoker ($18.95 in chips) 
Seat 2: M.DiLandro ($8.60 in chips) 
Seat 3: xSkokEx ($10.63 in chips) 
Seat 4: zebaztravez ($11.77 in chips) 
Seat 5: Mello_Ace ($2.34 in chips) 
Seat 6: kätzi<3 ($8.91 in chips) 
xSkokEx: posts small blind $0.05
zebaztravez: posts big blind $0.10
*** HOLE CARDS ***
Mello_Ace: folds 
kätzi<3: folds 
tortpoker: folds 
M.DiLandro: raises $0.20 to $0.30
xSkokEx: folds 
zebaztravez: folds 
Uncalled bet ($0.20) returned to M.DiLandro
M.DiLandro collected $0.25 from pot
M.DiLandro: doesn't show hand 
*** SUMMARY ***
Total pot $0.25 | Rake $0 
Seat 1: tortpoker folded before Flop (didn't bet)
Seat 2: M.DiLandro (button) collected ($0.25)
Seat 3: xSkokEx (small blind) folded before Flop
Seat 4: zebaztravez (big blind) folded before Flop
Seat 5: Mello_Ace folded before Flop (didn't bet)
Seat 6: kätzi<3 folded before Flop (didn't bet)



PokerStars Hand #222979559261:  Hold'em No Limit ($0.05/$0.10 USD) - 2021/01/23 19:19:13 ET
Table 'Stephano III' 6-max Seat #3 is the button
Seat 1: tortpoker ($18.95 in chips) 
Seat 2: M.DiLandro ($8.75 in chips) 
Seat 3: xSkokEx ($10.58 in chips) 
Seat 4: zebaztravez ($11.67 in chips) 
Seat 5: Mello_Ace ($2.34 in chips) 
Seat 6: kätzi<3 ($8.91 in chips) 
zebaztravez: posts small blind $0.05
Mello_Ace: posts big blind $0.10
*** HOLE CARDS ***
kätzi<3: raises $0.20 to $0.30
tortpoker: calls $0.30
M.DiLandro: calls $0.30
xSkokEx: folds 
zebaztravez: folds 
Mello_Ace: folds 
*** FLOP *** [6c 8d Kc]
kätzi<3: checks 
tortpoker: checks 
M.DiLandro: checks 
*** TURN *** [6c 8d Kc] [Jc]
kätzi<3: checks 
tortpoker: checks 
M.DiLandro: bets $0.60
kätzi<3: folds 
tortpoker: folds 
Uncalled bet ($0.60) returned to M.DiLandro
M.DiLandro collected $1 from pot
M.DiLandro: doesn't show hand 
*** SUMMARY ***
Total pot $1.05 | Rake $0.05 
Board [6c 8d Kc Jc]
Seat 1: tortpoker folded on the Turn
Seat 2: M.DiLandro collected ($1)
Seat 3: xSkokEx (button) folded before Flop (didn't bet)
Seat 4: zebaztravez (small blind) folded before Flop
Seat 5: Mello_Ace (big blind) folded before Flop
Seat 6: kätzi<3 folded on the Turn



PokerStars Hand #222979582941:  Hold'em No Limit ($0.05/$0.10 USD) - 2021/01/23 19:19:57 ET
Table 'Stephano III' 6-max Seat #4 is the button
Seat 1: tortpoker ($18.65 in chips) 
Seat 2: M.DiLandro ($9.45 in chips) 
Seat 3: xSkokEx ($10.58 in chips) 
Seat 4: zebaztravez ($11.62 in chips) 
Seat 5: Mello_Ace ($2.24 in chips) 
Seat 6: kätzi<3 ($8.61 in chips) 
Mello_Ace: posts small blind $0.05
kätzi<3: posts big blind $0.10
*** HOLE CARDS ***
tortpoker: folds 
M.DiLandro: folds 
xSkokEx: raises $0.15 to $0.25
zebaztravez: folds 
Mello_Ace: calls $0.20
kätzi<3: folds 
*** FLOP *** [3h Ts 2d]
Mello_Ace: checks 
xSkokEx: checks 
*** TURN *** [3h Ts 2d] [Qh]
Mello_Ace: checks 
xSkokEx: bets $0.46
Mello_Ace: raises $1.53 to $1.99 and is all-in
xSkokEx: calls $1.53
*** RIVER *** [3h Ts 2d Qh] [5d]
*** SHOW DOWN ***
Mello_Ace: shows [Qs 5s] (two pair, Queens and Fives)
xSkokEx: shows [Kc Qc] (a pair of Queens)
Mello_Ace collected $4.37 from pot
*** SUMMARY ***
Total pot $4.58 | Rake $0.21 
Board [3h Ts 2d Qh 5d]
Seat 1: tortpoker folded before Flop (didn't bet)
Seat 2: M.DiLandro folded before Flop (didn't bet)
Seat 3: xSkokEx showed [Kc Qc] and lost with a pair of Queens
Seat 4: zebaztravez (button) folded before Flop (didn't bet)
Seat 5: Mello_Ace (small blind) showed [Qs 5s] and won ($4.37) with two pair, Queens and Fives
Seat 6: kätzi<3 (big blind) folded before Flop



PokerStars Hand #222979607440:  Hold'em No Limit ($0.05/$0.10 USD) - 2021/01/23 19:20:43 ET
Table 'Stephano III' 6-max Seat #5 is the button
Seat 1: tortpoker ($18.65 in chips) 
Seat 2: M.DiLandro ($9.45 in chips) 
Seat 3: xSkokEx ($10 in chips) 
Seat 4: zebaztravez ($11.62 in chips) 
Seat 5: Mello_Ace ($4.37 in chips) 
Seat 6: kätzi<3 ($8.51 in chips) 
kätzi<3: posts small blind $0.05
tortpoker: posts big blind $0.10
*** HOLE CARDS ***
M.DiLandro: folds 
xSkokEx: folds 
zebaztravez: folds 
Mello_Ace: calls $0.10
kätzi<3: calls $0.05
tortpoker: raises $0.40 to $0.50
Mello_Ace: calls $0.40
kätzi<3: folds 
*** FLOP *** [9s Jd Qh]
tortpoker: checks 
Mello_Ace: checks 
*** TURN *** [9s Jd Qh] [Ac]
tortpoker: checks 
Mello_Ace: bets $0.10
tortpoker: calls $0.10
*** RIVER *** [9s Jd Qh Ac] [As]
tortpoker: bets $0.63
Mello_Ace: calls $0.63
*** SHOW DOWN ***
tortpoker: shows [2h Ah] (three of a kind, Aces)
Mello_Ace: mucks hand 
tortpoker collected $2.44 from pot
*** SUMMARY ***
Total pot $2.56 | Rake $0.12 
Board [9s Jd Qh Ac As]
Seat 1: tortpoker (big blind) showed [2h Ah] and won ($2.44) with three of a kind, Aces
Seat 2: M.DiLandro folded before Flop (didn't bet)
Seat 3: xSkokEx folded before Flop (didn't bet)
Seat 4: zebaztravez folded before Flop (didn't bet)
Seat 5: Mello_Ace (button) mucked
Seat 6: kätzi<3 (small blind) folded before Flop



PokerStars Hand #222979626583:  Hold'em No Limit ($0.05/$0.10 USD) - 2021/01/23 19:21:18 ET
Table 'Stephano III' 6-max Seat #6 is the button
Seat 1: tortpoker ($19.86 in chips) 
Seat 2: M.DiLandro ($9.45 in chips) 
Seat 3: xSkokEx ($10 in chips) 
Seat 4: zebaztravez ($11.62 in chips) 
Seat 5: Mello_Ace ($3.14 in chips) 
Seat 6: kätzi<3 ($8.41 in chips) 
tortpoker: posts small blind $0.05
M.DiLandro: posts big blind $0.10
*** HOLE CARDS ***
xSkokEx: folds 
zebaztravez: folds 
Mello_Ace: folds 
kätzi<3: raises $0.20 to $0.30
tortpoker: folds 
M.DiLandro: calls $0.20
*** FLOP *** [Ac 6h 8h]
M.DiLandro: checks 
kätzi<3: bets $0.40
M.DiLandro: calls $0.40
*** TURN *** [Ac 6h 8h] [Qd]
M.DiLandro: checks 
kätzi<3: bets $0.80
M.DiLandro: folds 
Uncalled bet ($0.80) returned to kätzi<3
kätzi<3 collected $1.38 from pot
kätzi<3: doesn't show hand 
*** SUMMARY ***
Total pot $1.45 | Rake $0.07 
Board [Ac 6h 8h Qd]
Seat 1: tortpoker (small blind) folded before Flop
Seat 2: M.DiLandro (big blind) folded on the Turn
Seat 3: xSkokEx folded before Flop (didn't bet)
Seat 4: zebaztravez folded before Flop (didn't bet)
Seat 5: Mello_Ace folded before Flop (didn't bet)
Seat 6: kätzi<3 (button) collected ($1.38)



PokerStars Hand #222979656597:  Hold'em No Limit ($0.05/$0.10 USD) - 2021/01/23 19:22:15 ET
Table 'Stephano III' 6-max Seat #1 is the button
Seat 1: tortpoker ($19.81 in chips) 
Seat 2: M.DiLandro ($8.75 in chips) 
Seat 3: xSkokEx ($10 in chips) 
Seat 4: zebaztravez ($11.62 in chips) 
Seat 5: Mello_Ace ($3.14 in chips) 
Seat 6: kätzi<3 ($9.09 in chips) 
M.DiLandro: posts small blind $0.05
xSkokEx: posts big blind $0.10
*** HOLE CARDS ***
zebaztravez: folds 
Mello_Ace is disconnected 
Mello_Ace is connected 
Mello_Ace: folds 
Mello_Ace is disconnected 
kätzi<3: raises $0.20 to $0.30
tortpoker: folds 
M.DiLandro: folds 
xSkokEx: folds 
Uncalled bet ($0.20) returned to kätzi<3
kätzi<3 collected $0.25 from pot
kätzi<3: doesn't show hand 
*** SUMMARY ***
Total pot $0.25 | Rake $0 
Seat 1: tortpoker (button) folded before Flop (didn't bet)
Seat 2: M.DiLandro (small blind) folded before Flop
Seat 3: xSkokEx (big blind) folded before Flop
Seat 4: zebaztravez folded before Flop (didn't bet)
Seat 5: Mello_Ace folded before Flop (didn't bet)
Seat 6: kätzi<3 collected ($0.25)



PokerStars Hand #222979670964:  Hold'em No Limit ($0.05/$0.10 USD) - 2021/01/23 19:22:42 ET
Table 'Stephano III' 6-max Seat #2 is the button
Seat 1: tortpoker ($19.81 in chips) 
Seat 2: M.DiLandro ($8.70 in chips) 
Seat 3: xSkokEx ($10 in chips) 
Seat 4: zebaztravez ($11.62 in chips) 
Seat 5: Mello_Ace ($3.14 in chips) 
Seat 6: kätzi<3 ($9.24 in chips) 
xSkokEx: posts small blind $0.05
zebaztravez: posts big blind $0.10
*** HOLE CARDS ***
Mello_Ace has timed out while disconnected
Mello_Ace: folds 
kätzi<3: raises $0.10 to $0.20
tortpoker: folds 
M.DiLandro: calls $0.20
xSkokEx: raises $1 to $1.20
zebaztravez: folds 
kätzi<3: folds 
M.DiLandro: folds 
Uncalled bet ($1) returned to xSkokEx
xSkokEx collected $0.70 from pot
xSkokEx: doesn't show hand 
*** SUMMARY ***
Total pot $0.70 | Rake $0 
Seat 1: tortpoker folded before Flop (didn't bet)
Seat 2: M.DiLandro (button) folded before Flop
Seat 3: xSkokEx (small blind) collected ($0.70)
Seat 4: zebaztravez (big blind) folded before Flop
Seat 5: Mello_Ace folded before Flop (didn't bet)
Seat 6: kätzi<3 folded before Flop



PokerStars Hand #222979689941:  Hold'em No Limit ($0.05/$0.10 USD) - 2021/01/23 19:23:17 ET
Table 'Stephano III' 6-max Seat #3 is the button
Seat 1: tortpoker ($19.81 in chips) 
Seat 2: M.DiLandro ($8.50 in chips) 
Seat 3: xSkokEx ($10.50 in chips) 
Seat 4: zebaztravez ($11.52 in chips) 
Seat 5: Mello_Ace ($3.14 in chips) 
Seat 6: kätzi<3 ($9.04 in chips) 
zebaztravez: posts small blind $0.05
Mello_Ace: posts big blind $0.10
*** HOLE CARDS ***
kätzi<3: folds 
tortpoker: folds 
M.DiLandro: raises $0.20 to $0.30
xSkokEx: folds 
zebaztravez: folds 
Mello_Ace: folds 
Uncalled bet ($0.20) returned to M.DiLandro
M.DiLandro collected $0.25 from pot
M.DiLandro: doesn't show hand 
*** SUMMARY ***
Total pot $0.25 | Rake $0 
Seat 1: tortpoker folded before Flop (didn't bet)
Seat 2: M.DiLandro collected ($0.25)
Seat 3: xSkokEx (button) folded before Flop (didn't bet)
Seat 4: zebaztravez (small blind) folded before Flop
Seat 5: Mello_Ace (big blind) folded before Flop
Seat 6: kätzi<3 folded before Flop (didn't bet)



PokerStars Hand #222979696541:  Hold'em No Limit ($0.05/$0.10 USD) - 2021/01/23 19:23:30 ET
Table 'Stephano III' 6-max Seat #4 is the button
Seat 1: tortpoker ($19.81 in chips) 
Seat 2: M.DiLandro ($8.65 in chips) 
Seat 3: xSkokEx ($10.50 in chips) 
Seat 4: zebaztravez ($11.47 in chips) 
Seat 5: Mello_Ace ($3.04 in chips) 
Seat 6: kätzi<3 ($9.04 in chips) 
Mello_Ace: posts small blind $0.05
kätzi<3: posts big blind $0.10
*** HOLE CARDS ***
tortpoker: folds 
M.DiLandro: raises $0.20 to $0.30
xSkokEx: folds 
zebaztravez: raises $0.60 to $0.90
Mello_Ace: folds 
kätzi<3: folds 
M.DiLandro: calls $0.60
*** FLOP *** [Kc Td Qd]
M.DiLandro: checks 
zebaztravez: checks 
*** TURN *** [Kc Td Qd] [7s]
M.DiLandro: checks 
zebaztravez: bets $1
M.DiLandro: calls $1
*** RIVER *** [Kc Td Qd 7s] [Jd]
M.DiLandro: checks 
zebaztravez: bets $1.13
M.DiLandro: calls $1.13
*** SHOW DOWN ***
zebaztravez: shows [As Kh] (a straight, Ten to Ace)
M.DiLandro: shows [Ah Qs] (a straight, Ten to Ace)
M.DiLandro collected $2.97 from pot
zebaztravez collected $2.96 from pot
*** SUMMARY ***
Total pot $6.21 | Rake $0.28 
Board [Kc Td Qd 7s Jd]
Seat 1: tortpoker folded before Flop (didn't bet)
Seat 2: M.DiLandro showed [Ah Qs] and won ($2.97) with a straight, Ten to Ace
Seat 3: xSkokEx folded before Flop (didn't bet)
Seat 4: zebaztravez (button) showed [As Kh] and won ($2.96) with a straight, Ten to Ace
Seat 5: Mello_Ace (small blind) folded before Flop
Seat 6: kätzi<3 (big blind) folded before Flop



PokerStars Hand #222979732608:  Hold'em No Limit ($0.05/$0.10 USD) - 2021/01/23 19:24:38 ET
Table 'Stephano III' 6-max Seat #5 is the button
Seat 1: tortpoker ($19.81 in chips) 
Seat 2: M.DiLandro ($8.59 in chips) 
Seat 3: xSkokEx ($10.50 in chips) 
Seat 4: zebaztravez ($11.40 in chips) 
Seat 5: Mello_Ace ($2.99 in chips) 
Seat 6: kätzi<3 ($8.94 in chips) 
kätzi<3: posts small blind $0.05
tortpoker: posts big blind $0.10
*** HOLE CARDS ***
M.DiLandro: folds 
xSkokEx: raises $0.15 to $0.25
zebaztravez: folds 
Mello_Ace: calls $0.25
kätzi<3: folds 
tortpoker: folds 
*** FLOP *** [Jh 9h 4c]
xSkokEx: checks 
Mello_Ace: checks 
*** TURN *** [Jh 9h 4c] [2d]
xSkokEx: checks 
Mello_Ace: checks 
*** RIVER *** [Jh 9h 4c 2d] [Ah]
xSkokEx: checks 
Mello_Ace: checks 
*** SHOW DOWN ***
xSkokEx: shows [Ad Tc] (a pair of Aces)
Mello_Ace: mucks hand 
xSkokEx collected $0.62 from pot
*** SUMMARY ***
Total pot $0.65 | Rake $0.03 
Board [Jh 9h 4c 2d Ah]
Seat 1: tortpoker (big blind) folded before Flop
Seat 2: M.DiLandro folded before Flop (didn't bet)
Seat 3: xSkokEx showed [Ad Tc] and won ($0.62) with a pair of Aces
Seat 4: zebaztravez folded before Flop (didn't bet)
Seat 5: Mello_Ace (button) mucked
Seat 6: kätzi<3 (small blind) folded before Flop



PokerStars Hand #222979766831:  Hold'em No Limit ($0.05/$0.10 USD) - 2021/01/23 19:25:43 ET
Table 'Stephano III' 6-max Seat #6 is the button
Seat 1: tortpoker ($19.71 in chips) 
Seat 2: M.DiLandro ($8.59 in chips) 
Seat 3: xSkokEx ($10.87 in chips) 
Seat 4: zebaztravez ($11.40 in chips) 
Seat 5: Mello_Ace ($2.74 in chips) 
Seat 6: kätzi<3 ($8.89 in chips) 
tortpoker: posts small blind $0.05
M.DiLandro: posts big blind $0.10
*** HOLE CARDS ***
xSkokEx: folds 
zebaztravez: raises $0.20 to $0.30
Mello_Ace: folds 
kätzi<3: folds 
tortpoker: folds 
M.DiLandro: folds 
Uncalled bet ($0.20) returned to zebaztravez
zebaztravez collected $0.25 from pot
zebaztravez: doesn't show hand 
*** SUMMARY ***
Total pot $0.25 | Rake $0 
Seat 1: tortpoker (small blind) folded before Flop
Seat 2: M.DiLandro (big blind) folded before Flop
Seat 3: xSkokEx folded before Flop (didn't bet)
Seat 4: zebaztravez collected ($0.25)
Seat 5: Mello_Ace folded before Flop (didn't bet)
Seat 6: kätzi<3 (button) folded before Flop (didn't bet)



PokerStars Hand #222979772922:  Hold'em No Limit ($0.05/$0.10 USD) - 2021/01/23 19:25:54 ET
Table 'Stephano III' 6-max Seat #1 is the button
Seat 1: tortpoker ($19.66 in chips) 
Seat 2: M.DiLandro ($8.49 in chips) 
Seat 4: zebaztravez ($11.55 in chips) 
Seat 5: Mello_Ace ($2.74 in chips) 
Seat 6: kätzi<3 ($8.89 in chips) 
M.DiLandro: posts small blind $0.05
xSkokEx: is sitting out 
zebaztravez: posts big blind $0.10
*** HOLE CARDS ***
Mello_Ace: folds 
kätzi<3: folds 
tortpoker: folds 
xSkokEx leaves the table
M.DiLandro: calls $0.05
zebaztravez: checks 
*** FLOP *** [4c 5h 7s]
M.DiLandro: bets $0.19
zebaztravez: calls $0.19
*** TURN *** [4c 5h 7s] [8d]
marcin116 joins the table at seat #3 
M.DiLandro: checks 
zebaztravez: checks 
*** RIVER *** [4c 5h 7s 8d] [Tc]
M.DiLandro: checks 
zebaztravez: checks 
*** SHOW DOWN ***
M.DiLandro: shows [5d Kd] (a pair of Fives)
zebaztravez: shows [Ks 8h] (a pair of Eights)
zebaztravez collected $0.55 from pot
*** SUMMARY ***
Total pot $0.58 | Rake $0.03 
Board [4c 5h 7s 8d Tc]
Seat 1: tortpoker (button) folded before Flop (didn't bet)
Seat 2: M.DiLandro (small blind) showed [5d Kd] and lost with a pair of Fives
Seat 4: zebaztravez (big blind) showed [Ks 8h] and won ($0.55) with a pair of Eights
Seat 5: Mello_Ace folded before Flop (didn't bet)
Seat 6: kätzi<3 folded before Flop (didn't bet)



PokerStars Hand #222979795616:  Hold'em No Limit ($0.05/$0.10 USD) - 2021/01/23 19:26:37 ET
Table 'Stephano III' 6-max Seat #2 is the button
Seat 1: tortpoker ($19.66 in chips) 
Seat 2: M.DiLandro ($8.20 in chips) 
Seat 4: zebaztravez ($11.81 in chips) 
Seat 5: Mello_Ace ($2.74 in chips) 
Seat 6: kätzi<3 ($8.89 in chips) 
zebaztravez: posts small blind $0.05
Mello_Ace: posts big blind $0.10
*** HOLE CARDS ***
kätzi<3: folds 
tortpoker: folds 
M.DiLandro: folds 
zebaztravez: raises $0.20 to $0.30
Mello_Ace: calls $0.20
*** FLOP *** [4c 9h Th]
zebaztravez: checks 
Mello_Ace: bets $0.29
zebaztravez: folds 
Uncalled bet ($0.29) returned to Mello_Ace
Mello_Ace collected $0.57 from pot
Mello_Ace: doesn't show hand 
*** SUMMARY ***
Total pot $0.60 | Rake $0.03 
Board [4c 9h Th]
Seat 1: tortpoker folded before Flop (didn't bet)
Seat 2: M.DiLandro (button) folded before Flop (didn't bet)
Seat 4: zebaztravez (small blind) folded on the Flop
Seat 5: Mello_Ace (big blind) collected ($0.57)
Seat 6: kätzi<3 folded before Flop (didn't bet)



PokerStars Hand #222979807063:  Hold'em No Limit ($0.05/$0.10 USD) - 2021/01/23 19:26:59 ET
Table 'Stephano III' 6-max Seat #4 is the button
Seat 1: tortpoker ($19.66 in chips) 
Seat 2: M.DiLandro ($8.20 in chips) 
Seat 4: zebaztravez ($11.51 in chips) 
Seat 5: Mello_Ace ($3.01 in chips) 
Seat 6: kätzi<3 ($8.89 in chips) 
Mello_Ace: posts small blind $0.05
kätzi<3: posts big blind $0.10
marcin116: sits out 
*** HOLE CARDS ***
tortpoker: folds 
M.DiLandro: raises $0.20 to $0.30
zebaztravez: folds 
Mello_Ace: folds 
kätzi<3: calls $0.20
*** FLOP *** [9c Jh Ad]
kätzi<3: bets $0.40
M.DiLandro: calls $0.40
*** TURN *** [9c Jh Ad] [7h]
kätzi<3: bets $0.50
M.DiLandro: raises $2 to $2.50
kätzi<3: folds 
Uncalled bet ($2) returned to M.DiLandro
M.DiLandro collected $2.34 from pot
M.DiLandro: doesn't show hand 
*** SUMMARY ***
Total pot $2.45 | Rake $0.11 
Board [9c Jh Ad 7h]
Seat 1: tortpoker folded before Flop (didn't bet)
Seat 2: M.DiLandro collected ($2.34)
Seat 4: zebaztravez (button) folded before Flop (didn't bet)
Seat 5: Mello_Ace (small blind) folded before Flop
Seat 6: kätzi<3 (big blind) folded on the Turn



PokerStars Hand #222979841048:  Hold'em No Limit ($0.05/$0.10 USD) - 2021/01/23 19:27:59 ET
Table 'Stephano III' 6-max Seat #5 is the button
Seat 1: tortpoker ($19.66 in chips) 
Seat 2: M.DiLandro ($9.34 in chips) 
Seat 4: zebaztravez ($11.51 in chips) 
Seat 5: Mello_Ace ($2.96 in chips) 
Seat 6: kätzi<3 ($7.69 in chips) 
kätzi<3: posts small blind $0.05
tortpoker: posts big blind $0.10
marcin116: sits out 
*** HOLE CARDS ***
M.DiLandro: calls $0.10
zebaztravez: folds 
Mello_Ace: calls $0.10
kätzi<3: calls $0.05
tortpoker: checks 
*** FLOP *** [Qd 3h Ts]
kätzi<3: checks 
tortpoker: checks 
M.DiLandro: checks 
Mello_Ace: bets $0.19
kätzi<3: folds 
tortpoker: folds 
M.DiLandro: calls $0.19
*** TURN *** [Qd 3h Ts] [Ks]
M.DiLandro: checks 
Mello_Ace: checks 
*** RIVER *** [Qd 3h Ts Ks] [7h]
M.DiLandro: bets $0.74
Mello_Ace: calls $0.74
*** SHOW DOWN ***
M.DiLandro: shows [Jd 9s] (a straight, Nine to King)
Mello_Ace: mucks hand 
M.DiLandro collected $2.16 from pot
*** SUMMARY ***
Total pot $2.26 | Rake $0.10 
Board [Qd 3h Ts Ks 7h]
Seat 1: tortpoker (big blind) folded on the Flop
Seat 2: M.DiLandro showed [Jd 9s] and won ($2.16) with a straight, Nine to King
Seat 4: zebaztravez folded before Flop (didn't bet)
Seat 5: Mello_Ace (button) mucked
Seat 6: kätzi<3 (small blind) folded on the Flop



PokerStars Hand #222979872921:  Hold'em No Limit ($0.05/$0.10 USD) - 2021/01/23 19:29:00 ET
Table 'Stephano III' 6-max Seat #6 is the button
Seat 1: tortpoker ($19.56 in chips) 
Seat 2: M.DiLandro ($10.47 in chips) 
Seat 4: zebaztravez ($11.51 in chips) 
Seat 5: Mello_Ace ($1.93 in chips) 
Seat 6: kätzi<3 ($7.59 in chips) 
tortpoker: posts small blind $0.05
M.DiLandro: posts big blind $0.10
marcin116: sits out 
*** HOLE CARDS ***
zebaztravez: folds 
Mello_Ace: calls $0.10
kätzi<3: raises $0.20 to $0.30
tortpoker: folds 
M.DiLandro: folds 
Mello_Ace: calls $0.20
*** FLOP *** [5h Qs 9d]
Mello_Ace: checks 
kätzi<3: bets $0.60
Mello_Ace: folds 
Uncalled bet ($0.60) returned to kätzi<3
kätzi<3 collected $0.72 from pot
kätzi<3: doesn't show hand 
*** SUMMARY ***
Total pot $0.75 | Rake $0.03 
Board [5h Qs 9d]
Seat 1: tortpoker (small blind) folded before Flop
Seat 2: M.DiLandro (big blind) folded before Flop
Seat 4: zebaztravez folded before Flop (didn't bet)
Seat 5: Mello_Ace folded on the Flop
Seat 6: kätzi<3 (button) collected ($0.72)



PokerStars Hand #222979890410:  Hold'em No Limit ($0.05/$0.10 USD) - 2021/01/23 19:29:34 ET
Table 'Stephano III' 6-max Seat #1 is the button
Seat 1: tortpoker ($19.51 in chips) 
Seat 2: M.DiLandro ($10.37 in chips) 
Seat 3: marcin116 ($10 in chips) 
Seat 4: zebaztravez ($11.51 in chips) 
Seat 5: Mello_Ace ($1.63 in chips) 
Seat 6: kätzi<3 ($8.01 in chips) 
M.DiLandro: posts small blind $0.05
marcin116: posts big blind $0.10
*** HOLE CARDS ***
zebaztravez: folds 
Mello_Ace: calls $0.10
kätzi<3: folds 
tortpoker: folds 
M.DiLandro: calls $0.05
marcin116: raises $0.35 to $0.45
Mello_Ace: folds 
M.DiLandro: calls $0.35
*** FLOP *** [Td Ts Js]
M.DiLandro: checks 
marcin116: checks 
*** TURN *** [Td Ts Js] [3c]
M.DiLandro: bets $0.50
marcin116: calls $0.50
*** RIVER *** [Td Ts Js 3c] [Ac]
M.DiLandro: checks 
marcin116: checks 
*** SHOW DOWN ***
M.DiLandro: shows [9c 8c] (a pair of Tens)
marcin116: shows [7h 7d] (two pair, Tens and Sevens)
marcin116 collected $1.91 from pot
*** SUMMARY ***
Total pot $2 | Rake $0.09 
Board [Td Ts Js 3c Ac]
Seat 1: tortpoker (button) folded before Flop (didn't bet)
Seat 2: M.DiLandro (small blind) showed [9c 8c] and lost with a pair of Tens
Seat 3: marcin116 (big blind) showed [7h 7d] and won ($1.91) with two pair, Tens and Sevens
Seat 4: zebaztravez folded before Flop (didn't bet)
Seat 5: Mello_Ace folded before Flop
Seat 6: kätzi<3 folded before Flop (didn't bet)



PokerStars Hand #222979921875:  Hold'em No Limit ($0.05/$0.10 USD) - 2021/01/23 19:30:34 ET
Table 'Stephano III' 6-max Seat #2 is the button
Seat 1: tortpoker ($19.51 in chips) 
Seat 2: M.DiLandro ($9.42 in chips) 
Seat 3: marcin116 ($10.96 in chips) 
Seat 4: zebaztravez ($11.51 in chips) 
Seat 5: Mello_Ace ($1.53 in chips) 
Seat 6: kätzi<3 ($8.01 in chips) 
marcin116: posts small blind $0.05
zebaztravez: posts big blind $0.10
*** HOLE CARDS ***
Mello_Ace: folds 
kätzi<3: folds 
tortpoker: folds 
M.DiLandro: raises $0.20 to $0.30
marcin116: folds 
zebaztravez: calls $0.20
*** FLOP *** [2d 4h Ad]
zebaztravez: checks 
M.DiLandro: bets $0.31
zebaztravez: folds 
Uncalled bet ($0.31) returned to M.DiLandro
M.DiLandro collected $0.62 from pot
M.DiLandro: doesn't show hand 
*** SUMMARY ***
Total pot $0.65 | Rake $0.03 
Board [2d 4h Ad]
Seat 1: tortpoker folded before Flop (didn't bet)
Seat 2: M.DiLandro (button) collected ($0.62)
Seat 3: marcin116 (small blind) folded before Flop
Seat 4: zebaztravez (big blind) folded on the Flop
Seat 5: Mello_Ace folded before Flop (didn't bet)
Seat 6: kätzi<3 folded before Flop (didn't bet)



PokerStars Hand #222979945245:  Hold'em No Limit ($0.05/$0.10 USD) - 2021/01/23 19:31:19 ET
Table 'Stephano III' 6-max Seat #3 is the button
Seat 1: tortpoker ($19.51 in chips) 
Seat 2: M.DiLandro ($9.74 in chips) 
Seat 3: marcin116 ($10.91 in chips) 
Seat 4: zebaztravez ($11.21 in chips) 
Seat 5: Mello_Ace ($1.53 in chips) 
Seat 6: kätzi<3 ($8.01 in chips) 
zebaztravez: posts small blind $0.05
Mello_Ace: posts big blind $0.10
*** HOLE CARDS ***
kätzi<3: folds 
tortpoker: folds 
M.DiLandro: folds 
marcin116: raises $0.25 to $0.35
zebaztravez: folds 
Mello_Ace: calls $0.25
*** FLOP *** [3c 9c 2s]
Mello_Ace: checks 
marcin116: checks 
*** TURN *** [3c 9c 2s] [5h]
Mello_Ace: bets $1.18 and is all-in
marcin116: folds 
Uncalled bet ($1.18) returned to Mello_Ace
Mello_Ace collected $0.72 from pot
Mello_Ace: doesn't show hand 
*** SUMMARY ***
Total pot $0.75 | Rake $0.03 
Board [3c 9c 2s 5h]
Seat 1: tortpoker folded before Flop (didn't bet)
Seat 2: M.DiLandro folded before Flop (didn't bet)
Seat 3: marcin116 (button) folded on the Turn
Seat 4: zebaztravez (small blind) folded before Flop
Seat 5: Mello_Ace (big blind) collected ($0.72)
Seat 6: kätzi<3 folded before Flop (didn't bet)



PokerStars Hand #222979959734:  Hold'em No Limit ($0.05/$0.10 USD) - 2021/01/23 19:31:47 ET
Table 'Stephano III' 6-max Seat #4 is the button
Seat 1: tortpoker ($19.51 in chips) 
Seat 2: M.DiLandro ($9.74 in chips) 
Seat 3: marcin116 ($10.56 in chips) 
Seat 4: zebaztravez ($11.16 in chips) 
Seat 5: Mello_Ace ($1.90 in chips) 
Seat 6: kätzi<3 ($8.01 in chips) 
Mello_Ace: posts small blind $0.05
kätzi<3: posts big blind $0.10
*** HOLE CARDS ***
tortpoker: folds 
M.DiLandro: raises $0.20 to $0.30
marcin116: folds 
zebaztravez: folds 
Mello_Ace: calls $0.25
kätzi<3: raises $0.40 to $0.70
M.DiLandro: calls $0.40
Mello_Ace: calls $0.40
*** FLOP *** [Td 3h Kh]
Mello_Ace: checks 
kätzi<3: bets $0.30
M.DiLandro: calls $0.30
Mello_Ace: folds 
*** TURN *** [Td 3h Kh] [Ks]
kätzi<3: bets $0.80
M.DiLandro: calls $0.80
*** RIVER *** [Td 3h Kh Ks] [3s]
kätzi<3: bets $6.21 and is all-in
M.DiLandro: folds 
Uncalled bet ($6.21) returned to kätzi<3
kätzi<3 collected $4.11 from pot
kätzi<3: doesn't show hand 
*** SUMMARY ***
Total pot $4.30 | Rake $0.19 
Board [Td 3h Kh Ks 3s]
Seat 1: tortpoker folded before Flop (didn't bet)
Seat 2: M.DiLandro folded on the River
Seat 3: marcin116 folded before Flop (didn't bet)
Seat 4: zebaztravez (button) folded before Flop (didn't bet)
Seat 5: Mello_Ace (small blind) folded on the Flop
Seat 6: kätzi<3 (big blind) collected ($4.11)



PokerStars Hand #222980018794:  Hold'em No Limit ($0.05/$0.10 USD) - 2021/01/23 19:33:26 ET
Table 'Stephano III' 6-max Seat #5 is the button
Seat 1: tortpoker ($19.51 in chips) 
Seat 2: M.DiLandro ($7.94 in chips) 
Seat 3: marcin116 ($10.56 in chips) 
Seat 4: zebaztravez ($11.16 in chips) 
Seat 5: Mello_Ace ($1.20 in chips) 
Seat 6: kätzi<3 ($10.32 in chips) 
kätzi<3: posts small blind $0.05
tortpoker: posts big blind $0.10
*** HOLE CARDS ***
M.DiLandro: calls $0.10
marcin116: folds 
zebaztravez: folds 
Mello_Ace: folds 
kätzi<3: folds 
tortpoker: checks 
*** FLOP *** [9d Th Kd]
tortpoker: checks 
M.DiLandro: bets $0.24
tortpoker: folds 
Uncalled bet ($0.24) returned to M.DiLandro
M.DiLandro collected $0.24 from pot
M.DiLandro: doesn't show hand 
*** SUMMARY ***
Total pot $0.25 | Rake $0.01 
Board [9d Th Kd]
Seat 1: tortpoker (big blind) folded on the Flop
Seat 2: M.DiLandro collected ($0.24)
Seat 3: marcin116 folded before Flop (didn't bet)
Seat 4: zebaztravez folded before Flop (didn't bet)
Seat 5: Mello_Ace (button) folded before Flop (didn't bet)
Seat 6: kätzi<3 (small blind) folded before Flop



PokerStars Hand #222980032340:  Hold'em No Limit ($0.05/$0.10 USD) - 2021/01/23 19:33:53 ET
Table 'Stephano III' 6-max Seat #6 is the button
Seat 1: tortpoker ($19.41 in chips) 
Seat 2: M.DiLandro ($8.08 in chips) 
Seat 3: marcin116 ($10.56 in chips) 
Seat 4: zebaztravez ($11.16 in chips) 
Seat 5: Mello_Ace ($1.20 in chips) 
Seat 6: kätzi<3 ($10.27 in chips) 
tortpoker: posts small blind $0.05
M.DiLandro: posts big blind $0.10
*** HOLE CARDS ***
marcin116: folds 
zebaztravez: raises $0.20 to $0.30
Mello_Ace: folds 
kätzi<3: folds 
tortpoker: folds 
M.DiLandro: calls $0.20
*** FLOP *** [9c 9h Ad]
M.DiLandro: checks 
zebaztravez: checks 
*** TURN *** [9c 9h Ad] [Qs]
M.DiLandro: checks 
zebaztravez: checks 
*** RIVER *** [9c 9h Ad Qs] [4d]
M.DiLandro: checks 
zebaztravez: checks 
*** SHOW DOWN ***
M.DiLandro: shows [Ts 8s] (a pair of Nines)
zebaztravez: shows [As 3s] (two pair, Aces and Nines)
zebaztravez collected $0.62 from pot
*** SUMMARY ***
Total pot $0.65 | Rake $0.03 
Board [9c 9h Ad Qs 4d]
Seat 1: tortpoker (small blind) folded before Flop
Seat 2: M.DiLandro (big blind) showed [Ts 8s] and lost with a pair of Nines
Seat 3: marcin116 folded before Flop (didn't bet)
Seat 4: zebaztravez showed [As 3s] and won ($0.62) with two pair, Aces and Nines
Seat 5: Mello_Ace folded before Flop (didn't bet)
Seat 6: kätzi<3 (button) folded before Flop (didn't bet)



PokerStars Hand #222980057645:  Hold'em No Limit ($0.05/$0.10 USD) - 2021/01/23 19:34:43 ET
Table 'Stephano III' 6-max Seat #1 is the button
Seat 1: tortpoker ($19.36 in chips) 
Seat 2: M.DiLandro ($7.78 in chips) 
Seat 3: marcin116 ($10.56 in chips) 
Seat 4: zebaztravez ($11.48 in chips) 
Seat 5: Mello_Ace ($1.20 in chips) 
Seat 6: kätzi<3 ($10.27 in chips) 
M.DiLandro: posts small blind $0.05
marcin116: posts big blind $0.10
*** HOLE CARDS ***
zebaztravez: folds 
Mello_Ace: raises $0.20 to $0.30
kätzi<3: folds 
tortpoker: raises $0.90 to $1.20
M.DiLandro: folds 
marcin116: folds 
Mello_Ace: calls $0.90 and is all-in
*** FLOP *** [9c 3c 9s]
*** TURN *** [9c 3c 9s] [3h]
*** RIVER *** [9c 3c 9s 3h] [4h]
*** SHOW DOWN ***
Mello_Ace: shows [As Ah] (two pair, Aces and Nines)
tortpoker: shows [Kd Ac] (two pair, Nines and Threes)
Mello_Ace collected $2.44 from pot
*** SUMMARY ***
Total pot $2.55 | Rake $0.11 
Board [9c 3c 9s 3h 4h]
Seat 1: tortpoker (button) showed [Kd Ac] and lost with two pair, Nines and Threes
Seat 2: M.DiLandro (small blind) folded before Flop
Seat 3: marcin116 (big blind) folded before Flop
Seat 4: zebaztravez folded before Flop (didn't bet)
Seat 5: Mello_Ace showed [As Ah] and won ($2.44) with two pair, Aces and Nines
Seat 6: kätzi<3 folded before Flop (didn't bet)



PokerStars Hand #222980073621:  Hold'em No Limit ($0.05/$0.10 USD) - 2021/01/23 19:35:15 ET
Table 'Stephano III' 6-max Seat #2 is the button
Seat 1: tortpoker ($18.16 in chips) 
Seat 2: M.DiLandro ($7.73 in chips) 
Seat 3: marcin116 ($10.46 in chips) 
Seat 5: Mello_Ace ($2.44 in chips) 
Seat 6: kätzi<3 ($10.27 in chips) 
marcin116: posts small blind $0.05
Mello_Ace: posts big blind $0.10
*** HOLE CARDS ***
kätzi<3: folds 
tortpoker: folds 
M.DiLandro: raises $0.20 to $0.30
marcin116: folds 
Mello_Ace: folds 
Uncalled bet ($0.20) returned to M.DiLandro
M.DiLandro collected $0.25 from pot
M.DiLandro: doesn't show hand 
*** SUMMARY ***
Total pot $0.25 | Rake $0 
Seat 1: tortpoker folded before Flop (didn't bet)
Seat 2: M.DiLandro (button) collected ($0.25)
Seat 3: marcin116 (small blind) folded before Flop
Seat 5: Mello_Ace (big blind) folded before Flop
Seat 6: kätzi<3 folded before Flop (didn't bet)



PokerStars Hand #222980080839:  Hold'em No Limit ($0.05/$0.10 USD) - 2021/01/23 19:35:29 ET
Table 'Stephano III' 6-max Seat #3 is the button
Seat 1: tortpoker ($18.16 in chips) 
Seat 2: M.DiLandro ($7.88 in chips) 
Seat 3: marcin116 ($10.41 in chips) 
Seat 5: Mello_Ace ($2.34 in chips) 
Seat 6: kätzi<3 ($10.27 in chips) 
Mello_Ace: posts small blind $0.05
kätzi<3: posts big blind $0.10
*** HOLE CARDS ***
tortpoker: folds 
M.DiLandro: raises $0.20 to $0.30
marcin116: folds 
Mello_Ace: folds 
kätzi<3: calls $0.20
*** FLOP *** [8s Ad 6h]
kätzi<3: bets $0.40
M.DiLandro: calls $0.40
*** TURN *** [8s Ad 6h] [Qd]
kätzi<3: checks 
M.DiLandro: bets $0.80
kätzi<3: raises $0.80 to $1.60
M.DiLandro: folds 
Uncalled bet ($0.80) returned to kätzi<3
kätzi<3 collected $2.91 from pot
kätzi<3: doesn't show hand 
*** SUMMARY ***
Total pot $3.05 | Rake $0.14 
Board [8s Ad 6h Qd]
Seat 1: tortpoker folded before Flop (didn't bet)
Seat 2: M.DiLandro folded on the Turn
Seat 3: marcin116 (button) folded before Flop (didn't bet)
Seat 5: Mello_Ace (small blind) folded before Flop
Seat 6: kätzi<3 (big blind) collected ($2.91)



PokerStars Hand #222980126704:  Hold'em No Limit ($0.05/$0.10 USD) - 2021/01/23 19:37:00 ET
Table 'Stephano III' 6-max Seat #5 is the button
Seat 1: tortpoker ($18.16 in chips) 
Seat 2: M.DiLandro ($6.38 in chips) 
Seat 3: marcin116 ($10.41 in chips) 
Seat 5: Mello_Ace ($2.29 in chips) 
Seat 6: kätzi<3 ($11.68 in chips) 
kätzi<3: posts small blind $0.05
tortpoker: posts big blind $0.10
*** HOLE CARDS ***
M.DiLandro: folds 
marcin116: folds 
M.DiLandro leaves the table
Mello_Ace: calls $0.10
kidmosy joins the table at seat #2 
kätzi<3: raises $0.20 to $0.30
tortpoker: folds 
Mello_Ace: calls $0.20
*** FLOP *** [8d 8h 3c]
kätzi<3: bets $0.40
Mello_Ace: folds 
Uncalled bet ($0.40) returned to kätzi<3
kätzi<3 collected $0.67 from pot
kätzi<3: doesn't show hand 
*** SUMMARY ***
Total pot $0.70 | Rake $0.03 
Board [8d 8h 3c]
Seat 1: tortpoker (big blind) folded before Flop
Seat 2: M.DiLandro folded before Flop (didn't bet)
Seat 3: marcin116 folded before Flop (didn't bet)
Seat 5: Mello_Ace (button) folded on the Flop
Seat 6: kätzi<3 (small blind) collected ($0.67)



PokerStars Hand #222980146502:  Hold'em No Limit ($0.05/$0.10 USD) - 2021/01/23 19:37:39 ET
Table 'Stephano III' 6-max Seat #6 is the button
Seat 1: tortpoker ($18.06 in chips) 
Seat 2: kidmosy ($10 in chips) 
Seat 3: marcin116 ($10.41 in chips) 
Seat 5: Mello_Ace ($1.99 in chips) 
Seat 6: kätzi<3 ($12.05 in chips) 
tortpoker: posts small blind $0.05
kidmosy: posts big blind $0.10
*** HOLE CARDS ***
marcin116: folds 
Mello_Ace: folds 
kätzi<3: raises $0.20 to $0.30
tortpoker: folds 
kidmosy: calls $0.20
*** FLOP *** [4d Qs 3s]
kidmosy: checks 
kätzi<3: bets $0.50
kidmosy: folds 
Uncalled bet ($0.50) returned to kätzi<3
kätzi<3 collected $0.62 from pot
kätzi<3: doesn't show hand 
*** SUMMARY ***
Total pot $0.65 | Rake $0.03 
Board [4d Qs 3s]
Seat 1: tortpoker (small blind) folded before Flop
Seat 2: kidmosy (big blind) folded on the Flop
Seat 3: marcin116 folded before Flop (didn't bet)
Seat 5: Mello_Ace folded before Flop (didn't bet)
Seat 6: kätzi<3 (button) collected ($0.62)



PokerStars Hand #222980169310:  Hold'em No Limit ($0.05/$0.10 USD) - 2021/01/23 19:38:25 ET
Table 'Stephano III' 6-max Seat #1 is the button
Seat 1: tortpoker ($18.01 in chips) 
Seat 2: kidmosy ($9.70 in chips) 
Seat 3: marcin116 ($10.41 in chips) 
Seat 5: Mello_Ace ($1.99 in chips) 
Seat 6: kätzi<3 ($12.37 in chips) 
kidmosy: posts small blind $0.05
marcin116: posts big blind $0.10
*** HOLE CARDS ***
Mello_Ace: folds 
kätzi<3: folds 
tortpoker: folds 
kidmosy: raises $0.15 to $0.25
marcin116: folds 
Uncalled bet ($0.15) returned to kidmosy
kidmosy collected $0.20 from pot
kidmosy: doesn't show hand 
*** SUMMARY ***
Total pot $0.20 | Rake $0 
Seat 1: tortpoker (button) folded before Flop (didn't bet)
Seat 2: kidmosy (small blind) collected ($0.20)
Seat 3: marcin116 (big blind) folded before Flop
Seat 5: Mello_Ace folded before Flop (didn't bet)
Seat 6: kätzi<3 folded before Flop (didn't bet)



PokerStars Hand #222980175617:  Hold'em No Limit ($0.05/$0.10 USD) - 2021/01/23 19:38:38 ET
Table 'Stephano III' 6-max Seat #2 is the button
Seat 1: tortpoker ($18.01 in chips) 
Seat 2: kidmosy ($9.80 in chips) 
Seat 3: marcin116 ($10.31 in chips) 
Seat 5: Mello_Ace ($1.99 in chips) 
Seat 6: kätzi<3 ($12.37 in chips) 
marcin116: posts small blind $0.05
Mello_Ace: posts big blind $0.10
*** HOLE CARDS ***
kätzi<3: folds 
tortpoker: folds 
kidmosy: raises $0.15 to $0.25
marcin116: folds 
Mello_Ace: calls $0.15
*** FLOP *** [3d Ac Qs]
Mello_Ace: checks 
kidmosy: bets $0.27
Mello_Ace: folds 
Uncalled bet ($0.27) returned to kidmosy
kidmosy collected $0.53 from pot
kidmosy: doesn't show hand 
*** SUMMARY ***
Total pot $0.55 | Rake $0.02 
Board [3d Ac Qs]
Seat 1: tortpoker folded before Flop (didn't bet)
Seat 2: kidmosy (button) collected ($0.53)
Seat 3: marcin116 (small blind) folded before Flop
Seat 5: Mello_Ace (big blind) folded on the Flop
Seat 6: kätzi<3 folded before Flop (didn't bet)



PokerStars Hand #222980189738:  Hold'em No Limit ($0.05/$0.10 USD) - 2021/01/23 19:39:05 ET
Table 'Stephano III' 6-max Seat #3 is the button
Seat 1: tortpoker ($18.01 in chips) 
Seat 2: kidmosy ($10.08 in chips) 
Seat 3: marcin116 ($10.26 in chips) 
Seat 5: Mello_Ace ($1.74 in chips) 
Seat 6: kätzi<3 ($12.37 in chips) 
Mello_Ace: posts small blind $0.05
kätzi<3: posts big blind $0.10
*** HOLE CARDS ***
tortpoker: raises $0.20 to $0.30
kidmosy: folds 
marcin116: folds 
Mello_Ace: folds 
kätzi<3: calls $0.20
*** FLOP *** [3s 9d 6s]
kätzi<3: bets $0.30
tortpoker: raises $0.70 to $1
kätzi<3: raises $0.70 to $1.70
tortpoker: folds 
Uncalled bet ($0.70) returned to kätzi<3
kätzi<3 collected $2.53 from pot
kätzi<3: doesn't show hand 
*** SUMMARY ***
Total pot $2.65 | Rake $0.12 
Board [3s 9d 6s]
Seat 1: tortpoker folded on the Flop
Seat 2: kidmosy folded before Flop (didn't bet)
Seat 3: marcin116 (button) folded before Flop (didn't bet)
Seat 5: Mello_Ace (small blind) folded before Flop
Seat 6: kätzi<3 (big blind) collected ($2.53)



PokerStars Hand #222977604979:  Hold'em No Limit ($0.05/$0.10 USD) - 2021/01/23 18:24:54 ET
Table 'Stephano III' 6-max Seat #3 is the button
Seat 1: tortpoker ($13.34 in chips) 
Seat 2: perespell ($22.45 in chips) 
Seat 3: jammer35983 ($10.06 in chips) 
Seat 4: pondax ($10 in chips) 
Seat 5: dancayamanda ($17.08 in chips) 
Seat 6: Hannibal2018 ($14.41 in chips) 
pondax: posts small blind $0.05
dancayamanda: posts big blind $0.10
*** HOLE CARDS ***
Hannibal2018: folds 
tortpoker: folds 
perespell: folds 
jammer35983: calls $0.10
pondax: folds 
dancayamanda: checks 
*** FLOP *** [3d Ts 3h]
dancayamanda: checks 
jammer35983: checks 
*** TURN *** [3d Ts 3h] [Jc]
dancayamanda: checks 
jammer35983: bets $0.24
dancayamanda: folds 
Uncalled bet ($0.24) returned to jammer35983
jammer35983 collected $0.24 from pot
jammer35983: doesn't show hand 
*** SUMMARY ***
Total pot $0.25 | Rake $0.01 
Board [3d Ts 3h Jc]
Seat 1: tortpoker folded before Flop (didn't bet)
Seat 2: perespell folded before Flop (didn't bet)
Seat 3: jammer35983 (button) collected ($0.24)
Seat 4: pondax (small blind) folded before Flop
Seat 5: dancayamanda (big blind) folded on the Turn
Seat 6: Hannibal2018 folded before Flop (didn't bet)



PokerStars Hand #222977628560:  Hold'em No Limit ($0.05/$0.10 USD) - 2021/01/23 18:25:30 ET
Table 'Stephano III' 6-max Seat #4 is the button
Seat 1: tortpoker ($13.34 in chips) 
Seat 2: perespell ($22.45 in chips) 
Seat 3: jammer35983 ($10.20 in chips) 
Seat 4: pondax ($9.95 in chips) 
Seat 5: dancayamanda ($16.98 in chips) 
Seat 6: Hannibal2018 ($14.41 in chips) 
dancayamanda: posts small blind $0.05
Hannibal2018: posts big blind $0.10
*** HOLE CARDS ***
tortpoker: folds 
perespell: folds 
jammer35983: raises $0.25 to $0.35
pondax: folds 
dancayamanda: folds 
Hannibal2018: folds 
Uncalled bet ($0.25) returned to jammer35983
jammer35983 collected $0.25 from pot
jammer35983: doesn't show hand 
*** SUMMARY ***
Total pot $0.25 | Rake $0 
Seat 1: tortpoker folded before Flop (didn't bet)
Seat 2: perespell folded before Flop (didn't bet)
Seat 3: jammer35983 collected ($0.25)
Seat 4: pondax (button) folded before Flop (didn't bet)
Seat 5: dancayamanda (small blind) folded before Flop
Seat 6: Hannibal2018 (big blind) folded before Flop



PokerStars Hand #222977641240:  Hold'em No Limit ($0.05/$0.10 USD) - 2021/01/23 18:25:50 ET
Table 'Stephano III' 6-max Seat #5 is the button
Seat 1: tortpoker ($13.34 in chips) 
Seat 2: perespell ($22.45 in chips) 
Seat 3: jammer35983 ($10.35 in chips) 
Seat 4: pondax ($9.95 in chips) 
Seat 5: dancayamanda ($16.93 in chips) 
Seat 6: Hannibal2018 ($14.31 in chips) 
Hannibal2018: posts small blind $0.05
tortpoker: posts big blind $0.10
*** HOLE CARDS ***
perespell: folds 
jammer35983: calls $0.10
pondax: folds 
dancayamanda: folds 
Hannibal2018: folds 
tortpoker: checks 
*** FLOP *** [Tc 3s 9s]
tortpoker: checks 
jammer35983: checks 
*** TURN *** [Tc 3s 9s] [2d]
tortpoker: checks 
jammer35983: checks 
*** RIVER *** [Tc 3s 9s 2d] [8d]
tortpoker: checks 
jammer35983: checks 
*** SHOW DOWN ***
tortpoker: shows [7s 2s] (a pair of Deuces)
jammer35983: mucks hand 
tortpoker collected $0.24 from pot
*** SUMMARY ***
Total pot $0.25 | Rake $0.01 
Board [Tc 3s 9s 2d 8d]
Seat 1: tortpoker (big blind) showed [7s 2s] and won ($0.24) with a pair of Deuces
Seat 2: perespell folded before Flop (didn't bet)
Seat 3: jammer35983 mucked
Seat 4: pondax folded before Flop (didn't bet)
Seat 5: dancayamanda (button) folded before Flop (didn't bet)
Seat 6: Hannibal2018 (small blind) folded before Flop



PokerStars Hand #222977662674:  Hold'em No Limit ($0.05/$0.10 USD) - 2021/01/23 18:26:22 ET
Table 'Stephano III' 6-max Seat #6 is the button
Seat 1: tortpoker ($13.48 in chips) 
Seat 2: perespell ($22.45 in chips) 
Seat 3: jammer35983 ($10.25 in chips) 
Seat 4: pondax ($9.95 in chips) 
Seat 5: dancayamanda ($16.93 in chips) 
Seat 6: Hannibal2018 ($14.26 in chips) 
tortpoker: posts small blind $0.05
perespell: posts big blind $0.10
*** HOLE CARDS ***
jammer35983: folds 
pondax: folds 
dancayamanda: raises $0.15 to $0.25
Hannibal2018: folds 
tortpoker: folds 
perespell: folds 
Uncalled bet ($0.15) returned to dancayamanda
dancayamanda collected $0.25 from pot
*** SUMMARY ***
Total pot $0.25 | Rake $0 
Seat 1: tortpoker (small blind) folded before Flop
Seat 2: perespell (big blind) folded before Flop
Seat 3: jammer35983 folded before Flop (didn't bet)
Seat 4: pondax folded before Flop (didn't bet)
Seat 5: dancayamanda collected ($0.25)
Seat 6: Hannibal2018 (button) folded before Flop (didn't bet)



PokerStars Hand #222977675111:  Hold'em No Limit ($0.05/$0.10 USD) - 2021/01/23 18:26:41 ET
Table 'Stephano III' 6-max Seat #1 is the button
Seat 1: tortpoker ($13.43 in chips) 
Seat 2: perespell ($22.35 in chips) 
Seat 3: jammer35983 ($10.25 in chips) 
Seat 4: pondax ($9.95 in chips) 
Seat 5: dancayamanda ($17.08 in chips) 
Seat 6: Hannibal2018 ($14.26 in chips) 
perespell: posts small blind $0.05
jammer35983: posts big blind $0.10
*** HOLE CARDS ***
pondax: folds 
dancayamanda: folds 
Hannibal2018: folds 
tortpoker: folds 
perespell: folds 
Uncalled bet ($0.05) returned to jammer35983
jammer35983 collected $0.10 from pot
jammer35983: doesn't show hand 
*** SUMMARY ***
Total pot $0.10 | Rake $0 
Seat 1: tortpoker (button) folded before Flop (didn't bet)
Seat 2: perespell (small blind) folded before Flop
Seat 3: jammer35983 (big blind) collected ($0.10)
Seat 4: pondax folded before Flop (didn't bet)
Seat 5: dancayamanda folded before Flop (didn't bet)
Seat 6: Hannibal2018 folded before Flop (didn't bet)



PokerStars Hand #222977686057:  Hold'em No Limit ($0.05/$0.10 USD) - 2021/01/23 18:26:58 ET
Table 'Stephano III' 6-max Seat #2 is the button
Seat 1: tortpoker ($13.43 in chips) 
Seat 2: perespell ($22.30 in chips) 
Seat 3: jammer35983 ($10.30 in chips) 
Seat 4: pondax ($9.95 in chips) 
Seat 5: dancayamanda ($17.08 in chips) 
Seat 6: Hannibal2018 ($14.26 in chips) 
jammer35983: posts small blind $0.05
pondax: posts big blind $0.10
*** HOLE CARDS ***
dancayamanda: folds 
Hannibal2018: folds 
tortpoker: raises $0.20 to $0.30
perespell: folds 
jammer35983: raises $0.20 to $0.50
pondax: folds 
tortpoker: calls $0.20
*** FLOP *** [Jc 7d 5d]
jammer35983: checks 
tortpoker: bets $0.54
jammer35983: calls $0.54
*** TURN *** [Jc 7d 5d] [6h]
jammer35983: checks 
tortpoker: checks 
*** RIVER *** [Jc 7d 5d 6h] [2c]
jammer35983: bets $4.40
tortpoker: folds 
Uncalled bet ($4.40) returned to jammer35983
jammer35983 collected $2.08 from pot
jammer35983: doesn't show hand 
*** SUMMARY ***
Total pot $2.18 | Rake $0.10 
Board [Jc 7d 5d 6h 2c]
Seat 1: tortpoker folded on the River
Seat 2: perespell (button) folded before Flop (didn't bet)
Seat 3: jammer35983 (small blind) collected ($2.08)
Seat 4: pondax (big blind) folded before Flop
Seat 5: dancayamanda folded before Flop (didn't bet)
Seat 6: Hannibal2018 folded before Flop (didn't bet)



PokerStars Hand #222977713645:  Hold'em No Limit ($0.05/$0.10 USD) - 2021/01/23 18:27:40 ET
Table 'Stephano III' 6-max Seat #3 is the button
Seat 1: tortpoker ($12.39 in chips) 
Seat 2: perespell ($22.30 in chips) 
Seat 3: jammer35983 ($11.34 in chips) 
Seat 4: pondax ($10 in chips) 
Seat 5: dancayamanda ($17.08 in chips) 
Seat 6: Hannibal2018 ($14.26 in chips) 
pondax: posts small blind $0.05
dancayamanda: posts big blind $0.10
*** HOLE CARDS ***
Hannibal2018: folds 
tortpoker: raises $0.20 to $0.30
perespell: folds 
jammer35983: folds 
pondax: folds 
dancayamanda: calls $0.20
*** FLOP *** [9d Qs Th]
dancayamanda: checks 
tortpoker: checks 
*** TURN *** [9d Qs Th] [As]
dancayamanda: checks 
tortpoker: bets $0.32
dancayamanda: raises $1.58 to $1.90
tortpoker: folds 
Uncalled bet ($1.58) returned to dancayamanda
dancayamanda collected $1.23 from pot
dancayamanda: doesn't show hand 
*** SUMMARY ***
Total pot $1.29 | Rake $0.06 
Board [9d Qs Th As]
Seat 1: tortpoker folded on the Turn
Seat 2: perespell folded before Flop (didn't bet)
Seat 3: jammer35983 (button) folded before Flop (didn't bet)
Seat 4: pondax (small blind) folded before Flop
Seat 5: dancayamanda (big blind) collected ($1.23)
Seat 6: Hannibal2018 folded before Flop (didn't bet)



PokerStars Hand #222977752970:  Hold'em No Limit ($0.05/$0.10 USD) - 2021/01/23 18:28:40 ET
Table 'Stephano III' 6-max Seat #4 is the button
Seat 1: tortpoker ($11.77 in chips) 
Seat 2: perespell ($22.30 in chips) 
Seat 3: jammer35983 ($11.34 in chips) 
Seat 4: pondax ($9.95 in chips) 
Seat 5: dancayamanda ($17.69 in chips) 
Seat 6: Hannibal2018 ($14.26 in chips) 
dancayamanda: posts small blind $0.05
Hannibal2018: posts big blind $0.10
*** HOLE CARDS ***
tortpoker: folds 
perespell: folds 
jammer35983: calls $0.10
pondax: folds 
dancayamanda: folds 
Hannibal2018: checks 
*** FLOP *** [Ad Kh 5d]
Hannibal2018: checks 
jammer35983: checks 
*** TURN *** [Ad Kh 5d] [Kd]
Hannibal2018: checks 
jammer35983: checks 
*** RIVER *** [Ad Kh 5d Kd] [Kc]
Hannibal2018: checks 
jammer35983: checks 
*** SHOW DOWN ***
Hannibal2018: shows [9h 6s] (three of a kind, Kings)
jammer35983: mucks hand 
Hannibal2018 collected $0.24 from pot
*** SUMMARY ***
Total pot $0.25 | Rake $0.01 
Board [Ad Kh 5d Kd Kc]
Seat 1: tortpoker folded before Flop (didn't bet)
Seat 2: perespell folded before Flop (didn't bet)
Seat 3: jammer35983 mucked
Seat 4: pondax (button) folded before Flop (didn't bet)
Seat 5: dancayamanda (small blind) folded before Flop
Seat 6: Hannibal2018 (big blind) showed [9h 6s] and won ($0.24) with three of a kind, Kings



PokerStars Hand #222977769943:  Hold'em No Limit ($0.05/$0.10 USD) - 2021/01/23 18:29:06 ET
Table 'Stephano III' 6-max Seat #5 is the button
Seat 1: tortpoker ($11.77 in chips) 
Seat 2: perespell ($22.30 in chips) 
Seat 3: jammer35983 ($11.24 in chips) 
Seat 4: pondax ($9.95 in chips) 
Seat 5: dancayamanda ($17.64 in chips) 
Seat 6: Hannibal2018 ($14.40 in chips) 
Hannibal2018: posts small blind $0.05
tortpoker: posts big blind $0.10
*** HOLE CARDS ***
perespell: folds 
jammer35983: raises $0.25 to $0.35
pondax: folds 
dancayamanda: folds 
Hannibal2018: folds 
tortpoker: folds 
Uncalled bet ($0.25) returned to jammer35983
jammer35983 collected $0.25 from pot
jammer35983: doesn't show hand 
*** SUMMARY ***
Total pot $0.25 | Rake $0 
Seat 1: tortpoker (big blind) folded before Flop
Seat 2: perespell folded before Flop (didn't bet)
Seat 3: jammer35983 collected ($0.25)
Seat 4: pondax folded before Flop (didn't bet)
Seat 5: dancayamanda (button) folded before Flop (didn't bet)
Seat 6: Hannibal2018 (small blind) folded before Flop



PokerStars Hand #222977783526:  Hold'em No Limit ($0.05/$0.10 USD) - 2021/01/23 18:29:27 ET
Table 'Stephano III' 6-max Seat #6 is the button
Seat 1: tortpoker ($11.67 in chips) 
Seat 2: perespell ($22.30 in chips) 
Seat 3: jammer35983 ($11.39 in chips) 
Seat 4: pondax ($9.95 in chips) 
Seat 5: dancayamanda ($17.64 in chips) 
Seat 6: Hannibal2018 ($14.35 in chips) 
tortpoker: posts small blind $0.05
perespell: posts big blind $0.10
*** HOLE CARDS ***
jammer35983: raises $0.20 to $0.30
pondax: folds 
dancayamanda: folds 
Hannibal2018: folds 
tortpoker: folds 
perespell: folds 
Uncalled bet ($0.20) returned to jammer35983
jammer35983 collected $0.25 from pot
jammer35983: doesn't show hand 
*** SUMMARY ***
Total pot $0.25 | Rake $0 
Seat 1: tortpoker (small blind) folded before Flop
Seat 2: perespell (big blind) folded before Flop
Seat 3: jammer35983 collected ($0.25)
Seat 4: pondax folded before Flop (didn't bet)
Seat 5: dancayamanda folded before Flop (didn't bet)
Seat 6: Hannibal2018 (button) folded before Flop (didn't bet)



PokerStars Hand #222977797638:  Hold'em No Limit ($0.05/$0.10 USD) - 2021/01/23 18:29:49 ET
Table 'Stephano III' 6-max Seat #1 is the button
Seat 1: tortpoker ($11.62 in chips) 
Seat 2: perespell ($22.20 in chips) 
Seat 3: jammer35983 ($11.54 in chips) 
Seat 4: pondax ($9.95 in chips) 
Seat 5: dancayamanda ($17.64 in chips) 
Seat 6: Hannibal2018 ($14.35 in chips) 
perespell: posts small blind $0.05
jammer35983: posts big blind $0.10
*** HOLE CARDS ***
pondax: folds 
dancayamanda: folds 
dancayamanda leaves the table
Hannibal2018: folds 
tortpoker: raises $0.10 to $0.20
perespell: calls $0.15
jammer35983: calls $0.10
*** FLOP *** [Jc Qc 6s]
perespell: checks 
jammer35983: checks 
tortpoker: bets $0.29
perespell: folds 
jammer35983: calls $0.29
*** TURN *** [Jc Qc 6s] [7h]
jammer35983: checks 
tortpoker: bets $0.58
jammer35983: calls $0.58
*** RIVER *** [Jc Qc 6s 7h] [Th]
jammer35983: checks 
tortpoker: checks 
*** SHOW DOWN ***
jammer35983: shows [9c Tc] (a pair of Tens)
tortpoker: shows [4s Qs] (a pair of Queens)
tortpoker collected $2.23 from pot
*** SUMMARY ***
Total pot $2.34 | Rake $0.11 
Board [Jc Qc 6s 7h Th]
Seat 1: tortpoker (button) showed [4s Qs] and won ($2.23) with a pair of Queens
Seat 2: perespell (small blind) folded on the Flop
Seat 3: jammer35983 (big blind) showed [9c Tc] and lost with a pair of Tens
Seat 4: pondax folded before Flop (didn't bet)
Seat 5: dancayamanda folded before Flop (didn't bet)
Seat 6: Hannibal2018 folded before Flop (didn't bet)



PokerStars Hand #222977836184:  Hold'em No Limit ($0.05/$0.10 USD) - 2021/01/23 18:30:48 ET
Table 'Stephano III' 6-max Seat #2 is the button
Seat 1: tortpoker ($12.78 in chips) 
Seat 2: perespell ($22 in chips) 
Seat 3: jammer35983 ($10.47 in chips) 
Seat 4: pondax ($9.95 in chips) 
Seat 6: Hannibal2018 ($14.35 in chips) 
jammer35983: posts small blind $0.05
pondax: posts big blind $0.10
*** HOLE CARDS ***
Hannibal2018: folds 
tortpoker: folds 
perespell: folds 
jammer35983: raises $0.10 to $0.20
pondax: folds 
Uncalled bet ($0.10) returned to jammer35983
jammer35983 collected $0.20 from pot
jammer35983: doesn't show hand 
*** SUMMARY ***
Total pot $0.20 | Rake $0 
Seat 1: tortpoker folded before Flop (didn't bet)
Seat 2: perespell (button) folded before Flop (didn't bet)
Seat 3: jammer35983 (small blind) collected ($0.20)
Seat 4: pondax (big blind) folded before Flop
Seat 6: Hannibal2018 folded before Flop (didn't bet)



PokerStars Hand #222977845750:  Hold'em No Limit ($0.05/$0.10 USD) - 2021/01/23 18:31:03 ET
Table 'Stephano III' 6-max Seat #3 is the button
Seat 1: tortpoker ($12.78 in chips) 
Seat 2: perespell ($22 in chips) 
Seat 3: jammer35983 ($10.57 in chips) 
Seat 4: pondax ($10 in chips) 
Seat 6: Hannibal2018 ($14.35 in chips) 
pondax: posts small blind $0.05
Hannibal2018: posts big blind $0.10
*** HOLE CARDS ***
tortpoker: folds 
perespell: folds 
jammer35983: raises $0.10 to $0.20
pondax: folds 
Hannibal2018: calls $0.10
*** FLOP *** [2h Kh 5d]
Hannibal2018: checks 
jammer35983: checks 
*** TURN *** [2h Kh 5d] [3c]
Hannibal2018: checks 
jammer35983: checks 
*** RIVER *** [2h Kh 5d 3c] [Qc]
Hannibal2018: bets $0.21
jammer35983: raises $0.21 to $0.42
Hannibal2018: calls $0.21
*** SHOW DOWN ***
jammer35983: shows [Qh Tc] (a pair of Queens)
Hannibal2018: shows [Js Qs] (a pair of Queens - King+Jack kicker)
Hannibal2018 collected $1.23 from pot
*** SUMMARY ***
Total pot $1.29 | Rake $0.06 
Board [2h Kh 5d 3c Qc]
Seat 1: tortpoker folded before Flop (didn't bet)
Seat 2: perespell folded before Flop (didn't bet)
Seat 3: jammer35983 (button) showed [Qh Tc] and lost with a pair of Queens
Seat 4: pondax (small blind) folded before Flop
Seat 6: Hannibal2018 (big blind) showed [Js Qs] and won ($1.23) with a pair of Queens



PokerStars Hand #222977870423:  Hold'em No Limit ($0.05/$0.10 USD) - 2021/01/23 18:31:41 ET
Table 'Stephano III' 6-max Seat #4 is the button
Seat 1: tortpoker ($12.78 in chips) 
Seat 2: perespell ($22 in chips) 
Seat 3: jammer35983 ($9.95 in chips) 
Seat 4: pondax ($9.95 in chips) 
Seat 6: Hannibal2018 ($14.96 in chips) 
Hannibal2018: posts small blind $0.05
tortpoker: posts big blind $0.10
*** HOLE CARDS ***
perespell: raises $0.15 to $0.25
jammer35983: calls $0.25
pondax: folds 
Hannibal2018: folds 
tortpoker: folds 
*** FLOP *** [6s Qh Kh]
perespell: bets $0.32
jammer35983: calls $0.32
*** TURN *** [6s Qh Kh] [Ks]
perespell: bets $0.63
jammer35983: folds 
Uncalled bet ($0.63) returned to perespell
perespell collected $1.23 from pot
perespell: doesn't show hand 
*** SUMMARY ***
Total pot $1.29 | Rake $0.06 
Board [6s Qh Kh Ks]
Seat 1: tortpoker (big blind) folded before Flop
Seat 2: perespell collected ($1.23)
Seat 3: jammer35983 folded on the Turn
Seat 4: pondax (button) folded before Flop (didn't bet)
Seat 6: Hannibal2018 (small blind) folded before Flop



PokerStars Hand #222977889915:  Hold'em No Limit ($0.05/$0.10 USD) - 2021/01/23 18:32:10 ET
Table 'Stephano III' 6-max Seat #6 is the button
Seat 1: tortpoker ($12.68 in chips) 
Seat 2: perespell ($22.66 in chips) 
Seat 3: jammer35983 ($9.38 in chips) 
Seat 4: pondax ($9.95 in chips) 
Seat 6: Hannibal2018 ($14.91 in chips) 
tortpoker: posts small blind $0.05
perespell: posts big blind $0.10
*** HOLE CARDS ***
jammer35983: folds 
pondax: folds 
Hannibal2018: folds 
tortpoker: folds 
Uncalled bet ($0.05) returned to perespell
perespell collected $0.10 from pot
perespell: doesn't show hand 
*** SUMMARY ***
Total pot $0.10 | Rake $0 
Seat 1: tortpoker (small blind) folded before Flop
Seat 2: perespell (big blind) collected ($0.10)
Seat 3: jammer35983 folded before Flop (didn't bet)
Seat 4: pondax folded before Flop (didn't bet)
Seat 6: Hannibal2018 (button) folded before Flop (didn't bet)



PokerStars Hand #222977901871:  Hold'em No Limit ($0.05/$0.10 USD) - 2021/01/23 18:32:28 ET
Table 'Stephano III' 6-max Seat #1 is the button
Seat 1: tortpoker ($12.63 in chips) 
Seat 2: perespell ($22.71 in chips) 
Seat 3: jammer35983 ($9.38 in chips) 
Seat 4: pondax ($9.95 in chips) 
Seat 6: Hannibal2018 ($14.91 in chips) 
perespell: posts small blind $0.05
jammer35983: posts big blind $0.10
*** HOLE CARDS ***
pondax: folds 
Hannibal2018: calls $0.10
tortpoker: folds 
perespell: raises $0.15 to $0.25
jammer35983: folds 
Hannibal2018: calls $0.15
*** FLOP *** [5h 4c Qd]
perespell: checks 
Hannibal2018: bets $0.20
perespell: raises $0.40 to $0.60
Hannibal2018: folds 
Uncalled bet ($0.40) returned to perespell
perespell collected $0.96 from pot
perespell: doesn't show hand 
*** SUMMARY ***
Total pot $1 | Rake $0.04 
Board [5h 4c Qd]
Seat 1: tortpoker (button) folded before Flop (didn't bet)
Seat 2: perespell (small blind) collected ($0.96)
Seat 3: jammer35983 (big blind) folded before Flop
Seat 4: pondax folded before Flop (didn't bet)
Seat 6: Hannibal2018 folded on the Flop



PokerStars Hand #222977921917:  Hold'em No Limit ($0.05/$0.10 USD) - 2021/01/23 18:32:59 ET
Table 'Stephano III' 6-max Seat #2 is the button
Seat 1: tortpoker ($12.63 in chips) 
Seat 2: perespell ($23.22 in chips) 
Seat 3: jammer35983 ($9.28 in chips) 
Seat 4: pondax ($9.95 in chips) 
Seat 6: Hannibal2018 ($14.46 in chips) 
jammer35983: posts small blind $0.05
pondax: posts big blind $0.10
*** HOLE CARDS ***
Hannibal2018: raises $0.20 to $0.30
tortpoker: calls $0.30
perespell: folds 
jammer35983: calls $0.25
pondax: folds 
*** FLOP *** [Ad 8s 6c]
jammer35983: checks 
Hannibal2018: bets $0.48
tortpoker: folds 
jammer35983: calls $0.48
*** TURN *** [Ad 8s 6c] [5c]
jammer35983: checks 
Hannibal2018: checks 
*** RIVER *** [Ad 8s 6c 5c] [6d]
jammer35983: bets $1.87
Hannibal2018: folds 
Uncalled bet ($1.87) returned to jammer35983
jammer35983 collected $1.87 from pot
jammer35983: doesn't show hand 
*** SUMMARY ***
Total pot $1.96 | Rake $0.09 
Board [Ad 8s 6c 5c 6d]
Seat 1: tortpoker folded on the Flop
Seat 2: perespell (button) folded before Flop (didn't bet)
Seat 3: jammer35983 (small blind) collected ($1.87)
Seat 4: pondax (big blind) folded before Flop
Seat 6: Hannibal2018 folded on the River



PokerStars Hand #222977945431:  Hold'em No Limit ($0.05/$0.10 USD) - 2021/01/23 18:33:35 ET
Table 'Stephano III' 6-max Seat #3 is the button
Seat 1: tortpoker ($12.33 in chips) 
Seat 2: perespell ($23.22 in chips) 
Seat 3: jammer35983 ($10.37 in chips) 
Seat 4: pondax ($10 in chips) 
Seat 6: Hannibal2018 ($13.68 in chips) 
pondax: posts small blind $0.05
Hannibal2018: posts big blind $0.10
*** HOLE CARDS ***
tortpoker: folds 
perespell: folds 
jammer35983: calls $0.10
pondax: folds 
Hannibal2018: raises $0.20 to $0.30
jammer35983: calls $0.20
*** FLOP *** [8h 8d 4d]
Hannibal2018: bets $0.31
jammer35983: calls $0.31
*** TURN *** [8h 8d 4d] [7d]
Hannibal2018: bets $0.60
jammer35983: folds 
Uncalled bet ($0.60) returned to Hannibal2018
Hannibal2018 collected $1.21 from pot
*** SUMMARY ***
Total pot $1.27 | Rake $0.06 
Board [8h 8d 4d 7d]
Seat 1: tortpoker folded before Flop (didn't bet)
Seat 2: perespell folded before Flop (didn't bet)
Seat 3: jammer35983 (button) folded on the Turn
Seat 4: pondax (small blind) folded before Flop
Seat 6: Hannibal2018 (big blind) collected ($1.21)



PokerStars Hand #222977965265:  Hold'em No Limit ($0.05/$0.10 USD) - 2021/01/23 18:34:05 ET
Table 'Stephano III' 6-max Seat #6 is the button
Seat 1: tortpoker ($12.33 in chips) 
Seat 2: perespell ($23.22 in chips) 
Seat 3: jammer35983 ($9.76 in chips) 
Seat 6: Hannibal2018 ($14.28 in chips) 
tortpoker: posts small blind $0.05
perespell: posts big blind $0.10
*** HOLE CARDS ***
jammer35983: calls $0.10
Hannibal2018: raises $0.20 to $0.30
tortpoker: folds 
perespell: folds 
jammer35983: calls $0.20
*** FLOP *** [4c 5h 3h]
jammer35983: checks 
Hannibal2018: bets $0.72
jammer35983: folds 
Uncalled bet ($0.72) returned to Hannibal2018
Hannibal2018 collected $0.72 from pot
*** SUMMARY ***
Total pot $0.75 | Rake $0.03 
Board [4c 5h 3h]
Seat 1: tortpoker (small blind) folded before Flop
Seat 2: perespell (big blind) folded before Flop
Seat 3: jammer35983 folded on the Flop
Seat 6: Hannibal2018 (button) collected ($0.72)



PokerStars Hand #222977986492:  Hold'em No Limit ($0.05/$0.10 USD) - 2021/01/23 18:34:37 ET
Table 'Stephano III' 6-max Seat #1 is the button
Seat 1: tortpoker ($12.28 in chips) 
Seat 2: perespell ($23.12 in chips) 
Seat 3: jammer35983 ($9.46 in chips) 
Seat 6: Hannibal2018 ($14.70 in chips) 
perespell: posts small blind $0.05
jammer35983: posts big blind $0.10
*** HOLE CARDS ***
Hannibal2018: folds 
tortpoker: raises $0.20 to $0.30
perespell: folds 
jammer35983: folds 
Uncalled bet ($0.20) returned to tortpoker
tortpoker collected $0.25 from pot
tortpoker: doesn't show hand 
*** SUMMARY ***
Total pot $0.25 | Rake $0 
Seat 1: tortpoker (button) collected ($0.25)
Seat 2: perespell (small blind) folded before Flop
Seat 3: jammer35983 (big blind) folded before Flop
Seat 6: Hannibal2018 folded before Flop (didn't bet)



PokerStars Hand #222977994489:  Hold'em No Limit ($0.05/$0.10 USD) - 2021/01/23 18:34:50 ET
Table 'Stephano III' 6-max Seat #2 is the button
Seat 1: tortpoker ($12.43 in chips) 
Seat 2: perespell ($23.07 in chips) 
Seat 3: jammer35983 ($9.36 in chips) 
Seat 6: Hannibal2018 ($14.70 in chips) 
jammer35983: posts small blind $0.05
Hannibal2018: posts big blind $0.10
*** HOLE CARDS ***
tortpoker: raises $0.10 to $0.20
perespell: folds 
jammer35983: calls $0.15
Hannibal2018: calls $0.10
*** FLOP *** [Th 2c 9s]
jammer35983: checks 
Hannibal2018: checks 
tortpoker: checks 
*** TURN *** [Th 2c 9s] [7d]
jammer35983: checks 
Hannibal2018: checks 
tortpoker: checks 
*** RIVER *** [Th 2c 9s 7d] [5s]
jammer35983: checks 
Hannibal2018: checks 
tortpoker: checks 
*** SHOW DOWN ***
jammer35983: shows [8h Kc] (high card King)
Hannibal2018: shows [As 2h] (a pair of Deuces)
tortpoker: shows [7h Kh] (a pair of Sevens)
tortpoker collected $0.57 from pot
*** SUMMARY ***
Total pot $0.60 | Rake $0.03 
Board [Th 2c 9s 7d 5s]
Seat 1: tortpoker showed [7h Kh] and won ($0.57) with a pair of Sevens
Seat 2: perespell (button) folded before Flop (didn't bet)
Seat 3: jammer35983 (small blind) showed [8h Kc] and lost with high card King
Seat 6: Hannibal2018 (big blind) showed [As 2h] and lost with a pair of Deuces



PokerStars Hand #222978022784:  Hold'em No Limit ($0.05/$0.10 USD) - 2021/01/23 18:35:33 ET
Table 'Stephano III' 6-max Seat #3 is the button
Seat 2: perespell ($23.07 in chips) 
Seat 3: jammer35983 ($9.16 in chips) 
Seat 6: Hannibal2018 ($14.50 in chips) 
Hannibal2018: posts small blind $0.05
tortpoker: is sitting out 
perespell: posts big blind $0.10
*** HOLE CARDS ***
jammer35983: calls $0.10
Hannibal2018: calls $0.05
perespell: checks 
*** FLOP *** [6d Ah 7d]
Hannibal2018: checks 
perespell: bets $0.15
jammer35983: folds 
Hannibal2018: folds 
Uncalled bet ($0.15) returned to perespell
perespell collected $0.29 from pot
perespell: doesn't show hand 
*** SUMMARY ***
Total pot $0.30 | Rake $0.01 
Board [6d Ah 7d]
Seat 2: perespell (big blind) collected ($0.29)
Seat 3: jammer35983 (button) folded on the Flop
Seat 6: Hannibal2018 (small blind) folded on the Flop



PokerStars Hand #222978048323:  Hold'em No Limit ($0.05/$0.10 USD) - 2021/01/23 18:36:12 ET
Table 'Stephano III' 6-max Seat #6 is the button
Seat 2: perespell ($23.26 in chips) 
Seat 3: jammer35983 ($9.06 in chips) 
Seat 6: Hannibal2018 ($14.40 in chips) 
perespell: posts small blind $0.05
jammer35983: posts big blind $0.10
pondax: sits out 
*** HOLE CARDS ***
Hannibal2018: folds 
perespell: folds 
Uncalled bet ($0.05) returned to jammer35983
jammer35983 collected $0.10 from pot
jammer35983: doesn't show hand 
*** SUMMARY ***
Total pot $0.10 | Rake $0 
Seat 2: perespell (small blind) folded before Flop
Seat 3: jammer35983 (big blind) collected ($0.10)
Seat 6: Hannibal2018 (button) folded before Flop (didn't bet)



PokerStars Hand #222978054017:  Hold'em No Limit ($0.05/$0.10 USD) - 2021/01/23 18:36:21 ET
Table 'Stephano III' 6-max Seat #2 is the button
Seat 2: perespell ($23.21 in chips) 
Seat 3: jammer35983 ($9.11 in chips) 
Seat 4: pondax ($9.95 in chips) 
Seat 6: Hannibal2018 ($14.40 in chips) 
jammer35983: posts small blind $0.05
pondax: posts big blind $0.10
*** HOLE CARDS ***
Hannibal2018: folds 
perespell: folds 
jammer35983: calls $0.05
pondax: raises $0.60 to $0.70
Mello_Ace joins the table at seat #5 
jammer35983: calls $0.60
*** FLOP *** [2c 9d 2s]
jammer35983: checks 
pondax: bets $0.80
jammer35983: folds 
Uncalled bet ($0.80) returned to pondax
pondax collected $1.34 from pot
pondax: doesn't show hand 
*** SUMMARY ***
Total pot $1.40 | Rake $0.06 
Board [2c 9d 2s]
Seat 2: perespell (button) folded before Flop (didn't bet)
Seat 3: jammer35983 (small blind) folded on the Flop
Seat 4: pondax (big blind) collected ($1.34)
Seat 6: Hannibal2018 folded before Flop (didn't bet)



PokerStars Hand #222978090613:  Hold'em No Limit ($0.05/$0.10 USD) - 2021/01/23 18:37:18 ET
Table 'Stephano III' 6-max Seat #3 is the button
Seat 2: perespell ($23.21 in chips) 
Seat 3: jammer35983 ($8.41 in chips) 
Seat 4: pondax ($10.59 in chips) 
Seat 5: Mello_Ace ($5.36 in chips) 
Seat 6: Hannibal2018 ($14.40 in chips) 
pondax: posts small blind $0.05
Mello_Ace: posts big blind $0.10
*** HOLE CARDS ***
Hannibal2018: folds 
perespell: raises $0.15 to $0.25
jammer35983: calls $0.25
pondax: folds 
Mello_Ace: calls $0.15
*** FLOP *** [8d 6d 5s]
Mello_Ace: bets $0.38
perespell: folds 
jammer35983: folds 
Uncalled bet ($0.38) returned to Mello_Ace
Mello_Ace collected $0.76 from pot
Mello_Ace: doesn't show hand 
*** SUMMARY ***
Total pot $0.80 | Rake $0.04 
Board [8d 6d 5s]
Seat 2: perespell folded on the Flop
Seat 3: jammer35983 (button) folded on the Flop
Seat 4: pondax (small blind) folded before Flop
Seat 5: Mello_Ace (big blind) collected ($0.76)
Seat 6: Hannibal2018 folded before Flop (didn't bet)



PokerStars Hand #222978113040:  Hold'em No Limit ($0.05/$0.10 USD) - 2021/01/23 18:37:53 ET
Table 'Stephano III' 6-max Seat #4 is the button
Seat 2: perespell ($22.96 in chips) 
Seat 3: jammer35983 ($8.16 in chips) 
Seat 4: pondax ($10.54 in chips) 
Seat 5: Mello_Ace ($5.87 in chips) 
Seat 6: Hannibal2018 ($14.40 in chips) 
Mello_Ace: posts small blind $0.05
Hannibal2018: posts big blind $0.10
*** HOLE CARDS ***
perespell: folds 
jammer35983: raises $0.10 to $0.20
pondax: folds 
Mello_Ace: calls $0.15
Hannibal2018: calls $0.10
*** FLOP *** [Ad As 3c]
Mello_Ace: bets $0.10
Hannibal2018: folds 
jammer35983: folds 
Uncalled bet ($0.10) returned to Mello_Ace
Mello_Ace collected $0.57 from pot
Mello_Ace: doesn't show hand 
*** SUMMARY ***
Total pot $0.60 | Rake $0.03 
Board [Ad As 3c]
Seat 2: perespell folded before Flop (didn't bet)
Seat 3: jammer35983 folded on the Flop
Seat 4: pondax (button) folded before Flop (didn't bet)
Seat 5: Mello_Ace (small blind) collected ($0.57)
Seat 6: Hannibal2018 (big blind) folded on the Flop



PokerStars Hand #222978138997:  Hold'em No Limit ($0.05/$0.10 USD) - 2021/01/23 18:38:33 ET
Table 'Stephano III' 6-max Seat #5 is the button
Seat 2: perespell ($22.96 in chips) 
Seat 3: jammer35983 ($7.96 in chips) 
Seat 4: pondax ($10.54 in chips) 
Seat 5: Mello_Ace ($6.24 in chips) 
Seat 6: Hannibal2018 ($14.20 in chips) 
Hannibal2018: posts small blind $0.05
perespell: posts big blind $0.10
*** HOLE CARDS ***
jammer35983: raises $0.10 to $0.20
pondax: folds 
Mello_Ace: folds 
Hannibal2018: folds 
perespell: calls $0.10
*** FLOP *** [Td Ts 4s]
perespell: checks 
jammer35983: checks 
*** TURN *** [Td Ts 4s] [7s]
perespell: checks 
jammer35983: bets $0.43
perespell: folds 
Uncalled bet ($0.43) returned to jammer35983
jammer35983 collected $0.43 from pot
jammer35983: doesn't show hand 
*** SUMMARY ***
Total pot $0.45 | Rake $0.02 
Board [Td Ts 4s 7s]
Seat 2: perespell (big blind) folded on the Turn
Seat 3: jammer35983 collected ($0.43)
Seat 4: pondax folded before Flop (didn't bet)
Seat 5: Mello_Ace (button) folded before Flop (didn't bet)
Seat 6: Hannibal2018 (small blind) folded before Flop



PokerStars Hand #222978166060:  Hold'em No Limit ($0.05/$0.10 USD) - 2021/01/23 18:39:15 ET
Table 'Stephano III' 6-max Seat #6 is the button
Seat 2: perespell ($22.76 in chips) 
Seat 3: jammer35983 ($8.19 in chips) 
Seat 4: pondax ($10.54 in chips) 
Seat 5: Mello_Ace ($6.24 in chips) 
Seat 6: Hannibal2018 ($14.15 in chips) 
perespell: posts small blind $0.05
jammer35983: posts big blind $0.10
*** HOLE CARDS ***
pondax: folds 
Mello_Ace: calls $0.10
Hannibal2018: raises $0.20 to $0.30
perespell: folds 
jammer35983: calls $0.20
Mello_Ace: calls $0.20
*** FLOP *** [Td 7d 6d]
jammer35983: checks 
Mello_Ace: checks 
Hannibal2018: checks 
*** TURN *** [Td 7d 6d] [8d]
jammer35983: checks 
Mello_Ace: bets $0.10
Hannibal2018: folds 
jammer35983: raises $0.10 to $0.20
Mello_Ace: calls $0.10
*** RIVER *** [Td 7d 6d 8d] [9h]
jammer35983: bets $1.29
Mello_Ace: calls $1.29
*** SHOW DOWN ***
jammer35983: shows [Ah 9d] (a straight flush, Six to Ten)
Mello_Ace: mucks hand 
jammer35983 collected $3.75 from pot
*** SUMMARY ***
Total pot $3.93 | Rake $0.18 
Board [Td 7d 6d 8d 9h]
Seat 2: perespell (small blind) folded before Flop
Seat 3: jammer35983 (big blind) showed [Ah 9d] and won ($3.75) with a straight flush, Six to Ten
Seat 4: pondax folded before Flop (didn't bet)
Seat 5: Mello_Ace mucked
Seat 6: Hannibal2018 (button) folded on the Turn



PokerStars Hand #222978200351:  Hold'em No Limit ($0.05/$0.10 USD) - 2021/01/23 18:40:09 ET
Table 'Stephano III' 6-max Seat #2 is the button
Seat 2: perespell ($22.71 in chips) 
Seat 3: jammer35983 ($10.15 in chips) 
Seat 4: pondax ($10.54 in chips) 
Seat 5: Mello_Ace ($4.45 in chips) 
Seat 6: Hannibal2018 ($13.85 in chips) 
jammer35983: posts small blind $0.05
pondax: posts big blind $0.10
*** HOLE CARDS ***
Mello_Ace: folds 
Hannibal2018: folds 
perespell: folds 
jammer35983: calls $0.05
pondax: checks 
*** FLOP *** [Jh 5h Tc]
jammer35983: checks 
pondax: checks 
*** TURN *** [Jh 5h Tc] [4h]
jammer35983: checks 
pondax: checks 
*** RIVER *** [Jh 5h Tc 4h] [Js]
jammer35983: checks 
pondax: checks 
*** SHOW DOWN ***
jammer35983: shows [Qs 3d] (a pair of Jacks)
pondax: mucks hand 
jammer35983 collected $0.19 from pot
*** SUMMARY ***
Total pot $0.20 | Rake $0.01 
Board [Jh 5h Tc 4h Js]
Seat 2: perespell (button) folded before Flop (didn't bet)
Seat 3: jammer35983 (small blind) showed [Qs 3d] and won ($0.19) with a pair of Jacks
Seat 4: pondax (big blind) mucked
Seat 5: Mello_Ace folded before Flop (didn't bet)
Seat 6: Hannibal2018 folded before Flop (didn't bet)



PokerStars Hand #222978227750:  Hold'em No Limit ($0.05/$0.10 USD) - 2021/01/23 18:40:52 ET
Table 'Stephano III' 6-max Seat #3 is the button
Seat 2: perespell ($22.71 in chips) 
Seat 3: jammer35983 ($10.24 in chips) 
Seat 4: pondax ($10.44 in chips) 
Seat 5: Mello_Ace ($4.45 in chips) 
Seat 6: Hannibal2018 ($13.85 in chips) 
pondax: posts small blind $0.05
Mello_Ace: posts big blind $0.10
*** HOLE CARDS ***
Hannibal2018: folds 
perespell: folds 
jammer35983: calls $0.10
pondax: folds 
Mello_Ace: checks 
*** FLOP *** [Kd 7s 4s]
Mello_Ace: checks 
jammer35983: checks 
*** TURN *** [Kd 7s 4s] [7h]
Mello_Ace: bets $0.10
jammer35983: folds 
Uncalled bet ($0.10) returned to Mello_Ace
Mello_Ace collected $0.24 from pot
Mello_Ace: doesn't show hand 
*** SUMMARY ***
Total pot $0.25 | Rake $0.01 
Board [Kd 7s 4s 7h]
Seat 2: perespell folded before Flop (didn't bet)
Seat 3: jammer35983 (button) folded on the Turn
Seat 4: pondax (small blind) folded before Flop
Seat 5: Mello_Ace (big blind) collected ($0.24)
Seat 6: Hannibal2018 folded before Flop (didn't bet)



PokerStars Hand #222978242844:  Hold'em No Limit ($0.05/$0.10 USD) - 2021/01/23 18:41:16 ET
Table 'Stephano III' 6-max Seat #4 is the button
Seat 2: perespell ($22.71 in chips) 
Seat 3: jammer35983 ($10.14 in chips) 
Seat 4: pondax ($10.39 in chips) 
Seat 5: Mello_Ace ($4.59 in chips) 
Seat 6: Hannibal2018 ($13.85 in chips) 
Mello_Ace: posts small blind $0.05
Hannibal2018: posts big blind $0.10
*** HOLE CARDS ***
perespell: folds 
jammer35983: folds 
pondax: raises $0.20 to $0.30
Mello_Ace: folds 
Hannibal2018: calls $0.20
*** FLOP *** [3d Ac Jc]
Hannibal2018: bets $0.31
pondax: raises $1.89 to $2.20
Hannibal2018: folds 
Uncalled bet ($1.89) returned to pondax
pondax collected $1.21 from pot
pondax: doesn't show hand 
*** SUMMARY ***
Total pot $1.27 | Rake $0.06 
Board [3d Ac Jc]
Seat 2: perespell folded before Flop (didn't bet)
Seat 3: jammer35983 folded before Flop (didn't bet)
Seat 4: pondax (button) collected ($1.21)
Seat 5: Mello_Ace (small blind) folded before Flop
Seat 6: Hannibal2018 (big blind) folded on the Flop



PokerStars Hand #222978258973:  Hold'em No Limit ($0.05/$0.10 USD) - 2021/01/23 18:41:41 ET
Table 'Stephano III' 6-max Seat #5 is the button
Seat 3: jammer35983 ($10.14 in chips) 
Seat 4: pondax ($10.99 in chips) 
Seat 5: Mello_Ace ($4.54 in chips) 
Seat 6: Hannibal2018 ($13.24 in chips) 
Hannibal2018: posts small blind $0.05
perespell: is sitting out 
jammer35983: posts big blind $0.10
*** HOLE CARDS ***
pondax: folds 
perespell leaves the table
Mello_Ace: calls $0.10
Hannibal2018: raises $0.20 to $0.30
jammer35983: folds 
Mello_Ace: calls $0.20
*** FLOP *** [Ad 7c Td]
jammer35983 leaves the table
Hannibal2018: bets $0.33
Mello_Ace: calls $0.33
*** TURN *** [Ad 7c Td] [Qc]
Hannibal2018: bets $0.65
Mello_Ace: calls $0.65
*** RIVER *** [Ad 7c Td Qc] [6s]
Hannibal2018: bets $1.27
Mello_Ace: folds 
Uncalled bet ($1.27) returned to Hannibal2018
Hannibal2018 collected $2.54 from pot
*** SUMMARY ***
Total pot $2.66 | Rake $0.12 
Board [Ad 7c Td Qc 6s]
Seat 3: jammer35983 (big blind) folded before Flop
Seat 4: pondax folded before Flop (didn't bet)
Seat 5: Mello_Ace (button) folded on the River
Seat 6: Hannibal2018 (small blind) collected ($2.54)



PokerStars Hand #222978288245:  Hold'em No Limit ($0.05/$0.10 USD) - 2021/01/23 18:42:13 ET
Table 'Stephano III' 6-max Seat #6 is the button
Seat 4: pondax ($10.99 in chips) 
Seat 5: Mello_Ace ($3.26 in chips) 
Seat 6: Hannibal2018 ($14.50 in chips) 
pondax: posts small blind $0.05
Mello_Ace: posts big blind $0.10
*** HOLE CARDS ***
Hannibal2018: folds 
pondax: folds 
Uncalled bet ($0.05) returned to Mello_Ace
Mello_Ace collected $0.10 from pot
Mello_Ace: doesn't show hand 
*** SUMMARY ***
Total pot $0.10 | Rake $0 
Seat 4: pondax (small blind) folded before Flop
Seat 5: Mello_Ace (big blind) collected ($0.10)
Seat 6: Hannibal2018 (button) folded before Flop (didn't bet)



PokerStars Hand #222980208439:  Hold'em No Limit ($0.05/$0.10 USD) - 2021/01/23 19:39:43 ET
Table 'Stephano III' 6-max Seat #5 is the button
Seat 1: tortpoker ($16.71 in chips) 
Seat 2: kidmosy ($10.08 in chips) 
Seat 3: marcin116 ($10.26 in chips) 
Seat 5: Mello_Ace ($1.69 in chips) 
Seat 6: kätzi<3 ($13.60 in chips) 
kätzi<3: posts small blind $0.05
tortpoker: posts big blind $0.10
*** HOLE CARDS ***
kidmosy: folds 
marcin116: raises $0.25 to $0.35
Mello_Ace: calls $0.35
kätzi<3: calls $0.30
tortpoker: folds 
*** FLOP *** [5d 7c 2c]
kätzi<3: bets $0.70
marcin116: folds 
Mello_Ace: raises $0.64 to $1.34 and is all-in
kätzi<3: calls $0.64
*** TURN *** [5d 7c 2c] [9c]
*** RIVER *** [5d 7c 2c 9c] [5h]
*** SHOW DOWN ***
kätzi<3: shows [Tc Jc] (a flush, Jack high)
Mello_Ace: shows [7s 7d] (a full house, Sevens full of Fives)
Mello_Ace collected $3.66 from pot
*** SUMMARY ***
Total pot $3.83 | Rake $0.17 
Board [5d 7c 2c 9c 5h]
Seat 1: tortpoker (big blind) folded before Flop
Seat 2: kidmosy folded before Flop (didn't bet)
Seat 3: marcin116 folded on the Flop
Seat 5: Mello_Ace (button) showed [7s 7d] and won ($3.66) with a full house, Sevens full of Fives
Seat 6: kätzi<3 (small blind) showed [Tc Jc] and lost with a flush, Jack high



PokerStars Hand #222980239319:  Hold'em No Limit ($0.05/$0.10 USD) - 2021/01/23 19:40:45 ET
Table 'Stephano III' 6-max Seat #6 is the button
Seat 1: tortpoker ($16.61 in chips) 
Seat 2: kidmosy ($10.08 in chips) 
Seat 3: marcin116 ($10 in chips) 
Seat 5: Mello_Ace ($3.66 in chips) 
Seat 6: kätzi<3 ($11.91 in chips) 
tortpoker: posts small blind $0.05
kidmosy: posts big blind $0.10
*** HOLE CARDS ***
marcin116: folds 
Mello_Ace: folds 
kätzi<3: folds 
tortpoker: folds 
Uncalled bet ($0.05) returned to kidmosy
kidmosy collected $0.10 from pot
kidmosy: doesn't show hand 
*** SUMMARY ***
Total pot $0.10 | Rake $0 
Seat 1: tortpoker (small blind) folded before Flop
Seat 2: kidmosy (big blind) collected ($0.10)
Seat 3: marcin116 folded before Flop (didn't bet)
Seat 5: Mello_Ace folded before Flop (didn't bet)
Seat 6: kätzi<3 (button) folded before Flop (didn't bet)



PokerStars Hand #222980247842:  Hold'em No Limit ($0.05/$0.10 USD) - 2021/01/23 19:41:02 ET
Table 'Stephano III' 6-max Seat #1 is the button
Seat 1: tortpoker ($16.56 in chips) 
Seat 2: kidmosy ($10.13 in chips) 
Seat 3: marcin116 ($10 in chips) 
Seat 5: Mello_Ace ($3.66 in chips) 
Seat 6: kätzi<3 ($11.91 in chips) 
kidmosy: posts small blind $0.05
marcin116: posts big blind $0.10
*** HOLE CARDS ***
Mello_Ace: calls $0.10
kätzi<3: folds 
tortpoker: raises $0.50 to $0.60
kidmosy: folds 
marcin116: folds 
Mello_Ace: folds 
Uncalled bet ($0.50) returned to tortpoker
tortpoker collected $0.35 from pot
tortpoker: doesn't show hand 
*** SUMMARY ***
Total pot $0.35 | Rake $0 
Seat 1: tortpoker (button) collected ($0.35)
Seat 2: kidmosy (small blind) folded before Flop
Seat 3: marcin116 (big blind) folded before Flop
Seat 5: Mello_Ace folded before Flop
Seat 6: kätzi<3 folded before Flop (didn't bet)



PokerStars Hand #222980255900:  Hold'em No Limit ($0.05/$0.10 USD) - 2021/01/23 19:41:19 ET
Table 'Stephano III' 6-max Seat #2 is the button
Seat 1: tortpoker ($16.81 in chips) 
Seat 2: kidmosy ($10.08 in chips) 
Seat 3: marcin116 ($10 in chips) 
Seat 5: Mello_Ace ($3.56 in chips) 
Seat 6: kätzi<3 ($11.91 in chips) 
marcin116: posts small blind $0.05
Mello_Ace: posts big blind $0.10
*** HOLE CARDS ***
kätzi<3: folds 
tortpoker: folds 
kidmosy: raises $0.15 to $0.25
marcin116: folds 
Mello_Ace: calls $0.15
*** FLOP *** [Qd 8s 4d]
Mello_Ace: checks 
kidmosy: bets $0.20
Mello_Ace: folds 
Uncalled bet ($0.20) returned to kidmosy
kidmosy collected $0.53 from pot
kidmosy: doesn't show hand 
*** SUMMARY ***
Total pot $0.55 | Rake $0.02 
Board [Qd 8s 4d]
Seat 1: tortpoker folded before Flop (didn't bet)
Seat 2: kidmosy (button) collected ($0.53)
Seat 3: marcin116 (small blind) folded before Flop
Seat 5: Mello_Ace (big blind) folded on the Flop
Seat 6: kätzi<3 folded before Flop (didn't bet)



PokerStars Hand #222980267460:  Hold'em No Limit ($0.05/$0.10 USD) - 2021/01/23 19:41:42 ET
Table 'Stephano III' 6-max Seat #3 is the button
Seat 1: tortpoker ($16.81 in chips) 
Seat 3: marcin116 ($10 in chips) 
Seat 5: Mello_Ace ($3.31 in chips) 
Seat 6: kätzi<3 ($11.91 in chips) 
Mello_Ace: posts small blind $0.05
kätzi<3: posts big blind $0.10
*** HOLE CARDS ***
kidmosy leaves the table
tortpoker: folds 
marcin116: folds 
Mello_Ace: folds 
Uncalled bet ($0.05) returned to kätzi<3
kätzi<3 collected $0.10 from pot
kätzi<3: doesn't show hand 
*** SUMMARY ***
Total pot $0.10 | Rake $0 
Seat 1: tortpoker folded before Flop (didn't bet)
Seat 3: marcin116 (button) folded before Flop (didn't bet)
Seat 5: Mello_Ace (small blind) folded before Flop
Seat 6: kätzi<3 (big blind) collected ($0.10)



PokerStars Hand #222980270140:  Hold'em No Limit ($0.05/$0.10 USD) - 2021/01/23 19:41:47 ET
Table 'Stephano III' 6-max Seat #5 is the button
Seat 1: tortpoker ($16.81 in chips) 
Seat 3: marcin116 ($10 in chips) 
Seat 5: Mello_Ace ($3.26 in chips) 
Seat 6: kätzi<3 ($11.96 in chips) 
kätzi<3: posts small blind $0.05
tortpoker: posts big blind $0.10
*** HOLE CARDS ***
André3001 joins the table at seat #2 
marcin116: folds 
Mello_Ace: calls $0.10
kätzi<3: calls $0.05
tortpoker: checks 
*** FLOP *** [4c 9c 3s]
kätzi<3: bets $0.40
tortpoker: folds 
Mello_Ace: calls $0.40
*** TURN *** [4c 9c 3s] [2d]
kätzi<3: bets $0.40
Mello_Ace: calls $0.40
*** RIVER *** [4c 9c 3s 2d] [Td]
kätzi<3: bets $1.30
Mello_Ace: folds 
Uncalled bet ($1.30) returned to kätzi<3
kätzi<3 collected $1.81 from pot
kätzi<3: doesn't show hand 
*** SUMMARY ***
Total pot $1.90 | Rake $0.09 
Board [4c 9c 3s 2d Td]
Seat 1: tortpoker (big blind) folded on the Flop
Seat 3: marcin116 folded before Flop (didn't bet)
Seat 5: Mello_Ace (button) folded on the River
Seat 6: kätzi<3 (small blind) collected ($1.81)



PokerStars Hand #222980305033:  Hold'em No Limit ($0.05/$0.10 USD) - 2021/01/23 19:42:58 ET
Table 'Stephano III' 6-max Seat #6 is the button
Seat 1: tortpoker ($16.71 in chips) 
Seat 2: André3001 ($10 in chips) 
Seat 3: marcin116 ($10 in chips) 
Seat 5: Mello_Ace ($2.36 in chips) 
Seat 6: kätzi<3 ($12.87 in chips) 
tortpoker: posts small blind $0.05
André3001: posts big blind $0.10
zebaztravez: sits out 
*** HOLE CARDS ***
marcin116: folds 
Mello_Ace: calls $0.10
kätzi<3: folds 
tortpoker: folds 
André3001: checks 
*** FLOP *** [Kc 5c Ac]
André3001: checks 
Mello_Ace: checks 
*** TURN *** [Kc 5c Ac] [5h]
André3001: bets $0.20
Mello_Ace: calls $0.20
*** RIVER *** [Kc 5c Ac 5h] [3h]
André3001: checks 
Mello_Ace: bets $0.31
André3001: folds 
Uncalled bet ($0.31) returned to Mello_Ace
Mello_Ace collected $0.62 from pot
Mello_Ace: doesn't show hand 
*** SUMMARY ***
Total pot $0.65 | Rake $0.03 
Board [Kc 5c Ac 5h 3h]
Seat 1: tortpoker (small blind) folded before Flop
Seat 2: André3001 (big blind) folded on the River
Seat 3: marcin116 folded before Flop (didn't bet)
Seat 5: Mello_Ace collected ($0.62)
Seat 6: kätzi<3 (button) folded before Flop (didn't bet)



PokerStars Hand #222980318887:  Hold'em No Limit ($0.05/$0.10 USD) - 2021/01/23 19:43:27 ET
Table 'Stephano III' 6-max Seat #1 is the button
Seat 1: tortpoker ($16.66 in chips) 
Seat 2: André3001 ($10 in chips) 
Seat 3: marcin116 ($10 in chips) 
Seat 5: Mello_Ace ($2.68 in chips) 
Seat 6: kätzi<3 ($12.87 in chips) 
André3001: posts small blind $0.05
marcin116: posts big blind $0.10
zebaztravez: sits out 
*** HOLE CARDS ***
Mello_Ace: folds 
kätzi<3: folds 
tortpoker: raises $0.20 to $0.30
André3001: folds 
marcin116: folds 
Uncalled bet ($0.20) returned to tortpoker
tortpoker collected $0.25 from pot
tortpoker: doesn't show hand 
*** SUMMARY ***
Total pot $0.25 | Rake $0 
Seat 1: tortpoker (button) collected ($0.25)
Seat 2: André3001 (small blind) folded before Flop
Seat 3: marcin116 (big blind) folded before Flop
Seat 5: Mello_Ace folded before Flop (didn't bet)
Seat 6: kätzi<3 folded before Flop (didn't bet)



PokerStars Hand #222980326011:  Hold'em No Limit ($0.05/$0.10 USD) - 2021/01/23 19:43:41 ET
Table 'Stephano III' 6-max Seat #2 is the button
Seat 1: tortpoker ($16.81 in chips) 
Seat 2: André3001 ($9.95 in chips) 
Seat 3: marcin116 ($10 in chips) 
Seat 4: zebaztravez ($11.48 in chips) 
Seat 5: Mello_Ace ($2.68 in chips) 
Seat 6: kätzi<3 ($12.87 in chips) 
marcin116: posts small blind $0.05
zebaztravez: posts big blind $0.10
*** HOLE CARDS ***
Mello_Ace: folds 
kätzi<3: folds 
tortpoker: folds 
André3001: raises $0.20 to $0.30
marcin116: folds 
zebaztravez: folds 
Uncalled bet ($0.20) returned to André3001
André3001 collected $0.25 from pot
André3001: doesn't show hand 
*** SUMMARY ***
Total pot $0.25 | Rake $0 
Seat 1: tortpoker folded before Flop (didn't bet)
Seat 2: André3001 (button) collected ($0.25)
Seat 3: marcin116 (small blind) folded before Flop
Seat 4: zebaztravez (big blind) folded before Flop
Seat 5: Mello_Ace folded before Flop (didn't bet)
Seat 6: kätzi<3 folded before Flop (didn't bet)



PokerStars Hand #222980333517:  Hold'em No Limit ($0.05/$0.10 USD) - 2021/01/23 19:43:56 ET
Table 'Stephano III' 6-max Seat #3 is the button
Seat 1: tortpoker ($16.81 in chips) 
Seat 2: André3001 ($10.10 in chips) 
Seat 3: marcin116 ($10 in chips) 
Seat 4: zebaztravez ($11.38 in chips) 
Seat 5: Mello_Ace ($2.68 in chips) 
Seat 6: kätzi<3 ($12.87 in chips) 
zebaztravez: posts small blind $0.05
Mello_Ace: posts big blind $0.10
*** HOLE CARDS ***
kätzi<3: folds 
tortpoker: folds 
André3001: raises $0.20 to $0.30
marcin116: folds 
zebaztravez: folds 
Mello_Ace: calls $0.20
*** FLOP *** [9d 6d 3h]
Mello_Ace: checks 
André3001: bets $0.30
Mello_Ace: calls $0.30
*** TURN *** [9d 6d 3h] [8d]
Mello_Ace: checks 
André3001: checks 
*** RIVER *** [9d 6d 3h 8d] [6c]
Mello_Ace: bets $0.60
André3001: raises $8.90 to $9.50 and is all-in
Mello_Ace: folds 
Uncalled bet ($8.90) returned to André3001
André3001 collected $2.34 from pot
André3001: doesn't show hand 
*** SUMMARY ***
Total pot $2.45 | Rake $0.11 
Board [9d 6d 3h 8d 6c]
Seat 1: tortpoker folded before Flop (didn't bet)
Seat 2: André3001 collected ($2.34)
Seat 3: marcin116 (button) folded before Flop (didn't bet)
Seat 4: zebaztravez (small blind) folded before Flop
Seat 5: Mello_Ace (big blind) folded on the River
Seat 6: kätzi<3 folded before Flop (didn't bet)



PokerStars Hand #222980354939:  Hold'em No Limit ($0.05/$0.10 USD) - 2021/01/23 19:44:40 ET
Table 'Stephano III' 6-max Seat #4 is the button
Seat 1: tortpoker ($16.81 in chips) 
Seat 2: André3001 ($11.24 in chips) 
Seat 3: marcin116 ($10 in chips) 
Seat 4: zebaztravez ($11.33 in chips) 
Seat 5: Mello_Ace ($1.48 in chips) 
Seat 6: kätzi<3 ($12.87 in chips) 
Mello_Ace: posts small blind $0.05
kätzi<3: posts big blind $0.10
*** HOLE CARDS ***
tortpoker: folds 
André3001: raises $0.20 to $0.30
marcin116: folds 
zebaztravez: folds 
Mello_Ace: folds 
kätzi<3: raises $0.30 to $0.60
André3001: calls $0.30
*** FLOP *** [6s Js Ts]
kätzi<3: bets $0.80
André3001: calls $0.80
*** TURN *** [6s Js Ts] [8s]
kätzi<3: bets $0.80
André3001: calls $0.80
*** RIVER *** [6s Js Ts 8s] [7h]
kätzi<3: checks 
André3001: bets $3.20
kätzi<3: folds 
Uncalled bet ($3.20) returned to André3001
André3001 collected $4.25 from pot
André3001: doesn't show hand 
*** SUMMARY ***
Total pot $4.45 | Rake $0.20 
Board [6s Js Ts 8s 7h]
Seat 1: tortpoker folded before Flop (didn't bet)
Seat 2: André3001 collected ($4.25)
Seat 3: marcin116 folded before Flop (didn't bet)
Seat 4: zebaztravez (button) folded before Flop (didn't bet)
Seat 5: Mello_Ace (small blind) folded before Flop
Seat 6: kätzi<3 (big blind) folded on the River



PokerStars Hand #222980389966:  Hold'em No Limit ($0.05/$0.10 USD) - 2021/01/23 19:45:52 ET
Table 'Stephano III' 6-max Seat #5 is the button
Seat 1: tortpoker ($16.81 in chips) 
Seat 2: André3001 ($13.29 in chips) 
Seat 3: marcin116 ($10 in chips) 
Seat 4: zebaztravez ($11.33 in chips) 
Seat 5: Mello_Ace ($1.43 in chips) 
Seat 6: kätzi<3 ($10.67 in chips) 
kätzi<3: posts small blind $0.05
tortpoker: posts big blind $0.10
*** HOLE CARDS ***
André3001: folds 
marcin116: raises $0.25 to $0.35
zebaztravez: folds 
Mello_Ace: folds 
kätzi<3: folds 
tortpoker: calls $0.25
*** FLOP *** [As Ah Tc]
tortpoker: checks 
marcin116: bets $0.54
tortpoker: calls $0.54
*** TURN *** [As Ah Tc] [5s]
tortpoker: checks 
marcin116: checks 
*** RIVER *** [As Ah Tc 5s] [Td]
tortpoker: bets $0.58
marcin116: calls $0.58
*** SHOW DOWN ***
tortpoker: shows [7d Ad] (a full house, Aces full of Tens)
marcin116: mucks hand 
tortpoker collected $2.86 from pot
*** SUMMARY ***
Total pot $2.99 | Rake $0.13 
Board [As Ah Tc 5s Td]
Seat 1: tortpoker (big blind) showed [7d Ad] and won ($2.86) with a full house, Aces full of Tens
Seat 2: André3001 folded before Flop (didn't bet)
Seat 3: marcin116 mucked
Seat 4: zebaztravez folded before Flop (didn't bet)
Seat 5: Mello_Ace (button) folded before Flop (didn't bet)
Seat 6: kätzi<3 (small blind) folded before Flop



PokerStars Hand #222980406714:  Hold'em No Limit ($0.05/$0.10 USD) - 2021/01/23 19:46:26 ET
Table 'Stephano III' 6-max Seat #6 is the button
Seat 1: tortpoker ($18.20 in chips) 
Seat 2: André3001 ($13.29 in chips) 
Seat 3: marcin116 ($10 in chips) 
Seat 4: zebaztravez ($11.33 in chips) 
Seat 5: Mello_Ace ($1.43 in chips) 
Seat 6: kätzi<3 ($10.62 in chips) 
tortpoker: posts small blind $0.05
André3001: posts big blind $0.10
*** HOLE CARDS ***
marcin116: folds 
zebaztravez: folds 
Mello_Ace: calls $0.10
kätzi<3: folds 
tortpoker: folds 
André3001: checks 
*** FLOP *** [Jd 7h 7c]
André3001: checks 
Mello_Ace: checks 
*** TURN *** [Jd 7h 7c] [8s]
André3001: bets $0.20
Mello_Ace: calls $0.20
*** RIVER *** [Jd 7h 7c 8s] [Ah]
André3001: checks 
Mello_Ace: bets $0.31
André3001: folds 
Uncalled bet ($0.31) returned to Mello_Ace
Mello_Ace collected $0.62 from pot
Mello_Ace: doesn't show hand 
*** SUMMARY ***
Total pot $0.65 | Rake $0.03 
Board [Jd 7h 7c 8s Ah]
Seat 1: tortpoker (small blind) folded before Flop
Seat 2: André3001 (big blind) folded on the River
Seat 3: marcin116 folded before Flop (didn't bet)
Seat 4: zebaztravez folded before Flop (didn't bet)
Seat 5: Mello_Ace collected ($0.62)
Seat 6: kätzi<3 (button) folded before Flop (didn't bet)



PokerStars Hand #222980441918:  Hold'em No Limit ($0.05/$0.10 USD) - 2021/01/23 19:47:16 ET
Table 'Stephano III' 6-max Seat #1 is the button
Seat 1: tortpoker ($18.15 in chips) 
Seat 2: André3001 ($12.99 in chips) 
Seat 3: marcin116 ($10 in chips) 
Seat 4: zebaztravez ($11.33 in chips) 
Seat 5: Mello_Ace ($1.75 in chips) 
Seat 6: kätzi<3 ($10.62 in chips) 
André3001: posts small blind $0.05
marcin116: posts big blind $0.10
*** HOLE CARDS ***
zebaztravez: folds 
Mello_Ace: calls $0.10
kätzi<3: folds 
tortpoker: folds 
André3001: raises $0.30 to $0.40
marcin116: calls $0.30
Mello_Ace: calls $0.30
*** FLOP *** [2s 6s 9d]
André3001: bets $0.69
marcin116: folds 
Mello_Ace: folds 
Uncalled bet ($0.69) returned to André3001
André3001 collected $1.15 from pot
André3001: doesn't show hand 
*** SUMMARY ***
Total pot $1.20 | Rake $0.05 
Board [2s 6s 9d]
Seat 1: tortpoker (button) folded before Flop (didn't bet)
Seat 2: André3001 (small blind) collected ($1.15)
Seat 3: marcin116 (big blind) folded on the Flop
Seat 4: zebaztravez folded before Flop (didn't bet)
Seat 5: Mello_Ace folded on the Flop
Seat 6: kätzi<3 folded before Flop (didn't bet)



PokerStars Hand #222980453814:  Hold'em No Limit ($0.05/$0.10 USD) - 2021/01/23 19:47:41 ET
Table 'Stephano III' 6-max Seat #2 is the button
Seat 1: tortpoker ($18.15 in chips) 
Seat 2: André3001 ($13.74 in chips) 
Seat 3: marcin116 ($10 in chips) 
Seat 4: zebaztravez ($11.33 in chips) 
Seat 5: Mello_Ace ($1.35 in chips) 
Seat 6: kätzi<3 ($10.62 in chips) 
marcin116: posts small blind $0.05
zebaztravez: posts big blind $0.10
*** HOLE CARDS ***
Mello_Ace: raises $0.10 to $0.20
kätzi<3: calls $0.20
tortpoker: folds 
André3001: folds 
marcin116: folds 
zebaztravez: folds 
*** FLOP *** [5d Qs 9c]
Mello_Ace: bets $1.15 and is all-in
kätzi<3: folds 
Uncalled bet ($1.15) returned to Mello_Ace
Mello_Ace collected $0.53 from pot
Mello_Ace: doesn't show hand 
*** SUMMARY ***
Total pot $0.55 | Rake $0.02 
Board [5d Qs 9c]
Seat 1: tortpoker folded before Flop (didn't bet)
Seat 2: André3001 (button) folded before Flop (didn't bet)
Seat 3: marcin116 (small blind) folded before Flop
Seat 4: zebaztravez (big blind) folded before Flop
Seat 5: Mello_Ace collected ($0.53)
Seat 6: kätzi<3 folded on the Flop



PokerStars Hand #222980466444:  Hold'em No Limit ($0.05/$0.10 USD) - 2021/01/23 19:48:06 ET
Table 'Stephano III' 6-max Seat #3 is the button
Seat 1: tortpoker ($18.15 in chips) 
Seat 2: André3001 ($13.74 in chips) 
Seat 3: marcin116 ($10 in chips) 
Seat 4: zebaztravez ($11.23 in chips) 
Seat 5: Mello_Ace ($1.68 in chips) 
Seat 6: kätzi<3 ($10.42 in chips) 
zebaztravez: posts small blind $0.05
Mello_Ace: posts big blind $0.10
*** HOLE CARDS ***
kätzi<3: raises $0.20 to $0.30
tortpoker: folds 
André3001: folds 
marcin116: folds 
zebaztravez: raises $0.70 to $1
Mello_Ace: folds 
kätzi<3: raises $1 to $2
zebaztravez: raises $9.23 to $11.23 and is all-in
kätzi<3: folds 
Uncalled bet ($9.23) returned to zebaztravez
zebaztravez collected $4.10 from pot
zebaztravez: doesn't show hand 
*** SUMMARY ***
Total pot $4.10 | Rake $0 
Seat 1: tortpoker folded before Flop (didn't bet)
Seat 2: André3001 folded before Flop (didn't bet)
Seat 3: marcin116 (button) folded before Flop (didn't bet)
Seat 4: zebaztravez (small blind) collected ($4.10)
Seat 5: Mello_Ace (big blind) folded before Flop
Seat 6: kätzi<3 folded before Flop



PokerStars Hand #222980499249:  Hold'em No Limit ($0.05/$0.10 USD) - 2021/01/23 19:49:15 ET
Table 'Stephano III' 6-max Seat #4 is the button
Seat 1: tortpoker ($18.15 in chips) 
Seat 2: André3001 ($13.74 in chips) 
Seat 3: marcin116 ($10 in chips) 
Seat 4: zebaztravez ($13.33 in chips) 
Seat 5: Mello_Ace ($1.58 in chips) 
Seat 6: kätzi<3 ($8.42 in chips) 
Mello_Ace: posts small blind $0.05
kätzi<3: posts big blind $0.10
*** HOLE CARDS ***
tortpoker: raises $0.20 to $0.30
André3001: folds 
marcin116: folds 
zebaztravez: folds 
Mello_Ace: folds 
kätzi<3: calls $0.20
*** FLOP *** [3d 3s 2s]
kätzi<3: checks 
tortpoker: checks 
*** TURN *** [3d 3s 2s] [7h]
kätzi<3: checks 
tortpoker: checks 
*** RIVER *** [3d 3s 2s 7h] [Ad]
kätzi<3: bets $0.20
tortpoker: folds 
Uncalled bet ($0.20) returned to kätzi<3
kätzi<3 collected $0.62 from pot
kätzi<3: doesn't show hand 
*** SUMMARY ***
Total pot $0.65 | Rake $0.03 
Board [3d 3s 2s 7h Ad]
Seat 1: tortpoker folded on the River
Seat 2: André3001 folded before Flop (didn't bet)
Seat 3: marcin116 folded before Flop (didn't bet)
Seat 4: zebaztravez (button) folded before Flop (didn't bet)
Seat 5: Mello_Ace (small blind) folded before Flop
Seat 6: kätzi<3 (big blind) collected ($0.62)



PokerStars Hand #222980518603:  Hold'em No Limit ($0.05/$0.10 USD) - 2021/01/23 19:49:55 ET
Table 'Stephano III' 6-max Seat #5 is the button
Seat 1: tortpoker ($17.85 in chips) 
Seat 2: André3001 ($13.74 in chips) 
Seat 3: marcin116 ($10 in chips) 
Seat 4: zebaztravez ($13.33 in chips) 
Seat 5: Mello_Ace ($1.53 in chips) 
Seat 6: kätzi<3 ($8.74 in chips) 
kätzi<3: posts small blind $0.05
tortpoker: posts big blind $0.10
*** HOLE CARDS ***
André3001: folds 
marcin116: folds 
zebaztravez: raises $0.20 to $0.30
Mello_Ace: calls $0.30
kätzi<3: folds 
tortpoker: folds 
*** FLOP *** [Ah 7d 5s]
zebaztravez: bets $0.18
Mello_Ace: calls $0.18
*** TURN *** [Ah 7d 5s] [2c]
zebaztravez: checks 
Mello_Ace: checks 
*** RIVER *** [Ah 7d 5s 2c] [8d]
zebaztravez: bets $2.12
Mello_Ace: folds 
Uncalled bet ($2.12) returned to zebaztravez
zebaztravez collected $1.06 from pot
zebaztravez: doesn't show hand 
*** SUMMARY ***
Total pot $1.11 | Rake $0.05 
Board [Ah 7d 5s 2c 8d]
Seat 1: tortpoker (big blind) folded before Flop
Seat 2: André3001 folded before Flop (didn't bet)
Seat 3: marcin116 folded before Flop (didn't bet)
Seat 4: zebaztravez collected ($1.06)
Seat 5: Mello_Ace (button) folded on the River
Seat 6: kätzi<3 (small blind) folded before Flop



PokerStars Hand #222980539310:  Hold'em No Limit ($0.05/$0.10 USD) - 2021/01/23 19:50:39 ET
Table 'Stephano III' 6-max Seat #6 is the button
Seat 1: tortpoker ($17.75 in chips) 
Seat 2: André3001 ($13.74 in chips) 
Seat 3: marcin116 ($10 in chips) 
Seat 4: zebaztravez ($13.91 in chips) 
Seat 5: Mello_Ace ($1.05 in chips) 
Seat 6: kätzi<3 ($8.69 in chips) 
tortpoker: posts small blind $0.05
André3001: posts big blind $0.10
*** HOLE CARDS ***
marcin116: folds 
marcin116 leaves the table
zebaztravez: folds 
Mello_Ace: calls $0.10
kätzi<3: folds 
tortpoker: folds 
André3001: checks 
*** FLOP *** [Js Td 6s]
André3001: bets $0.20
Mello_Ace: raises $0.75 to $0.95 and is all-in
André3001: calls $0.75
*** TURN *** [Js Td 6s] [4d]
*** RIVER *** [Js Td 6s 4d] [8c]
*** SHOW DOWN ***
André3001: shows [9d Qc] (a straight, Eight to Queen)
Mello_Ace: shows [Jd Qh] (a pair of Jacks)
André3001 collected $2.05 from pot
*** SUMMARY ***
Total pot $2.15 | Rake $0.10 
Board [Js Td 6s 4d 8c]
Seat 1: tortpoker (small blind) folded before Flop
Seat 2: André3001 (big blind) showed [9d Qc] and won ($2.05) with a straight, Eight to Queen
Seat 3: marcin116 folded before Flop (didn't bet)
Seat 4: zebaztravez folded before Flop (didn't bet)
Seat 5: Mello_Ace showed [Jd Qh] and lost with a pair of Jacks
Seat 6: kätzi<3 (button) folded before Flop (didn't bet)



PokerStars Hand #222980555196:  Hold'em No Limit ($0.05/$0.10 USD) - 2021/01/23 19:51:12 ET
Table 'Stephano III' 6-max Seat #1 is the button
Seat 1: tortpoker ($17.70 in chips) 
Seat 2: André3001 ($14.74 in chips) 
Seat 4: zebaztravez ($13.91 in chips) 
Seat 6: kätzi<3 ($8.69 in chips) 
André3001: posts small blind $0.05
zebaztravez: posts big blind $0.10
*** HOLE CARDS ***
kätzi<3: folds 
tortpoker: raises $0.10 to $0.20
Mello_Ace leaves the table
André3001: folds 
zebaztravez: folds 
Uncalled bet ($0.10) returned to tortpoker
tortpoker collected $0.25 from pot
tortpoker: doesn't show hand 
dontgotrona joins the table at seat #3 
*** SUMMARY ***
Total pot $0.25 | Rake $0 
Seat 1: tortpoker (button) collected ($0.25)
Seat 2: André3001 (small blind) folded before Flop
Seat 4: zebaztravez (big blind) folded before Flop
Seat 6: kätzi<3 folded before Flop (didn't bet)



PokerStars Hand #222980563913:  Hold'em No Limit ($0.05/$0.10 USD) - 2021/01/23 19:51:31 ET
Table 'Stephano III' 6-max Seat #2 is the button
Seat 1: tortpoker ($17.85 in chips) 
Seat 2: André3001 ($14.69 in chips) 
Seat 4: zebaztravez ($13.81 in chips) 
Seat 6: kätzi<3 ($8.69 in chips) 
zebaztravez: posts small blind $0.05
kätzi<3: posts big blind $0.10
*** HOLE CARDS ***
tortpoker: folds 
aaronjones99 joins the table at seat #5 
André3001: raises $0.20 to $0.30
zebaztravez: folds 
kätzi<3: folds 
Uncalled bet ($0.20) returned to André3001
André3001 collected $0.25 from pot
André3001: doesn't show hand 
*** SUMMARY ***
Total pot $0.25 | Rake $0 
Seat 1: tortpoker folded before Flop (didn't bet)
Seat 2: André3001 (button) collected ($0.25)
Seat 4: zebaztravez (small blind) folded before Flop
Seat 6: kätzi<3 (big blind) folded before Flop



PokerStars Hand #222980572832:  Hold'em No Limit ($0.05/$0.10 USD) - 2021/01/23 19:51:50 ET
Table 'Stephano III' 6-max Seat #4 is the button
Seat 1: tortpoker ($17.85 in chips) 
Seat 2: André3001 ($14.84 in chips) 
Seat 3: dontgotrona ($4 in chips) 
Seat 4: zebaztravez ($13.76 in chips) 
Seat 6: kätzi<3 ($8.59 in chips) 
kätzi<3: posts small blind $0.05
tortpoker: posts big blind $0.10
dontgotrona: posts big blind $0.10
*** HOLE CARDS ***
André3001: folds 
dontgotrona: checks 
zebaztravez: folds 
kätzi<3: calls $0.05
tortpoker: checks 
*** FLOP *** [Kd Qc Jc]
kätzi<3: checks 
tortpoker: bets $0.20
dontgotrona: folds 
kätzi<3: folds 
Uncalled bet ($0.20) returned to tortpoker
tortpoker collected $0.29 from pot
tortpoker: doesn't show hand 
*** SUMMARY ***
Total pot $0.30 | Rake $0.01 
Board [Kd Qc Jc]
Seat 1: tortpoker (big blind) collected ($0.29)
Seat 2: André3001 folded before Flop (didn't bet)
Seat 3: dontgotrona folded on the Flop (didn't bet)
Seat 4: zebaztravez (button) folded before Flop (didn't bet)
Seat 6: kätzi<3 (small blind) folded on the Flop



PokerStars Hand #222980589801:  Hold'em No Limit ($0.05/$0.10 USD) - 2021/01/23 19:52:26 ET
Table 'Stephano III' 6-max Seat #6 is the button
Seat 1: tortpoker ($18.04 in chips) 
Seat 2: André3001 ($14.84 in chips) 
Seat 3: dontgotrona ($3.90 in chips) 
Seat 4: zebaztravez ($13.76 in chips) 
Seat 5: aaronjones99 ($7.88 in chips) 
Seat 6: kätzi<3 ($8.49 in chips) 
tortpoker: posts small blind $0.05
André3001: posts big blind $0.10
aaronjones99: posts big blind $0.10
*** HOLE CARDS ***
dontgotrona: folds 
zebaztravez: folds 
aaronjones99: checks 
kätzi<3: folds 
tortpoker: calls $0.05
André3001: checks 
*** FLOP *** [3s 6d 7s]
tortpoker: checks 
André3001: checks 
aaronjones99: bets $0.34
tortpoker: folds 
André3001: folds 
Uncalled bet ($0.34) returned to aaronjones99
aaronjones99 collected $0.29 from pot
aaronjones99: doesn't show hand 
*** SUMMARY ***
Total pot $0.30 | Rake $0.01 
Board [3s 6d 7s]
Seat 1: tortpoker (small blind) folded on the Flop
Seat 2: André3001 (big blind) folded on the Flop
Seat 3: dontgotrona folded before Flop (didn't bet)
Seat 4: zebaztravez folded before Flop (didn't bet)
Seat 5: aaronjones99 collected ($0.29)
Seat 6: kätzi<3 (button) folded before Flop (didn't bet)



PokerStars Hand #222980606122:  Hold'em No Limit ($0.05/$0.10 USD) - 2021/01/23 19:53:00 ET
Table 'Stephano III' 6-max Seat #1 is the button
Seat 1: tortpoker ($17.94 in chips) 
Seat 2: André3001 ($14.74 in chips) 
Seat 3: dontgotrona ($3.90 in chips) 
Seat 4: zebaztravez ($13.76 in chips) 
Seat 5: aaronjones99 ($8.07 in chips) 
Seat 6: kätzi<3 ($8.49 in chips) 
André3001: posts small blind $0.05
dontgotrona: posts big blind $0.10
*** HOLE CARDS ***
zebaztravez: folds 
aaronjones99: calls $0.10
kätzi<3: folds 
tortpoker: folds 
André3001: folds 
dontgotrona: checks 
*** FLOP *** [Ac 9c Js]
dontgotrona: checks 
aaronjones99: bets $0.12
dontgotrona: folds 
Uncalled bet ($0.12) returned to aaronjones99
aaronjones99 collected $0.24 from pot
aaronjones99: doesn't show hand 
*** SUMMARY ***
Total pot $0.25 | Rake $0.01 
Board [Ac 9c Js]
Seat 1: tortpoker (button) folded before Flop (didn't bet)
Seat 2: André3001 (small blind) folded before Flop
Seat 3: dontgotrona (big blind) folded on the Flop
Seat 4: zebaztravez folded before Flop (didn't bet)
Seat 5: aaronjones99 collected ($0.24)
Seat 6: kätzi<3 folded before Flop (didn't bet)



PokerStars Hand #222980621956:  Hold'em No Limit ($0.05/$0.10 USD) - 2021/01/23 19:53:34 ET
Table 'Stephano III' 6-max Seat #2 is the button
Seat 1: tortpoker ($17.94 in chips) 
Seat 2: André3001 ($14.69 in chips) 
Seat 3: dontgotrona ($3.80 in chips) 
Seat 4: zebaztravez ($13.76 in chips) 
Seat 5: aaronjones99 ($8.21 in chips) 
Seat 6: kätzi<3 ($8.49 in chips) 
dontgotrona: posts small blind $0.05
zebaztravez: posts big blind $0.10
*** HOLE CARDS ***
aaronjones99: calls $0.10
kätzi<3: folds 
tortpoker: folds 
André3001: folds 
dontgotrona: calls $0.05
zebaztravez: checks 
*** FLOP *** [6d 7h 3s]
dontgotrona: checks 
zebaztravez: checks 
aaronjones99: bets $0.34
dontgotrona: folds 
zebaztravez: folds 
Uncalled bet ($0.34) returned to aaronjones99
aaronjones99 collected $0.29 from pot
aaronjones99: doesn't show hand 
*** SUMMARY ***
Total pot $0.30 | Rake $0.01 
Board [6d 7h 3s]
Seat 1: tortpoker folded before Flop (didn't bet)
Seat 2: André3001 (button) folded before Flop (didn't bet)
Seat 3: dontgotrona (small blind) folded on the Flop
Seat 4: zebaztravez (big blind) folded on the Flop
Seat 5: aaronjones99 collected ($0.29)
Seat 6: kätzi<3 folded before Flop (didn't bet)



PokerStars Hand #222980638333:  Hold'em No Limit ($0.05/$0.10 USD) - 2021/01/23 19:54:09 ET
Table 'Stephano III' 6-max Seat #3 is the button
Seat 1: tortpoker ($17.94 in chips) 
Seat 2: André3001 ($14.69 in chips) 
Seat 3: dontgotrona ($3.70 in chips) 
Seat 4: zebaztravez ($13.66 in chips) 
Seat 5: aaronjones99 ($8.40 in chips) 
Seat 6: kätzi<3 ($8.49 in chips) 
zebaztravez: posts small blind $0.05
aaronjones99: posts big blind $0.10
*** HOLE CARDS ***
kätzi<3: folds 
tortpoker: folds 
André3001: folds 
dontgotrona: folds 
zebaztravez: raises $0.20 to $0.30
aaronjones99: folds 
Uncalled bet ($0.20) returned to zebaztravez
zebaztravez collected $0.20 from pot
zebaztravez: doesn't show hand 
*** SUMMARY ***
Total pot $0.20 | Rake $0 
Seat 1: tortpoker folded before Flop (didn't bet)
Seat 2: André3001 folded before Flop (didn't bet)
Seat 3: dontgotrona (button) folded before Flop (didn't bet)
Seat 4: zebaztravez (small blind) collected ($0.20)
Seat 5: aaronjones99 (big blind) folded before Flop
Seat 6: kätzi<3 folded before Flop (didn't bet)



PokerStars Hand #222980646773:  Hold'em No Limit ($0.05/$0.10 USD) - 2021/01/23 19:54:27 ET
Table 'Stephano III' 6-max Seat #4 is the button
Seat 1: tortpoker ($17.94 in chips) 
Seat 2: André3001 ($14.69 in chips) 
Seat 3: dontgotrona ($3.70 in chips) 
Seat 4: zebaztravez ($13.76 in chips) 
Seat 5: aaronjones99 ($8.30 in chips) 
Seat 6: kätzi<3 ($8.49 in chips) 
aaronjones99: posts small blind $0.05
kätzi<3: posts big blind $0.10
*** HOLE CARDS ***
tortpoker: folds 
André3001: raises $0.20 to $0.30
dontgotrona has timed out
dontgotrona: folds 
dontgotrona is disconnected 
zebaztravez: folds 
aaronjones99: folds 
kätzi<3: calls $0.20
*** FLOP *** [2h Js Ad]
kätzi<3: checks 
André3001: bets $0.37
kätzi<3: folds 
Uncalled bet ($0.37) returned to André3001
André3001 collected $0.62 from pot
André3001: doesn't show hand 
*** SUMMARY ***
Total pot $0.65 | Rake $0.03 
Board [2h Js Ad]
Seat 1: tortpoker folded before Flop (didn't bet)
Seat 2: André3001 collected ($0.62)
Seat 3: dontgotrona folded before Flop (didn't bet)
Seat 4: zebaztravez (button) folded before Flop (didn't bet)
Seat 5: aaronjones99 (small blind) folded before Flop
Seat 6: kätzi<3 (big blind) folded on the Flop



PokerStars Hand #222980673778:  Hold'em No Limit ($0.05/$0.10 USD) - 2021/01/23 19:55:29 ET
Table 'Stephano III' 6-max Seat #5 is the button
Seat 1: tortpoker ($17.94 in chips) 
Seat 2: André3001 ($15.01 in chips) 
Seat 4: zebaztravez ($13.76 in chips) 
Seat 5: aaronjones99 ($8.25 in chips) 
Seat 6: kätzi<3 ($8.19 in chips) 
kätzi<3: posts small blind $0.05
tortpoker: posts big blind $0.10
*** HOLE CARDS ***
André3001: folds 
zebaztravez: folds 
aaronjones99: calls $0.10
kätzi<3: calls $0.05
tortpoker: raises $0.60 to $0.70
aaronjones99: calls $0.60
kätzi<3: folds 
*** FLOP *** [Ah 8s 2s]
tortpoker: checks 
aaronjones99: bets $0.71
tortpoker: calls $0.71
*** TURN *** [Ah 8s 2s] [9s]
tortpoker: checks 
aaronjones99: bets $2.79
tortpoker: folds 
Uncalled bet ($2.79) returned to aaronjones99
aaronjones99 collected $2.79 from pot
aaronjones99: doesn't show hand 
*** SUMMARY ***
Total pot $2.92 | Rake $0.13 
Board [Ah 8s 2s 9s]
Seat 1: tortpoker (big blind) folded on the Turn
Seat 2: André3001 folded before Flop (didn't bet)
Seat 4: zebaztravez folded before Flop (didn't bet)
Seat 5: aaronjones99 (button) collected ($2.79)
Seat 6: kätzi<3 (small blind) folded before Flop



PokerStars Hand #222980691434:  Hold'em No Limit ($0.05/$0.10 USD) - 2021/01/23 19:56:18 ET
Table 'Stephano III' 6-max Seat #6 is the button
Seat 1: tortpoker ($16.53 in chips) 
Seat 2: André3001 ($15.01 in chips) 
Seat 4: zebaztravez ($13.76 in chips) 
Seat 5: aaronjones99 ($9.63 in chips) 
Seat 6: kätzi<3 ($8.09 in chips) 
tortpoker: posts small blind $0.05
André3001: posts big blind $0.10
*** HOLE CARDS ***
zebaztravez: folds 
aaronjones99 has timed out
aaronjones99: folds 
kätzi<3: folds 
tortpoker: raises $0.20 to $0.30
André3001: folds 
Uncalled bet ($0.20) returned to tortpoker
tortpoker collected $0.20 from pot
tortpoker: doesn't show hand 
*** SUMMARY ***
Total pot $0.20 | Rake $0 
Seat 1: tortpoker (small blind) collected ($0.20)
Seat 2: André3001 (big blind) folded before Flop
Seat 4: zebaztravez folded before Flop (didn't bet)
Seat 5: aaronjones99 folded before Flop (didn't bet)
Seat 6: kätzi<3 (button) folded before Flop (didn't bet)



PokerStars Hand #222980699548:  Hold'em No Limit ($0.05/$0.10 USD) - 2021/01/23 19:56:41 ET
Table 'Stephano III' 6-max Seat #1 is the button
Seat 1: tortpoker ($16.63 in chips) 
Seat 2: André3001 ($14.91 in chips) 
Seat 4: zebaztravez ($13.76 in chips) 
Seat 5: aaronjones99 ($9.63 in chips) 
Seat 6: kätzi<3 ($8.09 in chips) 
André3001: posts small blind $0.05
zebaztravez: posts big blind $0.10
*** HOLE CARDS ***
aaronjones99: raises $0.10 to $0.20
kätzi<3: folds 
tortpoker: calls $0.20
André3001: folds 
zebaztravez: calls $0.10
*** FLOP *** [6d Ts 5d]
zebaztravez: checks 
aaronjones99: bets $0.31
tortpoker: folds 
zebaztravez: raises $0.89 to $1.20
aaronjones99: folds 
Uncalled bet ($0.89) returned to zebaztravez
zebaztravez collected $1.21 from pot
zebaztravez: doesn't show hand 
*** SUMMARY ***
Total pot $1.27 | Rake $0.06 
Board [6d Ts 5d]
Seat 1: tortpoker (button) folded on the Flop
Seat 2: André3001 (small blind) folded before Flop
Seat 4: zebaztravez (big blind) collected ($1.21)
Seat 5: aaronjones99 folded on the Flop
Seat 6: kätzi<3 folded before Flop (didn't bet)



PokerStars Hand #222980716486:  Hold'em No Limit ($0.05/$0.10 USD) - 2021/01/23 19:57:27 ET
Table 'Stephano III' 6-max Seat #2 is the button
Seat 1: tortpoker ($16.43 in chips) 
Seat 2: André3001 ($14.86 in chips) 
Seat 4: zebaztravez ($14.46 in chips) 
Seat 5: aaronjones99 ($9.12 in chips) 
Seat 6: kätzi<3 ($8.09 in chips) 
zebaztravez: posts small blind $0.05
aaronjones99: posts big blind $0.10
*** HOLE CARDS ***
kätzi<3: folds 
tortpoker: folds 
André3001: raises $0.20 to $0.30
zebaztravez: folds 
aaronjones99: folds 
Uncalled bet ($0.20) returned to André3001
aaronjones99 leaves the table
André3001 collected $0.25 from pot
André3001: doesn't show hand 
*** SUMMARY ***
Total pot $0.25 | Rake $0 
Seat 1: tortpoker folded before Flop (didn't bet)
Seat 2: André3001 (button) collected ($0.25)
Seat 4: zebaztravez (small blind) folded before Flop
Seat 5: aaronjones99 (big blind) folded before Flop
Seat 6: kätzi<3 folded before Flop (didn't bet)



PokerStars Hand #222980720858:  Hold'em No Limit ($0.05/$0.10 USD) - 2021/01/23 19:57:40 ET
Table 'Stephano III' 6-max Seat #4 is the button
Seat 1: tortpoker ($16.43 in chips) 
Seat 2: André3001 ($15.01 in chips) 
Seat 4: zebaztravez ($14.41 in chips) 
Seat 6: kätzi<3 ($8.09 in chips) 
kätzi<3: posts small blind $0.05
tortpoker: posts big blind $0.10
*** HOLE CARDS ***
André3001: raises $0.20 to $0.30
zebaztravez: folds 
vanapaguss joins the table at seat #5 
kätzi<3: raises $0.30 to $0.60
tortpoker: calls $0.50
André3001: calls $0.30
*** FLOP *** [2d Ks 5c]
kätzi<3: bets $0.80
tortpoker: folds 
André3001: folds 
Uncalled bet ($0.80) returned to kätzi<3
kätzi<3 collected $1.72 from pot
kätzi<3: doesn't show hand 
*** SUMMARY ***
Total pot $1.80 | Rake $0.08 
Board [2d Ks 5c]
Seat 1: tortpoker (big blind) folded on the Flop
Seat 2: André3001 folded on the Flop
Seat 4: zebaztravez (button) folded before Flop (didn't bet)
Seat 6: kätzi<3 (small blind) collected ($1.72)



PokerStars Hand #222980738448:  Hold'em No Limit ($0.05/$0.10 USD) - 2021/01/23 19:58:29 ET
Table 'Stephano III' 6-max Seat #6 is the button
Seat 1: tortpoker ($15.83 in chips) 
Seat 2: André3001 ($14.41 in chips) 
Seat 4: zebaztravez ($14.41 in chips) 
Seat 6: kätzi<3 ($9.21 in chips) 
tortpoker: posts small blind $0.05
André3001: posts big blind $0.10
vanapaguss: sits out 
*** HOLE CARDS ***
zebaztravez: folds 
kätzi<3: raises $0.20 to $0.30
tortpoker: folds 
André3001: calls $0.20
*** FLOP *** [4d 4h 3c]
André3001: checks 
kätzi<3: bets $0.62
André3001: folds 
Uncalled bet ($0.62) returned to kätzi<3
kätzi<3 collected $0.62 from pot
kätzi<3: doesn't show hand 
*** SUMMARY ***
Total pot $0.65 | Rake $0.03 
Board [4d 4h 3c]
Seat 1: tortpoker (small blind) folded before Flop
Seat 2: André3001 (big blind) folded on the Flop
Seat 4: zebaztravez folded before Flop (didn't bet)
Seat 6: kätzi<3 (button) collected ($0.62)



PokerStars Hand #222980748030:  Hold'em No Limit ($0.05/$0.10 USD) - 2021/01/23 19:58:55 ET
Table 'Stephano III' 6-max Seat #1 is the button
Seat 1: tortpoker ($15.78 in chips) 
Seat 2: André3001 ($14.11 in chips) 
Seat 4: zebaztravez ($14.41 in chips) 
Seat 6: kätzi<3 ($9.53 in chips) 
André3001: posts small blind $0.05
zebaztravez: posts big blind $0.10
vanapaguss: sits out 
*** HOLE CARDS ***
kätzi<3: folds 
tortpoker: raises $0.10 to $0.20
André3001: folds 
zebaztravez: folds 
Uncalled bet ($0.10) returned to tortpoker
tortpoker collected $0.25 from pot
tortpoker: doesn't show hand 
*** SUMMARY ***
Total pot $0.25 | Rake $0 
Seat 1: tortpoker (button) collected ($0.25)
Seat 2: André3001 (small blind) folded before Flop
Seat 4: zebaztravez (big blind) folded before Flop
Seat 6: kätzi<3 folded before Flop (didn't bet)



PokerStars Hand #222980754037:  Hold'em No Limit ($0.05/$0.10 USD) - 2021/01/23 19:59:11 ET
Table 'Stephano III' 6-max Seat #2 is the button
Seat 1: tortpoker ($15.93 in chips) 
Seat 2: André3001 ($14.06 in chips) 
Seat 4: zebaztravez ($14.31 in chips) 
Seat 5: vanapaguss ($10 in chips) 
Seat 6: kätzi<3 ($9.53 in chips) 
zebaztravez: posts small blind $0.05
vanapaguss: posts big blind $0.10
*** HOLE CARDS ***
kätzi<3: folds 
tortpoker: folds 
André3001: raises $0.20 to $0.30
zebaztravez: folds 
vanapaguss: raises $0.80 to $1.10
André3001: calls $0.80
*** FLOP *** [2h 9c 5c]
vanapaguss: bets $1.50
André3001: calls $1.50
*** TURN *** [2h 9c 5c] [6h]
vanapaguss: bets $3.50
André3001: raises $7.96 to $11.46 and is all-in
vanapaguss: calls $3.90 and is all-in
Uncalled bet ($4.06) returned to André3001
*** RIVER *** [2h 9c 5c 6h] [Td]
*** SHOW DOWN ***
vanapaguss: shows [Th Tc] (three of a kind, Tens)
André3001: shows [Ts Ac] (a pair of Tens)
vanapaguss cashed out the hand for $17.67 | Cash Out Fee $0.18
*** SUMMARY ***
Total pot $20.05 | Rake $0.90 
Board [2h 9c 5c 6h Td]
Seat 1: tortpoker folded before Flop (didn't bet)
Seat 2: André3001 (button) showed [Ts Ac] and lost with a pair of Tens
Seat 4: zebaztravez (small blind) folded before Flop
Seat 5: vanapaguss (big blind) showed [Th Tc] and won ($19.15) with three of a kind, Tens (pot not awarded as player cashed out)
Seat 6: kätzi<3 folded before Flop (didn't bet)



PokerStars Hand #222980783682:  Hold'em No Limit ($0.05/$0.10 USD) - 2021/01/23 20:00:30 ET
Table 'Stephano III' 6-max Seat #5 is the button
Seat 1: tortpoker ($15.93 in chips) 
Seat 2: André3001 ($10 in chips) 
Seat 5: vanapaguss ($17.67 in chips) 
Seat 6: kätzi<3 ($9.53 in chips) 
kätzi<3: posts small blind $0.05
tortpoker: posts big blind $0.10
*** HOLE CARDS ***
André3001: raises $0.20 to $0.30
vanapaguss: folds 
kätzi<3: folds 
tortpoker: folds 
Uncalled bet ($0.20) returned to André3001
André3001 collected $0.25 from pot
André3001: doesn't show hand 
*** SUMMARY ***
Total pot $0.25 | Rake $0 
Seat 1: tortpoker (big blind) folded before Flop
Seat 2: André3001 collected ($0.25)
Seat 5: vanapaguss (button) folded before Flop (didn't bet)
Seat 6: kätzi<3 (small blind) folded before Flop



PokerStars Hand #222980792570:  Hold'em No Limit ($0.05/$0.10 USD) - 2021/01/23 20:00:51 ET
Table 'Stephano III' 6-max Seat #1 is the button
Seat 1: tortpoker ($15.83 in chips) 
Seat 2: André3001 ($10.15 in chips) 
Seat 5: vanapaguss ($17.67 in chips) 
André3001: posts small blind $0.05
vanapaguss: posts big blind $0.10
*** HOLE CARDS ***
tortpoker: raises $0.10 to $0.20
André3001: folds 
vanapaguss: folds 
Uncalled bet ($0.10) returned to tortpoker
tortpoker collected $0.25 from pot
tortpoker: doesn't show hand 
*** SUMMARY ***
Total pot $0.25 | Rake $0 
Seat 1: tortpoker (button) collected ($0.25)
Seat 2: André3001 (small blind) folded before Flop
Seat 5: vanapaguss (big blind) folded before Flop



PokerStars Hand #222980796121:  Hold'em No Limit ($0.05/$0.10 USD) - 2021/01/23 20:00:59 ET
Table 'Stephano III' 6-max Seat #5 is the button
Seat 2: André3001 ($10.10 in chips) 
Seat 5: vanapaguss ($17.57 in chips) 
vanapaguss: posts small blind $0.05
tortpoker: is sitting out 
André3001: posts big blind $0.10
*** HOLE CARDS ***
tortpoker leaves the table
vanapaguss: raises $0.20 to $0.30
André3001: calls $0.20
*** FLOP *** [7h Ts 2c]
André3001: checks 
kätzi<3 leaves the table
vanapaguss: bets $0.20
André3001: calls $0.20
*** TURN *** [7h Ts 2c] [3d]
André3001: checks 
vanapaguss: bets $0.66
André3001: raises $1.04 to $1.70
vanapaguss: calls $1.04
*** RIVER *** [7h Ts 2c 3d] [2s]
André3001: bets $2.52
vanapaguss: calls $2.52
*** SHOW DOWN ***
André3001: shows [6s Ks] (a pair of Deuces)
vanapaguss: shows [Th Kd] (two pair, Tens and Deuces)
vanapaguss collected $9.02 from pot
dontgotrona was removed from the table for failing to post
dontgotrona leaves the table
*** SUMMARY ***
Total pot $9.44 | Rake $0.42 
Board [7h Ts 2c 3d 2s]
Seat 2: André3001 (big blind) showed [6s Ks] and lost with a pair of Deuces
Seat 5: vanapaguss (button) (small blind) showed [Th Kd] and won ($9.02) with two pair, Tens and Deuces



PokerStars Hand #222980810368:  Hold'em No Limit ($0.05/$0.10 USD) - 2021/01/23 20:01:32 ET
Table 'Stephano III' 6-max Seat #2 is the button
Seat 2: André3001 ($10 in chips) 
Seat 5: vanapaguss ($21.87 in chips) 
André3001: posts small blind $0.05
vanapaguss: posts big blind $0.10
*** HOLE CARDS ***
André3001: raises $0.20 to $0.30
vanapaguss: folds 
Uncalled bet ($0.20) returned to André3001
André3001 collected $0.20 from pot
André3001: doesn't show hand 
*** SUMMARY ***
Total pot $0.20 | Rake $0 
Seat 2: André3001 (button) (small blind) collected ($0.20)
Seat 5: vanapaguss (big blind) folded before Flop



PokerStars Hand #222980813716:  Hold'em No Limit ($0.05/$0.10 USD) - 2021/01/23 20:01:39 ET
Table 'Stephano III' 6-max Seat #5 is the button
Seat 2: André3001 ($10.10 in chips) 
Seat 5: vanapaguss ($21.77 in chips) 
vanapaguss: posts small blind $0.05
André3001: posts big blind $0.10
*** HOLE CARDS ***
vanapaguss: raises $0.20 to $0.30
André3001: calls $0.20
*** FLOP *** [2h 7c As]
André3001: checks 
vanapaguss: bets $0.20
André3001: calls $0.20
*** TURN *** [2h 7c As] [Ad]
André3001: checks 
vanapaguss: bets $0.70
André3001: calls $0.70
*** RIVER *** [2h 7c As Ad] [9d]
André3001: checks 
vanapaguss: bets $2.24
André3001: calls $2.24
*** SHOW DOWN ***
vanapaguss: shows [Qh Qc] (two pair, Aces and Queens)
André3001: mucks hand 
vanapaguss collected $6.57 from pot
*** SUMMARY ***
Total pot $6.88 | Rake $0.31 
Board [2h 7c As Ad 9d]
Seat 2: André3001 (big blind) mucked
Seat 5: vanapaguss (button) (small blind) showed [Qh Qc] and won ($6.57) with two pair, Aces and Queens



PokerStars Hand #222980825680:  Hold'em No Limit ($0.05/$0.10 USD) - 2021/01/23 20:02:06 ET
Table 'Stephano III' 6-max Seat #2 is the button
Seat 2: André3001 ($10 in chips) 
Seat 5: vanapaguss ($24.90 in chips) 
André3001: posts small blind $0.05
vanapaguss: posts big blind $0.10
*** HOLE CARDS ***
André3001: raises $0.20 to $0.30
vanapaguss: folds 
Uncalled bet ($0.20) returned to André3001
André3001 collected $0.20 from pot
André3001: doesn't show hand 
*** SUMMARY ***
Total pot $0.20 | Rake $0 
Seat 2: André3001 (button) (small blind) collected ($0.20)
Seat 5: vanapaguss (big blind) folded before Flop



PokerStars Hand #222980828510:  Hold'em No Limit ($0.05/$0.10 USD) - 2021/01/23 20:02:12 ET
Table 'Stephano III' 6-max Seat #5 is the button
Seat 2: André3001 ($10.10 in chips) 
Seat 5: vanapaguss ($24.80 in chips) 
vanapaguss: posts small blind $0.05
André3001: posts big blind $0.10
*** HOLE CARDS ***
vanapaguss: raises $0.15 to $0.25
André3001: folds 
Uncalled bet ($0.15) returned to vanapaguss
vanapaguss collected $0.20 from pot
vanapaguss: doesn't show hand 
*** SUMMARY ***
Total pot $0.20 | Rake $0 
Seat 2: André3001 (big blind) folded before Flop
Seat 5: vanapaguss (button) (small blind) collected ($0.20)



PokerStars Hand #222980831257:  Hold'em No Limit ($0.05/$0.10 USD) - 2021/01/23 20:02:18 ET
Table 'Stephano III' 6-max Seat #2 is the button
Seat 2: André3001 ($10 in chips) 
Seat 5: vanapaguss ($24.90 in chips) 
André3001: posts small blind $0.05
vanapaguss: posts big blind $0.10
*** HOLE CARDS ***
André3001: raises $0.20 to $0.30
vanapaguss: calls $0.20
*** FLOP *** [Jd Jc Ks]
vanapaguss: checks 
André3001: bets $0.30
vanapaguss: folds 
Uncalled bet ($0.30) returned to André3001
André3001 collected $0.57 from pot
André3001: doesn't show hand 
*** SUMMARY ***
Total pot $0.60 | Rake $0.03 
Board [Jd Jc Ks]
Seat 2: André3001 (button) (small blind) collected ($0.57)
Seat 5: vanapaguss (big blind) folded on the Flop



PokerStars Hand #222980838272:  Hold'em No Limit ($0.05/$0.10 USD) - 2021/01/23 20:02:33 ET
Table 'Stephano III' 6-max Seat #5 is the button
Seat 2: André3001 ($10.27 in chips) 
Seat 5: vanapaguss ($24.60 in chips) 
vanapaguss: posts small blind $0.05
André3001: posts big blind $0.10
*** HOLE CARDS ***
vanapaguss: raises $0.10 to $0.20
André3001: raises $0.60 to $0.80
vanapaguss: folds 
Uncalled bet ($0.60) returned to André3001
André3001 collected $0.40 from pot
André3001: doesn't show hand 
*** SUMMARY ***
Total pot $0.40 | Rake $0 
Seat 2: André3001 (big blind) collected ($0.40)
Seat 5: vanapaguss (button) (small blind) folded before Flop



PokerStars Hand #222980842093:  Hold'em No Limit ($0.05/$0.10 USD) - 2021/01/23 20:02:41 ET
Table 'Stephano III' 6-max Seat #2 is the button
Seat 2: André3001 ($10.47 in chips) 
Seat 5: vanapaguss ($24.40 in chips) 
André3001: posts small blind $0.05
vanapaguss: posts big blind $0.10
*** HOLE CARDS ***
André3001: raises $0.20 to $0.30
vanapaguss: calls $0.20
*** FLOP *** [6d 3c 5h]
vanapaguss: checks 
xiexie!01 joins the table at seat #1 
André3001: bets $0.34
vanapaguss: calls $0.34
*** TURN *** [6d 3c 5h] [4c]
vanapaguss: checks 
André3001: bets $0.92
vanapaguss: folds 
Uncalled bet ($0.92) returned to André3001
André3001 collected $1.22 from pot
André3001: doesn't show hand 
*** SUMMARY ***
Total pot $1.28 | Rake $0.06 
Board [6d 3c 5h 4c]
Seat 2: André3001 (button) (small blind) collected ($1.22)
Seat 5: vanapaguss (big blind) folded on the Turn



PokerStars Hand #222980850697:  Hold'em No Limit ($0.05/$0.10 USD) - 2021/01/23 20:03:01 ET
Table 'Stephano III' 6-max Seat #2 is the button
Seat 1: xiexie!01 ($7.68 in chips) 
Seat 2: André3001 ($11.05 in chips) 
Seat 5: vanapaguss ($23.76 in chips) 
vanapaguss: posts small blind $0.05
xiexie!01: posts big blind $0.10
*** HOLE CARDS ***
André3001: raises $0.20 to $0.30
vanapaguss: calls $0.25
xiexie!01: calls $0.20
*** FLOP *** [Tc As 6h]
vanapaguss: checks 
xiexie!01: checks 
André3001: bets $0.40
vanapaguss: folds 
xiexie!01: calls $0.40
*** TURN *** [Tc As 6h] [4d]
xiexie!01: checks 
André3001: bets $0.97
xiexie!01: folds 
Uncalled bet ($0.97) returned to André3001
André3001 collected $1.62 from pot
André3001: doesn't show hand 
*** SUMMARY ***
Total pot $1.70 | Rake $0.08 
Board [Tc As 6h 4d]
Seat 1: xiexie!01 (big blind) folded on the Turn
Seat 2: André3001 (button) collected ($1.62)
Seat 5: vanapaguss (small blind) folded on the Flop



PokerStars Hand #222980871905:  Hold'em No Limit ($0.05/$0.10 USD) - 2021/01/23 20:03:40 ET
Table 'Stephano III' 6-max Seat #5 is the button
Seat 1: xiexie!01 ($6.98 in chips) 
Seat 2: André3001 ($11.97 in chips) 
Seat 5: vanapaguss ($23.46 in chips) 
xiexie!01: posts small blind $0.05
André3001: posts big blind $0.10
*** HOLE CARDS ***
vanapaguss: folds 
xiexie!01: folds 
Uncalled bet ($0.05) returned to André3001
André3001 collected $0.10 from pot
André3001: doesn't show hand 
*** SUMMARY ***
Total pot $0.10 | Rake $0 
Seat 1: xiexie!01 (small blind) folded before Flop
Seat 2: André3001 (big blind) collected ($0.10)
Seat 5: vanapaguss (button) folded before Flop (didn't bet)



PokerStars Hand #222980873953:  Hold'em No Limit ($0.05/$0.10 USD) - 2021/01/23 20:03:44 ET
Table 'Stephano III' 6-max Seat #1 is the button
Seat 1: xiexie!01 ($6.93 in chips) 
Seat 2: André3001 ($12.02 in chips) 
Seat 5: vanapaguss ($23.46 in chips) 
André3001: posts small blind $0.05
vanapaguss: posts big blind $0.10
*** HOLE CARDS ***
xiexie!01: raises $0.20 to $0.30
André3001: folds 
vanapaguss: folds 
Uncalled bet ($0.20) returned to xiexie!01
xiexie!01 collected $0.25 from pot
xiexie!01: doesn't show hand 
*** SUMMARY ***
Total pot $0.25 | Rake $0 
Seat 1: xiexie!01 (button) collected ($0.25)
Seat 2: André3001 (small blind) folded before Flop
Seat 5: vanapaguss (big blind) folded before Flop



PokerStars Hand #222980877937:  Hold'em No Limit ($0.05/$0.10 USD) - 2021/01/23 20:03:53 ET
Table 'Stephano III' 6-max Seat #2 is the button
Seat 1: xiexie!01 ($7.08 in chips) 
Seat 2: André3001 ($11.97 in chips) 
Seat 5: vanapaguss ($23.36 in chips) 
vanapaguss: posts small blind $0.05
xiexie!01: posts big blind $0.10
*** HOLE CARDS ***
André3001: folds 
vanapaguss: folds 
Uncalled bet ($0.05) returned to xiexie!01
0nix770 joins the table at seat #3 
xiexie!01 collected $0.10 from pot
xiexie!01: doesn't show hand 
*** SUMMARY ***
Total pot $0.10 | Rake $0 
Seat 1: xiexie!01 (big blind) collected ($0.10)
Seat 2: André3001 (button) folded before Flop (didn't bet)
Seat 5: vanapaguss (small blind) folded before Flop



PokerStars Hand #222980880792:  Hold'em No Limit ($0.05/$0.10 USD) - 2021/01/23 20:03:59 ET
Table 'Stephano III' 6-max Seat #5 is the button
Seat 1: xiexie!01 ($7.13 in chips) 
Seat 2: André3001 ($11.97 in chips) 
Seat 5: vanapaguss ($23.31 in chips) 
xiexie!01: posts small blind $0.05
André3001: posts big blind $0.10
0nix770: sits out 
*** HOLE CARDS ***
J3vgen joins the table at seat #6 
vanapaguss: folds 
xiexie!01: calls $0.05
André3001: raises $0.40 to $0.50
xiexie!01: folds 
Uncalled bet ($0.40) returned to André3001
André3001 collected $0.20 from pot
André3001: doesn't show hand 
*** SUMMARY ***
Total pot $0.20 | Rake $0 
Seat 1: xiexie!01 (small blind) folded before Flop
Seat 2: André3001 (big blind) collected ($0.20)
Seat 5: vanapaguss (button) folded before Flop (didn't bet)



PokerStars Hand #222980886164:  Hold'em No Limit ($0.05/$0.10 USD) - 2021/01/23 20:04:11 ET
Table 'Stephano III' 6-max Seat #1 is the button
Seat 1: xiexie!01 ($7.03 in chips) 
Seat 2: André3001 ($12.07 in chips) 
Seat 3: 0nix770 ($10 in chips) 
Seat 5: vanapaguss ($23.31 in chips) 
André3001: posts small blind $0.05
0nix770: posts big blind $0.10
J3vgen: sits out 
*** HOLE CARDS ***
vanapaguss: folds 
xiexie!01: folds 
André3001: raises $0.20 to $0.30
0nix770: calls $0.20
*** FLOP *** [2s As 6c]
André3001: bets $0.30
0nix770: folds 
Uncalled bet ($0.30) returned to André3001
André3001 collected $0.57 from pot
André3001: doesn't show hand 
*** SUMMARY ***
Total pot $0.60 | Rake $0.03 
Board [2s As 6c]
Seat 1: xiexie!01 (button) folded before Flop (didn't bet)
Seat 2: André3001 (small blind) collected ($0.57)
Seat 3: 0nix770 (big blind) folded on the Flop
Seat 5: vanapaguss folded before Flop (didn't bet)



PokerStars Hand #222980900682:  Hold'em No Limit ($0.05/$0.10 USD) - 2021/01/23 20:04:28 ET
Table 'Stephano III' 6-max Seat #2 is the button
Seat 1: xiexie!01 ($7.03 in chips) 
Seat 2: André3001 ($12.34 in chips) 
Seat 3: 0nix770 ($10 in chips) 
Seat 5: vanapaguss ($23.31 in chips) 
0nix770: posts small blind $0.05
vanapaguss: posts big blind $0.10
J3vgen: sits out 
*** HOLE CARDS ***
xiexie!01: folds 
xiexie!01 leaves the table
André3001: raises $0.20 to $0.30
0nix770: folds 
vanapaguss: calls $0.20
*** FLOP *** [Ks Ah 5s]
vanapaguss: checks 
André3001: bets $0.37
vanapaguss: calls $0.37
*** TURN *** [Ks Ah 5s] [Jd]
vanapaguss: checks 
André3001: checks 
*** RIVER *** [Ks Ah 5s Jd] [Qs]
vanapaguss: checks 
André3001: bets $1.33
vanapaguss: folds 
Uncalled bet ($1.33) returned to André3001
André3001 collected $1.33 from pot
zebaztravez was removed from the table for failing to post
zebaztravez leaves the table
André3001: doesn't show hand 
*** SUMMARY ***
Total pot $1.39 | Rake $0.06 
Board [Ks Ah 5s Jd Qs]
Seat 1: xiexie!01 folded before Flop (didn't bet)
Seat 2: André3001 (button) collected ($1.33)
Seat 3: 0nix770 (small blind) folded before Flop
Seat 5: vanapaguss (big blind) folded on the River



PokerStars Hand #222980911740:  Hold'em No Limit ($0.05/$0.10 USD) - 2021/01/23 20:04:52 ET
Table 'Stephano III' 6-max Seat #3 is the button
Seat 2: André3001 ($13 in chips) 
Seat 3: 0nix770 ($10 in chips) 
Seat 5: vanapaguss ($22.64 in chips) 
Seat 6: J3vgen ($10 in chips) 
vanapaguss: posts small blind $0.05
J3vgen: posts big blind $0.10
*** HOLE CARDS ***
André3001: raises $0.20 to $0.30
0nix770: folds 
vanapaguss: calls $0.25
J3vgen: folds 
*** FLOP *** [9c 2c Kd]
vanapaguss: checks 
André3001: bets $0.40
vanapaguss: calls $0.40
*** TURN *** [9c 2c Kd] [7d]
vanapaguss: checks 
André3001: checks 
*** RIVER *** [9c 2c Kd 7d] [6h]
FFDD15 joins the table at seat #1 
vanapaguss: bets $0.50
André3001: calls $0.50
*** SHOW DOWN ***
vanapaguss: shows [Qs Ts] (high card King)
André3001: shows [Js Jh] (a pair of Jacks)
André3001 collected $2.39 from pot
*** SUMMARY ***
Total pot $2.50 | Rake $0.11 
Board [9c 2c Kd 7d 6h]
Seat 2: André3001 showed [Js Jh] and won ($2.39) with a pair of Jacks
Seat 3: 0nix770 (button) folded before Flop (didn't bet)
Seat 5: vanapaguss (small blind) showed [Qs Ts] and lost with high card King
Seat 6: J3vgen (big blind) folded before Flop



PokerStars Hand #222980927921:  Hold'em No Limit ($0.05/$0.10 USD) - 2021/01/23 20:05:27 ET
Table 'Stephano III' 6-max Seat #5 is the button
Seat 1: FFDD15 ($4.90 in chips) 
Seat 2: André3001 ($14.19 in chips) 
Seat 3: 0nix770 ($10 in chips) 
Seat 5: vanapaguss ($21.44 in chips) 
Seat 6: J3vgen ($10 in chips) 
J3vgen: posts small blind $0.05
FFDD15: posts big blind $0.10
*** HOLE CARDS ***
André3001: folds 
0nix770: folds 
vanapaguss: folds 
J3vgen: folds 
Uncalled bet ($0.05) returned to FFDD15
FFDD15 collected $0.10 from pot
FFDD15: doesn't show hand 
*** SUMMARY ***
Total pot $0.10 | Rake $0 
Seat 1: FFDD15 (big blind) collected ($0.10)
Seat 2: André3001 folded before Flop (didn't bet)
Seat 3: 0nix770 folded before Flop (didn't bet)
Seat 5: vanapaguss (button) folded before Flop (didn't bet)
Seat 6: J3vgen (small blind) folded before Flop



PokerStars Hand #222980933331:  Hold'em No Limit ($0.05/$0.10 USD) - 2021/01/23 20:05:39 ET
Table 'Stephano III' 6-max Seat #6 is the button
Seat 1: FFDD15 ($4.95 in chips) 
Seat 2: André3001 ($14.19 in chips) 
Seat 3: 0nix770 ($10 in chips) 
Seat 5: vanapaguss ($21.44 in chips) 
Seat 6: J3vgen ($10 in chips) 
FFDD15: posts small blind $0.05
André3001: posts big blind $0.10
*** HOLE CARDS ***
0nix770: raises $0.20 to $0.30
vanapaguss: raises $0.60 to $0.90
J3vgen: folds 
FFDD15: calls $0.85
André3001: folds 
0nix770: raises $1.60 to $2.50
vanapaguss: calls $1.60
FFDD15: folds 
*** FLOP *** [8s 9s As]
0nix770: bets $1.91
vanapaguss: folds 
Uncalled bet ($1.91) returned to 0nix770
0nix770 collected $5.73 from pot
0nix770: doesn't show hand 
*** SUMMARY ***
Total pot $6 | Rake $0.27 
Board [8s 9s As]
Seat 1: FFDD15 (small blind) folded before Flop
Seat 2: André3001 (big blind) folded before Flop
Seat 3: 0nix770 collected ($5.73)
Seat 5: vanapaguss folded on the Flop
Seat 6: J3vgen (button) folded before Flop (didn't bet)



PokerStars Hand #222980958088:  Hold'em No Limit ($0.05/$0.10 USD) - 2021/01/23 20:06:32 ET
Table 'Stephano III' 6-max Seat #1 is the button
Seat 1: FFDD15 ($4.05 in chips) 
Seat 2: André3001 ($14.09 in chips) 
Seat 3: 0nix770 ($13.23 in chips) 
Seat 5: vanapaguss ($18.94 in chips) 
Seat 6: J3vgen ($10 in chips) 
André3001: posts small blind $0.05
0nix770: posts big blind $0.10
*** HOLE CARDS ***
vanapaguss: raises $0.15 to $0.25
J3vgen: folds 
FFDD15: calls $0.25
André3001: raises $0.95 to $1.20
0nix770: folds 
vanapaguss: calls $0.95
FFDD15: folds 
*** FLOP *** [2c 3h 7h]
André3001: bets $1.97
vanapaguss: calls $1.97
*** TURN *** [2c 3h 7h] [Td]
André3001: checks 
vanapaguss: checks 
*** RIVER *** [2c 3h 7h Td] [9c]
André3001: bets $4.80
vanapaguss: folds 
Uncalled bet ($4.80) returned to André3001
André3001 collected $6.39 from pot
André3001: doesn't show hand 
*** SUMMARY ***
Total pot $6.69 | Rake $0.30 
Board [2c 3h 7h Td 9c]
Seat 1: FFDD15 (button) folded before Flop
Seat 2: André3001 (small blind) collected ($6.39)
Seat 3: 0nix770 (big blind) folded before Flop
Seat 5: vanapaguss folded on the River
Seat 6: J3vgen folded before Flop (didn't bet)



PokerStars Hand #222980978743:  Hold'em No Limit ($0.05/$0.10 USD) - 2021/01/23 20:07:17 ET
Table 'Stephano III' 6-max Seat #2 is the button
Seat 1: FFDD15 ($3.80 in chips) 
Seat 2: André3001 ($17.31 in chips) 
Seat 3: 0nix770 ($13.13 in chips) 
Seat 5: vanapaguss ($15.77 in chips) 
Seat 6: J3vgen ($10 in chips) 
0nix770: posts small blind $0.05
vanapaguss: posts big blind $0.10
*** HOLE CARDS ***
J3vgen: raises $0.20 to $0.30
FFDD15: folds 
André3001: calls $0.30
0nix770: folds 
vanapaguss: folds 
*** FLOP *** [9h 2s 9c]
J3vgen: bets $0.29
Do-Man22 joins the table at seat #4 
André3001: calls $0.29
*** TURN *** [9h 2s 9c] [5s]
J3vgen: checks 
André3001: bets $0.95
J3vgen: folds 
Uncalled bet ($0.95) returned to André3001
André3001 collected $1.27 from pot
André3001: doesn't show hand 
*** SUMMARY ***
Total pot $1.33 | Rake $0.06 
Board [9h 2s 9c 5s]
Seat 1: FFDD15 folded before Flop (didn't bet)
Seat 2: André3001 (button) collected ($1.27)
Seat 3: 0nix770 (small blind) folded before Flop
Seat 5: vanapaguss (big blind) folded before Flop
Seat 6: J3vgen folded on the Turn



PokerStars Hand #222980991770:  Hold'em No Limit ($0.05/$0.10 USD) - 2021/01/23 20:07:45 ET
Table 'Stephano III' 6-max Seat #3 is the button
Seat 1: FFDD15 ($3.80 in chips) 
Seat 2: André3001 ($17.99 in chips) 
Seat 3: 0nix770 ($13.08 in chips) 
Seat 5: vanapaguss ($15.67 in chips) 
Seat 6: J3vgen ($10 in chips) 
vanapaguss: posts small blind $0.05
J3vgen: posts big blind $0.10
*** HOLE CARDS ***
FFDD15: folds 
André3001: raises $0.20 to $0.30
0nix770: folds 
vanapaguss: folds 
J3vgen: folds 
Uncalled bet ($0.20) returned to André3001
André3001 collected $0.25 from pot
André3001: doesn't show hand 
*** SUMMARY ***
Total pot $0.25 | Rake $0 
Seat 1: FFDD15 folded before Flop (didn't bet)
Seat 2: André3001 collected ($0.25)
Seat 3: 0nix770 (button) folded before Flop (didn't bet)
Seat 5: vanapaguss (small blind) folded before Flop
Seat 6: J3vgen (big blind) folded before Flop



PokerStars Hand #222981000948:  Hold'em No Limit ($0.05/$0.10 USD) - 2021/01/23 20:08:05 ET
Table 'Stephano III' 6-max Seat #5 is the button
Seat 1: FFDD15 ($3.80 in chips) 
Seat 2: André3001 ($18.14 in chips) 
Seat 3: 0nix770 ($13.08 in chips) 
Seat 4: Do-Man22 ($10 in chips) 
Seat 5: vanapaguss ($15.62 in chips) 
Seat 6: J3vgen ($10 in chips) 
J3vgen: posts small blind $0.05
FFDD15: posts big blind $0.10
Do-Man22: posts big blind $0.10
*** HOLE CARDS ***
André3001: folds 
0nix770: folds 
Do-Man22: raises $0.40 to $0.50
vanapaguss: folds 
J3vgen: folds 
FFDD15: folds 
Uncalled bet ($0.40) returned to Do-Man22
Do-Man22 collected $0.25 from pot
*** SUMMARY ***
Total pot $0.25 | Rake $0 
Seat 1: FFDD15 (big blind) folded before Flop
Seat 2: André3001 folded before Flop (didn't bet)
Seat 3: 0nix770 folded before Flop (didn't bet)
Seat 4: Do-Man22 collected ($0.25)
Seat 5: vanapaguss (button) folded before Flop (didn't bet)
Seat 6: J3vgen (small blind) folded before Flop



PokerStars Hand #222981009465:  Hold'em No Limit ($0.05/$0.10 USD) - 2021/01/23 20:08:24 ET
Table 'Stephano III' 6-max Seat #6 is the button
Seat 1: FFDD15 ($3.70 in chips) 
Seat 2: André3001 ($18.14 in chips) 
Seat 3: 0nix770 ($13.08 in chips) 
Seat 4: Do-Man22 ($10.15 in chips) 
Seat 5: vanapaguss ($15.62 in chips) 
Seat 6: J3vgen ($10 in chips) 
FFDD15: posts small blind $0.05
André3001: posts big blind $0.10
*** HOLE CARDS ***
0nix770: raises $0.20 to $0.30
Do-Man22: raises $0.20 to $0.50
vanapaguss: folds 
J3vgen: folds 
FFDD15: folds 
André3001: calls $0.40
0nix770: calls $0.20
*** FLOP *** [Kh As 5d]
André3001: checks 
0nix770: checks 
Do-Man22: bets $0.90
André3001: calls $0.90
0nix770: folds 
*** TURN *** [Kh As 5d] [Qd]
André3001: checks 
Do-Man22: checks 
*** RIVER *** [Kh As 5d Qd] [6c]
André3001: bets $3.20
Do-Man22: folds 
Uncalled bet ($3.20) returned to André3001
André3001 collected $3.20 from pot
André3001: doesn't show hand 
*** SUMMARY ***
Total pot $3.35 | Rake $0.15 
Board [Kh As 5d Qd 6c]
Seat 1: FFDD15 (small blind) folded before Flop
Seat 2: André3001 (big blind) collected ($3.20)
Seat 3: 0nix770 folded on the Flop
Seat 4: Do-Man22 folded on the River
Seat 5: vanapaguss folded before Flop (didn't bet)
Seat 6: J3vgen (button) folded before Flop (didn't bet)



PokerStars Hand #222981040148:  Hold'em No Limit ($0.05/$0.10 USD) - 2021/01/23 20:09:10 ET
Table 'Stephano III' 6-max Seat #1 is the button
Seat 1: FFDD15 ($3.65 in chips) 
Seat 2: André3001 ($19.94 in chips) 
Seat 3: 0nix770 ($12.58 in chips) 
Seat 4: Do-Man22 ($8.75 in chips) 
Seat 5: vanapaguss ($15.62 in chips) 
Seat 6: J3vgen ($10 in chips) 
André3001: posts small blind $0.05
0nix770: posts big blind $0.10
*** HOLE CARDS ***
Do-Man22: raises $0.60 to $0.70
vanapaguss: folds 
J3vgen: folds 
FFDD15: folds 
André3001: folds 
0nix770: folds 
Uncalled bet ($0.60) returned to Do-Man22
Do-Man22 collected $0.25 from pot
*** SUMMARY ***
Total pot $0.25 | Rake $0 
Seat 1: FFDD15 (button) folded before Flop (didn't bet)
Seat 2: André3001 (small blind) folded before Flop
Seat 3: 0nix770 (big blind) folded before Flop
Seat 4: Do-Man22 collected ($0.25)
Seat 5: vanapaguss folded before Flop (didn't bet)
Seat 6: J3vgen folded before Flop (didn't bet)



PokerStars Hand #222981047495:  Hold'em No Limit ($0.05/$0.10 USD) - 2021/01/23 20:09:26 ET
Table 'Stephano III' 6-max Seat #2 is the button
Seat 1: FFDD15 ($3.65 in chips) 
Seat 2: André3001 ($19.89 in chips) 
Seat 3: 0nix770 ($12.48 in chips) 
Seat 4: Do-Man22 ($10 in chips) 
Seat 5: vanapaguss ($15.62 in chips) 
Seat 6: J3vgen ($10 in chips) 
0nix770: posts small blind $0.05
Do-Man22: posts big blind $0.10
*** HOLE CARDS ***
vanapaguss: folds 
J3vgen: folds 
FFDD15: raises $0.20 to $0.30
André3001: calls $0.30
0nix770: raises $1 to $1.30
Do-Man22: folds 
FFDD15: raises $2.35 to $3.65 and is all-in
André3001: folds 
0nix770: calls $2.35
*** FLOP *** [Th Jd Tc]
*** TURN *** [Th Jd Tc] [5h]
*** RIVER *** [Th Jd Tc 5h] [6d]
*** SHOW DOWN ***
0nix770: shows [Jc As] (two pair, Jacks and Tens)
FFDD15: shows [Ac Qh] (a pair of Tens)
0nix770 collected $7.35 from pot
*** SUMMARY ***
Total pot $7.70 | Rake $0.35 
Board [Th Jd Tc 5h 6d]
Seat 1: FFDD15 showed [Ac Qh] and lost with a pair of Tens
Seat 2: André3001 (button) folded before Flop
Seat 3: 0nix770 (small blind) showed [Jc As] and won ($7.35) with two pair, Jacks and Tens
Seat 4: Do-Man22 (big blind) folded before Flop
Seat 5: vanapaguss folded before Flop (didn't bet)
Seat 6: J3vgen folded before Flop (didn't bet)



PokerStars Hand #222981063551:  Hold'em No Limit ($0.05/$0.10 USD) - 2021/01/23 20:10:02 ET
Table 'Stephano III' 6-max Seat #3 is the button
Seat 2: André3001 ($19.59 in chips) 
Seat 3: 0nix770 ($16.18 in chips) 
Seat 4: Do-Man22 ($9.90 in chips) 
Seat 5: vanapaguss ($15.62 in chips) 
Seat 6: J3vgen ($10 in chips) 
Do-Man22: posts small blind $0.05
vanapaguss: posts big blind $0.10
*** HOLE CARDS ***
J3vgen: folds 
André3001: raises $0.20 to $0.30
0nix770: folds 
Do-Man22: calls $0.25
vanapaguss: calls $0.20
*** FLOP *** [5s 7c 3d]
Do-Man22: bets $0.43
FFDD15 leaves the table
pudge.3096 joins the table at seat #1 
vanapaguss: folds 
André3001: calls $0.43
*** TURN *** [5s 7c 3d] [5h]
Do-Man22: checks 
André3001: bets $1.10
Do-Man22: calls $1.10
*** RIVER *** [5s 7c 3d 5h] [9s]
Do-Man22: checks 
André3001: checks 
*** SHOW DOWN ***
Do-Man22: shows [6d Ah] (a pair of Fives)
André3001: mucks hand 
Do-Man22 collected $3.78 from pot
*** SUMMARY ***
Total pot $3.96 | Rake $0.18 
Board [5s 7c 3d 5h 9s]
Seat 2: André3001 mucked
Seat 3: 0nix770 (button) folded before Flop (didn't bet)
Seat 4: Do-Man22 (small blind) showed [6d Ah] and won ($3.78) with a pair of Fives
Seat 5: vanapaguss (big blind) folded on the Flop
Seat 6: J3vgen folded before Flop (didn't bet)



PokerStars Hand #222981082075:  Hold'em No Limit ($0.05/$0.10 USD) - 2021/01/23 20:10:42 ET
Table 'Stephano III' 6-max Seat #4 is the button
Seat 2: André3001 ($17.76 in chips) 
Seat 3: 0nix770 ($16.18 in chips) 
Seat 4: Do-Man22 ($11.85 in chips) 
Seat 5: vanapaguss ($15.32 in chips) 
Seat 6: J3vgen ($10 in chips) 
vanapaguss: posts small blind $0.05
J3vgen: posts big blind $0.10
pudge.3096: sits out 
*** HOLE CARDS ***
André3001: folds 
0nix770: folds 
Do-Man22: folds 
vanapaguss: folds 
Uncalled bet ($0.05) returned to J3vgen
J3vgen collected $0.10 from pot
J3vgen: doesn't show hand 
*** SUMMARY ***
Total pot $0.10 | Rake $0 
Seat 2: André3001 folded before Flop (didn't bet)
Seat 3: 0nix770 folded before Flop (didn't bet)
Seat 4: Do-Man22 (button) folded before Flop (didn't bet)
Seat 5: vanapaguss (small blind) folded before Flop
Seat 6: J3vgen (big blind) collected ($0.10)



PokerStars Hand #222981090704:  Hold'em No Limit ($0.05/$0.10 USD) - 2021/01/23 20:11:02 ET
Table 'Stephano III' 6-max Seat #5 is the button
Seat 1: pudge.3096 ($10 in chips) 
Seat 2: André3001 ($17.76 in chips) 
Seat 3: 0nix770 ($16.18 in chips) 
Seat 4: Do-Man22 ($11.85 in chips) 
Seat 5: vanapaguss ($15.27 in chips) 
Seat 6: J3vgen ($10.05 in chips) 
J3vgen: posts small blind $0.05
pudge.3096: posts big blind $0.10
*** HOLE CARDS ***
André3001: raises $0.20 to $0.30
0nix770: folds 
Do-Man22: calls $0.30
vanapaguss: folds 
J3vgen: folds 
pudge.3096: calls $0.20
*** FLOP *** [8c 3c 6h]
pudge.3096: checks 
André3001: bets $0.55
Do-Man22: calls $0.55
pudge.3096: folds 
*** TURN *** [8c 3c 6h] [Kc]
André3001: checks 
Do-Man22: checks 
*** RIVER *** [8c 3c 6h Kc] [5s]
André3001: checks 
Do-Man22: checks 
*** SHOW DOWN ***
André3001: shows [Jd As] (high card Ace)
Do-Man22: shows [2h 3h] (a pair of Threes)
Do-Man22 collected $1.96 from pot
*** SUMMARY ***
Total pot $2.05 | Rake $0.09 
Board [8c 3c 6h Kc 5s]
Seat 1: pudge.3096 (big blind) folded on the Flop
Seat 2: André3001 showed [Jd As] and lost with high card Ace
Seat 3: 0nix770 folded before Flop (didn't bet)
Seat 4: Do-Man22 showed [2h 3h] and won ($1.96) with a pair of Threes
Seat 5: vanapaguss (button) folded before Flop (didn't bet)
Seat 6: J3vgen (small blind) folded before Flop



PokerStars Hand #222981107124:  Hold'em No Limit ($0.05/$0.10 USD) - 2021/01/23 20:11:38 ET
Table 'Stephano III' 6-max Seat #6 is the button
Seat 1: pudge.3096 ($10 in chips) 
Seat 2: André3001 ($16.91 in chips) 
Seat 3: 0nix770 ($16.18 in chips) 
Seat 4: Do-Man22 ($12.96 in chips) 
Seat 5: vanapaguss ($15.27 in chips) 
Seat 6: J3vgen ($10 in chips) 
pudge.3096: posts small blind $0.05
André3001: posts big blind $0.10
*** HOLE CARDS ***
0nix770: folds 
Do-Man22: folds 
vanapaguss: folds 
J3vgen: raises $0.20 to $0.30
pudge.3096: folds 
André3001: calls $0.20
*** FLOP *** [5s 8d 6d]
André3001: checks 
J3vgen: bets $0.25
André3001: calls $0.25
*** TURN *** [5s 8d 6d] [7s]
André3001: checks 
J3vgen: checks 
*** RIVER *** [5s 8d 6d 7s] [Qd]
André3001: checks 
J3vgen: checks 
*** SHOW DOWN ***
André3001: shows [5c Ah] (a pair of Fives)
J3vgen: shows [7h 6c] (two pair, Sevens and Sixes)
J3vgen collected $1.10 from pot
*** SUMMARY ***
Total pot $1.15 | Rake $0.05 
Board [5s 8d 6d 7s Qd]
Seat 1: pudge.3096 (small blind) folded before Flop
Seat 2: André3001 (big blind) showed [5c Ah] and lost with a pair of Fives
Seat 3: 0nix770 folded before Flop (didn't bet)
Seat 4: Do-Man22 folded before Flop (didn't bet)
Seat 5: vanapaguss folded before Flop (didn't bet)
Seat 6: J3vgen (button) showed [7h 6c] and won ($1.10) with two pair, Sevens and Sixes



PokerStars Hand #222981121490:  Hold'em No Limit ($0.05/$0.10 USD) - 2021/01/23 20:12:10 ET
Table 'Stephano III' 6-max Seat #1 is the button
Seat 1: pudge.3096 ($10 in chips) 
Seat 2: André3001 ($16.36 in chips) 
Seat 3: 0nix770 ($16.18 in chips) 
Seat 4: Do-Man22 ($12.96 in chips) 
Seat 5: vanapaguss ($15.27 in chips) 
Seat 6: J3vgen ($10.55 in chips) 
André3001: posts small blind $0.05
0nix770: posts big blind $0.10
*** HOLE CARDS ***
Do-Man22: folds 
vanapaguss: folds 
J3vgen: raises $0.20 to $0.30
pudge.3096: folds 
André3001: calls $0.25
0nix770: folds 
*** FLOP *** [6d 3d 9d]
André3001: bets $0.60
J3vgen: folds 
Uncalled bet ($0.60) returned to André3001
André3001 collected $0.67 from pot
André3001: doesn't show hand 
*** SUMMARY ***
Total pot $0.70 | Rake $0.03 
Board [6d 3d 9d]
Seat 1: pudge.3096 (button) folded before Flop (didn't bet)
Seat 2: André3001 (small blind) collected ($0.67)
Seat 3: 0nix770 (big blind) folded before Flop
Seat 4: Do-Man22 folded before Flop (didn't bet)
Seat 5: vanapaguss folded before Flop (didn't bet)
Seat 6: J3vgen folded on the Flop



PokerStars Hand #222981130601:  Hold'em No Limit ($0.05/$0.10 USD) - 2021/01/23 20:12:30 ET
Table 'Stephano III' 6-max Seat #2 is the button
Seat 1: pudge.3096 ($10 in chips) 
Seat 2: André3001 ($16.73 in chips) 
Seat 3: 0nix770 ($16.08 in chips) 
Seat 4: Do-Man22 ($12.96 in chips) 
Seat 5: vanapaguss ($15.27 in chips) 
Seat 6: J3vgen ($10.25 in chips) 
0nix770: posts small blind $0.05
Do-Man22: posts big blind $0.10
*** HOLE CARDS ***
vanapaguss: folds 
J3vgen: folds 
pudge.3096: folds 
André3001: folds 
0nix770: raises $0.20 to $0.30
Do-Man22: calls $0.20
*** FLOP *** [8s Ad 2h]
0nix770: checks 
Do-Man22: bets $0.50
0nix770: calls $0.50
*** TURN *** [8s Ad 2h] [5h]
0nix770: checks 
Do-Man22: bets $0.50
0nix770: raises $1.24 to $1.74
Do-Man22: calls $1.24
*** RIVER *** [8s Ad 2h 5h] [9c]
0nix770: checks 
Do-Man22: checks 
*** SHOW DOWN ***
0nix770: shows [8c 7d] (a pair of Eights)
Do-Man22: shows [Kh As] (a pair of Aces)
Do-Man22 collected $4.85 from pot
*** SUMMARY ***
Total pot $5.08 | Rake $0.23 
Board [8s Ad 2h 5h 9c]
Seat 1: pudge.3096 folded before Flop (didn't bet)
Seat 2: André3001 (button) folded before Flop (didn't bet)
Seat 3: 0nix770 (small blind) showed [8c 7d] and lost with a pair of Eights
Seat 4: Do-Man22 (big blind) showed [Kh As] and won ($4.85) with a pair of Aces
Seat 5: vanapaguss folded before Flop (didn't bet)
Seat 6: J3vgen folded before Flop (didn't bet)



PokerStars Hand #222981153359:  Hold'em No Limit ($0.05/$0.10 USD) - 2021/01/23 20:13:21 ET
Table 'Stephano III' 6-max Seat #3 is the button
Seat 1: pudge.3096 ($10 in chips) 
Seat 2: André3001 ($16.73 in chips) 
Seat 3: 0nix770 ($13.54 in chips) 
Seat 4: Do-Man22 ($15.27 in chips) 
Seat 5: vanapaguss ($15.27 in chips) 
Seat 6: J3vgen ($10.25 in chips) 
Do-Man22: posts small blind $0.05
vanapaguss: posts big blind $0.10
*** HOLE CARDS ***
J3vgen: folds 
pudge.3096: raises $0.20 to $0.30
André3001: folds 
J3vgen leaves the table
0nix770: raises $0.60 to $0.90
Do-Man22: calls $0.85
vanapaguss: folds 
pudge.3096: calls $0.60
*** FLOP *** [3d Kc 9c]
Do-Man22: checks 
pudge.3096: checks 
0nix770: bets $1.47
Do-Man22: folds 
pudge.3096: folds 
Uncalled bet ($1.47) returned to 0nix770
0nix770 collected $2.67 from pot
0nix770: doesn't show hand 
*** SUMMARY ***
Total pot $2.80 | Rake $0.13 
Board [3d Kc 9c]
Seat 1: pudge.3096 folded on the Flop
Seat 2: André3001 folded before Flop (didn't bet)
Seat 3: 0nix770 (button) collected ($2.67)
Seat 4: Do-Man22 (small blind) folded on the Flop
Seat 5: vanapaguss (big blind) folded before Flop
Seat 6: J3vgen folded before Flop (didn't bet)



PokerStars Hand #222981166002:  Hold'em No Limit ($0.05/$0.10 USD) - 2021/01/23 20:13:49 ET
Table 'Stephano III' 6-max Seat #4 is the button
Seat 1: pudge.3096 ($10 in chips) 
Seat 2: André3001 ($16.73 in chips) 
Seat 3: 0nix770 ($15.31 in chips) 
Seat 4: Do-Man22 ($14.37 in chips) 
Seat 5: vanapaguss ($15.17 in chips) 
vanapaguss: posts small blind $0.05
pudge.3096: posts big blind $0.10
*** HOLE CARDS ***
Marauder777 joins the table at seat #6 
André3001: folds 
0nix770: raises $0.15 to $0.25
Do-Man22: calls $0.25
vanapaguss: folds 
pudge.3096: raises $1.15 to $1.40
0nix770: raises $1.80 to $3.20
Do-Man22: folds 
pudge.3096: raises $6.80 to $10 and is all-in
0nix770: calls $6.80
*** FIRST FLOP *** [3h 2c 9s]
*** FIRST TURN *** [3h 2c 9s] [7d]
*** FIRST RIVER *** [3h 2c 9s 7d] [Ah]
*** SECOND FLOP *** [8s 4d 3s]
*** SECOND TURN *** [8s 4d 3s] [8h]
*** SECOND RIVER *** [8s 4d 3s 8h] [5h]
*** FIRST SHOW DOWN ***
pudge.3096: shows [Kd As] (a pair of Aces)
0nix770: shows [Jc Jh] (a pair of Jacks)
pudge.3096 collected $9.70 from pot
*** SECOND SHOW DOWN ***
pudge.3096: shows [Kd As] (a pair of Eights)
0nix770: shows [Jc Jh] (two pair, Jacks and Eights)
0nix770 collected $9.69 from pot
*** SUMMARY ***
Total pot $20.30 | Rake $0.91 
Hand was run twice
FIRST Board [3h 2c 9s 7d Ah]
SECOND Board [8s 4d 3s 8h 5h]
Seat 1: pudge.3096 (big blind) showed [Kd As] and won ($9.70) with a pair of Aces, and lost with a pair of Eights
Seat 2: André3001 folded before Flop (didn't bet)
Seat 3: 0nix770 showed [Jc Jh] and lost with a pair of Jacks, and won ($9.69) with two pair, Jacks and Eights
Seat 4: Do-Man22 (button) folded before Flop
Seat 5: vanapaguss (small blind) folded before Flop



PokerStars Hand #222981197476:  Hold'em No Limit ($0.05/$0.10 USD) - 2021/01/23 20:15:00 ET
Table 'Stephano III' 6-max Seat #5 is the button
Seat 1: pudge.3096 ($10 in chips) 
Seat 3: 0nix770 ($15 in chips) 
Seat 4: Do-Man22 ($14.12 in chips) 
Seat 5: vanapaguss ($15.12 in chips) 
pudge.3096: posts small blind $0.05
André3001: is sitting out 
0nix770: posts big blind $0.10
*** HOLE CARDS ***
Do-Man22: folds 
André3001 leaves the table
vanapaguss: folds 
pudge.3096: folds 
Uncalled bet ($0.05) returned to 0nix770
0nix770 collected $0.10 from pot
0nix770: doesn't show hand 
*** SUMMARY ***
Total pot $0.10 | Rake $0 
Seat 1: pudge.3096 (small blind) folded before Flop
Seat 3: 0nix770 (big blind) collected ($0.10)
Seat 4: Do-Man22 folded before Flop (didn't bet)
Seat 5: vanapaguss (button) folded before Flop (didn't bet)



PokerStars Hand #222981202420:  Hold'em No Limit ($0.05/$0.10 USD) - 2021/01/23 20:15:10 ET
Table 'Stephano III' 6-max Seat #1 is the button
Seat 1: pudge.3096 ($10 in chips) 
Seat 3: 0nix770 ($15.05 in chips) 
Seat 4: Do-Man22 ($14.12 in chips) 
Seat 5: vanapaguss ($15.12 in chips) 
0nix770: posts small blind $0.05
Do-Man22: posts big blind $0.10
Marauder777: sits out 
*** HOLE CARDS ***
vanapaguss: folds 
pudge.3096: folds 
0nix770: calls $0.05
Do-Man22: checks 
*** FLOP *** [Jd Jh 5c]
0nix770: bets $0.10
Do-Man22: folds 
Uncalled bet ($0.10) returned to 0nix770
0nix770 collected $0.19 from pot
0nix770: doesn't show hand 
Machinekev211 joins the table at seat #2 
*** SUMMARY ***
Total pot $0.20 | Rake $0.01 
Board [Jd Jh 5c]
Seat 1: pudge.3096 (button) folded before Flop (didn't bet)
Seat 3: 0nix770 (small blind) collected ($0.19)
Seat 4: Do-Man22 (big blind) folded on the Flop
Seat 5: vanapaguss folded before Flop (didn't bet)



PokerStars Hand #222981210442:  Hold'em No Limit ($0.05/$0.10 USD) - 2021/01/23 20:15:28 ET
Table 'Stephano III' 6-max Seat #3 is the button
Seat 1: pudge.3096 ($10 in chips) 
Seat 3: 0nix770 ($15.14 in chips) 
Seat 4: Do-Man22 ($14.02 in chips) 
Seat 5: vanapaguss ($15.12 in chips) 
Do-Man22: posts small blind $0.05
vanapaguss: posts big blind $0.10
Marauder777: sits out 
Machinekev211: sits out 
*** HOLE CARDS ***
pudge.3096: folds 
0nix770: raises $0.13 to $0.23
Do-Man22: calls $0.18
vanapaguss: folds 
*** FLOP *** [Kd 9d Jh]
Do-Man22: bets $0.30
0nix770: folds 
Uncalled bet ($0.30) returned to Do-Man22
Do-Man22 collected $0.53 from pot
*** SUMMARY ***
Total pot $0.56 | Rake $0.03 
Board [Kd 9d Jh]
Seat 1: pudge.3096 folded before Flop (didn't bet)
Seat 3: 0nix770 (button) folded on the Flop
Seat 4: Do-Man22 (small blind) collected ($0.53)
Seat 5: vanapaguss (big blind) folded before Flop



PokerStars Hand #222981218306:  Hold'em No Limit ($0.05/$0.10 USD) - 2021/01/23 20:15:46 ET
Table 'Stephano III' 6-max Seat #4 is the button
Seat 1: pudge.3096 ($10 in chips) 
Seat 3: 0nix770 ($14.91 in chips) 
Seat 4: Do-Man22 ($14.32 in chips) 
Seat 5: vanapaguss ($15.02 in chips) 
Seat 6: Marauder777 ($10 in chips) 
vanapaguss: posts small blind $0.05
Marauder777: posts big blind $0.10
Machinekev211: sits out 
*** HOLE CARDS ***
pudge.3096: folds 
0nix770: folds 
Do-Man22: raises $0.20 to $0.30
vanapaguss: folds 
Marauder777: calls $0.20
*** FLOP *** [2s 7s 4d]
Marauder777: checks 
Do-Man22: checks 
*** TURN *** [2s 7s 4d] [6d]
Marauder777: checks 
Do-Man22: checks 
*** RIVER *** [2s 7s 4d 6d] [3c]
Marauder777: checks 
Do-Man22: checks 
*** SHOW DOWN ***
Marauder777: shows [Ts 4s] (a pair of Fours)
Do-Man22: mucks hand 
Marauder777 collected $0.62 from pot
*** SUMMARY ***
Total pot $0.65 | Rake $0.03 
Board [2s 7s 4d 6d 3c]
Seat 1: pudge.3096 folded before Flop (didn't bet)
Seat 3: 0nix770 folded before Flop (didn't bet)
Seat 4: Do-Man22 (button) mucked
Seat 5: vanapaguss (small blind) folded before Flop
Seat 6: Marauder777 (big blind) showed [Ts 4s] and won ($0.62) with a pair of Fours



PokerStars Hand #222981235041:  Hold'em No Limit ($0.05/$0.10 USD) - 2021/01/23 20:16:24 ET
Table 'Stephano III' 6-max Seat #5 is the button
Seat 1: pudge.3096 ($10 in chips) 
Seat 3: 0nix770 ($14.91 in chips) 
Seat 4: Do-Man22 ($14.02 in chips) 
Seat 5: vanapaguss ($14.97 in chips) 
Seat 6: Marauder777 ($10.32 in chips) 
Marauder777: posts small blind $0.05
pudge.3096: posts big blind $0.10
Machinekev211: sits out 
*** HOLE CARDS ***
0nix770: folds 
Do-Man22: folds 
vanapaguss: raises $0.15 to $0.25
Marauder777: folds 
pudge.3096: calls $0.15
*** FLOP *** [Ah 9s 9d]
pudge.3096: checks 
vanapaguss: bets $0.19
pudge.3096: folds 
Uncalled bet ($0.19) returned to vanapaguss
vanapaguss collected $0.53 from pot
vanapaguss: doesn't show hand 
*** SUMMARY ***
Total pot $0.55 | Rake $0.02 
Board [Ah 9s 9d]
Seat 1: pudge.3096 (big blind) folded on the Flop
Seat 3: 0nix770 folded before Flop (didn't bet)
Seat 4: Do-Man22 folded before Flop (didn't bet)
Seat 5: vanapaguss (button) collected ($0.53)
Seat 6: Marauder777 (small blind) folded before Flop



PokerStars Hand #222981243236:  Hold'em No Limit ($0.05/$0.10 USD) - 2021/01/23 20:16:42 ET
Table 'Stephano III' 6-max Seat #6 is the button
Seat 1: pudge.3096 ($10 in chips) 
Seat 2: Machinekev211 ($4 in chips) 
Seat 3: 0nix770 ($14.91 in chips) 
Seat 5: vanapaguss ($15.25 in chips) 
Seat 6: Marauder777 ($10.27 in chips) 
pudge.3096: posts small blind $0.05
Machinekev211: posts big blind $0.10
*** HOLE CARDS ***
0nix770: folds 
vanapaguss: folds 
Marauder777: folds 
pudge.3096: folds 
Uncalled bet ($0.05) returned to Machinekev211
Machinekev211 collected $0.10 from pot
Machinekev211: doesn't show hand 
*** SUMMARY ***
Total pot $0.10 | Rake $0 
Seat 1: pudge.3096 (small blind) folded before Flop
Seat 2: Machinekev211 (big blind) collected ($0.10)
Seat 3: 0nix770 folded before Flop (didn't bet)
Seat 5: vanapaguss folded before Flop (didn't bet)
Seat 6: Marauder777 (button) folded before Flop (didn't bet)



PokerStars Hand #222981248996:  Hold'em No Limit ($0.05/$0.10 USD) - 2021/01/23 20:16:55 ET
Table 'Stephano III' 6-max Seat #1 is the button
Seat 1: pudge.3096 ($10 in chips) 
Seat 2: Machinekev211 ($4.05 in chips) 
Seat 3: 0nix770 ($14.91 in chips) 
Seat 5: vanapaguss ($15.25 in chips) 
Seat 6: Marauder777 ($10.27 in chips) 
Machinekev211: posts small blind $0.05
0nix770: posts big blind $0.10
*** HOLE CARDS ***
vanapaguss: folds 
Marauder777: folds 
pudge.3096: folds 
Machinekev211: calls $0.05
0nix770: checks 
*** FLOP *** [Td 7c Ad]
Machinekev211: checks 
0nix770: checks 
*** TURN *** [Td 7c Ad] [2d]
Machinekev211: checks 
0nix770: checks 
*** RIVER *** [Td 7c Ad 2d] [Tc]
Machinekev211: checks 
0nix770: bets $0.14
Machinekev211: folds 
Uncalled bet ($0.14) returned to 0nix770
0nix770 collected $0.19 from pot
0nix770: doesn't show hand 
*** SUMMARY ***
Total pot $0.20 | Rake $0.01 
Board [Td 7c Ad 2d Tc]
Seat 1: pudge.3096 (button) folded before Flop (didn't bet)
Seat 2: Machinekev211 (small blind) folded on the River
Seat 3: 0nix770 (big blind) collected ($0.19)
Seat 5: vanapaguss folded before Flop (didn't bet)
Seat 6: Marauder777 folded before Flop (didn't bet)



PokerStars Hand #222981280361:  Hold'em No Limit ($0.05/$0.10 USD) - 2021/01/23 20:18:06 ET
Table 'Stephano III' 6-max Seat #2 is the button
Seat 1: pudge.3096 ($10 in chips) 
Seat 2: Machinekev211 ($3.95 in chips) 
Seat 3: 0nix770 ($15 in chips) 
Seat 4: Do-Man22 ($14.02 in chips) 
Seat 5: vanapaguss ($15.25 in chips) 
Seat 6: Marauder777 ($10.27 in chips) 
0nix770: posts small blind $0.05
Do-Man22: posts big blind $0.10
*** HOLE CARDS ***
vanapaguss: folds 
Marauder777: folds 
pudge.3096: folds 
Machinekev211: calls $0.10
0nix770: folds 
Do-Man22: checks 
*** FLOP *** [8h 4d Jd]
Do-Man22: checks 
Machinekev211: checks 
*** TURN *** [8h 4d Jd] [Ts]
Do-Man22: checks 
Machinekev211: bets $0.10
Do-Man22: calls $0.10
*** RIVER *** [8h 4d Jd Ts] [Ah]
Do-Man22: checks 
Machinekev211: bets $0.30
Do-Man22: folds 
Uncalled bet ($0.30) returned to Machinekev211
Machinekev211 collected $0.43 from pot
Machinekev211: doesn't show hand 
*** SUMMARY ***
Total pot $0.45 | Rake $0.02 
Board [8h 4d Jd Ts Ah]
Seat 1: pudge.3096 folded before Flop (didn't bet)
Seat 2: Machinekev211 (button) collected ($0.43)
Seat 3: 0nix770 (small blind) folded before Flop
Seat 4: Do-Man22 (big blind) folded on the River
Seat 5: vanapaguss folded before Flop (didn't bet)
Seat 6: Marauder777 folded before Flop (didn't bet)



PokerStars Hand #222981294870:  Hold'em No Limit ($0.05/$0.10 USD) - 2021/01/23 20:18:40 ET
Table 'Stephano III' 6-max Seat #3 is the button
Seat 1: pudge.3096 ($10 in chips) 
Seat 2: Machinekev211 ($4.18 in chips) 
Seat 3: 0nix770 ($14.95 in chips) 
Seat 4: Do-Man22 ($13.82 in chips) 
Seat 5: vanapaguss ($15.25 in chips) 
Seat 6: Marauder777 ($10.27 in chips) 
Do-Man22: posts small blind $0.05
vanapaguss: posts big blind $0.10
*** HOLE CARDS ***
Marauder777: folds 
pudge.3096: folds 
Machinekev211: calls $0.10
0nix770: folds 
Do-Man22: calls $0.05
vanapaguss: checks 
*** FLOP *** [5s 6s 8s]
Do-Man22: bets $0.30
vanapaguss: calls $0.30
Machinekev211: folds 
*** TURN *** [5s 6s 8s] [Qd]
Do-Man22: checks 
vanapaguss: bets $0.60
Do-Man22: folds 
Uncalled bet ($0.60) returned to vanapaguss
vanapaguss collected $0.86 from pot
vanapaguss: doesn't show hand 
*** SUMMARY ***
Total pot $0.90 | Rake $0.04 
Board [5s 6s 8s Qd]
Seat 1: pudge.3096 folded before Flop (didn't bet)
Seat 2: Machinekev211 folded on the Flop
Seat 3: 0nix770 (button) folded before Flop (didn't bet)
Seat 4: Do-Man22 (small blind) folded on the Turn
Seat 5: vanapaguss (big blind) collected ($0.86)
Seat 6: Marauder777 folded before Flop (didn't bet)



PokerStars Hand #222981308702:  Hold'em No Limit ($0.05/$0.10 USD) - 2021/01/23 20:19:11 ET
Table 'Stephano III' 6-max Seat #4 is the button
Seat 1: pudge.3096 ($10 in chips) 
Seat 2: Machinekev211 ($4.08 in chips) 
Seat 3: 0nix770 ($14.95 in chips) 
Seat 4: Do-Man22 ($13.42 in chips) 
Seat 5: vanapaguss ($15.71 in chips) 
Seat 6: Marauder777 ($10.27 in chips) 
vanapaguss: posts small blind $0.05
Marauder777: posts big blind $0.10
*** HOLE CARDS ***
pudge.3096: raises $0.20 to $0.30
Machinekev211: folds 
0nix770: calls $0.30
Do-Man22: folds 
vanapaguss: folds 
Marauder777: folds 
*** FLOP *** [6h Qh 9c]
pudge.3096: checks 
0nix770: bets $0.32
pudge.3096: folds 
Uncalled bet ($0.32) returned to 0nix770
0nix770 collected $0.72 from pot
0nix770: doesn't show hand 
*** SUMMARY ***
Total pot $0.75 | Rake $0.03 
Board [6h Qh 9c]
Seat 1: pudge.3096 folded on the Flop
Seat 2: Machinekev211 folded before Flop (didn't bet)
Seat 3: 0nix770 collected ($0.72)
Seat 4: Do-Man22 (button) folded before Flop (didn't bet)
Seat 5: vanapaguss (small blind) folded before Flop
Seat 6: Marauder777 (big blind) folded before Flop



PokerStars Hand #222981322506:  Hold'em No Limit ($0.05/$0.10 USD) - 2021/01/23 20:19:43 ET
Table 'Stephano III' 6-max Seat #5 is the button
Seat 1: pudge.3096 ($10 in chips) 
Seat 2: Machinekev211 ($4.08 in chips) 
Seat 3: 0nix770 ($15.37 in chips) 
Seat 4: Do-Man22 ($13.42 in chips) 
Seat 5: vanapaguss ($15.66 in chips) 
Seat 6: Marauder777 ($10.17 in chips) 
Marauder777: posts small blind $0.05
pudge.3096: posts big blind $0.10
*** HOLE CARDS ***
Machinekev211: calls $0.10
0nix770: folds 
Do-Man22: folds 
vanapaguss: folds 
Marauder777: folds 
pudge.3096: checks 
*** FLOP *** [7h Kh Th]
pudge.3096: checks 
Machinekev211: checks 
*** TURN *** [7h Kh Th] [8d]
pudge.3096: checks 
Machinekev211: checks 
*** RIVER *** [7h Kh Th 8d] [3c]
pudge.3096: checks 
Machinekev211: checks 
*** SHOW DOWN ***
pudge.3096: shows [2d Qc] (high card King)
Machinekev211: shows [6h 6c] (a pair of Sixes)
Machinekev211 collected $0.24 from pot
*** SUMMARY ***
Total pot $0.25 | Rake $0.01 
Board [7h Kh Th 8d 3c]
Seat 1: pudge.3096 (big blind) showed [2d Qc] and lost with high card King
Seat 2: Machinekev211 showed [6h 6c] and won ($0.24) with a pair of Sixes
Seat 3: 0nix770 folded before Flop (didn't bet)
Seat 4: Do-Man22 folded before Flop (didn't bet)
Seat 5: vanapaguss (button) folded before Flop (didn't bet)
Seat 6: Marauder777 (small blind) folded before Flop



PokerStars Hand #222981333900:  Hold'em No Limit ($0.05/$0.10 USD) - 2021/01/23 20:20:09 ET
Table 'Stephano III' 6-max Seat #6 is the button
Seat 1: pudge.3096 ($10 in chips) 
Seat 2: Machinekev211 ($4.22 in chips) 
Seat 3: 0nix770 ($15.37 in chips) 
Seat 4: Do-Man22 ($13.42 in chips) 
Seat 5: vanapaguss ($15.66 in chips) 
Seat 6: Marauder777 ($10.12 in chips) 
pudge.3096: posts small blind $0.05
Machinekev211: posts big blind $0.10
*** HOLE CARDS ***
0nix770: folds 
Do-Man22: folds 
vanapaguss: folds 
Marauder777: folds 
pudge.3096: raises $0.15 to $0.25
Machinekev211: calls $0.15
*** FLOP *** [9h Jd 8s]
pudge.3096: bets $0.15
Machinekev211: calls $0.15
*** TURN *** [9h Jd 8s] [9d]
pudge.3096: bets $0.57
Machinekev211: folds 
Uncalled bet ($0.57) returned to pudge.3096
pudge.3096 collected $0.76 from pot
pudge.3096: doesn't show hand 
*** SUMMARY ***
Total pot $0.80 | Rake $0.04 
Board [9h Jd 8s 9d]
Seat 1: pudge.3096 (small blind) collected ($0.76)
Seat 2: Machinekev211 (big blind) folded on the Turn
Seat 3: 0nix770 folded before Flop (didn't bet)
Seat 4: Do-Man22 folded before Flop (didn't bet)
Seat 5: vanapaguss folded before Flop (didn't bet)
Seat 6: Marauder777 (button) folded before Flop (didn't bet)



PokerStars Hand #222981346316:  Hold'em No Limit ($0.05/$0.10 USD) - 2021/01/23 20:20:38 ET
Table 'Stephano III' 6-max Seat #1 is the button
Seat 1: pudge.3096 ($10.36 in chips) 
Seat 2: Machinekev211 ($3.82 in chips) 
Seat 3: 0nix770 ($15.37 in chips) 
Seat 4: Do-Man22 ($13.42 in chips) 
Seat 5: vanapaguss ($15.66 in chips) 
Seat 6: Marauder777 ($10.12 in chips) 
Machinekev211: posts small blind $0.05
0nix770: posts big blind $0.10
*** HOLE CARDS ***
Do-Man22: calls $0.10
vanapaguss has timed out
vanapaguss: folds 
Marauder777: folds 
pudge.3096: folds 
Machinekev211: folds 
0nix770: raises $0.40 to $0.50
Do-Man22: calls $0.40
*** FLOP *** [8h 7c 8s]
0nix770: bets $0.51
Do-Man22: folds 
Uncalled bet ($0.51) returned to 0nix770
0nix770 collected $1 from pot
0nix770: doesn't show hand 
*** SUMMARY ***
Total pot $1.05 | Rake $0.05 
Board [8h 7c 8s]
Seat 1: pudge.3096 (button) folded before Flop (didn't bet)
Seat 2: Machinekev211 (small blind) folded before Flop
Seat 3: 0nix770 (big blind) collected ($1)
Seat 4: Do-Man22 folded on the Flop
Seat 5: vanapaguss folded before Flop (didn't bet)
Seat 6: Marauder777 folded before Flop (didn't bet)



PokerStars Hand #222981362401:  Hold'em No Limit ($0.05/$0.10 USD) - 2021/01/23 20:21:14 ET
Table 'Stephano III' 6-max Seat #2 is the button
Seat 1: pudge.3096 ($10.36 in chips) 
Seat 2: Machinekev211 ($3.77 in chips) 
Seat 3: 0nix770 ($15.87 in chips) 
Seat 4: Do-Man22 ($12.92 in chips) 
Seat 5: vanapaguss ($15.66 in chips) 
Seat 6: Marauder777 ($10.12 in chips) 
0nix770: posts small blind $0.05
Do-Man22: posts big blind $0.10
*** HOLE CARDS ***
vanapaguss: folds 
Marauder777: folds 
pudge.3096: folds 
Machinekev211: calls $0.10
0nix770: folds 
Do-Man22: checks 
*** FLOP *** [Th 3h 8h]
Do-Man22: bets $0.30
Machinekev211: calls $0.30
*** TURN *** [Th 3h 8h] [Jh]
Do-Man22: checks 
Machinekev211: checks 
*** RIVER *** [Th 3h 8h Jh] [4d]
Do-Man22: checks 
Machinekev211: checks 
*** SHOW DOWN ***
Do-Man22: shows [3s 2s] (a pair of Threes)
Machinekev211: shows [8d Ac] (a pair of Eights)
Machinekev211 collected $0.81 from pot
*** SUMMARY ***
Total pot $0.85 | Rake $0.04 
Board [Th 3h 8h Jh 4d]
Seat 1: pudge.3096 folded before Flop (didn't bet)
Seat 2: Machinekev211 (button) showed [8d Ac] and won ($0.81) with a pair of Eights
Seat 3: 0nix770 (small blind) folded before Flop
Seat 4: Do-Man22 (big blind) showed [3s 2s] and lost with a pair of Threes
Seat 5: vanapaguss folded before Flop (didn't bet)
Seat 6: Marauder777 folded before Flop (didn't bet)



PokerStars Hand #222981377343:  Hold'em No Limit ($0.05/$0.10 USD) - 2021/01/23 20:21:49 ET
Table 'Stephano III' 6-max Seat #3 is the button
Seat 1: pudge.3096 ($10.36 in chips) 
Seat 2: Machinekev211 ($4.18 in chips) 
Seat 3: 0nix770 ($15.82 in chips) 
Seat 4: Do-Man22 ($12.52 in chips) 
Seat 5: vanapaguss ($15.66 in chips) 
Seat 6: Marauder777 ($10.12 in chips) 
Do-Man22: posts small blind $0.05
vanapaguss: posts big blind $0.10
*** HOLE CARDS ***
Marauder777: folds 
pudge.3096: folds 
Machinekev211: folds 
Machinekev211 leaves the table
0nix770: raises $0.13 to $0.23
Do-Man22: folds 
vanapaguss: raises $0.87 to $1.10
0nix770: folds 
Uncalled bet ($0.87) returned to vanapaguss
vanapaguss collected $0.51 from pot
vanapaguss: doesn't show hand 
*** SUMMARY ***
Total pot $0.51 | Rake $0 
Seat 1: pudge.3096 folded before Flop (didn't bet)
Seat 2: Machinekev211 folded before Flop (didn't bet)
Seat 3: 0nix770 (button) folded before Flop
Seat 4: Do-Man22 (small blind) folded before Flop
Seat 5: vanapaguss (big blind) collected ($0.51)
Seat 6: Marauder777 folded before Flop (didn't bet)



PokerStars Hand #222981387201:  Hold'em No Limit ($0.05/$0.10 USD) - 2021/01/23 20:22:11 ET
Table 'Stephano III' 6-max Seat #4 is the button
Seat 1: pudge.3096 ($10.36 in chips) 
Seat 3: 0nix770 ($15.59 in chips) 
Seat 4: Do-Man22 ($12.47 in chips) 
Seat 5: vanapaguss ($15.94 in chips) 
Seat 6: Marauder777 ($10.12 in chips) 
vanapaguss: posts small blind $0.05
Marauder777: posts big blind $0.10
*** HOLE CARDS ***
pudge.3096: folds 
0nix770: folds 
Do-Man22: folds 
vanapaguss: folds 
Uncalled bet ($0.05) returned to Marauder777
Marauder777 collected $0.10 from pot
Marauder777: doesn't show hand 
*** SUMMARY ***
Total pot $0.10 | Rake $0 
Seat 1: pudge.3096 folded before Flop (didn't bet)
Seat 3: 0nix770 folded before Flop (didn't bet)
Seat 4: Do-Man22 (button) folded before Flop (didn't bet)
Seat 5: vanapaguss (small blind) folded before Flop
Seat 6: Marauder777 (big blind) collected ($0.10)



PokerStars Hand #222981389734:  Hold'em No Limit ($0.05/$0.10 USD) - 2021/01/23 20:22:17 ET
Table 'Stephano III' 6-max Seat #5 is the button
Seat 1: pudge.3096 ($10.36 in chips) 
Seat 3: 0nix770 ($15.59 in chips) 
Seat 4: Do-Man22 ($12.47 in chips) 
Seat 5: vanapaguss ($15.89 in chips) 
Seat 6: Marauder777 ($10.17 in chips) 
Marauder777: posts small blind $0.05
pudge.3096: posts big blind $0.10
*** HOLE CARDS ***
0nix770: folds 
Do-Man22: folds 
vanapaguss: raises $0.15 to $0.25
Marauder777: folds 
pudge.3096: folds 
Uncalled bet ($0.15) returned to vanapaguss
vanapaguss collected $0.25 from pot
vanapaguss: doesn't show hand 
*** SUMMARY ***
Total pot $0.25 | Rake $0 
Seat 1: pudge.3096 (big blind) folded before Flop
Seat 3: 0nix770 folded before Flop (didn't bet)
Seat 4: Do-Man22 folded before Flop (didn't bet)
Seat 5: vanapaguss (button) collected ($0.25)
Seat 6: Marauder777 (small blind) folded before Flop



PokerStars Hand #222981394419:  Hold'em No Limit ($0.05/$0.10 USD) - 2021/01/23 20:22:28 ET
Table 'Stephano III' 6-max Seat #6 is the button
Seat 1: pudge.3096 ($10.26 in chips) 
Seat 3: 0nix770 ($15.59 in chips) 
Seat 4: Do-Man22 ($12.47 in chips) 
Seat 5: vanapaguss ($16.04 in chips) 
Seat 6: Marauder777 ($10.12 in chips) 
pudge.3096: posts small blind $0.05
0nix770: posts big blind $0.10
*** HOLE CARDS ***
Do-Man22: folds 
vanapaguss: folds 
Marauder777: folds 
pudge.3096: raises $0.15 to $0.25
0nix770: calls $0.15
*** FLOP *** [Ad Kc Qc]
pudge.3096: bets $0.24
0nix770: calls $0.24
*** TURN *** [Ad Kc Qc] [6h]
pudge.3096: bets $0.71
0nix770: folds 
Uncalled bet ($0.71) returned to pudge.3096
pudge.3096 collected $0.94 from pot
pudge.3096: doesn't show hand 
*** SUMMARY ***
Total pot $0.98 | Rake $0.04 
Board [Ad Kc Qc 6h]
Seat 1: pudge.3096 (small blind) collected ($0.94)
Seat 3: 0nix770 (big blind) folded on the Turn
Seat 4: Do-Man22 folded before Flop (didn't bet)
Seat 5: vanapaguss folded before Flop (didn't bet)
Seat 6: Marauder777 (button) folded before Flop (didn't bet)



PokerStars Hand #222981408431:  Hold'em No Limit ($0.05/$0.10 USD) - 2021/01/23 20:23:00 ET
Table 'Stephano III' 6-max Seat #1 is the button
Seat 1: pudge.3096 ($10.71 in chips) 
Seat 3: 0nix770 ($15.10 in chips) 
Seat 4: Do-Man22 ($12.47 in chips) 
Seat 5: vanapaguss ($16.04 in chips) 
Seat 6: Marauder777 ($10.12 in chips) 
0nix770: posts small blind $0.05
Do-Man22: posts big blind $0.10
*** HOLE CARDS ***
vanapaguss: folds 
Marauder777: folds 
pudge.3096: folds 
0nix770: folds 
Uncalled bet ($0.05) returned to Do-Man22
Do-Man22 collected $0.10 from pot
*** SUMMARY ***
Total pot $0.10 | Rake $0 
Seat 1: pudge.3096 (button) folded before Flop (didn't bet)
Seat 3: 0nix770 (small blind) folded before Flop
Seat 4: Do-Man22 (big blind) collected ($0.10)
Seat 5: vanapaguss folded before Flop (didn't bet)
Seat 6: Marauder777 folded before Flop (didn't bet)



PokerStars Hand #222981413516:  Hold'em No Limit ($0.05/$0.10 USD) - 2021/01/23 20:23:11 ET
Table 'Stephano III' 6-max Seat #3 is the button
Seat 1: pudge.3096 ($10.71 in chips) 
Seat 3: 0nix770 ($15.05 in chips) 
Seat 4: Do-Man22 ($12.52 in chips) 
Seat 5: vanapaguss ($16.04 in chips) 
Seat 6: Marauder777 ($10.12 in chips) 
Do-Man22: posts small blind $0.05
vanapaguss: posts big blind $0.10
*** HOLE CARDS ***
Marauder777: raises $0.12 to $0.22
pudge.3096: folds 
0nix770: folds 
Do-Man22: calls $0.17
vanapaguss: calls $0.12
*** FLOP *** [Qd 6s Jh]
Do-Man22: bets $1
vanapaguss: folds 
benben288 joins the table at seat #2 
Marauder777: raises $1.95 to $2.95
Do-Man22: raises $9.35 to $12.30 and is all-in
Marauder777: calls $6.95 and is all-in
Uncalled bet ($2.40) returned to Do-Man22
*** TURN *** [Qd 6s Jh] [Ah]
*** RIVER *** [Qd 6s Jh Ah] [8s]
*** SHOW DOWN ***
Do-Man22: shows [Qh Js] (two pair, Queens and Jacks)
Marauder777: shows [Jc Qc] (two pair, Queens and Jacks)
Do-Man22 collected $9.77 from pot
Marauder777 collected $9.77 from pot
*** SUMMARY ***
Total pot $20.46 | Rake $0.92 
Board [Qd 6s Jh Ah 8s]
Seat 1: pudge.3096 folded before Flop (didn't bet)
Seat 3: 0nix770 (button) folded before Flop (didn't bet)
Seat 4: Do-Man22 (small blind) showed [Qh Js] and won ($9.77) with two pair, Queens and Jacks
Seat 5: vanapaguss (big blind) folded on the Flop
Seat 6: Marauder777 showed [Jc Qc] and won ($9.77) with two pair, Queens and Jacks



PokerStars Hand #222981433075:  Hold'em No Limit ($0.05/$0.10 USD) - 2021/01/23 20:23:51 ET
Table 'Stephano III' 6-max Seat #4 is the button
Seat 1: pudge.3096 ($10.71 in chips) 
Seat 3: 0nix770 ($15.05 in chips) 
Seat 4: Do-Man22 ($12.17 in chips) 
Seat 5: vanapaguss ($15.82 in chips) 
Seat 6: Marauder777 ($10 in chips) 
vanapaguss: posts small blind $0.05
Marauder777: posts big blind $0.10
benben288: sits out 
*** HOLE CARDS ***
pudge.3096: folds 
0nix770: folds 
Do-Man22: raises $0.20 to $0.30
vanapaguss: folds 
Marauder777: folds 
Uncalled bet ($0.20) returned to Do-Man22
Do-Man22 collected $0.25 from pot
*** SUMMARY ***
Total pot $0.25 | Rake $0 
Seat 1: pudge.3096 folded before Flop (didn't bet)
Seat 3: 0nix770 folded before Flop (didn't bet)
Seat 4: Do-Man22 (button) collected ($0.25)
Seat 5: vanapaguss (small blind) folded before Flop
Seat 6: Marauder777 (big blind) folded before Flop



PokerStars Hand #222981440627:  Hold'em No Limit ($0.05/$0.10 USD) - 2021/01/23 20:24:08 ET
Table 'Stephano III' 6-max Seat #5 is the button
Seat 1: pudge.3096 ($10.71 in chips) 
Seat 3: 0nix770 ($15.05 in chips) 
Seat 4: Do-Man22 ($12.32 in chips) 
Seat 5: vanapaguss ($15.77 in chips) 
Seat 6: Marauder777 ($10 in chips) 
Marauder777: posts small blind $0.05
pudge.3096: posts big blind $0.10
benben288: sits out 
*** HOLE CARDS ***
0nix770: raises $0.20 to $0.30
Do-Man22: calls $0.30
vanapaguss: folds 
Marauder777: calls $0.25
pudge.3096: folds 
*** FLOP *** [9h Jh 2d]
Marauder777: checks 
0nix770: checks 
Do-Man22: checks 
*** TURN *** [9h Jh 2d] [Js]
Marauder777: bets $0.61
0nix770: folds 
Do-Man22: folds 
Uncalled bet ($0.61) returned to Marauder777
Marauder777 collected $0.96 from pot
Marauder777: doesn't show hand 
*** SUMMARY ***
Total pot $1 | Rake $0.04 
Board [9h Jh 2d Js]
Seat 1: pudge.3096 (big blind) folded before Flop
Seat 3: 0nix770 folded on the Turn
Seat 4: Do-Man22 folded on the Turn
Seat 5: vanapaguss (button) folded before Flop (didn't bet)
Seat 6: Marauder777 (small blind) collected ($0.96)



PokerStars Hand #222981459460:  Hold'em No Limit ($0.05/$0.10 USD) - 2021/01/23 20:24:51 ET
Table 'Stephano III' 6-max Seat #6 is the button
Seat 1: pudge.3096 ($10.61 in chips) 
Seat 2: benben288 ($8 in chips) 
Seat 3: 0nix770 ($14.75 in chips) 
Seat 4: Do-Man22 ($12.02 in chips) 
Seat 5: vanapaguss ($15.77 in chips) 
Seat 6: Marauder777 ($10.66 in chips) 
pudge.3096: posts small blind $0.05
benben288: posts big blind $0.10
*** HOLE CARDS ***
0nix770: folds 
Do-Man22: folds 
vanapaguss: folds 
Marauder777: folds 
pudge.3096: folds 
Uncalled bet ($0.05) returned to benben288
benben288 collected $0.10 from pot
benben288: doesn't show hand 
*** SUMMARY ***
Total pot $0.10 | Rake $0 
Seat 1: pudge.3096 (small blind) folded before Flop
Seat 2: benben288 (big blind) collected ($0.10)
Seat 3: 0nix770 folded before Flop (didn't bet)
Seat 4: Do-Man22 folded before Flop (didn't bet)
Seat 5: vanapaguss folded before Flop (didn't bet)
Seat 6: Marauder777 (button) folded before Flop (didn't bet)



PokerStars Hand #222981465880:  Hold'em No Limit ($0.05/$0.10 USD) - 2021/01/23 20:25:05 ET
Table 'Stephano III' 6-max Seat #1 is the button
Seat 1: pudge.3096 ($10.56 in chips) 
Seat 2: benben288 ($8.05 in chips) 
Seat 3: 0nix770 ($14.75 in chips) 
Seat 4: Do-Man22 ($12.02 in chips) 
Seat 5: vanapaguss ($15.77 in chips) 
Seat 6: Marauder777 ($10.66 in chips) 
benben288: posts small blind $0.05
0nix770: posts big blind $0.10
*** HOLE CARDS ***
Do-Man22: folds 
vanapaguss: folds 
Marauder777: folds 
pudge.3096: folds 
benben288: folds 
Uncalled bet ($0.05) returned to 0nix770
0nix770 collected $0.10 from pot
0nix770: doesn't show hand 
*** SUMMARY ***
Total pot $0.10 | Rake $0 
Seat 1: pudge.3096 (button) folded before Flop (didn't bet)
Seat 2: benben288 (small blind) folded before Flop
Seat 3: 0nix770 (big blind) collected ($0.10)
Seat 4: Do-Man22 folded before Flop (didn't bet)
Seat 5: vanapaguss folded before Flop (didn't bet)
Seat 6: Marauder777 folded before Flop (didn't bet)



PokerStars Hand #222981470140:  Hold'em No Limit ($0.05/$0.10 USD) - 2021/01/23 20:25:15 ET
Table 'Stephano III' 6-max Seat #2 is the button
Seat 1: pudge.3096 ($10.56 in chips) 
Seat 2: benben288 ($8 in chips) 
Seat 3: 0nix770 ($14.80 in chips) 
Seat 4: Do-Man22 ($12.02 in chips) 
Seat 5: vanapaguss ($15.77 in chips) 
Seat 6: Marauder777 ($10.66 in chips) 
0nix770: posts small blind $0.05
Do-Man22: posts big blind $0.10
*** HOLE CARDS ***
vanapaguss: folds 
Marauder777: folds 
pudge.3096: folds 
benben288: folds 
0nix770: raises $0.20 to $0.30
Do-Man22: folds 
Uncalled bet ($0.20) returned to 0nix770
0nix770 collected $0.20 from pot
0nix770: doesn't show hand 
*** SUMMARY ***
Total pot $0.20 | Rake $0 
Seat 1: pudge.3096 folded before Flop (didn't bet)
Seat 2: benben288 (button) folded before Flop (didn't bet)
Seat 3: 0nix770 (small blind) collected ($0.20)
Seat 4: Do-Man22 (big blind) folded before Flop
Seat 5: vanapaguss folded before Flop (didn't bet)
Seat 6: Marauder777 folded before Flop (didn't bet)



PokerStars Hand #222981475643:  Hold'em No Limit ($0.05/$0.10 USD) - 2021/01/23 20:25:27 ET
Table 'Stephano III' 6-max Seat #3 is the button
Seat 1: pudge.3096 ($10.56 in chips) 
Seat 2: benben288 ($8 in chips) 
Seat 3: 0nix770 ($14.90 in chips) 
Seat 4: Do-Man22 ($11.92 in chips) 
Seat 5: vanapaguss ($15.77 in chips) 
Seat 6: Marauder777 ($10.66 in chips) 
Do-Man22: posts small blind $0.05
vanapaguss: posts big blind $0.10
*** HOLE CARDS ***
Marauder777: raises $0.12 to $0.22
pudge.3096: folds 
benben288: folds 
0nix770: folds 
Do-Man22: folds 
vanapaguss: folds 
Uncalled bet ($0.12) returned to Marauder777
Marauder777 collected $0.25 from pot
Marauder777: doesn't show hand 
*** SUMMARY ***
Total pot $0.25 | Rake $0 
Seat 1: pudge.3096 folded before Flop (didn't bet)
Seat 2: benben288 folded before Flop (didn't bet)
Seat 3: 0nix770 (button) folded before Flop (didn't bet)
Seat 4: Do-Man22 (small blind) folded before Flop
Seat 5: vanapaguss (big blind) folded before Flop
Seat 6: Marauder777 collected ($0.25)



PokerStars Hand #222981484521:  Hold'em No Limit ($0.05/$0.10 USD) - 2021/01/23 20:25:47 ET
Table 'Stephano III' 6-max Seat #4 is the button
Seat 1: pudge.3096 ($10.56 in chips) 
Seat 2: benben288 ($8 in chips) 
Seat 3: 0nix770 ($14.90 in chips) 
Seat 4: Do-Man22 ($11.87 in chips) 
Seat 5: vanapaguss ($15.67 in chips) 
Seat 6: Marauder777 ($10.81 in chips) 
vanapaguss: posts small blind $0.05
Marauder777: posts big blind $0.10
*** HOLE CARDS ***
pudge.3096: folds 
benben288: folds 
0nix770: folds 
Do-Man22: raises $0.20 to $0.30
vanapaguss: folds 
Marauder777: folds 
Uncalled bet ($0.20) returned to Do-Man22
Do-Man22 collected $0.25 from pot
*** SUMMARY ***
Total pot $0.25 | Rake $0 
Seat 1: pudge.3096 folded before Flop (didn't bet)
Seat 2: benben288 folded before Flop (didn't bet)
Seat 3: 0nix770 folded before Flop (didn't bet)
Seat 4: Do-Man22 (button) collected ($0.25)
Seat 5: vanapaguss (small blind) folded before Flop
Seat 6: Marauder777 (big blind) folded before Flop



PokerStars Hand #222981501038:  Hold'em No Limit ($0.05/$0.10 USD) - 2021/01/23 20:26:25 ET
Table 'Stephano III' 6-max Seat #5 is the button
Seat 1: pudge.3096 ($10.56 in chips) 
Seat 2: benben288 ($8 in chips) 
Seat 3: 0nix770 ($14.90 in chips) 
Seat 4: Do-Man22 ($12.02 in chips) 
Seat 5: vanapaguss ($15.62 in chips) 
Seat 6: Marauder777 ($10.71 in chips) 
Marauder777: posts small blind $0.05
pudge.3096: posts big blind $0.10
*** HOLE CARDS ***
benben288: folds 
0nix770: folds 
Do-Man22: raises $0.20 to $0.30
vanapaguss: folds 
Marauder777: folds 
pudge.3096: folds 
Uncalled bet ($0.20) returned to Do-Man22
Do-Man22 collected $0.25 from pot
*** SUMMARY ***
Total pot $0.25 | Rake $0 
Seat 1: pudge.3096 (big blind) folded before Flop
Seat 2: benben288 folded before Flop (didn't bet)
Seat 3: 0nix770 folded before Flop (didn't bet)
Seat 4: Do-Man22 collected ($0.25)
Seat 5: vanapaguss (button) folded before Flop (didn't bet)
Seat 6: Marauder777 (small blind) folded before Flop



PokerStars Hand #222981511837:  Hold'em No Limit ($0.05/$0.10 USD) - 2021/01/23 20:26:50 ET
Table 'Stephano III' 6-max Seat #6 is the button
Seat 1: pudge.3096 ($10.46 in chips) 
Seat 2: benben288 ($8 in chips) 
Seat 3: 0nix770 ($14.90 in chips) 
Seat 4: Do-Man22 ($12.17 in chips) 
Seat 5: vanapaguss ($15.62 in chips) 
Seat 6: Marauder777 ($10.66 in chips) 
pudge.3096: posts small blind $0.05
benben288: posts big blind $0.10
*** HOLE CARDS ***
0nix770: folds 
Do-Man22: calls $0.10
vanapaguss: raises $0.30 to $0.40
Marauder777: folds 
pudge.3096: folds 
benben288: folds 
Do-Man22: folds 
Uncalled bet ($0.30) returned to vanapaguss
vanapaguss collected $0.35 from pot
vanapaguss: doesn't show hand 
*** SUMMARY ***
Total pot $0.35 | Rake $0 
Seat 1: pudge.3096 (small blind) folded before Flop
Seat 2: benben288 (big blind) folded before Flop
Seat 3: 0nix770 folded before Flop (didn't bet)
Seat 4: Do-Man22 folded before Flop
Seat 5: vanapaguss collected ($0.35)
Seat 6: Marauder777 (button) folded before Flop (didn't bet)



PokerStars Hand #222981525630:  Hold'em No Limit ($0.05/$0.10 USD) - 2021/01/23 20:27:04 ET
Table 'Stephano III' 6-max Seat #1 is the button
Seat 1: pudge.3096 ($10.41 in chips) 
Seat 2: benben288 ($7.90 in chips) 
Seat 3: 0nix770 ($14.90 in chips) 
Seat 4: Do-Man22 ($12.07 in chips) 
Seat 5: vanapaguss ($15.87 in chips) 
Seat 6: Marauder777 ($10.66 in chips) 
benben288: posts small blind $0.05
0nix770: posts big blind $0.10
*** HOLE CARDS ***
Do-Man22: raises $0.30 to $0.40
vanapaguss: folds 
Marauder777: folds 
pudge.3096: raises $0.80 to $1.20
benben288: folds 
0nix770: calls $1.10
Do-Man22: calls $0.80
*** FLOP *** [5c 7h Qc]
0nix770: checks 
Do-Man22: checks 
pudge.3096: checks 
*** TURN *** [5c 7h Qc] [2h]
0nix770: bets $1.53
Do-Man22: calls $1.53
pudge.3096: folds 
*** RIVER *** [5c 7h Qc 2h] [3d]
0nix770: bets $2.24
Do-Man22: calls $2.24
*** SHOW DOWN ***
0nix770: shows [Js Jd] (a pair of Jacks)
Do-Man22: shows [Qh 8h] (a pair of Queens)
Do-Man22 collected $10.69 from pot
*** SUMMARY ***
Total pot $11.19 | Rake $0.50 
Board [5c 7h Qc 2h 3d]
Seat 1: pudge.3096 (button) folded on the Turn
Seat 2: benben288 (small blind) folded before Flop
Seat 3: 0nix770 (big blind) showed [Js Jd] and lost with a pair of Jacks
Seat 4: Do-Man22 showed [Qh 8h] and won ($10.69) with a pair of Queens
Seat 5: vanapaguss folded before Flop (didn't bet)
Seat 6: Marauder777 folded before Flop (didn't bet)



PokerStars Hand #222981546265:  Hold'em No Limit ($0.05/$0.10 USD) - 2021/01/23 20:27:52 ET
Table 'Stephano III' 6-max Seat #2 is the button
Seat 1: pudge.3096 ($10 in chips) 
Seat 2: benben288 ($7.85 in chips) 
Seat 3: 0nix770 ($10 in chips) 
Seat 4: Do-Man22 ($17.79 in chips) 
Seat 5: vanapaguss ($15.87 in chips) 
Seat 6: Marauder777 ($10.66 in chips) 
0nix770: posts small blind $0.05
Do-Man22: posts big blind $0.10
*** HOLE CARDS ***
vanapaguss: folds 
Marauder777: folds 
pudge.3096: raises $0.20 to $0.30
benben288: calls $0.30
0nix770: folds 
Do-Man22: folds 
*** FLOP *** [9d Kh 4c]
pudge.3096: bets $0.36
benben288: folds 
Uncalled bet ($0.36) returned to pudge.3096
pudge.3096 collected $0.72 from pot
pudge.3096: doesn't show hand 
*** SUMMARY ***
Total pot $0.75 | Rake $0.03 
Board [9d Kh 4c]
Seat 1: pudge.3096 collected ($0.72)
Seat 2: benben288 (button) folded on the Flop
Seat 3: 0nix770 (small blind) folded before Flop
Seat 4: Do-Man22 (big blind) folded before Flop
Seat 5: vanapaguss folded before Flop (didn't bet)
Seat 6: Marauder777 folded before Flop (didn't bet)



PokerStars Hand #222981555515:  Hold'em No Limit ($0.05/$0.10 USD) - 2021/01/23 20:28:14 ET
Table 'Stephano III' 6-max Seat #3 is the button
Seat 1: pudge.3096 ($10.42 in chips) 
Seat 2: benben288 ($7.55 in chips) 
Seat 3: 0nix770 ($10 in chips) 
Seat 4: Do-Man22 ($17.69 in chips) 
Seat 5: vanapaguss ($15.87 in chips) 
Seat 6: Marauder777 ($10.66 in chips) 
Do-Man22: posts small blind $0.05
vanapaguss: posts big blind $0.10
*** HOLE CARDS ***
Marauder777: folds 
pudge.3096: folds 
benben288: raises $0.10 to $0.20
0nix770: calls $0.20
Do-Man22: calls $0.15
vanapaguss: calls $0.10
*** FLOP *** [9h Ah 7c]
Do-Man22: bets $0.30
vanapaguss: folds 
benben288: folds 
0nix770: raises $0.80 to $1.10
Do-Man22: calls $0.80
*** TURN *** [9h Ah 7c] [4s]
Do-Man22: checks 
0nix770: bets $2.86
Do-Man22: folds 
Uncalled bet ($2.86) returned to 0nix770
0nix770 collected $2.86 from pot
0nix770: doesn't show hand 
*** SUMMARY ***
Total pot $3 | Rake $0.14 
Board [9h Ah 7c 4s]
Seat 1: pudge.3096 folded before Flop (didn't bet)
Seat 2: benben288 folded on the Flop
Seat 3: 0nix770 (button) collected ($2.86)
Seat 4: Do-Man22 (small blind) folded on the Turn
Seat 5: vanapaguss (big blind) folded on the Flop
Seat 6: Marauder777 folded before Flop (didn't bet)



PokerStars Hand #222981576357:  Hold'em No Limit ($0.05/$0.10 USD) - 2021/01/23 20:29:03 ET
Table 'Stephano III' 6-max Seat #4 is the button
Seat 1: pudge.3096 ($10.42 in chips) 
Seat 2: benben288 ($7.35 in chips) 
Seat 3: 0nix770 ($11.56 in chips) 
Seat 4: Do-Man22 ($16.39 in chips) 
Seat 5: vanapaguss ($15.67 in chips) 
Seat 6: Marauder777 ($10.66 in chips) 
vanapaguss: posts small blind $0.05
Marauder777: posts big blind $0.10
*** HOLE CARDS ***
pudge.3096: folds 
benben288: folds 
0nix770: folds 
Do-Man22: raises $0.20 to $0.30
vanapaguss: folds 
Marauder777: folds 
Uncalled bet ($0.20) returned to Do-Man22
Do-Man22 collected $0.25 from pot
*** SUMMARY ***
Total pot $0.25 | Rake $0 
Seat 1: pudge.3096 folded before Flop (didn't bet)
Seat 2: benben288 folded before Flop (didn't bet)
Seat 3: 0nix770 folded before Flop (didn't bet)
Seat 4: Do-Man22 (button) collected ($0.25)
Seat 5: vanapaguss (small blind) folded before Flop
Seat 6: Marauder777 (big blind) folded before Flop



PokerStars Hand #222981581762:  Hold'em No Limit ($0.05/$0.10 USD) - 2021/01/23 20:29:15 ET
Table 'Stephano III' 6-max Seat #5 is the button
Seat 1: pudge.3096 ($10.42 in chips) 
Seat 2: benben288 ($7.35 in chips) 
Seat 3: 0nix770 ($11.56 in chips) 
Seat 4: Do-Man22 ($16.54 in chips) 
Seat 5: vanapaguss ($15.62 in chips) 
Seat 6: Marauder777 ($10.56 in chips) 
Marauder777: posts small blind $0.05
pudge.3096: posts big blind $0.10
*** HOLE CARDS ***
benben288: folds 
0nix770: folds 
Do-Man22: raises $0.20 to $0.30
vanapaguss: folds 
Marauder777: folds 
pudge.3096: folds 
Uncalled bet ($0.20) returned to Do-Man22
Do-Man22 collected $0.25 from pot
*** SUMMARY ***
Total pot $0.25 | Rake $0 
Seat 1: pudge.3096 (big blind) folded before Flop
Seat 2: benben288 folded before Flop (didn't bet)
Seat 3: 0nix770 folded before Flop (didn't bet)
Seat 4: Do-Man22 collected ($0.25)
Seat 5: vanapaguss (button) folded before Flop (didn't bet)
Seat 6: Marauder777 (small blind) folded before Flop



PokerStars Hand #222981587338:  Hold'em No Limit ($0.05/$0.10 USD) - 2021/01/23 20:29:28 ET
Table 'Stephano III' 6-max Seat #6 is the button
Seat 1: pudge.3096 ($10.32 in chips) 
Seat 2: benben288 ($7.35 in chips) 
Seat 3: 0nix770 ($11.56 in chips) 
Seat 4: Do-Man22 ($16.69 in chips) 
Seat 5: vanapaguss ($15.62 in chips) 
Seat 6: Marauder777 ($10.51 in chips) 
pudge.3096: posts small blind $0.05
benben288: posts big blind $0.10
*** HOLE CARDS ***
0nix770: folds 
Do-Man22: raises $0.20 to $0.30
vanapaguss: folds 
Marauder777: folds 
pudge.3096: folds 
benben288: folds 
Uncalled bet ($0.20) returned to Do-Man22
Do-Man22 collected $0.25 from pot
*** SUMMARY ***
Total pot $0.25 | Rake $0 
Seat 1: pudge.3096 (small blind) folded before Flop
Seat 2: benben288 (big blind) folded before Flop
Seat 3: 0nix770 folded before Flop (didn't bet)
Seat 4: Do-Man22 collected ($0.25)
Seat 5: vanapaguss folded before Flop (didn't bet)
Seat 6: Marauder777 (button) folded before Flop (didn't bet)



PokerStars Hand #222981595380:  Hold'em No Limit ($0.05/$0.10 USD) - 2021/01/23 20:29:47 ET
Table 'Stephano III' 6-max Seat #1 is the button
Seat 1: pudge.3096 ($10.27 in chips) 
Seat 2: benben288 ($7.25 in chips) 
Seat 3: 0nix770 ($11.56 in chips) 
Seat 4: Do-Man22 ($16.84 in chips) 
Seat 5: vanapaguss ($15.62 in chips) 
Seat 6: Marauder777 ($10.51 in chips) 
benben288: posts small blind $0.05
0nix770: posts big blind $0.10
*** HOLE CARDS ***
Do-Man22: raises $0.20 to $0.30
vanapaguss: folds 
Marauder777: folds 
pudge.3096: raises $0.70 to $1
benben288: calls $0.95
0nix770: folds 
Do-Man22: calls $0.70
*** FLOP *** [7c 3s Qc]
benben288: checks 
Do-Man22: checks 
pudge.3096: checks 
*** TURN *** [7c 3s Qc] [3c]
benben288: checks 
Do-Man22: bets $0.80
pudge.3096: calls $0.80
benben288: folds 
*** RIVER *** [7c 3s Qc 3c] [5s]
Do-Man22: checks 
pudge.3096: checks 
*** SHOW DOWN ***
Do-Man22: shows [6d 7d] (two pair, Sevens and Threes)
pudge.3096: mucks hand 
Do-Man22 collected $4.49 from pot
*** SUMMARY ***
Total pot $4.70 | Rake $0.21 
Board [7c 3s Qc 3c 5s]
Seat 1: pudge.3096 (button) mucked
Seat 2: benben288 (small blind) folded on the Turn
Seat 3: 0nix770 (big blind) folded before Flop
Seat 4: Do-Man22 showed [6d 7d] and won ($4.49) with two pair, Sevens and Threes
Seat 5: vanapaguss folded before Flop (didn't bet)
Seat 6: Marauder777 folded before Flop (didn't bet)



PokerStars Hand #222981618321:  Hold'em No Limit ($0.05/$0.10 USD) - 2021/01/23 20:30:40 ET
Table 'Stephano III' 6-max Seat #2 is the button
Seat 1: pudge.3096 ($10 in chips) 
Seat 2: benben288 ($6.25 in chips) 
Seat 3: 0nix770 ($11.46 in chips) 
Seat 4: Do-Man22 ($19.53 in chips) 
Seat 5: vanapaguss ($15.62 in chips) 
Seat 6: Marauder777 ($10.51 in chips) 
0nix770: posts small blind $0.05
Do-Man22: posts big blind $0.10
*** HOLE CARDS ***
vanapaguss: raises $0.15 to $0.25
Marauder777: folds 
pudge.3096: folds 
benben288: folds 
0nix770: folds 
Do-Man22: calls $0.15
*** FLOP *** [5d Qc 2c]
Do-Man22: bets $0.40
vanapaguss: folds 
Uncalled bet ($0.40) returned to Do-Man22
Do-Man22 collected $0.53 from pot
*** SUMMARY ***
Total pot $0.55 | Rake $0.02 
Board [5d Qc 2c]
Seat 1: pudge.3096 folded before Flop (didn't bet)
Seat 2: benben288 (button) folded before Flop (didn't bet)
Seat 3: 0nix770 (small blind) folded before Flop
Seat 4: Do-Man22 (big blind) collected ($0.53)
Seat 5: vanapaguss folded on the Flop
Seat 6: Marauder777 folded before Flop (didn't bet)



PokerStars Hand #222981630667:  Hold'em No Limit ($0.05/$0.10 USD) - 2021/01/23 20:31:09 ET
Table 'Stephano III' 6-max Seat #3 is the button
Seat 1: pudge.3096 ($10 in chips) 
Seat 2: benben288 ($6.25 in chips) 
Seat 3: 0nix770 ($11.41 in chips) 
Seat 4: Do-Man22 ($19.81 in chips) 
Seat 5: vanapaguss ($15.37 in chips) 
Seat 6: Marauder777 ($10.51 in chips) 
Do-Man22: posts small blind $0.05
vanapaguss: posts big blind $0.10
*** HOLE CARDS ***
Marauder777: folds 
pudge.3096: folds 
benben288: folds 
0nix770: raises $0.13 to $0.23
Do-Man22: calls $0.18
vanapaguss: folds 
*** FLOP *** [Ts 7h 5s]
Do-Man22: checks 
0nix770: bets $0.44
Do-Man22: folds 
Uncalled bet ($0.44) returned to 0nix770
0nix770 collected $0.53 from pot
0nix770: doesn't show hand 
*** SUMMARY ***
Total pot $0.56 | Rake $0.03 
Board [Ts 7h 5s]
Seat 1: pudge.3096 folded before Flop (didn't bet)
Seat 2: benben288 folded before Flop (didn't bet)
Seat 3: 0nix770 (button) collected ($0.53)
Seat 4: Do-Man22 (small blind) folded on the Flop
Seat 5: vanapaguss (big blind) folded before Flop
Seat 6: Marauder777 folded before Flop (didn't bet)



PokerStars Hand #222981640177:  Hold'em No Limit ($0.05/$0.10 USD) - 2021/01/23 20:31:31 ET
Table 'Stephano III' 6-max Seat #4 is the button
Seat 1: pudge.3096 ($10 in chips) 
Seat 2: benben288 ($6.25 in chips) 
Seat 3: 0nix770 ($11.71 in chips) 
Seat 4: Do-Man22 ($19.58 in chips) 
Seat 5: vanapaguss ($15.27 in chips) 
Seat 6: Marauder777 ($10.51 in chips) 
vanapaguss: posts small blind $0.05
Marauder777: posts big blind $0.10
*** HOLE CARDS ***
pudge.3096: folds 
benben288: folds 
0nix770: folds 
Do-Man22: folds 
vanapaguss: folds 
Uncalled bet ($0.05) returned to Marauder777
Marauder777 collected $0.10 from pot
Marauder777: doesn't show hand 
*** SUMMARY ***
Total pot $0.10 | Rake $0 
Seat 1: pudge.3096 folded before Flop (didn't bet)
Seat 2: benben288 folded before Flop (didn't bet)
Seat 3: 0nix770 folded before Flop (didn't bet)
Seat 4: Do-Man22 (button) folded before Flop (didn't bet)
Seat 5: vanapaguss (small blind) folded before Flop
Seat 6: Marauder777 (big blind) collected ($0.10)



PokerStars Hand #222981645253:  Hold'em No Limit ($0.05/$0.10 USD) - 2021/01/23 20:31:43 ET
Table 'Stephano III' 6-max Seat #5 is the button
Seat 1: pudge.3096 ($10 in chips) 
Seat 2: benben288 ($6.25 in chips) 
Seat 3: 0nix770 ($11.71 in chips) 
Seat 4: Do-Man22 ($19.58 in chips) 
Seat 5: vanapaguss ($15.22 in chips) 
Seat 6: Marauder777 ($10.56 in chips) 
Marauder777: posts small blind $0.05
pudge.3096: posts big blind $0.10
*** HOLE CARDS ***
benben288: raises $0.20 to $0.30
0nix770: raises $0.60 to $0.90
Do-Man22: calls $0.90
vanapaguss: folds 
Marauder777: folds 
pudge.3096: folds 
benben288: calls $0.60
*** FLOP *** [6c 3s Tc]
benben288: checks 
0nix770: bets $1.50
Do-Man22: folds 
benben288: calls $1.50
*** TURN *** [6c 3s Tc] [Th]
benben288: checks 
0nix770: bets $1.95
benben288: folds 
Uncalled bet ($1.95) returned to 0nix770
0nix770 collected $5.59 from pot
0nix770: doesn't show hand 
*** SUMMARY ***
Total pot $5.85 | Rake $0.26 
Board [6c 3s Tc Th]
Seat 1: pudge.3096 (big blind) folded before Flop
Seat 2: benben288 folded on the Turn
Seat 3: 0nix770 collected ($5.59)
Seat 4: Do-Man22 folded on the Flop
Seat 5: vanapaguss (button) folded before Flop (didn't bet)
Seat 6: Marauder777 (small blind) folded before Flop



PokerStars Hand #222981668126:  Hold'em No Limit ($0.05/$0.10 USD) - 2021/01/23 20:32:35 ET
Table 'Stephano III' 6-max Seat #6 is the button
Seat 1: pudge.3096 ($10 in chips) 
Seat 2: benben288 ($3.85 in chips) 
Seat 3: 0nix770 ($14.90 in chips) 
Seat 4: Do-Man22 ($18.68 in chips) 
Seat 5: vanapaguss ($15.22 in chips) 
Seat 6: Marauder777 ($10.51 in chips) 
pudge.3096: posts small blind $0.05
benben288: posts big blind $0.10
*** HOLE CARDS ***
0nix770: folds 
Do-Man22: folds 
vanapaguss: raises $0.15 to $0.25
Marauder777: folds 
pudge.3096: folds 
benben288: calls $0.15
*** FLOP *** [3s 5d 7c]
benben288: checks 
vanapaguss: checks 
*** TURN *** [3s 5d 7c] [7s]
benben288: bets $0.60
vanapaguss: folds 
Uncalled bet ($0.60) returned to benben288
benben288 collected $0.53 from pot
benben288: doesn't show hand 
*** SUMMARY ***
Total pot $0.55 | Rake $0.02 
Board [3s 5d 7c 7s]
Seat 1: pudge.3096 (small blind) folded before Flop
Seat 2: benben288 (big blind) collected ($0.53)
Seat 3: 0nix770 folded before Flop (didn't bet)
Seat 4: Do-Man22 folded before Flop (didn't bet)
Seat 5: vanapaguss folded on the Turn
Seat 6: Marauder777 (button) folded before Flop (didn't bet)



PokerStars Hand #222981682417:  Hold'em No Limit ($0.05/$0.10 USD) - 2021/01/23 20:33:09 ET
Table 'Stephano III' 6-max Seat #1 is the button
Seat 1: pudge.3096 ($10 in chips) 
Seat 2: benben288 ($4.13 in chips) 
Seat 3: 0nix770 ($14.90 in chips) 
Seat 4: Do-Man22 ($18.68 in chips) 
Seat 5: vanapaguss ($14.97 in chips) 
Seat 6: Marauder777 ($10.51 in chips) 
benben288: posts small blind $0.05
0nix770: posts big blind $0.10
*** HOLE CARDS ***
Do-Man22: folds 
vanapaguss: raises $0.15 to $0.25
Marauder777: folds 
pudge.3096: folds 
benben288: folds 
0nix770: folds 
Uncalled bet ($0.15) returned to vanapaguss
vanapaguss collected $0.25 from pot
vanapaguss: doesn't show hand 
*** SUMMARY ***
Total pot $0.25 | Rake $0 
Seat 1: pudge.3096 (button) folded before Flop (didn't bet)
Seat 2: benben288 (small blind) folded before Flop
Seat 3: 0nix770 (big blind) folded before Flop
Seat 4: Do-Man22 folded before Flop (didn't bet)
Seat 5: vanapaguss collected ($0.25)
Seat 6: Marauder777 folded before Flop (didn't bet)



PokerStars Hand #222981687100:  Hold'em No Limit ($0.05/$0.10 USD) - 2021/01/23 20:33:19 ET
Table 'Stephano III' 6-max Seat #2 is the button
Seat 1: pudge.3096 ($10 in chips) 
Seat 2: benben288 ($4.08 in chips) 
Seat 3: 0nix770 ($14.80 in chips) 
Seat 4: Do-Man22 ($18.68 in chips) 
Seat 5: vanapaguss ($15.12 in chips) 
Seat 6: Marauder777 ($10.51 in chips) 
0nix770: posts small blind $0.05
Do-Man22: posts big blind $0.10
*** HOLE CARDS ***
vanapaguss: folds 
Marauder777: folds 
pudge.3096: raises $0.20 to $0.30
benben288: folds 
0nix770: calls $0.25
Do-Man22: calls $0.20
*** FLOP *** [Jd Qh 7h]
0nix770: checks 
Do-Man22: bets $1.40
pudge.3096: folds 
0nix770: folds 
Uncalled bet ($1.40) returned to Do-Man22
Do-Man22 collected $0.86 from pot
*** SUMMARY ***
Total pot $0.90 | Rake $0.04 
Board [Jd Qh 7h]
Seat 1: pudge.3096 folded on the Flop
Seat 2: benben288 (button) folded before Flop (didn't bet)
Seat 3: 0nix770 (small blind) folded on the Flop
Seat 4: Do-Man22 (big blind) collected ($0.86)
Seat 5: vanapaguss folded before Flop (didn't bet)
Seat 6: Marauder777 folded before Flop (didn't bet)



PokerStars Hand #222981707459:  Hold'em No Limit ($0.05/$0.10 USD) - 2021/01/23 20:34:06 ET
Table 'Stephano III' 6-max Seat #3 is the button
Seat 1: pudge.3096 ($10 in chips) 
Seat 2: benben288 ($6.08 in chips) 
Seat 3: 0nix770 ($14.50 in chips) 
Seat 4: Do-Man22 ($19.24 in chips) 
Seat 5: vanapaguss ($15.12 in chips) 
Seat 6: Marauder777 ($10.51 in chips) 
Do-Man22: posts small blind $0.05
vanapaguss: posts big blind $0.10
*** HOLE CARDS ***
Marauder777: folds 
pudge.3096: folds 
benben288: folds 
0nix770: raises $0.13 to $0.23
Do-Man22: calls $0.18
vanapaguss: folds 
*** FLOP *** [2c Ts 9d]
Do-Man22: checks 
0nix770: bets $0.34
Do-Man22: folds 
Uncalled bet ($0.34) returned to 0nix770
0nix770 collected $0.53 from pot
0nix770: doesn't show hand 
*** SUMMARY ***
Total pot $0.56 | Rake $0.03 
Board [2c Ts 9d]
Seat 1: pudge.3096 folded before Flop (didn't bet)
Seat 2: benben288 folded before Flop (didn't bet)
Seat 3: 0nix770 (button) collected ($0.53)
Seat 4: Do-Man22 (small blind) folded on the Flop
Seat 5: vanapaguss (big blind) folded before Flop
Seat 6: Marauder777 folded before Flop (didn't bet)



PokerStars Hand #222981715815:  Hold'em No Limit ($0.05/$0.10 USD) - 2021/01/23 20:34:25 ET
Table 'Stephano III' 6-max Seat #4 is the button
Seat 1: pudge.3096 ($10 in chips) 
Seat 2: benben288 ($6.08 in chips) 
Seat 3: 0nix770 ($14.80 in chips) 
Seat 4: Do-Man22 ($19.01 in chips) 
Seat 5: vanapaguss ($15.02 in chips) 
Seat 6: Marauder777 ($10.51 in chips) 
vanapaguss: posts small blind $0.05
Marauder777: posts big blind $0.10
*** HOLE CARDS ***
pudge.3096: folds 
benben288: raises $0.10 to $0.20
0nix770: folds 
Do-Man22: folds 
vanapaguss: folds 
Marauder777: folds 
Uncalled bet ($0.10) returned to benben288
benben288 collected $0.25 from pot
benben288: doesn't show hand 
*** SUMMARY ***
Total pot $0.25 | Rake $0 
Seat 1: pudge.3096 folded before Flop (didn't bet)
Seat 2: benben288 collected ($0.25)
Seat 3: 0nix770 folded before Flop (didn't bet)
Seat 4: Do-Man22 (button) folded before Flop (didn't bet)
Seat 5: vanapaguss (small blind) folded before Flop
Seat 6: Marauder777 (big blind) folded before Flop



PokerStars Hand #222981722229:  Hold'em No Limit ($0.05/$0.10 USD) - 2021/01/23 20:34:35 ET
Table 'Stephano III' 6-max Seat #5 is the button
Seat 1: pudge.3096 ($10 in chips) 
Seat 2: benben288 ($6.23 in chips) 
Seat 3: 0nix770 ($14.80 in chips) 
Seat 4: Do-Man22 ($19.01 in chips) 
Seat 5: vanapaguss ($14.97 in chips) 
Seat 6: Marauder777 ($10.41 in chips) 
Marauder777: posts small blind $0.05
pudge.3096: posts big blind $0.10
*** HOLE CARDS ***
benben288: raises $0.20 to $0.30
0nix770: folds 
Do-Man22: folds 
vanapaguss: folds 
Marauder777: folds 
pudge.3096: calls $0.20
*** FLOP *** [9d 9h 3c]
pudge.3096: checks 
benben288: checks 
*** TURN *** [9d 9h 3c] [5s]
pudge.3096: checks 
benben288: checks 
*** RIVER *** [9d 9h 3c 5s] [8c]
pudge.3096: bets $0.62
benben288: calls $0.62
*** SHOW DOWN ***
pudge.3096: shows [9s Ts] (three of a kind, Nines)
benben288: mucks hand 
pudge.3096 collected $1.80 from pot
*** SUMMARY ***
Total pot $1.89 | Rake $0.09 
Board [9d 9h 3c 5s 8c]
Seat 1: pudge.3096 (big blind) showed [9s Ts] and won ($1.80) with three of a kind, Nines
Seat 2: benben288 mucked
Seat 3: 0nix770 folded before Flop (didn't bet)
Seat 4: Do-Man22 folded before Flop (didn't bet)
Seat 5: vanapaguss (button) folded before Flop (didn't bet)
Seat 6: Marauder777 (small blind) folded before Flop



PokerStars Hand #222981743340:  Hold'em No Limit ($0.05/$0.10 USD) - 2021/01/23 20:35:24 ET
Table 'Stephano III' 6-max Seat #6 is the button
Seat 1: pudge.3096 ($10.88 in chips) 
Seat 2: benben288 ($5.31 in chips) 
Seat 3: 0nix770 ($14.80 in chips) 
Seat 4: Do-Man22 ($19.01 in chips) 
Seat 5: vanapaguss ($14.97 in chips) 
Seat 6: Marauder777 ($10.36 in chips) 
pudge.3096: posts small blind $0.05
benben288: posts big blind $0.10
*** HOLE CARDS ***
0nix770: folds 
Do-Man22: folds 
vanapaguss: folds 
Marauder777: raises $0.15 to $0.25
pudge.3096: folds 
benben288: calls $0.15
*** FLOP *** [3d 8c Qs]
benben288: checks 
Marauder777: bets $0.15
benben288: calls $0.15
*** TURN *** [3d 8c Qs] [Jd]
benben288: checks 
Marauder777: checks 
*** RIVER *** [3d 8c Qs Jd] [Ac]
benben288: checks 
Marauder777: bets $0.28
benben288: folds 
Uncalled bet ($0.28) returned to Marauder777
Marauder777 collected $0.81 from pot
Marauder777: doesn't show hand 
*** SUMMARY ***
Total pot $0.85 | Rake $0.04 
Board [3d 8c Qs Jd Ac]
Seat 1: pudge.3096 (small blind) folded before Flop
Seat 2: benben288 (big blind) folded on the River
Seat 3: 0nix770 folded before Flop (didn't bet)
Seat 4: Do-Man22 folded before Flop (didn't bet)
Seat 5: vanapaguss folded before Flop (didn't bet)
Seat 6: Marauder777 (button) collected ($0.81)



PokerStars Hand #222981760641:  Hold'em No Limit ($0.05/$0.10 USD) - 2021/01/23 20:36:05 ET
Table 'Stephano III' 6-max Seat #1 is the button
Seat 1: pudge.3096 ($10.83 in chips) 
Seat 2: benben288 ($4.91 in chips) 
Seat 3: 0nix770 ($14.80 in chips) 
Seat 4: Do-Man22 ($19.01 in chips) 
Seat 5: vanapaguss ($14.97 in chips) 
Seat 6: Marauder777 ($10.77 in chips) 
benben288: posts small blind $0.05
0nix770: posts big blind $0.10
*** HOLE CARDS ***
Do-Man22: folds 
vanapaguss: folds 
Marauder777: folds 
pudge.3096: folds 
benben288: folds 
Uncalled bet ($0.05) returned to 0nix770
0nix770 collected $0.10 from pot
0nix770: doesn't show hand 
*** SUMMARY ***
Total pot $0.10 | Rake $0 
Seat 1: pudge.3096 (button) folded before Flop (didn't bet)
Seat 2: benben288 (small blind) folded before Flop
Seat 3: 0nix770 (big blind) collected ($0.10)
Seat 4: Do-Man22 folded before Flop (didn't bet)
Seat 5: vanapaguss folded before Flop (didn't bet)
Seat 6: Marauder777 folded before Flop (didn't bet)



PokerStars Hand #222981765801:  Hold'em No Limit ($0.05/$0.10 USD) - 2021/01/23 20:36:17 ET
Table 'Stephano III' 6-max Seat #2 is the button
Seat 1: pudge.3096 ($10.83 in chips) 
Seat 2: benben288 ($4.86 in chips) 
Seat 3: 0nix770 ($14.85 in chips) 
Seat 4: Do-Man22 ($19.01 in chips) 
Seat 5: vanapaguss ($14.97 in chips) 
Seat 6: Marauder777 ($10.77 in chips) 
0nix770: posts small blind $0.05
Do-Man22: posts big blind $0.10
*** HOLE CARDS ***
vanapaguss: folds 
Marauder777: folds 
pudge.3096: folds 
benben288: folds 
0nix770: raises $0.20 to $0.30
Do-Man22: raises $0.20 to $0.50
0nix770: calls $0.20
*** FLOP *** [Jd 8h As]
0nix770: checks 
Do-Man22: bets $0.48
0nix770: calls $0.48
*** TURN *** [Jd 8h As] [Jh]
0nix770: checks 
Do-Man22: bets $0.40
0nix770: raises $1.50 to $1.90
Do-Man22: calls $1.50
*** RIVER *** [Jd 8h As Jh] [3d]
0nix770: bets $6.46
Do-Man22: folds 
Uncalled bet ($6.46) returned to 0nix770
0nix770 collected $5.50 from pot
0nix770: doesn't show hand 
*** SUMMARY ***
Total pot $5.76 | Rake $0.26 
Board [Jd 8h As Jh 3d]
Seat 1: pudge.3096 folded before Flop (didn't bet)
Seat 2: benben288 (button) folded before Flop (didn't bet)
Seat 3: 0nix770 (small blind) collected ($5.50)
Seat 4: Do-Man22 (big blind) folded on the River
Seat 5: vanapaguss folded before Flop (didn't bet)
Seat 6: Marauder777 folded before Flop (didn't bet)



PokerStars Hand #222981786796:  Hold'em No Limit ($0.05/$0.10 USD) - 2021/01/23 20:37:06 ET
Table 'Stephano III' 6-max Seat #3 is the button
Seat 1: pudge.3096 ($10.83 in chips) 
Seat 2: benben288 ($4.86 in chips) 
Seat 3: 0nix770 ($17.47 in chips) 
Seat 4: Do-Man22 ($16.13 in chips) 
Seat 5: vanapaguss ($14.97 in chips) 
Seat 6: Marauder777 ($10.77 in chips) 
Do-Man22: posts small blind $0.05
vanapaguss: posts big blind $0.10
*** HOLE CARDS ***
Marauder777: folds 
pudge.3096: folds 
benben288: folds 
0nix770: folds 
Do-Man22: folds 
Uncalled bet ($0.05) returned to vanapaguss
vanapaguss collected $0.10 from pot
vanapaguss: doesn't show hand 
*** SUMMARY ***
Total pot $0.10 | Rake $0 
Seat 1: pudge.3096 folded before Flop (didn't bet)
Seat 2: benben288 folded before Flop (didn't bet)
Seat 3: 0nix770 (button) folded before Flop (didn't bet)
Seat 4: Do-Man22 (small blind) folded before Flop
Seat 5: vanapaguss (big blind) collected ($0.10)
Seat 6: Marauder777 folded before Flop (didn't bet)



PokerStars Hand #222981792625:  Hold'em No Limit ($0.05/$0.10 USD) - 2021/01/23 20:37:20 ET
Table 'Stephano III' 6-max Seat #4 is the button
Seat 1: pudge.3096 ($10.83 in chips) 
Seat 2: benben288 ($4.86 in chips) 
Seat 3: 0nix770 ($17.47 in chips) 
Seat 4: Do-Man22 ($16.08 in chips) 
Seat 5: vanapaguss ($15.02 in chips) 
Seat 6: Marauder777 ($10.77 in chips) 
vanapaguss: posts small blind $0.05
Marauder777: posts big blind $0.10
*** HOLE CARDS ***
pudge.3096: folds 
benben288: folds 
0nix770: raises $0.15 to $0.25
Do-Man22: calls $0.25
vanapaguss: folds 
Marauder777: folds 
*** FLOP *** [2s 8d Td]
0nix770: checks 
Do-Man22: checks 
*** TURN *** [2s 8d Td] [3h]
0nix770: bets $0.90
Do-Man22: calls $0.90
*** RIVER *** [2s 8d Td 3h] [Qs]
0nix770: bets $3.44
Do-Man22: folds 
Uncalled bet ($3.44) returned to 0nix770
0nix770 collected $2.34 from pot
0nix770: doesn't show hand 
*** SUMMARY ***
Total pot $2.45 | Rake $0.11 
Board [2s 8d Td 3h Qs]
Seat 1: pudge.3096 folded before Flop (didn't bet)
Seat 2: benben288 folded before Flop (didn't bet)
Seat 3: 0nix770 collected ($2.34)
Seat 4: Do-Man22 (button) folded on the River
Seat 5: vanapaguss (small blind) folded before Flop
Seat 6: Marauder777 (big blind) folded before Flop



PokerStars Hand #222981807501:  Hold'em No Limit ($0.05/$0.10 USD) - 2021/01/23 20:37:55 ET
Table 'Stephano III' 6-max Seat #5 is the button
Seat 1: pudge.3096 ($10.83 in chips) 
Seat 2: benben288 ($4.86 in chips) 
Seat 3: 0nix770 ($18.66 in chips) 
Seat 4: Do-Man22 ($14.93 in chips) 
Seat 5: vanapaguss ($14.97 in chips) 
Seat 6: Marauder777 ($10.67 in chips) 
Marauder777: posts small blind $0.05
pudge.3096: posts big blind $0.10
*** HOLE CARDS ***
benben288: folds 
0nix770: raises $0.20 to $0.30
Do-Man22: raises $0.50 to $0.80
vanapaguss: folds 
Marauder777: folds 
pudge.3096: folds 
0nix770: calls $0.50
*** FLOP *** [6h Th 4h]
0nix770: checks 
Do-Man22: bets $1
0nix770: calls $1
*** TURN *** [6h Th 4h] [8s]
0nix770: checks 
Do-Man22: checks 
*** RIVER *** [6h Th 4h 8s] [7h]
0nix770: bets $1.84
Do-Man22: folds 
Uncalled bet ($1.84) returned to 0nix770
0nix770 collected $3.58 from pot
0nix770: doesn't show hand 
*** SUMMARY ***
Total pot $3.75 | Rake $0.17 
Board [6h Th 4h 8s 7h]
Seat 1: pudge.3096 (big blind) folded before Flop
Seat 2: benben288 folded before Flop (didn't bet)
Seat 3: 0nix770 collected ($3.58)
Seat 4: Do-Man22 folded on the River
Seat 5: vanapaguss (button) folded before Flop (didn't bet)
Seat 6: Marauder777 (small blind) folded before Flop



PokerStars Hand #222981826470:  Hold'em No Limit ($0.05/$0.10 USD) - 2021/01/23 20:38:40 ET
Table 'Stephano III' 6-max Seat #6 is the button
Seat 1: pudge.3096 ($10.73 in chips) 
Seat 2: benben288 ($4.86 in chips) 
Seat 3: 0nix770 ($20.44 in chips) 
Seat 4: Do-Man22 ($13.13 in chips) 
Seat 5: vanapaguss ($14.97 in chips) 
Seat 6: Marauder777 ($10.62 in chips) 
pudge.3096: posts small blind $0.05
benben288: posts big blind $0.10
*** HOLE CARDS ***
0nix770: raises $0.20 to $0.30
Do-Man22: raises $1.90 to $2.20
vanapaguss: folds 
Marauder777: folds 
pudge.3096: folds 
benben288: folds 
0nix770: folds 
Uncalled bet ($1.90) returned to Do-Man22
Do-Man22 collected $0.75 from pot
*** SUMMARY ***
Total pot $0.75 | Rake $0 
Seat 1: pudge.3096 (small blind) folded before Flop
Seat 2: benben288 (big blind) folded before Flop
Seat 3: 0nix770 folded before Flop
Seat 4: Do-Man22 collected ($0.75)
Seat 5: vanapaguss folded before Flop (didn't bet)
Seat 6: Marauder777 (button) folded before Flop (didn't bet)



PokerStars Hand #222981835528:  Hold'em No Limit ($0.05/$0.10 USD) - 2021/01/23 20:38:55 ET
Table 'Stephano III' 6-max Seat #1 is the button
Seat 1: pudge.3096 ($10.68 in chips) 
Seat 2: benben288 ($4.76 in chips) 
Seat 3: 0nix770 ($20.14 in chips) 
Seat 4: Do-Man22 ($13.58 in chips) 
Seat 5: vanapaguss ($14.97 in chips) 
Seat 6: Marauder777 ($10.62 in chips) 
benben288: posts small blind $0.05
0nix770: posts big blind $0.10
*** HOLE CARDS ***
Do-Man22: raises $0.80 to $0.90
vanapaguss: folds 
Marauder777: folds 
pudge.3096: folds 
benben288: folds 
0nix770: calls $0.80
*** FLOP *** [Kc 4h 2d]
0nix770: checks 
Do-Man22: bets $1.80
0nix770: folds 
Uncalled bet ($1.80) returned to Do-Man22
Do-Man22 collected $1.77 from pot
*** SUMMARY ***
Total pot $1.85 | Rake $0.08 
Board [Kc 4h 2d]
Seat 1: pudge.3096 (button) folded before Flop (didn't bet)
Seat 2: benben288 (small blind) folded before Flop
Seat 3: 0nix770 (big blind) folded on the Flop
Seat 4: Do-Man22 collected ($1.77)
Seat 5: vanapaguss folded before Flop (didn't bet)
Seat 6: Marauder777 folded before Flop (didn't bet)



PokerStars Hand #222981848932:  Hold'em No Limit ($0.05/$0.10 USD) - 2021/01/23 20:39:27 ET
Table 'Stephano III' 6-max Seat #3 is the button
Seat 1: pudge.3096 ($10.68 in chips) 
Seat 3: 0nix770 ($19.24 in chips) 
Seat 4: Do-Man22 ($14.45 in chips) 
Seat 5: vanapaguss ($14.97 in chips) 
Seat 6: Marauder777 ($10.62 in chips) 
Do-Man22: posts small blind $0.05
vanapaguss: posts big blind $0.10
*** HOLE CARDS ***
Marauder777: folds 
pudge.3096: folds 
0nix770: raises $0.13 to $0.23
Do-Man22: calls $0.18
vanapaguss: folds 
*** FLOP *** [7s 3s Qh]
Do-Man22: bets $0.70
0nix770: calls $0.70
*** TURN *** [7s 3s Qh] [9c]
Do-Man22: bets $0.90
0nix770: raises $2.60 to $3.50
Do-Man22: calls $2.60
*** RIVER *** [7s 3s Qh 9c] [8d]
Do-Man22: bets $1.90
0nix770: raises $12.91 to $14.81 and is all-in
Do-Man22: folds 
Uncalled bet ($12.91) returned to 0nix770
0nix770 collected $12.19 from pot
0nix770: doesn't show hand 
*** SUMMARY ***
Total pot $12.76 | Rake $0.57 
Board [7s 3s Qh 9c 8d]
Seat 1: pudge.3096 folded before Flop (didn't bet)
Seat 3: 0nix770 (button) collected ($12.19)
Seat 4: Do-Man22 (small blind) folded on the River
Seat 5: vanapaguss (big blind) folded before Flop
Seat 6: Marauder777 folded before Flop (didn't bet)



PokerStars Hand #222981864123:  Hold'em No Limit ($0.05/$0.10 USD) - 2021/01/23 20:40:02 ET
Table 'Stephano III' 6-max Seat #4 is the button
Seat 1: pudge.3096 ($10.68 in chips) 
Seat 2: benben288 ($4.71 in chips) 
Seat 3: 0nix770 ($25.10 in chips) 
Seat 4: Do-Man22 ($8.12 in chips) 
Seat 5: vanapaguss ($14.87 in chips) 
Seat 6: Marauder777 ($10.62 in chips) 
vanapaguss: posts small blind $0.05
Marauder777: posts big blind $0.10
*** HOLE CARDS ***
pudge.3096: folds 
benben288: folds 
0nix770: folds 
Do-Man22: folds 
vanapaguss: folds 
Uncalled bet ($0.05) returned to Marauder777
Marauder777 collected $0.10 from pot
Marauder777: doesn't show hand 
*** SUMMARY ***
Total pot $0.10 | Rake $0 
Seat 1: pudge.3096 folded before Flop (didn't bet)
Seat 2: benben288 folded before Flop (didn't bet)
Seat 3: 0nix770 folded before Flop (didn't bet)
Seat 4: Do-Man22 (button) folded before Flop (didn't bet)
Seat 5: vanapaguss (small blind) folded before Flop
Seat 6: Marauder777 (big blind) collected ($0.10)



PokerStars Hand #222981869914:  Hold'em No Limit ($0.05/$0.10 USD) - 2021/01/23 20:40:16 ET
Table 'Stephano III' 6-max Seat #5 is the button
Seat 1: pudge.3096 ($10.68 in chips) 
Seat 2: benben288 ($4.71 in chips) 
Seat 3: 0nix770 ($25.10 in chips) 
Seat 4: Do-Man22 ($10 in chips) 
Seat 5: vanapaguss ($14.82 in chips) 
Seat 6: Marauder777 ($10.67 in chips) 
Marauder777: posts small blind $0.05
pudge.3096: posts big blind $0.10
*** HOLE CARDS ***
benben288: folds 
0nix770: folds 
Do-Man22: folds 
vanapaguss: folds 
Marauder777: raises $0.17 to $0.27
pudge.3096: folds 
Uncalled bet ($0.17) returned to Marauder777
Marauder777 collected $0.20 from pot
Marauder777: doesn't show hand 
*** SUMMARY ***
Total pot $0.20 | Rake $0 
Seat 1: pudge.3096 (big blind) folded before Flop
Seat 2: benben288 folded before Flop (didn't bet)
Seat 3: 0nix770 folded before Flop (didn't bet)
Seat 4: Do-Man22 folded before Flop (didn't bet)
Seat 5: vanapaguss (button) folded before Flop (didn't bet)
Seat 6: Marauder777 (small blind) collected ($0.20)



PokerStars Hand #222981879520:  Hold'em No Limit ($0.05/$0.10 USD) - 2021/01/23 20:40:39 ET
Table 'Stephano III' 6-max Seat #6 is the button
Seat 1: pudge.3096 ($10.58 in chips) 
Seat 2: benben288 ($4.71 in chips) 
Seat 3: 0nix770 ($25.10 in chips) 
Seat 4: Do-Man22 ($10 in chips) 
Seat 5: vanapaguss ($14.82 in chips) 
Seat 6: Marauder777 ($10.77 in chips) 
pudge.3096: posts small blind $0.05
benben288: posts big blind $0.10
*** HOLE CARDS ***
0nix770: raises $0.20 to $0.30
Do-Man22: calls $0.30
vanapaguss: folds 
Marauder777: raises $1.25 to $1.55
pudge.3096: folds 
benben288: folds 
0nix770: folds 
Do-Man22: calls $1.25
*** FLOP *** [7d Qs Qh]
Do-Man22: bets $0.80
Marauder777: calls $0.80
*** TURN *** [7d Qs Qh] [6c]
Do-Man22: checks 
Marauder777: checks 
*** RIVER *** [7d Qs Qh 6c] [As]
Do-Man22: checks 
Marauder777: bets $3.79
Do-Man22: folds 
Uncalled bet ($3.79) returned to Marauder777
Marauder777 collected $4.92 from pot
Marauder777: doesn't show hand 
*** SUMMARY ***
Total pot $5.15 | Rake $0.23 
Board [7d Qs Qh 6c As]
Seat 1: pudge.3096 (small blind) folded before Flop
Seat 2: benben288 (big blind) folded before Flop
Seat 3: 0nix770 folded before Flop
Seat 4: Do-Man22 folded on the River
Seat 5: vanapaguss folded before Flop (didn't bet)
Seat 6: Marauder777 (button) collected ($4.92)



PokerStars Hand #222981899833:  Hold'em No Limit ($0.05/$0.10 USD) - 2021/01/23 20:41:27 ET
Table 'Stephano III' 6-max Seat #1 is the button
Seat 1: pudge.3096 ($10.53 in chips) 
Seat 2: benben288 ($4.61 in chips) 
Seat 3: 0nix770 ($24.80 in chips) 
Seat 4: Do-Man22 ($7.65 in chips) 
Seat 5: vanapaguss ($14.82 in chips) 
Seat 6: Marauder777 ($13.34 in chips) 
benben288: posts small blind $0.05
0nix770: posts big blind $0.10
*** HOLE CARDS ***
Do-Man22: folds 
vanapaguss: folds 
Marauder777: folds 
pudge.3096: folds 
benben288: raises $0.20 to $0.30
0nix770: folds 
Uncalled bet ($0.20) returned to benben288
benben288 collected $0.20 from pot
benben288: doesn't show hand 
*** SUMMARY ***
Total pot $0.20 | Rake $0 
Seat 1: pudge.3096 (button) folded before Flop (didn't bet)
Seat 2: benben288 (small blind) collected ($0.20)
Seat 3: 0nix770 (big blind) folded before Flop
Seat 4: Do-Man22 folded before Flop (didn't bet)
Seat 5: vanapaguss folded before Flop (didn't bet)
Seat 6: Marauder777 folded before Flop (didn't bet)



PokerStars Hand #222981905146:  Hold'em No Limit ($0.05/$0.10 USD) - 2021/01/23 20:41:40 ET
Table 'Stephano III' 6-max Seat #2 is the button
Seat 1: pudge.3096 ($10.53 in chips) 
Seat 2: benben288 ($4.71 in chips) 
Seat 3: 0nix770 ($24.70 in chips) 
Seat 4: Do-Man22 ($10 in chips) 
Seat 5: vanapaguss ($14.82 in chips) 
Seat 6: Marauder777 ($13.34 in chips) 
0nix770: posts small blind $0.05
Do-Man22: posts big blind $0.10
*** HOLE CARDS ***
vanapaguss: folds 
Marauder777: folds 
pudge.3096: raises $0.20 to $0.30
benben288: calls $0.30
0nix770: folds 
Do-Man22: folds 
*** FLOP *** [8s 3d Ah]
pudge.3096: bets $0.36
benben288: calls $0.36
*** TURN *** [8s 3d Ah] [5s]
pudge.3096: checks 
benben288: bets $0.70
pudge.3096: folds 
Uncalled bet ($0.70) returned to benben288
benben288 collected $1.40 from pot
benben288: doesn't show hand 
*** SUMMARY ***
Total pot $1.47 | Rake $0.07 
Board [8s 3d Ah 5s]
Seat 1: pudge.3096 folded on the Turn
Seat 2: benben288 (button) collected ($1.40)
Seat 3: 0nix770 (small blind) folded before Flop
Seat 4: Do-Man22 (big blind) folded before Flop
Seat 5: vanapaguss folded before Flop (didn't bet)
Seat 6: Marauder777 folded before Flop (didn't bet)



PokerStars Hand #222981920649:  Hold'em No Limit ($0.05/$0.10 USD) - 2021/01/23 20:42:17 ET
Table 'Stephano III' 6-max Seat #3 is the button
Seat 1: pudge.3096 ($10 in chips) 
Seat 2: benben288 ($5.45 in chips) 
Seat 3: 0nix770 ($24.65 in chips) 
Seat 4: Do-Man22 ($9.90 in chips) 
Seat 5: vanapaguss ($14.82 in chips) 
Seat 6: Marauder777 ($13.34 in chips) 
Do-Man22: posts small blind $0.05
vanapaguss: posts big blind $0.10
*** HOLE CARDS ***
Marauder777: folds 
pudge.3096: folds 
benben288: folds 
0nix770: raises $0.13 to $0.23
Do-Man22: folds 
vanapaguss: folds 
Uncalled bet ($0.13) returned to 0nix770
0nix770 collected $0.25 from pot
0nix770: doesn't show hand 
*** SUMMARY ***
Total pot $0.25 | Rake $0 
Seat 1: pudge.3096 folded before Flop (didn't bet)
Seat 2: benben288 folded before Flop (didn't bet)
Seat 3: 0nix770 (button) collected ($0.25)
Seat 4: Do-Man22 (small blind) folded before Flop
Seat 5: vanapaguss (big blind) folded before Flop
Seat 6: Marauder777 folded before Flop (didn't bet)



PokerStars Hand #222981924470:  Hold'em No Limit ($0.05/$0.10 USD) - 2021/01/23 20:42:26 ET
Table 'Stephano III' 6-max Seat #4 is the button
Seat 1: pudge.3096 ($10 in chips) 
Seat 2: benben288 ($5.45 in chips) 
Seat 3: 0nix770 ($24.80 in chips) 
Seat 4: Do-Man22 ($9.85 in chips) 
Seat 5: vanapaguss ($14.72 in chips) 
Seat 6: Marauder777 ($13.34 in chips) 
vanapaguss: posts small blind $0.05
Marauder777: posts big blind $0.10
*** HOLE CARDS ***
pudge.3096: raises $0.20 to $0.30
benben288: calls $0.30
0nix770: folds 
Do-Man22: folds 
vanapaguss: folds 
Marauder777: folds 
*** FLOP *** [Ts 3s 8d]
pudge.3096: bets $0.36
benben288: calls $0.36
*** TURN *** [Ts 3s 8d] [6h]
pudge.3096: bets $1.05
benben288: folds 
Uncalled bet ($1.05) returned to pudge.3096
pudge.3096 collected $1.40 from pot
pudge.3096: doesn't show hand 
*** SUMMARY ***
Total pot $1.47 | Rake $0.07 
Board [Ts 3s 8d 6h]
Seat 1: pudge.3096 collected ($1.40)
Seat 2: benben288 folded on the Turn
Seat 3: 0nix770 folded before Flop (didn't bet)
Seat 4: Do-Man22 (button) folded before Flop (didn't bet)
Seat 5: vanapaguss (small blind) folded before Flop
Seat 6: Marauder777 (big blind) folded before Flop



PokerStars Hand #222981936845:  Hold'em No Limit ($0.05/$0.10 USD) - 2021/01/23 20:42:55 ET
Table 'Stephano III' 6-max Seat #5 is the button
Seat 1: pudge.3096 ($10.74 in chips) 
Seat 2: benben288 ($4.79 in chips) 
Seat 3: 0nix770 ($24.80 in chips) 
Seat 4: Do-Man22 ($9.85 in chips) 
Seat 5: vanapaguss ($14.67 in chips) 
Seat 6: Marauder777 ($13.24 in chips) 
Marauder777: posts small blind $0.05
pudge.3096: posts big blind $0.10
*** HOLE CARDS ***
benben288: folds 
0nix770: folds 
Do-Man22: calls $0.10
vanapaguss: folds 
Marauder777: calls $0.05
pudge.3096: checks 
*** FLOP *** [4s Js 8h]
Marauder777: checks 
pudge.3096: checks 
Do-Man22: checks 
*** TURN *** [4s Js 8h] [5d]
Marauder777: checks 
pudge.3096: checks 
Do-Man22: checks 
*** RIVER *** [4s Js 8h 5d] [Kc]
Marauder777: checks 
pudge.3096: bets $0.29
Do-Man22: folds 
Marauder777: folds 
Uncalled bet ($0.29) returned to pudge.3096
pudge.3096 collected $0.29 from pot
pudge.3096: doesn't show hand 
*** SUMMARY ***
Total pot $0.30 | Rake $0.01 
Board [4s Js 8h 5d Kc]
Seat 1: pudge.3096 (big blind) collected ($0.29)
Seat 2: benben288 folded before Flop (didn't bet)
Seat 3: 0nix770 folded before Flop (didn't bet)
Seat 4: Do-Man22 folded on the River
Seat 5: vanapaguss (button) folded before Flop (didn't bet)
Seat 6: Marauder777 (small blind) folded on the River



PokerStars Hand #222981961394:  Hold'em No Limit ($0.05/$0.10 USD) - 2021/01/23 20:43:35 ET
Table 'Stephano III' 6-max Seat #6 is the button
Seat 1: pudge.3096 ($10.93 in chips) 
Seat 2: benben288 ($4.79 in chips) 
Seat 3: 0nix770 ($24.80 in chips) 
Seat 4: Do-Man22 ($9.75 in chips) 
Seat 5: vanapaguss ($14.67 in chips) 
Seat 6: Marauder777 ($13.14 in chips) 
pudge.3096: posts small blind $0.05
benben288: posts big blind $0.10
*** HOLE CARDS ***
0nix770: raises $0.20 to $0.30
Do-Man22: calls $0.30
vanapaguss: folds 
Marauder777: folds 
pudge.3096: folds 
benben288: folds 
*** FLOP *** [Kd 9c Ac]
0nix770: checks 
Do-Man22: checks 
*** TURN *** [Kd 9c Ac] [6c]
0nix770: bets $0.34
Do-Man22: calls $0.34
*** RIVER *** [Kd 9c Ac 6c] [Qd]
0nix770: checks 
Do-Man22: bets $0.69
0nix770: calls $0.69
*** SHOW DOWN ***
Do-Man22: shows [7c Jc] (a flush, Ace high)
0nix770: mucks hand 
Do-Man22 collected $2.68 from pot
*** SUMMARY ***
Total pot $2.81 | Rake $0.13 
Board [Kd 9c Ac 6c Qd]
Seat 1: pudge.3096 (small blind) folded before Flop
Seat 2: benben288 (big blind) folded before Flop
Seat 3: 0nix770 mucked
Seat 4: Do-Man22 showed [7c Jc] and won ($2.68) with a flush, Ace high
Seat 5: vanapaguss folded before Flop (didn't bet)
Seat 6: Marauder777 (button) folded before Flop (didn't bet)



PokerStars Hand #222981977031:  Hold'em No Limit ($0.05/$0.10 USD) - 2021/01/23 20:44:03 ET
Table 'Stephano III' 6-max Seat #1 is the button
Seat 1: pudge.3096 ($10.88 in chips) 
Seat 2: benben288 ($4.69 in chips) 
Seat 3: 0nix770 ($23.47 in chips) 
Seat 4: Do-Man22 ($11.10 in chips) 
Seat 5: vanapaguss ($14.67 in chips) 
Seat 6: Marauder777 ($13.14 in chips) 
benben288: posts small blind $0.05
0nix770: posts big blind $0.10
*** HOLE CARDS ***
Do-Man22: folds 
vanapaguss: raises $0.15 to $0.25
Marauder777: folds 
pudge.3096: folds 
benben288: folds 
0nix770: calls $0.15
*** FLOP *** [4c 8s 2c]
0nix770: checks 
vanapaguss: bets $0.19
0nix770: raises $0.62 to $0.81
vanapaguss: raises $1.39 to $2.20
0nix770: calls $1.39
*** TURN *** [4c 8s 2c] [Ks]
0nix770: checks 
vanapaguss: bets $3.20
0nix770: folds 
Uncalled bet ($3.20) returned to vanapaguss
vanapaguss collected $4.73 from pot
vanapaguss: doesn't show hand 
*** SUMMARY ***
Total pot $4.95 | Rake $0.22 
Board [4c 8s 2c Ks]
Seat 1: pudge.3096 (button) folded before Flop (didn't bet)
Seat 2: benben288 (small blind) folded before Flop
Seat 3: 0nix770 (big blind) folded on the Turn
Seat 4: Do-Man22 folded before Flop (didn't bet)
Seat 5: vanapaguss collected ($4.73)
Seat 6: Marauder777 folded before Flop (didn't bet)



PokerStars Hand #222982022143:  Hold'em No Limit ($0.05/$0.10 USD) - 2021/01/23 20:45:53 ET
Table 'Stephano III' 6-max Seat #2 is the button
Seat 1: pudge.3096 ($10.88 in chips) 
Seat 2: benben288 ($4.64 in chips) 
Seat 3: 0nix770 ($21.02 in chips) 
Seat 4: Do-Man22 ($11.10 in chips) 
Seat 5: vanapaguss ($16.95 in chips) 
Seat 6: Marauder777 ($13.14 in chips) 
0nix770: posts small blind $0.05
Do-Man22: posts big blind $0.10
*** HOLE CARDS ***
vanapaguss: raises $0.15 to $0.25
Marauder777: folds 
pudge.3096: calls $0.25
benben288: folds 
0nix770: folds 
Do-Man22: calls $0.15
*** FLOP *** [4s Jc 3c]
Do-Man22: bets $0.30
vanapaguss: folds 
pudge.3096: raises $0.70 to $1
Do-Man22: calls $0.70
*** TURN *** [4s Jc 3c] [Tc]
Do-Man22: checks 
pudge.3096: checks 
*** RIVER *** [4s Jc 3c Tc] [Ac]
Do-Man22: bets $1
pudge.3096: calls $1
*** SHOW DOWN ***
Do-Man22: shows [Qc 8c] (a flush, Ace high)
pudge.3096: mucks hand 
Do-Man22 collected $4.58 from pot
*** SUMMARY ***
Total pot $4.80 | Rake $0.22 
Board [4s Jc 3c Tc Ac]
Seat 1: pudge.3096 mucked
Seat 2: benben288 (button) folded before Flop (didn't bet)
Seat 3: 0nix770 (small blind) folded before Flop
Seat 4: Do-Man22 (big blind) showed [Qc 8c] and won ($4.58) with a flush, Ace high
Seat 5: vanapaguss folded on the Flop
Seat 6: Marauder777 folded before Flop (didn't bet)



PokerStars Hand #222982048574:  Hold'em No Limit ($0.05/$0.10 USD) - 2021/01/23 20:46:57 ET
Table 'Stephano III' 6-max Seat #3 is the button
Seat 1: pudge.3096 ($10 in chips) 
Seat 2: benben288 ($4.64 in chips) 
Seat 3: 0nix770 ($20.97 in chips) 
Seat 4: Do-Man22 ($13.43 in chips) 
Seat 5: vanapaguss ($16.70 in chips) 
Seat 6: Marauder777 ($13.14 in chips) 
Do-Man22: posts small blind $0.05
vanapaguss: posts big blind $0.10
*** HOLE CARDS ***
Marauder777: raises $0.12 to $0.22
pudge.3096: folds 
benben288: folds 
0nix770: folds 
Do-Man22: calls $0.17
vanapaguss: folds 
*** FLOP *** [Qh 5h 6c]
Do-Man22: bets $0.40
Marauder777: folds 
Uncalled bet ($0.40) returned to Do-Man22
Do-Man22 collected $0.52 from pot
*** SUMMARY ***
Total pot $0.54 | Rake $0.02 
Board [Qh 5h 6c]
Seat 1: pudge.3096 folded before Flop (didn't bet)
Seat 2: benben288 folded before Flop (didn't bet)
Seat 3: 0nix770 (button) folded before Flop (didn't bet)
Seat 4: Do-Man22 (small blind) collected ($0.52)
Seat 5: vanapaguss (big blind) folded before Flop
Seat 6: Marauder777 folded on the Flop



PokerStars Hand #222982055571:  Hold'em No Limit ($0.05/$0.10 USD) - 2021/01/23 20:47:14 ET
Table 'Stephano III' 6-max Seat #4 is the button
Seat 1: pudge.3096 ($10 in chips) 
Seat 2: benben288 ($4.64 in chips) 
Seat 3: 0nix770 ($20.97 in chips) 
Seat 4: Do-Man22 ($13.73 in chips) 
Seat 5: vanapaguss ($16.60 in chips) 
Seat 6: Marauder777 ($12.92 in chips) 
vanapaguss: posts small blind $0.05
Marauder777: posts big blind $0.10
*** HOLE CARDS ***
pudge.3096: raises $0.20 to $0.30
benben288: folds 
0nix770: calls $0.30
Do-Man22: folds 
vanapaguss: folds 
Marauder777: folds 
*** FLOP *** [2s 2c Ah]
pudge.3096: bets $0.23
0nix770: folds 
Uncalled bet ($0.23) returned to pudge.3096
pudge.3096 collected $0.72 from pot
pudge.3096: doesn't show hand 
*** SUMMARY ***
Total pot $0.75 | Rake $0.03 
Board [2s 2c Ah]
Seat 1: pudge.3096 collected ($0.72)
Seat 2: benben288 folded before Flop (didn't bet)
Seat 3: 0nix770 folded on the Flop
Seat 4: Do-Man22 (button) folded before Flop (didn't bet)
Seat 5: vanapaguss (small blind) folded before Flop
Seat 6: Marauder777 (big blind) folded before Flop



PokerStars Hand #222982067327:  Hold'em No Limit ($0.05/$0.10 USD) - 2021/01/23 20:47:42 ET
Table 'Stephano III' 6-max Seat #5 is the button
Seat 1: pudge.3096 ($10.42 in chips) 
Seat 2: benben288 ($4.64 in chips) 
Seat 3: 0nix770 ($20.67 in chips) 
Seat 4: Do-Man22 ($13.73 in chips) 
Seat 5: vanapaguss ($16.55 in chips) 
Seat 6: Marauder777 ($12.82 in chips) 
Marauder777: posts small blind $0.05
pudge.3096: posts big blind $0.10
*** HOLE CARDS ***
benben288: folds 
0nix770: folds 
Do-Man22: calls $0.10
vanapaguss: folds 
Marauder777: folds 
pudge.3096: raises $0.40 to $0.50
Do-Man22: calls $0.40
*** FLOP *** [Jd 2s 6h]
pudge.3096: bets $0.50
Do-Man22: folds 
Uncalled bet ($0.50) returned to pudge.3096
pudge.3096 collected $1 from pot
pudge.3096: doesn't show hand 
*** SUMMARY ***
Total pot $1.05 | Rake $0.05 
Board [Jd 2s 6h]
Seat 1: pudge.3096 (big blind) collected ($1)
Seat 2: benben288 folded before Flop (didn't bet)
Seat 3: 0nix770 folded before Flop (didn't bet)
Seat 4: Do-Man22 folded on the Flop
Seat 5: vanapaguss (button) folded before Flop (didn't bet)
Seat 6: Marauder777 (small blind) folded before Flop



PokerStars Hand #222982080509:  Hold'em No Limit ($0.05/$0.10 USD) - 2021/01/23 20:48:14 ET
Table 'Stephano III' 6-max Seat #6 is the button
Seat 1: pudge.3096 ($10.92 in chips) 
Seat 2: benben288 ($4.64 in chips) 
Seat 3: 0nix770 ($20.67 in chips) 
Seat 4: Do-Man22 ($13.23 in chips) 
Seat 5: vanapaguss ($16.55 in chips) 
Seat 6: Marauder777 ($12.77 in chips) 
pudge.3096: posts small blind $0.05
benben288: posts big blind $0.10
*** HOLE CARDS ***
0nix770: raises $0.20 to $0.30
Do-Man22: calls $0.30
vanapaguss: folds 
Marauder777: folds 
pudge.3096: folds 
benben288: folds 
*** FLOP *** [Qh 3d Jd]
0nix770: bets $0.31
Do-Man22: folds 
Uncalled bet ($0.31) returned to 0nix770
0nix770 collected $0.72 from pot
0nix770: doesn't show hand 
*** SUMMARY ***
Total pot $0.75 | Rake $0.03 
Board [Qh 3d Jd]
Seat 1: pudge.3096 (small blind) folded before Flop
Seat 2: benben288 (big blind) folded before Flop
Seat 3: 0nix770 collected ($0.72)
Seat 4: Do-Man22 folded on the Flop
Seat 5: vanapaguss folded before Flop (didn't bet)
Seat 6: Marauder777 (button) folded before Flop (didn't bet)



PokerStars Hand #222982087174:  Hold'em No Limit ($0.05/$0.10 USD) - 2021/01/23 20:48:30 ET
Table 'Stephano III' 6-max Seat #1 is the button
Seat 1: pudge.3096 ($10.87 in chips) 
Seat 2: benben288 ($4.54 in chips) 
Seat 3: 0nix770 ($21.09 in chips) 
Seat 4: Do-Man22 ($12.93 in chips) 
Seat 5: vanapaguss ($16.55 in chips) 
Seat 6: Marauder777 ($12.77 in chips) 
benben288: posts small blind $0.05
0nix770: posts big blind $0.10
*** HOLE CARDS ***
Do-Man22: folds 
vanapaguss: raises $0.15 to $0.25
Marauder777: folds 
pudge.3096: raises $0.55 to $0.80
benben288: calls $0.75
0nix770: folds 
vanapaguss: calls $0.55
*** FLOP *** [7h 2h 5s]
benben288: checks 
vanapaguss: checks 
pudge.3096: bets $1.20
benben288: folds 
vanapaguss: calls $1.20
*** TURN *** [7h 2h 5s] [Qs]
vanapaguss: checks 
pudge.3096: checks 
*** RIVER *** [7h 2h 5s Qs] [4s]
vanapaguss: checks 
pudge.3096: checks 
*** SHOW DOWN ***
vanapaguss: shows [6h Ah] (high card Ace)
pudge.3096: shows [6d 7d] (a pair of Sevens)
pudge.3096 collected $4.68 from pot
*** SUMMARY ***
Total pot $4.90 | Rake $0.22 
Board [7h 2h 5s Qs 4s]
Seat 1: pudge.3096 (button) showed [6d 7d] and won ($4.68) with a pair of Sevens
Seat 2: benben288 (small blind) folded on the Flop
Seat 3: 0nix770 (big blind) folded before Flop
Seat 4: Do-Man22 folded before Flop (didn't bet)
Seat 5: vanapaguss showed [6h Ah] and lost with high card Ace
Seat 6: Marauder777 folded before Flop (didn't bet)



PokerStars Hand #222982116448:  Hold'em No Limit ($0.05/$0.10 USD) - 2021/01/23 20:49:41 ET
Table 'Stephano III' 6-max Seat #2 is the button
Seat 1: pudge.3096 ($13.55 in chips) 
Seat 2: benben288 ($7.74 in chips) 
Seat 3: 0nix770 ($20.99 in chips) 
Seat 4: Do-Man22 ($12.93 in chips) 
Seat 5: vanapaguss ($14.55 in chips) 
Seat 6: Marauder777 ($12.77 in chips) 
0nix770: posts small blind $0.05
Do-Man22: posts big blind $0.10
*** HOLE CARDS ***
vanapaguss: folds 
Marauder777: folds 
pudge.3096: folds 
benben288: folds 
0nix770: raises $0.20 to $0.30
Do-Man22: calls $0.20
*** FLOP *** [7h 6h Jc]
0nix770: bets $0.23
Do-Man22: calls $0.23
*** TURN *** [7h 6h Jc] [5h]
0nix770: checks 
Do-Man22: bets $0.60
0nix770: calls $0.60
*** RIVER *** [7h 6h Jc 5h] [4h]
0nix770: checks 
Do-Man22: checks 
*** SHOW DOWN ***
0nix770: shows [8d 5d] (a straight, Four to Eight)
Do-Man22: shows [As 8s] (a straight, Four to Eight)
0nix770 collected $1.08 from pot
Do-Man22 collected $1.08 from pot
*** SUMMARY ***
Total pot $2.26 | Rake $0.10 
Board [7h 6h Jc 5h 4h]
Seat 1: pudge.3096 folded before Flop (didn't bet)
Seat 2: benben288 (button) folded before Flop (didn't bet)
Seat 3: 0nix770 (small blind) showed [8d 5d] and won ($1.08) with a straight, Four to Eight
Seat 4: Do-Man22 (big blind) showed [As 8s] and won ($1.08) with a straight, Four to Eight
Seat 5: vanapaguss folded before Flop (didn't bet)
Seat 6: Marauder777 folded before Flop (didn't bet)



PokerStars Hand #222982132470:  Hold'em No Limit ($0.05/$0.10 USD) - 2021/01/23 20:50:21 ET
Table 'Stephano III' 6-max Seat #3 is the button
Seat 1: pudge.3096 ($13.55 in chips) 
Seat 2: benben288 ($7.74 in chips) 
Seat 3: 0nix770 ($20.94 in chips) 
Seat 4: Do-Man22 ($12.88 in chips) 
Seat 5: vanapaguss ($14.55 in chips) 
Seat 6: Marauder777 ($12.77 in chips) 
Do-Man22: posts small blind $0.05
vanapaguss: posts big blind $0.10
*** HOLE CARDS ***
Marauder777: folds 
pudge.3096: folds 
benben288: folds 
0nix770: folds 
Do-Man22: folds 
Uncalled bet ($0.05) returned to vanapaguss
vanapaguss collected $0.10 from pot
vanapaguss: doesn't show hand 
*** SUMMARY ***
Total pot $0.10 | Rake $0 
Seat 1: pudge.3096 folded before Flop (didn't bet)
Seat 2: benben288 folded before Flop (didn't bet)
Seat 3: 0nix770 (button) folded before Flop (didn't bet)
Seat 4: Do-Man22 (small blind) folded before Flop
Seat 5: vanapaguss (big blind) collected ($0.10)
Seat 6: Marauder777 folded before Flop (didn't bet)



PokerStars Hand #222982135989:  Hold'em No Limit ($0.05/$0.10 USD) - 2021/01/23 20:50:30 ET
Table 'Stephano III' 6-max Seat #4 is the button
Seat 1: pudge.3096 ($13.55 in chips) 
Seat 2: benben288 ($7.74 in chips) 
Seat 3: 0nix770 ($20.94 in chips) 
Seat 4: Do-Man22 ($12.83 in chips) 
Seat 5: vanapaguss ($14.60 in chips) 
Seat 6: Marauder777 ($12.77 in chips) 
vanapaguss: posts small blind $0.05
Marauder777: posts big blind $0.10
*** HOLE CARDS ***
pudge.3096: folds 
benben288: folds 
0nix770: folds 
Do-Man22: folds 
vanapaguss: folds 
Uncalled bet ($0.05) returned to Marauder777
Marauder777 collected $0.10 from pot
Marauder777: doesn't show hand 
*** SUMMARY ***
Total pot $0.10 | Rake $0 
Seat 1: pudge.3096 folded before Flop (didn't bet)
Seat 2: benben288 folded before Flop (didn't bet)
Seat 3: 0nix770 folded before Flop (didn't bet)
Seat 4: Do-Man22 (button) folded before Flop (didn't bet)
Seat 5: vanapaguss (small blind) folded before Flop
Seat 6: Marauder777 (big blind) collected ($0.10)



PokerStars Hand #222982139124:  Hold'em No Limit ($0.05/$0.10 USD) - 2021/01/23 20:50:37 ET
Table 'Stephano III' 6-max Seat #5 is the button
Seat 1: pudge.3096 ($13.55 in chips) 
Seat 2: benben288 ($7.74 in chips) 
Seat 3: 0nix770 ($20.94 in chips) 
Seat 4: Do-Man22 ($12.83 in chips) 
Seat 5: vanapaguss ($14.55 in chips) 
Seat 6: Marauder777 ($12.82 in chips) 
Marauder777: posts small blind $0.05
pudge.3096: posts big blind $0.10
*** HOLE CARDS ***
benben288: folds 
0nix770: folds 
Do-Man22: raises $0.30 to $0.40
vanapaguss: folds 
Marauder777: folds 
pudge.3096: folds 
Uncalled bet ($0.30) returned to Do-Man22
Do-Man22 collected $0.25 from pot
*** SUMMARY ***
Total pot $0.25 | Rake $0 
Seat 1: pudge.3096 (big blind) folded before Flop
Seat 2: benben288 folded before Flop (didn't bet)
Seat 3: 0nix770 folded before Flop (didn't bet)
Seat 4: Do-Man22 collected ($0.25)
Seat 5: vanapaguss (button) folded before Flop (didn't bet)
Seat 6: Marauder777 (small blind) folded before Flop



PokerStars Hand #222982145722:  Hold'em No Limit ($0.05/$0.10 USD) - 2021/01/23 20:50:54 ET
Table 'Stephano III' 6-max Seat #6 is the button
Seat 1: pudge.3096 ($13.45 in chips) 
Seat 2: benben288 ($7.74 in chips) 
Seat 3: 0nix770 ($20.94 in chips) 
Seat 4: Do-Man22 ($12.98 in chips) 
Seat 5: vanapaguss ($14.55 in chips) 
Seat 6: Marauder777 ($12.77 in chips) 
pudge.3096: posts small blind $0.05
benben288: posts big blind $0.10
*** HOLE CARDS ***
0nix770: folds 
Do-Man22: calls $0.10
vanapaguss: folds 
Marauder777: raises $0.20 to $0.30
pudge.3096: folds 
benben288: calls $0.20
Do-Man22: calls $0.20
*** FLOP *** [8h Kc 5d]
benben288: checks 
Do-Man22: bets $1.60
Marauder777: folds 
benben288: folds 
Uncalled bet ($1.60) returned to Do-Man22
Do-Man22 collected $0.91 from pot
*** SUMMARY ***
Total pot $0.95 | Rake $0.04 
Board [8h Kc 5d]
Seat 1: pudge.3096 (small blind) folded before Flop
Seat 2: benben288 (big blind) folded on the Flop
Seat 3: 0nix770 folded before Flop (didn't bet)
Seat 4: Do-Man22 collected ($0.91)
Seat 5: vanapaguss folded before Flop (didn't bet)
Seat 6: Marauder777 (button) folded on the Flop



PokerStars Hand #222982160101:  Hold'em No Limit ($0.05/$0.10 USD) - 2021/01/23 20:51:28 ET
Table 'Stephano III' 6-max Seat #1 is the button
Seat 1: pudge.3096 ($13.40 in chips) 
Seat 2: benben288 ($7.44 in chips) 
Seat 3: 0nix770 ($20.94 in chips) 
Seat 4: Do-Man22 ($13.59 in chips) 
Seat 5: vanapaguss ($14.55 in chips) 
Seat 6: Marauder777 ($12.47 in chips) 
benben288: posts small blind $0.05
0nix770: posts big blind $0.10
*** HOLE CARDS ***
Do-Man22: calls $0.10
vanapaguss: folds 
Marauder777: folds 
pudge.3096: raises $0.40 to $0.50
benben288: folds 
0nix770: folds 
Do-Man22: calls $0.40
*** FLOP *** [4h Qh 7h]
Do-Man22: checks 
pudge.3096: bets $0.35
Do-Man22: calls $0.35
*** TURN *** [4h Qh 7h] [6s]
Do-Man22: checks 
pudge.3096: checks 
*** RIVER *** [4h Qh 7h 6s] [9s]
Do-Man22: checks 
pudge.3096: bets $1.70
Do-Man22: folds 
Uncalled bet ($1.70) returned to pudge.3096
pudge.3096 collected $1.77 from pot
pudge.3096: doesn't show hand 
*** SUMMARY ***
Total pot $1.85 | Rake $0.08 
Board [4h Qh 7h 6s 9s]
Seat 1: pudge.3096 (button) collected ($1.77)
Seat 2: benben288 (small blind) folded before Flop
Seat 3: 0nix770 (big blind) folded before Flop
Seat 4: Do-Man22 folded on the River
Seat 5: vanapaguss folded before Flop (didn't bet)
Seat 6: Marauder777 folded before Flop (didn't bet)



PokerStars Hand #222982178942:  Hold'em No Limit ($0.05/$0.10 USD) - 2021/01/23 20:52:15 ET
Table 'Stephano III' 6-max Seat #2 is the button
Seat 1: pudge.3096 ($14.32 in chips) 
Seat 2: benben288 ($7.39 in chips) 
Seat 3: 0nix770 ($20.84 in chips) 
Seat 4: Do-Man22 ($12.74 in chips) 
Seat 5: vanapaguss ($14.55 in chips) 
Seat 6: Marauder777 ($12.47 in chips) 
0nix770: posts small blind $0.05
Do-Man22: posts big blind $0.10
*** HOLE CARDS ***
vanapaguss: folds 
Marauder777: folds 
pudge.3096: folds 
benben288: folds 
0nix770: folds 
Uncalled bet ($0.05) returned to Do-Man22
Do-Man22 collected $0.10 from pot
*** SUMMARY ***
Total pot $0.10 | Rake $0 
Seat 1: pudge.3096 folded before Flop (didn't bet)
Seat 2: benben288 (button) folded before Flop (didn't bet)
Seat 3: 0nix770 (small blind) folded before Flop
Seat 4: Do-Man22 (big blind) collected ($0.10)
Seat 5: vanapaguss folded before Flop (didn't bet)
Seat 6: Marauder777 folded before Flop (didn't bet)



PokerStars Hand #222982183297:  Hold'em No Limit ($0.05/$0.10 USD) - 2021/01/23 20:52:25 ET
Table 'Stephano III' 6-max Seat #3 is the button
Seat 1: pudge.3096 ($14.32 in chips) 
Seat 2: benben288 ($7.39 in chips) 
Seat 3: 0nix770 ($20.79 in chips) 
Seat 4: Do-Man22 ($12.79 in chips) 
Seat 5: vanapaguss ($14.55 in chips) 
Seat 6: Marauder777 ($12.47 in chips) 
Do-Man22: posts small blind $0.05
vanapaguss: posts big blind $0.10
*** HOLE CARDS ***
Marauder777: folds 
pudge.3096: folds 
benben288: raises $0.20 to $0.30
0nix770: folds 
Do-Man22: calls $0.25
vanapaguss: calls $0.20
*** FLOP *** [Qd 2s 2c]
Do-Man22: bets $0.40
vanapaguss: folds 
benben288: calls $0.40
*** TURN *** [Qd 2s 2c] [3c]
Do-Man22: bets $0.30
benben288: folds 
Uncalled bet ($0.30) returned to Do-Man22
Do-Man22 collected $1.62 from pot
*** SUMMARY ***
Total pot $1.70 | Rake $0.08 
Board [Qd 2s 2c 3c]
Seat 1: pudge.3096 folded before Flop (didn't bet)
Seat 2: benben288 folded on the Turn
Seat 3: 0nix770 (button) folded before Flop (didn't bet)
Seat 4: Do-Man22 (small blind) collected ($1.62)
Seat 5: vanapaguss (big blind) folded on the Flop
Seat 6: Marauder777 folded before Flop (didn't bet)



PokerStars Hand #222982198471:  Hold'em No Limit ($0.05/$0.10 USD) - 2021/01/23 20:53:03 ET
Table 'Stephano III' 6-max Seat #4 is the button
Seat 1: pudge.3096 ($14.32 in chips) 
Seat 2: benben288 ($6.69 in chips) 
Seat 3: 0nix770 ($20.79 in chips) 
Seat 4: Do-Man22 ($13.71 in chips) 
Seat 5: vanapaguss ($14.25 in chips) 
Seat 6: Marauder777 ($12.47 in chips) 
vanapaguss: posts small blind $0.05
Marauder777: posts big blind $0.10
*** HOLE CARDS ***
pudge.3096: folds 
benben288: folds 
0nix770: raises $0.15 to $0.25
Do-Man22: calls $0.25
vanapaguss: folds 
Marauder777: calls $0.15
*** FLOP *** [7s 9d Ac]
Marauder777: checks 
0nix770: bets $0.24
Do-Man22: calls $0.24
Marauder777: folds 
*** TURN *** [7s 9d Ac] [2d]
0nix770: bets $1.53
Do-Man22: folds 
Uncalled bet ($1.53) returned to 0nix770
0nix770 collected $1.22 from pot
0nix770: doesn't show hand 
*** SUMMARY ***
Total pot $1.28 | Rake $0.06 
Board [7s 9d Ac 2d]
Seat 1: pudge.3096 folded before Flop (didn't bet)
Seat 2: benben288 folded before Flop (didn't bet)
Seat 3: 0nix770 collected ($1.22)
Seat 4: Do-Man22 (button) folded on the Turn
Seat 5: vanapaguss (small blind) folded before Flop
Seat 6: Marauder777 (big blind) folded on the Flop



PokerStars Hand #222982213344:  Hold'em No Limit ($0.05/$0.10 USD) - 2021/01/23 20:53:39 ET
Table 'Stephano III' 6-max Seat #5 is the button
Seat 1: pudge.3096 ($14.32 in chips) 
Seat 2: benben288 ($6.69 in chips) 
Seat 3: 0nix770 ($21.52 in chips) 
Seat 4: Do-Man22 ($13.22 in chips) 
Seat 5: vanapaguss ($14.20 in chips) 
Seat 6: Marauder777 ($12.22 in chips) 
Marauder777: posts small blind $0.05
pudge.3096: posts big blind $0.10
*** HOLE CARDS ***
benben288: raises $0.10 to $0.20
0nix770: raises $0.60 to $0.80
Do-Man22: calls $0.80
vanapaguss: folds 
Marauder777: folds 
pudge.3096: folds 
benben288: calls $0.60
*** FLOP *** [Kc Kd 4c]
benben288: checks 
0nix770: checks 
Do-Man22: checks 
*** TURN *** [Kc Kd 4c] [8h]
benben288: checks 
0nix770: bets $1.24
Do-Man22: folds 
benben288: folds 
Uncalled bet ($1.24) returned to 0nix770
0nix770 collected $2.44 from pot
0nix770: doesn't show hand 
*** SUMMARY ***
Total pot $2.55 | Rake $0.11 
Board [Kc Kd 4c 8h]
Seat 1: pudge.3096 (big blind) folded before Flop
Seat 2: benben288 folded on the Turn
Seat 3: 0nix770 collected ($2.44)
Seat 4: Do-Man22 folded on the Turn
Seat 5: vanapaguss (button) folded before Flop (didn't bet)
Seat 6: Marauder777 (small blind) folded before Flop



PokerStars Hand #222982230029:  Hold'em No Limit ($0.05/$0.10 USD) - 2021/01/23 20:54:21 ET
Table 'Stephano III' 6-max Seat #6 is the button
Seat 1: pudge.3096 ($14.22 in chips) 
Seat 2: benben288 ($5.89 in chips) 
Seat 3: 0nix770 ($23.16 in chips) 
Seat 4: Do-Man22 ($12.42 in chips) 
Seat 5: vanapaguss ($14.20 in chips) 
Seat 6: Marauder777 ($12.17 in chips) 
pudge.3096: posts small blind $0.05
benben288: posts big blind $0.10
*** HOLE CARDS ***
0nix770: folds 
Do-Man22: raises $0.40 to $0.50
vanapaguss: folds 
Marauder777: folds 
pudge.3096: folds 
benben288: folds 
Uncalled bet ($0.40) returned to Do-Man22
Do-Man22 collected $0.25 from pot
*** SUMMARY ***
Total pot $0.25 | Rake $0 
Seat 1: pudge.3096 (small blind) folded before Flop
Seat 2: benben288 (big blind) folded before Flop
Seat 3: 0nix770 folded before Flop (didn't bet)
Seat 4: Do-Man22 collected ($0.25)
Seat 5: vanapaguss folded before Flop (didn't bet)
Seat 6: Marauder777 (button) folded before Flop (didn't bet)



PokerStars Hand #222982233994:  Hold'em No Limit ($0.05/$0.10 USD) - 2021/01/23 20:54:31 ET
Table 'Stephano III' 6-max Seat #1 is the button
Seat 1: pudge.3096 ($14.17 in chips) 
Seat 2: benben288 ($5.79 in chips) 
Seat 3: 0nix770 ($23.16 in chips) 
Seat 4: Do-Man22 ($12.57 in chips) 
Seat 5: vanapaguss ($14.20 in chips) 
Seat 6: Marauder777 ($12.17 in chips) 
benben288: posts small blind $0.05
0nix770: posts big blind $0.10
*** HOLE CARDS ***
Do-Man22: raises $0.30 to $0.40
vanapaguss: folds 
Marauder777: folds 
pudge.3096: folds 
benben288: calls $0.35
0nix770: folds 
*** FLOP *** [7d 6h 2d]
benben288: checks 
Do-Man22: bets $0.40
benben288: calls $0.40
*** TURN *** [7d 6h 2d] [Kc]
benben288: checks 
Do-Man22: bets $0.40
benben288: folds 
Uncalled bet ($0.40) returned to Do-Man22
Do-Man22 collected $1.62 from pot
*** SUMMARY ***
Total pot $1.70 | Rake $0.08 
Board [7d 6h 2d Kc]
Seat 1: pudge.3096 (button) folded before Flop (didn't bet)
Seat 2: benben288 (small blind) folded on the Turn
Seat 3: 0nix770 (big blind) folded before Flop
Seat 4: Do-Man22 collected ($1.62)
Seat 5: vanapaguss folded before Flop (didn't bet)
Seat 6: Marauder777 folded before Flop (didn't bet)



PokerStars Hand #222982247884:  Hold'em No Limit ($0.05/$0.10 USD) - 2021/01/23 20:55:05 ET
Table 'Stephano III' 6-max Seat #2 is the button
Seat 1: pudge.3096 ($14.17 in chips) 
Seat 2: benben288 ($4.99 in chips) 
Seat 3: 0nix770 ($23.06 in chips) 
Seat 4: Do-Man22 ($13.39 in chips) 
Seat 5: vanapaguss ($14.20 in chips) 
Seat 6: Marauder777 ($12.17 in chips) 
0nix770: posts small blind $0.05
Do-Man22: posts big blind $0.10
*** HOLE CARDS ***
vanapaguss: raises $0.15 to $0.25
Marauder777: folds 
pudge.3096: folds 
benben288: folds 
0nix770: calls $0.20
Do-Man22: calls $0.15
*** FLOP *** [2d Js 9c]
0nix770: checks 
Do-Man22: bets $1.10
vanapaguss: folds 
0nix770: folds 
Uncalled bet ($1.10) returned to Do-Man22
Do-Man22 collected $0.72 from pot
*** SUMMARY ***
Total pot $0.75 | Rake $0.03 
Board [2d Js 9c]
Seat 1: pudge.3096 folded before Flop (didn't bet)
Seat 2: benben288 (button) folded before Flop (didn't bet)
Seat 3: 0nix770 (small blind) folded on the Flop
Seat 4: Do-Man22 (big blind) collected ($0.72)
Seat 5: vanapaguss folded on the Flop
Seat 6: Marauder777 folded before Flop (didn't bet)



PokerStars Hand #222982258466:  Hold'em No Limit ($0.05/$0.10 USD) - 2021/01/23 20:55:37 ET
Table 'Stephano III' 6-max Seat #3 is the button
Seat 1: pudge.3096 ($14.17 in chips) 
Seat 2: benben288 ($4.99 in chips) 
Seat 3: 0nix770 ($22.81 in chips) 
Seat 4: Do-Man22 ($13.86 in chips) 
Seat 5: vanapaguss ($13.95 in chips) 
Seat 6: Marauder777 ($12.17 in chips) 
Do-Man22: posts small blind $0.05
vanapaguss: posts big blind $0.10
*** HOLE CARDS ***
Marauder777: folds 
pudge.3096: folds 
benben288: raises $0.20 to $0.30
0nix770: calls $0.30
Do-Man22: calls $0.25
vanapaguss: calls $0.20
*** FLOP *** [9c 6c Ad]
Do-Man22: checks 
vanapaguss: checks 
benben288: checks 
0nix770: checks 
*** TURN *** [9c 6c Ad] [4c]
Do-Man22: checks 
vanapaguss: checks 
benben288: checks 
0nix770: checks 
*** RIVER *** [9c 6c Ad 4c] [3c]
Do-Man22: checks 
vanapaguss: bets $0.40
benben288: folds 
0nix770: calls $0.40
Do-Man22: folds 
*** SHOW DOWN ***
vanapaguss: shows [8c Qc] (a flush, Queen high)
0nix770: mucks hand 
vanapaguss collected $1.91 from pot
*** SUMMARY ***
Total pot $2 | Rake $0.09 
Board [9c 6c Ad 4c 3c]
Seat 1: pudge.3096 folded before Flop (didn't bet)
Seat 2: benben288 folded on the River
Seat 3: 0nix770 (button) mucked
Seat 4: Do-Man22 (small blind) folded on the River
Seat 5: vanapaguss (big blind) showed [8c Qc] and won ($1.91) with a flush, Queen high
Seat 6: Marauder777 folded before Flop (didn't bet)



PokerStars Hand #222982276937:  Hold'em No Limit ($0.05/$0.10 USD) - 2021/01/23 20:56:30 ET
Table 'Stephano III' 6-max Seat #4 is the button
Seat 1: pudge.3096 ($14.17 in chips) 
Seat 2: benben288 ($4.69 in chips) 
Seat 3: 0nix770 ($22.11 in chips) 
Seat 4: Do-Man22 ($13.56 in chips) 
Seat 5: vanapaguss ($15.16 in chips) 
Seat 6: Marauder777 ($12.17 in chips) 
vanapaguss: posts small blind $0.05
Marauder777: posts big blind $0.10
*** HOLE CARDS ***
pudge.3096: folds 
benben288: raises $0.10 to $0.20
0nix770: folds 
Do-Man22: calls $0.20
vanapaguss: folds 
Marauder777: folds 
*** FLOP *** [Jh 9c 4h]
benben288: checks 
Do-Man22: bets $0.40
benben288: raises $0.90 to $1.30
Do-Man22: calls $0.90
*** TURN *** [Jh 9c 4h] [8h]
benben288: bets $3.19 and is all-in
Do-Man22: calls $3.19
*** RIVER *** [Jh 9c 4h 8h] [3c]
*** SHOW DOWN ***
benben288: shows [Jc Tc] (a pair of Jacks)
Do-Man22: shows [8s Jd] (two pair, Jacks and Eights)
Do-Man22 cashed out the hand for $6.14 | Cash Out Fee $0.06
*** SUMMARY ***
Total pot $9.53 | Rake $0.43 
Board [Jh 9c 4h 8h 3c]
Seat 1: pudge.3096 folded before Flop (didn't bet)
Seat 2: benben288 showed [Jc Tc] and lost with a pair of Jacks
Seat 3: 0nix770 folded before Flop (didn't bet)
Seat 4: Do-Man22 (button) showed [8s Jd] and won ($9.10) with two pair, Jacks and Eights (pot not awarded as player cashed out)
Seat 5: vanapaguss (small blind) folded before Flop
Seat 6: Marauder777 (big blind) folded before Flop



PokerStars Hand #222982289056:  Hold'em No Limit ($0.05/$0.10 USD) - 2021/01/23 20:57:08 ET
Table 'Stephano III' 6-max Seat #5 is the button
Seat 1: pudge.3096 ($14.17 in chips) 
Seat 3: 0nix770 ($22.11 in chips) 
Seat 4: Do-Man22 ($15.01 in chips) 
Seat 5: vanapaguss ($15.11 in chips) 
Seat 6: Marauder777 ($12.07 in chips) 
Marauder777: posts small blind $0.05
pudge.3096: posts big blind $0.10
*** HOLE CARDS ***
0nix770: folds 
Do-Man22: raises $0.20 to $0.30
vanapaguss: folds 
Marauder777: folds 
pudge.3096: folds 
Uncalled bet ($0.20) returned to Do-Man22
Do-Man22 collected $0.25 from pot
*** SUMMARY ***
Total pot $0.25 | Rake $0 
Seat 1: pudge.3096 (big blind) folded before Flop
Seat 3: 0nix770 folded before Flop (didn't bet)
Seat 4: Do-Man22 collected ($0.25)
Seat 5: vanapaguss (button) folded before Flop (didn't bet)
Seat 6: Marauder777 (small blind) folded before Flop



PokerStars Hand #222982291777:  Hold'em No Limit ($0.05/$0.10 USD) - 2021/01/23 20:57:17 ET
Table 'Stephano III' 6-max Seat #6 is the button
Seat 1: pudge.3096 ($14.07 in chips) 
Seat 2: benben288 ($7 in chips) 
Seat 3: 0nix770 ($22.11 in chips) 
Seat 4: Do-Man22 ($15.16 in chips) 
Seat 5: vanapaguss ($15.11 in chips) 
Seat 6: Marauder777 ($12.02 in chips) 
pudge.3096: posts small blind $0.05
benben288: posts big blind $0.10
*** HOLE CARDS ***
0nix770: raises $0.20 to $0.30
Do-Man22: raises $0.20 to $0.50
vanapaguss: folds 
Marauder777: folds 
pudge.3096: folds 
benben288: folds 
0nix770: calls $0.20
*** FLOP *** [3d 3h 3c]
0nix770: checks 
Do-Man22: checks 
*** TURN *** [3d 3h 3c] [3s]
0nix770: checks 
Do-Man22: checks 
*** RIVER *** [3d 3h 3c 3s] [Qh]
0nix770: bets $1.94
Do-Man22: folds 
Uncalled bet ($1.94) returned to 0nix770
0nix770 collected $1.10 from pot
0nix770: doesn't show hand 
*** SUMMARY ***
Total pot $1.15 | Rake $0.05 
Board [3d 3h 3c 3s Qh]
Seat 1: pudge.3096 (small blind) folded before Flop
Seat 2: benben288 (big blind) folded before Flop
Seat 3: 0nix770 collected ($1.10)
Seat 4: Do-Man22 folded on the River
Seat 5: vanapaguss folded before Flop (didn't bet)
Seat 6: Marauder777 (button) folded before Flop (didn't bet)



PokerStars Hand #222982299629:  Hold'em No Limit ($0.05/$0.10 USD) - 2021/01/23 20:57:42 ET
Table 'Stephano III' 6-max Seat #1 is the button
Seat 1: pudge.3096 ($14.02 in chips) 
Seat 2: benben288 ($6.90 in chips) 
Seat 3: 0nix770 ($22.71 in chips) 
Seat 4: Do-Man22 ($14.66 in chips) 
Seat 5: vanapaguss ($15.11 in chips) 
Seat 6: Marauder777 ($12.02 in chips) 
benben288: posts small blind $0.05
0nix770: posts big blind $0.10
*** HOLE CARDS ***
Do-Man22: calls $0.10
vanapaguss: folds 
Marauder777: folds 
pudge.3096: raises $0.40 to $0.50
benben288: calls $0.45
0nix770: folds 
Do-Man22: calls $0.40
*** FLOP *** [2s 7s 3d]
benben288: checks 
Do-Man22: checks 
pudge.3096: checks 
*** TURN *** [2s 7s 3d] [2d]
benben288: checks 
Do-Man22: checks 
pudge.3096: checks 
*** RIVER *** [2s 7s 3d 2d] [Ah]
benben288: checks 
Do-Man22: checks 
pudge.3096: bets $1.20
benben288: folds 
Do-Man22: folds 
Uncalled bet ($1.20) returned to pudge.3096
pudge.3096 collected $1.53 from pot
pudge.3096: doesn't show hand 
*** SUMMARY ***
Total pot $1.60 | Rake $0.07 
Board [2s 7s 3d 2d Ah]
Seat 1: pudge.3096 (button) collected ($1.53)
Seat 2: benben288 (small blind) folded on the River
Seat 3: 0nix770 (big blind) folded before Flop
Seat 4: Do-Man22 folded on the River
Seat 5: vanapaguss folded before Flop (didn't bet)
Seat 6: Marauder777 folded before Flop (didn't bet)



PokerStars Hand #222982313146:  Hold'em No Limit ($0.05/$0.10 USD) - 2021/01/23 20:58:24 ET
Table 'Stephano III' 6-max Seat #2 is the button
Seat 1: pudge.3096 ($15.05 in chips) 
Seat 2: benben288 ($6.40 in chips) 
Seat 3: 0nix770 ($22.61 in chips) 
Seat 5: vanapaguss ($15.11 in chips) 
Seat 6: Marauder777 ($12.02 in chips) 
0nix770: posts small blind $0.05
vanapaguss: posts big blind $0.10
*** HOLE CARDS ***
Marauder777: folds 
pudge.3096: folds 
benben288: folds 
0nix770: raises $0.20 to $0.30
vanapaguss: folds 
Uncalled bet ($0.20) returned to 0nix770
0nix770 collected $0.20 from pot
0nix770: doesn't show hand 
*** SUMMARY ***
Total pot $0.20 | Rake $0 
Seat 1: pudge.3096 folded before Flop (didn't bet)
Seat 2: benben288 (button) folded before Flop (didn't bet)
Seat 3: 0nix770 (small blind) collected ($0.20)
Seat 5: vanapaguss (big blind) folded before Flop
Seat 6: Marauder777 folded before Flop (didn't bet)



PokerStars Hand #222982320366:  Hold'em No Limit ($0.05/$0.10 USD) - 2021/01/23 20:58:47 ET
Table 'Stephano III' 6-max Seat #3 is the button
Seat 1: pudge.3096 ($15.05 in chips) 
Seat 2: benben288 ($6.40 in chips) 
Seat 3: 0nix770 ($22.71 in chips) 
Seat 5: vanapaguss ($15.01 in chips) 
vanapaguss: posts small blind $0.05
Marauder777: is sitting out 
pudge.3096: posts big blind $0.10
*** HOLE CARDS ***
benben288: folds 
0nix770: folds 
vanapaguss: raises $0.20 to $0.30
pudge.3096: raises $0.60 to $0.90
vanapaguss: folds 
Uncalled bet ($0.60) returned to pudge.3096
pudge.3096 collected $0.60 from pot
pudge.3096: doesn't show hand 
*** SUMMARY ***
Total pot $0.60 | Rake $0 
Seat 1: pudge.3096 (big blind) collected ($0.60)
Seat 2: benben288 folded before Flop (didn't bet)
Seat 3: 0nix770 (button) folded before Flop (didn't bet)
Seat 5: vanapaguss (small blind) folded before Flop



PokerStars Hand #222982326257:  Hold'em No Limit ($0.05/$0.10 USD) - 2021/01/23 20:59:06 ET
Table 'Stephano III' 6-max Seat #5 is the button
Seat 1: pudge.3096 ($15.35 in chips) 
Seat 2: benben288 ($6.40 in chips) 
Seat 3: 0nix770 ($22.71 in chips) 
Seat 5: vanapaguss ($14.71 in chips) 
pudge.3096: posts small blind $0.05
benben288: posts big blind $0.10
*** HOLE CARDS ***
0nix770: raises $0.15 to $0.25
vanapaguss: folds 
pudge.3096: folds 
benben288: folds 
Uncalled bet ($0.15) returned to 0nix770
0nix770 collected $0.25 from pot
0nix770: doesn't show hand 
*** SUMMARY ***
Total pot $0.25 | Rake $0 
Seat 1: pudge.3096 (small blind) folded before Flop
Seat 2: benben288 (big blind) folded before Flop
Seat 3: 0nix770 collected ($0.25)
Seat 5: vanapaguss (button) folded before Flop (didn't bet)



PokerStars Hand #222982328737:  Hold'em No Limit ($0.05/$0.10 USD) - 2021/01/23 20:59:14 ET
Table 'Stephano III' 6-max Seat #1 is the button
Seat 1: pudge.3096 ($15.30 in chips) 
Seat 2: benben288 ($6.30 in chips) 
Seat 3: 0nix770 ($22.86 in chips) 
Seat 5: vanapaguss ($14.71 in chips) 
benben288: posts small blind $0.05
0nix770: posts big blind $0.10
*** HOLE CARDS ***
vanapaguss: folds 
pudge.3096: folds 
benben288: folds 
Uncalled bet ($0.05) returned to 0nix770
0nix770 collected $0.10 from pot
0nix770: doesn't show hand 
*** SUMMARY ***
Total pot $0.10 | Rake $0 
Seat 1: pudge.3096 (button) folded before Flop (didn't bet)
Seat 2: benben288 (small blind) folded before Flop
Seat 3: 0nix770 (big blind) collected ($0.10)
Seat 5: vanapaguss folded before Flop (didn't bet)



PokerStars Hand #222982333212:  Hold'em No Limit ($0.05/$0.10 USD) - 2021/01/23 20:59:28 ET
Table 'Stephano III' 6-max Seat #2 is the button
Seat 1: pudge.3096 ($15.30 in chips) 
Seat 2: benben288 ($6.25 in chips) 
Seat 3: 0nix770 ($22.91 in chips) 
Seat 4: Do-Man22 ($14.16 in chips) 
Seat 5: vanapaguss ($14.71 in chips) 
0nix770: posts small blind $0.05
Do-Man22: posts big blind $0.10
*** HOLE CARDS ***
vanapaguss: folds 
pudge.3096: folds 
benben288: folds 
0nix770: raises $0.20 to $0.30
Do-Man22: calls $0.20
*** FLOP *** [6h 4c Jd]
0nix770: bets $0.31
Do-Man22: raises $0.31 to $0.62
0nix770: calls $0.31
*** TURN *** [6h 4c Jd] [9c]
0nix770: checks 
Do-Man22: checks 
*** RIVER *** [6h 4c Jd 9c] [Qh]
0nix770: bets $1.34
Do-Man22: folds 
Uncalled bet ($1.34) returned to 0nix770
0nix770 collected $1.76 from pot
0nix770: doesn't show hand 
*** SUMMARY ***
Total pot $1.84 | Rake $0.08 
Board [6h 4c Jd 9c Qh]
Seat 1: pudge.3096 folded before Flop (didn't bet)
Seat 2: benben288 (button) folded before Flop (didn't bet)
Seat 3: 0nix770 (small blind) collected ($1.76)
Seat 4: Do-Man22 (big blind) folded on the River
Seat 5: vanapaguss folded before Flop (didn't bet)



PokerStars Hand #222982343018:  Hold'em No Limit ($0.05/$0.10 USD) - 2021/01/23 21:00:00 ET
Table 'Stephano III' 6-max Seat #3 is the button
Seat 1: pudge.3096 ($15.30 in chips) 
Seat 3: 0nix770 ($23.75 in chips) 
Seat 4: Do-Man22 ($13.24 in chips) 
Seat 5: vanapaguss ($14.71 in chips) 
Do-Man22: posts small blind $0.05
vanapaguss: posts big blind $0.10
Marauder777: sits out 
*** HOLE CARDS ***
pudge.3096: raises $0.20 to $0.30
0nix770: calls $0.30
Do-Man22: raises $0.20 to $0.50
vanapaguss: folds 
pudge.3096: calls $0.20
0nix770: calls $0.20
*** FLOP *** [Kd Jh As]
Do-Man22: bets $0.77
pudge.3096: calls $0.77
0nix770: folds 
*** TURN *** [Kd Jh As] [Qs]
Do-Man22: bets $0.60
pudge.3096: calls $0.60
*** RIVER *** [Kd Jh As Qs] [Kh]
Do-Man22: bets $1
pudge.3096: raises $12.43 to $13.43 and is all-in
Do-Man22: folds 
Uncalled bet ($12.43) returned to pudge.3096
pudge.3096 collected $6.05 from pot
pudge.3096: doesn't show hand 
*** SUMMARY ***
Total pot $6.34 | Rake $0.29 
Board [Kd Jh As Qs Kh]
Seat 1: pudge.3096 collected ($6.05)
Seat 3: 0nix770 (button) folded on the Flop
Seat 4: Do-Man22 (small blind) folded on the River
Seat 5: vanapaguss (big blind) folded before Flop



PokerStars Hand #222982374071:  Hold'em No Limit ($0.05/$0.10 USD) - 2021/01/23 21:01:09 ET
Table 'Stephano III' 6-max Seat #4 is the button
Seat 1: pudge.3096 ($18.48 in chips) 
Seat 2: benben288 ($6.25 in chips) 
Seat 3: 0nix770 ($23.25 in chips) 
Seat 4: Do-Man22 ($10.37 in chips) 
Seat 5: vanapaguss ($14.61 in chips) 
Seat 6: Marauder777 ($12.02 in chips) 
vanapaguss: posts small blind $0.05
Marauder777: posts big blind $0.10
*** HOLE CARDS ***
pudge.3096: raises $0.20 to $0.30
benben288: folds 
0nix770: folds 
Do-Man22: raises $1.60 to $1.90
vanapaguss: folds 
Marauder777: folds 
pudge.3096: folds 
Uncalled bet ($1.60) returned to Do-Man22
Do-Man22 collected $0.75 from pot
*** SUMMARY ***
Total pot $0.75 | Rake $0 
Seat 1: pudge.3096 folded before Flop
Seat 2: benben288 folded before Flop (didn't bet)
Seat 3: 0nix770 folded before Flop (didn't bet)
Seat 4: Do-Man22 (button) collected ($0.75)
Seat 5: vanapaguss (small blind) folded before Flop
Seat 6: Marauder777 (big blind) folded before Flop



PokerStars Hand #222982381394:  Hold'em No Limit ($0.05/$0.10 USD) - 2021/01/23 21:01:24 ET
Table 'Stephano III' 6-max Seat #5 is the button
Seat 1: pudge.3096 ($18.18 in chips) 
Seat 2: benben288 ($6.25 in chips) 
Seat 3: 0nix770 ($23.25 in chips) 
Seat 4: Do-Man22 ($10.82 in chips) 
Seat 5: vanapaguss ($14.56 in chips) 
Seat 6: Marauder777 ($11.92 in chips) 
Marauder777: posts small blind $0.05
pudge.3096: posts big blind $0.10
*** HOLE CARDS ***
benben288: folds 
0nix770: folds 
Do-Man22: raises $1.50 to $1.60
vanapaguss: folds 
Marauder777: folds 
pudge.3096: folds 
Uncalled bet ($1.50) returned to Do-Man22
Do-Man22 collected $0.25 from pot
*** SUMMARY ***
Total pot $0.25 | Rake $0 
Seat 1: pudge.3096 (big blind) folded before Flop
Seat 2: benben288 folded before Flop (didn't bet)
Seat 3: 0nix770 folded before Flop (didn't bet)
Seat 4: Do-Man22 collected ($0.25)
Seat 5: vanapaguss (button) folded before Flop (didn't bet)
Seat 6: Marauder777 (small blind) folded before Flop



PokerStars Hand #222982396076:  Hold'em No Limit ($0.05/$0.10 USD) - 2021/01/23 21:01:42 ET
Table 'Stephano III' 6-max Seat #6 is the button
Seat 1: pudge.3096 ($18.08 in chips) 
Seat 2: benben288 ($6.25 in chips) 
Seat 3: 0nix770 ($23.25 in chips) 
Seat 4: Do-Man22 ($10.97 in chips) 
Seat 5: vanapaguss ($14.56 in chips) 
Seat 6: Marauder777 ($11.87 in chips) 
pudge.3096: posts small blind $0.05
benben288: posts big blind $0.10
*** HOLE CARDS ***
0nix770: folds 
Do-Man22: raises $0.40 to $0.50
vanapaguss: folds 
Marauder777: calls $0.50
pudge.3096: folds 
benben288: folds 
*** FLOP *** [Qc 7d 4s]
Do-Man22: checks 
Marauder777: checks 
*** TURN *** [Qc 7d 4s] [7c]
Do-Man22: checks 
Marauder777: bets $0.39
Do-Man22: calls $0.39
*** RIVER *** [Qc 7d 4s 7c] [7h]
Do-Man22: checks 
Marauder777: checks 
*** SHOW DOWN ***
Do-Man22: shows [5s 8s] (three of a kind, Sevens)
Marauder777: shows [3c 3h] (a full house, Sevens full of Threes)
Marauder777 collected $1.84 from pot
*** SUMMARY ***
Total pot $1.93 | Rake $0.09 
Board [Qc 7d 4s 7c 7h]
Seat 1: pudge.3096 (small blind) folded before Flop
Seat 2: benben288 (big blind) folded before Flop
Seat 3: 0nix770 folded before Flop (didn't bet)
Seat 4: Do-Man22 showed [5s 8s] and lost with three of a kind, Sevens
Seat 5: vanapaguss folded before Flop (didn't bet)
Seat 6: Marauder777 (button) showed [3c 3h] and won ($1.84) with a full house, Sevens full of Threes



PokerStars Hand #222982412110:  Hold'em No Limit ($0.05/$0.10 USD) - 2021/01/23 21:02:20 ET
Table 'Stephano III' 6-max Seat #1 is the button
Seat 1: pudge.3096 ($18.03 in chips) 
Seat 2: benben288 ($6.15 in chips) 
Seat 3: 0nix770 ($23.25 in chips) 
Seat 4: Do-Man22 ($10.08 in chips) 
Seat 5: vanapaguss ($14.56 in chips) 
Seat 6: Marauder777 ($12.82 in chips) 
benben288: posts small blind $0.05
0nix770: posts big blind $0.10
*** HOLE CARDS ***
Do-Man22: raises $0.40 to $0.50
vanapaguss: folds 
Marauder777: folds 
pudge.3096: raises $1 to $1.50
benben288: folds 
0nix770: folds 
Do-Man22: calls $1
*** FLOP *** [Td 2h 7c]
Do-Man22: checks 
pudge.3096: bets $1.51
Do-Man22: folds 
Uncalled bet ($1.51) returned to pudge.3096
pudge.3096 collected $3.01 from pot
pudge.3096: doesn't show hand 
*** SUMMARY ***
Total pot $3.15 | Rake $0.14 
Board [Td 2h 7c]
Seat 1: pudge.3096 (button) collected ($3.01)
Seat 2: benben288 (small blind) folded before Flop
Seat 3: 0nix770 (big blind) folded before Flop
Seat 4: Do-Man22 folded on the Flop
Seat 5: vanapaguss folded before Flop (didn't bet)
Seat 6: Marauder777 folded before Flop (didn't bet)



PokerStars Hand #222982428986:  Hold'em No Limit ($0.05/$0.10 USD) - 2021/01/23 21:03:01 ET
Table 'Stephano III' 6-max Seat #2 is the button
Seat 1: pudge.3096 ($19.54 in chips) 
Seat 2: benben288 ($6.10 in chips) 
Seat 3: 0nix770 ($23.15 in chips) 
Seat 4: Do-Man22 ($8.58 in chips) 
Seat 5: vanapaguss ($14.56 in chips) 
Seat 6: Marauder777 ($12.82 in chips) 
0nix770: posts small blind $0.05
Do-Man22: posts big blind $0.10
*** HOLE CARDS ***
vanapaguss: folds 
Marauder777: folds 
pudge.3096: folds 
benben288: raises $0.10 to $0.20
0nix770: calls $0.15
Do-Man22: folds 
*** FLOP *** [5c 7h 2s]
0nix770: checks 
benben288: checks 
*** TURN *** [5c 7h 2s] [Jc]
0nix770: bets $0.34
benben288: raises $0.56 to $0.90
0nix770: calls $0.56
*** RIVER *** [5c 7h 2s Jc] [3s]
0nix770: checks 
benben288: checks 
*** SHOW DOWN ***
0nix770: shows [8c 6c] (high card Jack)
benben288: shows [Kh Js] (a pair of Jacks)
benben288 collected $2.20 from pot
*** SUMMARY ***
Total pot $2.30 | Rake $0.10 
Board [5c 7h 2s Jc 3s]
Seat 1: pudge.3096 folded before Flop (didn't bet)
Seat 2: benben288 (button) showed [Kh Js] and won ($2.20) with a pair of Jacks
Seat 3: 0nix770 (small blind) showed [8c 6c] and lost with high card Jack
Seat 4: Do-Man22 (big blind) folded before Flop
Seat 5: vanapaguss folded before Flop (didn't bet)
Seat 6: Marauder777 folded before Flop (didn't bet)



PokerStars Hand #222982443263:  Hold'em No Limit ($0.05/$0.10 USD) - 2021/01/23 21:03:35 ET
Table 'Stephano III' 6-max Seat #3 is the button
Seat 1: pudge.3096 ($19.54 in chips) 
Seat 2: benben288 ($7.20 in chips) 
Seat 3: 0nix770 ($22.05 in chips) 
Seat 4: Do-Man22 ($10 in chips) 
Seat 5: vanapaguss ($14.56 in chips) 
Seat 6: Marauder777 ($12.82 in chips) 
Do-Man22: posts small blind $0.05
vanapaguss: posts big blind $0.10
*** HOLE CARDS ***
Marauder777: folds 
pudge.3096: folds 
benben288: folds 
0nix770: raises $0.13 to $0.23
Do-Man22: calls $0.18
vanapaguss: calls $0.13
*** FLOP *** [6c 2s 7h]
Do-Man22: checks 
vanapaguss: checks 
0nix770: checks 
*** TURN *** [6c 2s 7h] [4d]
Do-Man22: checks 
vanapaguss: checks 
0nix770: checks 
*** RIVER *** [6c 2s 7h 4d] [As]
Do-Man22: bets $0.80
vanapaguss: folds 
0nix770: folds 
Uncalled bet ($0.80) returned to Do-Man22
Do-Man22 collected $0.66 from pot
*** SUMMARY ***
Total pot $0.69 | Rake $0.03 
Board [6c 2s 7h 4d As]
Seat 1: pudge.3096 folded before Flop (didn't bet)
Seat 2: benben288 folded before Flop (didn't bet)
Seat 3: 0nix770 (button) folded on the River
Seat 4: Do-Man22 (small blind) collected ($0.66)
Seat 5: vanapaguss (big blind) folded on the River
Seat 6: Marauder777 folded before Flop (didn't bet)



PokerStars Hand #222982465216:  Hold'em No Limit ($0.05/$0.10 USD) - 2021/01/23 21:04:28 ET
Table 'Stephano III' 6-max Seat #4 is the button
Seat 1: pudge.3096 ($19.54 in chips) 
Seat 2: benben288 ($7.20 in chips) 
Seat 3: 0nix770 ($21.82 in chips) 
Seat 4: Do-Man22 ($10.43 in chips) 
Seat 5: vanapaguss ($14.33 in chips) 
Seat 6: Marauder777 ($12.82 in chips) 
vanapaguss: posts small blind $0.05
Marauder777: posts big blind $0.10
*** HOLE CARDS ***
pudge.3096: folds 
benben288: folds 
0nix770: folds 
Do-Man22: raises $0.30 to $0.40
vanapaguss: calls $0.35
Marauder777: folds 
*** FLOP *** [Qd Ks 4d]
vanapaguss: checks 
Do-Man22: bets $0.43
vanapaguss: folds 
Uncalled bet ($0.43) returned to Do-Man22
Do-Man22 collected $0.86 from pot
*** SUMMARY ***
Total pot $0.90 | Rake $0.04 
Board [Qd Ks 4d]
Seat 1: pudge.3096 folded before Flop (didn't bet)
Seat 2: benben288 folded before Flop (didn't bet)
Seat 3: 0nix770 folded before Flop (didn't bet)
Seat 4: Do-Man22 (button) collected ($0.86)
Seat 5: vanapaguss (small blind) folded on the Flop
Seat 6: Marauder777 (big blind) folded before Flop



PokerStars Hand #222982477481:  Hold'em No Limit ($0.05/$0.10 USD) - 2021/01/23 21:04:58 ET
Table 'Stephano III' 6-max Seat #5 is the button
Seat 1: pudge.3096 ($19.54 in chips) 
Seat 2: benben288 ($7.20 in chips) 
Seat 3: 0nix770 ($21.82 in chips) 
Seat 4: Do-Man22 ($10.89 in chips) 
Seat 5: vanapaguss ($13.93 in chips) 
Seat 6: Marauder777 ($12.72 in chips) 
Marauder777: posts small blind $0.05
pudge.3096: posts big blind $0.10
*** HOLE CARDS ***
benben288: folds 
0nix770: raises $0.20 to $0.30
Do-Man22: calls $0.30
vanapaguss: folds 
Marauder777: folds 
pudge.3096: calls $0.20
*** FLOP *** [2s Th 6c]
pudge.3096: checks 
0nix770: bets $0.41
Do-Man22: raises $0.79 to $1.20
pudge.3096: folds 
0nix770: calls $0.79
*** TURN *** [2s Th 6c] [3d]
0nix770: checks 
Do-Man22: bets $3.20
0nix770: folds 
Uncalled bet ($3.20) returned to Do-Man22
Do-Man22 collected $3.20 from pot
*** SUMMARY ***
Total pot $3.35 | Rake $0.15 
Board [2s Th 6c 3d]
Seat 1: pudge.3096 (big blind) folded on the Flop
Seat 2: benben288 folded before Flop (didn't bet)
Seat 3: 0nix770 folded on the Turn
Seat 4: Do-Man22 collected ($3.20)
Seat 5: vanapaguss (button) folded before Flop (didn't bet)
Seat 6: Marauder777 (small blind) folded before Flop



PokerStars Hand #222982502310:  Hold'em No Limit ($0.05/$0.10 USD) - 2021/01/23 21:05:58 ET
Table 'Stephano III' 6-max Seat #6 is the button
Seat 1: pudge.3096 ($19.24 in chips) 
Seat 2: benben288 ($7.20 in chips) 
Seat 3: 0nix770 ($20.32 in chips) 
Seat 4: Do-Man22 ($12.59 in chips) 
Seat 5: vanapaguss ($13.93 in chips) 
Seat 6: Marauder777 ($12.67 in chips) 
pudge.3096: posts small blind $0.05
benben288: posts big blind $0.10
*** HOLE CARDS ***
0nix770: folds 
Do-Man22: raises $0.30 to $0.40
vanapaguss: folds 
Marauder777: raises $1.05 to $1.45
pudge.3096: folds 
benben288: folds 
Do-Man22: folds 
Uncalled bet ($1.05) returned to Marauder777
Marauder777 collected $0.95 from pot
Marauder777: doesn't show hand 
*** SUMMARY ***
Total pot $0.95 | Rake $0 
Seat 1: pudge.3096 (small blind) folded before Flop
Seat 2: benben288 (big blind) folded before Flop
Seat 3: 0nix770 folded before Flop (didn't bet)
Seat 4: Do-Man22 folded before Flop
Seat 5: vanapaguss folded before Flop (didn't bet)
Seat 6: Marauder777 (button) collected ($0.95)



PokerStars Hand #222982509497:  Hold'em No Limit ($0.05/$0.10 USD) - 2021/01/23 21:06:15 ET
Table 'Stephano III' 6-max Seat #1 is the button
Seat 1: pudge.3096 ($19.19 in chips) 
Seat 2: benben288 ($7.10 in chips) 
Seat 3: 0nix770 ($20.32 in chips) 
Seat 4: Do-Man22 ($12.19 in chips) 
Seat 5: vanapaguss ($13.93 in chips) 
Seat 6: Marauder777 ($13.22 in chips) 
benben288: posts small blind $0.05
0nix770: posts big blind $0.10
*** HOLE CARDS ***
Do-Man22: raises $0.20 to $0.30
vanapaguss: folds 
Marauder777: folds 
pudge.3096: folds 
benben288: folds 
0nix770: calls $0.20
*** FLOP *** [6c Jh 2d]
0nix770: checks 
Do-Man22: bets $0.50
0nix770: calls $0.50
*** TURN *** [6c Jh 2d] [Qd]
0nix770: checks 
Do-Man22: checks 
*** RIVER *** [6c Jh 2d Qd] [4h]
0nix770: bets $0.54
Do-Man22: calls $0.54
*** SHOW DOWN ***
0nix770: shows [8s Jd] (a pair of Jacks)
Do-Man22: mucks hand 
0nix770 collected $2.61 from pot
*** SUMMARY ***
Total pot $2.73 | Rake $0.12 
Board [6c Jh 2d Qd 4h]
Seat 1: pudge.3096 (button) folded before Flop (didn't bet)
Seat 2: benben288 (small blind) folded before Flop
Seat 3: 0nix770 (big blind) showed [8s Jd] and won ($2.61) with a pair of Jacks
Seat 4: Do-Man22 mucked
Seat 5: vanapaguss folded before Flop (didn't bet)
Seat 6: Marauder777 folded before Flop (didn't bet)



PokerStars Hand #222982528953:  Hold'em No Limit ($0.05/$0.10 USD) - 2021/01/23 21:07:02 ET
Table 'Stephano III' 6-max Seat #2 is the button
Seat 1: pudge.3096 ($19.19 in chips) 
Seat 2: benben288 ($7.05 in chips) 
Seat 3: 0nix770 ($21.59 in chips) 
Seat 4: Do-Man22 ($10.85 in chips) 
Seat 5: vanapaguss ($13.93 in chips) 
Seat 6: Marauder777 ($13.22 in chips) 
0nix770: posts small blind $0.05
Do-Man22: posts big blind $0.10
*** HOLE CARDS ***
vanapaguss: folds 
Marauder777: folds 
pudge.3096: folds 
benben288: folds 
0nix770: folds 
Uncalled bet ($0.05) returned to Do-Man22
Do-Man22 collected $0.10 from pot
*** SUMMARY ***
Total pot $0.10 | Rake $0 
Seat 1: pudge.3096 folded before Flop (didn't bet)
Seat 2: benben288 (button) folded before Flop (didn't bet)
Seat 3: 0nix770 (small blind) folded before Flop
Seat 4: Do-Man22 (big blind) collected ($0.10)
Seat 5: vanapaguss folded before Flop (didn't bet)
Seat 6: Marauder777 folded before Flop (didn't bet)



PokerStars Hand #222982533408:  Hold'em No Limit ($0.05/$0.10 USD) - 2021/01/23 21:07:12 ET
Table 'Stephano III' 6-max Seat #3 is the button
Seat 1: pudge.3096 ($19.19 in chips) 
Seat 3: 0nix770 ($21.54 in chips) 
Seat 4: Do-Man22 ($10.90 in chips) 
Seat 5: vanapaguss ($13.93 in chips) 
Seat 6: Marauder777 ($13.22 in chips) 
Do-Man22: posts small blind $0.05
vanapaguss: posts big blind $0.10
*** HOLE CARDS ***
Marauder777: folds 
pudge.3096: folds 
0nix770: folds 
Do-Man22: raises $0.40 to $0.50
vanapaguss: raises $1 to $1.50
Do-Man22: calls $1
*** FLOP *** [Ts 8d As]
Do-Man22: checks 
vanapaguss: bets $1
Do-Man22: calls $1
*** TURN *** [Ts 8d As] [3h]
Do-Man22: checks 
vanapaguss: bets $2
Do-Man22: folds 
Uncalled bet ($2) returned to vanapaguss
vanapaguss collected $4.78 from pot
vanapaguss: doesn't show hand 
*** SUMMARY ***
Total pot $5 | Rake $0.22 
Board [Ts 8d As 3h]
Seat 1: pudge.3096 folded before Flop (didn't bet)
Seat 3: 0nix770 (button) folded before Flop (didn't bet)
Seat 4: Do-Man22 (small blind) folded on the Turn
Seat 5: vanapaguss (big blind) collected ($4.78)
Seat 6: Marauder777 folded before Flop (didn't bet)



PokerStars Hand #222982546443:  Hold'em No Limit ($0.05/$0.10 USD) - 2021/01/23 21:07:44 ET
Table 'Stephano III' 6-max Seat #4 is the button
Seat 1: pudge.3096 ($19.19 in chips) 
Seat 3: 0nix770 ($21.54 in chips) 
Seat 4: Do-Man22 ($8.40 in chips) 
Seat 5: vanapaguss ($16.21 in chips) 
Seat 6: Marauder777 ($13.22 in chips) 
vanapaguss: posts small blind $0.05
Marauder777: posts big blind $0.10
*** HOLE CARDS ***
pudge.3096: folds 
0nix770: folds 
Do-Man22: folds 
vanapaguss: raises $0.20 to $0.30
Marauder777: calls $0.20
*** FLOP *** [Jc 4s 6h]
vanapaguss: checks 
Marauder777: bets $0.20
vanapaguss: calls $0.20
*** TURN *** [Jc 4s 6h] [Jh]
vanapaguss: checks 
Marauder777: bets $0.34
vanapaguss: calls $0.34
*** RIVER *** [Jc 4s 6h Jh] [As]
vanapaguss: checks 
Marauder777: checks 
*** SHOW DOWN ***
vanapaguss: shows [Ah 9h] (two pair, Aces and Jacks)
Marauder777: mucks hand 
vanapaguss collected $1.60 from pot
*** SUMMARY ***
Total pot $1.68 | Rake $0.08 
Board [Jc 4s 6h Jh As]
Seat 1: pudge.3096 folded before Flop (didn't bet)
Seat 3: 0nix770 folded before Flop (didn't bet)
Seat 4: Do-Man22 (button) folded before Flop (didn't bet)
Seat 5: vanapaguss (small blind) showed [Ah 9h] and won ($1.60) with two pair, Aces and Jacks
Seat 6: Marauder777 (big blind) mucked



PokerStars Hand #222982569451:  Hold'em No Limit ($0.05/$0.10 USD) - 2021/01/23 21:08:40 ET
Table 'Stephano III' 6-max Seat #5 is the button
Seat 1: pudge.3096 ($19.19 in chips) 
Seat 3: 0nix770 ($21.54 in chips) 
Seat 4: Do-Man22 ($10 in chips) 
Seat 5: vanapaguss ($16.97 in chips) 
Seat 6: Marauder777 ($12.38 in chips) 
Marauder777: posts small blind $0.05
pudge.3096: posts big blind $0.10
*** HOLE CARDS ***
0nix770: folds 
Do-Man22: folds 
vanapaguss: raises $0.15 to $0.25
Marauder777: folds 
pudge.3096: calls $0.15
*** FLOP *** [Js 2c Ts]
pudge.3096: checks 
vanapaguss: bets $0.19
pudge.3096: folds 
Uncalled bet ($0.19) returned to vanapaguss
vanapaguss collected $0.53 from pot
vanapaguss: doesn't show hand 
*** SUMMARY ***
Total pot $0.55 | Rake $0.02 
Board [Js 2c Ts]
Seat 1: pudge.3096 (big blind) folded on the Flop
Seat 3: 0nix770 folded before Flop (didn't bet)
Seat 4: Do-Man22 folded before Flop (didn't bet)
Seat 5: vanapaguss (button) collected ($0.53)
Seat 6: Marauder777 (small blind) folded before Flop



PokerStars Hand #222982581439:  Hold'em No Limit ($0.05/$0.10 USD) - 2021/01/23 21:09:09 ET
Table 'Stephano III' 6-max Seat #6 is the button
Seat 1: pudge.3096 ($18.94 in chips) 
Seat 2: benben288 ($7.05 in chips) 
Seat 3: 0nix770 ($21.54 in chips) 
Seat 4: Do-Man22 ($10 in chips) 
Seat 5: vanapaguss ($17.25 in chips) 
Seat 6: Marauder777 ($12.33 in chips) 
pudge.3096: posts small blind $0.05
benben288: posts big blind $0.10
*** HOLE CARDS ***
0nix770: raises $0.20 to $0.30
Do-Man22: folds 
vanapaguss: folds 
Marauder777: folds 
pudge.3096: folds 
benben288: folds 
Uncalled bet ($0.20) returned to 0nix770
0nix770 collected $0.25 from pot
0nix770: doesn't show hand 
*** SUMMARY ***
Total pot $0.25 | Rake $0 
Seat 1: pudge.3096 (small blind) folded before Flop
Seat 2: benben288 (big blind) folded before Flop
Seat 3: 0nix770 collected ($0.25)
Seat 4: Do-Man22 folded before Flop (didn't bet)
Seat 5: vanapaguss folded before Flop (didn't bet)
Seat 6: Marauder777 (button) folded before Flop (didn't bet)



PokerStars Hand #222982587118:  Hold'em No Limit ($0.05/$0.10 USD) - 2021/01/23 21:09:23 ET
Table 'Stephano III' 6-max Seat #1 is the button
Seat 1: pudge.3096 ($18.89 in chips) 
Seat 2: benben288 ($6.95 in chips) 
Seat 3: 0nix770 ($21.69 in chips) 
Seat 4: Do-Man22 ($10 in chips) 
Seat 5: vanapaguss ($17.25 in chips) 
Seat 6: Marauder777 ($12.33 in chips) 
benben288: posts small blind $0.05
0nix770: posts big blind $0.10
*** HOLE CARDS ***
Do-Man22: raises $0.20 to $0.30
vanapaguss: raises $0.60 to $0.90
Marauder777: folds 
pudge.3096: folds 
benben288: folds 
0nix770: raises $1.80 to $2.70
Do-Man22: folds 
vanapaguss: folds 
Uncalled bet ($1.80) returned to 0nix770
0nix770 collected $2.15 from pot
0nix770: doesn't show hand 
*** SUMMARY ***
Total pot $2.15 | Rake $0 
Seat 1: pudge.3096 (button) folded before Flop (didn't bet)
Seat 2: benben288 (small blind) folded before Flop
Seat 3: 0nix770 (big blind) collected ($2.15)
Seat 4: Do-Man22 folded before Flop
Seat 5: vanapaguss folded before Flop
Seat 6: Marauder777 folded before Flop (didn't bet)



PokerStars Hand #222982598325:  Hold'em No Limit ($0.05/$0.10 USD) - 2021/01/23 21:09:50 ET
Table 'Stephano III' 6-max Seat #2 is the button
Seat 1: pudge.3096 ($18.89 in chips) 
Seat 2: benben288 ($6.90 in chips) 
Seat 3: 0nix770 ($22.94 in chips) 
Seat 4: Do-Man22 ($9.70 in chips) 
Seat 5: vanapaguss ($16.35 in chips) 
Seat 6: Marauder777 ($12.33 in chips) 
0nix770: posts small blind $0.05
Do-Man22: posts big blind $0.10
*** HOLE CARDS ***
vanapaguss: raises $0.15 to $0.25
Marauder777: folds 
pudge.3096: folds 
benben288: folds 
0nix770: folds 
Do-Man22: calls $0.15
*** FLOP *** [Kh 6s 3h]
Do-Man22: checks 
vanapaguss: checks 
*** TURN *** [Kh 6s 3h] [3s]
Do-Man22: bets $0.53
vanapaguss: calls $0.53
*** RIVER *** [Kh 6s 3h 3s] [7s]
Do-Man22: bets $0.40
vanapaguss: raises $1.60 to $2
Do-Man22: folds 
Uncalled bet ($1.60) returned to vanapaguss
vanapaguss collected $2.30 from pot
vanapaguss: doesn't show hand 
*** SUMMARY ***
Total pot $2.41 | Rake $0.11 
Board [Kh 6s 3h 3s 7s]
Seat 1: pudge.3096 folded before Flop (didn't bet)
Seat 2: benben288 (button) folded before Flop (didn't bet)
Seat 3: 0nix770 (small blind) folded before Flop
Seat 4: Do-Man22 (big blind) folded on the River
Seat 5: vanapaguss collected ($2.30)
Seat 6: Marauder777 folded before Flop (didn't bet)



PokerStars Hand #222982615900:  Hold'em No Limit ($0.05/$0.10 USD) - 2021/01/23 21:10:32 ET
Table 'Stephano III' 6-max Seat #3 is the button
Seat 1: pudge.3096 ($18.89 in chips) 
Seat 2: benben288 ($6.90 in chips) 
Seat 3: 0nix770 ($22.89 in chips) 
Seat 4: Do-Man22 ($8.52 in chips) 
Seat 5: vanapaguss ($17.47 in chips) 
Seat 6: Marauder777 ($12.33 in chips) 
Do-Man22: posts small blind $0.05
vanapaguss: posts big blind $0.10
*** HOLE CARDS ***
Marauder777: folds 
pudge.3096: folds 
benben288: folds 
0nix770: raises $0.13 to $0.23
Do-Man22: folds 
vanapaguss: calls $0.13
*** FLOP *** [7s 8h 3s]
vanapaguss: checks 
0nix770: bets $0.22
vanapaguss: calls $0.22
*** TURN *** [7s 8h 3s] [5h]
vanapaguss: checks 
0nix770: checks 
*** RIVER *** [7s 8h 3s 5h] [Kh]
vanapaguss: bets $0.60
0nix770: raises $1.28 to $1.88
vanapaguss: calls $1.28
*** SHOW DOWN ***
0nix770: shows [Tc Qh] (high card King)
vanapaguss: shows [8s 8d] (three of a kind, Eights)
vanapaguss collected $4.50 from pot
*** SUMMARY ***
Total pot $4.71 | Rake $0.21 
Board [7s 8h 3s 5h Kh]
Seat 1: pudge.3096 folded before Flop (didn't bet)
Seat 2: benben288 folded before Flop (didn't bet)
Seat 3: 0nix770 (button) showed [Tc Qh] and lost with high card King
Seat 4: Do-Man22 (small blind) folded before Flop
Seat 5: vanapaguss (big blind) showed [8s 8d] and won ($4.50) with three of a kind, Eights
Seat 6: Marauder777 folded before Flop (didn't bet)



PokerStars Hand #222982636457:  Hold'em No Limit ($0.05/$0.10 USD) - 2021/01/23 21:11:22 ET
Table 'Stephano III' 6-max Seat #4 is the button
Seat 1: pudge.3096 ($18.89 in chips) 
Seat 2: benben288 ($6.90 in chips) 
Seat 3: 0nix770 ($20.56 in chips) 
Seat 4: Do-Man22 ($10 in chips) 
Seat 5: vanapaguss ($19.64 in chips) 
Seat 6: Marauder777 ($12.33 in chips) 
vanapaguss: posts small blind $0.05
Marauder777: posts big blind $0.10
*** HOLE CARDS ***
pudge.3096: folds 
benben288: folds 
0nix770: folds 
Do-Man22: raises $0.40 to $0.50
vanapaguss: calls $0.45
Marauder777: calls $0.40
*** FLOP *** [2h Ad 8h]
vanapaguss: checks 
Marauder777: checks 
Do-Man22: bets $1.60
vanapaguss: calls $1.60
Marauder777: folds 
*** TURN *** [2h Ad 8h] [2c]
vanapaguss: checks 
Do-Man22: checks 
*** RIVER *** [2h Ad 8h 2c] [8c]
vanapaguss: checks 
Do-Man22: checks 
*** SHOW DOWN ***
vanapaguss: shows [Jh Ah] (two pair, Aces and Eights)
Do-Man22: shows [Jd Ac] (two pair, Aces and Eights)
vanapaguss collected $2.25 from pot
Do-Man22 collected $2.24 from pot
*** SUMMARY ***
Total pot $4.70 | Rake $0.21 
Board [2h Ad 8h 2c 8c]
Seat 1: pudge.3096 folded before Flop (didn't bet)
Seat 2: benben288 folded before Flop (didn't bet)
Seat 3: 0nix770 folded before Flop (didn't bet)
Seat 4: Do-Man22 (button) showed [Jd Ac] and won ($2.24) with two pair, Aces and Eights
Seat 5: vanapaguss (small blind) showed [Jh Ah] and won ($2.25) with two pair, Aces and Eights
Seat 6: Marauder777 (big blind) folded on the Flop



PokerStars Hand #222982653495:  Hold'em No Limit ($0.05/$0.10 USD) - 2021/01/23 21:12:03 ET
Table 'Stephano III' 6-max Seat #5 is the button
Seat 1: pudge.3096 ($18.89 in chips) 
Seat 2: benben288 ($6.90 in chips) 
Seat 3: 0nix770 ($20.56 in chips) 
Seat 4: Do-Man22 ($10.14 in chips) 
Seat 5: vanapaguss ($19.79 in chips) 
Seat 6: Marauder777 ($11.83 in chips) 
Marauder777: posts small blind $0.05
pudge.3096: posts big blind $0.10
*** HOLE CARDS ***
benben288: folds 
0nix770: folds 
Do-Man22: calls $0.10
vanapaguss: raises $0.20 to $0.30
Marauder777: folds 
pudge.3096: folds 
Do-Man22: calls $0.20
*** FLOP *** [9c 5s 6c]
Do-Man22: checks 
vanapaguss: checks 
*** TURN *** [9c 5s 6c] [Kh]
Do-Man22: checks 
vanapaguss: checks 
*** RIVER *** [9c 5s 6c Kh] [Jh]
Do-Man22: checks 
vanapaguss: checks 
*** SHOW DOWN ***
Do-Man22: shows [8c Th] (high card King)
vanapaguss: shows [7c 7h] (a pair of Sevens)
vanapaguss collected $0.72 from pot
*** SUMMARY ***
Total pot $0.75 | Rake $0.03 
Board [9c 5s 6c Kh Jh]
Seat 1: pudge.3096 (big blind) folded before Flop
Seat 2: benben288 folded before Flop (didn't bet)
Seat 3: 0nix770 folded before Flop (didn't bet)
Seat 4: Do-Man22 showed [8c Th] and lost with high card King
Seat 5: vanapaguss (button) showed [7c 7h] and won ($0.72) with a pair of Sevens
Seat 6: Marauder777 (small blind) folded before Flop



PokerStars Hand #222982672327:  Hold'em No Limit ($0.05/$0.10 USD) - 2021/01/23 21:12:38 ET
Table 'Stephano III' 6-max Seat #6 is the button
Seat 1: pudge.3096 ($18.79 in chips) 
Seat 2: benben288 ($6.90 in chips) 
Seat 3: 0nix770 ($20.56 in chips) 
Seat 4: Do-Man22 ($9.84 in chips) 
Seat 5: vanapaguss ($20.21 in chips) 
Seat 6: Marauder777 ($11.78 in chips) 
pudge.3096: posts small blind $0.05
benben288: posts big blind $0.10
*** HOLE CARDS ***
0nix770: raises $0.20 to $0.30
Do-Man22: calls $0.30
vanapaguss: folds 
Marauder777: calls $0.30
pudge.3096: folds 
benben288: folds 
*** FLOP *** [7s Ts Tc]
0nix770: checks 
Do-Man22: checks 
Marauder777: checks 
*** TURN *** [7s Ts Tc] [2h]
0nix770: bets $0.47
Do-Man22: calls $0.47
Marauder777: folds 
*** RIVER *** [7s Ts Tc 2h] [9d]
0nix770: bets $1.82
Do-Man22: folds 
Uncalled bet ($1.82) returned to 0nix770
0nix770 collected $1.90 from pot
0nix770: doesn't show hand 
*** SUMMARY ***
Total pot $1.99 | Rake $0.09 
Board [7s Ts Tc 2h 9d]
Seat 1: pudge.3096 (small blind) folded before Flop
Seat 2: benben288 (big blind) folded before Flop
Seat 3: 0nix770 collected ($1.90)
Seat 4: Do-Man22 folded on the River
Seat 5: vanapaguss folded before Flop (didn't bet)
Seat 6: Marauder777 (button) folded on the Turn



PokerStars Hand #222982688749:  Hold'em No Limit ($0.05/$0.10 USD) - 2021/01/23 21:13:18 ET
Table 'Stephano III' 6-max Seat #1 is the button
Seat 1: pudge.3096 ($18.74 in chips) 
Seat 2: benben288 ($6.80 in chips) 
Seat 3: 0nix770 ($21.69 in chips) 
Seat 4: Do-Man22 ($9.07 in chips) 
Seat 5: vanapaguss ($20.21 in chips) 
Seat 6: Marauder777 ($11.48 in chips) 
benben288: posts small blind $0.05
0nix770: posts big blind $0.10
*** HOLE CARDS ***
Do-Man22: calls $0.10
vanapaguss: folds 
Marauder777: folds 
pudge.3096: folds 
benben288: folds 
0nix770: checks 
*** FLOP *** [5c Jc 5s]
0nix770: checks 
Do-Man22: checks 
*** TURN *** [5c Jc 5s] [9h]
0nix770: checks 
Do-Man22: checks 
*** RIVER *** [5c Jc 5s 9h] [8s]
0nix770: checks 
Do-Man22: checks 
*** SHOW DOWN ***
0nix770: shows [Ts 6s] (a pair of Fives)
Do-Man22: shows [7h 8c] (two pair, Eights and Fives)
Do-Man22 collected $0.24 from pot
*** SUMMARY ***
Total pot $0.25 | Rake $0.01 
Board [5c Jc 5s 9h 8s]
Seat 1: pudge.3096 (button) folded before Flop (didn't bet)
Seat 2: benben288 (small blind) folded before Flop
Seat 3: 0nix770 (big blind) showed [Ts 6s] and lost with a pair of Fives
Seat 4: Do-Man22 showed [7h 8c] and won ($0.24) with two pair, Eights and Fives
Seat 5: vanapaguss folded before Flop (didn't bet)
Seat 6: Marauder777 folded before Flop (didn't bet)



PokerStars Hand #222982702296:  Hold'em No Limit ($0.05/$0.10 USD) - 2021/01/23 21:13:51 ET
Table 'Stephano III' 6-max Seat #2 is the button
Seat 1: pudge.3096 ($18.74 in chips) 
Seat 2: benben288 ($6.75 in chips) 
Seat 3: 0nix770 ($21.59 in chips) 
Seat 4: Do-Man22 ($9.21 in chips) 
Seat 5: vanapaguss ($20.21 in chips) 
Seat 6: Marauder777 ($11.48 in chips) 
0nix770: posts small blind $0.05
Do-Man22: posts big blind $0.10
*** HOLE CARDS ***
vanapaguss: raises $0.15 to $0.25
Marauder777: folds 
pudge.3096: calls $0.25
benben288: folds 
0nix770: folds 
Do-Man22: calls $0.15
*** FLOP *** [5h 4c As]
Do-Man22: checks 
vanapaguss: bets $0.40
pudge.3096: calls $0.40
Do-Man22: calls $0.40
*** TURN *** [5h 4c As] [Th]
Do-Man22: checks 
vanapaguss: bets $1
pudge.3096: calls $1
Do-Man22: calls $1
*** RIVER *** [5h 4c As Th] [2d]
Do-Man22: checks 
vanapaguss: checks 
pudge.3096: bets $1.53
Do-Man22: calls $1.53
vanapaguss: folds 
*** SHOW DOWN ***
pudge.3096: shows [4d 4h] (three of a kind, Fours)
Do-Man22: mucks hand 
pudge.3096 collected $7.70 from pot
*** SUMMARY ***
Total pot $8.06 | Rake $0.36 
Board [5h 4c As Th 2d]
Seat 1: pudge.3096 showed [4d 4h] and won ($7.70) with three of a kind, Fours
Seat 2: benben288 (button) folded before Flop (didn't bet)
Seat 3: 0nix770 (small blind) folded before Flop
Seat 4: Do-Man22 (big blind) mucked
Seat 5: vanapaguss folded on the River
Seat 6: Marauder777 folded before Flop (didn't bet)



PokerStars Hand #222982725474:  Hold'em No Limit ($0.05/$0.10 USD) - 2021/01/23 21:14:48 ET
Table 'Stephano III' 6-max Seat #3 is the button
Seat 1: pudge.3096 ($23.26 in chips) 
Seat 2: benben288 ($6.75 in chips) 
Seat 3: 0nix770 ($21.54 in chips) 
Seat 4: Do-Man22 ($6.03 in chips) 
Seat 5: vanapaguss ($18.56 in chips) 
Seat 6: Marauder777 ($11.48 in chips) 
Do-Man22: posts small blind $0.05
vanapaguss: posts big blind $0.10
*** HOLE CARDS ***
Marauder777: raises $0.12 to $0.22
pudge.3096: folds 
benben288: calls $0.22
0nix770: folds 
Do-Man22: folds 
vanapaguss: calls $0.12
*** FLOP *** [Th Qc 2h]
Do-Man22 leaves the table
vanapaguss: checks 
Marauder777: checks 
benben288: bets $0.60
vanapaguss: folds 
Marauder777: folds 
Uncalled bet ($0.60) returned to benben288
benben288 collected $0.68 from pot
benben288: doesn't show hand 
*** SUMMARY ***
Total pot $0.71 | Rake $0.03 
Board [Th Qc 2h]
Seat 1: pudge.3096 folded before Flop (didn't bet)
Seat 2: benben288 collected ($0.68)
Seat 3: 0nix770 (button) folded before Flop (didn't bet)
Seat 4: Do-Man22 (small blind) folded before Flop
Seat 5: vanapaguss (big blind) folded on the Flop
Seat 6: Marauder777 folded on the Flop



PokerStars Hand #222982739949:  Hold'em No Limit ($0.05/$0.10 USD) - 2021/01/23 21:15:23 ET
Table 'Stephano III' 6-max Seat #5 is the button
Seat 1: pudge.3096 ($23.26 in chips) 
Seat 2: benben288 ($7.21 in chips) 
Seat 3: 0nix770 ($21.54 in chips) 
Seat 5: vanapaguss ($18.34 in chips) 
Seat 6: Marauder777 ($11.26 in chips) 
Marauder777: posts small blind $0.05
pudge.3096: posts big blind $0.10
*** HOLE CARDS ***
benben288: folds 
0nix770: folds 
vanapaguss: folds 
Marauder777: folds 
Uncalled bet ($0.05) returned to pudge.3096
pudge.3096 collected $0.10 from pot
pudge.3096: doesn't show hand 
*** SUMMARY ***
Total pot $0.10 | Rake $0 
Seat 1: pudge.3096 (big blind) collected ($0.10)
Seat 2: benben288 folded before Flop (didn't bet)
Seat 3: 0nix770 folded before Flop (didn't bet)
Seat 5: vanapaguss (button) folded before Flop (didn't bet)
Seat 6: Marauder777 (small blind) folded before Flop



PokerStars Hand #222982744753:  Hold'em No Limit ($0.05/$0.10 USD) - 2021/01/23 21:15:35 ET
Table 'Stephano III' 6-max Seat #6 is the button
Seat 1: pudge.3096 ($23.31 in chips) 
Seat 2: benben288 ($7.21 in chips) 
Seat 3: 0nix770 ($21.54 in chips) 
Seat 5: vanapaguss ($18.34 in chips) 
Seat 6: Marauder777 ($11.21 in chips) 
pudge.3096: posts small blind $0.05
benben288: posts big blind $0.10
*** HOLE CARDS ***
0nix770: folds 
vanapaguss: raises $0.15 to $0.25
Marauder777: folds 
Veinar Dina joins the table at seat #4 
pudge.3096: folds 
benben288: folds 
Uncalled bet ($0.15) returned to vanapaguss
vanapaguss collected $0.25 from pot
vanapaguss: doesn't show hand 
*** SUMMARY ***
Total pot $0.25 | Rake $0 
Seat 1: pudge.3096 (small blind) folded before Flop
Seat 2: benben288 (big blind) folded before Flop
Seat 3: 0nix770 folded before Flop (didn't bet)
Seat 5: vanapaguss collected ($0.25)
Seat 6: Marauder777 (button) folded before Flop (didn't bet)



PokerStars Hand #222982754300:  Hold'em No Limit ($0.05/$0.10 USD) - 2021/01/23 21:15:58 ET
Table 'Stephano III' 6-max Seat #1 is the button
Seat 1: pudge.3096 ($23.26 in chips) 
Seat 2: benben288 ($7.11 in chips) 
Seat 4: Veinar Dina ($10 in chips) 
Seat 5: vanapaguss ($18.49 in chips) 
Seat 6: Marauder777 ($11.21 in chips) 
benben288: posts small blind $0.05
0nix770: is sitting out 
Veinar Dina: posts big blind $0.10
*** HOLE CARDS ***
0nix770 leaves the table
NoMMoney joins the table at seat #3 
vanapaguss: folds 
Marauder777: folds 
pudge.3096: folds 
benben288: folds 
Uncalled bet ($0.05) returned to Veinar Dina
Veinar Dina collected $0.10 from pot
Veinar Dina: doesn't show hand 
*** SUMMARY ***
Total pot $0.10 | Rake $0 
Seat 1: pudge.3096 (button) folded before Flop (didn't bet)
Seat 2: benben288 (small blind) folded before Flop
Seat 4: Veinar Dina (big blind) collected ($0.10)
Seat 5: vanapaguss folded before Flop (didn't bet)
Seat 6: Marauder777 folded before Flop (didn't bet)



PokerStars Hand #222982759498:  Hold'em No Limit ($0.05/$0.10 USD) - 2021/01/23 21:16:11 ET
Table 'Stephano III' 6-max Seat #2 is the button
Seat 1: pudge.3096 ($23.26 in chips) 
Seat 2: benben288 ($7.06 in chips) 
Seat 4: Veinar Dina ($10.05 in chips) 
Seat 5: vanapaguss ($18.49 in chips) 
Seat 6: Marauder777 ($11.21 in chips) 
Veinar Dina: posts small blind $0.05
vanapaguss: posts big blind $0.10
*** HOLE CARDS ***
Marauder777: folds 
pudge.3096: folds 
benben288: raises $0.10 to $0.20
Veinar Dina: folds 
pudge.3096 leaves the table
vanapaguss: folds 
Uncalled bet ($0.10) returned to benben288
benben288 collected $0.25 from pot
benben288: doesn't show hand 
*** SUMMARY ***
Total pot $0.25 | Rake $0 
Seat 1: pudge.3096 folded before Flop (didn't bet)
Seat 2: benben288 (button) collected ($0.25)
Seat 4: Veinar Dina (small blind) folded before Flop
Seat 5: vanapaguss (big blind) folded before Flop
Seat 6: Marauder777 folded before Flop (didn't bet)



PokerStars Hand #222982766120:  Hold'em No Limit ($0.05/$0.10 USD) - 2021/01/23 21:16:27 ET
Table 'Stephano III' 6-max Seat #4 is the button
Seat 2: benben288 ($7.21 in chips) 
Seat 3: NoMMoney ($8 in chips) 
Seat 4: Veinar Dina ($10 in chips) 
Seat 5: vanapaguss ($18.39 in chips) 
vanapaguss: posts small blind $0.05
Marauder777: is sitting out 
benben288: posts big blind $0.10
NoMMoney: posts big blind $0.10
*** HOLE CARDS ***
NoMMoney: checks 
Veinar Dina: folds 
vanapaguss: folds 
Pacman576 joins the table at seat #1 
benben288: checks 
*** FLOP *** [2h Js Tc]
benben288: bets $0.30
NoMMoney: folds 
Uncalled bet ($0.30) returned to benben288
benben288 collected $0.24 from pot
benben288: doesn't show hand 
*** SUMMARY ***
Total pot $0.25 | Rake $0.01 
Board [2h Js Tc]
Seat 2: benben288 (big blind) collected ($0.24)
Seat 3: NoMMoney folded on the Flop (didn't bet)
Seat 4: Veinar Dina (button) folded before Flop (didn't bet)
Seat 5: vanapaguss (small blind) folded before Flop



PokerStars Hand #222982775144:  Hold'em No Limit ($0.05/$0.10 USD) - 2021/01/23 21:16:49 ET
Table 'Stephano III' 6-max Seat #5 is the button
Seat 2: benben288 ($7.35 in chips) 
Seat 3: NoMMoney ($7.90 in chips) 
Seat 4: Veinar Dina ($10 in chips) 
Seat 5: vanapaguss ($18.34 in chips) 
benben288: posts small blind $0.05
NoMMoney: posts big blind $0.10
*** HOLE CARDS ***
Veinar Dina: raises $0.20 to $0.30
vanapaguss: folds 
benben288: folds 
NoMMoney: calls $0.20
*** FLOP *** [5s Jd 4s]
NoMMoney: bets $0.30
Veinar Dina: folds 
Uncalled bet ($0.30) returned to NoMMoney
NoMMoney collected $0.62 from pot
NoMMoney: doesn't show hand 
*** SUMMARY ***
Total pot $0.65 | Rake $0.03 
Board [5s Jd 4s]
Seat 2: benben288 (small blind) folded before Flop
Seat 3: NoMMoney (big blind) collected ($0.62)
Seat 4: Veinar Dina folded on the Flop
Seat 5: vanapaguss (button) folded before Flop (didn't bet)



PokerStars Hand #222982788007:  Hold'em No Limit ($0.05/$0.10 USD) - 2021/01/23 21:17:21 ET
Table 'Stephano III' 6-max Seat #2 is the button
Seat 1: Pacman576 ($5.10 in chips) 
Seat 2: benben288 ($7.30 in chips) 
Seat 3: NoMMoney ($8.22 in chips) 
Seat 4: Veinar Dina ($10 in chips) 
Seat 5: vanapaguss ($18.34 in chips) 
NoMMoney: posts small blind $0.05
Veinar Dina: posts big blind $0.10
Pacman576: posts big blind $0.10
*** HOLE CARDS ***
vanapaguss: raises $0.15 to $0.25
Pacman576: calls $0.15
benben288: folds 
NoMMoney: calls $0.20
Veinar Dina: folds 
*** FLOP *** [Jh Qc Qs]
NoMMoney: bets $0.10
vanapaguss: calls $0.10
Pacman576: raises $0.10 to $0.20
NoMMoney: calls $0.10
vanapaguss: raises $1.38 to $1.58
Pacman576: raises $1.38 to $2.96
NoMMoney: folds 
vanapaguss: raises $2.84 to $5.80
Pacman576: calls $1.89 and is all-in
Uncalled bet ($0.95) returned to vanapaguss
*** TURN *** [Jh Qc Qs] [9s]
*** RIVER *** [Jh Qc Qs 9s] [Th]
*** SHOW DOWN ***
vanapaguss: shows [Td Qh] (a full house, Queens full of Tens)
Pacman576: shows [Qd Jc] (a full house, Queens full of Jacks)
Pacman576 collected $10.27 from pot
*** SUMMARY ***
Total pot $10.75 | Rake $0.48 
Board [Jh Qc Qs 9s Th]
Seat 1: Pacman576 showed [Qd Jc] and won ($10.27) with a full house, Queens full of Jacks
Seat 2: benben288 (button) folded before Flop (didn't bet)
Seat 3: NoMMoney (small blind) folded on the Flop
Seat 4: Veinar Dina (big blind) folded before Flop
Seat 5: vanapaguss showed [Td Qh] and lost with a full house, Queens full of Tens



PokerStars Hand #222982825147:  Hold'em No Limit ($0.05/$0.10 USD) - 2021/01/23 21:18:44 ET
Table 'Stephano III' 6-max Seat #3 is the button
Seat 1: Pacman576 ($10.27 in chips) 
Seat 2: benben288 ($7.30 in chips) 
Seat 3: NoMMoney ($7.77 in chips) 
Seat 4: Veinar Dina ($10 in chips) 
Seat 5: vanapaguss ($13.24 in chips) 
Veinar Dina: posts small blind $0.05
vanapaguss: posts big blind $0.10
Marauder777: sits out 
*** HOLE CARDS ***
Pacman576: folds 
benben288: folds 
NoMMoney: folds 
Veinar Dina: folds 
Uncalled bet ($0.05) returned to vanapaguss
vanapaguss collected $0.10 from pot
vanapaguss: doesn't show hand 
*** SUMMARY ***
Total pot $0.10 | Rake $0 
Seat 1: Pacman576 folded before Flop (didn't bet)
Seat 2: benben288 folded before Flop (didn't bet)
Seat 3: NoMMoney (button) folded before Flop (didn't bet)
Seat 4: Veinar Dina (small blind) folded before Flop
Seat 5: vanapaguss (big blind) collected ($0.10)



PokerStars Hand #222982829016:  Hold'em No Limit ($0.05/$0.10 USD) - 2021/01/23 21:18:53 ET
Table 'Stephano III' 6-max Seat #4 is the button
Seat 1: Pacman576 ($10.27 in chips) 
Seat 2: benben288 ($7.30 in chips) 
Seat 3: NoMMoney ($7.77 in chips) 
Seat 4: Veinar Dina ($10 in chips) 
Seat 5: vanapaguss ($13.29 in chips) 
Seat 6: Marauder777 ($11.21 in chips) 
vanapaguss: posts small blind $0.05
Marauder777: posts big blind $0.10
*** HOLE CARDS ***
Pacman576: calls $0.10
benben288: folds 
NoMMoney: folds 
Veinar Dina: folds 
vanapaguss: folds 
Marauder777: checks 
*** FLOP *** [Js Jh 7s]
Marauder777: checks 
Pacman576: checks 
*** TURN *** [Js Jh 7s] [Jd]
Marauder777: bets $0.15
Pacman576: raises $2.75 to $2.90
Marauder777: folds 
Uncalled bet ($2.75) returned to Pacman576
Pacman576 collected $0.53 from pot
Pacman576: doesn't show hand 
*** SUMMARY ***
Total pot $0.55 | Rake $0.02 
Board [Js Jh 7s Jd]
Seat 1: Pacman576 collected ($0.53)
Seat 2: benben288 folded before Flop (didn't bet)
Seat 3: NoMMoney folded before Flop (didn't bet)
Seat 4: Veinar Dina (button) folded before Flop (didn't bet)
Seat 5: vanapaguss (small blind) folded before Flop
Seat 6: Marauder777 (big blind) folded on the Turn



PokerStars Hand #222982845199:  Hold'em No Limit ($0.05/$0.10 USD) - 2021/01/23 21:19:33 ET
Table 'Stephano III' 6-max Seat #5 is the button
Seat 1: Pacman576 ($10.55 in chips) 
Seat 2: benben288 ($7.30 in chips) 
Seat 3: NoMMoney ($7.77 in chips) 
Seat 4: Veinar Dina ($10 in chips) 
Seat 5: vanapaguss ($13.24 in chips) 
Seat 6: Marauder777 ($10.96 in chips) 
Marauder777: posts small blind $0.05
Pacman576: posts big blind $0.10
*** HOLE CARDS ***
benben288: raises $0.10 to $0.20
NoMMoney: folds 
Veinar Dina: folds 
vanapaguss: folds 
Marauder777: folds 
Pacman576: folds 
Uncalled bet ($0.10) returned to benben288
benben288 collected $0.25 from pot
benben288: doesn't show hand 
*** SUMMARY ***
Total pot $0.25 | Rake $0 
Seat 1: Pacman576 (big blind) folded before Flop
Seat 2: benben288 collected ($0.25)
Seat 3: NoMMoney folded before Flop (didn't bet)
Seat 4: Veinar Dina folded before Flop (didn't bet)
Seat 5: vanapaguss (button) folded before Flop (didn't bet)
Seat 6: Marauder777 (small blind) folded before Flop



PokerStars Hand #222982849673:  Hold'em No Limit ($0.05/$0.10 USD) - 2021/01/23 21:19:44 ET
Table 'Stephano III' 6-max Seat #6 is the button
Seat 1: Pacman576 ($10.45 in chips) 
Seat 2: benben288 ($7.45 in chips) 
Seat 3: NoMMoney ($7.77 in chips) 
Seat 4: Veinar Dina ($10 in chips) 
Seat 5: vanapaguss ($13.24 in chips) 
Seat 6: Marauder777 ($10.91 in chips) 
Pacman576: posts small blind $0.05
benben288: posts big blind $0.10
*** HOLE CARDS ***
NoMMoney: folds 
Veinar Dina: raises $0.20 to $0.30
vanapaguss: folds 
Marauder777: folds 
Pacman576: folds 
benben288: folds 
Uncalled bet ($0.20) returned to Veinar Dina
Veinar Dina collected $0.25 from pot
Veinar Dina: doesn't show hand 
*** SUMMARY ***
Total pot $0.25 | Rake $0 
Seat 1: Pacman576 (small blind) folded before Flop
Seat 2: benben288 (big blind) folded before Flop
Seat 3: NoMMoney folded before Flop (didn't bet)
Seat 4: Veinar Dina collected ($0.25)
Seat 5: vanapaguss folded before Flop (didn't bet)
Seat 6: Marauder777 (button) folded before Flop (didn't bet)



PokerStars Hand #222982856370:  Hold'em No Limit ($0.05/$0.10 USD) - 2021/01/23 21:20:01 ET
Table 'Stephano III' 6-max Seat #1 is the button
Seat 1: Pacman576 ($10.40 in chips) 
Seat 2: benben288 ($7.35 in chips) 
Seat 3: NoMMoney ($7.77 in chips) 
Seat 4: Veinar Dina ($10.15 in chips) 
Seat 5: vanapaguss ($13.24 in chips) 
Seat 6: Marauder777 ($10.91 in chips) 
benben288: posts small blind $0.05
NoMMoney: posts big blind $0.10
*** HOLE CARDS ***
Veinar Dina: folds 
vanapaguss: folds 
Marauder777: folds 
Pacman576: folds 
benben288: folds 
Uncalled bet ($0.05) returned to NoMMoney
NoMMoney collected $0.10 from pot
NoMMoney: doesn't show hand 
*** SUMMARY ***
Total pot $0.10 | Rake $0 
Seat 1: Pacman576 (button) folded before Flop (didn't bet)
Seat 2: benben288 (small blind) folded before Flop
Seat 3: NoMMoney (big blind) collected ($0.10)
Seat 4: Veinar Dina folded before Flop (didn't bet)
Seat 5: vanapaguss folded before Flop (didn't bet)
Seat 6: Marauder777 folded before Flop (didn't bet)



PokerStars Hand #222982862423:  Hold'em No Limit ($0.05/$0.10 USD) - 2021/01/23 21:20:16 ET
Table 'Stephano III' 6-max Seat #2 is the button
Seat 1: Pacman576 ($10.40 in chips) 
Seat 2: benben288 ($7.30 in chips) 
Seat 3: NoMMoney ($7.82 in chips) 
Seat 4: Veinar Dina ($10.15 in chips) 
Seat 5: vanapaguss ($13.24 in chips) 
Seat 6: Marauder777 ($10.91 in chips) 
NoMMoney: posts small blind $0.05
Veinar Dina: posts big blind $0.10
*** HOLE CARDS ***
vanapaguss: folds 
Marauder777: raises $0.12 to $0.22
Pacman576: folds 
benben288: folds 
NoMMoney: folds 
Veinar Dina: folds 
Uncalled bet ($0.12) returned to Marauder777
Marauder777 collected $0.25 from pot
Marauder777: doesn't show hand 
*** SUMMARY ***
Total pot $0.25 | Rake $0 
Seat 1: Pacman576 folded before Flop (didn't bet)
Seat 2: benben288 (button) folded before Flop (didn't bet)
Seat 3: NoMMoney (small blind) folded before Flop
Seat 4: Veinar Dina (big blind) folded before Flop
Seat 5: vanapaguss folded before Flop (didn't bet)
Seat 6: Marauder777 collected ($0.25)



PokerStars Hand #222982874723:  Hold'em No Limit ($0.05/$0.10 USD) - 2021/01/23 21:20:46 ET
Table 'Stephano III' 6-max Seat #3 is the button
Seat 1: Pacman576 ($10.40 in chips) 
Seat 2: benben288 ($7.30 in chips) 
Seat 3: NoMMoney ($7.77 in chips) 
Seat 4: Veinar Dina ($10.05 in chips) 
Seat 5: vanapaguss ($13.24 in chips) 
Seat 6: Marauder777 ($11.06 in chips) 
Veinar Dina: posts small blind $0.05
vanapaguss: posts big blind $0.10
*** HOLE CARDS ***
Marauder777: folds 
Pacman576: folds 
benben288: folds 
NoMMoney: calls $0.10
Veinar Dina: folds 
vanapaguss: checks 
*** FLOP *** [7h Td 4h]
vanapaguss: checks 
NoMMoney: checks 
*** TURN *** [7h Td 4h] [8c]
vanapaguss: checks 
NoMMoney: checks 
*** RIVER *** [7h Td 4h 8c] [7c]
vanapaguss: checks 
NoMMoney: bets $0.30
vanapaguss: folds 
Uncalled bet ($0.30) returned to NoMMoney
NoMMoney collected $0.24 from pot
NoMMoney: doesn't show hand 
*** SUMMARY ***
Total pot $0.25 | Rake $0.01 
Board [7h Td 4h 8c 7c]
Seat 1: Pacman576 folded before Flop (didn't bet)
Seat 2: benben288 folded before Flop (didn't bet)
Seat 3: NoMMoney (button) collected ($0.24)
Seat 4: Veinar Dina (small blind) folded before Flop
Seat 5: vanapaguss (big blind) folded on the River
Seat 6: Marauder777 folded before Flop (didn't bet)



PokerStars Hand #222982887980:  Hold'em No Limit ($0.05/$0.10 USD) - 2021/01/23 21:21:19 ET
Table 'Stephano III' 6-max Seat #4 is the button
Seat 1: Pacman576 ($10.40 in chips) 
Seat 2: benben288 ($7.30 in chips) 
Seat 3: NoMMoney ($7.91 in chips) 
Seat 4: Veinar Dina ($10 in chips) 
Seat 5: vanapaguss ($13.14 in chips) 
Seat 6: Marauder777 ($11.06 in chips) 
vanapaguss: posts small blind $0.05
Marauder777: posts big blind $0.10
*** HOLE CARDS ***
Pacman576: calls $0.10
benben288: folds 
NoMMoney: calls $0.10
Veinar Dina: folds 
vanapaguss: calls $0.05
Marauder777: checks 
*** FLOP *** [9c 7s Jc]
vanapaguss: checks 
Marauder777: checks 
Pacman576: checks 
NoMMoney: bets $0.20
vanapaguss: folds 
Marauder777: folds 
Pacman576: folds 
Uncalled bet ($0.20) returned to NoMMoney
NoMMoney collected $0.38 from pot
NoMMoney: doesn't show hand 
*** SUMMARY ***
Total pot $0.40 | Rake $0.02 
Board [9c 7s Jc]
Seat 1: Pacman576 folded on the Flop
Seat 2: benben288 folded before Flop (didn't bet)
Seat 3: NoMMoney collected ($0.38)
Seat 4: Veinar Dina (button) folded before Flop (didn't bet)
Seat 5: vanapaguss (small blind) folded on the Flop
Seat 6: Marauder777 (big blind) folded on the Flop



PokerStars Hand #222982905831:  Hold'em No Limit ($0.05/$0.10 USD) - 2021/01/23 21:22:04 ET
Table 'Stephano III' 6-max Seat #5 is the button
Seat 1: Pacman576 ($10.30 in chips) 
Seat 2: benben288 ($7.30 in chips) 
Seat 3: NoMMoney ($8.19 in chips) 
Seat 4: Veinar Dina ($10 in chips) 
Seat 5: vanapaguss ($13.04 in chips) 
Seat 6: Marauder777 ($10.96 in chips) 
Marauder777: posts small blind $0.05
Pacman576: posts big blind $0.10
*** HOLE CARDS ***
benben288: folds 
NoMMoney: calls $0.10
Veinar Dina: folds 
vanapaguss: folds 
Marauder777: folds 
Pacman576: checks 
*** FLOP *** [Qs 4s 4c]
Pacman576: checks 
NoMMoney: bets $0.10
Pacman576: folds 
Uncalled bet ($0.10) returned to NoMMoney
NoMMoney collected $0.24 from pot
NoMMoney: doesn't show hand 
*** SUMMARY ***
Total pot $0.25 | Rake $0.01 
Board [Qs 4s 4c]
Seat 1: Pacman576 (big blind) folded on the Flop
Seat 2: benben288 folded before Flop (didn't bet)
Seat 3: NoMMoney collected ($0.24)
Seat 4: Veinar Dina folded before Flop (didn't bet)
Seat 5: vanapaguss (button) folded before Flop (didn't bet)
Seat 6: Marauder777 (small blind) folded before Flop



PokerStars Hand #222982919253:  Hold'em No Limit ($0.05/$0.10 USD) - 2021/01/23 21:22:38 ET
Table 'Stephano III' 6-max Seat #6 is the button
Seat 1: Pacman576 ($10.20 in chips) 
Seat 2: benben288 ($7.30 in chips) 
Seat 3: NoMMoney ($8.33 in chips) 
Seat 4: Veinar Dina ($10 in chips) 
Seat 5: vanapaguss ($13.04 in chips) 
Seat 6: Marauder777 ($10.91 in chips) 
Pacman576: posts small blind $0.05
benben288: posts big blind $0.10
*** HOLE CARDS ***
NoMMoney: calls $0.10
Veinar Dina: folds 
vanapaguss: folds 
Marauder777: folds 
Pacman576: folds 
benben288: checks 
*** FLOP *** [2d 2h 6d]
benben288: checks 
NoMMoney: checks 
*** TURN *** [2d 2h 6d] [6c]
benben288: checks 
NoMMoney: bets $0.20
benben288: calls $0.20
*** RIVER *** [2d 2h 6d 6c] [3s]
benben288: checks 
NoMMoney: bets $0.31
benben288: calls $0.31
*** SHOW DOWN ***
NoMMoney: shows [5c 2c] (a full house, Deuces full of Sixes)
benben288: mucks hand 
NoMMoney collected $1.21 from pot
*** SUMMARY ***
Total pot $1.27 | Rake $0.06 
Board [2d 2h 6d 6c 3s]
Seat 1: Pacman576 (small blind) folded before Flop
Seat 2: benben288 (big blind) mucked
Seat 3: NoMMoney showed [5c 2c] and won ($1.21) with a full house, Deuces full of Sixes
Seat 4: Veinar Dina folded before Flop (didn't bet)
Seat 5: vanapaguss folded before Flop (didn't bet)
Seat 6: Marauder777 (button) folded before Flop (didn't bet)



PokerStars Hand #222982948947:  Hold'em No Limit ($0.05/$0.10 USD) - 2021/01/23 21:23:35 ET
Table 'Stephano III' 6-max Seat #1 is the button
Seat 1: Pacman576 ($10.15 in chips) 
Seat 2: benben288 ($6.69 in chips) 
Seat 3: NoMMoney ($8.93 in chips) 
Seat 4: Veinar Dina ($10 in chips) 
Seat 5: vanapaguss ($13.04 in chips) 
Seat 6: Marauder777 ($10.91 in chips) 
benben288: posts small blind $0.05
NoMMoney: posts big blind $0.10
*** HOLE CARDS ***
Veinar Dina: folds 
vanapaguss: folds 
Marauder777: folds 
Pacman576: calls $0.10
benben288: folds 
NoMMoney: checks 
*** FLOP *** [Qc As Ts]
NoMMoney: bets $0.20
Pacman576: folds 
Uncalled bet ($0.20) returned to NoMMoney
NoMMoney collected $0.24 from pot
NoMMoney: doesn't show hand 
*** SUMMARY ***
Total pot $0.25 | Rake $0.01 
Board [Qc As Ts]
Seat 1: Pacman576 (button) folded on the Flop
Seat 2: benben288 (small blind) folded before Flop
Seat 3: NoMMoney (big blind) collected ($0.24)
Seat 4: Veinar Dina folded before Flop (didn't bet)
Seat 5: vanapaguss folded before Flop (didn't bet)
Seat 6: Marauder777 folded before Flop (didn't bet)



PokerStars Hand #222982966896:  Hold'em No Limit ($0.05/$0.10 USD) - 2021/01/23 21:24:02 ET
Table 'Stephano III' 6-max Seat #2 is the button
Seat 1: Pacman576 ($10.05 in chips) 
Seat 2: benben288 ($6.64 in chips) 
Seat 3: NoMMoney ($9.07 in chips) 
Seat 4: Veinar Dina ($10 in chips) 
Seat 5: vanapaguss ($13.04 in chips) 
Seat 6: Marauder777 ($10.91 in chips) 
NoMMoney: posts small blind $0.05
Veinar Dina: posts big blind $0.10
*** HOLE CARDS ***
vanapaguss has timed out
vanapaguss: folds 
Marauder777: folds 
Pacman576: folds 
benben288: raises $0.20 to $0.30
NoMMoney: calls $0.25
Veinar Dina: folds 
*** FLOP *** [8d Js 8s]
NoMMoney: checks 
benben288: bets $0.30
NoMMoney: folds 
Uncalled bet ($0.30) returned to benben288
benben288 collected $0.67 from pot
benben288: doesn't show hand 
*** SUMMARY ***
Total pot $0.70 | Rake $0.03 
Board [8d Js 8s]
Seat 1: Pacman576 folded before Flop (didn't bet)
Seat 2: benben288 (button) collected ($0.67)
Seat 3: NoMMoney (small blind) folded on the Flop
Seat 4: Veinar Dina (big blind) folded before Flop
Seat 5: vanapaguss folded before Flop (didn't bet)
Seat 6: Marauder777 folded before Flop (didn't bet)



PokerStars Hand #222982979429:  Hold'em No Limit ($0.05/$0.10 USD) - 2021/01/23 21:24:33 ET
Table 'Stephano III' 6-max Seat #3 is the button
Seat 1: Pacman576 ($10.05 in chips) 
Seat 2: benben288 ($7.01 in chips) 
Seat 3: NoMMoney ($8.77 in chips) 
Seat 4: Veinar Dina ($10 in chips) 
Seat 5: vanapaguss ($13.04 in chips) 
Seat 6: Marauder777 ($10.91 in chips) 
Veinar Dina: posts small blind $0.05
vanapaguss: posts big blind $0.10
*** HOLE CARDS ***
Marauder777: folds 
Pacman576: folds 
benben288: folds 
NoMMoney: calls $0.10
Veinar Dina: raises $0.30 to $0.40
vanapaguss: folds 
NoMMoney: folds 
Uncalled bet ($0.30) returned to Veinar Dina
Veinar Dina collected $0.30 from pot
Veinar Dina: doesn't show hand 
*** SUMMARY ***
Total pot $0.30 | Rake $0 
Seat 1: Pacman576 folded before Flop (didn't bet)
Seat 2: benben288 folded before Flop (didn't bet)
Seat 3: NoMMoney (button) folded before Flop
Seat 4: Veinar Dina (small blind) collected ($0.30)
Seat 5: vanapaguss (big blind) folded before Flop
Seat 6: Marauder777 folded before Flop (didn't bet)



PokerStars Hand #222982986822:  Hold'em No Limit ($0.05/$0.10 USD) - 2021/01/23 21:24:52 ET
Table 'Stephano III' 6-max Seat #4 is the button
Seat 1: Pacman576 ($10.05 in chips) 
Seat 2: benben288 ($7.01 in chips) 
Seat 3: NoMMoney ($8.67 in chips) 
Seat 4: Veinar Dina ($10.20 in chips) 
Seat 5: vanapaguss ($12.94 in chips) 
Seat 6: Marauder777 ($10.91 in chips) 
vanapaguss: posts small blind $0.05
Marauder777: posts big blind $0.10
*** HOLE CARDS ***
Pacman576: calls $0.10
benben288: calls $0.10
NoMMoney: folds 
Veinar Dina: folds 
vanapaguss: calls $0.05
Marauder777: checks 
*** FLOP *** [4d Kd Qc]
vanapaguss: checks 
Marauder777: checks 
Pacman576: bets $0.50
benben288: folds 
vanapaguss: folds 
Marauder777: folds 
Uncalled bet ($0.50) returned to Pacman576
Pacman576 collected $0.38 from pot
Pacman576: doesn't show hand 
*** SUMMARY ***
Total pot $0.40 | Rake $0.02 
Board [4d Kd Qc]
Seat 1: Pacman576 collected ($0.38)
Seat 2: benben288 folded on the Flop
Seat 3: NoMMoney folded before Flop (didn't bet)
Seat 4: Veinar Dina (button) folded before Flop (didn't bet)
Seat 5: vanapaguss (small blind) folded on the Flop
Seat 6: Marauder777 (big blind) folded on the Flop



PokerStars Hand #222983000178:  Hold'em No Limit ($0.05/$0.10 USD) - 2021/01/23 21:25:26 ET
Table 'Stephano III' 6-max Seat #5 is the button
Seat 1: Pacman576 ($10.33 in chips) 
Seat 2: benben288 ($6.91 in chips) 
Seat 3: NoMMoney ($8.67 in chips) 
Seat 4: Veinar Dina ($10.20 in chips) 
Seat 5: vanapaguss ($12.84 in chips) 
Seat 6: Marauder777 ($10.81 in chips) 
Marauder777: posts small blind $0.05
Pacman576: posts big blind $0.10
*** HOLE CARDS ***
benben288: folds 
NoMMoney: folds 
Veinar Dina: folds 
vanapaguss: folds 
Marauder777: raises $0.20 to $0.30
Pacman576: folds 
Uncalled bet ($0.20) returned to Marauder777
Marauder777 collected $0.20 from pot
Marauder777: doesn't show hand 
*** SUMMARY ***
Total pot $0.20 | Rake $0 
Seat 1: Pacman576 (big blind) folded before Flop
Seat 2: benben288 folded before Flop (didn't bet)
Seat 3: NoMMoney folded before Flop (didn't bet)
Seat 4: Veinar Dina folded before Flop (didn't bet)
Seat 5: vanapaguss (button) folded before Flop (didn't bet)
Seat 6: Marauder777 (small blind) collected ($0.20)



PokerStars Hand #222983007947:  Hold'em No Limit ($0.05/$0.10 USD) - 2021/01/23 21:25:45 ET
Table 'Stephano III' 6-max Seat #6 is the button
Seat 1: Pacman576 ($10.23 in chips) 
Seat 2: benben288 ($6.91 in chips) 
Seat 3: NoMMoney ($8.67 in chips) 
Seat 4: Veinar Dina ($10.20 in chips) 
Seat 5: vanapaguss ($12.84 in chips) 
Seat 6: Marauder777 ($10.91 in chips) 
Pacman576: posts small blind $0.05
benben288: posts big blind $0.10
*** HOLE CARDS ***
NoMMoney: calls $0.10
Veinar Dina: folds 
vanapaguss: folds 
Marauder777: raises $0.25 to $0.35
Pacman576: folds 
benben288: calls $0.25
NoMMoney: calls $0.25
*** FLOP *** [Ac 7s 6h]
benben288: checks 
NoMMoney: bets $0.30
Marauder777: folds 
benben288: calls $0.30
*** TURN *** [Ac 7s 6h] [8c]
benben288: checks 
NoMMoney: checks 
*** RIVER *** [Ac 7s 6h 8c] [Qc]
benben288: checks 
NoMMoney: bets $0.40
benben288: folds 
Uncalled bet ($0.40) returned to NoMMoney
NoMMoney collected $1.62 from pot
NoMMoney: doesn't show hand 
*** SUMMARY ***
Total pot $1.70 | Rake $0.08 
Board [Ac 7s 6h 8c Qc]
Seat 1: Pacman576 (small blind) folded before Flop
Seat 2: benben288 (big blind) folded on the River
Seat 3: NoMMoney collected ($1.62)
Seat 4: Veinar Dina folded before Flop (didn't bet)
Seat 5: vanapaguss folded before Flop (didn't bet)
Seat 6: Marauder777 (button) folded on the Flop



PokerStars Hand #222983026639:  Hold'em No Limit ($0.05/$0.10 USD) - 2021/01/23 21:26:33 ET
Table 'Stephano III' 6-max Seat #1 is the button
Seat 1: Pacman576 ($10.18 in chips) 
Seat 2: benben288 ($6.26 in chips) 
Seat 3: NoMMoney ($9.64 in chips) 
Seat 4: Veinar Dina ($10.20 in chips) 
Seat 5: vanapaguss ($12.84 in chips) 
Seat 6: Marauder777 ($10.56 in chips) 
benben288: posts small blind $0.05
NoMMoney: posts big blind $0.10
*** HOLE CARDS ***
Veinar Dina: folds 
vanapaguss: folds 
Marauder777: folds 
Pacman576: folds 
benben288: folds 
Uncalled bet ($0.05) returned to NoMMoney
NoMMoney collected $0.10 from pot
NoMMoney: doesn't show hand 
*** SUMMARY ***
Total pot $0.10 | Rake $0 
Seat 1: Pacman576 (button) folded before Flop (didn't bet)
Seat 2: benben288 (small blind) folded before Flop
Seat 3: NoMMoney (big blind) collected ($0.10)
Seat 4: Veinar Dina folded before Flop (didn't bet)
Seat 5: vanapaguss folded before Flop (didn't bet)
Seat 6: Marauder777 folded before Flop (didn't bet)



PokerStars Hand #222983031787:  Hold'em No Limit ($0.05/$0.10 USD) - 2021/01/23 21:26:46 ET
Table 'Stephano III' 6-max Seat #2 is the button
Seat 1: Pacman576 ($10.18 in chips) 
Seat 2: benben288 ($6.21 in chips) 
Seat 3: NoMMoney ($9.69 in chips) 
Seat 4: Veinar Dina ($10.20 in chips) 
Seat 5: vanapaguss ($12.84 in chips) 
Seat 6: Marauder777 ($10.56 in chips) 
NoMMoney: posts small blind $0.05
Veinar Dina: posts big blind $0.10
*** HOLE CARDS ***
vanapaguss: folds 
Marauder777: folds 
Pacman576: folds 
benben288: folds 
NoMMoney: raises $0.10 to $0.20
Veinar Dina: folds 
Uncalled bet ($0.10) returned to NoMMoney
NoMMoney collected $0.20 from pot
NoMMoney: doesn't show hand 
*** SUMMARY ***
Total pot $0.20 | Rake $0 
Seat 1: Pacman576 folded before Flop (didn't bet)
Seat 2: benben288 (button) folded before Flop (didn't bet)
Seat 3: NoMMoney (small blind) collected ($0.20)
Seat 4: Veinar Dina (big blind) folded before Flop
Seat 5: vanapaguss folded before Flop (didn't bet)
Seat 6: Marauder777 folded before Flop (didn't bet)



PokerStars Hand #222983036876:  Hold'em No Limit ($0.05/$0.10 USD) - 2021/01/23 21:26:59 ET
Table 'Stephano III' 6-max Seat #3 is the button
Seat 1: Pacman576 ($10.18 in chips) 
Seat 2: benben288 ($6.21 in chips) 
Seat 3: NoMMoney ($9.79 in chips) 
Seat 4: Veinar Dina ($10.10 in chips) 
Seat 5: vanapaguss ($12.84 in chips) 
Seat 6: Marauder777 ($10.56 in chips) 
Veinar Dina: posts small blind $0.05
vanapaguss: posts big blind $0.10
*** HOLE CARDS ***
Marauder777: raises $0.12 to $0.22
Pacman576: calls $0.22
benben288: folds 
NoMMoney: folds 
Veinar Dina: raises $0.76 to $0.98
vanapaguss: folds 
Marauder777: folds 
Pacman576: calls $0.76
*** FLOP *** [Ac 5c 2d]
Veinar Dina: checks 
Pacman576: checks 
*** TURN *** [Ac 5c 2d] [7s]
Veinar Dina: checks 
Pacman576: bets $0.10
Veinar Dina: raises $1.19 to $1.29
Pacman576: calls $1.19
*** RIVER *** [Ac 5c 2d 7s] [3s]
Veinar Dina: checks 
Pacman576: checks 
*** SHOW DOWN ***
Veinar Dina: shows [Qs Qc] (a pair of Queens)
Pacman576: shows [As Qd] (a pair of Aces)
Pacman576 collected $4.64 from pot
*** SUMMARY ***
Total pot $4.86 | Rake $0.22 
Board [Ac 5c 2d 7s 3s]
Seat 1: Pacman576 showed [As Qd] and won ($4.64) with a pair of Aces
Seat 2: benben288 folded before Flop (didn't bet)
Seat 3: NoMMoney (button) folded before Flop (didn't bet)
Seat 4: Veinar Dina (small blind) showed [Qs Qc] and lost with a pair of Queens
Seat 5: vanapaguss (big blind) folded before Flop
Seat 6: Marauder777 folded before Flop



PokerStars Hand #222983060283:  Hold'em No Limit ($0.05/$0.10 USD) - 2021/01/23 21:27:59 ET
Table 'Stephano III' 6-max Seat #4 is the button
Seat 1: Pacman576 ($12.55 in chips) 
Seat 2: benben288 ($6.21 in chips) 
Seat 3: NoMMoney ($9.79 in chips) 
Seat 4: Veinar Dina ($10 in chips) 
Seat 5: vanapaguss ($12.74 in chips) 
Seat 6: Marauder777 ($10.34 in chips) 
vanapaguss: posts small blind $0.05
Marauder777: posts big blind $0.10
*** HOLE CARDS ***
Pacman576: calls $0.10
benben288: folds 
NoMMoney: calls $0.10
Veinar Dina: folds 
vanapaguss: raises $0.30 to $0.40
Marauder777: folds 
Pacman576: calls $0.30
NoMMoney: folds 
*** FLOP *** [2d 6c 4h]
vanapaguss: checks 
Pacman576: checks 
*** TURN *** [2d 6c 4h] [5d]
vanapaguss: bets $0.50
Pacman576: calls $0.50
*** RIVER *** [2d 6c 4h 5d] [6s]
vanapaguss: bets $1.40
Pacman576: folds 
Uncalled bet ($1.40) returned to vanapaguss
vanapaguss collected $1.91 from pot
vanapaguss: doesn't show hand 
*** SUMMARY ***
Total pot $2 | Rake $0.09 
Board [2d 6c 4h 5d 6s]
Seat 1: Pacman576 folded on the River
Seat 2: benben288 folded before Flop (didn't bet)
Seat 3: NoMMoney folded before Flop
Seat 4: Veinar Dina (button) folded before Flop (didn't bet)
Seat 5: vanapaguss (small blind) collected ($1.91)
Seat 6: Marauder777 (big blind) folded before Flop



PokerStars Hand #222983087158:  Hold'em No Limit ($0.05/$0.10 USD) - 2021/01/23 21:29:07 ET
Table 'Stephano III' 6-max Seat #5 is the button
Seat 1: Pacman576 ($11.65 in chips) 
Seat 2: benben288 ($6.21 in chips) 
Seat 3: NoMMoney ($9.69 in chips) 
Seat 4: Veinar Dina ($10 in chips) 
Seat 5: vanapaguss ($13.75 in chips) 
Seat 6: Marauder777 ($10.24 in chips) 
Marauder777: posts small blind $0.05
Pacman576: posts big blind $0.10
*** HOLE CARDS ***
benben288: folds 
NoMMoney: folds 
Veinar Dina: folds 
vanapaguss: folds 
Marauder777: calls $0.05
Pacman576: checks 
*** FLOP *** [2c As 5s]
Marauder777: bets $0.10
Pacman576: calls $0.10
*** TURN *** [2c As 5s] [8h]
Marauder777: checks 
Pacman576: checks 
*** RIVER *** [2c As 5s 8h] [3h]
Marauder777: checks 
Pacman576: bets $3
Marauder777: folds 
Uncalled bet ($3) returned to Pacman576
Pacman576 collected $0.38 from pot
Pacman576: doesn't show hand 
*** SUMMARY ***
Total pot $0.40 | Rake $0.02 
Board [2c As 5s 8h 3h]
Seat 1: Pacman576 (big blind) collected ($0.38)
Seat 2: benben288 folded before Flop (didn't bet)
Seat 3: NoMMoney folded before Flop (didn't bet)
Seat 4: Veinar Dina folded before Flop (didn't bet)
Seat 5: vanapaguss (button) folded before Flop (didn't bet)
Seat 6: Marauder777 (small blind) folded on the River



PokerStars Hand #222983103437:  Hold'em No Limit ($0.05/$0.10 USD) - 2021/01/23 21:29:49 ET
Table 'Stephano III' 6-max Seat #6 is the button
Seat 1: Pacman576 ($11.83 in chips) 
Seat 3: NoMMoney ($9.69 in chips) 
Seat 4: Veinar Dina ($10 in chips) 
Seat 5: vanapaguss ($13.75 in chips) 
Seat 6: Marauder777 ($10.04 in chips) 
Pacman576: posts small blind $0.05
NoMMoney: posts big blind $0.10
*** HOLE CARDS ***
Veinar Dina: folds 
vanapaguss: folds 
Marauder777: folds 
Pacman576: folds 
Uncalled bet ($0.05) returned to NoMMoney
NoMMoney collected $0.10 from pot
NoMMoney: doesn't show hand 
*** SUMMARY ***
Total pot $0.10 | Rake $0 
Seat 1: Pacman576 (small blind) folded before Flop
Seat 3: NoMMoney (big blind) collected ($0.10)
Seat 4: Veinar Dina folded before Flop (didn't bet)
Seat 5: vanapaguss folded before Flop (didn't bet)
Seat 6: Marauder777 (button) folded before Flop (didn't bet)



PokerStars Hand #222983110341:  Hold'em No Limit ($0.05/$0.10 USD) - 2021/01/23 21:30:06 ET
Table 'Stephano III' 6-max Seat #1 is the button
Seat 1: Pacman576 ($11.78 in chips) 
Seat 3: NoMMoney ($9.74 in chips) 
Seat 4: Veinar Dina ($10 in chips) 
Seat 5: vanapaguss ($13.75 in chips) 
Seat 6: Marauder777 ($10.04 in chips) 
NoMMoney: posts small blind $0.05
Veinar Dina: posts big blind $0.10
*** HOLE CARDS ***
vanapaguss: raises $0.15 to $0.25
Marauder777: folds 
Pacman576: folds 
NoMMoney: calls $0.20
Veinar Dina: folds 
*** FLOP *** [Kh 6d 3c]
NoMMoney: bets $0.20
vanapaguss: raises $0.40 to $0.60
NoMMoney: folds 
Uncalled bet ($0.40) returned to vanapaguss
vanapaguss collected $0.96 from pot
vanapaguss: doesn't show hand 
*** SUMMARY ***
Total pot $1 | Rake $0.04 
Board [Kh 6d 3c]
Seat 1: Pacman576 (button) folded before Flop (didn't bet)
Seat 3: NoMMoney (small blind) folded on the Flop
Seat 4: Veinar Dina (big blind) folded before Flop
Seat 5: vanapaguss collected ($0.96)
Seat 6: Marauder777 folded before Flop (didn't bet)



PokerStars Hand #222983124344:  Hold'em No Limit ($0.05/$0.10 USD) - 2021/01/23 21:30:42 ET
Table 'Stephano III' 6-max Seat #3 is the button
Seat 1: Pacman576 ($11.78 in chips) 
Seat 3: NoMMoney ($9.29 in chips) 
Seat 4: Veinar Dina ($10 in chips) 
Seat 5: vanapaguss ($14.26 in chips) 
Seat 6: Marauder777 ($10.04 in chips) 
Veinar Dina: posts small blind $0.05
vanapaguss: posts big blind $0.10
*** HOLE CARDS ***
Marauder777: folds 
Pacman576: folds 
NoMMoney: calls $0.10
Veinar Dina: folds 
vanapaguss: raises $0.20 to $0.30
NoMMoney: calls $0.20
*** FLOP *** [Ac Jc Th]
vanapaguss: checks 
NoMMoney: checks 
*** TURN *** [Ac Jc Th] [Js]
vanapaguss: bets $0.20
NoMMoney: raises $0.20 to $0.40
vanapaguss: calls $0.20
*** RIVER *** [Ac Jc Th Js] [8c]
vanapaguss: checks 
NoMMoney: bets $0.99
vanapaguss: folds 
Uncalled bet ($0.99) returned to NoMMoney
NoMMoney collected $1.38 from pot
NoMMoney: doesn't show hand 
*** SUMMARY ***
Total pot $1.45 | Rake $0.07 
Board [Ac Jc Th Js 8c]
Seat 1: Pacman576 folded before Flop (didn't bet)
Seat 3: NoMMoney (button) collected ($1.38)
Seat 4: Veinar Dina (small blind) folded before Flop
Seat 5: vanapaguss (big blind) folded on the River
Seat 6: Marauder777 folded before Flop (didn't bet)



PokerStars Hand #222983143089:  Hold'em No Limit ($0.05/$0.10 USD) - 2021/01/23 21:31:29 ET
Table 'Stephano III' 6-max Seat #4 is the button
Seat 1: Pacman576 ($11.78 in chips) 
Seat 3: NoMMoney ($9.97 in chips) 
Seat 4: Veinar Dina ($10 in chips) 
Seat 5: vanapaguss ($13.56 in chips) 
Seat 6: Marauder777 ($10.04 in chips) 
vanapaguss: posts small blind $0.05
Marauder777: posts big blind $0.10
benben288: sits out 
*** HOLE CARDS ***
Pacman576: folds 
NoMMoney: calls $0.10
Veinar Dina: folds 
vanapaguss: folds 
Marauder777: checks 
*** FLOP *** [Qc Qh Kh]
Marauder777: checks 
NoMMoney: bets $0.10
Marauder777: calls $0.10
*** TURN *** [Qc Qh Kh] [2h]
Marauder777: checks 
NoMMoney: bets $0.40
Marauder777: folds 
Uncalled bet ($0.40) returned to NoMMoney
NoMMoney collected $0.43 from pot
NoMMoney: doesn't show hand 
*** SUMMARY ***
Total pot $0.45 | Rake $0.02 
Board [Qc Qh Kh 2h]
Seat 1: Pacman576 folded before Flop (didn't bet)
Seat 3: NoMMoney collected ($0.43)
Seat 4: Veinar Dina (button) folded before Flop (didn't bet)
Seat 5: vanapaguss (small blind) folded before Flop
Seat 6: Marauder777 (big blind) folded on the Turn



PokerStars Hand #222983159928:  Hold'em No Limit ($0.05/$0.10 USD) - 2021/01/23 21:32:12 ET
Table 'Stephano III' 6-max Seat #5 is the button
Seat 1: Pacman576 ($11.78 in chips) 
Seat 3: NoMMoney ($10.20 in chips) 
Seat 4: Veinar Dina ($10 in chips) 
Seat 5: vanapaguss ($13.51 in chips) 
Seat 6: Marauder777 ($10 in chips) 
Marauder777: posts small blind $0.05
Pacman576: posts big blind $0.10
benben288: sits out 
*** HOLE CARDS ***
NoMMoney: calls $0.10
Veinar Dina: folds 
vanapaguss: folds 
Marauder777: calls $0.05
Pacman576: checks 
*** FLOP *** [3d 5d 8s]
Marauder777: checks 
Pacman576: checks 
NoMMoney: bets $0.30
Marauder777: folds 
Pacman576: folds 
Uncalled bet ($0.30) returned to NoMMoney
NoMMoney collected $0.29 from pot
NoMMoney: doesn't show hand 
*** SUMMARY ***
Total pot $0.30 | Rake $0.01 
Board [3d 5d 8s]
Seat 1: Pacman576 (big blind) folded on the Flop
Seat 3: NoMMoney collected ($0.29)
Seat 4: Veinar Dina folded before Flop (didn't bet)
Seat 5: vanapaguss (button) folded before Flop (didn't bet)
Seat 6: Marauder777 (small blind) folded on the Flop



PokerStars Hand #222983178326:  Hold'em No Limit ($0.05/$0.10 USD) - 2021/01/23 21:32:58 ET
Table 'Stephano III' 6-max Seat #6 is the button
Seat 1: Pacman576 ($11.68 in chips) 
Seat 2: benben288 ($6.21 in chips) 
Seat 3: NoMMoney ($10.39 in chips) 
Seat 4: Veinar Dina ($10 in chips) 
Seat 5: vanapaguss ($13.51 in chips) 
Seat 6: Marauder777 ($10 in chips) 
Pacman576: posts small blind $0.05
benben288: posts big blind $0.10
*** HOLE CARDS ***
Pacman576 is disconnected 
NoMMoney: folds 
Veinar Dina: folds 
vanapaguss: folds 
Marauder777: folds 
Pacman576 has timed out while disconnected
Pacman576: folds 
Uncalled bet ($0.05) returned to benben288
benben288 collected $0.10 from pot
benben288: doesn't show hand 
*** SUMMARY ***
Total pot $0.10 | Rake $0 
Seat 1: Pacman576 (small blind) folded before Flop
Seat 2: benben288 (big blind) collected ($0.10)
Seat 3: NoMMoney folded before Flop (didn't bet)
Seat 4: Veinar Dina folded before Flop (didn't bet)
Seat 5: vanapaguss folded before Flop (didn't bet)
Seat 6: Marauder777 (button) folded before Flop (didn't bet)



PokerStars Hand #222983184711:  Hold'em No Limit ($0.05/$0.10 USD) - 2021/01/23 21:33:14 ET
Table 'Stephano III' 6-max Seat #2 is the button
Seat 2: benben288 ($6.26 in chips) 
Seat 3: NoMMoney ($10.39 in chips) 
Seat 4: Veinar Dina ($10 in chips) 
Seat 5: vanapaguss ($13.51 in chips) 
Seat 6: Marauder777 ($10 in chips) 
NoMMoney: posts small blind $0.05
Veinar Dina: posts big blind $0.10
*** HOLE CARDS ***
vanapaguss: folds 
Marauder777: raises $0.12 to $0.22
benben288: folds 
NoMMoney: folds 
Veinar Dina: folds 
Uncalled bet ($0.12) returned to Marauder777
Marauder777 collected $0.25 from pot
Marauder777: doesn't show hand 
*** SUMMARY ***
Total pot $0.25 | Rake $0 
Seat 2: benben288 (button) folded before Flop (didn't bet)
Seat 3: NoMMoney (small blind) folded before Flop
Seat 4: Veinar Dina (big blind) folded before Flop
Seat 5: vanapaguss folded before Flop (didn't bet)
Seat 6: Marauder777 collected ($0.25)



PokerStars Hand #222983189338:  Hold'em No Limit ($0.05/$0.10 USD) - 2021/01/23 21:33:26 ET
Table 'Stephano III' 6-max Seat #3 is the button
Seat 2: benben288 ($6.26 in chips) 
Seat 3: NoMMoney ($10.34 in chips) 
Seat 4: Veinar Dina ($10 in chips) 
Seat 5: vanapaguss ($13.51 in chips) 
Seat 6: Marauder777 ($10.15 in chips) 
Veinar Dina: posts small blind $0.05
vanapaguss: posts big blind $0.10
*** HOLE CARDS ***
Marauder777: folds 
benben288: folds 
NoMMoney: folds 
Veinar Dina: folds 
Uncalled bet ($0.05) returned to vanapaguss
vanapaguss collected $0.10 from pot
vanapaguss: doesn't show hand 
*** SUMMARY ***
Total pot $0.10 | Rake $0 
Seat 2: benben288 folded before Flop (didn't bet)
Seat 3: NoMMoney (button) folded before Flop (didn't bet)
Seat 4: Veinar Dina (small blind) folded before Flop
Seat 5: vanapaguss (big blind) collected ($0.10)
Seat 6: Marauder777 folded before Flop (didn't bet)



PokerStars Hand #222983192413:  Hold'em No Limit ($0.05/$0.10 USD) - 2021/01/23 21:33:34 ET
Table 'Stephano III' 6-max Seat #4 is the button
Seat 2: benben288 ($6.26 in chips) 
Seat 3: NoMMoney ($10.34 in chips) 
Seat 4: Veinar Dina ($10 in chips) 
Seat 5: vanapaguss ($13.56 in chips) 
Seat 6: Marauder777 ($10.15 in chips) 
vanapaguss: posts small blind $0.05
Marauder777: posts big blind $0.10
*** HOLE CARDS ***
benben288: folds 
NoMMoney: calls $0.10
Veinar Dina: folds 
vanapaguss: folds 
Marauder777: checks 
*** FLOP *** [9d 6c 2d]
Marauder777: checks 
NoMMoney: checks 
*** TURN *** [9d 6c 2d] [4c]
Marauder777: bets $0.10
NoMMoney: raises $0.20 to $0.30
Marauder777: folds 
Uncalled bet ($0.20) returned to NoMMoney
NoMMoney collected $0.43 from pot
NoMMoney: doesn't show hand 
*** SUMMARY ***
Total pot $0.45 | Rake $0.02 
Board [9d 6c 2d 4c]
Seat 2: benben288 folded before Flop (didn't bet)
Seat 3: NoMMoney collected ($0.43)
Seat 4: Veinar Dina (button) folded before Flop (didn't bet)
Seat 5: vanapaguss (small blind) folded before Flop
Seat 6: Marauder777 (big blind) folded on the Turn



PokerStars Hand #222983213023:  Hold'em No Limit ($0.05/$0.10 USD) - 2021/01/23 21:34:20 ET
Table 'Stephano III' 6-max Seat #5 is the button
Seat 2: benben288 ($6.26 in chips) 
Seat 3: NoMMoney ($10.57 in chips) 
Seat 4: Veinar Dina ($10 in chips) 
Seat 5: vanapaguss ($13.51 in chips) 
Seat 6: Marauder777 ($10 in chips) 
Marauder777: posts small blind $0.05
benben288: posts big blind $0.10
*** HOLE CARDS ***
NoMMoney: calls $0.10
Veinar Dina: folds 
vanapaguss: raises $0.30 to $0.40
Marauder777: folds 
benben288: folds 
NoMMoney: folds 
Uncalled bet ($0.30) returned to vanapaguss
vanapaguss collected $0.35 from pot
vanapaguss: doesn't show hand 
*** SUMMARY ***
Total pot $0.35 | Rake $0 
Seat 2: benben288 (big blind) folded before Flop
Seat 3: NoMMoney folded before Flop
Seat 4: Veinar Dina folded before Flop (didn't bet)
Seat 5: vanapaguss (button) collected ($0.35)
Seat 6: Marauder777 (small blind) folded before Flop



PokerStars Hand #222983218769:  Hold'em No Limit ($0.05/$0.10 USD) - 2021/01/23 21:34:35 ET
Table 'Stephano III' 6-max Seat #6 is the button
Seat 2: benben288 ($6.16 in chips) 
Seat 3: NoMMoney ($10.47 in chips) 
Seat 4: Veinar Dina ($10 in chips) 
Seat 5: vanapaguss ($13.76 in chips) 
Seat 6: Marauder777 ($10 in chips) 
benben288: posts small blind $0.05
NoMMoney: posts big blind $0.10
*** HOLE CARDS ***
Veinar Dina: folds 
vanapaguss: folds 
Marauder777: folds 
benben288: calls $0.05
NoMMoney: raises $0.20 to $0.30
benben288: calls $0.20
*** FLOP *** [Tc 5s 2c]
benben288: checks 
NoMMoney: bets $0.40
benben288: calls $0.40
*** TURN *** [Tc 5s 2c] [2s]
benben288: checks 
NoMMoney: checks 
*** RIVER *** [Tc 5s 2c 2s] [6s]
benben288: checks 
NoMMoney: bets $1.34
benben288: calls $1.34
*** SHOW DOWN ***
NoMMoney: shows [6d 6h] (a full house, Sixes full of Deuces)
benben288: mucks hand 
NoMMoney collected $3.90 from pot
*** SUMMARY ***
Total pot $4.08 | Rake $0.18 
Board [Tc 5s 2c 2s 6s]
Seat 2: benben288 (small blind) mucked
Seat 3: NoMMoney (big blind) showed [6d 6h] and won ($3.90) with a full house, Sixes full of Deuces
Seat 4: Veinar Dina folded before Flop (didn't bet)
Seat 5: vanapaguss folded before Flop (didn't bet)
Seat 6: Marauder777 (button) folded before Flop (didn't bet)



PokerStars Hand #222983238210:  Hold'em No Limit ($0.05/$0.10 USD) - 2021/01/23 21:35:24 ET
Table 'Stephano III' 6-max Seat #2 is the button
Seat 2: benben288 ($4.12 in chips) 
Seat 3: NoMMoney ($12.33 in chips) 
Seat 4: Veinar Dina ($10 in chips) 
Seat 5: vanapaguss ($13.76 in chips) 
Seat 6: Marauder777 ($10 in chips) 
NoMMoney: posts small blind $0.05
Veinar Dina: posts big blind $0.10
*** HOLE CARDS ***
vanapaguss: raises $0.15 to $0.25
Marauder777: folds 
benben288: folds 
NoMMoney: folds 
Veinar Dina: folds 
Uncalled bet ($0.15) returned to vanapaguss
vanapaguss collected $0.25 from pot
vanapaguss: doesn't show hand 
*** SUMMARY ***
Total pot $0.25 | Rake $0 
Seat 2: benben288 (button) folded before Flop (didn't bet)
Seat 3: NoMMoney (small blind) folded before Flop
Seat 4: Veinar Dina (big blind) folded before Flop
Seat 5: vanapaguss collected ($0.25)
Seat 6: Marauder777 folded before Flop (didn't bet)



PokerStars Hand #222983245464:  Hold'em No Limit ($0.05/$0.10 USD) - 2021/01/23 21:35:42 ET
Table 'Stephano III' 6-max Seat #3 is the button
Seat 2: benben288 ($4.12 in chips) 
Seat 3: NoMMoney ($12.28 in chips) 
Seat 4: Veinar Dina ($10 in chips) 
Seat 5: vanapaguss ($13.91 in chips) 
Seat 6: Marauder777 ($10 in chips) 
Veinar Dina: posts small blind $0.05
vanapaguss: posts big blind $0.10
*** HOLE CARDS ***
Marauder777: raises $0.12 to $0.22
benben288: folds 
NoMMoney: folds 
Veinar Dina: folds 
vanapaguss: calls $0.12
*** FLOP *** [Ac 7d 8h]
vanapaguss: checks 
Marauder777: bets $0.16
vanapaguss: folds 
Uncalled bet ($0.16) returned to Marauder777
Marauder777 collected $0.47 from pot
Marauder777: doesn't show hand 
*** SUMMARY ***
Total pot $0.49 | Rake $0.02 
Board [Ac 7d 8h]
Seat 2: benben288 folded before Flop (didn't bet)
Seat 3: NoMMoney (button) folded before Flop (didn't bet)
Seat 4: Veinar Dina (small blind) folded before Flop
Seat 5: vanapaguss (big blind) folded on the Flop
Seat 6: Marauder777 collected ($0.47)



PokerStars Hand #222983260253:  Hold'em No Limit ($0.05/$0.10 USD) - 2021/01/23 21:36:19 ET
Table 'Stephano III' 6-max Seat #4 is the button
Seat 2: benben288 ($4.12 in chips) 
Seat 3: NoMMoney ($12.28 in chips) 
Seat 4: Veinar Dina ($10 in chips) 
Seat 5: vanapaguss ($13.69 in chips) 
Seat 6: Marauder777 ($10.25 in chips) 
vanapaguss: posts small blind $0.05
Marauder777: posts big blind $0.10
*** HOLE CARDS ***
benben288: folds 
NoMMoney: raises $0.10 to $0.20
Veinar Dina: folds 
vanapaguss: folds 
Marauder777: calls $0.10
*** FLOP *** [9c 5h Jc]
Marauder777: checks 
NoMMoney: checks 
*** TURN *** [9c 5h Jc] [8h]
Marauder777: checks 
NoMMoney: bets $0.20
Marauder777: raises $0.64 to $0.84
NoMMoney: calls $0.64
*** RIVER *** [9c 5h Jc 8h] [9s]
Marauder777: bets $0.75
NoMMoney: folds 
Uncalled bet ($0.75) returned to Marauder777
Marauder777 collected $2.03 from pot
Marauder777: doesn't show hand 
*** SUMMARY ***
Total pot $2.13 | Rake $0.10 
Board [9c 5h Jc 8h 9s]
Seat 2: benben288 folded before Flop (didn't bet)
Seat 3: NoMMoney folded on the River
Seat 4: Veinar Dina (button) folded before Flop (didn't bet)
Seat 5: vanapaguss (small blind) folded before Flop
Seat 6: Marauder777 (big blind) collected ($2.03)



PokerStars Hand #222983283787:  Hold'em No Limit ($0.05/$0.10 USD) - 2021/01/23 21:37:18 ET
Table 'Stephano III' 6-max Seat #5 is the button
Seat 2: benben288 ($4.12 in chips) 
Seat 3: NoMMoney ($11.24 in chips) 
Seat 4: Veinar Dina ($10 in chips) 
Seat 5: vanapaguss ($13.64 in chips) 
Seat 6: Marauder777 ($11.24 in chips) 
Marauder777: posts small blind $0.05
benben288: posts big blind $0.10
*** HOLE CARDS ***
NoMMoney: raises $0.10 to $0.20
Veinar Dina: folds 
vanapaguss: folds 
Marauder777: calls $0.15
benben288: folds 
*** FLOP *** [4d Td 2c]
Marauder777: checks 
NoMMoney: checks 
*** TURN *** [4d Td 2c] [6s]
Marauder777: checks 
NoMMoney: checks 
*** RIVER *** [4d Td 2c 6s] [5s]
Marauder777: checks 
NoMMoney: bets $0.30
Marauder777: folds 
Uncalled bet ($0.30) returned to NoMMoney
NoMMoney collected $0.48 from pot
NoMMoney: doesn't show hand 
*** SUMMARY ***
Total pot $0.50 | Rake $0.02 
Board [4d Td 2c 6s 5s]
Seat 2: benben288 (big blind) folded before Flop
Seat 3: NoMMoney collected ($0.48)
Seat 4: Veinar Dina folded before Flop (didn't bet)
Seat 5: vanapaguss (button) folded before Flop (didn't bet)
Seat 6: Marauder777 (small blind) folded on the River



PokerStars Hand #222983300764:  Hold'em No Limit ($0.05/$0.10 USD) - 2021/01/23 21:37:53 ET
Table 'Stephano III' 6-max Seat #6 is the button
Seat 2: benben288 ($4.02 in chips) 
Seat 3: NoMMoney ($11.52 in chips) 
Seat 4: Veinar Dina ($10 in chips) 
Seat 5: vanapaguss ($13.64 in chips) 
Seat 6: Marauder777 ($11.04 in chips) 
benben288: posts small blind $0.05
NoMMoney: posts big blind $0.10
*** HOLE CARDS ***
Veinar Dina: folds 
vanapaguss: folds 
Marauder777: raises $0.12 to $0.22
benben288: folds 
NoMMoney: calls $0.12
*** FLOP *** [6s 9c 7s]
NoMMoney: checks 
Marauder777: bets $0.16
NoMMoney: calls $0.16
*** TURN *** [6s 9c 7s] [7c]
NoMMoney: checks 
Marauder777: bets $0.59
NoMMoney: calls $0.59
*** RIVER *** [6s 9c 7s 7c] [9d]
NoMMoney: checks 
Marauder777: checks 
*** SHOW DOWN ***
NoMMoney: shows [4s 5d] (two pair, Nines and Sevens)
Marauder777: shows [Td 8c] (a straight, Six to Ten)
Marauder777 collected $1.90 from pot
*** SUMMARY ***
Total pot $1.99 | Rake $0.09 
Board [6s 9c 7s 7c 9d]
Seat 2: benben288 (small blind) folded before Flop
Seat 3: NoMMoney (big blind) showed [4s 5d] and lost with two pair, Nines and Sevens
Seat 4: Veinar Dina folded before Flop (didn't bet)
Seat 5: vanapaguss folded before Flop (didn't bet)
Seat 6: Marauder777 (button) showed [Td 8c] and won ($1.90) with a straight, Six to Ten



PokerStars Hand #222983319337:  Hold'em No Limit ($0.05/$0.10 USD) - 2021/01/23 21:38:41 ET
Table 'Stephano III' 6-max Seat #2 is the button
Seat 2: benben288 ($3.97 in chips) 
Seat 3: NoMMoney ($10.55 in chips) 
Seat 4: Veinar Dina ($10 in chips) 
Seat 5: vanapaguss ($13.64 in chips) 
Seat 6: Marauder777 ($11.97 in chips) 
NoMMoney: posts small blind $0.05
Veinar Dina: posts big blind $0.10
*** HOLE CARDS ***
vanapaguss: folds 
Marauder777: folds 
benben288: folds 
NoMMoney: calls $0.05
Veinar Dina: checks 
*** FLOP *** [5c Ks 5d]
NoMMoney: checks 
Veinar Dina: checks 
*** TURN *** [5c Ks 5d] [Ac]
NoMMoney: checks 
Veinar Dina: checks 
*** RIVER *** [5c Ks 5d Ac] [Td]
NoMMoney: checks 
Veinar Dina: checks 
*** SHOW DOWN ***
NoMMoney: shows [4s Jd] (a pair of Fives)
Veinar Dina: mucks hand 
NoMMoney collected $0.19 from pot
*** SUMMARY ***
Total pot $0.20 | Rake $0.01 
Board [5c Ks 5d Ac Td]
Seat 2: benben288 (button) folded before Flop (didn't bet)
Seat 3: NoMMoney (small blind) showed [4s Jd] and won ($0.19) with a pair of Fives
Seat 4: Veinar Dina (big blind) mucked
Seat 5: vanapaguss folded before Flop (didn't bet)
Seat 6: Marauder777 folded before Flop (didn't bet)



PokerStars Hand #222983330916:  Hold'em No Limit ($0.05/$0.10 USD) - 2021/01/23 21:39:10 ET
Table 'Stephano III' 6-max Seat #3 is the button
Seat 2: benben288 ($3.97 in chips) 
Seat 3: NoMMoney ($10.64 in chips) 
Seat 4: Veinar Dina ($10 in chips) 
Seat 5: vanapaguss ($13.64 in chips) 
Seat 6: Marauder777 ($11.97 in chips) 
Veinar Dina: posts small blind $0.05
vanapaguss: posts big blind $0.10
*** HOLE CARDS ***
Marauder777: raises $0.12 to $0.22
benben288: folds 
NoMMoney: folds 
Veinar Dina: calls $0.17
vanapaguss: folds 
*** FLOP *** [Th Jh 8c]
Veinar Dina: checks 
Marauder777: checks 
*** TURN *** [Th Jh 8c] [9h]
Veinar Dina: bets $0.39
Marauder777: calls $0.39
*** RIVER *** [Th Jh 8c 9h] [8d]
Veinar Dina: checks 
Marauder777: checks 
*** SHOW DOWN ***
Veinar Dina: shows [Ah Ts] (two pair, Tens and Eights)
Marauder777: mucks hand 
Veinar Dina collected $1.26 from pot
*** SUMMARY ***
Total pot $1.32 | Rake $0.06 
Board [Th Jh 8c 9h 8d]
Seat 2: benben288 folded before Flop (didn't bet)
Seat 3: NoMMoney (button) folded before Flop (didn't bet)
Seat 4: Veinar Dina (small blind) showed [Ah Ts] and won ($1.26) with two pair, Tens and Eights
Seat 5: vanapaguss (big blind) folded before Flop
Seat 6: Marauder777 mucked



PokerStars Hand #222984071558:  Hold'em No Limit ($0.05/$0.10 USD) - 2021/01/23 22:12:10 ET
Table 'Stephano III' 6-max Seat #2 is the button
Seat 1: mazzyb123 ($4.08 in chips) 
Seat 2: Tyche3814 ($4.27 in chips) 
Seat 3: edumstrf ($10.08 in chips) 
Seat 4: starii13 ($10 in chips) 
Seat 5: vanapaguss ($21.51 in chips) 
Seat 6: TSA958 ($10 in chips) 
edumstrf: posts small blind $0.05
starii13: posts big blind $0.10
*** HOLE CARDS ***
vanapaguss: folds 
TSA958: folds 
mazzyb123: folds 
Tyche3814: raises $0.10 to $0.20
edumstrf: folds 
starii13: calls $0.10
*** FLOP *** [Ts Js Ad]
starii13: checks 
Tyche3814: bets $0.30
starii13: calls $0.30
*** TURN *** [Ts Js Ad] [9d]
starii13: checks 
Tyche3814: checks 
*** RIVER *** [Ts Js Ad 9d] [Qd]
starii13: checks 
Tyche3814: bets $0.30
starii13: calls $0.30
*** SHOW DOWN ***
Tyche3814: shows [8c 9s] (a straight, Eight to Queen)
starii13: mucks hand 
Tyche3814 collected $1.58 from pot
*** SUMMARY ***
Total pot $1.65 | Rake $0.07 
Board [Ts Js Ad 9d Qd]
Seat 1: mazzyb123 folded before Flop (didn't bet)
Seat 2: Tyche3814 (button) showed [8c 9s] and won ($1.58) with a straight, Eight to Queen
Seat 3: edumstrf (small blind) folded before Flop
Seat 4: starii13 (big blind) mucked
Seat 5: vanapaguss folded before Flop (didn't bet)
Seat 6: TSA958 folded before Flop (didn't bet)



PokerStars Hand #222984097583:  Hold'em No Limit ($0.05/$0.10 USD) - 2021/01/23 22:13:21 ET
Table 'Stephano III' 6-max Seat #3 is the button
Seat 1: mazzyb123 ($4.08 in chips) 
Seat 2: Tyche3814 ($5.05 in chips) 
Seat 3: edumstrf ($10.03 in chips) 
Seat 4: starii13 ($10 in chips) 
Seat 5: vanapaguss ($21.51 in chips) 
Seat 6: TSA958 ($10 in chips) 
starii13: posts small blind $0.05
vanapaguss: posts big blind $0.10
*** HOLE CARDS ***
TSA958: folds 
mazzyb123: folds 
Tyche3814: folds 
edumstrf: calls $0.10
starii13: folds 
TSA958 leaves the table
vanapaguss: checks 
*** FLOP *** [5s Js 3c]
vanapaguss: checks 
edumstrf: bets $0.24
vanapaguss: folds 
Uncalled bet ($0.24) returned to edumstrf
edumstrf collected $0.24 from pot
edumstrf: doesn't show hand 
*** SUMMARY ***
Total pot $0.25 | Rake $0.01 
Board [5s Js 3c]
Seat 1: mazzyb123 folded before Flop (didn't bet)
Seat 2: Tyche3814 folded before Flop (didn't bet)
Seat 3: edumstrf (button) collected ($0.24)
Seat 4: starii13 (small blind) folded before Flop
Seat 5: vanapaguss (big blind) folded on the Flop
Seat 6: TSA958 folded before Flop (didn't bet)



PokerStars Hand #222984114914:  Hold'em No Limit ($0.05/$0.10 USD) - 2021/01/23 22:13:44 ET
Table 'Stephano III' 6-max Seat #4 is the button
Seat 1: mazzyb123 ($4.08 in chips) 
Seat 2: Tyche3814 ($5.05 in chips) 
Seat 3: edumstrf ($10.17 in chips) 
Seat 4: starii13 ($10 in chips) 
Seat 5: vanapaguss ($21.41 in chips) 
vanapaguss: posts small blind $0.05
mazzyb123: posts big blind $0.10
*** HOLE CARDS ***
Tyche3814: folds 
edumstrf: folds 
TSA958 joins the table at seat #6 
starii13: raises $0.20 to $0.30
vanapaguss: raises $0.80 to $1.10
mazzyb123: folds 
starii13: folds 
Uncalled bet ($0.80) returned to vanapaguss
vanapaguss collected $0.70 from pot
vanapaguss: doesn't show hand 
*** SUMMARY ***
Total pot $0.70 | Rake $0 
Seat 1: mazzyb123 (big blind) folded before Flop
Seat 2: Tyche3814 folded before Flop (didn't bet)
Seat 3: edumstrf folded before Flop (didn't bet)
Seat 4: starii13 (button) folded before Flop
Seat 5: vanapaguss (small blind) collected ($0.70)



PokerStars Hand #222984122512:  Hold'em No Limit ($0.05/$0.10 USD) - 2021/01/23 22:14:05 ET
Table 'Stephano III' 6-max Seat #5 is the button
Seat 1: mazzyb123 ($3.98 in chips) 
Seat 2: Tyche3814 ($5.05 in chips) 
Seat 3: edumstrf ($10.17 in chips) 
Seat 4: starii13 ($10 in chips) 
Seat 5: vanapaguss ($21.81 in chips) 
mazzyb123: posts small blind $0.05
Tyche3814: posts big blind $0.10
*** HOLE CARDS ***
edumstrf: folds 
starii13: folds 
vanapaguss: folds 
mazzyb123: folds 
Uncalled bet ($0.05) returned to Tyche3814
Tyche3814 collected $0.10 from pot
*** SUMMARY ***
Total pot $0.10 | Rake $0 
Seat 1: mazzyb123 (small blind) folded before Flop
Seat 2: Tyche3814 (big blind) collected ($0.10)
Seat 3: edumstrf folded before Flop (didn't bet)
Seat 4: starii13 folded before Flop (didn't bet)
Seat 5: vanapaguss (button) folded before Flop (didn't bet)



PokerStars Hand #222984127698:  Hold'em No Limit ($0.05/$0.10 USD) - 2021/01/23 22:14:19 ET
Table 'Stephano III' 6-max Seat #1 is the button
Seat 1: mazzyb123 ($3.93 in chips) 
Seat 2: Tyche3814 ($5.10 in chips) 
Seat 3: edumstrf ($10.17 in chips) 
Seat 4: starii13 ($10 in chips) 
Seat 5: vanapaguss ($21.81 in chips) 
Tyche3814: posts small blind $0.05
edumstrf: posts big blind $0.10
TSA958: sits out 
*** HOLE CARDS ***
starii13: folds 
vanapaguss: raises $0.15 to $0.25
starii13 leaves the table
mazzyb123: folds 
Tyche3814: folds 
edumstrf: folds 
Uncalled bet ($0.15) returned to vanapaguss
vanapaguss collected $0.25 from pot
vanapaguss: doesn't show hand 
*** SUMMARY ***
Total pot $0.25 | Rake $0 
Seat 1: mazzyb123 (button) folded before Flop (didn't bet)
Seat 2: Tyche3814 (small blind) folded before Flop
Seat 3: edumstrf (big blind) folded before Flop
Seat 4: starii13 folded before Flop (didn't bet)
Seat 5: vanapaguss collected ($0.25)



PokerStars Hand #222984134020:  Hold'em No Limit ($0.05/$0.10 USD) - 2021/01/23 22:14:37 ET
Table 'Stephano III' 6-max Seat #2 is the button
Seat 1: mazzyb123 ($3.93 in chips) 
Seat 2: Tyche3814 ($5.05 in chips) 
Seat 3: edumstrf ($10.07 in chips) 
Seat 5: vanapaguss ($21.96 in chips) 
edumstrf: posts small blind $0.05
vanapaguss: posts big blind $0.10
TSA958: sits out 
*** HOLE CARDS ***
mazzyb123: calls $0.10
Tyche3814: folds 
edumstrf: raises $0.10 to $0.20
vanapaguss: folds 
mazzyb123: calls $0.10
*** FLOP *** [Jc 5h 8h]
edumstrf: bets $0.48
Pablo7-Pro joins the table at seat #4 
mazzyb123: raises $0.62 to $1.10
edumstrf: raises $8.77 to $9.87 and is all-in
mazzyb123: calls $2.63 and is all-in
Uncalled bet ($6.14) returned to edumstrf
*** TURN *** [Jc 5h 8h] [2s]
*** RIVER *** [Jc 5h 8h 2s] [Kc]
*** SHOW DOWN ***
edumstrf: shows [Js Kh] (two pair, Kings and Jacks)
mazzyb123: shows [As Ad] (a pair of Aces)
edumstrf collected $7.60 from pot
*** SUMMARY ***
Total pot $7.96 | Rake $0.36 
Board [Jc 5h 8h 2s Kc]
Seat 1: mazzyb123 showed [As Ad] and lost with a pair of Aces
Seat 2: Tyche3814 (button) folded before Flop (didn't bet)
Seat 3: edumstrf (small blind) showed [Js Kh] and won ($7.60) with two pair, Kings and Jacks
Seat 5: vanapaguss (big blind) folded before Flop



PokerStars Hand #222984153408:  Hold'em No Limit ($0.05/$0.10 USD) - 2021/01/23 22:15:30 ET
Table 'Stephano III' 6-max Seat #3 is the button
Seat 2: Tyche3814 ($5.05 in chips) 
Seat 3: edumstrf ($13.74 in chips) 
Seat 5: vanapaguss ($21.86 in chips) 
Seat 6: TSA958 ($10 in chips) 
vanapaguss: posts small blind $0.05
TSA958: posts big blind $0.10
*** HOLE CARDS ***
Tyche3814: folds 
edumstrf: folds 
vanapaguss: raises $0.20 to $0.30
TSA958: calls $0.20
*** FLOP *** [Kh 5h Jh]
vanapaguss: checks 
TSA958: checks 
*** TURN *** [Kh 5h Jh] [7d]
vanapaguss: bets $0.20
TSA958: folds 
Uncalled bet ($0.20) returned to vanapaguss
vanapaguss collected $0.57 from pot
vanapaguss: doesn't show hand 
*** SUMMARY ***
Total pot $0.60 | Rake $0.03 
Board [Kh 5h Jh 7d]
Seat 2: Tyche3814 folded before Flop (didn't bet)
Seat 3: edumstrf (button) folded before Flop (didn't bet)
Seat 5: vanapaguss (small blind) collected ($0.57)
Seat 6: TSA958 (big blind) folded on the Turn



PokerStars Hand #222984163142:  Hold'em No Limit ($0.05/$0.10 USD) - 2021/01/23 22:15:57 ET
Table 'Stephano III' 6-max Seat #5 is the button
Seat 2: Tyche3814 ($5.05 in chips) 
Seat 3: edumstrf ($13.74 in chips) 
Seat 5: vanapaguss ($22.13 in chips) 
Seat 6: TSA958 ($10 in chips) 
TSA958: posts small blind $0.05
Tyche3814: posts big blind $0.10
Pablo7-Pro: sits out 
*** HOLE CARDS ***
edumstrf: folds 
vanapaguss: folds 
TSA958: folds 
Uncalled bet ($0.05) returned to Tyche3814
Tyche3814 collected $0.10 from pot
*** SUMMARY ***
Total pot $0.10 | Rake $0 
Seat 2: Tyche3814 (big blind) collected ($0.10)
Seat 3: edumstrf folded before Flop (didn't bet)
Seat 5: vanapaguss (button) folded before Flop (didn't bet)
Seat 6: TSA958 (small blind) folded before Flop



PokerStars Hand #222984168372:  Hold'em No Limit ($0.05/$0.10 USD) - 2021/01/23 22:16:11 ET
Table 'Stephano III' 6-max Seat #6 is the button
Seat 2: Tyche3814 ($5.10 in chips) 
Seat 3: edumstrf ($13.74 in chips) 
Seat 5: vanapaguss ($22.13 in chips) 
Seat 6: TSA958 ($10 in chips) 
Tyche3814: posts small blind $0.05
edumstrf: posts big blind $0.10
Pablo7-Pro: sits out 
*** HOLE CARDS ***
vanapaguss: folds 
TSA958: folds 
Tyche3814: calls $0.05
edumstrf: checks 
*** FLOP *** [9h 4c Kc]
Tyche3814: checks 
edumstrf: bets $0.10
Tyche3814: folds 
Uncalled bet ($0.10) returned to edumstrf
edumstrf collected $0.19 from pot
edumstrf: doesn't show hand 
*** SUMMARY ***
Total pot $0.20 | Rake $0.01 
Board [9h 4c Kc]
Seat 2: Tyche3814 (small blind) folded on the Flop
Seat 3: edumstrf (big blind) collected ($0.19)
Seat 5: vanapaguss folded before Flop (didn't bet)
Seat 6: TSA958 (button) folded before Flop (didn't bet)



PokerStars Hand #222984175064:  Hold'em No Limit ($0.05/$0.10 USD) - 2021/01/23 22:16:30 ET
Table 'Stephano III' 6-max Seat #2 is the button
Seat 2: Tyche3814 ($5 in chips) 
Seat 3: edumstrf ($13.83 in chips) 
Seat 4: Pablo7-Pro ($10 in chips) 
Seat 5: vanapaguss ($22.13 in chips) 
Seat 6: TSA958 ($10 in chips) 
edumstrf: posts small blind $0.05
Pablo7-Pro: posts big blind $0.10
*** HOLE CARDS ***
vanapaguss: folds 
TSA958: folds 
Tyche3814: calls $0.10
edumstrf: calls $0.05
Pablo7-Pro: checks 
*** FLOP *** [5s Ts Th]
edumstrf: bets $0.29
Pablo7-Pro: calls $0.29
Tyche3814: calls $0.29
*** TURN *** [5s Ts Th] [8d]
edumstrf: bets $0.56
Pablo7-Pro: folds 
Tyche3814: calls $0.56
*** RIVER *** [5s Ts Th 8d] [4c]
edumstrf: bets $2.19
Tyche3814: raises $1.86 to $4.05 and is all-in
edumstrf: folds 
Uncalled bet ($1.86) returned to Tyche3814
Tyche3814 collected $6.37 from pot
*** SUMMARY ***
Total pot $6.67 | Rake $0.30 
Board [5s Ts Th 8d 4c]
Seat 2: Tyche3814 (button) collected ($6.37)
Seat 3: edumstrf (small blind) folded on the River
Seat 4: Pablo7-Pro (big blind) folded on the Turn
Seat 5: vanapaguss folded before Flop (didn't bet)
Seat 6: TSA958 folded before Flop (didn't bet)



PokerStars Hand #222984198847:  Hold'em No Limit ($0.05/$0.10 USD) - 2021/01/23 22:17:36 ET
Table 'Stephano III' 6-max Seat #3 is the button
Seat 2: Tyche3814 ($8.23 in chips) 
Seat 3: edumstrf ($10.69 in chips) 
Seat 4: Pablo7-Pro ($10 in chips) 
Seat 5: vanapaguss ($22.13 in chips) 
Seat 6: TSA958 ($10 in chips) 
Pablo7-Pro: posts small blind $0.05
vanapaguss: posts big blind $0.10
mazzyb123: sits out 
*** HOLE CARDS ***
TSA958: raises $0.25 to $0.35
Tyche3814: folds 
edumstrf: calls $0.35
Pablo7-Pro: folds 
vanapaguss: folds 
*** FLOP *** [5s 6h 7h]
TSA958: bets $0.60
edumstrf: calls $0.60
*** TURN *** [5s 6h 7h] [4s]
TSA958: bets $1
edumstrf: calls $1
*** RIVER *** [5s 6h 7h 4s] [3s]
TSA958: checks 
edumstrf: bets $8.74 and is all-in
TSA958: calls $8.05 and is all-in
Uncalled bet ($0.69) returned to edumstrf
*** SHOW DOWN ***
edumstrf: shows [8d 8h] (a straight, Four to Eight)
TSA958: shows [9c 9s] (a straight, Three to Seven)
edumstrf collected $19.24 from pot
*** SUMMARY ***
Total pot $20.15 | Rake $0.91 
Board [5s 6h 7h 4s 3s]
Seat 2: Tyche3814 folded before Flop (didn't bet)
Seat 3: edumstrf (button) showed [8d 8h] and won ($19.24) with a straight, Four to Eight
Seat 4: Pablo7-Pro (small blind) folded before Flop
Seat 5: vanapaguss (big blind) folded before Flop
Seat 6: TSA958 showed [9c 9s] and lost with a straight, Three to Seven



PokerStars Hand #222984216318:  Hold'em No Limit ($0.05/$0.10 USD) - 2021/01/23 22:18:24 ET
Table 'Stephano III' 6-max Seat #4 is the button
Seat 2: Tyche3814 ($8.23 in chips) 
Seat 3: edumstrf ($19.93 in chips) 
Seat 4: Pablo7-Pro ($10 in chips) 
Seat 5: vanapaguss ($22.03 in chips) 
Seat 6: TSA958 ($10 in chips) 
vanapaguss: posts small blind $0.05
TSA958: posts big blind $0.10
mazzyb123: sits out 
*** HOLE CARDS ***
Tyche3814: folds 
edumstrf: folds 
Pablo7-Pro: raises $0.10 to $0.20
vanapaguss: folds 
TSA958: folds 
Uncalled bet ($0.10) returned to Pablo7-Pro
Pablo7-Pro collected $0.25 from pot
Pablo7-Pro: doesn't show hand 
*** SUMMARY ***
Total pot $0.25 | Rake $0 
Seat 2: Tyche3814 folded before Flop (didn't bet)
Seat 3: edumstrf folded before Flop (didn't bet)
Seat 4: Pablo7-Pro (button) collected ($0.25)
Seat 5: vanapaguss (small blind) folded before Flop
Seat 6: TSA958 (big blind) folded before Flop



PokerStars Hand #222984223541:  Hold'em No Limit ($0.05/$0.10 USD) - 2021/01/23 22:18:44 ET
Table 'Stephano III' 6-max Seat #5 is the button
Seat 1: mazzyb123 ($6.80 in chips) 
Seat 2: Tyche3814 ($8.23 in chips) 
Seat 3: edumstrf ($19.93 in chips) 
Seat 4: Pablo7-Pro ($10.15 in chips) 
Seat 5: vanapaguss ($21.98 in chips) 
Seat 6: TSA958 ($10 in chips) 
TSA958: posts small blind $0.05
mazzyb123: posts big blind $0.10
*** HOLE CARDS ***
Tyche3814: raises $0.10 to $0.20
edumstrf: folds 
Pablo7-Pro: folds 
vanapaguss: folds 
TSA958: folds 
edumstrf leaves the table
mazzyb123: folds 
Uncalled bet ($0.10) returned to Tyche3814
Tyche3814 collected $0.25 from pot
*** SUMMARY ***
Total pot $0.25 | Rake $0 
Seat 1: mazzyb123 (big blind) folded before Flop
Seat 2: Tyche3814 collected ($0.25)
Seat 3: edumstrf folded before Flop (didn't bet)
Seat 4: Pablo7-Pro folded before Flop (didn't bet)
Seat 5: vanapaguss (button) folded before Flop (didn't bet)
Seat 6: TSA958 (small blind) folded before Flop



PokerStars Hand #222984228468:  Hold'em No Limit ($0.05/$0.10 USD) - 2021/01/23 22:18:58 ET
Table 'Stephano III' 6-max Seat #6 is the button
Seat 1: mazzyb123 ($6.70 in chips) 
Seat 2: Tyche3814 ($8.38 in chips) 
Seat 4: Pablo7-Pro ($10.15 in chips) 
Seat 5: vanapaguss ($21.98 in chips) 
Seat 6: TSA958 ($10 in chips) 
mazzyb123: posts small blind $0.05
Tyche3814: posts big blind $0.10
*** HOLE CARDS ***
Pablo7-Pro: folds 
vanapaguss: folds 
TSA958: folds 
mazzyb123: raises $0.10 to $0.20
Tyche3814: folds 
Uncalled bet ($0.10) returned to mazzyb123
mazzyb123 collected $0.20 from pot
mazzyb123: doesn't show hand 
*** SUMMARY ***
Total pot $0.20 | Rake $0 
Seat 1: mazzyb123 (small blind) collected ($0.20)
Seat 2: Tyche3814 (big blind) folded before Flop
Seat 4: Pablo7-Pro folded before Flop (didn't bet)
Seat 5: vanapaguss folded before Flop (didn't bet)
Seat 6: TSA958 (button) folded before Flop (didn't bet)



PokerStars Hand #222984231998:  Hold'em No Limit ($0.05/$0.10 USD) - 2021/01/23 22:19:08 ET
Table 'Stephano III' 6-max Seat #1 is the button
Seat 1: mazzyb123 ($6.80 in chips) 
Seat 2: Tyche3814 ($8.28 in chips) 
Seat 4: Pablo7-Pro ($10.15 in chips) 
Seat 5: vanapaguss ($21.98 in chips) 
Seat 6: TSA958 ($10 in chips) 
Tyche3814: posts small blind $0.05
Nealy_Godz joins the table at seat #3 
Pablo7-Pro: posts big blind $0.10
*** HOLE CARDS ***
vanapaguss: folds 
TSA958: raises $0.25 to $0.35
mazzyb123: folds 
Tyche3814: folds 
Pablo7-Pro: folds 
Uncalled bet ($0.25) returned to TSA958
TSA958 collected $0.25 from pot
TSA958: doesn't show hand 
*** SUMMARY ***
Total pot $0.25 | Rake $0 
Seat 1: mazzyb123 (button) folded before Flop (didn't bet)
Seat 2: Tyche3814 (small blind) folded before Flop
Seat 4: Pablo7-Pro (big blind) folded before Flop
Seat 5: vanapaguss folded before Flop (didn't bet)
Seat 6: TSA958 collected ($0.25)



PokerStars Hand #222984237290:  Hold'em No Limit ($0.05/$0.10 USD) - 2021/01/23 22:19:23 ET
Table 'Stephano III' 6-max Seat #2 is the button
Seat 1: mazzyb123 ($6.80 in chips) 
Seat 2: Tyche3814 ($8.23 in chips) 
Seat 4: Pablo7-Pro ($10.05 in chips) 
Seat 5: vanapaguss ($21.98 in chips) 
Seat 6: TSA958 ($10.15 in chips) 
Pablo7-Pro: posts small blind $0.05
vanapaguss: posts big blind $0.10
*** HOLE CARDS ***
TSA958: folds 
mazzyb123: raises $0.10 to $0.20
Tyche3814: folds 
Pablo7-Pro: folds 
vanapaguss: folds 
Uncalled bet ($0.10) returned to mazzyb123
mazzyb123 collected $0.25 from pot
mazzyb123: doesn't show hand 
*** SUMMARY ***
Total pot $0.25 | Rake $0 
Seat 1: mazzyb123 collected ($0.25)
Seat 2: Tyche3814 (button) folded before Flop (didn't bet)
Seat 4: Pablo7-Pro (small blind) folded before Flop
Seat 5: vanapaguss (big blind) folded before Flop
Seat 6: TSA958 folded before Flop (didn't bet)



PokerStars Hand #222984242613:  Hold'em No Limit ($0.05/$0.10 USD) - 2021/01/23 22:19:37 ET
Table 'Stephano III' 6-max Seat #4 is the button
Seat 1: mazzyb123 ($6.95 in chips) 
Seat 2: Tyche3814 ($8.23 in chips) 
Seat 4: Pablo7-Pro ($10 in chips) 
Seat 5: vanapaguss ($21.88 in chips) 
Seat 6: TSA958 ($10.15 in chips) 
vanapaguss: posts small blind $0.05
TSA958: posts big blind $0.10
Nealy_Godz: sits out 
*** HOLE CARDS ***
mazzyb123: folds 
Tyche3814: folds 
Pablo7-Pro: raises $0.10 to $0.20
vanapaguss: calls $0.15
TSA958: folds 
*** FLOP *** [Kh 9d Ad]
vanapaguss: checks 
Pablo7-Pro: checks 
*** TURN *** [Kh 9d Ad] [Ts]
vanapaguss: bets $0.33
Pablo7-Pro: calls $0.33
*** RIVER *** [Kh 9d Ad Ts] [6d]
vanapaguss: checks 
Pablo7-Pro: checks 
*** SHOW DOWN ***
vanapaguss: shows [As Th] (two pair, Aces and Tens)
Pablo7-Pro: mucks hand 
vanapaguss collected $1.11 from pot
*** SUMMARY ***
Total pot $1.16 | Rake $0.05 
Board [Kh 9d Ad Ts 6d]
Seat 1: mazzyb123 folded before Flop (didn't bet)
Seat 2: Tyche3814 folded before Flop (didn't bet)
Seat 4: Pablo7-Pro (button) mucked
Seat 5: vanapaguss (small blind) showed [As Th] and won ($1.11) with two pair, Aces and Tens
Seat 6: TSA958 (big blind) folded before Flop



PokerStars Hand #222984258387:  Hold'em No Limit ($0.05/$0.10 USD) - 2021/01/23 22:20:21 ET
Table 'Stephano III' 6-max Seat #5 is the button
Seat 1: mazzyb123 ($6.95 in chips) 
Seat 2: Tyche3814 ($8.23 in chips) 
Seat 4: Pablo7-Pro ($10 in chips) 
Seat 5: vanapaguss ($22.46 in chips) 
Seat 6: TSA958 ($10.05 in chips) 
TSA958: posts small blind $0.05
mazzyb123: posts big blind $0.10
Nealy_Godz: sits out 
*** HOLE CARDS ***
Tyche3814: raises $0.10 to $0.20
Pablo7-Pro: folds 
vanapaguss: calls $0.20
TSA958: folds 
mazzyb123: calls $0.10
*** FLOP *** [Td Ts 8c]
mazzyb123: checks 
Tyche3814: checks 
vanapaguss: bets $0.22
mazzyb123: folds 
Tyche3814: folds 
Uncalled bet ($0.22) returned to vanapaguss
vanapaguss collected $0.62 from pot
vanapaguss: doesn't show hand 
*** SUMMARY ***
Total pot $0.65 | Rake $0.03 
Board [Td Ts 8c]
Seat 1: mazzyb123 (big blind) folded on the Flop
Seat 2: Tyche3814 folded on the Flop
Seat 4: Pablo7-Pro folded before Flop (didn't bet)
Seat 5: vanapaguss (button) collected ($0.62)
Seat 6: TSA958 (small blind) folded before Flop



PokerStars Hand #222984268507:  Hold'em No Limit ($0.05/$0.10 USD) - 2021/01/23 22:20:49 ET
Table 'Stephano III' 6-max Seat #6 is the button
Seat 1: mazzyb123 ($6.75 in chips) 
Seat 2: Tyche3814 ($8.03 in chips) 
Seat 4: Pablo7-Pro ($10 in chips) 
Seat 5: vanapaguss ($22.88 in chips) 
Seat 6: TSA958 ($10 in chips) 
mazzyb123: posts small blind $0.05
Tyche3814: posts big blind $0.10
Nealy_Godz: sits out 
*** HOLE CARDS ***
Pablo7-Pro: folds 
vanapaguss: folds 
TSA958: raises $0.20 to $0.30
mazzyb123: calls $0.25
Tyche3814: calls $0.20
*** FLOP *** [6c 4c Qd]
mazzyb123: checks 
Tyche3814: checks 
TSA958: bets $0.60
mazzyb123: calls $0.60
Tyche3814: folds 
*** TURN *** [6c 4c Qd] [7d]
mazzyb123: bets $1.01
TSA958: calls $1.01
*** RIVER *** [6c 4c Qd 7d] [5h]
mazzyb123: bets $1.97
TSA958: raises $2.53 to $4.50
mazzyb123: calls $2.53
*** SHOW DOWN ***
TSA958: shows [8c Ac] (a straight, Four to Eight)
mazzyb123: mucks hand 
TSA958 collected $12.53 from pot
*** SUMMARY ***
Total pot $13.12 | Rake $0.59 
Board [6c 4c Qd 7d 5h]
Seat 1: mazzyb123 (small blind) mucked
Seat 2: Tyche3814 (big blind) folded on the Flop
Seat 4: Pablo7-Pro folded before Flop (didn't bet)
Seat 5: vanapaguss folded before Flop (didn't bet)
Seat 6: TSA958 (button) showed [8c Ac] and won ($12.53) with a straight, Four to Eight



PokerStars Hand #222984289760:  Hold'em No Limit ($0.05/$0.10 USD) - 2021/01/23 22:21:48 ET
Table 'Stephano III' 6-max Seat #1 is the button
Seat 1: mazzyb123 ($0.34 in chips) 
Seat 2: Tyche3814 ($7.73 in chips) 
Seat 3: Nealy_Godz ($10 in chips) 
Seat 4: Pablo7-Pro ($10 in chips) 
Seat 5: vanapaguss ($22.88 in chips) 
Seat 6: TSA958 ($16.12 in chips) 
Tyche3814: posts small blind $0.05
Nealy_Godz: posts big blind $0.10
*** HOLE CARDS ***
Pablo7-Pro: folds 
vanapaguss: folds 
TSA958: folds 
mazzyb123: raises $0.24 to $0.34 and is all-in
Tyche3814: folds 
Nealy_Godz: folds 
Uncalled bet ($0.24) returned to mazzyb123
mazzyb123 collected $0.25 from pot
mazzyb123: doesn't show hand 
*** SUMMARY ***
Total pot $0.25 | Rake $0 
Seat 1: mazzyb123 (button) collected ($0.25)
Seat 2: Tyche3814 (small blind) folded before Flop
Seat 3: Nealy_Godz (big blind) folded before Flop
Seat 4: Pablo7-Pro folded before Flop (didn't bet)
Seat 5: vanapaguss folded before Flop (didn't bet)
Seat 6: TSA958 folded before Flop (didn't bet)



PokerStars Hand #222984295704:  Hold'em No Limit ($0.05/$0.10 USD) - 2021/01/23 22:22:05 ET
Table 'Stephano III' 6-max Seat #2 is the button
Seat 1: mazzyb123 ($0.49 in chips) 
Seat 2: Tyche3814 ($7.68 in chips) 
Seat 3: Nealy_Godz ($10 in chips) 
Seat 4: Pablo7-Pro ($10 in chips) 
Seat 5: vanapaguss ($22.88 in chips) 
Seat 6: TSA958 ($16.12 in chips) 
Nealy_Godz: posts small blind $0.05
Pablo7-Pro: posts big blind $0.10
*** HOLE CARDS ***
vanapaguss: raises $0.15 to $0.25
TSA958: folds 
mazzyb123: folds 
Tyche3814: folds 
Nealy_Godz: calls $0.20
Pablo7-Pro: folds 
*** FLOP *** [Jd Ts Ks]
Nealy_Godz: checks 
vanapaguss: checks 
*** TURN *** [Jd Ts Ks] [4d]
Nealy_Godz: checks 
vanapaguss: bets $0.20
Nealy_Godz: calls $0.20
*** RIVER *** [Jd Ts Ks 4d] [Kh]
Nealy_Godz: checks 
vanapaguss: bets $0.50
Nealy_Godz: calls $0.50
*** SHOW DOWN ***
vanapaguss: shows [4c 4h] (a full house, Fours full of Kings)
Nealy_Godz: mucks hand 
vanapaguss collected $1.91 from pot
*** SUMMARY ***
Total pot $2 | Rake $0.09 
Board [Jd Ts Ks 4d Kh]
Seat 1: mazzyb123 folded before Flop (didn't bet)
Seat 2: Tyche3814 (button) folded before Flop (didn't bet)
Seat 3: Nealy_Godz (small blind) mucked
Seat 4: Pablo7-Pro (big blind) folded before Flop
Seat 5: vanapaguss showed [4c 4h] and won ($1.91) with a full house, Fours full of Kings
Seat 6: TSA958 folded before Flop (didn't bet)



PokerStars Hand #222984306984:  Hold'em No Limit ($0.05/$0.10 USD) - 2021/01/23 22:22:36 ET
Table 'Stephano III' 6-max Seat #3 is the button
Seat 1: mazzyb123 ($0.49 in chips) 
Seat 2: Tyche3814 ($7.68 in chips) 
Seat 3: Nealy_Godz ($10 in chips) 
Seat 4: Pablo7-Pro ($10 in chips) 
Seat 5: vanapaguss ($23.84 in chips) 
Seat 6: TSA958 ($16.12 in chips) 
Pablo7-Pro: posts small blind $0.05
vanapaguss: posts big blind $0.10
*** HOLE CARDS ***
TSA958: folds 
mazzyb123: folds 
Tyche3814: folds 
Nealy_Godz: folds 
Pablo7-Pro: folds 
Uncalled bet ($0.05) returned to vanapaguss
vanapaguss collected $0.10 from pot
vanapaguss: doesn't show hand 
*** SUMMARY ***
Total pot $0.10 | Rake $0 
Seat 1: mazzyb123 folded before Flop (didn't bet)
Seat 2: Tyche3814 folded before Flop (didn't bet)
Seat 3: Nealy_Godz (button) folded before Flop (didn't bet)
Seat 4: Pablo7-Pro (small blind) folded before Flop
Seat 5: vanapaguss (big blind) collected ($0.10)
Seat 6: TSA958 folded before Flop (didn't bet)



PokerStars Hand #222984310535:  Hold'em No Limit ($0.05/$0.10 USD) - 2021/01/23 22:22:46 ET
Table 'Stephano III' 6-max Seat #4 is the button
Seat 1: mazzyb123 ($0.49 in chips) 
Seat 2: Tyche3814 ($7.68 in chips) 
Seat 3: Nealy_Godz ($10 in chips) 
Seat 4: Pablo7-Pro ($10 in chips) 
Seat 5: vanapaguss ($23.89 in chips) 
Seat 6: TSA958 ($16.12 in chips) 
vanapaguss: posts small blind $0.05
TSA958: posts big blind $0.10
*** HOLE CARDS ***
mazzyb123: folds 
Tyche3814: folds 
Nealy_Godz: folds 
Pablo7-Pro: folds 
vanapaguss: folds 
Uncalled bet ($0.05) returned to TSA958
TSA958 collected $0.10 from pot
TSA958: doesn't show hand 
*** SUMMARY ***
Total pot $0.10 | Rake $0 
Seat 1: mazzyb123 folded before Flop (didn't bet)
Seat 2: Tyche3814 folded before Flop (didn't bet)
Seat 3: Nealy_Godz folded before Flop (didn't bet)
Seat 4: Pablo7-Pro (button) folded before Flop (didn't bet)
Seat 5: vanapaguss (small blind) folded before Flop
Seat 6: TSA958 (big blind) collected ($0.10)



PokerStars Hand #222984317079:  Hold'em No Limit ($0.05/$0.10 USD) - 2021/01/23 22:23:05 ET
Table 'Stephano III' 6-max Seat #5 is the button
Seat 1: mazzyb123 ($0.49 in chips) 
Seat 2: Tyche3814 ($7.68 in chips) 
Seat 3: Nealy_Godz ($10 in chips) 
Seat 4: Pablo7-Pro ($10 in chips) 
Seat 5: vanapaguss ($23.84 in chips) 
Seat 6: TSA958 ($16.17 in chips) 
TSA958: posts small blind $0.05
mazzyb123: posts big blind $0.10
*** HOLE CARDS ***
Tyche3814: folds 
Nealy_Godz: raises $0.20 to $0.30
Pablo7-Pro: folds 
vanapaguss: folds 
TSA958: folds 
mazzyb123: folds 
Uncalled bet ($0.20) returned to Nealy_Godz
Nealy_Godz collected $0.25 from pot
Nealy_Godz: doesn't show hand 
*** SUMMARY ***
Total pot $0.25 | Rake $0 
Seat 1: mazzyb123 (big blind) folded before Flop
Seat 2: Tyche3814 folded before Flop (didn't bet)
Seat 3: Nealy_Godz collected ($0.25)
Seat 4: Pablo7-Pro folded before Flop (didn't bet)
Seat 5: vanapaguss (button) folded before Flop (didn't bet)
Seat 6: TSA958 (small blind) folded before Flop



PokerStars Hand #222984321666:  Hold'em No Limit ($0.05/$0.10 USD) - 2021/01/23 22:23:17 ET
Table 'Stephano III' 6-max Seat #6 is the button
Seat 1: mazzyb123 ($0.39 in chips) 
Seat 2: Tyche3814 ($7.68 in chips) 
Seat 3: Nealy_Godz ($10.15 in chips) 
Seat 4: Pablo7-Pro ($10 in chips) 
Seat 5: vanapaguss ($23.84 in chips) 
Seat 6: TSA958 ($16.12 in chips) 
mazzyb123: posts small blind $0.05
Tyche3814: posts big blind $0.10
*** HOLE CARDS ***
Nealy_Godz: raises $0.20 to $0.30
Pablo7-Pro: folds 
vanapaguss: folds 
TSA958: folds 
mazzyb123: folds 
Tyche3814: calls $0.20
*** FLOP *** [Jd 7d 7s]
Tyche3814: bets $0.20
Nealy_Godz: calls $0.20
*** TURN *** [Jd 7d 7s] [7h]
Tyche3814: bets $0.20
Nealy_Godz: folds 
Uncalled bet ($0.20) returned to Tyche3814
Tyche3814 collected $1 from pot
*** SUMMARY ***
Total pot $1.05 | Rake $0.05 
Board [Jd 7d 7s 7h]
Seat 1: mazzyb123 (small blind) folded before Flop
Seat 2: Tyche3814 (big blind) collected ($1)
Seat 3: Nealy_Godz folded on the Turn
Seat 4: Pablo7-Pro folded before Flop (didn't bet)
Seat 5: vanapaguss folded before Flop (didn't bet)
Seat 6: TSA958 (button) folded before Flop (didn't bet)



PokerStars Hand #222984333680:  Hold'em No Limit ($0.05/$0.10 USD) - 2021/01/23 22:23:52 ET
Table 'Stephano III' 6-max Seat #1 is the button
Seat 1: mazzyb123 ($0.34 in chips) 
Seat 2: Tyche3814 ($8.18 in chips) 
Seat 3: Nealy_Godz ($10 in chips) 
Seat 4: Pablo7-Pro ($10 in chips) 
Seat 5: vanapaguss ($23.84 in chips) 
Seat 6: TSA958 ($16.12 in chips) 
Tyche3814: posts small blind $0.05
Nealy_Godz: posts big blind $0.10
*** HOLE CARDS ***
Pablo7-Pro: folds 
vanapaguss: folds 
TSA958: folds 
mazzyb123: folds 
Tyche3814: calls $0.05
Nealy_Godz: checks 
*** FLOP *** [Ac 3d Th]
Tyche3814: checks 
Nealy_Godz: bets $0.10
Tyche3814: folds 
Uncalled bet ($0.10) returned to Nealy_Godz
Nealy_Godz collected $0.19 from pot
Nealy_Godz: doesn't show hand 
*** SUMMARY ***
Total pot $0.20 | Rake $0.01 
Board [Ac 3d Th]
Seat 1: mazzyb123 (button) folded before Flop (didn't bet)
Seat 2: Tyche3814 (small blind) folded on the Flop
Seat 3: Nealy_Godz (big blind) collected ($0.19)
Seat 4: Pablo7-Pro folded before Flop (didn't bet)
Seat 5: vanapaguss folded before Flop (didn't bet)
Seat 6: TSA958 folded before Flop (didn't bet)



PokerStars Hand #222984341786:  Hold'em No Limit ($0.05/$0.10 USD) - 2021/01/23 22:24:15 ET
Table 'Stephano III' 6-max Seat #2 is the button
Seat 1: mazzyb123 ($0.34 in chips) 
Seat 2: Tyche3814 ($8.08 in chips) 
Seat 3: Nealy_Godz ($10.09 in chips) 
Seat 4: Pablo7-Pro ($10 in chips) 
Seat 5: vanapaguss ($23.84 in chips) 
Seat 6: TSA958 ($16.12 in chips) 
Nealy_Godz: posts small blind $0.05
Pablo7-Pro: posts big blind $0.10
*** HOLE CARDS ***
vanapaguss: folds 
TSA958: folds 
mazzyb123: folds 
Tyche3814: raises $0.10 to $0.20
Nealy_Godz: folds 
Pablo7-Pro: calls $0.10
*** FLOP *** [8s 7s 6c]
Pablo7-Pro: checks 
Tyche3814: bets $0.20
Pablo7-Pro: calls $0.20
*** TURN *** [8s 7s 6c] [7c]
Pablo7-Pro: checks 
Tyche3814: bets $0.30
Pablo7-Pro: raises $0.50 to $0.80
Tyche3814: folds 
Uncalled bet ($0.50) returned to Pablo7-Pro
Pablo7-Pro collected $1.38 from pot
Pablo7-Pro: doesn't show hand 
*** SUMMARY ***
Total pot $1.45 | Rake $0.07 
Board [8s 7s 6c 7c]
Seat 1: mazzyb123 folded before Flop (didn't bet)
Seat 2: Tyche3814 (button) folded on the Turn
Seat 3: Nealy_Godz (small blind) folded before Flop
Seat 4: Pablo7-Pro (big blind) collected ($1.38)
Seat 5: vanapaguss folded before Flop (didn't bet)
Seat 6: TSA958 folded before Flop (didn't bet)



PokerStars Hand #222984362254:  Hold'em No Limit ($0.05/$0.10 USD) - 2021/01/23 22:25:04 ET
Table 'Stephano III' 6-max Seat #3 is the button
Seat 1: mazzyb123 ($0.34 in chips) 
Seat 2: Tyche3814 ($7.38 in chips) 
Seat 3: Nealy_Godz ($10.04 in chips) 
Seat 4: Pablo7-Pro ($10.68 in chips) 
Seat 5: vanapaguss ($23.84 in chips) 
Seat 6: TSA958 ($16.12 in chips) 
Pablo7-Pro: posts small blind $0.05
vanapaguss: posts big blind $0.10
*** HOLE CARDS ***
TSA958: folds 
mazzyb123: folds 
Tyche3814: raises $0.20 to $0.30
Nealy_Godz: calls $0.30
Pablo7-Pro: raises $1.20 to $1.50
vanapaguss: folds 
Tyche3814: folds 
Nealy_Godz: folds 
Uncalled bet ($1.20) returned to Pablo7-Pro
Pablo7-Pro collected $1 from pot
Pablo7-Pro: doesn't show hand 
*** SUMMARY ***
Total pot $1 | Rake $0 
Seat 1: mazzyb123 folded before Flop (didn't bet)
Seat 2: Tyche3814 folded before Flop
Seat 3: Nealy_Godz (button) folded before Flop
Seat 4: Pablo7-Pro (small blind) collected ($1)
Seat 5: vanapaguss (big blind) folded before Flop
Seat 6: TSA958 folded before Flop (didn't bet)



PokerStars Hand #222984373322:  Hold'em No Limit ($0.05/$0.10 USD) - 2021/01/23 22:25:36 ET
Table 'Stephano III' 6-max Seat #4 is the button
Seat 1: mazzyb123 ($0.34 in chips) 
Seat 2: Tyche3814 ($7.08 in chips) 
Seat 3: Nealy_Godz ($10 in chips) 
Seat 4: Pablo7-Pro ($11.38 in chips) 
Seat 5: vanapaguss ($23.74 in chips) 
Seat 6: TSA958 ($16.12 in chips) 
vanapaguss: posts small blind $0.05
TSA958: posts big blind $0.10
*** HOLE CARDS ***
mazzyb123: folds 
Tyche3814: folds 
Nealy_Godz: folds 
Pablo7-Pro: folds 
vanapaguss: folds 
Uncalled bet ($0.05) returned to TSA958
TSA958 collected $0.10 from pot
TSA958: doesn't show hand 
*** SUMMARY ***
Total pot $0.10 | Rake $0 
Seat 1: mazzyb123 folded before Flop (didn't bet)
Seat 2: Tyche3814 folded before Flop (didn't bet)
Seat 3: Nealy_Godz folded before Flop (didn't bet)
Seat 4: Pablo7-Pro (button) folded before Flop (didn't bet)
Seat 5: vanapaguss (small blind) folded before Flop
Seat 6: TSA958 (big blind) collected ($0.10)



PokerStars Hand #222984378412:  Hold'em No Limit ($0.05/$0.10 USD) - 2021/01/23 22:25:50 ET
Table 'Stephano III' 6-max Seat #5 is the button
Seat 1: mazzyb123 ($0.34 in chips) 
Seat 2: Tyche3814 ($7.08 in chips) 
Seat 3: Nealy_Godz ($10 in chips) 
Seat 4: Pablo7-Pro ($11.38 in chips) 
Seat 5: vanapaguss ($23.69 in chips) 
Seat 6: TSA958 ($16.17 in chips) 
TSA958: posts small blind $0.05
mazzyb123: posts big blind $0.10
*** HOLE CARDS ***
Tyche3814: raises $0.10 to $0.20
Nealy_Godz: folds 
Pablo7-Pro: calls $0.20
vanapaguss: folds 
TSA958: folds 
mazzyb123: folds 
*** FLOP *** [3s 7c 4d]
Tyche3814: bets $0.20
Pablo7-Pro: calls $0.20
*** TURN *** [3s 7c 4d] [3c]
Tyche3814: bets $0.20
Pablo7-Pro: calls $0.20
*** RIVER *** [3s 7c 4d 3c] [Td]
Tyche3814: checks 
Pablo7-Pro: checks 
*** SHOW DOWN ***
Tyche3814: shows [2d Ad] (a pair of Threes)
Pablo7-Pro: shows [6h 6d] (two pair, Sixes and Threes)
Pablo7-Pro collected $1.29 from pot
*** SUMMARY ***
Total pot $1.35 | Rake $0.06 
Board [3s 7c 4d 3c Td]
Seat 1: mazzyb123 (big blind) folded before Flop
Seat 2: Tyche3814 showed [2d Ad] and lost with a pair of Threes
Seat 3: Nealy_Godz folded before Flop (didn't bet)
Seat 4: Pablo7-Pro showed [6h 6d] and won ($1.29) with two pair, Sixes and Threes
Seat 5: vanapaguss (button) folded before Flop (didn't bet)
Seat 6: TSA958 (small blind) folded before Flop



PokerStars Hand #222984393268:  Hold'em No Limit ($0.05/$0.10 USD) - 2021/01/23 22:26:33 ET
Table 'Stephano III' 6-max Seat #6 is the button
Seat 1: mazzyb123 ($0.24 in chips) 
Seat 2: Tyche3814 ($6.48 in chips) 
Seat 3: Nealy_Godz ($10 in chips) 
Seat 4: Pablo7-Pro ($12.07 in chips) 
Seat 5: vanapaguss ($23.69 in chips) 
Seat 6: TSA958 ($16.12 in chips) 
mazzyb123: posts small blind $0.05
Tyche3814: posts big blind $0.10
*** HOLE CARDS ***
Nealy_Godz: folds 
Pablo7-Pro: folds 
vanapaguss: folds 
TSA958: folds 
mazzyb123: raises $0.14 to $0.24 and is all-in
Tyche3814: calls $0.14
*** FLOP *** [3s 6h Jh]
*** TURN *** [3s 6h Jh] [3c]
*** RIVER *** [3s 6h Jh 3c] [9c]
*** SHOW DOWN ***
mazzyb123: shows [Ad 3d] (three of a kind, Threes)
Tyche3814: shows [Td 9d] (two pair, Nines and Threes)
mazzyb123 collected $0.46 from pot
*** SUMMARY ***
Total pot $0.48 | Rake $0.02 
Board [3s 6h Jh 3c 9c]
Seat 1: mazzyb123 (small blind) showed [Ad 3d] and won ($0.46) with three of a kind, Threes
Seat 2: Tyche3814 (big blind) showed [Td 9d] and lost with two pair, Nines and Threes
Seat 3: Nealy_Godz folded before Flop (didn't bet)
Seat 4: Pablo7-Pro folded before Flop (didn't bet)
Seat 5: vanapaguss folded before Flop (didn't bet)
Seat 6: TSA958 (button) folded before Flop (didn't bet)



PokerStars Hand #222984402993:  Hold'em No Limit ($0.05/$0.10 USD) - 2021/01/23 22:27:00 ET
Table 'Stephano III' 6-max Seat #1 is the button
Seat 1: mazzyb123 ($0.46 in chips) 
Seat 2: Tyche3814 ($6.24 in chips) 
Seat 3: Nealy_Godz ($10 in chips) 
Seat 4: Pablo7-Pro ($12.07 in chips) 
Seat 5: vanapaguss ($23.69 in chips) 
Seat 6: TSA958 ($16.12 in chips) 
Tyche3814: posts small blind $0.05
Nealy_Godz: posts big blind $0.10
*** HOLE CARDS ***
Pablo7-Pro: folds 
vanapaguss: folds 
TSA958: folds 
mazzyb123: folds 
Tyche3814: folds 
Uncalled bet ($0.05) returned to Nealy_Godz
Nealy_Godz collected $0.10 from pot
Nealy_Godz: doesn't show hand 
*** SUMMARY ***
Total pot $0.10 | Rake $0 
Seat 1: mazzyb123 (button) folded before Flop (didn't bet)
Seat 2: Tyche3814 (small blind) folded before Flop
Seat 3: Nealy_Godz (big blind) collected ($0.10)
Seat 4: Pablo7-Pro folded before Flop (didn't bet)
Seat 5: vanapaguss folded before Flop (didn't bet)
Seat 6: TSA958 folded before Flop (didn't bet)



PokerStars Hand #222984409925:  Hold'em No Limit ($0.05/$0.10 USD) - 2021/01/23 22:27:20 ET
Table 'Stephano III' 6-max Seat #2 is the button
Seat 1: mazzyb123 ($0.46 in chips) 
Seat 2: Tyche3814 ($6.19 in chips) 
Seat 3: Nealy_Godz ($10.05 in chips) 
Seat 4: Pablo7-Pro ($12.07 in chips) 
Seat 5: vanapaguss ($23.69 in chips) 
Seat 6: TSA958 ($16.12 in chips) 
Nealy_Godz: posts small blind $0.05
Pablo7-Pro: posts big blind $0.10
*** HOLE CARDS ***
vanapaguss: folds 
TSA958: folds 
mazzyb123: folds 
Tyche3814: raises $0.10 to $0.20
Nealy_Godz: folds 
Pablo7-Pro: folds 
Uncalled bet ($0.10) returned to Tyche3814
Tyche3814 collected $0.25 from pot
*** SUMMARY ***
Total pot $0.25 | Rake $0 
Seat 1: mazzyb123 folded before Flop (didn't bet)
Seat 2: Tyche3814 (button) collected ($0.25)
Seat 3: Nealy_Godz (small blind) folded before Flop
Seat 4: Pablo7-Pro (big blind) folded before Flop
Seat 5: vanapaguss folded before Flop (didn't bet)
Seat 6: TSA958 folded before Flop (didn't bet)



PokerStars Hand #222984420667:  Hold'em No Limit ($0.05/$0.10 USD) - 2021/01/23 22:27:37 ET
Table 'Stephano III' 6-max Seat #3 is the button
Seat 1: mazzyb123 ($0.46 in chips) 
Seat 2: Tyche3814 ($6.34 in chips) 
Seat 3: Nealy_Godz ($10 in chips) 
Seat 4: Pablo7-Pro ($11.97 in chips) 
Seat 5: vanapaguss ($23.69 in chips) 
Seat 6: TSA958 ($16.12 in chips) 
Pablo7-Pro: posts small blind $0.05
vanapaguss: posts big blind $0.10
*** HOLE CARDS ***
TSA958: folds 
mazzyb123: folds 
Tyche3814: folds 
Nealy_Godz: folds 
Pablo7-Pro: folds 
Uncalled bet ($0.05) returned to vanapaguss
vanapaguss collected $0.10 from pot
vanapaguss: doesn't show hand 
*** SUMMARY ***
Total pot $0.10 | Rake $0 
Seat 1: mazzyb123 folded before Flop (didn't bet)
Seat 2: Tyche3814 folded before Flop (didn't bet)
Seat 3: Nealy_Godz (button) folded before Flop (didn't bet)
Seat 4: Pablo7-Pro (small blind) folded before Flop
Seat 5: vanapaguss (big blind) collected ($0.10)
Seat 6: TSA958 folded before Flop (didn't bet)



PokerStars Hand #222984424257:  Hold'em No Limit ($0.05/$0.10 USD) - 2021/01/23 22:27:47 ET
Table 'Stephano III' 6-max Seat #4 is the button
Seat 1: mazzyb123 ($0.46 in chips) 
Seat 2: Tyche3814 ($6.34 in chips) 
Seat 3: Nealy_Godz ($10 in chips) 
Seat 4: Pablo7-Pro ($11.92 in chips) 
Seat 5: vanapaguss ($23.74 in chips) 
Seat 6: TSA958 ($16.12 in chips) 
vanapaguss: posts small blind $0.05
TSA958: posts big blind $0.10
*** HOLE CARDS ***
mazzyb123: folds 
Tyche3814: folds 
Nealy_Godz: folds 
Pablo7-Pro: folds 
vanapaguss: folds 
Uncalled bet ($0.05) returned to TSA958
TSA958 collected $0.10 from pot
TSA958: doesn't show hand 
*** SUMMARY ***
Total pot $0.10 | Rake $0 
Seat 1: mazzyb123 folded before Flop (didn't bet)
Seat 2: Tyche3814 folded before Flop (didn't bet)
Seat 3: Nealy_Godz folded before Flop (didn't bet)
Seat 4: Pablo7-Pro (button) folded before Flop (didn't bet)
Seat 5: vanapaguss (small blind) folded before Flop
Seat 6: TSA958 (big blind) collected ($0.10)



PokerStars Hand #222984431557:  Hold'em No Limit ($0.05/$0.10 USD) - 2021/01/23 22:28:08 ET
Table 'Stephano III' 6-max Seat #5 is the button
Seat 1: mazzyb123 ($0.46 in chips) 
Seat 2: Tyche3814 ($6.34 in chips) 
Seat 3: Nealy_Godz ($10 in chips) 
Seat 4: Pablo7-Pro ($11.92 in chips) 
Seat 5: vanapaguss ($23.69 in chips) 
Seat 6: TSA958 ($16.17 in chips) 
TSA958: posts small blind $0.05
mazzyb123: posts big blind $0.10
*** HOLE CARDS ***
Tyche3814: folds 
Nealy_Godz: folds 
Pablo7-Pro: raises $0.20 to $0.30
vanapaguss: folds 
vanapaguss leaves the table
TSA958: folds 
mazzyb123: folds 
Uncalled bet ($0.20) returned to Pablo7-Pro
Pablo7-Pro collected $0.25 from pot
Pablo7-Pro: doesn't show hand 
*** SUMMARY ***
Total pot $0.25 | Rake $0 
Seat 1: mazzyb123 (big blind) folded before Flop
Seat 2: Tyche3814 folded before Flop (didn't bet)
Seat 3: Nealy_Godz folded before Flop (didn't bet)
Seat 4: Pablo7-Pro collected ($0.25)
Seat 5: vanapaguss (button) folded before Flop (didn't bet)
Seat 6: TSA958 (small blind) folded before Flop



PokerStars Hand #222984435536:  Hold'em No Limit ($0.05/$0.10 USD) - 2021/01/23 22:28:19 ET
Table 'Stephano III' 6-max Seat #6 is the button
Seat 1: mazzyb123 ($0.36 in chips) 
Seat 2: Tyche3814 ($6.34 in chips) 
Seat 3: Nealy_Godz ($10 in chips) 
Seat 4: Pablo7-Pro ($12.07 in chips) 
Seat 6: TSA958 ($16.12 in chips) 
mazzyb123: posts small blind $0.05
Tyche3814: posts big blind $0.10
*** HOLE CARDS ***
Nealy_Godz: folds 
Pablo7-Pro: folds 
TSA958: folds 
mazzyb123: folds 
Uncalled bet ($0.05) returned to Tyche3814
Tyche3814 collected $0.10 from pot
*** SUMMARY ***
Total pot $0.10 | Rake $0 
Seat 1: mazzyb123 (small blind) folded before Flop
Seat 2: Tyche3814 (big blind) collected ($0.10)
Seat 3: Nealy_Godz folded before Flop (didn't bet)
Seat 4: Pablo7-Pro folded before Flop (didn't bet)
Seat 6: TSA958 (button) folded before Flop (didn't bet)



